		10.0
sarva taTAgata aDizWAna vyUham sUtram	@416a rgya gar skad du / a'arya sarba ta th'a ga t'a dhashth'i na satv'a ba lo ke na buddha kshe tre ni rde sha na by'u ha n'a ma ma h'a y'a na s'u tra / bod skad du /'phags pa de bzhin gshegs pa thams cad kyi byin gyi rlabs sems can la gzigs shing sangs rgyas kyi zhing gi bkod pa kun tu ston pa zhes bya ba theg pa chen po'i mdo / sangs rgyas dang byang chub sems dpa' thams cad la phyag 'tshal lo // 'di skad bdag gis thos pa dus gcig na /	48.34610452052842
evam mayA Srutam ekasmin samaye potalaka parvate Arya avalokita ISvara Ayatane divya maNi ratna SrIindranIla maye puzpa saMstRte deva siMhAsane BagavAn sArDam mahatA Bikzu saFGena paQca mAtrEH Bikzu SatEH sarvEH arhadBiH kzINa AsravEH cetaH vaSitA prAptEH sat Darma pAraMgatEH ca sArDam boDisattvEH	bcom ldan 'das ri gru 'dzin na 'phags pa spyan ras gzigs dbang phyug gi gnas lha'i nor bu rin po che dpal gyi snying po dang / me tog rgyas pa dang / lha'i sengge'i khri bkod pa na dge slong lnga brgya tsam gyi dge slong gi dge 'dun chen po thams cad kyang dgra bcom pa / zag pa zad pa /	52.0330478590622
sarvEH mahA karuNA jQAna prAptEH sarvEH eka jAti pratibadDEH dvijAtiByAm ca tri jAtiBiH daSa jAtiBiH viSati jAtiBiH triMSat jAtiBiH	sems thams cad kyi dbang gi dam pa'i pha rol tu son pa sha stag dang / byang chub sems dpa' thams cad kyang snying rje chen po'i shes pa la gnas pa / thams cad kyang skye ba gcig gis thogs pa dang / skye ba gnyis dang / skye ba gsum dang / skye ba bcu dang / skye ba nyi shu dang / skye ba sum cu dang / skye ba brgya'i bar dag gis @416b thogs pa /	74.55419289508434
Sata jAtiBiH vA pratibadDEH sarvEH azwa Pala prAptEH daSa BUmi sTitEH tat yaTA	thams cad kyang sa brgyad pa dang / sa bcu pa la gnas pa sha stag ste /	58.6121692273462
Arya avalokita ISvareNa maMju SriyA vimala ketunA ratna SriyA vajraketunA vimala praBeNa candanena amRta ketunA evaMpramuKEH sapta SatEH boDisattvEH sArDam upAsa ka upAsikABiH sarvEH ca vyAkRtEH samADi prAptEH nAnA lokaDAtuBiH sannipatitEH paQca sahasrEH	'phags pa spyan ras gzigs dbang phyug dang / 'jam dpal dang / dri med tog dang / nor dpal dang / glog gi tog dang / dri med 'od dang / tsandan dang / bdud rtsi'i tog la sogs pa byang chub sems dpa' sems dpa' chen po bdun brgya dang / dge bsnyen dang / dge bsnyen ma thams cad kyang lung bstan pa dang ldan pa / ting nge 'dzin thob pa /	73.43593554527514
sarvEH ganDarva Sata sahasrEH pUrva budDa paryupAsitEH	'jig rten gyi khams tha dad pa nas 'dus pa lnga stong dang / lha dang / klu dang / gnod sbyin dang / dri za thams cad kyang sngon gyi sangs rgyas la bsnyen bkur byas pa /	69.84722949527816
taTAgata prAtihArya dRzwEH sArDam sarvABiH mahA yakziNIBiH boDisattva jQAna prAptABiH	de bzhin gshegs pa'i cho 'phrul mthong ba brgya stong dang / gnod sbyin mo chen mo thams cad kyang byang chub sems dpa'i ye shes thob pa lung bstan pa thob pa /	80.49782198199452
vyAkaraNa prAptABiH avEvartikABiH anOpamyayA vimala praBayA ca praBAvatyA BIma SriyA yakziNyA ca evaMpramuKABiH aSItyA mahA yakziNIBiH Satakratu brahma vESravaNa DRtarAzwra virUXaka vi rUpa akza maNi Badra putra pUrNaBadrAH etEH ca lokapAlEH sArDam nizaNNaH BUt	phyir mi ldog pa dpe med ma dang / dri med 'od dang / 'od can ma dang / 'jigs byed ma dang / dpal ldan ma dang / 'phrog ma dang / dung can ma la sogs pa gnod sbyin mo chen mo brgyad cu dang / brgya byin dang / tshangs pa dang / rnam thos kyi bu dang / yul 'khor srung dang / 'phags skyes po dang / mig mi bzang dang / nor bu bzang po'i bu dang / gang pa bzang po la sogs pa 'jig rten skyong ba thams cad kyi bar dag dang thabs cig tu bzhugs so //	87.25306561477015
aTa tEH sarvEH taTAgatam siMhAsana nizaNNam jQAtvA sva ka svakEH kuSala mUlEH taTAgatam	de nas de dag thams cad kyis de bzhin gshegs pa sengge'i khri la @417a *// bzhugs par rig nas rang rang gi dge ba'i rtsa ba dag gis de bzhin gshegs pa la lha'i rgyan dang /	85.57559543615344
divya alaMkAra vastra puzpa mAlya DUpa vilepana vAdya Sabdena mAnitaH pUjitaH Sata sahasra kowiSas	na bza' dang / me tog dang / me tog phreng dang / spos dang / byug pa dang / rol mo'i sgra rnams kyis mchod par byas / ri mor byas so // kha cig gis lan 'bum phrag du mar bskor ba byas te bstod do //	85.69010494806842
pradakziNIkRtya arcitaH ca tena Kalu punar samayena BagavAn sarva sattva mahA karuNA jQAna sTitam nAma samADim samApannaH BUt	de nas de'i tshe bcom ldan 'das sems can thams cad la dmigs pa snying rje chen po'i shes pa la gnas pa zhes bya ba'i ting nge 'dzin la snyoms par zhugs so //	85.86254742269921
tena samADi DAraNa balena tri sAhasra mahA sAhasra loka DAtavaH ABayAH avaBAsitAH aBUvan sarva rUpANi sPuwitAni	ting nge 'dzin de'i mthus stong gsum gyi stong chen po'i 'jig rten gyi khams 'di 'od kyis snang bar gyur cing / gzugs thams cad snang bas khyab par gyur nas sems can dmus long gang yin pa de gyur cing / dag gis ni /	86.58923072158589
ye ca sattvAH jAti anDAH cakzuzA rUpANi paSyanti sma	mig gis gzugs mthong bar gyur to //	58.36342579977853
vaDirAH SrotreNa SabdAn SRNvanti sma	'on pa rnams kyis ni rna bas sgra dag thos par gyur to //	85.88200997051439
roga spRzwAH vigata rogAH Bavanti sma	nad kyis btab pa rnams ni nad dag dang bral bar gyur to //	83.00156762682158
nagnAH ca vastra AvRtAH vaBUvuH	gos med pa rnams ni gos dag thob par gyur to //	78.53397505334084
unmattAH smRtim pratilaBante sma	smyon pa rnams ni dran pa thob par gyur to //	72.85512381129794
hIna kAyAH paripUrNa indriyAH baBUvuH	lus nyams pa dang dbang po ma tshang ba rnams ni lus dang dbang po yongs su rdzogs par gyur to; ;dbul po rnams kyis ni nor dag thob par gyur to //	73.67819944725103
daridra DanAni pratilaBante sma sattvAnAm yaH Kalu Dana vastu Boga vihInaH AsIt sa Dana vastu Boga sampannaH BUt	sems can gang dag nor dang / yo byad dang / longs spyod med pa de dag nor dang / yo byad dang / longs spyod dag dang @417b ldan par gyur to //	75.68500035940713
sarva sattvAH sarva suKa samarpitAH sarva ASA paripUrNAH aBUvan	sems can thams cad kyang bde ba thams cad dang ldan zhing bsam pa thams cad yongs su rdzogs par gyur to //	92.11121206699902
tri sAhasra mahA sAhasra lokaDAtO ye kecid sattvAH anuSAsana Darma SravaNAya yena BagavAn tena aMjalim praNamya upasaMkrAntAH ye sattvAH dutt	stong gsum gyi stong chen po'i 'jig rten gyi khams kyi sems can gang yin pa de dag thams cad la'ang bskul nas thams cad chos mnyan pa'i phyir bcom ldan 'das ga la ba der lhags gyur to //	87.84564043812638
deva BUtAH te sarva deva suKam saMprahAya budDa anusmRtim kRtvA Darma SravaNAya yena BagavAn tena upasaMkrAntAH	te / sems can gang dag lha rnams kyi nang du skyes pa de dag thams cad kyis ni lha'i bde ba yongs su spangs nas sangs rgyas rjes su dran par byas te chos mnyan pa'i phyir bcom ldan 'das ga la ba der lhags so gyur to // te /	90.34739561373988
ye sattvAH manuzya BUtAH te ca manuzya suKam parityajya Darma SravaNa kAmAya yena BagavAn= tena upasaMkrAntAH	// sems can gang dag mi rnams kyi nang du skyes pa de dag gis kyang mi'i bde ba yongs su spangs nas chos mnyan pa'i phyir bcom ldan 'das ga la ba der lhags gyur to // te / // so //	93.14467800700447
ye sattvAH nAga yakza rAkzasa preta piSAca BUtAH te budDa anusmRtim prApya sarva sattvezu mEtra cittAH BUtvA kAya citta suKam labDvA DarmaSrayena BagavAn tena upasaMkrAntAH	sems can gang dag klu dang / gnod sbyin dang / srin po dang / yi dvags dang / sha za rnams kyi nang du skyes pa de dag gis kyang sangs rgyas rjes su dran pa so sor thob nas sems can thams cad la byams par gnas pa dang / lus dang sems bde bar gyur nas chos mnyan pa'i phyir bcom ldan 'das ga la ba pa dang / der lhags so //	88.98540834264472
ye sattvAH yama loke anDatamisrAyAm jAtAH te pi budDa anuBAvena ekakzaNam smRtim labDvA parasparam saMjAnate sma	sems can gang dag gshin rje'i 'jig rten rnams su mun pa mun nag gi nang du skyes pa de dag kyang sangs rgyas kyi mthus yud tsam zhig dran pa so sor thob nas gcig gis gcig kun tu shes par gyur pa dang / der lhags so // te /	87.12538092623761
te mahA tamisrAByaH parimuktAH baBUvuH	de dag mun pa @418a *// chen po de nas yongs su thar par gyur to //	84.56047153947262
sarve satvAH parasparam mEtra cittAH baBUvuH tezAm upakleSAH kzINAH aBUvan	sems can thams cad gcig la gcig byams par gnas shing nye ba'i nyon mongs pa rnams dang bral bar gyur to //	78.369627972562
tena Kalu samayena mahA pRTivI zaw vikAram prakampate unnamati avanamati sma	de nas de'i tshe sa chen po 'di rnam pa drug tu rab tu g-yos te mtho gyur to //	77.18394062016988
aTa tasyAm parzadi maMju SrI kumAra BUtaH sannizaNNaH san boDisattvam mahAsattva m Arya avalokiteSvaram etat avocat	ba dang / dma' bar gyur to // de nas 'khor 'dus pa der 'jam dpal gzhon nur gyur pa 'dus te 'dug par gyur nas des byang chub sems dpa' sems dpa' chen po 'phags pa spyan ras gzigs dbang phyug la 'di skad ces smras so // rigs kyi bu /	89.65264025325565
kula putra mahA boDisattva parzadi avaBAsitAyAm mahA parzadaH pUrva nimittam parisPuwam	byang chub sems dpa'i 'dus pa chen po kun tu snang zhing 'dus pa chen po'i snga ltas kyang kun tu snang la / rigs kyi bu /	81.61664785808644
aneka boDisattva kowi niyuta Sata sahasrANAm ca vyAkaraNam prakawitam Darma mahA vAkyasya pUrva nimittam saMdRSyate	byang chub sems dpa' bye ba khrag khrig 'bum phrag mang po dag lung ston pa'ang kun tu snang zhing chos kyi 'brel ba'i gtam chen po'i snga ltas kyang kun tu snang ba las na /	89.42902402902554
kula putra anekAnAm ca boDisattva kowi niyuta Sata sahasrANAm sarva ASAparipUri mahA jQAna pratilamBaH Bavizyati	rigs kyi bu / byang chub sems dpa' bye ba khrag khrig 'bum phrag du ma dag gi re ba thams cad yongs su rdzogs par 'gyur zhing ye shes chen po'ang 'thob par 'gyur gyi / rigs kyi bu /	93.16849486404661
tat kula putra sattvAnAm kAruNyam utpAdya hitAya suKAya yAvat anuttarasyAm samyaksaMboDO pratizWApanAya taTAgatam paripRcCa	de'i phyir khyed kyis sems can thams cad la snying rje skyed la / phan pa dang / bde ba dang / bla na med pa yang dag par rdzogs pa'i byang chub la dgod par bya ba'i bar gyi phyir de bzhin gshegs pa la yongs su zhus @418b shig / rigs kyi bu /	85.56308276022993
santi kula putra sattvAH paScime kAle paScime samaye Bavizyanti pApa kAriNaH daridrAH	phyi ma'i dus phyi ma'i tshe na sems can sdig pa byed pa / dbul ba / nyam chung ba /	80.20386822433947
kRSAH durvarNa SarIrAH jarA vyADi paripIxitAH parItta BogA apariBAvita kAyAH alpa AyuzkA	lus mdog ngan pa / rga ba dang na bas yongs su gzir ba / longs spyod chung ba / lus yongs su ma bsgoms pa / tshe thung ba /	89.30805682615053
alpabudDayaH rAga dveza moha paripIxitAH	blo chung ba / 'dod chags dang / zhe sdang dang / gti mug gis yongs su gzir ba dag 'byung ba yod de /	81.79874810312701
tezAm arTAya kula putra taTAgatam aDyezaya Darma deSanAyE tat te kRtam Bavizyati	rigs kyi bu / de dag gi don du chos bstan par bya ba'i phyir de bzhin gshegs pa la gsol ba thob cig dang / rigs kyi bu /	87.15591149166187
dIrGarAtram sattvAnAm arTAya hitAya suKAya sarva avyADi praSamanAya sarva pApa nivAraNAya sarva pApa praSamanAya sarva SAparipUraNa arTam yAvat anuttara parinirvANa arTam dutt  i	de'i phyir khyod kyis yun ring por sems can rnams kyi don dang / phan pa dang / bde ba dang / nad thams cad rab tu zhi bar bya ba dang / sdig pa thams cad bzlog par bya ba dang / sdig pa thams cad rab tu zhi bar bya ba dang / re ba thams cad yongs su rdzogs par bya ba dang / bla na med pa'i yongs su mya ngan las 'da' ba dag byas par 'gyur ro //	87.86563038455107
aTa Arya avalokiSvaraH boDisattvaH mahAsattvaH daSa diSam avalokya gaFgA nadI vAlukA samAH taTAgata kowIH mamanasi	de nas byang chub sems dpa' sems dpa' chen po 'phags pa spyan ras gzigs dbang phyug gis phyogs bcur rnam par bltas te /	76.1467667254206
kurvan yena BagavAn= tena aMjalim praNamya tris pradakziNIkRtya paMca maNxalena praNipatya Bagavantam etat avocat	de bzhin gshegs pa bye ba phrag gangg'a'i klung gi bye ma snyed dag yid la byas nas bcom ldan 'das ga la ba de logs su thal mo sbyar ba btud de lan gsum bskor ba byas nas yan lag lngas phyag 'tshal te bcom ldan 'das la 'di skad ces gsol to // bcom ldan 'das /	85.6940247219772
santi Bagavan sattvAH paScime kAle Bavizyanti jarA vyADi Soka mRtyu duHKa kAla mRtyu paripIxitAH	slad ma'i dus slad ma'i tshe na sems @419a *// can rga ba dang / na ba dang / 'chi ba dang / mya ngan gyis non par gyur pa / dus ma lags par 'gum pas yongs su gzir ba / nyam chung ba / mdog ngan pa /	81.865465753821
kRSAH durvarNAH alpa AyuzkAH parItta BogAH apariBAvita kAyAH te parasparANi mAtsarya dOHSIlya citta tayA	tshe thung ba / longs spyod chung ba / lus yongs su ma bsgoms pa dag 'byung ba mchis te / de dag ni / ser sna dang / 'chal ba'i tshul khrims kyi sems kyis gcig la gcig 'gum par 'gyur la / gcig gis gcig gi nor dang / longs spyod dang / dbang phyug dag 'phrog par 'gyur zhing /	79.60998147484418
GAtayizyanti parasparANi Dana Boga ESvaryANi Apaharizyanti hAsya lAsya nAwya krIxA aBiratAH anitye nitya saMjQinaH aSuBe SuBa saMjQinaH	gad mo dang / 'jo sgeg dang / bro gar dang / rtsed mo dag gis mngon par rtse ba dang / mi rtag pa la rtag par 'du shes pa dang / mi sdug pa la sdug par 'du shes par bgyid lags so // de ci'i slad du zhe na /	79.02909289900222
te tad hetO tad nidAnA sattvAH nAnA prakArEH vihaga naraka tiryagyoni yama lokezu ca upapatsyante	de dag rgyu de dang / gzhi des sems can rnams la mi dge ba rnam pa sna tshogs dag gis gtses nas sems can dmyal ba dang / dud 'gro'i skye gnas dang / gshin rje'i 'jig rten dag tu'ang skye bar 'gyur lags pas / bcom ldan 'das /	81.65688726959652
tat tezAm aham Bagavan arTAya hitAya sarva ASAparipUra rNa arTam yAvat taTAgata jQAna AharaNa arTam budDa kzetra upapattaye sarva pApa nivAraNA	de'i slad du bdag de dag gi don dang / sman pa dang / bde ba dang / re ba thams cad yongs su rdzogs par bgyi ba dang / de bzhin gshegs pa'i ye shes thob par bgyi ba dang / sangs rgyas kyi zhing du skye bar bgyi ba dang / sdig pa thams cad bzlog par bgyi ba'i slad du de bzhin @419b gshegs pa la gsol ba 'debs par 'tshal gyi / bcom ldan 'das /	77.56107530691881
BAzasva Bagavan BAzasva sugataH na asti taTAgatasya tat jQAnam yat aviditam adRzwam aSrutam avijQAtam eva bahavaH Bagavan boDisattva Bikzu BikzuNI upAsa kopAsikAH deva nAgAH yakza ganDarva asura kinnarAH ca samAgatAH Darma sAMkaTyam Srotu kAmAH pUrva budDa paryupAsitAH sa prajQAH jAtAH te nirASIBUtA prakramizyanti	de bzhin gshegs pa la ni mi mkhyen pa dang / ma rtogs pa dang / ma gzigs pa dang / ma gsan pa dang / rnam par mi mkhyen pa ci'ang mi mnga' bas chos kyi 'bel ba'i gtam nyan par 'tshal ba dang / sngon gyi sangs rgyas la bsnyen bkur bgyis pa dang / shes rab dang ldan pa'i rang bzhin can gyi byang chub sems dpa' dang / dge slong dang / dge slong ma dang / dge bsnyen dang / dge bsnyen ma dang / lha dang / klu dang / gnod sbyin dang / dri za dang / lha ma yin dang / nam mkha' lding dang / mi 'am ci dang / lto 'phye chen po mang po lhags pa 'di dag re ba ma mchis par gyur cing / slar mchi bar mi 'gyur bar bcom ldan 'das / bshad du gsol /	69.01421720372586
aTa te sarve yaTA samAgatAH parzad paMca maNxalena praNipatya eka kaNWena evam AhuH	bde bar gshegs pa / bshad du gsol / de nas thams cad dang ldan pa'i 'khor ji ltar lhags pa de dag gis kyang yan lag lngas phyag byas te tshig mthun par 'di skad ces gsol to // bcom ldan 'das /	79.97743502843777
sADu Bagavan BAzasva Bagavan BAzasva sugataH	legs par bshad du gsol / bde bar gshegs pa / legs par bshad du gsol /	80.64423450585691
dutt  aTa BagavAn dvis api tris api aDyezaNAm viditvA daSa diSam avalokya valgu maNaH jQa svareNa AryAvalokita ISvaram boDisattvam mahAsatt	de nas bcom ldan 'das kyis lan gnyis lan gsum du gsol ba btab par thugs su chud nas phyogs bcur rnam par gzigs te / snyan cing 'jebs la yid du 'ong ba'i gsung dbyangs kyis byang chub sems @420a *// dpa' sems dpa' chen po 'phags pa spyan ras gzigs dbang phyug la 'di skad ces bka' stsal to //	85.35125560437743
asti kula putra sarva taTAgata aDizWAn sattva avalokana budDakzetrasandarSana vyUhaH nAma samADiH yaH mayA pUrvam praTama citta utpAdam upAdAy	rigs kyi bu / de bzhin gshegs pa thams cad kyi byin gyi rlabs sems can la gzigs shing sangs rgyas kyi zhing gi bkod pa kun tu ston pa zhes bya ba'i ting nge 'dzin yod de / ngas sngon dang po sems bskyed pa nas bzung ste /	91.51739821645718
su kusuma jyotiH sandarSanasya taTAgatasya antikAt SrutaH	de bzhin gshegs pa me tog snang ba kun tu ston pa zhes bya ba'i spyan sngar de thos so // rigs kyi bu /	81.23541070312393
tat saha SravaNAt eva tasya samADeH nAmaDeyasya navatInAm sattva kowInAm taTAgata jQAna pratilamBaH BUt te sarve ca vyAkRtAH taTAgatEH nAnA byudDa kzetrezu	ting nge 'dzin de'i ming thos ma thag tu sems can bye ba phrag dgu bcus de bzhin gshegs pa'i ye shes thob par gyur nas thams cad kyang de bzhin gshegs pas sangs rgyas kyi zhing tha dad pa dag tu lung bstan te /	82.95487173172643
mayA ca kula putra vyAkaraNam anuprAptam	ngas kyang lung bstan pa thob bo // rigs kyi bu /	80.08130375706419
tat smarAmi aham kula putra divyena taTAgata jQAnena triMSatyA taTAgata sahasrEH ayam Darma paryAyaH BAzitaH sattvAnAm arTAya	ngas de bzhin gshegs pa'i lha'i mkhyen pas sngon de bzhin gshegs pa sum khris sems can thams cad kyi don du chos kyi rnam grangs 'di bshad de /	84.45719941000087
sarvatra tvam eva Arya avalokita ISvara taTagatA aDyezakaH maMju SriyaH ca kumAra BUtaH	thams cad du'ang de bzhin gshegs pa la gsol ba 'debs pa ni 'phags pa spyan ras gzigs dbang phyug khyod nyid dang / 'jam dpal gzhon nur gyur pa yin la / byang chub sems /	88.3420139632837
ayam ca yaTA samAgatA sarva boDisattvAnAm parzad Bikzu BikzuNI upAsa kopAsikA parzad ete sarveSrutvA mAnanAm pUjanAm kurvanti sma	dpa' sems dpa' chen po'i 'khor rnams dang / dge slong dang / dge slong ma dang / dge bsnyen dang / dge bsnyen ma 'khor ji ltar lhags pa 'di dag gis kyang thos nas ri @420b mo dang / mchod pa dag byas te /	87.16057120263709
tatas ca anekAni sattva kowI niyuta Sata sahasrANi vyAkaraNam pratilaBante sma boDisattva sama aDInAm ca lABinaH Bavanti sarva kAmam gatAH kRta sarva ASAH samRDyante vigata vyADayaH saMvRttA paripakva kuSala mUlAH	de'i 'og tu sems can bye ba khrag khrig 'bum phrag du ma ngag gis lung bstan pa thob cing byang chub sems dpa'i ting nge 'dzin dag thob par gyur nas 'dod pa thams cad du 'gro ba dang / re ba thams cad grub pa dang / nad rnams dang bral bar yang gyur la /	74.03676152169638
sarva AvaraNa prahINAH aBirUpa prAsAdika darSanIyAH Dana DAnya koSa kozWAgAra samRdDAH sarva rAja rAja putra amatya aBinandanIyAH sarva sattvEH vandanIyAH dutt smRtimantaH prajQAvantaH budDe Dama saMGe aBedya prasAdena samanvAgatAH DRtimantaH AyuH varNa tejaH bala raTa AmavantaH sarva AkAra varopet	dge ba'i rtsa ba rnams yongs su smin pa dang / sgrib pa thams cad spangs pa dang / gzugs bzang zhing mdzes la blta na sdug pa dang / nor dang / 'bru dang / mdzod dang / bang ba rnams 'byor ba dang / rgyal po dang / rgyal bu dang / blon po rnams kyis mngon par bstod par 'os pa dang / sems can thams cad kyis phyag bya bar 'os pa dang / dran pa dang ldan pa dang / shes rab dang ldan pa dang / sangs rgyas dang / chos dang / dge 'dun la dad pa mi phyed pa dang ldan pa dang / rdzu 'phrul dang ldan pa dang / tshe dang / kha dog dang / gzi brjid dang / mthu stobs dang ldan zhing rnam pa thams cad kyi mchog dang ldan par gyur te /	66.44886263005772
na ca kadAcid priya viprayogam na priya vyasanam saMvRttam	nam yang sdug pa dang bral bar ma gyur cing / sdug pa'i sdug bsngal med par gyur pa de dran te / rigs kyi bu /	72.57332272772868
evam kula putra bahu guNa sasanva AgatAH te kula putrAH vA kula duhitaraH ca Bavizyanti	de ltar na / rigs kyi bu'am / rigs kyi bu mo dag chos smra ba de la mchog tu gus pa'i sems bskyed de /	75.3904520406919
yadA sadDarma paryAyam paMca maNxalena praNipatya puzpa DUpa ganDa mAlya vilepana= Catra Dvaja patAkEH	chos kyi rnam grangs 'di la yan lag lngas phyag byas shing / me tog dang / bdug spos dang / me tog phreng dang / @421a *// byug pa dang / gdugs dang / rgyal mtshan dang / ba dan dag gis legs par brgyan nas sangs rgyas la phyag 'tshal lo // zhes brjod cing phyag 'tshal bar byed pa dang / lags so //	76.99596044141286
samalaMkRtya namaH budDAya iti kRtvA namaskarizyanti sADu kAram dAsyanti DArayizyanti vAcayizyanti vAcApayizyanti liKizyanti liKApayizyanti parama gOravam cittam utpAdya	zhes bya ba sbyin par byed pa dang / 'dzin pa dang / 'chang ba dang / klog pa dang / yi ger 'brir 'jug pa de dag ni yon tan mang po dang ldan par 'gyur ro //	70.16271052128289
tasya Darma BANakasya antike te dRzwaH eva Darme sarva sa guNa samanvAgatAH Bavizyanti	de dag ni tshe 'di nyid la'ang yon tan mang po dang ldan par 'gyur te /	72.53077476371736
aBirUpAH prAsAdikAH darSanIyAH vigata vyADayaH dIrGa AyuzkAH sTira budDayaH smRtimantaH DRtimantaH sarva rAjAnAm sarva rAjQInAm rAja putra amAtyAnAm sarva SatrUNAm sarva sattvAnAm ca aBinandanIyAH Bavizyanti vandanIyAH satkaraNIyAH	gzugs bzang zhing mdzes la blta na sdug pa dang / nad rnams dang bral ba dang / tshe ring ba dang / blo brtan pa dang / dran pa dang ldan pa dang / brtan pa dang ldan pa dang / rgyal po thams cad dang / rgyal po'i btsun mo thams cad dang / rgyal bu thams cad dang / blon po thams cad dang / dgra thams cad dang / sems can gyis mngon par bstod par 'os pa dang / phyag bya bar 'os pa dang / bsnyen bkur bya bar 'os par 'gyur ro //	80.61312162651247
praBUta vitta upakaraNAH Bavizyanti	nor dang yo byad mang por yang 'gyur ro //	75.84640161196391
candana ganDaH ca asya muKAt pravAsyati	de dag gi kha nas tsandan gyi dri'i ngad 'byung bar yang 'gyur ro //	84.85718738112679
nIlotpala sadRSa netraH Bavizyati	mig autpa la sngon po'i 'dab ma 'dra bar yang 'gyur ro //	75.76937404431796
rAtrindivam ca asya budDa boDisattva darSanam Bavizyati	de dag gis nyin mtshan du sangs rgyas dang byang chub sems dpa' dag mthong bar yang 'gyur ro //	82.45290485523965
sarva AvaraNam ca asya kzayam ca asyanti paMcAnantarya praBRtayaH kRtvA devatA SAsya dutt	mtshams med pa la sogs pa'i sgrib pa thams cad zad par yang 'gyur ro // de dag la lha rnams srung bar yang @421b 'gyur ro //	82.08048321849162
rakzizyanti maraNa kAle ca asya budDa darSanam boDisattva darSana Bavizyati	de dag 'chi ba'i dus na sangs rgyas dang byang chub sems dpa' dag mthong bar yang 'gyur ro //	84.11422715877634
na IrzyAlukaH na vikzepa cittam kAlam karizyati	phrag dog med pa dang / sems rnam par g-yeng ba med par 'chi ba'i dus byed par yang 'gyur ro //	78.01039325640754
yAvat cyutaH suKAvatyAm lokaDAtO= upapadyate vyAkRtAH te mayA kula putra saMmuKa vyAkaraNena	shi 'phos nas kyang 'jig rten gyi khams bde ba can du skye ba'i bar du 'gyur ro // rigs kyi bu /	78.70929049896039
dRzwaH ham tEH satkRtaH mAnitaH na tEH saMSayam utpAdayitavyam boDO ye imam Darma paryAyam DArayizyanti satkRtya liKizyanti liKApayizyanti vAcayizyanti pUjayizyanti udgrahIzyanti nAmaDeyam ca	gang dag chos kyi rnam grangs 'di 'dzin pa dang / bsnyen bkur byas te yi ger 'bri ba dang / yi ger 'brir 'jug pa dang / klog pa dang / mchod par byed pa dang / 'chang ba dang / ming tsam thos par 'gyur ba de dag ni ngas mngon sum du lung bstan pas lung bstan pa yin te / de dag gis nga mthong zhing bsnyen bkur byas / ri mor byas / mchod pa byas pa'ang yin pas / de dag gis ni sangs rgyas kyi byang chub la the tshom bskyed par mi bya'o //	71.75917795525956
Srozyanti  boDisattvaH iti sa manasi kRtvA satkartavyaH	gang dag gi rna lam du grag par gyur pa de dag kyang byang chub sems dpa' yin par yid la byas la bsnyen bkur bya'o //	64.06868887268989
yena asya pUva karma vipAkena asya rUpa vEkalyam Boga vEkalyam budDi vEkalyam pariBAzyam ca priya viprayogam ca rAjya kzoBam ca te asya samADeH anuBAvena SravaNena kecid SIrza rogeNa kecid Bakta= Cedena kecid kucela aBiDAraNena kecid kAya citta pIxena kecid duHKa saMsparSa SayyA kalpanena	de'i sngon gyi las kyi rnam par smin pas gzugs mi mdzes pa dang / longs spyod med pa dang / blo med pa dang / sred pa che ba dang / sdug pa dang bral ba dang / rgyal srid 'khrugs par gyur pa gang yin pa de dag dang / klad pa na ba gang yin pa dang / zan chad pa gang yin pa dang / gos ngan par gyur pa gang yin pa dang / lus dang sems la gnod pa gang yin pa dang / reg na mi bde ba'i mal bcas @422a *//	65.78368325199283
kecid pariBAzyeNa sarvam tat karma AvaraNam kzayam yAsyanti	pa gang yin pa dang / spyo ba gang yin pa'i las kyi sgrib pa de dag thams cad kyang ting nge 'dzin 'di thos pa'i mthus yongs su zad par 'gyur ro //	75.8182989466101
tena cavam cittam utpAdayitavyam pUrvam mayA saMsAre saMsaradBiH pApam akuSalam sattvezu nAnA prakAram upacitam tam pratideSayAmi ApraticCAdayAmi	des kyang 'di ltar sems bskyed par bya ste / bdag gis sngon 'khor ba na 'khor ba'i tshe sems can rnams la sdig pa me dge ba rnam pa sna tshogs bsags pa de dag so sor bshags par bya'o // bsal bar bya'o //	82.84844445024065
budDe Darme saMGe aBedya prasAda cittam utpAdayitavyam	mi bcab par bya'o // sangs rgyas dang / chos dang / dge 'dun la dad pa mi phyed pa dang ldan pa'i sems bskyed par bya ste /	77.83273012092098
yeca tasya kula putrasya kulu duhituH vA Ceda Boga Palam saMvartanIyam dutt	rigs kyi bu'am rigs kyi bu mo de'i longs spyod kyi 'bras bu med par 'gyur ba'i las kyi sgrib pa dang /	83.05689587722799
karma AvaraNam Bavizyati budDe vA Darme vA saMGe vA SrAvaka pratyekabudDe vA mAtA pitRBiH vA pApa karma kRtam upacittam Bavizyati tat sparikzayam yAsyati	sangs rgyas dang / chos dang / dge 'dun dang / nyan thos dang / rang sangs rgyas dag dang / pha ma dag la sdig pa'i las byas shing bsags par gyur pa gang yin pa de dag thams cad yongs su zad par 'gyur zhing dbang phyug chen po dag kyang yang dag par 'grub par 'gyur ro //	83.06231034305218
mahA ESvarya samRdDaH Bavizyati ye ca tasya kula putrasya ca kula duhituH vA duHKa nAraka vedanIyam karma AvaraNam Bavizyati priya viprayoga saMvartanIyam jAti anDa saMvartanIyam strI saMvartanIyam dvi vyaMjana saMvartanIyam	rigs kyi bu'am rigs kyi bu mo de'i sems can dmyal ba'i sdug bsngal myong bar 'gyur ba'i las kyi sgrib pa dang /	21.586164243704676
IrzyA mAna kroDa vaSena yama loka preta tiryagyoni saMvartanIyam tat sarvam parikzayam yAsyati	sdug pa dang bral bar 'gyur ba dang / dmus long du 'gyur ba dang / bud med kyi dngos por 'gyur ba dang / mtshan gnyis par 'gyur ba dang / phrag dog dang / nga rgyal dang / khro ba'i dbang gis gshin rje'i 'jig rten @422b dang / yi dvags dang / dud 'gro'i skye gnas su 'gyur ba gang yin pa de dag thams cad kyang yongs su zad par 'gyur te /	63.154721427618085
evam kula putra sarva guNa AkaraH yam samADeH	rigs kyi bu / de ltar na / ting nge 'dzin 'di ni yon tan thams cad kyi 'byung gnas yin no //	86.36003777597394
asti kula putra asya Darma paryAyasya cira sTiti karAH	rigs kyi bu /	32.70463672051063
tezAm ca kula putrANAm kula duhitRNAm rakzA AvaraNa guptAni sarvezAm guNAnAm sarva SAparipUra karANi mahA Boga ESvarya suKa karANi sarva cintita prArTita samRdDi karANi sarva karma kzayaMkarANi sarva akAla mRtyu duHsvapna sarva vyADi praSamana karANI sarva yudDa jayaMkarANi AyuH varNa bala vIrya sTAma karANi sarva yakza BUta manuzya vaSaMkarANi sarva jvara avizAdaka praSamana karANi	chos kyi rnam grangs 'di yun ring du gnas par byed pa dang / rigs kyi bu dang / rigs kyi bu mo de dag la srung ba dang / skyob pa dang / sbed bar byed pa dang / de dag thams cad kyi yon tan dang / re ba thams cad yongs su rdzogs par longs spyod pa dang / dbang phyug dang / bde ba chen por byed pa dang / bsam pa dang 'dod pa thams cad yang dag par 'grub par byed pa dang / las thams cad zad par byed pa dang / dus ma yin par 'chi ba dang / rmi lam ngan pa thams cad rab tu zhi bar byed pa dang / g-yul thams cad las rgyal bar byed pa dang / tshe dang / mdog dang / stobs dang / brtson 'grus dang / mthu che bar byed pa dang / gnod sbyin dang / 'byung po dang / mi dang / mi ma yin pa thams cad dbang du byed pa dang / rims dang / dug dang / me dang / chu thams cad rab tu zhi bar byed pa dang / lung bstan pa'i bar dag thob par byed pa'i gzungs kyi gsang sngags kyi gzhi dag yod de /	54.8507433066912
yAvat vyAkaraNa pratilaMBa karANi DAraNI mantra padAni yAni SrutvA DAritvA vAci tvA satkaritvA liKitvA liKapayitvA guptaye sa te kula putrAH vA kula duhitaraH ca sarvAn etAn guNAn pratilaBante	de dag mnyan cing bzung ste bsnyen bkur byed pa dang / klog pa dang / yi ger 'bri ba dang / yi ger 'brir 'jug pa'i rigs kyi bu dang / rigs kyi bu @423a *// mo dag ni yon tan de dag thams cad 'thob par 'gyur ro //	69.04800268355808
aTa tasmin samaye iyam mahA pRTivI zaz vikAram akaMpata sA ca yaTA samAgatA parzad taTAgatam puzpa DUpa ganDa mAlya duzya yugEH saMcCAdya sADukAram adAt	de nas de'i tshe sa chen po 'di rnam pa drug tu rab tu g-yos pa dang / ji ltar lhags pa'i 'khor de dag gis kyang de bzhin gshegs pa'i sku la me tog dang / bdug spos dang / spos dang / me tog phreng dang / phye ma dang / byug pa dang / ras bcos bu zung dag gsol te / legs so zhes bya ba gsol nas bcom ldan 'das / legs so //	84.87063868833297
sADu sADu Bagavan katamAni tAni mantra padAni	legs so // gzungs kyi gsang sngags kyi gzhi de dag gang lags / bcom ldan 'das kyis bka' stsal pa /	87.62994431450865
dutt  namaH sarva taTAgatAnAm tat yaTAbudDe su budDe SudDa mate	na ma: sarba ta th'a ga t'a n'am/ tadya th'a / buddhe / su buddhe / buddha ma te /	78.14050936542903
loke viloke loka atikrAnte	lo ka bi lo ke lo aa ti kr'ante / satva aa ba lo ke ni /	64.93868953841073
sattva avalokane sarva taTAgata aDizWAna aDizWite	sarba ta th'a ga ta aa dhish'a te / sarba aa sha pa ri p'u ra ni / dyu ti nadha re /	73.53646585637834
sarva SAparipUraNe dyutinDare narake ca pUjite taTAgata jQAna dade taTAgata aDizWAne ca	na ra de ba p'u dzi te ta th'a ga ta dzny'a na da de / ta th'a ga ta aa dhishsh'a ne na /	70.94895514525189
sarva lokaH suKI Bavatu pUrva karma kzapaya  mama	sarba lo ka ma su kh'a bha ba tu /	63.59958687950583
na Atseham mAra pati SukziNasya Ayazadika	b'urba ksharma ksha pa ya tu /	55.91555698712667
mahASrAdva upAsaka Suli vajrasya	raksha bha ba tu /	48.769478691948784
rakzA Bavatu sarva BayeByaH taTAgata aDizWAnena svAhA	sarba ye bhya ta th'a ga ta aa dhi sh'a ne na sv'ah'a /	80.78707928363636
imAni tAni kula putra ahaH mantra padAni triMSatyA taTAgata sahasrEH BAzitAni aDizWitAni	kye rigs kyi bu dag / gzungs kyi gsang sngags kyi gzhi 'di dag ni / de bzhin gshegs pa sum khris gsungs shing byin gyis brlabs pa yin no //	91.24350018283673
mayA api etarhi BAzitAni sarva sattvAnAm arTAya hitAya suKAya rakzA AvaraNa guptaye sarva vyADi praSamana karANi budDa kzetra upapattaye	ngas kyang da ltar sems can thams cad kyi don dang / phan pa dang / bde ba dang / srung ba dang / skyob pa dang / sba ba dang / nad thams cad rab tu zhi bar bya ba dang / sangs rgyas kyi @423b zhing du skye bar bya ba'i phyir bshad de / grogs po dag /	91.02102780117973
yaH kaScid parzaH evam jAnIyuH kaTam nu vayam sarvAn etAn taTAgata BAzitAn guNAn	gang la la zhig 'di snyam du bdag gis ji ltar na /	55.591969365079144
pratilaBeya tena kalyam eva utTAya sarva sattvAnAm dayA cittena karUNa acittena mEtra cittena IrzyA mAnamrakza kroDa parivarjitena ekAgra cittena budDasya udAratarAm pUjAm kRtvA daSa diSam sarva taTAgatAnAm namaskRtvA yaTAkAmam guNAn manasikRtya azwaSatam japya puzpam ekEkam taTAgate deyam	de bzhin gshegs pas gsungs pa'i yon tan de dag thams cad 'thob par 'gyur snyam du sems pa des nang par sngar langs te sems can thams cad la snying brtse ba'i sems dang / snying rje'i sems dang / byams pa'i sems dang / phrag dog dang / nga rgyal dang / 'chab pa dang / khro ba yongs su spangs pa'i sems dang / rtse gcig pa'i sems kyis sangs rgyas dang byang chub sems dpa' rnams la mchod pa shin tu rgya cher byas la phyogs bcu'i de bzhin gshegs pa thams cad la phyag byas te gang 'dod pa yid la byas nas me tog la bzlas brjod lan brgya rtsa brgyad bya zhing / de bzhin gshegs pa la re re nas dbul bar bya'o //	70.92153201694072
tatas tasya sarva ASAsam RdDiH Bavizyati	des na de'i re ba thams cad yang dag par 'grub par 'gyur ro //	69.89982054450667
svapne ca taTAgata darSanam Bavizyati	rmi lam na de bzhin gshegs pa mthong bar yang 'gyur ro //	79.45415142544529
yam varam icCati tam laBate	dam pa gang 'dod pa de thob par yang 'gyur ro //	69.5266809463501
maraNa kAle ca taTAgata darSanam Bavizyati	'chi ba'i tshe na de bzhin gshegs pa mthong bar yang 'gyur ro //	81.50615247572298
cyutvA suKAvatyAm ca lokaDAtO upapatsyate	shi 'phos kyang 'jig rten gyi khams bde ba can du skye bar 'gyur ro //	89.57321058181161
AyuH bala varNa viryasam anvAgataH	tshe dang / stobs dang / mdog dang / brtson 'grus dang ldan par yang 'gyur ro //	62.0810236224279
sarva SatravaH ca asya vaSa gAminaH Bavizyanti	dgra thams cad kyang de'i dbang du 'gyur ro //	80.98814702033997
dutt  asyAm Kalu punar DAraNyAm BAzyamANAyAm zazwInAm ca prANi sahasrANAm anutpattikezu Darmezu kzAnti pratilaMBaH BUt	gzungs 'di bshad pa na srog chags drug khri mi skye ba'i chos la bzod pa thob @424a *//	74.06019012599599
sarve ca sarva karmA varaNa vinirmuktAH sarva aBiprAya paripUrNAH saMvRttAH  ii	par gyur nas de dag thams cad las kyi sgrib pa thams cad las rnam par grol zhing bsam pa thams cad yongs su rdzogs par gyur to //	86.6090523961804
aTa Kalu vajrapANiH boDisattvaH daSa diSam vyavalokya Bagavantam etat avocat	de nas byang chub sems dpa' sems dpa' chen po lag na rdo rjes phyogs bcur rnam par bltas te bcom ldan 'das la 'di skad ces gsol to // bcom ldan 'das /	92.77364696351111
asti Bagavan aBayatejam nAma DAraNI boDisattvAnAm pratijQA yA mayA aBaya vyUha rAjasya taTAgatasya antikAt udgRhItA	byang chub sems dpa' rnams kyi dam 'cha' ba mi 'jigs pa'i gzi brjid ces bgyi ba'i gzungs mchis te / bdag gis de bzhin gshegs pa 'jigs med bkod pa gzi brjid rgyal po'i spyan sngar de bzung lags / so //	84.85261444414924
udgRhya sarva sattveByaH prakASitA	bzung nas kyang sems can thams cad la bshad lags so // bcom ldan 'das / deng slan chad bdag gis mngon 'tshal te /	59.842306538954546
tatas punar Bagavat na aBijAna aBi yasya svapne pi sA DAraNI karNa puwe nipatita antargatA	gang gi rna lam du gzungs de grags par gyur tam / glo bur chud par gyur pa de'i lus nyam nga ba'am / nyon mongs pa sna tshogs sam / bro nad dam /	76.61249587320633
tasya syAt SarIre dOrbalyam vA kleSaH vA vyADiH vA jvaraH vA kAya SUlam vA citta pIxA	rims sam / lus bro 'tshal ba'am / sems gdung ba'am / dus ma lags par 'grum pa'am / chab kyis 'jigs pa'am / mtshon gyis 'jigs pa'am / dug gis 'jigs pa'am /	84.40546937923939
vA akAla mRtyuH vA udakam vA Sastram vA vizam vA garam vA xAkinI vA BUtaH vA yakzaH	dug sbyar mas 'jigs pa'am / mkha' 'gro ma dang / 'byung po'i 'jigs pa'am / gnod sbyin nam / dgra rnams sam /	84.04521199110496
vA SatravaH vA manuzyAH vA amanuzyAH vA viheWam vA kartum hiMsAm vA viDAtum vA na idam sTAnam vidyate	mi dang / mi ma lags pa dag gis mtho 'tsham pa'am / rnam par gtse ba'am / gnod pa bgyid par 'gyur ba de ni @424b gnas ma mchis lags so //	79.56823879866639
tad anujAnAtu Bagavan yat aham boDisattva pratijQA mudrAm dAsyAmi	de'i slad du bcom ldan 'das kyis bdag la rjes su gnang ba stsol cig /	80.11725344028898
tezAm Darma BANakAnAm Darma SrAvaNikAnAm arTAya SrotLNAm mAnayitLNAm pUjayitLNAm DArayitLNAm vAcayitLNAm sarva ASA paripUra karANi	bdag gis chos smra ba dang / chos nyan pa de dag gi don du nyan pa rnams dang / ri mor bgyid pa rnams dang / mchod par bgyid pa rnams dang / 'dzin par bgyid pa rnams kyi re ba thams cad yongs su rdzogs par bgyid pa / byang chub sems dpa' rnams kyi dam bca' ba'i phyag rgya dag stsal bar bgyi'o //	75.41014739292257
namaH sarva budDAnAm	na ma: sarba ta th'a ga t'a n'am/	81.86058992328066
sarva boDisattvAnAm arhantAnAm	sarba be dhi satva n'am/ aa ri ha h'a na / tada th'a /	50.881556246015755
tat yaTA om vajraDara vajraDara vajrakAya vajra bala vajra teja	aom badzra dha ra / badzra k'a yam/ badzra ba la / badzra te dza /	88.25751579203765
hum hum	h'um h'um/	95.60593271255493
vajrapANe dutt	badzra p'a ni /	64.7326676050822
taTAgata AjQAm pAlaya	ta th'a ga ta a'a dzny'a pa l'a ya /	69.3289516766866
smara pratijQAm	sma ra pra ti dzny'am/	66.60700958425349
sarva vyADim sarva pApAni nASaya dehi me yaTA Ipsitam varam  mama	sarba bya dhi na sarba p'a pam n'a sha ya / de hi me / yi the ba si tam pha ra ma /	82.97791259049588
na Atseham mArapati SulkziNasya Ayaza Adika Suli vajrasya yam yam eva aBiyAcAma stam tam eva samRDyatu	yan ya me ba aa bhi pr'a yan tsa mi tanta me ba sa mram dhya tu /	56.91348455404581
he he	he he /	86.39973633629936
turu turu	tu ru tu ru / a'a gatstsha /	67.890666110175
AgacCa AgacCa	a'a gatstsa /	48.29452848434448
mA vilamba	ma bi lamba da ri sha ya /	61.05352984941923
darSaya vajra kAyam darSaya vajra kAyam	badzra k'a ya / da ri sha ya / badzra kr'a yam/	88.14401026989552
budDa aDizWAnena svAhA	buddha aa dhi shsh'a ne na sv'ah'a /	80.3714373641544
asyAm DAraNyAm BAzyamANAyAm iyam mahA pRTivI unmajja nimajjanam karotu	gzungs 'di brjod pa na sa chen po mtho ba dang dma' bar gyur to //	74.89712044799747
sarve ca yakza rAkzasAH saMBrAntAH sarve ca devAH yAvat manuzya amanuzyAH vismayam ApannAH sADu kAram pradadati	gnod sbyin dang srin po thams cad kyang rab tu dngangs so //	64.05194370007004
sADu sADu mahAsattvAH parama sidDAni imAni DAraNI mantra padAni BAzitAni	lha thams cad dang / mi dang / mi ma yin pa'i bar dag kyang ngo mtshar du gyur nas sems can chen po rab tu grub par byed pa'i gzungs kyi gsang sngags kyi gzhi 'di dag bshad pa ni legs so //	73.34765220910442
aTa vajrapANi boDisattvaH Bagavantam etat avocat	legs so zhes bya ba byin no // de nas bcom ldan 'das la byang chub sems dpa' sems dpa' chen po lag na rdo rjes 'di skad ces gsol to // @425a *//btsun pa bcom ldan 'das /	83.15772421852326
yaH kaScid Badanta Bagavan boDisattva BUmim aBiprArTayate Dana DAnya Boga ESvaryam	gang la la zhig byang chub sems dpa'i sa'am / nor dang / 'bru dang / longs spyod kyi dbang phyug gam / rgyal srid kyi dbang phyug gam; rig sngags 'chang ba nyid dam /	79.93951928337911
rAjyam vidyADara tvam AyuH bala vIrya dIrGa Ayuzka tvam tena Sukla azwamyAm Svetacandanam ayaH	tshe dang / stobs dang / mdog dang / brtson 'grus dang / tshe ring po nyid 'tshal ba des snga nas bsnyen par bgyis la dgung zla yar gyi ngo tshes brgyad la tsandan dkar po las rdo rje 'dzin pa rta gang du dgod cing rgyan thams cad kyis brgyan pa / snying gar sku gdung stsal pa /	65.29411362729256
vajraDaraH kAryaH awwahAsaH sarva alaMkAra viBUzitaH sa DAtuka hRdayam kartavyam sa DAtukam vajraDaram samASvAsakam vidyADaram DUpa dahyamAnam SucinA ahorAtra uzitena kAryam tatas zwamyAm pUrva secam dutt	sku gdung dang bcas pa'i rdo rje 'dzin pa /	10.0
kRtvA Suce sa taTA gata sTAne mahatA DUpa puzpa ganDa dIpEH pUjAm kRtvA triskRtvA azwaSatikaH jApaH dAtavyaH taTAgatasya pUjA kartavyA	rig sngags 'chang yang dag par dbugs 'byin par bgyid pa bgyis la / gtsang mas bdug spos kyis bdug cing gdugs mtshan gcig tu smyung ba bgyis la /	79.79104968447687
sarva taTAgatAnAm namaskRtya catvAri pUrNa kumBa anisTApya raktacandana mayam maNxalam kRtvA Sveta vastra aprAvRtena ekAgra mAnasena caturdiSe ca rasa ganDa madya pAyasa valim	de nas tshes brgyad nas tshes bco lnga'i bar du de bzhin gshegs pa'i sku gzugs bzhugs pa'i gnas gtsang mar tsandan dkar po'i dkyil 'khor bgyis la bum pa gang ba bzhi'ang gzhag par bgyi; phyogs bzhir yang ro dang ldan pa dang / dri dang ldan pa dang / skyems dang / 'o thug gi gtor ma dag stsal la rad pa dkar po bgos te sems rtse gcig tu bgyis nas dus gsum du bdug spos dang / me tog dang / spos dang / mar me dag gis mchod pa chen po bgyi zhing de bzhin gshegs pa'ang mchod pa bgyis te /	63.29731255880725
dattvA azwa Sata sumanaH puzpEH vajrapANiH AhartavyaH	de bzhin gshegs pa la phyag @425b bgyis nas sna ma'i me tog brgya rtsa brgyad la bzlas brjod brgya rtsa brgyad bzlas shing / re re nas lag na rdo rje la bsnun par bgyi'o //	75.73699339140161
yAvat paQcadaSI tatas mahA nirGozaH Bavizyati pRTivI kampaH ca raSmayaH niScarizyanti	des na sgra skad chen po 'byung bar 'gyur zhing / dog sa g-yo ba dang / 'od zer kyang 'byung bar 'gyur te /	83.78372368369396
tatas yaTA Ipsitam varam dAsyAmi	de nas dam pa ci 'tshal ba'ang stsal bar bgyi'o //	79.88591871261596
sarva karmANi sarva kAryANi japita mAtreNa samRdDizyanti	bzlas brjod bgyis pa tsam gyis las thams cad dang / dgos pa thams cad kyang yang dag par 'grub par 'gyur lags so //	84.90329679438835
vigata vyADayaH cirajIvI sarva pApa vivarjitaH Bavizyati guNa sahasram pratilapsyate	bro nad ma mchis pa dang / tshe ring pa dang / sdig pa thams cad bral bar 'gyur zhing yon tan stong yang 'byung bar 'gyur lags so //	83.67014843259733
maraNa kAle ca budDam paSyati	'gum pa'i tshe na'ang sangs rgyas bcom ldan 'das stong mthong bar 'gyur lags so //	66.17513114852028
aham ca darSanam dAsyAmi	bdag mthong bar yang stsal bar bgyi lags so //	88.50467234072478
aTa BagavAn sADukAram adAt	de nas bcom ldan 'das kyis lag na rdo rje la legs so zhes bya ba byin te /	75.4557299098453
sADu sADu vajrapANe anatikramaNIyA iyam mudrA	lag na rdo rje legs so // legs so // phyag rgya 'di ni lha dang bcas pa'i 'jig rten gyis 'da' bar bya ba ma yin te /	77.27277915922033
na atra kAMkzA na vimatiH na vicikitsA kartavyA sa devakena lokena  iii	'di la som nyi med pa dang / yid gnyis med pa dang / the tshom med par bya'o //	75.48679032540369
aTa maMju SrIH kumAra BUtaH Bagavantam etat avocat	de nas bcom ldan 'das la 'jam dpal gzhon nur gyur pas 'di skad ces gsol to // bcom ldan 'das /	91.53252689456421
kena arTena ayam Bagavan sarva taTAgata aDizWAna sattva avalokana budDakzetrasandarSana vyUhaH nAma samADiH ucyate	ci'i slad du ting nge 'dzin 'di de bzhin gshegs pa thams cad kyi byin gyi rlabs sems can la gzigs shing sangs rgyas kyi zhing gi bkod pa kun tu ston pa zhes bgyi /	88.35653474743876
BagavAn Aha sarva taTAgatAnAm aDizWAnam dutt	bcom ldan 'das kyis bka' stsal pa / de bzhin gshegs @426a *//	66.40338446284639
sarva boDisattvAnAm aDizWitaH ca sarva samADim sarva DAraNI muKAni pratilaBate sarva sattvAnAm citta cEtasika samiMjita prasAritAni prajAnAti devAnAm nAgAnAm manuzyANAm yakzANAm ganDarvANAm pretAnAm tiryagyoni gatAnAm yAma lOkikAnAm amI sattvAH puNya upagAH sukRta karAH budDprasAdam pratilaBante	pa thams cad kyi byin gyi rlabs dang / byang chub sems dpa' thams cad kyi byin gyi rlabs de las ting nge 'dzin thams cad dang / gzungs kyi sgo thams cad 'thob par 'gyur ba dang / lha rnams dang / klu rnams dang / mi rnams dang / gnod sbyin rnams dang / dri za rnams dang / yi dvags rnams dang / dud 'gro'i skye gnas su skyes pa rnams dang / gshin rje'i 'jig rten pa'i sems can thams cad kyi sems dang sems las byung ba lhag par g-yo ba dang bral bar g-yo ba dag rab tu shes shing sems can 'di dag ni bsod nams su nye bar 'gro ba ste / legs par spyod pa'i las byed la / sangs rgyas dang / chos dang / dge 'dun dag la dad pa 'thob par 'gyur pa'o //	65.53191304471943
amI naraka gAmi duzkRta gAmi pApa kAriNaH	'di dag ni sems can dmyal bar 'gro ba ste / nyes par spyod pa'i las byed pa /	66.13837151367478
tezAm sattvAnAm pApa dRzwi gatAnAm Darmam deSayati sarva pApeByaH nivArayati	sdig pa spyod par byed pa / shes nas sdig pa'i lta bar gyur pa'i sems can de dag la chos ston par byed cing /	87.34786350690905
budDa boDO pratizWApayati sarva aBiprAyam paripUrayati IrzyA mAna kroDa mAtsaryam vinodayati te ca sattvAH budDa Darma saMGezu prasAdam pratilaBya budDa kzetra izupapadyante na jAtu duHKam anuBavanti na dOrmanasyam	sdig pa thams cad las zlog bar byed pa dang / sangs rgyas kyi byang chub la 'god par byed pa dang / bsam pa thams cad yongs su rdzogs par byed pa dang / phrag dog dang / nga rgyal dang / khro ba dang / ser sna dag sel bar byed pa dang / sems can de dag kyang sangs rgyas dang / chos dang / dge 'dun @426b dag la dad pa rab tu thob nas sangs rgyas kyi zhing rnams su skye zhing nam du'ang sdug bsngal nyams su myong bar mi 'gyur la / yid mi bde bar mi 'gyur bas na /	76.38299777685955
tena ayam kula putra sarva taTAgata aDizWAna sattva avalokana budDakzetrasandarSana vyUhaH nAma samADiH ucyate	rigs kyi bu / de'i phyir ting nge 'dzin 'di ni de bzhin gshegs pa thams cad kyi byin gyi rlabs sems can la gzigs shing sangs rgyas kyi zhing gi bkod pa kun tu ston pa zhes bya ste /	93.46414573857922
yam SrutvA niyatO= EvarTika BUmim pratilaBante	'di thos pa'i sems can rnams ni phyir mi ldog par nges pa'i sa 'thob par 'gyur ro //	81.96750477862825
saAha  kena arTena Bagavan= tezAm kula putrANAm vyAkaraNam Bavati kiyat tezAm puNya skanDam Bavati kim duzkara caryA	gsol pa / bcom ldan 'das / ci'i slad du rigs kyi bu dang / rigs kyi bu mo de dag lung bstan par 'gyur lags /	68.07174413966835
duzkaram ca Bagavan arhat tvam prAk eva anuttarA samyaksaMboDiH	bcom ldan 'das / dgra bcom pa nyid kyang dka' ba lags te / bla na med pa yang dag par rdzogs pa'i byang chub lta ci smos kyang mi 'tshol lags na / de dag gi bsod nams kyi phung po dang / dka' ba spyod pa ji tsam zhig tu 'gyur lags /	74.16287489207788
BagavAn Aha	bcom ldan 'das kyis bka' stsal pa / rigs kyi bu /	91.16233241314791
yaH ca mayA kula putra praTama citta utpAdam upAdAya dAna SIla kzAnti vIrya DyAna prajQApAramitA paripUritAH yaH ca SiraH kara caraNa nayana uttamAMga priya putra BAryA duhitR dAsa dAsI parityAga kRtaH yaH ca asya Darma paryAyasya dutt	ngas dang po sems bskyed pa nas nye bar bzung ste sbyin pa'i pha rol tu phyin pa dang / tshul khrims kyi pha rol tu phyin pa dang / bzod pa'i pha rol tu phyin pa dang / brtson 'grus kyi pha rol tu phyin pa dang / bsam gtan gyi pha rol tu phyin pa dang / shes rab kyi pha rol tu phyin pa yongs su rdzogs par byas pa gang yin pa dang / mgo dang / lag pa dang / rkang pa dang / mig dang / lus dang / sdug pa'i bu dang / bu mo dang / @427a *// chung ma dang / bran dang / bran mo dag yongs su btang bar gyur pa gang yin pa'i bsod nams mngon par 'du bya ba dang / dge ba'i rtsa ba mngon par 'du bya ba snga ma 'di ni chos kyi rnam grangs 'di la mchod pa byed pa dang / bsnyen bkur byed pa dang / yi ger 'bri ba dang / yi ger 'brir 'jug pa dang / klog pa dang / 'dzin pa'i bsod nams mngon par 'du bya ba dang / gzhan dag la'ang yang dag par ston par byed pa'i bsod nams mngon par 'du bya ba gang yin pa dang /	10.0
pUjana satkaraNa liKana leKApanavAcana udgrahaNIyaH puNya aBisaMskAraH pareByaH saMprakASanIyaH puNya aBisaMskAraH tezAm ca Darma BANakAnAm pUjana satkaraNa puNya aBisaMskAraH tasya ayam pUrvimakaH puNya aBisaMskAraH SatatamAm api kalAm na upEti	chos smra ba de dag la'ang mchod pa byed pa dang / bsnyen bkur byed pa'i bsod nams mngon par 'du bya ba gang yin pa de'i brgya'i char yang nye bar mi 'gro'o // rigs kyi bu /	43.60779575543809
yaH ca mayA kula putra DarmaH BAzitaH parya avAptaH tam sarvam satkare gurukare mAnaye pUjaye satkRtya liKaye liKA paye	nges kun chub par byas shing bshad pa'i chos de dag thams cad la bsnyen bkur byed pa dang / bla mar byed pa dang / ri mor byed pa dang / mchod pa byed pa dang / bsnyen bkur byas te yi ger 'bri pa dang / yi ger 'brir 'jug pa gang yin pa de bas ni gang zhig chos kyi rnam grangs 'di yi ger 'bri ba dang /	71.91911961248364
yaH ca ayam Darma paryAyaH liKe vAcaye pUjaye saMprakASaye bahutaram itas puNya aBisaMskAram parigrahIzyati	yi ger 'brir 'jug pa dang / klog pa dang / mchod pa byed pa dang / yang dag par ston par byed pa dang / nyan par byed na / de las bsod nams mngon par 'du bya ba ches mang du yongs su sdud par 'gyur te / des na /	86.10256992443757
tatas taTAgataH vyAkaroti anuttarAyAm samyaksaMboDO tat kasya hetoH	de bzhin gshegs pas bla na med pa yang @427b dag par rdzogs pa'i byang chub tu lung ston to // de ci'i phyir zhe na /	88.11663523319389
evaMrUpasya duzkaram Darma paryAyasya SravaNa udgrahaNa DAraNa pUjana liKanam	chos kyi rnam grangs 'di nyan pa dang / 'dzin pa dang / 'chang ba dang / klog pa dang / mchod pa dang / yi ger 'bri ba dang / yi ger 'brir 'jug pa'i bsod nams ni / de ltar dka' ba yin pa'i phyir ro // rigs kyi bu /	69.23235783481347
te ca sattvAH pApa samAcArAH KAdya peya hAsya nAwyA aBiratAH aSuBe SuBa saMjQinaH kAma kroDa vyApAda bahulA asuKe suKa saMjQinaH prahAra akroSa tarjana tAxana aBiratAH na jQAsyanti na manasi karizyanti te tatas pApa karma nidAna ajQAnAH akalyANa mitra parigRhItAH jarA vyADi Soka mRtyu paripIxitAH maraNa kAle paritarpyante	sems can gang dag sdig pa kun tu spyod pa dang / bza' ba dang / btung ba dang / bro gar la mngon par dga' ba dang / mi sdug pa la sdug par 'du shes pa dang / 'dod pa dang / khro ba dang / gnod sems mang ba dang / mi bde ba la bde bar 'du shes pa dang / mtshon cha dang / spyo ba dang / bsdigs pa dang / rdeg pa la mngon par dga' ba dang / shes par mi 'gyur ba dang / yid la byed par mi 'gyur ba de dag ni sdig pa'i las kyi gzhi de dang / mi shes pa des mi dge ba'i bshes gnyen gyis yongs su zin cing rga ba dang / na ba dang / mya ngan dang / 'chi bas yongs su zin pas 'chi ba'i tshe na yongs su gdung bar 'gyur te /	77.35369117706834
SmaSAna sadRSa maMcAvalaMvyamAnam parasparam paSyanti na ca kuSala cittam utpAdayizyanti nABedya prasAdam	dmigs pa na so so nas dur khrod dang 'dra 'kho nar mthong zhing / dge ba'i sems bskyed par yang mi 'gyur la / dad pa mi phyed pa thob par yang mi 'gyur te /	73.00056899260736
te tatas cyavitvA punar api duHKAni pratyanuBavizyanti	de dag de nas shi 'phos nas kyang sdug bsngal dag nyams su myong bar 'gyur bas na /	85.62844965294751
na ayam kula putra akRta kuSala mUlEH taTAgata AdarSAvinaH dutt	lung bstan pa'i dge ba'i rtsa ba med pa dang / de bzhin gshegs pa ma mthong ba dang / lung bstan pa ma thob @428a *//	79.30277144822261
avyAkaraNa prAptEH Srotum mAnayitum pUjayitum udgrahItum na liKitum na liKApayitum na SradDaDAtum na ca tAn Darma BANakAn satkartpUjayitum api na Sakyate	pa dag gis ni chos kyi rnam grangs 'di mnyan pa dang / ri mor bya ba dang / mchod par bya ba dang / gzung ba dang / yi ger 'bri ba dang / yi ger 'brir gzhug pa dang / dad par yang mi nus la / chos smra ba de la'ang bsnyen bkur bya ba dang / bla mar bya ba dang / ri mor bya ba dang / mchod pa bya bar yang mi nus so //	80.48144759362127
taTAgata kRtyam kula putra tatra vizaye Bavizyati yatra ayam Darma paryAyaH pracarizyati	rigs kyi bu; gang du chos kyi rnam grangs 'di rab tu spyod par 'gyur ba'i yul der ni de bzhin gshegs pa'i mdzad pa 'byung bar 'gyur ro //	90.08936442636552
aTa sA yaTA samAgatA parzad sADukAram adAt	de nas ji ltar lhags pa'i 'khor de dag gis bcom ldan 'das la legs so zhes bya ba gsol to //	71.73948988227252
sADu sADu Bagavan	bcom ldan 'das / legs so / legs so // bcom ldan 'das /	87.92826327571163
vayam api Bagavan Darma BANakam Darma SrAvaNikam taTAgata kRtyena satkarizyAmaH gurUkarizyAmaH mAnayizyAmaH sarva suKa upaDAnam ca asya up	bdag cag gis kyang chos smra ba de dang / chos nyan pa de dag la de bzhin gshegs pa'i mdzad pas bsnyen bkur bgyi / bla mar bgyi / ri mor bgyi / mchod par bgyi zhing / bde ba'i yo byad thams cad kyang nye bar bsgrub par bgyi lags so //	89.89462460205525
ayam ca Darma paryAyam vEstarikIkarizyAmaH rakzizyAmaH yena ayam Darma paryAyaH ciraStitikaH Bavizyati	chos kyi rnam grangs 'di'ang rgyas par bgyi bsrung bar bgyi ste / des na chos kyi rnam grangs 'di yun ring du gnas par yang 'gyur lags so //	84.53409014296143
aTa BagavAn= tasyAm velAyAm yaTA samAgatAm parzadam avalokya evam AhuH	de nas de'i tshe bcom ldan 'das kyis ji ltar lhags pa'i 'khor rnams la rnam par gzigs te bka' stsal pa /	85.09381224089914
sADu sADu kula putra	kye rigs kyi bu dag / legs so //	91.51658987998962
aho evam api yuzmAkam karaNIyam	legs @428b so; ;khyed cag gis de bzhin du gyis shig /	82.68781841026163
kAya citta nirapekzEH BUtvA sarva upaplavana pariBavana pariBAzaNa tarjana prahAra akroSa laByamAnam api imam Darma paryAyaH SrAvayitavyaH livAcayitavyaH	gnod pa byed pa dang / brnyas pa dang / gshe ba dang / bsdigs pa dang / mtshon 'byin pa dang / rgya 'gal bar byed na'ang lus dang / srog la mi ta bar byas la chos kyi rnam grangs 'di mnyan par bya / yi ger 'bri bar bya / yi ger 'brir gzhug par bya / bklag par bya'o //	84.53561253219888
tam ca Darma BANakam Darma SrAvaNikam sarva suKa upaDAnena ca upasTAtavyaH	chos smra ba de la'ang bde ba'i yo byad thams cad kyis rim gror bya'o //	80.07677651085199
sa ca vizayaH sa ca dvIpaH sa ca nagaraH rakzitavyaH sarva Baya upadrava upasarga upAyAseByaH	yul phyogs de dang / gling de dang / grong khyer de dag kyang 'jigs pa dang / gnod pa dang / 'go ba'i nad dang / 'khrug pa dag las bsrung bar bya'o //	84.70901420547705
tasya ca kula putrasya kula duhituH vA satata samitam samanvAhartavyam	rigs kyi bu dang / rigs kyi bu mo de dag la'ang rtag par rgyun du bsam par bya'o //	76.95004651401152
aTa BagavAn= tasyAm velAyAm imAH gATAH aBAzata SRNuta kula putra apramattA mA paSca kAle parittApyu BezyaTa	de nas de'i tshe bcom ldan 'das kyis tshigs su bcad pa 'di dag bka' stsal to //	67.90842917952592
budDasya utpAdyu kadAci laByate kalpAna kowIBi SatEH sahasrEH	bskal pa grangs med stong phrag bye snyed du // sangs rgyas 'byung ba lan 'ga' rnyed pa la // phyi ma'i dus na 'gyod par mi 'gyur bar // rigs kyi bu rnams bag yod chos nyon cig /	80.53996089805773
guNAH ca SRNvatu aBiSraddaDeta na durlaBA tezu samADi Bezyati	yon tan nyan cing mngon par dad byed pa // de dag gis ni ting 'dzin rnyed mi dka'//	88.64757457702828
kalpAn a kowIn yaTa gaFgavAlikAH yaH dAnu dadyAH dvipada uttamezu	gang gis rkang gnyis gtso bo rnams la ni // bskal pa bye ba gangg'a'i bye snyed du // nor dang 'bru dang de bzhin gos dang rgyan //	90.61524674835078
Danam cA DAnyam taTa vastra BUzaNam ganDam ca mAlyam ca vilepanam ca	spos dang phreng ba byug pa phul ba bas //	65.98491774490708
yaH ca eva sutram aBiSraddaDitvA SruNeya vAceya liKApayeta	gang gis mdo sde 'di la dad byas te // nyan cing klog la yi ger 'bri byed pa //	86.07498093798114
na tasya puNyasya pramANu vidyate tA ca apramANam sugatena deSitam	de la bsod nams tshad ni yod min te // bde bar @429a *// gshegs pas de snyed tshad ma gsungs //	88.49032202889732
raNyam ca seveta sadA apramattaH DyAnam ca DyAyetu sadA anya cittaH	rtag tu bag yod dgon par rten byed cing //	73.80661317829639
dAnam ca dadyA priya putra DItarAH hastO ca pAdO ca parityajeta dutt	sems gzhan med par bsam gtan dag sgom dang // sdug pa'i bu dang bu mo sbyin byed cing // lag pa rkang pa yongs su gtong ba bas //	81.45998260612282
yaTA eva sUtrasya DarA iti kaSci ayam tatas puNya viSezyu prApnuyA	gang su mdo sde 'di ni 'dzin byed pa // de ni de bas bsod nams mang po 'thob // mdo mchog 'di ni nor sbyin byed pa ste // de yi ngan song kun kyang rtag tu spangs //	74.03179833650857
arTasya dAtA vara sUtram etat sarvasya apAyA sadA varjita asya	'di ni nor dang 'bru sbyin byed pa ste // gang zhig mdo sde rnam dag 'di 'dzin pa //	67.85694689636709
Danasya DAnyasya ca dAyakaH hi ayam guNAH ca sarve pi na tasya durlaBAH	de la yon tan kun kyang mi dkon zhing //	67.94780006935261
AyuH balam vIryu na tasya durlaBam DArA iti sUtram yaH imam viSudDam	de la tshe stobs brtson 'grus mod pa yin //	71.59271164462815
drakzyanti budDam amita ABu nAyakam mayA api sa vyAkRtu budDa boDO	'dren pa sangs rgyas 'od dpag med mthong zhing // ngas de sangs rgyas byang chub lung yang bstan //	91.27336602756878
na tasya pApam pi kadAci vidyate suKAvatIm drakzyati lokaDAtum	de la nam yang sdig pa yod min cing // bde ba can gyi 'jig rten khams kyang mthong //	88.09923928390221
yam ca api tasya sada karmu Bezyati sarvam kzayam yAsyati citta nIxe	de la rtag tu las gang 'byung 'gyur ba // sems gdung lus lan ba'ang de bzhin du //	75.01545284095134
kAyasya SUle taTa SIrza tApe na tasya jAtu vinipAtu Bezyati	klad pa na bas thams cad zad 'gyur zhing // de ni nam yang rnam par ltung mi 'gyur // des ni mthong ba'i chos la'ang yon tan kun //	81.95279969679954
sAMdRzwikAn= ca api guNAm sa lapsyate sarvam yaTA cintitu prArTitam ca	ji ltar bsam zhing 'dod pas 'thob par 'gyur //	67.46229573667709
tasma aBi teBi sada BikzuBikzuNI upAsaka upAsika rAjaBiH sadA	de ltar rtag tu dge slong pho mo dang // dge bsnyen rnams dang rgyal pos rtag tu ni //	82.86598968420601
guru gOravam kRtvA ca Darma BANake yaTA narendrasya taTAgatasya dutt	mi yi dbang po de bzhin gshegs pa ltar // chos smra ba la rjes su gus byas te //	80.77265858362881
idam ca sUtram sadaH DAritavyam satkAru nityam ca kartavya DArake	mdo sde 'di ni @429b rtag tu gzung bya zhing // 'dzin pa la yang rtag tu bsnyen bkur bya //	86.74297953709123
ganDEH ca mAlyEH ca vilepanEH ca satkAru kRtvA ca liKApayeta	spos dang phreng ba byug pa rnams kyis ni // bsnyen bkur byas te yi ger 'brir yang gzhug /	86.67355673603497
mA paSca kAle jara vyADi pIxitAH aneka AyAsa sahasra vyAkulAH	phyi ma'i dus la rga nas gdungs gyur la // 'khrug pa stong phrag du mas g-yen spyo zhing //	86.87599753171827
narakezu tiryakzu pariBramANAH zaNXAH ca paNxAH ca jugupsanIyAH	sems dmyal yi dvags rnams su yongs 'khyams dang // za ma ma ning smad par bya ba dang // dmus long nyid dang ro dang khyi yi dri //	78.20140471612716
jAti anDa BUtAH kuNapAH ca ganDinaH saMjAsyate nIca kulezu strIzu	rigs dma' bud med rnams su skye bar byed // phrag dog che zhing rtag tu sdig byed la //	72.69184582297072
IrzyAlukasya sada pApa cAriNaH kroDa aBiBUtasya ca mad sarizya	khro bas zil non rtag tu ser sna can //	71.76264379838844
budDezu Darmezu karitva gOravam imezu jAtIzu upapadyate sO	sangs rgyas chos la gus par ma byas pas // de ni de 'dra'i rigs su skye 'gyur la //	80.96023034578312
tatra eva duHKAni ca veda mAnA mA paSca kAle paritApyu BezyaTa	der yang sdug bsngal tshor ba myong 'gyur zhing //	72.73820814636022
tasma aBi tehi sada pUjitasya yaH ca eva DAreta prakASayeta	de ni phyi ma'i dus la'ang gdung bar 'gyur // de phyir gang dag 'dzin cing ston byed pa; ;de dag gis ni rtag tu mchod par bya //	76.56059327029683
yaH ca eva pariBAzaNu tasya kurvate jugupsanAm tAxana banDanaQca	gang gis de la yongs su spyo ba dang // smad cing brdegs la bcing ba byas gyur pa //	79.01620837434248
dutt mama eva tena pariBAzaNA kRtA mama eva satkAru karitva DArake	de ni nga yang yongs su spyos pa yin // 'dzin la phu dud byas na nga la'ang byas //	77.53165167294979
tasmAt ca tEH hi sada Darma BANake yaH ca eva DAreta liKeta vAcaye	de phyir de dag gis ni chos smra dang // gang zhig 'di 'dzin 'bri zhing klog byed pa //	83.62756396239133
satkAru tEH ca sat anityu kuryA srigDAH ca vAcaH maDurAH BaNeta  iv	de dag la ni rtag tu bsnyen bkur zhing //	65.32345639346686
Arya avalokita ISvaraH boDisattvaH BagavataH caraNayoH nipatya Bagavantam etat avocat	tshig 'jam snyan pa rgyun du brjod par bya; ;de nas byang chub sems dpa' sems dpa' chen po 'phags pa spyan ras gzigs dbang phyug gis bcom ldan 'das kyi zhabs gnyis la gtugs te bcom ldan @430a *// 'das la 'di skad ces gsol to // bcom ldan 'das /	80.903709967941
anusmarAmi aham Bagavan asti vyavalokanaprAtihAryA nAma DAraNI yA mayA pUrvam jQAna ketu praBA karasya taTAgatasya antikAt udgRhItA Sr	bdag gis rnam par lta ba'i cho 'phrul zhes bgyi ba'i gzungs mchis par rjes su dran te / bdag gis sngon de bzhin gshegs pa 'od mdzad ye shes tog ces bgyi ba'i spyan sngar de thos shing bzung lags so //	87.51000781121873
yAm SrutvA matvA udgRhya DArayitvA vAcayitvA sat karitvA liKitvA liKApayitvA avEvartika BUmim pratilaBante	de nyan cing bzung la bcangs shing bklags te gzhan dag la'ang bsgrags shing bsnyen bkur bgyis nas yi ger bris sam / yi ger 'brir stsal na / phyir mi ldog pa'i sa 'thob par 'gyur zhing /	89.20734188432833
sarvAn etAn= taTAgata BAzitAn guNAn pratilaBante	de bzhin gshegs pas gsungs pa'i yon tan de dag thams cad kyang 'thob par 'gyur /	84.05135869979858
sarvam ca asya yaTA aBiprAyAm samRDyate	des ji ltar bsam pa thams cad yang dag par 'grub par 'gyur /	67.32751083374023
sarva karma AvaraNam ca asya kzayam gacCati	de'i las kyi sgrib pa thams cad kyang byang bar 'gyur /	81.6542369669134
samADim ca pratilaBate	ting nge 'dzin kyang 'thob par 'gyur /	88.70650258817172
vigatAH vyADayaH Bavanti	bro nad rnams dang bral bar yang 'gyur /	73.13700318336487
budDa darSanam boDisattva darSanam Bavati tat BagavAn sADukAram adAt	sangs rgyas mthong ba dang / byang chub sems dpa' yang mthong bar 'gyur lags so // de nas bcom ldan 'das kyis byang chub sems dpa' sems dpa' chen po 'phags pa spyan ras gzigs dbang phyug la legs so //	69.04745282324375
sADu sADu kula putra pravartaya aDizWitam taTAgatena	zhes bya ba byin te; rigs kyi bu / legs so // legs so // rigs kyi bu / khyod la de bzhin gshegs pas byin gyis brlabs zin gyi shod cig /	86.91792294736752
aTa Arya avalokita ISvaraH boDisattvaH daSa diSam sarva taTAgateByaH namaskRtyaH imAni mantra padAni BAzate sma dutt	de nas byang chub sems dpa' @430b sems dpa' chen po 'phags pa spyan ras gzigs dbang phyug gis phyogs bcu'i de bzhin gshegs pa thams cad la phyag byas te gsang sngags kyi gzhi 'di dag smras so //	92.0584285805594
namaH sarva taTAgatAnAm sarva ASAparipUra karANAm namaH Arya avalokita ISvarasya boDisattvasya mahA kAruNikasya  tat yaTA	na ma: sarba ta th'a ga t'a n'am/ sarba a'a sh'a pa ri p'u ra k'a n'am/ na ma a'arya ba lo ki te shva r'a ya / bo dhi satv'a ya / ma h'a satv'a ya / ma h'a k'a ru ni k'a ya / tadya th'a /	80.34291143841419
ha ha ha ha  mama mama	ha ha ha / ma ma ma /	68.09070024036225
Diri Diri	dhi ri dhi ri dhi ri / sh'ante / pra sh'ante /	59.898900498514585
SAnte praSAnte sarva pApa kzayaMkare	sarba p'a pa ksha yam ka ri / aa ba lo k'a ya / k'a ru ci ka // bo dhi tsitta ma ma na si ku ru /	62.75158770513309
avalokaya kAruNika boDi cittam manasi kuru vyavalokaya mAm smara smara yat tvayA pUrvam satya aDizWAnam kRtam	bya ba lo k'a ya / m'a ma / sma ra sma ra / yanta y'a b'urba / sad tya aa dhishtha nam kri tam/ te na san tye na pa tsa ne na /	64.2510010784062
tena satyena sarva ASAm me paripUraya	sarba a'a sh'a me pa ri p'u ra ya /	72.28581639698574
budDa kzetram pariSoDaya	buddha kshe ta ma pa ri sho dha y'a /	69.38831872553439
mA me kaScid viheWam karotu	ma me kashtsi de ba he tham ka ro tu /	60.24829514403092
budDa aDizWAnena svAhA  tat yaTA	buddha aa dhishth'a ne na sv'ah'a / tadya th'a /	73.24206765492757
teje teje mahA teje yat mama kAya duScaritam vAc duScaritam manaH duScaritam dAridrayam vA tat me kzapaya	te dze te dze / ma h'a te dze / ya na ma ma k'a ya du shtsa ri ta ma b'a / w'ag du shtsa ri ta ma b'a / ma no du shtsa ri ta ma b'a / d'a r'i drya ma b'a / tad sarba daksh'a p'a ya /	58.44270217323084
Alokaya vilokaya taTAgata darSanam ca aham aBikAMkzAmi boDisattva darSanam	aa lo k'a ya / bi lo k'a ya / ta th'a ga ta da ri sha nan tsa / aa ha ma dhi ka daksha mi bo dhi sa tya da ri sha na ma / dha dhu ma /	69.92163848374973
DuDupa dadasva me darSanam	dad sa sva me da ri sha na ma /	63.30030928888628
sarve me kuSalAH aBivarDantu	sarba me ku sha l'a aa bhi bardhantu /	65.11598255759792
namaH sarva taTAgatAnAm	na ma: sarba ta th'a ga t'a nan /	76.01510193853667
namaH avalokita ISvarasya	na ma a'arya ba lo ki te shva ra ya / bo dhi satv'a ya /	72.16117320741927
smara pratijQAH mahAsattvAH	sma ra pra ti dzny'a ma ma satva /	63.11887878530166
siDyantu mantra padAH svAhA	siddhyintu mantra pa de sv'ah'a /	81.49375707452947
asyAm DAraNyAm BAzyamANAyAm mahA pRTivI kaMpaH BUt mahA kilakilA SabdaH divyam ca puzpa varzam aBipravarzan sarvaH sa parzad sADukAra smadAt	gzungs 'di brjod pa na sa chen po 'di rab tu g-yos shing gzha'i sgra chen po dang / lha'i me tog gi char dag kyang mngon par rab tu bab par gyur to // @431a *// thams cad dang ldan pa'i 'khor des legs so zhes bya ba byin te / rigs kyi bu /	88.81200121964508
sADu sADu suBAzitam idam mahAsattvena sarva sattvAnAm trANa arTam sarva ASAparipUra karam	legs so // legs so // sems can chen po khyod sems can thams cad bskyab pa'i phyir re ba thams cad yongs su rdzogs par byed pa /	86.60368391755196
rakza sarva BayeByaH sarva karma kzayaMkara maraNa duHsvapna kAntAra praSamana	'jigs pa thams cad las srung bar byed pa / las thams cad phyang bar phyed pa / sdang ba dang rmi lam ngan pa'i gnod pa thams cad rab tu zhi bar byed pa'i gzugs 'di legs par smras so //	82.36434110972979
vayam api sarve BUtvA DArayizyAmaH satkarizyAmaH	bdag cag thams cad kyis kyang gzung bar bya / bsnyen bkur bya'o //	85.34355457542486
avalokita ISvaraH Aha yaH kaScid kula putraH imAn guNa an aBikAMkzate	spyan ras gzigs dbang phyug gis smras pa / rigs kyi bu dag /	68.71426069892188
yaTA taTAgatena parikirtitam vyAkaraNam mama kAMkzate mama api sammuKa darSanam samADi lamBam budDa boDisattva darSanam dutt Boga ESvarya lamBam budDa kzetra upapattim tena Sukla pakze SucinA su snAta gAtreNa BUtvA	gang la la ji ltar de bzhin gshegs pas yongs su bsgrags pa'i yon tan de dag mngon par 'dod cing lung bstan pa dang / kho bo'ang mngon sum du mthong ba dang / ting nge 'dzin 'thob pa dang / sangs rgyas dang byang chub sems dpa' mthong ba dang / longs spyod dang dbang phyug 'thob pa dang / sangs rgyas kyi zhing du skye bar 'dod pa des zla ba yar gyi ngo la lus legs par khrus byas shing gtsang la bsnyen te gnas pa 'phags pa yan lag brgyad pa la gnas par byas la tshes brgyad nas brtsams te /	67.61781134008112
Arya azwa aMga upavAsa upavasitEH azwamyAm AraBya SucO pradeSe budDa aDizWite ganDa puzpEH Dvaja patAkEH pUrNa kumBEH aByarcya sa pRTivI pradeSaH sa ca Darma BANakaH SuciH su snAta gAtraH Sveta vastra prAvRtaH nAnA puzpa mAlya ganDEH aByarcya liKApayitavyaH sarva sattva asADAraNAni	de bzhin gshegs pas byin gyis brlabs pa'i phyogs su spos dang / me tog dang / rgyal mtshan dang / ba dan dag dang / bum pa gang ba @431b dag gis phyogs de dang / chos smra ba de'ang mchod pa byas nas lus legs par khrus byas pa gtsang mas gos dkar po bgos te me tog dang / bdug spos dang / spos dang / me tog phreng dang / byug pa sna tshogs dag gis mchod nas yi ger bri bar bya'o // 'bri ba'i tshe na nyin gcig bzhin du dge ba'i rtsa ba rnams sems can thams cad dang thun mong du byas la /	89.69075134324365
kuSala mUlAni kRtvA sarva sattva mEtra cittena dayA cittena karuNA cittena taTAgata guru gOravam cittam upasTApya tena dine dine liKatA tAva liKe yAvat arDa divasam	de bzhin gshegs pa la bla ma dang / gus pa'i sems nye bar bzhag nas sems can thams cad la byams pa'i sems dang / snying brtse ba'i sems dang / snying rje'i sems kyis nyi ma phyed tshun chad kyi bar de tsam du bri bar bya'o //	84.17515978049308
azwamyAm AraBya yAvat paQcadaSIm dine dine sA eva pUjA kartavyA	tshes brgyad nas brtsams te tshes bco lnga'i bar du nyin gcig bzhin du mchod pa'ang de bzhin bya'o //	85.78581264769836
tatas nena eva viDinA liKita mAtreNa paQca AnantaryANi karmANi sarva pApAni ca asya kzayam yAsyanti kuSalEH DarmEH vivarDizyate	cho ga 'di kho na bzhin du byas te bris na / de ma thag tu mtshams med pa lnga la sogs pa las kyi sgrib pa thams cad dang / sdig pa thams cad byang bar 'gyur zhing dge ba'i rtsa ba rnams kyang 'phel bar 'gyur /	92.27457862599385
uttapta vIryaH Bavizyati	brtson 'grus 'bar bar 'gyur ro //	77.80834315039895
sarva Darmezu kAya suKam anuprApsyati	tshe de nyid la'ang lus bde pa 'thob par 'gyur /	67.54762665430705
tanU Bavizyanti rAga dveza moha mAna kroDAH	'dod chags dang / zhe sdang dang / gti mug dang / nga rgyal dang / khro ba dang / phrag dog dang / ser sna dag srab mor 'gyur ro //	81.15486529534644
tena liKApayitvA pUrva muKIm sa DAtukAm taTAgata pratimAm avalokita ISvara pratimAm ca sa DAtukAm sTApya sa DAtukeE ca etAyatane puzpa DUpaudAratarA pUjA kartavyA	des yi ger 'brir bcug nas kyang sku gdung dang bcas pa'i mchod rten gyi gnas su de bzhin @432a *// gshegs pa'i sku gzugs sku gdung dang bcas pa dang / spyan ras gzigs dbang phyug gi gzugs sku gdung dang bcas pa zhal shar phyogs su bstan te bzhag la / me tog dang / bdug spos dang / spos dang / mar me dag gis mchod pa shin tu rgya cher byas la /	72.27483271810196
azwamyAm AraBya yAvat paQcadaSIm sarva sattva mahA karuNA cittena Bavitavyam	tshes brgyad nas brtsams te tshes bco lnga'i bar du sems can thams cad la snying rje chen po'i sems bskyed par bya zhing /	86.75390491153291
Suci Sukla BojinA Arya azwa aMga upavAsa upavasitena suhRd sahAyakena mAna kroDa mAtsarya parivarjitena dine dine udAratarAm pUjAm kRtvA trisazwaSatikaH dAtavyaH	gtsang ma kha zas dkar po za ba / bsnyen te gnas pa 'phags pa yan lag brgyad pa la gnas pa grogs po yid gcugs pa dang ldan pa / nga rgyal dang / khro ba dang / phrag dog dang / ser sna yongs su spangs pas nyin gcig bzhin du mchod pa rgya chen po byas te dus gsum du bzlas brjod lan brgya rtsa brgyad rtsa brgyad bya'o //	81.79005719503817
dIpa DUpa puzpa ganDa Adi dattvA sumanaH puzpa azwaSatEH ca Arya avalokita ISvara pratimA tri sanDyam AhartavyA	me tog dang / bdug spos dang / spos dang / mar me dag kyang phul la / dus gsum du sna ma'i me tog brgya rtsa brgyad rtsa brgyad 'phags pa spyan ras gzigs dbang phyug gi gzugs la gtor bar bya'o //	87.01476175198033
dutt  vajrapANeH ca DUpaH dAtavyaH	lag na rdo rje la'ang bdug spos kyis bdug par bya'o //	78.2486541889332
daSa diSam aBinamaskRtya paScimena BImAyAH devyAH pUrveNa anopamAyAH UrDvena SaMKinyAH baliH nAnA rasa pAyasa daDyodanaH caturdiSam kzepta	phyogs bcur phyag byas la nub phyogs kyi lha mo 'jigs byed ma dang / shar phyogs kyi dpe med ma dang / steng gi phyogs kyi dung can ma la sogs pa la phyogs bzhir gtor ma ro sna @432b tshogs dang ldan pa dang / 'o thug dang / zho dang / 'bras chan dag kyang gtor bar bya'o //	83.63621696713307
tatas tasya na kaScid vikzepam karizyati saMtrAsaH pi na utpadyate na anyaTAtvam cittasya	des na de la rnam par g-yeng ba dang / 'jigs pa 'ga' yang 'byung bar mi 'gyur zhing sems 'khrul bar mi 'gyur ro //	79.87692320488962
sarvezAm ca azwaSatikaH jApaH azwa Sata sumanaH puzpEH ca saMcodanam	sna ma'i me tog brgya rtsa brgyad po thams cad la bzlas brjod brgya rtsa brgyad byas la bskul bar bya'o //	75.6500956275253
anena eva viDinA pUrva secam kRtvA tatas pUrNa paQcadaSyAm catvAri pUrNa kuMBAni sTApya	cho ga 'di kho na bzhin du sngar bsnyen pa byas la de nas tshes bco lnga'i nang par sa phyogs der bum pa gang ba bzhi bzhag la bdug spos dang / tsandan dang / pog dkar po dang / ga bur dag kyang gzhag mar me kha bzhi /	77.30435838452917
DUpa candana kunduruka karpUram dattvA dIpa muKAni catvAri nAnA ganDa Dvaja pawa patAkA suvarNa rUpya BANxEH tam pRTivI pradeSam samalaMkRtya daDi maDu pAyasa daDi odanam anyAni ca yaTAlamBena	me tog dang / bdug spos dang / gdugs dang / rgyal mtshan dang / dar dang / ba dan sna tshogs dag dang / gser dngul gyi snod dag gis legs par brgyan la sbrang rtsi dang sbyar ba'i 'o thug dang / zho dang / 'bras chen dang / gzhan yang ci 'byor pa'i lha bshos dang / gtor ma dag kyang phyogs bzhir gzhag go /	88.9703540737989
balim catur diSe dattvA nivedya su manaH puzpa azwaka SatEH ekEkam japya caturdiSe kzeptavyam	sna ma'i me tog brgya rtsa brgyad la snga ma bzhin du bzlas brjod lan re byas la phyogs bzhir gtor ro //	82.36068464599182
pUrvavat tri azwa SatEH su manaH jAti puzpEH ekEkam japya Arya avalokita ISvara pratimA AhartavyA	de nas sna ma'i me tog brgya rtsa brgyad phrag gsum la bzlas brjod lan re byas la; re re nas 'phags pa spyan ras gzigs dbang phyug gi gzugs la bsnun par bya'o //	88.12684635944267
tatas sat pratimA kaMpizyati	de nas gzugs de 'gul bar 'gyur zhing sgra skad chen po'ang 'byung bar 'gyur /	57.61517921031911
mahA nirGozaH Bavizyati raSmayaH niScarizyanti	@433a *// 'od zer dag kyang 'byung bar 'gyur /	78.06170797348022
pRTivI kampaH Bavizyati	sa'ang g-yo bar 'gyur ro //	70.98235910027115
tatas sarva karmANi sarva kAryANi ca asya samRdDizyanti taTAgata darSanam boDisattva BUmi pratilamBaH sarva sattva vandanIyaH Bavizyati	de nas las thams cad dang / dgos pa thams cad kyang 'grub par 'gyur zhing de bzhin gshegs pa mthong ba dang / byang chub sems dpa'i sa thob par yang 'gyur / sems can thams cad kyis phyag bya ba'i 'os su'ang 'gyur /	91.10205251618706
Dana DAnya koSa kozWAgAra samRdDaH sarva vyADi parivarjitaH cira jIvi dutt Bavizyati	nor dang / 'bru dang / mdzod dang / bang ba rnams 'byor par yang 'gyur /	72.9894846605902
sarva SatravaH sarva rAja rAja putra amAtya darSana aBikAMkziNaH Bavizyanti priyaMkarAH sarva kleSa rAga dveza moha prahINAH	nad thams cad yongs su spangs pa dang / tshe ring bar yang 'gyur / dgra thams cad dang / rgyal po dang / rgyal bu dang / blon po rnams kyang de la lta 'dod cing gces spras byed par yang 'gyur / nyon mongs pa thams cad dang / 'dod chags dang / zhe sdang dang / gti mug spangs par 'gyur /	82.55460431032787
na ca jAtu priya viprayogaH Bavizyati	nam du'ang sdug pa dang mi 'bral bar 'gyur ro //	73.44289557139079
mahA dRXa bala vIrya saMpannaH tejavAn= tIkzNa indriyaH budDimAn sarva sattva dayA cittaH Darma jQaH yAvat cyavana kAle budDam Bagavantam AryA valpaSyati mEtra vihArI kAlam karoti	brtan pa dang / stobs dang / brtson 'grus chen po dang ldan pa dang / gzi brjid dang ldan pa dang / dbang po rno ba dang / blo dang ldan pa dang / sems can thams cad la snying brtse ba'i sems dang ldan pa dang / cho ga shes pa dang / 'chi ba'i tshe na sangs rgyas bcom ldan 'das rnams mthong ba dang / 'phags pa spyan ras gzigs dbang phyug kyang mthong ba dang / byams pa la gnas shing chos ston bzhin du 'chi ba'i dus byed pa'i bar du'ang 'gyur ro //	61.88278396471853
Darmam deSayamAnam yaTA Ipsitezu budDa kzetrezu mahA cakravarti kulezu yatra anusmRtim karoti tatra upapadyate	sangs rgyas kyi zhing ji lta bu @433b 'dod pa dag gam / 'khor los bsgyur ba'i rigs chen po'am /	65.23456798899578
anyAni ca anekAni guNa sahasrANi pratilapsyate	gang du rjes su dran par byed pa der skye ba dang / gzhan yang yon tan stong phrag du ma dag kyang 'thob par 'gyur ro // gsol pa / bcom ldan 'das / de ltar na / chos kyi rnam grangs 'di dang / gzungs kyi gsang sngags kyi gzhi 'di dag ni /	69.79367163366807
evam Bagavan bahu guNa karaH yam Darma paryAyaH	yon tan mang po'i 'byung gnas lags te / chos kyi rnam grangs 'di ni /	88.15057982589522
imAni te DAraNI mantra padAni na vinA taTAgata aDizWAnasya ayam Darma paryAyam Sakyam Srotum na DArayitum na pUjayitum na liKitum na lna SraddaDAtum sace darSanam Bave na Sravam Bavizyati	de bzhin gshegs pa'i byin gyi rlabs ma mchis par mnyan par yang rngo mi thogs la gzung bar yang rngo mi thogs / klog par yang rdo mi thogs / mchod par yang rngo mi thogs / yi ge bri bar yang rngo mi thogs / yi ger 'brir stsal bar yang rngo mi thogs /	74.2857885348446
sace SravaNam tad vikzipta cittaH Srozyati na SradDAsyati na satkarizyati	dad par yang rngo mi thogs lags so // gal te mthong bar gyur na'ang nyan par mi 'gyur la / gal te nyan par gyur na'ang de sems rnam par g-yengs pas nyan par 'gyur zhing dad par mi 'gyur / bsnyen bkur bgyid par mi 'gyur lags so //	75.81124818903675
sace satkare kleSa vyApAda cittaHsatkarizyati sace liKe liKApayeta vyAkzipta cittaH	gal te bsnyen bkur bgyid par 'gyur na'ang nyon mongs pa dang / gnod sems dang bcas pa'i sems kyis bsnyen bkur bgyid par 'gyur lags so // gal te yi ger 'bri'am / yi ger 'brir stsal bar gyur na'ang de gzhan dag yid la bgyid par 'gyur lags so //	73.68021343785348
tat kasya hetoH	de ci'i slad du zhe na /	97.06714129447937
taTA hi tasya pUrva pApa karma Pala hetu tvAt karma anuBavitavyam	'di ltar de'i sngon gyi las kyi 'bras bu lags pa'i slad du ste / de ni las de nyams su myong bar bgyid @434a *//	88.77994322873374
sa vicikitsA prAptaH Bavizyati	cing the tshom skye bar 'gyur lags so //	71.94118356704712
paMcAnantaryam karizyati	mtshams ma mchis pa lnga bgyid pas kyang lan gsum bsgrubs na /	69.14814507576727
triBiH sADanEH sarva ASAsam RdDiH Bavizyati	re ba thams cad yang dag par 'grub par 'gyur lags te /	66.84316077055755
na atra kAMkzA na vimatiH na vicikitsA utpAdayitavyA	de la nem nur ma mchis pa dang / yid gnyis ma mchis pa dang / the tshom mi bskyed par bgyi lags so //	83.52064815349935
aTa BagavAn avalokiteSvarAya boDisattvAya mahAsattvAya sADukAram adAt	de nas bcom ldan 'das kyis byang chub sems dpa' sems dpa' chen po 'phags pa spyan ras gzigs dbang phyug la legs so zhes bya ba byin te /	85.28030730104396
sADu sADu kula putra	rigs kyi bu / legs so // legs so //	95.99949179376874
taTAgata kRtya mayam Darma paryAyaH karizyati sarva sattvAnAm	chos kyi rnam grangs 'di ni sems can thams cad la de bzhin gshegs pa'i mdzad pa byed par 'gyur ro //	88.73370547598567
dutt  v aTa Kalu ana upamA mahA yakziNI yena BagavAn= tena upasamakrAmat	de nas gnod sbyin mo chen mo dpe med ma bcom ldan 'das ga la ba der song ste phyin nas bcom ldan 'das la me tog dang ro //	85.02179773404765
Bagavantam nAnA puzpa duzya yugEH AcCAdya BagavataH pAdayoH nipatya Bagavantam etat avocat	/ spos dang / bdug spos sna tshogs dang / ras bcos bu zung dag gis mchod par byas te bcom ldan 'das kyi zhabs gnyis la gtugs nas bcom ldan 'das la 'di skad ces gsol to // bcom ldan 'das /	86.15877463570466
evam smarAmi aham Bagavat mayA BagavataH kOSAmbyAm Gozilasya ArAme viharataH puratas pratijQA samudAhRtA sarva sattvAnAm arTAya	bdag gis 'di ltar bcom ldan 'das yul ko'u sha mbhi na dbyangs can gyi kun dga' ra ba na bzhugs pa'i spyan sngar sems can thams cad kyi don dang / sman pa dang / bde ba'i slad du dam bcas pa brjod par rjes su dran lags te /	87.73915724837146
aham api Bagavan sarva vidyADarANAm hRdayam jAnAmi	bcom ldan 'das / bdag @434b cag gis kyang rig sngags 'chang ba thams cad kyi snying po dag 'tshal lags so //	81.56993387173483
tat me BagavAn anujAnAtu bahu jana hitAya bahu jana suKAya sarva ASA paripUraNa arTAya Bikzu BikzuNI upAsaka upAsikAnAm ca	de'i slad du bcom ldan 'das kyis skye bo mang po la sman pa dang / skye bo mang po la bde ba dang / re ba thams cad yongs su rdzogs par 'gyur ba dang / dge slong dang / dge slong ma dang / dge bsnyen dang / dge bsnyen ma rnams kyi don du bdag rjes su gzung du gsol /	87.0592768051275
namaH sarva taTAgatAnAm saMyyaTIt ha ha	na ma: sarba ta th'a ga t'a n'am/ sy'ada ya the dan /	72.75871100065842
hI hI	ha ha /	75.56060188157218
hu hu	hi hi / hu hu /	69.92877467473349
sara sara	sa ra sa ra /	78.07801598768968
lahum lahum	la h'um la h'um/	65.6914553642273
SIGram SIGram	sh'a ghr'im/	66.1189152399699
mahAvidye sarva vidyADara namaskRte hasaH hasaH	ma h'a bidy'a / sarba bidy'a dha ra na ma skri te / ha sa ha sa kim tishtha si /	75.94546115637155
kim tizWasi kim tizWasi	kim kim tishtha si / kan ka bi tsi tra /	55.46470260620118
kanaka vicitra ABaraNa viBUzita aMgi pawa pawa	aa ba ra na bi bh'u shi t'angge / pa ta pa ta /	44.250211502643346
Bara Bara	bha ra bha ra /	62.675678730010986
Biri Biri	bhi ri bhi ri /	61.16147041320801
BUru BUru	bhu ru bhu ru /	70.52885293960571
sarva arTam me sADaya	sarba aarthan me s'a dha ya /	86.17400593593203
turu turu	tu ru tu ru /	74.27178258162279
arTam sADaya	aarthan s'a dha ya /	73.52585792541504
arTam dehi me	aarthan de hi me / sarba satr'a n'am siddhim/	70.74895601802402
nAt saham mArapati SUlkziNasya	h'a h'a /	42.48529450098674
sarva saFGAnAH sidDim hA hA padme padme mahApadme	padme padme; ma h'a padme /	62.53673401585331
viSade viSade mahA viSade	bi sha de bi sha de / ma h'a bi sha de /	60.39831018447877
Bava Bava BavodBavAya tam aham Gore tam aham Gore dutt  tat me vidyAm prayojaya	bha ba bha ba / bha bo bha b'a ya / ta ma ham gho re / tan me bidya ma pra yo dza na ya /	70.93142643186904
sidDim kuru	siddhim ku ru /	62.987779299418136
sarvaSAm me paripUraya budDa aDizWAnena svAhA	sarba a'a sh'a me pa ri p'u ra ya / buddha aa dhishth'a ne na sv'ah'a; bcom ldan 'das /	84.26185165150687
yaH kaScid Bagavat guNa arTI Dana DAnya arTI sarva sattva vaSIkaraNa arTI Bave mahA ESvaryam rAja tvam vidyADara tvam aBikAMkzatemamA api saMmuKa darSanam tena azwamyAm Sukla pakze	gang la la yon tan 'tshal ba dang / nor dang 'bru 'tshal ba dang / sems can thams cad dbang du bgyid par 'tshal ba dang / nor gyi dbang phyug chen po dang / rgyal srid dang / rig sngags 'chang chen po nyid dang / bdag kyang mngon sum du mthong bar 'tshal ba des chos brgyad kyi gdugs la ras dkar po gsar pa kha tshar ma @435a *//	84.14724195121327
nave pawake acCinna daSe keSa apa gate SucinA citrakareNa Arya azwa aFga upavAsa upavasitena	bkum pa skra bsal ba la ri mo mkhan gtsang ma bsnyen te gnas pa /	65.07211090891165
aSlezEH aFgEH nava BAjana sTEH citrApayitavyam	'phags pa yan lag brgyad pa la gnas pas / tshon rtsi spyin dang ma 'bags pa snod gsar pa'i nang du stsal bas dbus su de bzhin gshegs ba'i sku gzugs chos ston pa'i tshul du bzhugs pa bri bar bgyi'o //	57.27427998667783
maDye taTAgata pratimAH Darmam deSayamAnAH dakziNena Arya vajra kroDaH vajram BrAmayamAnaH	g-yas phyogs su 'phags pa rdo rje khro bo rad pa dkar po 'tshal ba /	70.95718195310327
sarva alaFkAra viBUzitaH puzpa mAlya arDacandra hAraH Sveta vastra prAvRtaH vAma pArSve	rgyan thams cad dang / me tog phreng ba dang / zla gam dang / se mo dos brgyan pa rdo rje gsor zhing mchis pa bri bar bgyi'o //	86.95023999025638
anopamA SarakANxa gOrI sarva alaMkAra viBUzitA Sveta vastrA padma hastA samASvAsayaMtI	g-yon phyogs su ni gnod sbyin mo chen mo dpe med ma 'dam bu mda' rgyu'i mdog ltar dkar sham du mchis la / rad pa dkar po 'tshal ba / rgyan thams cad kyis brgyan pa / sug pa na padma thogs shing yang dag par dbugs 'byin pa'i tshul du mchis pa bri bar bgyi'o //	74.44740373666066
tatas SucinA vidyADareNa Arya azwa aFga upavasitena SucO sa DAtuke taTAgata sTAne kzIra yAvaka AhAreNa	de nas rig sngags 'chang gtsang ma bsnyen te gnas pa / 'phags pa yan lag brgyad pa la gnas pa / rad pa dkar po 'tshal ba / grogs dang ldan pa /	75.38344785506494
Sveta vastra prAvRtena Atma dvitIyena azwamyAm pUrva secam kRtvA nAnA puzpa ganDa DUpa dIpEH pUjAm kRtvA triskRtvA tri azwaSatikaH jApaH dAtavyaH	nas chan 'o ma dang sbyar ba 'tshal bas sngar bsnyen pa bgyi la / tshes brgyad kyi gdugs la de bzhin gshegs pa'i sku gdung dang bcas pa'i gnas gtsang mar dang por kho nar de bzhin gshegs pa dang / lag na rdo rje la me tog dang / bdug spos dang / spos dag gsol bar bgyi zhing / phyogs bzhir @435b yang 'o thug dang / zho dang / 'bras chan dang / ro sna tshogs dang ldan pa dang / chan sna tshogs kyi gtor ma dag gtor la /	66.52858709054125
ekEkam sumanaH puzpam jApya tri azwa SatEH sA pratimA AhartavyA taTAgatasya vajrapANeH ca pUrvataram puzpa DUpa ganDam dAtavyam	me tog dang / bdug spos dang / spos dang / mar me sna tshogs dag gis mchod pa bgyis nas dus gsum du sna ma'i me tog brgya rtsa brgyad phrag gsum la bzlas brjod brgya rtsa brgyad phrag gsum bgyi zhing / re re nas gnod sbyin mo chen mo dpe med ma'i gzugs de la bsnun par bgyi'o bgyi zhing /	81.5458648653936
bali pAyasat aDi odanam nAnA rasam nAnA madyam dutt caturdiSe kzeptavyam pUrNa paQcadaSyAm anena eva viDinA baliH anyAni ca yaTAlABena DUpa karpUra kunduruka candanamrakzam dAtavyam	// de nas zla ba nya'i tshes bco lnga'i gdugs la'ang chog 'di nyid dang / gzhan yang ci 'byor ba dag dang / bdug spos dang / ga pur dang / pog dkar po dang / tsandan dang / shing mu sa dag kyang dbul /	71.05133327419291
suganDa tElena dvO dipO dAtavyO	'bru mar dri bda' ba'i zhugs mar kha gnyis kyang dbul bar bgyi'o //	73.89393024302241
tatra aham svarUpeNa upatizWAmi	de nas bdag der rang gi gzugs kyis gnas par bgyi zhing dam pa ci 'tshal ba'ang stsal bar bgyi ste /	68.24545307138602
yaTA Ipsitam varam dAsyAmi samADi lABam AkASa gamanam antarDAnam rAja tvam bala cakravarti tvam vidyADara tvam niDivAdam DAtuvAdam para cidIrGa Ayuzka tvam	ting nge 'dzin thob pa dang / nam mkha' la mchis pa dang / lus mi snang bar bgyi ba dang / rgyal srid dang / stobs kyi 'khor los bsgyur ba nyid dang / rig sngags 'chang nyid dang / gter lta 'tshal ba dang / nor sgyur 'tshal ba dang / pha rol gyi sems 'tshal ba dang / tshe ring ba dang / dam pa ci 'tshal ba'ang stsal bar bgyi lags so // des kyang sems can thams cad la byams pa'i sems dang / nga rgyal dang / khro ba dang / phrag dog dang / ser sna yongs su @436a *//	54.46413936086131
sarva sattvAnAm mEtra cittena Bavitavyam	spangs pa'i sems su bgyi'o //	61.972893484707534
mAna kroDa DerzyA mAtsarya parivarjitena stOpika DArmika sAMGika arTa apahAra parivarjitena Bavitavyam taTAgatAnAm aBedya prasAdena Bavitavyam	mchod rten dang / chos dang / dge 'dun gyi nor 'phrog pa yongs su spang ba dang / de bzhin gshegs pa rnams la dang ba mi phyed par bgyi'o //	68.81622068095218
yadi ca aham Bagavan paQca Anantaryam karizyAmi triBiH sADanEH na samanvAheH ayam mA	bcom ldan 'das / gal te mtshams ma mchis pa bgyid ba zhig gis kyang lan gsum bsgrubs te bdag gis ma stsal bar gyur na /	81.3443237774058
ca aham Bagavan= anuttarAm samyaksaMboDim aBisaMbuDyeyam sace budDe aprasAda labDaH	bcom ldan 'das / bdag bla na med pa yang dag par rdzogs pa'i byang chub mngon par rdzogs par 'tshang rgya bar ma gyur cig /	84.86083424550752
Bave yaH ca vimati prAptaH yaH cam pApam akuSalam kRtvA na viratim anugRNhAti kleSa upakleSa cittaH tasya aham ca api darSanam dAsyAmi lABam api karizyAmi	gal te sangs rgyas la ma dad par gyur pa dang / yid gnyis su gyur pa gang lags pa dang / sdig pa mi dge ba'i chos bgyis nas 'gyod par mi bgyid pa dang / nyon mongs pa dang / nye ba'i nyon mongs pa'i sems dang ldan pa gang lags pa de dag la'ang bdag mthong ba stsal bar bgyi zhing thob par yang bgyi lags so //	80.37562573947979
aTa BagavAn sADukAram adAt	de nas bcom ldan 'das kyis gnod sbyin mo chen mo dpe med ma le legs so zhes bya ba byin te /	64.38364215967557
sADu sADu Bagini	sring mo / legs so // legs so //	85.36245727539062
sADu Kalu punar tvam Bagini yat tvayA sarva sattvAnAm arTAya pApa samAcArezu dutt sattvezu imAH evaMrUpA mantra padAH BAzitAH pratijQA kRtA	sring mo khyod kyis sems can thams cad kyi don du sdig pa kun tu spyod pa'i sems can rnams la gsang sngags kyi gzhi 'di lta bu 'di dag smras zhing dam bca' ba'ang byas pa ni /	81.08742738485212
Sakzyasi tvam anayA evaMrUpayA mahA karuNayA sarva sattvAn anuttarAyAm samyaksaMboDO pratizWApayitum	yang khyod legs so // khyod snying rje chen po 'di lta bu 'dis sems can thams cad bla na med pa yang dag par rdzogs @436b pa'i byang chub la rab tu 'god nus par 'gyur gyi /	85.89587312617249
evam eva tvayA api karaNIyam	khyod kyis de bzhin du gyis shig /	79.85396312264835
aTa SaMKini mahAdevI Bagavantam nAnA puzpEH nAnA ganDEH aByarcya pradakziNIkRtya pAdaryonipatya Bagavantam etat avocat	de nas lha mo chen mo dung can mas bcom ldan 'das la me tog sna tshogs dang / spos sna tshogs dag gis mchod pa byas te bskor ba byas nas bcom ldan 'das kyi zhabs gnyis la gtugs te bcom ldan 'das la 'di skad ces gsol to // bcom ldan 'das /	88.46166144536127
aham api Bagavan= taTAgata aDizWAnena pratijQAm karizyAmi taTAgata SAsana cira sTiti arTam tezAm ca Darma BANakAnAm Darma SrAvaNikAnAm sarva ASA paripUra karANi mantra padAni dAsyAmi rakzAyE tat me BagavAn anujAnAtu	bdag gis de bzhin gshegs pa'i byin gyi rlabs kyis de bzhin gshegs pa'i bstan pa yun ring du gnas par bgyi ba dang / chos smra ba de dag kyang bsrung ba'i slad du dam bca' bar bgyi zhing / re ba thams cad yongs su rdzogs par bgyid pa'i gsang sngags kyi gzhi rnams stsal bar bgyi lags kyi / de'i slad du bcom ldan 'das kyis bdag la rjes su gnang bar mdzad du gsol /	89.47079670665103
namaH namaH sarva taTAgatAnAm	na ma: sarba ta th'a ga ta n'i /	74.27266693115234
om SaMKini devi AgacCa AgacCa	tadya th'a / aom sham khi ni de bi / a'a gatstsha a'a gatstsha / tishth'a dha ne /	65.35546595496254
tizWa Dane Dana jaye	dh'a na dza ye / bri bri /	64.40008809016301
vR vR vRdDi kari	bri dh'a ka ri /	60.52622413635254
DR DR DRti kari	dhri dhri / dhri ti ka ri /	65.69683906767104
nAnA viviDa veSa vastra AyuDa DAriNi	n'a n'a bi bi dha / pa sha bsta /	63.502497759732336
yu yu AyuzpAlani	a'a yu dha dha ra ni / yu yu a'a yushpa la na /	63.83079474023048
taTAgatAnAm smara boDi cittam mA vilamba	ta th'a ga ta n'am/ sma ra bo dha tsittam/ ma bi lamba /	67.33476155144828
dehi me varam	de hi me ba ra na /	61.69241178663153
SaMKini svAhA imEH mantra padEH sa Bagavan kAya gatEH yaSaH vRdDim anuprApsyati	sham khi ni sv'ah'a / bcom ldan 'das / gsang sngags kyi gzhi 'di dag lus la gnas par bgyis na / de'i snyan pa 'phel bar 'gyur zhing /	76.00664232131984
tejaH vRdDim Boga vRdDim ESvarya vRdDim dIrGa Ayuzka tAm Satru vaSIkaraNa vRdDim anuprApsyati	gzi brjid 'phel ba dang / longs spyod 'phel pa dang / dbang phyug 'phel ba dang / tshe ring ba dang / dgra rnams dbang @437a *// du bgyi ba'ang 'phel bar 'gyur lags so // sa phyogs gtsang ma'am /	77.48594741864349
azwa Sata japtena yaTAlABena balim dattvA caturdiSe DUpam kundurukam taTAgatasya udAratara pUjA kartavyA dIpaH dutt  dAtavyaH	lha'i gnas su ci 'byor ba'i gtor ma phyogs bzhir stsal la / de bzhin gshegs pa la bdug spos dang / pog dkar po dag gis mchod pa rgya cher bgyi zhing zhugs mar dag kyang phul la /	74.06480644245842
ekaviMSati divasAni mEtra vihAriNA niyama sTena Bavitavyam tatas sarva aBiprAyam paripUrayizyAmi sadDarma pratikzepakam sTApya SucO pradeSe kartavyam devAyatane vA	dgung nyi shu rtsa gcig tu byams pa la gnas pa dang / des par gnas shing bzlas brjod lan brgya rtsa brgyad bgyis na /	59.85564377231674
aTa BagavAn sA ca yaTAsamAgatA parza sADukAram adAt	dam pa'i chos spong ba ma gtogs pa rnams kyi bsam pa thams cad yongs su rdzogs par bgyi lags so; ;de nas bcom ldan 'das dang / ji ltar lhags pa'i 'khor de dag gis lha mo chen mo dung can ma la lags so zhes bya ba byin te /	64.3042431759342
sADu sADu Bagini	sring mo / legs so //	85.28939416295006
suBAzitam idam pratijQA bahu guNa samanvAgatA	legs so; ;yon tan mang po dang ldan pa'i dam bca' ba 'di ni legs par smras so //	80.92151617728265
evam eva tvam api karaNIyam anAgate Dvani  vi	sring mo / khyod kyis ma 'ongs pa'i dus na de bzhin du gyis shig /	82.61130891012043
aTa Kalu BImA mahAdevI suvarNa puzpEH Bagavantam aByarcya BagavataH caraNayoH nipatya Bagavantam etat avocat	de nas lha mo chen mo 'jigs byed mas bcom ldan 'das la gser gyi me tog dag gis mchod pa byas nas bcom ldan 'das kyi zhabs gnyis la gtugs te bcom ldan 'das la 'di skad ces gsol to // bcom ldan 'das /	90.87186691695717
aham api Bagavan= tezAm Darma BANakAnAm Darma SrAvaNikAnAm tezAm ca leKakAnAm tezAm ca DArakANAm vAcakAnAm pUjakAnAm arTAya sarva ASAparipUra karANi hiraNya maNi muktA Boga ESvarya rAja tva dIrGa AyuzkarANi Satru vaSIkaraNAni mantra padAni dAsyAmi	bdag gis kyang chos smra ba de dag dang / chos nyan pa de dag dang / yi ger 'bri ba de dag dang / 'dzin pa dang / klog pa dang / mchod pa bgyid @437b pa de dag gi don du re ba thams cad yongs su rdzogs par bgyid pa / dbyig dang / nor bu dang / mu tig dang / longs spyod dang / dbang phyug dang / rgyal srid dang / tshe ring bar bgyid pa; dgra thams cad dbang du bgyid pa'i gsang sngags kyi gzhi rnams stsal bar bgyi ste / rgyal po'am / rgyal po'i btsun mo'am / dge slong ngam /	77.55420978020271
yaH kaSci rAjA vA rAjQI vA Bikzu BikzuNI upAsa ka upAsikAH vA DArayizyanti satkarizyanti	dge slong ma'am / dge bsnyon nam; dge bsnyen ma gang la la zhig 'dzin tam / klog gam / bsnyen bkur bgyid dam / yi ger 'bri'am / yi ger 'brir stsol tam /	76.97983189509978
liKizyanti liKApayizyanti taTAgata guru gOraveNa pratiprattyAH yaTA upadizwAH pratipatsyante	mchog tu gus pas ji skad gsungs ba'i sgrub pa la sgrub par bgyid na / bcom ldan 'das /	62.793797103456896
tasya aham Bagavan rakzizyAmi paripAlanam karizyAmi yaTocitam varam dAsyAmi Boga ESvaryEH avEkalyam	bdag gis de bsrung bar bya / yongs su bskyang bar bgyi zhing dam pa ci 'tshal ba'ang stsal bar bgyi ste / longs spyod dang / dbang phyug dag gis mi brel bar bgyi /	85.53000015491943
karizyAmi vivAda yudDaximba xamare jayam karizyAmi	'thab mo dang / 'gyed pa dang / khrag khrug dang / 'khrug slong dag lus rgyal bar bgyi /	73.28698154091443
AyuH saMpadam upasaMharizyAmi	tshe phun sum tshogs pa nye bar bsgrub par bgyi /	78.81072350424164
dutt  tasya ca vizayasya nagarasya paripAlanam karizyAmi	de'i yul dang grong khyer dag kyang yongs su bskyang bar bgyi lags kyi /	77.62404128775091
tat me BagavAn anujAnAtu	de'i slang du bcom ldan 'das kyis bdag la rjes su gnang bar mdzad du gsol /	84.78865594863892
namaH sarva taTAgatAnAm sarva boDisattvAnAm Arya avalokita ISvara vajrapANi praBRtInAm	na ma: sarba ta th'a ga ta n'am/ tadya th'a /	61.203039377424616
om mahAdevi BIme BIma mate	aom sham khi ni de bi / a'a gatstsha a'a gatstsha / tishth'adha ne /	78.97481815955219
jaye jayAvahe	dh'a na dza ye / bri bri / bri dh'a ka ri / dhri dhri / dhri ta ka ri / n'a n'a bi bi dha / ba sha bsta dha dha ri ni /	49.93280440543846
yaSa jave teja jave vyAkaraNa prApte sarva sattva avalokane kRpa teja bahule taTAgata anujQAtam pAlaya	yu yu aa yushpr'a la le / ta th'a ga ta n'am/ sma ra bo dhi @438a *//	60.95062445029688
smara pratijQAm	tsittam/ ma bi lamba /	52.3196570223028
budDa aDizWAnena dehi me varam sidDim kuru	de hi me pa ra na /	29.593129233310094
devi mahAdevi satya vacana devi BIme satya vacana pratizWite guhyanivAsini svAhA	sham khi ni sv'ah'a /	31.19327953628336
imAni tAni Bagavat mantra padAni taTAgata aDizWitAni taTAgata anujQAtAni mayA BAzitAni sattvAnAm arTAya	bcom ldan 'das / bdag gis sems can thams cad kyi don du de bzhin gshegs pas byin gyis brlabs shing de bzhin gshegs pas rjes su gnang ba'i gsang sngags kyi gzhi 'di dag smras lags te / de bzhin gshegs pa'i spyan sngar me tog dang / bdug spos dang / spos dang / mar me dag gis mchod pa bgyis la /	69.06193999605796
yam yam eva kAmam manasikRtvA japizyate taTAgatasya puratas puzpa DUpa ganDa dIpEH pUjAm kRtvA pAyasa rasa balim catur diSe dattvA tamazwa Sata jApena sarva ASAm paripUrayizyAmi	phyogs bzhir yang 'o thug dang / ro sna tshogs dang ldan pa'i gtor ma dag stsal te / ci dang ci 'tshal ba yid la bgyis shing bzlas brjod lan brgya rtsa brgyad kyis mchod pa bgyis na / re ba de dang de dag thams cad yongs su rdzogs par bgyid lags so //	83.54092565448894
yaH kaSci mAm sva rUpeNa aBikAMkzI Bave tena acCinna daSe keSa apagate aSlezEH aFgEH nava BAjana sTEH azwasyAm	gang la la bdag rang gi gzugs mthong bar 'tshal ba des tshes brgyad kyi gdugs la ras dkar po gsar pa kha tshar ma bkum pa skra ma mchis pa la ri mo mkhan gtsang ma 'phags pa'i yan lag brgyad yongs su bzung bas tshon rtsi spyin dang ma 'bags pa snod gsar pa'i nang du stsal bas / dbus su de bzhin gshegs pa'i sku gzugs chos ston pa'i tshul du bzhugs pa bri bar bgyi'o //	62.22628384292837
Arya azwa aMga parigRhItena citrakareNa citrApayitavyA SarakANxa gOrI sarva alaMkAra viBUzita aMgI Sveta vastrA maDye taTAgata pratimAH Darma deSayamAnAH dakziNena Arya avalokita ISvaraH sAMkaTyam kurvan vAma pArSve BImA mahAdevI dutt	g-yas phyogs su 'phags pa spyan ras gzigs dbang phyug chos kyi 'bel ba'i gtam ston pa bri bar bgyi'o // g-yon phyogs su ni lha mo chen mo 'jigs byed ma 'dam bu @438b mda' rgyu'i mdog ltar dkar sham du mchis la / rad pa dkar po 'chal ba / rgyan thams cad kyis brgyan pa /	72.03744573008572
kuNxi ganetRka parigRhItA samASvAsayantI	ril ba dang / bgrang phreng thogs shing yang dag par dbugs 'byin pa'i tshul du mchis pa bri bar bgyi'o //	75.92907947761076
tatas zwamyAm pUrva secam kRtvA puzpa DUpa ganDa mAlya vilepanEH sa DAtuke cEtya sTAne bali pAyasat aDi odanam caturdiSe yAvat pUrNa paQcadarSIm SUcinA vidyADareNa udAratarAm	de nas rig sngags 'chang gcang mas sngar bsnyen pa bgyi la tshes brgyad nas tshes bco lnga'i bar du mchod rten sku gdud dang bcas pa'i gnas su me tog dang / bdug spos dang / spos dang / me tog phreng dag gis mchod pa bgyi zhing / phyogs bzhir yang 'o thug dang / zho dang / 'bras chan gyi gtor ma dag gtor la /	88.98451587346263
puzpa DUpa ganDa dIpEH pUjAm kRtva balim dattvA nAnA rasEH anyAni ca yaTAlABena Sukla balim dattvA sarva sattvAnAm mEtra cittena dayA cittena BUtvA jAtI puzpANAm azwaBiH SatEH sA pratimA AhartavyA	me tog dang / bdug spos dang / mar me sna tshogs dag gis mchong pa rgya cher bgyi zhing lha bshos dkar po dag kyang phul la / gtor ma ro sna tshogs dang ldan pa dang / gzhan yang ci 'byor pa dag stsal nas sems can thams cad la byams pa'i sems dang / snying rje'i sems kyis sna ma'i me tog brgya rtsa brgyad la bzlas brjod lan brgya rtsa brgyad bgyi zhing / re re nas lha mo chen mo 'jigs byed ma'i gzungs de la 'phang bar bgyi'o //	73.39917922264138
ekEkam japya tatra aham svarUpeNa upatizWizyAmi yaTA Ipsitam varam dAsyAmi rAjya ESvaryam	de nas bdag der rang gi gzugs kyis gnas par bgyi / dam pa ci 'tshal ba'ang stsal bar bgyi ste /	72.43315660676822
AkASa gamanam niDivAdam DAtuvAdam vidyADara tvam anyAni ca yaTA IpsitAni karmANi	rgyal srid kyi dbang phyug dang / nam mkha' la mchi ba dang / gter lta 'tshal ba dang / nor sgyur 'tshal ba dang / rig sngags 'chang nyid dang / dus ma lags par @439a *//	72.48545245581468
karizyAmi akAla mRtyu pratizeDanam sarva roga praSamanam para cakra pramardanam putra lamBam arTa Agamanam prItim sarva sattvezu	'gum pa bzlog pa dang / bro nad thams cad rab tu zhi bar bgyi ba dang / pha rol gyi dmag tshogs rab tu gzhom pa dang / sems can thams cad la byams pa skye ba dang / gzhan yang ci 'tshal pa'i las dag kyang bgyi lags so // bcom ldan 'das /	84.0735815250862
yadi ca aham Bagavan paQca Anantaryam karizyAmi na sarva ASAm paripUrayeyam mA ca aham Bagavan= anuttarAm samyaksaMboDim aBisaMbuDyeyam sat Darma pratikzepakam sTApya yaH ca vicikitsA prAptaH budDa Darma saMGe	gal te dam pa'i chos spong ba dang / sangs rgyas dang / chos dang / dge 'dun dag la the tshom du gyur pa gang lags pa ma gtogs par mtshams ma mchis pa lnga bgyid pa zhig lags na'ang bdag gi re ba thams cad yongs su rdzogs par ma bgyis par gyur na / bcom ldan 'das / bdag bla na med pa yang dag par rdzogs pa'i byang chub mngon par rdzogs par 'tshang rgya bar ma gyur cig /	87.14353105706336
BagavAn Aha	bcom ldan 'das kyis bka' stsal pa; sring mo / legs so //	78.12455592836652
sADu sADu Bagini sADu Kalu punar tvam Bagini yat tvam sarva sattvAnAm hitAya suKAya pratipannAH asya eva ca Darma paryAyasya cira sTiti dutt pratipannA	legs so // sring mo khyod sems can thams cad kyi don dang / phan pa dang / bde ba'i phyir zhugs shing / chos kyi rnam grangs 'di'ang yun ring du gnas par bya ba'i phyir zhugs pa ni / yang khyod legs so // sring mo /	85.00874122497501
tena hi Bagini nityam eva imAH pratijQAH tvayA nityam eva samanvAhartavyAH	de'i phyir khyod kyis rtag tu dam bcas pa 'di dran par gyis shig /	67.96137473493118
aTa iyam mahA pRTivI tasmin samaye pracacAla divyaQca kusuma varzam aBiprAvarzat sA ca sarvAvatI parzad sADukAram adAt	de nas de'i tshe sa chen po 'di rab tu g-yos shing lha'i me tog gi char dag kyang mngon par rab tu bab pa dang / thams cad dang ldan pa'i 'khor de dag gis kyang legs so // zhes bya ba byin te /	92.75103628086376
sADu sADu suBAzitam idam	sring mo / legs @439b so; ;legs so //	83.36546487421603
pratijQA sarva sattvAnAm sarva ASAparipUrikA Bavizyati  vii	khyod kyis sems can thams cad kyi re ba thams cad yongs su rdzogs par 'gyur ba'i dam bca' ba 'di ni legs par smras so //	79.83127018078329
aTa Arya avalokita ISvaraH boDisattvaH mahAsattvaH punar Bagavantam etat avocat kim punar Bagavan	de nas bcom ldan 'das la byang chub sems dpa' sems dpa' chen po 'phags pa spyan ras gzigs dbang phyug gis 'di skad ces gsol to // bcom ldan 'das / ci rigs kyi bu'am /	93.66803409588638
sa kula putraH vA kula duhitA vA liKana vAcana liKApana saMprakASana paWana sva aDyayana pUjana saMprakASanayA puNyam anuprApsyati imasya Darma paryAyasya	rigs kyi bu mo da chos kyi rnam grangs 'di yi ger 'bri ba dang / yi ger 'brir stsol ba dang / klog pa dang / mchod pa dang / yang dag par ston pa dang / 'don pa dang / mchid ton du bgyid pa des bsod nams 'thob par 'gyur lags sam /	80.13172125362685
BagavAn Aha	bcom ldan 'das kyis bka' stsal pa /	94.66379267828805
tena hi tvAm eva Arya avalokita ISvara pariprakzyAmi yaTe te kzamam taTA vyAkuru	'phags pa spyan ras gzigs dbang phyug / de'i phyir de khyod nyid la dri yi / khyod kyis ji ltar bzod pa de bzhin du lan thob cig /	89.34213639711324
avalokita ISvaraH Aha	spyan ras gzigs dbang phyug gis gsol pa / bcom ldan 'das /	77.55659797273833
BagavAn eva vyAkurutAm na asti taTAgatasya adRzwam vA aSrutam vA avijQAtam vA	de bzhin gshegs pa la ni ma gzigs pa'am / ma gsan pa'am / ma dgongs pa dang / rnam par mi mkhyen pa mi mnga' bas bcom ldan 'das nyid kyis bka' stsal du gsol /	80.04963555496998
BagavAn Aha	bcom ldan 'das kyis bka' stsal pa / rigs kyi bu /	91.16233241314791
yaH ca kula putra asya Darma paryAyasya liKana liKA apana vAcana pUjana saMprakASana paWana sva aDyayanAt puNyam anuprApsyati saH upamena api navarNayitum	chos kyi rnam grangs 'di yi ger 'bri ba dang / yi ger 'brir 'jug pa dang / klog pa dang / mchod pa dang / yang dag par ston pa dang / 'don pa ndang / kha ton du byed pa las bsod @440a *// nams 'thob par 'gyur ba gang yin pa de ni dpes brjod par yang mi nus so //	82.40594020876361
tat kasya hetoH	de ci'i phyir zhe na / gos dang / rgyan dang / dbyig dang / gser dang / nor bu dang / mu tig dag gis sems can thams cad kyi bsam pa ji lta ba bzhin du yongs su rdzogs par byas te rtser bcug kyang sems can de dag skye ba dang /	43.27133195511831
sarva sattvAnAm yaTA aBiprAya paripUrakam dAnam dattvA te sattvAH aparimuktAH eva Bavanti jarA vyADi maraNa Soka parideva duHKa dOramanasya upAyAseByaH	rga ba dang / na ba dang / 'chi ba dang / mya ngan dang / smre sngags 'don pa dang / sdug bsngal ba dang / yid mi bde ba dang / 'khrug pa dag las yongs su thar par mi 'gyur ba nyid yin zhing /	77.56602325404593
varzata sahasram paQcaBiH kAma guNEH krixA payitvA aparimuktAH eva te sattvAH Bavanti naraka tiryagyoni yama loka preta vizayezu punar api	lo 'bum du 'dod pa'i yon tan lnga po dag gis rtser bcug kyang sems can de dag sems can dmyal ba dang / dud 'gro'i skye gnas dang / gshin rje'i 'jig rten dang / yi dvags kyi yul dag las yongs su thar par mi 'gyur ba nyid de /	91.52487489341236
asya Darma paryAyasya SravaNam sattveByaH kRtvA pUjanam saMprakASanaMcakRtvA arTam ca asya avaSrutya dutt	sems can rnams kyi phyir chos kyi rnam grangs 'di nyan cing mchod pa byed pa dang / yang dag par bstan te /	76.77038063432305
pratipattyA pratipadya parimuktAH eva Bavanti jAti jarA vyADi maraNa Soka parideva duHKa dOrmanasya upAyAseBya sarva naraka tiryagyoni yamal tasmAt taTAgataH ayam puNya skanDaH upamena api pramANam na kurvanti	de'i don kyang mnyan cing nan tan gyis sgrub par byed pa ni skye ba dang / rga ba dang / na ba dang / 'chi ba dang / mya ngan dang / smre sngags 'don pa dang / sdug bsngal ba dang / yid mi bde ba dang / 'khrug pa dag dang / sems can dmyal ba dang / dud 'gro'i skye gnas dang / gshin rje'i 'jig rten thams @440b cad las yongs su thar bar kho nar 'gyur bas de'i phyir de bzhin gshegs pas 'di'i bsod nams kyi ched kyi dpe mi mdzad do // rigs kyi bu /	76.56840787705602
yaH ca kula putra asya ca Darma paryAyasya uddiSya sarzapa Pala mAtrakam ca hiraNyasya	gang gis chos kyi rnam grangs 'di dang / chos smra ba dang / 'dzin pa dang / klog pa dang / yi ger 'bri ba dang / mchod pa byed pa dang / gang gi phyir dbyig yungs 'bru tsam yongs su gtong bar byed dam /	71.5741451235889
eka puzpam vE eka Palam vE eka patAkAm vA vAdyam vA ganDam vA vastram vA Asanam vA	me tog gcig gam / 'bras bu gcig gam / ba dan nam / rol mo'i sgra 'am / spos sam / gos sam / rgyan gcig tsam zhig yongs su gtong bar byed dam /	86.41833754104782
ABaraNam vA parityaje liKe liKA paye DAraye vAcaye pUjaye satkare pareByaH ca	yi ger 'bri ba'am; yi ger 'brir 'jug gam /	50.7637441436771
viastareNa saMprakASaye tam ca Darma BANakam vAcaye pUjaye yaH ca tizWate taTAgate	'chang ngam / klog gam /	38.76559681344086
saMmuKa pUjayA sa parza pUjaye mAnaye sarva suKa upaDAnena varza Sata sahasram upatizWe	mchod pa byed dam / yang dag par ston tam / bsnyen bkur byed dam / gzhan dag la'ang rgya cher yang dag par rab tu ston par byed pa gang yin pa dang / gang gis de bzhin gshegs pa 'khor dang bcas pa mngon sum du bzhugs pa la lo 'bum du me tog dang /	57.416387720156415
ganDa mAlya vilepanEH Dvaja patAkABiH vihAra caMkrama udyAnam kAra apaye arDa yojana ucCritam	bdug spos dang / spos dang; me tog phreng dang / byug pa dang / gdugs dang / rgyal mtshan dang / ba dan dag gis mchod pas mchod par byed / rje par byed cing / bde ba'i yo byad thams cad kyis bsnyen bkur byed pa dang / gtsug lag khang dang / 'chags dang / skyed mos tshal dag byed du bcug gam /	74.83047971074275
sapta ratna mayam stUpam kAraye Satam vA sahasram vA taTAgatam uddiSyatAn= ca divya pUjayA	de bzhin gshegs pa'i phyir rin po che sna bdun gyi mchod rten @441a *// 'phang du dpag tshad phyed pa brgya'am stong byed du bcug ste / de dag la lo 'bum du mchod pa dag gis mchod par byed pa bas / gang chos kyi rnam grangs 'di yi ger 'bri ba dang / yi ger 'brir 'jug pa dang / 'chang ba dang / klog pa dang / 'don pa dang / mchod pa byed pa dang / yang dag par ston pa de ni /	56.512294799640884
pUjaye varza Sata sahasram ayam ca tatas bahutara puNya saMskAram syA asya Darma paryAyasya liKana liKA apana DAraNa paWana pUjana saMprakASanayA na imAm	de pas chos bsod nams mngon par 'du bya ba ches mang du skye bar 'gyur gyi / de bzhin gshegs pa la mngon sum du mchod pa byed pa de ni de lta ma yin la /	65.86195768831138
taTAgata saMmuKa pUjAm na tu eva sattveByaH dAnam dattvA paQcaBiH kAma guNaH krIxA payitvA	sems can thams cad la sbyin pa byin zhing 'dod pa'i yon tan lnga po dag gis rtser bcug pa'ang de lta ma yin no //	77.01414741838938
tasmAt tarhi tEH ca kula putrEH kula duhitRBiH vA rAja rAja putra mahAmAtra amAtyEH vA satata smita mayam Darma paryAyaH pUjayitavyaH	de lta bas na / rigs kyi bu dang / rigs kyi bu mo dang / rgyal po dang / rgyal bu dang / blon po chen po dang / blon po de dag gis rtag par rgyun du chos kyi rnam grangs 'di mchod par bya'o //	90.54163548089028
taTAgata saMjQA eva utpAdayitavyA tezAm kalyANa mitrANAm yaH imam Darma paryAyam SrAvayati kaTayati arTam ca asya upasaMharati	gang chos kyi rnam grangs 'di sgrog par byed pa dang / rjod par byed pa dang / don kyang nye bar sgrub par byed pa'i dge ba'i bshes gnyen de dag la'ang de bzhin gshegs pa nyid du 'du shes bskyed par bya zhing /	90.00483751296997
tas satkRtya ayam Darma paryAyaH SrotavyaH udagrahItavyaH DArayitavyaH vAcayitavyaH manasi kartavyaH	de dag gis bsnyen bkur byas te chos kyi rnam grangs 'di mnyan par bya / gzung bar bya / bcang bar bya /	81.96895537819582
evam cittam utpAdayitavyam dutt  lABAH asmABiH su labDAH yaH smABiH Srutam apaTa gAminAm paTam upadarSayati anarTe arTa saMjQinAm anitye	bklag par bya / yid la bya zhing 'di ltar sems bskyed par bya ste /	27.90946181785146
nitya saMjQinAm asuKe suKa saMjQinAm yat asmABiH naraka tiH yogyoniyama loka parimokzaNa arTam taTAgata kRtyam kRtam	bdag cag don med pa la don @441b 'du shes pa dang / mi rtag pa la rtag par 'du shes pa dang / sdug bsngal ba la bde bar 'du shes shing / lam ma yin par zhugs pa la lam nye bar ston pa gang yin pa dang / bdag cag sems can dmyal ba dang / dud 'gro'i skye gnas dang / gshin rje'i 'jig rten las yongs su thar par bya ba'i phyir de bzhin gshegs pa'i mdzad pa gang yin pa de ni bdag cag gis rnyed pa legs par rnyed do snyam du sems bskyed par yang bya'o //	54.55044381468871
avalokita ISvaraH Aha	spyan ras gzigs dbang phyug gis gsol pa /	78.6025396556389
mahAkRtyena taTAgata kRtyena imam Darma paryAyam sarva sattvAnAm prakASitam	bcom ldan 'das / chos kyi rnam grangs 'di ni sems can thams cad la de bzhin gshegs pa'i mdzad pa mdzad pa chen pos yang dag par bshad lags so //	86.52020278004582
BagavAn Aha	bcom ldan 'das kyis bka' stsal pa /	94.66379267828805
ayam ca kula putra Darma paryAyaH paScime kAle paScime samaye dakziNApaTe pracarizyati	rigs kyi bu / chos kyi rnam grangs 'di ni phyi ma'i dus phyi ma'i tshen lho phyogs kyi rgyud na spyod par 'gyur te /	88.1037533759839
tatra api Bikzu Bi kzuNI upAsaka upAsikA rAja rAja putra mahAmAtra amAtyAH BAjanIBUtAH pUjakA	der yang dge slong dang / dge slong ma dang / dge bsnyen dang / dge bsnyen ma dang / rgyal po dang / rgyal bu dang / blon po chen po dang / blon po snod du gyur pa / mchod pa byed pa /	87.34566374790543
DArakAH vAcakAH Bavizyanti SradDAsyanti pattIzyanti	'dzin par byed pa / klog par byed pa dag 'byung bar 'gyur zhing / dang par 'gyur / yid ches par 'gyur ro //	73.28739944974856
sa ce uttara pUrva paScimAyAm pracare tat para karma aBiyuktAH te sattvAH Bavizyanti na	gal te byang dang / shar dang / nub phyogs kyi rgyud dag na spyod par 'gyur na'ang de na gang dag nyan par mi byed pa dang / dad par mi byed pa dang / yid @442a *//	79.36826484211997
Srozyanti SradDAsyanti na pattIzyanti na pUjayizyanti hIna vIrya nazwa smRtayaH nAnA vyAkzepa kuwamba dAsa dAsI Boga ESvarya hAsya lAsya nAwy	ches par mi byed pa dang / mchod par mi byed pa dang / brtson 'grus zhan pa dang / brjed nges pa dang / bu smad dang / bran mo dang / longs spyod dang / dbang phyug dang / bzhad gad dang / 'jo sgeg dang / bro dang / gar dang / glu sna tshogs kyis rnam par g-yengs shing / phrag dog dang / ser sna'i dran pas nyan par mi byed pa'i sems can de dag ni bdud kyi las la mngon par brtson pa yin te /	66.61752009870068
na Srozyanti na pattIzyanti na pUjayizyanti te aparimuktAH eva jarA vyADi maraNa Soka parideva duHKa dOrmanasya upAyAseBya preta yama loka vizayeByaH Bavizyanti	de dag ni skye ba dang / rga ba dang / na ba dang / 'chi ba dang / mya ngan dang / smre sngags 'don pa dang / sdug bsngal ba dang / yid mi bde ba dang / 'khrug pa dag dang / sems can dmyal ba dang / dud 'gro'i skye gnas dang / gshin rje'i 'jig rten dang / yi dvags kyi yul rnams las yongs su mi thar pa kho nar 'gyur ro // de lta bas na /	78.06241590142055
tasmAt tarhi tEH kula putrEH kula duhitRBiH vA sarva apAyEH AtmAnam parimoktu kAmena satkRtya ayam Darma paryAyaH pUjayitavyaH DArayitavyaH satkartavyaH pareByaH saMprakASatitavya u	rigs kyi bu dang / rigs kyi bu mo bdag nyid ngan song thams cad las yongs su thar par 'dod pa de dag gis bsnyen bkur byas te chos kyi rnam grangs 'di mchod par bya zhing / gzhan dag la yang dag par bstan par bya /	80.38518526483693
manasA DArayitavyaH	yid la'ang gzung bar bya'o //	77.25395589861377
ximbaxumara duH svapna durnimittezu akAla mRtyu gomara paSu maramAnuzamareByaH nAnA vyADi Baya upadraveBya imam Darma paryAyam pUjayitvA vAcayitavyaH Dvaje vA ucCrapitam kRtvA pUjayitvA	khrag khrug dang / 'khrug klog dang / rmi lam ngan pa dang / ltas ngan pa dag dang / dus ma yin par 'chi ba dang / gnag nad dang / phyugs na dang / mi nad dag dang / nad dang / 'jigs pa dang / @442b gnod pa sna tshogs dag la'ang chos kyi rnam grangs 'di mchod pa byas te bklag par bya'o //	85.21772277934546
nAnA ganDa puzpa DUpa vAdyEH pracezwavyaH caturdiSe balim IttvA aBinamaskRtya puzpa DUpa ganDEH sarve iti upadravAH praSamam yAsyanti	rgyal mtshan btsugs pa me tog dang / bdug spos dang / spos dang / rol mo'i sgra sna tshogs dag gis mchod cing phyogs bzhir gtor ma gtor la me tog dang / bdug spos dang / spos dag gis phyag byas te 'jug par byas na / der yams kyi nad dang / gnod pa dang / 'go ba'i nad thams cad kyang rab tu zhi bar 'gyur ro //	81.02381214604071
dutt aTa BagavAn tasyAm velAyAm imAH gATAH aBAzata	de nas de'i tshe bcom ldan 'das kyis tshigs su bcad pa 'di dag bka' stsal la to //	95.8206629573333
sarvasya sattvasya anugraha arTam yA BAzitA pUrva Bavezu nAyakEH	sngon gyi srid par 'dren pas gang gsungs shing // sems can thams cad rjes su gzung ba'i phyir //	82.0842798535586
aham taTA tvAm api deSayizye gRNhAhi AnandaH imam samADim	da ltar ngas kyang khyod la bshad pa yi // ting 'dzin 'di ni gzung zhig kun dga' po // sangs rgyas chos dang dge 'dun dkon mchog la //	76.52051670153655
yaH ca eva trEDAtuka dAnu dadyA saptAna ratnAna ca pUrayitvA	gang gis khams gsum sbyin par byin pa bas // mdo sde 'di la mchod pa byas na ni // sbyin pas de yid dper yang mi phod do //	85.27592139420796
dutt budDezu Darmezu sadA apramattaH upamA api tasya na sa Bonti dAnam yaH ca eva budDezu aBiSraddaDitvA vihAra kArApayi cEtyakAni	gang gis sangs rgyas la ni dad byas te // tshad med gtsug lag khang dag brtsigs pa bas //	65.0213963867962
yaH ca eva sUtraMca DarA iti kaSci ayam tatas bahu taru puNyu Bezyate	gang zhig mdo 'di 'dzin pa gang yin pa // de ni de bas bsod nams mang por 'gyur // gang zhig me tog gcig tsam 'thor byed cing //	86.09541893882738
yaH ca api ekam kzipayeta puzpam vastram ca mAlyam ca vilepanam taTA	gos dang phreng ba byug pa de bzhin te //	71.72980026486991
imam samADim caya satkareta na ayam tatas bahu taru puNyu Boti dutt	ting 'dzin 'di la bsnyen bkur byed gyur na // bsod nams tshogs char snga ma de mi 'gyur //	91.80889708127464
yaH ca api kArzApaNu dAnu dadyAH imasya sUtrasya ca pUjana arTam	gang gis mdo sde 'di la @443a *// mchod pa'i phyir // karsha pa ni'i sbyin pa sbyin byed cing //	79.16728218243128
janitvA boDAya ca mEtra citte ayam tatas bahu taru puNyu prApnuyA	byang chub phyir ni byams pa'i sems bskyed na // de ni de bas bsod nams mang po 'thob // byang chub sems dpa' gang gis sems can la //	90.47652459751131
yaH ca api sattvezu imam samADim prakASaye deSayi boDisattvaH pratipAdaye boDim anuttare taTA upamA api puNyaMpi na tasya Boti	ting 'dzin 'di bshad lung phog de bzhin du //	43.517955936766214
imam ca SrutvA taTaH AnuSaMsAH kRtvA ca mEtram taTa sarva sattvEH	bla med byang chub phyir ni bkod gyur na // de yi bsod nams dper yang mi bzod 'gyur; ;de ltas phan yon 'di dag thos nas kyang // sems can kun la de bzhin byams byas te //	82.38641084879946
dutt tasma api sUtram imu DArayeta liKeta vAceta taTA prakASaye	mdo 'di gzung zhing yi ger bri bar bya // bklag par bya zhing de bzhin bshad par bya; ;rga dang de bzhin na 'chis gnod gyur cing //	78.27611317788863
jarA vyADi mRtyuBiH taTA ati tIvrEH SatEH ca duHKEH paripIxitAH ca	sdug bsngal rab drag brgya yis yongs gdungs la //	73.33805032045275
upapadyamAnAH narakezu pretayaH mA paSca kAle parIta apyu BezyaTa	sems dmyal yi dvags rnams su skye ba na // phyi ma'i dus na 'gyod par gyur ta re //	78.53164450883084
sa mRtyu kAle Baya BIta mAnasaH aBIkzNam ucCvAsanam ucCvasantaH	'chi ba'i dus na yid skrag 'jigs gyur la //	70.78888976373054
kosma aBi trANam Bavate parAyaNam muKe muKam prekzati bAla budDiH dutt	yang dang yang du sngam pa 'dod byed cing // bdag gi dpung gnyen skyabs su 'gyur ba zhes // byis pa'i blo can phan tshun rtog ga re //	77.61413064105123
yasmE taTAgatam aBipUjayitvA bOdDam ca Darmam taTa sAMGi kaQca	gang phyir de bzhin gshegs pa ma mchod cing // sangs rgyas chos dang dge 'dun nor 'phrog pa //	80.20184313026554
harizya nezye yama loki dAruNe na tasya trANam sada kaSci Bezyati	mi zad gshin rje'i 'jig rten khrid 'gyur zhing // phyin chad rtag tu skyabs 'gyur 'ga' yang med //	86.17969605962307
na putra dAram na ca mitra bAnDavAn na ca api rAzwram na ca hAsyalAsyam	bu smad yod min nye du rtsa lag med // yul 'khor yod min bzhad gad 'jo sgeg med //	74.69523021047384
Danam na DAnyam na ca vastra BUzaNam sarvam jahitvA puna duHKa dAruNam	nor dang 'bru dang de bzhin gos dang rgyan // @443b kun spangs sdug bsngal yang dang yang mi zad // ting 'dzin 'di la dad par ma byas pas //	78.94158551293012
imam samADim na ca SraddaDitvA taTA ca duHKaMdAruNam vedayate	de 'dra'i sdug bsngal mi zad myong 'gyur bas //	65.82882173440872
dutt ima duHKu SrutvA imu AnuSaMsAH kaH bAla budDiH na jane prasAdam	sdug bsngal 'di dang phan yon de thos na // byis pa'i blo yang su zhig dad mi skyed //	87.34165851158345
tasmAt ca tEH hi sada Bikzu BikzuNI upAsa kopAsika rAjaBiH sadA	de phyir rtag tu dge slong pha ma dang // dge bsnyen rnams dang rgyal pos khor zug dang // mdo sde 'di ni rtag tu gzung bya zhing //	78.19178357841653
imam ca sUtram sadaH DArayitvA satkAru nityam ca kartavya DArake	'dzin pa la yang rtag tu bsnyen bkur bya //	76.98901525935389
aTa AyuzmAn AnandaH Bagavantam etat avocat	de nas bcom ldan 'das la tshe dang ldan pa kun dga' bos 'di skad ces gsol to // bcom ldan 'das /	95.30739711840364
udgRhItam mayA Bagavan imam Darma paryAyam SAstR saMjQayA DArayizyAmi pUjayizyAmi sarva sattveByaH saMprakASayizyAmi	bdag gis chos kyi rnam grangs 'di gzung lags te / ston pa'i 'du shes kyis bcang bar bgyi zhing sems can thams cad la yang dag par bstan par bgyi lags so //	86.37193714547983
BagavAn Aha	bcom ldan 'das kyis bka' stsal pa /	94.66379267828805
yadi tvam Ananda yat mayA DarmaH BAzitaH SrutaH DArayitum tat sarvam na DAraye na	kun dga' bo; gal te khyod kyis ngas chos gang bstan pa mnyan te kun bzung ba de dag thams cad 'phang bar mi byed / klog par mi byed / rgyas par mi byed kyang /	78.90825896363603
vAcaye na pUjaye na vEstArikIkuryA tvayA mama na aparADye na ca aSuSrUzA kRtA Bave na ca ASrAvaka tvam	des ni khyod kyis nga la nyes pa byas par mi 'gyur zhing gus par ma mnyan par yang mi 'gyur la / nyan thos nyid ma yin par yang mi 'gyur gyi /	82.81015893656915
yaH ca imam Darma paryAya na DAraye dutt	chos kyi rnam grangs 'di 'chang par mi byed / klog par mi byed /	69.42438915612256
na vAcaye na pUjaye na saMprakASaye na manasikuryA sa mAm aparADye aSuSrUzA kRtA Bave aSrAvaka tvam Bave	mchod par mi byed / yang dag par ston par mi byed / yid la mi byed na ni des na khyod kyis nga la nyes pa byas par 'gyur zhing gus par ma mnyan par yang 'gyur la / nyan thos @444a *// nyid yin par yang mi 'gyur ro //	77.89093536851416
tasmAt tarhi tvam Ananda satkRtya ayam Darma paryAyaH DArayitavyaH	kun dga' bo / de lta bas na / khyod kyis phu dud byas te chos kyi rnam grangs 'di bcang bar bya'o //	88.41651544169066
ayam te taTAgatasya anuttara samyaksaMboDa taTAgata kRtyam karizyati paScime kAle paScime samaye sarva sattvAnAm asmin Kalu punar Darma paryAye BagavatA BAzyamANe zazwInAm prANi sahasrANAm anupAdAya AsraveByaH cittAni vimuktAni saptAnAm SatAnAm boBUt	d'i ni phyi ma'i dus phyi ma'i tshe na sems can thams cad la de bzhin gshegs pa'i bla na med pa yang dag par rdzogs pa'i byang chub kyis de bzhin gshegs pa'i mdzad pa byed par 'gyur ro // bcom ldan 'das kyis chos kyi rnam grangs 'di bshad pa na srog chags drug khri lan pa med par zag pa rnams las sems rnam par grol lo // // byang chub sems dpa' bdun brgyas ni ting nge 'dzin thob par 'gyur to //	90.02278026989032
paQcAnAm SatAnAm nAnA budDa kzetra vyAkaraNa pratilaMBaH BUt	lnga brgyas ni / sangs rgyas kyi zhing tha dad par skye bar lung bstan pa thob par gyur to //	85.88359088772506
navatInAm prANi sahasrANAm sarva kleSa vinirmuktAH sarva akzaNa apAya durgatayaH prahINAH	srog chags dgu khri ni / nyon mongs pa thams cad las rnam par grol te mi khom pa dang / ngan song dang / ngan 'gro thams cad spangs so //	85.99393982145354
aTa Arya avalokita ISvaraH boDisattvaH mahAsattvaH punar Bagavantam etat avocat	de nas bcom ldan 'das la byang chub sems dpa' sems dpa' chen po 'phags pa spyan ras gzigs dbang phyug gis yang 'di skad ces gsol to // bcom ldan 'das / chos kyi rnam grangs 'di ni /	87.46581694224822
ayam Bagavan Darma paryAyaH paScima kAle paScima samaye tezAm kula putrANAm SrotLNAm DArayitLNAm mAnayitLNAm tezAm ca leKakAnAm taTkarizyati vyAkRtAH te yaTA Ipsitezu nAnA budDa kzetrezu	slad ma'i dus slad ma'i tshe na rigs kyi bu dang / rigs kyi bu mo nyan par bgyid pa dang / 'dzin par bgyid pa dang / ri mor bgyid pa dang / mchod par bgyid pa de dag dang / yi ger 'bri bar bgyid pa de dag @444b la de bzhin gshegs pa'i mdzad pa bgyid par 'gyur te / de dag kyang ji lta bu 'tshal ba'i sangs rgyas kyi zhing tha dad pa dag tu lung bstan / pa lags so //	76.66468187300308
ye ca sattvAH paScime kAle paScimesamaye hAsya nAwya gIta vAditezu nAnA vyAkzepa bahulA	slad ma'i dus slad ma'i tshe na sems can gang bzhad gad dang / 'jo sgeg dang / gar dang / bro dang / glu dang / rol mo'i sgra dag la sna tshogs su g-yang ba /	83.90094883278664
rAga dveza moha anDA rati krIxA saMjQinaH anitye nitya saMjQinaH IrzyA mAtsarya dOHSIlya parigRhItA	'dod chags dang / zhe sdang dang / gti mug gi mun pa che ba / rtsed mo la dga' bar 'du shes pa / mi rtag pa la rtag par 'du shes pa / phrag dog dang / ser snas yongs su zin cing / mchod par mi bgyid / ri mor mi bgyid / dad par mi bgyid /	79.52072542456482
na pUjayizyanti na mAnayizyanti na SradDAsyanti na pattIyizyanti na DArayizyanti	glo ba chos par mi bgyid / 'chang bar mi bgyid / klog par mi bgyid /	76.0590426575098
na Srozyanti na pratipattyA pratipatsyante	nyan par mi bgyid / nan tan gyis sgrub par mi bgyid pa de dag ni ngal ba 'di yid byung bar bgyis shing /	68.52312682468022
te tam pUrva karma SuBa Palam parikzepam kRtvA nAnA duHKa dOrmanasyam dutt nArakam duHKam anuBavizyanti	sngon gyi las kyi 'bras bu de yongs su bas par bgyis nas sdug bsngal ba yid mi bde ba sna tshogs dang /	81.72994092101753
tatas te anekAni kalpa kowI SatAni duHKam anuBavitvA naraka tiryagyoni yama lokezu vA upapatsyante	sems can dmyal ba'i sdug bsngal dag nyams su myong bar 'gyur zhing / de'ang bskal pa bye ba brgya phrag du mar sdug bsngal nyams su myong nas yang slar sems can dmyal ba dang / dud 'gro'i skye gnas dang / gshin rje'i 'jig rten rnams su skye bar 'gyur lags te /	85.31286126277723
dIrGa rAtram akalyANa mitra vaSAH paSca anutApinaH Bavizyanti imam kzaNam virAgayitvA	mi dge ba'i bshes gnyen gyi dbang gis yun ring por rjes su 'gyod par 'gyur lags so //	73.90635525973083
tasmAt tarhi kAya vAc manaH saMvareNa Bavitavyam	de lta lags pas na / lus dang / @445a *// ngag dang / yid legs par bsdam par bgyi zhing / sangs rgyas dang / chos dang / dge 'dun dag la'ang dad pa mi phyed par bgyi /	64.25031266124083
budDa Darma saMGea Bedya prasAdena sarva sattvezu mEtra cittena IrzyA mAtsarya dOHSIlya citta parivarjitena kroDa parivarjitena Bavitavyam aTa sA yaTAsamAgatA parza tEH tEH puNya aBisaMskArEH taTAgatam pUjayati sma	sems can thams cad la'ang byams pa'i sems dang / phrag dog dang / ser sna dang / 'chal ba'i tshul khrims yongs su spangs pa'i sems dang / khro ba yongs su spangs pa'i sems su bgyi lags so; ;de nas ji ltar lhags pa'i 'khor de dag gis rang rang gi bsod nams mngon par 'du bya ba dag gis de bzhin gshegs pa la lha'i me tog dang /	84.7842924296743
divya puzpa ganDa mAlya vilepana vastra ABaraNEH kili kili prakzvexita SabdEH ca divya tUrya tAxA vacara saMgIteH sADu kAram pradadO	bdug spos dang / spos dang / me tog phreng dang / byug pa dang / na bza' dang / rgyan dag dang / aa la la zhes ca co dang / gzha'i sgra dag dang / lha'i sil snyan dang / pheg rdob pa dang / glu dbyangs dag gi mchod pa byas nas / lags so zhes bya ba gsol te / bcom ldan 'das /	84.05071637755134
tat yaTA sADu sADu Bagavan suBAzitam idam mahA Darma paryAyam sarva sattvAnAm arTAya taTAgata SAsana cira sTiti arTam aTa AyuzmAn AnandaH Bagavantam etat avocat	legs so // legs so // sems can thams cad kyi don dang / de bzhin gshegs pa'i bstan pa yun ring du gnas par bgyi pa'i slad du chos kyi rnam grangs chen po 'di shin tu legs par bka' stsal lags so // de nas bcom ldan 'das la tshe dang ldan pa kun dga' bos 'di skad ces gsol to //	89.71069576635006
kiMnAma ayam Bagavan Darma paryAyaH kaTam ca vayam Bagavan DArayAmaH	bcom ldan 'das / chos kyi rnam grangs 'di'i ming ci lags / 'di ji ltar gzung bar bgyi /	82.61833091735899
BagavAn Aha	bcom ldan 'das kyis bka' stsal pa / kun dga' po /	94.73278772587679
tasmAt tarhi tvam AnandaH imam Darma paryAyam sarva taTAgata jQAna boDisattva BUmi kramaNam iti api nAma DAraya	de'i phyir khyod @445b kyis chos kyi rnam grangs 'di de bzhin gshegs pa thams cad kyis rjes su gnang ba dang / byang chub sems dpa'i sa gnon pa zhes bya bar yang zungs shig /	88.42038422168909
RdDi vikurvANa mahAtma sannipAtam iti api nAma DAraya	rdzu 'phrul gyi rnam par 'phrul pa 'dus pa chen po zhes bya bar yang zungs shig /	80.12213011666884
sarva taTAgata aDizWAna sattva avalokana budDa kzetrasandarSana vyUham iti api nAma DAraya	de bzhin gshegs pa thams cad kyi byin gyi rlabs sems can la gzigs shing sangs rgyas kyi zhing gi bkod pa kun tu ston pa zhes bya bar yang zungs shig / bcom ldan 'das kyis de skad ces bka' stsal nas 'phags pa spyan ras gzigs dbang phyug zungs shig / dang /	79.27570358223905
idam avocat BagavAn AttamAnAH Arya avalokita ISvara maMju SrI vajrapANi praBRtayaH sarve boDisattvAH mahAsattvAH sarve ca mahA SrAvakAH sarve ca Sakra brahmaldutt mahA rAjAH mahA yakziNyaH anOpamyAH vimala praBA praBAvatI BIma aSrI SaMKinI haritA mahAdevI praBRtayaH deva nAga yakza ganDarva asura garuxa kinnar	'jam dpal dang / lag na rdo rje la sogs pa byang chub sems dpa' sems dpa' chen po de dag thams cad dang / nyan thos chen po de dag thams cad dang / brgya byin dang / tshangs pa dang / 'jig rten skyong ba de dag thams cad dang / rgyal po chen po bzhi dang / gnod sbyin chen mo dpe med ma dang / dri med 'od dang / 'od can ma dang / 'jigs byed ma dang / dpal ldan ma dang / dung can ma dang / 'phrog ma la sogs pa de dag dang / lha dang / klu dang / gnod sbyin dang / dri za dang / lha ma yin dang / nam mkha' lding dang / mi 'am ci dang / lto 'phye chen po de dag thams cad dang / thams cad dang ldan pa'i 'khor ji ltar lhags pa de dag dang / dge slong dang / dge slong ma dang / dge bsnyen dang / dge bsnyen ma'i 'khor rnams yi rang ste bcom ldan 'das kyis @446a *//	55.61701389165379
sA ca sarvAvatI parza yaTA samAgatAH BagavataH BAzitam aBinandya sADukAram adAt sADu sADu Bagavan	gsungs pa la mngon par bstod do //	48.129214960324845
	'phags pa de bzhin gshegs pa thams cad kyi byin gyi rlabs sems can la gzigs shing sangs rgyas kyi zhing gi bkod pa kun tu ston pa zhes bya ba theg pa chen po'i mdo rdzogs so //// rgya gar gyi mkhan po dzi na mi tra dang / su rendra bo dhi dang / zhu chen gyi lo tsa ba bandhe ye shes sdes zhus te gtan la phab pa /	48.129214960324845

