skt	tib
 namaḥ sarvajñāya ||	༄༡བ་༅༎ རྒྱ་གར་སྐད་དུ་། པྲ་ཏི་མོཀཤ་སའུ་ཏྲ་། བོད་སྐད་དུ་། སོ་སོ་ཐར་བའི་མདོ་། བམ་པོ་དང་པོ་། ཐམས་ཅད་མཁྱེན་པ་ལ་ཕྱག་འཚལ་ལོ་༎ སྙན་པའི་བ་དན་འཇིག་རྟེན་གསུམ་དུ་གྲགས་༎ དམ་པའི་ཆོས་སྒྲ་སེང་གེའི་སྒྲ་བསྒྲགས་པ་༎ ཐམས་ཅད་མཁྱེན་པ་དཀོན་མཆོག་མཛོད་བརྙེས་པ་༎ ཞབས་ལ་ཚངས་དབང་གཙུག་གི་༄༢ཨ་༅༎ ནོར་བུས་གཏུགས་༎
 praṇamya pūrvaṃ jagati pradhānaṃ duḥkhālayottīrṇam anantapāram* |	སྡུག་བསྔལ་རྒྱ་མཚོ་གཏིང་མཐའ་མེད་རྒལ་བ་༎ འགྲོ་བའི་གཙོ་ལ་སྤྱི་བོས་ཕྱག་འཚལ་ཏེ་༎
 sarvajñaśikṣāpadaratnakośam udghāṭayāmy āryagaṇasya madhye || 1 ||	ཐམས་ཅད་མཁྱེན་པའི་བསླབ་གཞི་དཀོན་མཆོག་སྣོད་༎ འཕགས་པའི་ཚོགས་ཀྱི་དབུས་སུ་དབྱེ་བར་བྱ་༎
 trailokyavikhyātayaśaḥpatākaṃ saddharmanādoditasiṃhanādam* |	སངས་རྒྱས་འདུལ་བ་གངས་ཆེན་མཚོ་༎
 sarvaṃ kaṣāsāditaratnakośaṃ brahmāṇḍacūḍāmaṇighṛṣṭapādam* || 2 || kṛtsnasyāgādhapārasya bauddhasya vinayodadheḥ |	གཏིང་མཐའ་མེད་པ་ཐམས་ཅད་ཀྱི་༎
 pratiṣṭhāhṛdayaṃ sāraṃ prātimokṣo 'yam ucyate || 3 ||	གནས་པའི་སྙིང་དང་སྙིང་པོ་ནི་༎ སོ་སོར་ཐར་པ་འདི་ཡིན་ནོ༏་༏འདི་ནི་དམ་ཆོས་རྒྱལ་པོ་ཡི་༎
 eṣa saddharmarājasya saddharmālekhyasaṃgrahaḥ |	ཆོས་ཀུན་གྱི་ནི་འདྲེན་པ་མཆོག་།
 eṣa bhikṣuvaṇiggrāmaḥ śikṣāpaṇyamahāpaṇaḥ || 4 ||	འདི་ནི་དགེ་སློང་ཚོང་ཚོགས་ཀྱི་༎ བསླབ་ཟོང་ཚོང་ཁང་ཆེན་པོ་ཡིན་༎
 eṣa dauḥśīlyaduṣṭānāṃ viṣaviṣkambhaṇo 'gadaḥ |	ཚུལ་ཁྲིམས་འཆལ་བས་ཟིན་རྣམས་ཀྱི་༎ གདུག་པ་རྣམ་སེལ་སྨན་འདི་ཡིན་༎
 eṣa yauvanavibhrāntakumāradvipadāṅkuśaḥ || 5 ||	འདི་ནི་ལང་ཚོས་རྣམ་འཁྲུལ་༄༢བ་བའི༏་༏རྐང་གཉིས་གཞོན་ནུའི་ལྕགས་ཀྱུ་ཡིན་༎
 eṣa sāgaragambhīrasaṃsārottaraṇaplavaḥ |	མཚོ་བས་ཟབ་པའི་འཁོར་བ་ལས་༎ སྒྲོལ་བའི་རྒལ་ཐབས་འདི་ཡིན་ཏེ་༎ འདི་ནི་བཟང་འགྲོར་འགྲོ་བ་ཡི་༎ ངེས་པའི་ཆུ་ལོན་ཟམ་པ་ཡིན་༎
 eṣa kleśajayo mārgo nṛpater agranāyakaḥ || 6 ||	འདི་ནི་ཉོན་མོངས་ཕམ་བྱེད་ལམ་༎ རྒྱལ་པོ་ཡི་ནི་འདྲེན་པ་མཆོག་།
 eṣa mokṣapurārohe mūlasopānavat sthitaḥ |	འདི་ནི་ཐར་པའི་གྲོང་འཇུག་པའི་༎ ཐེམ་སྐས་གཞི་དང་འདྲ་བར་གནས་༎ ང་ནི་མྱ་ངན་འདས་གྱུར་ན་༎
 nirvṛte mayi yuṣmākam eṣa śāstety abhiṣṭutaḥ || 7 ||	འདི་ནི་ཁྱེད་ཀྱི་སྟོན་པ་ཞེས་༎ རང་བྱུང་ཉིད་ཀྱིས་གུས་བཅས་པ༏་༏ནན་ཏན་དགེ་སློང་ཚོགས་མདུན་བསྟོད་༎ སངས་རྒྱས་ཞེས་བྱའི་སྒྲ་འདི་ཡང་༎ འཇིག་རྟེན་དག་ན་རབ་ཏུ་དཀོན་༎ མི་ཉིད་རྙེད་པ་ཤིན་ཏུ་དཀའ༎ རབ་ཏུ་བྱུང་བ་ཤིན་ཏུ་དཀོན་༎ དེ་བཞིན་རབ་ཏུ་བྱུང་རྣམས་ཀྱི་༎ ཚུལ་ཁྲིམས་ཕུན་ཚོགས་རབ་ཏུ་དཀོན་༎ ཚུལ་ཁྲིམས་ཡོངས་སུ་དག་གྱུར་ཀྱང་༎ གྲོགས་བཟང་ཤིན་ཏུ་རྙེད་པར་དཀའ༎ འཇིག་རྟེན་སངས་རྒྱས་འབྱུང་བ་དང་༎ མི་དང་རབ་ཏུ་བྱུང་བ་དང་༎ ཚུལ་ཁྲིམས་ཕུན་སུམ་༄༣ཨ་༌༎ ཚོགས་པ་དང་༎ གྲོགས་བཟངས་རྙེད་དཀའ་རྙེད་གྱུར་ནས་༎
 svayaṃ + + + + + kṣumamakṣam caiva yatnataḥ | nihatākṣaḥ samantaḥ + + + + + + + + + || + + + + + + + + + + naibhyaty adīkṣitaiḥ |	མཁས་པ་བདག་ལ་ལེགས་འདོད་ཅིང་༎ དེ་དག་འབྲས་བཅས་བྱེད་འདོད་པའི་༎ སྡོམ་བརྩོན་རྣམས་ཀྱིས་སོ་སོར་ཐར་༎ མཉན་པའི་ཕྱིར་ནི་འབད་པར་བྱ་༎ དགེ་སློང་དབང་དུལ་ཀུན་དབང་པོ་༎ སངས་རྒྱས་མི་འགྱུར་རབ་བྱུང་བ་༎
 prātimokṣaḥ sadā rakṣo bhikṣubhir nirmumukṣubhiḥ || jita pravṛtte 'py ahitāya + + + + + + + | kṛtopakāre 'py apakartumīhate + + + + + ||	ངེས་པར་ཐར་པ་འདོད་རྣམས་ཀྱིས་༎ སོ་སོར་ཐར་པ་རྟག་ཏུ་བསྲུངས་༎
 prātimokṣasya śravaṇaṃ durlabhaṃ kalpakoṭibhiḥ |	བསྐལ་པ་བྱེ་བ་རྣམས་སུ་ཡང་༎ སོ་སོར་ཐར་པ་ཐོས་པ་དང་༎ གཟུང་དང་འཛིན་པ་རྙེད་དཀའ་སྟེ་༎
 grahaṇaṃ dharaṇaṃ caivatipattiḥ sudurlabhā || 8 ||	བསྒྲུབས་པའང་ཤིན་ཏུ་རྙེད་པར་དཀའ༎
 buddhānāṃ sukham utpādaḥ sukhā dharmasya dhīṣaṇā	སངས་རྒྱས་རྣམས་ནི་འབྱུང་བ་བདེ་༎ ཆོས་བསྟན་པ་ཡང་བདེ་བ་ཡིན་༎
 sukhā saṃghasya sāmagrī śramaṇānāṃ tapaḥ sukham* || 9 ||	དགེ་འདུན་མཐུན་པ་བདེ་བ་སྟེ་༎ མཐུན་པ་རྣམས་ཀྱི་དཀའ་ཐུབ་བདེ་༎
 sukhaṃ darśanam āryāṇāṃ saṃvāso 'pi satā sukhaḥ |	འཕགས་པ་རྣམས་ནི་མཐོང་བ་བདེ་༎ དམ་པ་དག་དང་འགྲོགས་པ་བདེ་༎
 adarśanena bālānāṃ nityam eva sukhaṃ bhavet* || 10 ||	བྱིས་པ་རྣམས་ནི་མ་མཐོང་ན་༎ རྟག་ཏུ་བདེ་བ་ཉིད་དུ་འགྱུར་༎ ཚུལ་ཁྲིམས་ལྡན་པ་མཐོང་བ་བདེ་༎
 sukhaṃ dṛṣṭāḥ śīlavantaḥ sukhaṃ dṛṣṭā bahuśrutāḥ |	མང་དུ་ཐོས་པ་མཐོང་བ་བདེ་༎ ༄༣བ་ཡང་སྲིད་རྣམ་པར་གྲོལ་བ་ཡི་༎
 arhantaś ca sukhaṃ dṛṣṭā vipramuktapunarbhavāḥ || 11 ||	དགྲ་བཅོམ་པ་དག་མཐོང་བ་བདེ་༎
 sukhā nadī sukhaṃ tīrthaṃ sukhaṃ dharmajito jataḥ |	འཇུག་ངོགས་བདེ་བའི་ཆུ་ཀླུང་བདེ་༎ ཆོས་ལ་གོམས་པའི་སྐྱེ་བོ་བདེ་༎
 sukhaṃ prajñāpratilaṃbho hy asmimānakṣayaḥ sukham* || 12 ||	ཤེས་རབ་ཐོབ་པར་འགྱུར་བ་བདེ་༎ ངའོ་ང་རྒྱལ་ཟད་པ་བདེ་༎
 sukho hi vāsaḥ kṛtaniścayānāṃ jitendriyāṇāṃ ca bahuśrutānām* |	ངེས་པར་བྱས་ཤིང་དབང་པོ་ཐུལ་བ་དག་།
 śānteṣv araṇyeṣu jarāṃ gatānāṃ vaneṣu nirvāpitayauvanānām* || 13 ||	དགོན་བཞི་བ་རྣམས་སུ་རྒས་གྱུར་དང་༎ མང་དུ་ཐོས་པ་ནགས་ཀྱི་ནང་དག་ཏུ་༎ ལང་ཚོ་ཡོལ་བ་རྣམས་ཀྱིས་གནས་པ་བདེ་༎
 nirgatam āyuṣmanto grīṣmāṇāṃ yāvat tāvad avaśiṣṭam* |	ཚེ་དང་ལྡན་པ་དག་སོག་རྣམས་ཀྱི་འདས་པ་དང་། ལྷག་མ་ཇི་ཙམ་པ་། དེ་ཙམ་མོ་༎ ཚེ་དང་ལྡན་པ་དག་།
 atikrāmati āyuḥ āgataṃ jarāmaraṇam* | pralaṅghyate śāstuḥ śāsanam (prmosū_mū-banerjee 6)	རྒ་བ་དང་འཆི་བ་མངོན་པར་འོང་ཞིང་།
 apramādena āuṣmadbhir yogaḥ karaṇīyaḥ |	སྟོན་པའི་བསྟན་པ་ཡང་འཇིག་པར་འགྱུར་བས༏་ཚེ་དང་ལྡན་པ་དག་གིས་བག་ཡོད་པས་རྣལ་འབྱོར་དུ་བྱའོ་༎ 
 apramādādhigatāhi tathāgatānām arhatāṃ samyaksaṃbuddhānāṃ bodhir iti vā apy evaṃbhāgīyāḥ kuśalā dharmā bodhipakṣyāḥ |	དེ་བཞིན་གཤེགས་པ་དགྲ་བཅོམ་པ་ཡང་དག་པར་རྫོགས་པའི་སངས་རྒྱས་རྣམས་ཀྱི་བྱང་དུ་བྱའོ་༎ ཆུབ་དང་། གཞན་ཡང་གང་དག་དེ་ལྟ་བུ་དང་མཐུན་པ་། དགེ་བའི་ཆོས་བྱང་ཆུབ་ཀྱི་ཕྱོགས་རྣམས་ཀྱང་བག་ཡོད་པས་འཐོབ་བོ་༎
 kiṃ bhagavataḥ śrāvakasaṃghasya pūrvakālakaraṇīyam alpo 'rtho 'lpakṛtyam* |	བཅོམ་ལྡན་འདས་ཀྱི་ཉན་ཐོས་ཀྱི་དགེ་འདུན་ནི་དོན་ཉུང་བ་། བྱ་བ་ཉུང་བ་ཡིན་པས་། དགེ་འདུན་གྱིས་ཐོག་མར་བྱ་བ་ཅི་ཡོད་།
 anāgatānām āyuṣmantaś chandapariśuddhiṃ cārocayata ārocitāṃ ca pravedayata |	ཚེ་དང་ལྡན་པ་དག་མ་ལྷགས་པ་རྣམས་ལ་འདུན་པ་དང་ཡོངས་སུ་དག་པ་དྲིས་ཤིག་། དྲིས་ནས་ཀྱང་བརྗོད་པར་བྱའོ་༎
 praṇamya śākyasiṃhāya bhūtvā hy asmai kṛtāṃjaliḥ |	ཤའཀྱ་སེངགེ་དེ་ལ་ནི་༎ སོར་མོ་བཅུ་ཡི་ཐལ་སྦྱར་ཏེ་༎
 prātimokṣaṃ pravakṣyāmi vinayaṃ tac chṛṇotu naḥ || 14 ||	སོ་སོར་ཐར་པ་གདོན་བར་བྱ་༎ གདུལ་བའི་དོན་དུ་ང་ལས་ཉོན་༎
 śrutvā ca tat karotv atra yathā proktaṃ maharṣiṇā |	ཐོས་ནས་དྲང་སྲོང་ཆེན་པོ་ཡིས་༎ ཇི་སྐད་གསུངས་བཞིན་བསྒྲུབས་བྱ་ཞིང་༎ ཁ་ན་མ་ཐོ་ཕྲ་རྣམས་༄༤ཨ་༌༎
 aṇumātreṣv avadyeṣu bhavatā yatnakāriṇā || 15 ||	ལ༏་༏རྟུན་ཅིང་བྱེད་པ་ཉིད་དུ་གྱིས་༎ རྟག་ཏུ་འབད་པས་འདའ་བ་ཡི་༎
 yatnād drutaṃ satataṃ yaś ca cittahayaṃ mukhavacaneṣu anusārayati |	སེམས་རྟ་ཁ་བླན་དཀའ་བ་ལ་༎
 prātimokṣakhalīnam api sadṛśaṃ śatakaṇṭakaṃ tīkṣṇaṃ yenātividhyate || 16 ||	མཐུན་པའི་གཟེར་རྣོན་བརྒྱབ་པ་ཡི་༎ སྲབ་ནི་སོ་སོར་ཐར་འདི་ཡིན་༎
 mahātmanaḥ ye vacanamātreṇa yathābhāgān na nivartante |	ཆེ་བ་གང་དག་ངག་ཙམ་གྱིས་༎ ལྡོག་ཅིང་མཚམས་ལས་མི་འདའ་བ་༎
 puruṣaturagās te khalu kleśaraṇajayino bhaviṣyanti || 17 ||	དེ་དག་མི་རྟ་བཟང་པོ་ཡི་༎ ཉོན་མོངས་ག-ཡུལ་ལས་ངེས་རྒྱལ་འགྱུར་༎
 yeṣāṃ tu khalīnam idaṃ na vidyate nāpi antaḥkāmaṃ |	སུ་ལ་སྲབ་འདི་མེད་པ་དང༏་༏ནང་དུའང་འདོད་པར་མི་འགྱུར་བ་༎
 te tu kleśaraṇavimathyatā uddāmā vibhramiṣyanti || 19 ||	དེ་དག་ཉོན་མོངས་ག-ཡུལ་གྱིས་དཀྲུགས་༎ འཇོག་བྲལ་རྣམ་པར་འཁྱམ་པར་འགྱུར་༎
 śṛṇotu bhadantaḥ saṃghaḥ adya saṃghasya poṣadhaḥ cāturdaśikaḥ pāṃcadaśiko vā (prmosū_mū-banerjee 7)	དགེ་འདུན་བཙུན་པ་རྣམས་གསན་དུ་གསོལ་། དེང་དགེ་འདུན་གྱི་གསོ་སྦྱོང་བཅུ་བཞི་པའམ་བཅོ་ལྔ་པ་སྟེ་།
 sacet saṃghasya prāptakālaṃ kṣametānujānīyāt saṃgho yat saṃghasya poṣadhaṃ kuryāt prātimokṣasūtroddeśam uddeśayed eṣā jñaptiḥ |	གལ་ཏེ་དགེ་འདུན་གྱིས་དུས་ལ་བབ་ཅིང་བཟོད་ན་། དགེ་འདུན་གྱིས་གནང་བར་མཛོད་ཅིག་དང་། དེང་དགེ་འདུན་གསོ་སྦྱོང་མཛད་དེ་། སོ་སོར་ཐར་པའི་མདོ་གདོན་པ་གདོན་ནོ་༎ འདི་ནི་གསོལ་བའོ་༎
 poṣadhaṃ vayam āyuṣman kariṣyāmaḥ prātimokṣasūtroddeśam uddeśāmaḥ |	ཚེ་དང་ལྡན་པ་དག་བདག་ཅག་གསོ་སྦྱོང་བྱ་སྟེ་། སོ་སོར་ཐར་པའི་མདོ་གདོན་པ་གདོན་གྱིས་།
 yasya syāt āpattiḥ tena āviṣkartavyā | āpattyāṃ asatyāṃ tūṣṇīṃ bhavitavyam* |	ཁྱེད་ཅག་སུ་ལ་ལྟུང་བ་ཡོད་པ་དེས་མཐོལ་ཅིག་། ལྟུང་བ་མེད་ན་ཅང་མ་སྨྲ་ཞིག་།
 tūṣṇīṃbhāvena ca vayam āyuṣmataḥ pariśuddhān vedayiṣyāmaḥ |	ཅང་མི་སྨྲ་ན་བདག་གིས་ཚེ་དང་ལྡན་པ་དག་ཡོངས་སུ་དག་པར་རིག་པར་བྱའོ་༎
 yathāpi pratyekaṃ pṛṣṭasya bhikṣor vyākaraṇaṃ bhavati evam evaṃ evaṃrūpāyāṃ bhikṣuparṣadi yāvat trir apy anuśrāvaṇaṃ bhavati |	ཇི་ལྟར་སོ་སོར་དྲིས་ནས་དགེ་སློང་གིས་ལན་བཏབ་པ་དེ་བཞིན་དུ་དགེ་སློང་གི་འཁོར་འདི་ལྟ་བུ་ཡང་། ལན་གསུམ་གྱི་བར་དུ་བསྒྲག་པར་བྱ་བ་ཡིན་ནོ་༎
 yaḥ punar bhikṣur evaṃrūpāyāṃ bhikṣuparṣadi yāvat trir apy anuśrāvyamāne smaran satīm āpattiṃ nāviṣkaroti saṃprajānan mṛṣāvādo 'sya bhavati	ཡང་དགེ་སློང་གང་། དགེ་སློང་གི་འཁོར་འདི་ལྟ་བུར་ལན་གསུམ་༄༤བ་གྱི་བར་དུ་བསྒྲགས་པ་ན་། ལྟུང་བ་ཡོད་པ་ལ་དྲན་བཞིན་དུ་མི་མཐོལ་ན་། དེ་ཤེས་བཞིན་དུ་རྫུན་དུ་སྨྲ་བ་ཡིན་ནོ་༎
 saṃprajānan mṛṣāvādaḥ khalv āyuṣmantaḥ antarāyiko dharma ukto bhagavatā |	ཚེ་དང་ལྡན་པ་དག་ཤེས་བཞིན་དུ་རྫུན་དུ་སྨྲ་བ་ནི་། བཅོམ་ལྡན་འདས་ཀྱིས་བར་དུ་གཅོད་པའི་ཆོས་སུ་གསུངས་སོ་༎
 tasmāt smaratā bhikṣuṇā āpannena viśuddhāpekṣeṇa satī āpattir āviṣkartavyā |	དེ་བས་ན་དགེ་སློང་གང་ལྟུང་བ་བྱུང་བ་རྣམ་པར་དག་པར་འདོད་པས་། ལྟུང་བ་ཡོད་ལ་དྲན་ཞིང་མཐོང་བ་མཐོལ་བར་བྱའོ་༎ མཐོལ་ནས་དེ་བདེ་བ་ལ་རེག་པར་གནས་པར་འགྱུར་རོ་༎
 āviṣkṛtenāsya phāsu bhavati nāviṣkṛtena na bhavati |	མ་མཐོལ་མ་བཤགས་ན་ནི་མི་འགྱུར་རོ་༎
 uddiṣṭaṃ khalu mayāyuṣmantaḥ prātimokṣasūtroddeśanidānam* |	ཚེ་དང་ལྡན་པ་དག་བདག་གིས་སོ་སོར་ཐར་པའི་མདོ་གདོན་པའི་གླེང་གཞི་བཏོན་ཟིན་ཏོ་༎
 tatrāyuṣmataḥ pṛcchāmi -- kaccit sthātra pariśuddhāḥ dvir api trir api pṛcchāmi -- kaccit sthātra pariśuddhāḥ	དེ་ལ་བདག་གིས་ཚེ་དང་ལྡན་པ་དག་ལ་ཅི་འདི་ལ་ཁྱེད་ཡོངས་སུ་དག་གམ་ཞེས་དྲིའོ་༎ ཅི་འདི་ལ་ཁྱེད་ཡོངས་སུ་དག་གམ་ཞེས་ལན་གཉིས་ལན་གསུམ་དུ་དྲིའོ་༎ འདི་ལ་ཚེ་དང་ལྡན་པ་དག་ཡོངས་སུ་དག་ན་།
 atrāyuṣmanto yasmāt tūṣṇīm evam etad dhārayāmi |	འདི་ལྟར་ཅང་མི་སྨྲ་བས་དེ་དེ་བཞིན་དུ་འཛིན་ཏོ་༎ སྡོམ་ལ་། མི་ཚངས་སྤྱོད་དང་རྐུ་བ་དང་༎ མི་ལ་གསད་པར་མི་བྱ་བ་༎ རྫུན་དུ་སྨྲ་དང་བཅས་པ་ཡི་༎
 catvāraḥ pārājikā dharmāḥ |	ཆོས་བཞི་འདིར་ནི་གསུངས་པ་ཡིན་༎
 ime khalu āyuṣmantaś catvāraḥ pārājikā dharmā anvardhamāsaṃ prātimokṣasūtroddeśam āgacchanti | pār|1 (prmosū_mū-banerjee)	ཚེ་དང་ལྡན་པ་དག་ཕམ་པར་འགྱུར་བའི་ཆོས་བཞི་པོ་འདི་དག་ནི་། ཟླ་བ་ཕྱེད་ཕྱེད་ཅིང་སོ་སོར་ཐར་པའི་མདོ་གདོན་པ་ལས་འབྱུང་ངོ་༎
 yaḥ punar bhikṣur bhikṣūṇāṃ śikṣāsājīvasamāpannaḥ śikṣām apratyākhyāya śikṣādaurbalyam anāviṣkṛtyābrahmacaryaṃ maithunaṃ dharmaṃ pratisevate antatas tiryagyonigatayāpi sārdhaṃ,	ཡང་དགེ་སློང་གང་དགེ་སློང་རྣམས་དང་ལྷན་ཅིག་བསླབ་པ་མཚུངས་པར་གྱུར་པས་། བསླབ་པ་མ་ཕུལ་བསླབ་པ་ཉམས་པར་མ་བྱས་པར་། མི་ཚངས་པར་སྤྱོད་པ་འཁྲིག་པ་ལས་བྱུང་བའི་ཆོས་བརྟེན་ན་ཐ་ན་དུད་འགྲོའི་སྐྱེ་གནས་སུ་༄༥ཨ་༌༎ སྐྱེས་པ་དང་ལྷན་ཅིག་ཀྱང་རུང་སྟེ་།
 ayam api bhikṣuḥ pārājiko bhavaty asaṃvāsyaḥ | pār|2 (prmosū_mū-banerjee)	དགེ་སློང་དེ་ཕམ་པར་གྱུར་པ་ཡིན་གྱིས་། གནས་པར་མི་བྱའོ་༎
 yaḥ punar bhikṣur grāmagatam araṇyagataṃ vā pareṣāṃ adattaṃ steyasaṃkhyātam ādadīta	ཡང་དགེ་སློང་གང་གཞན་དག་གི་གྲོང་ན་འདུག་པའམ་།
 yadrūpeṇādattādānena rājā vainaṃ gṛhītvā rājamātro vā hanyād vā saṃbadhnīyād vā pravāsayed	དགོན་པ་ན་འདུག་པ་མ་བྱིན་པ་རྐུ་བའི་གྲངས་སུ་གཏོགས་པ་བླངས་ན་ཅི་ཙམ་མ་བྱིན་པར་བླངས་པ་དེ་རྒྱལ་པོའམ་། བློན་པོ་ཆེན་པོས་བཟུང་ནས་།
 vā evaṃ cainaṃ vadet* -- tvaṃ bhoḥ puruṣa cauro 'si bālo 'si steno 'sīty evaṃrūpaṃ	དེ་ལ་འདི་སྐད་ཅེས་། ཀྱེ་མི་ཁྱོད་ནི་རྐུན་མའོ་༎ བྱིས་པའོ་༎ བླུན་པའོ་༎ རྐུ་བའོ་ཞེས་ཟེར་ཞིང་གསོད་དམ་། འཆིང་ངམ་། སྤྱུགས་ཀྱང་རུང་སྟེ་།
 adattaṃ bhikṣuḥ ādadita,	དགེ་སློང་དེ་ལྟར་མ་བྱིན་པར་ལེན་ན་།
 ayam api bhikṣuḥ pārājayiko bhavaty asaṃvāsyaḥ | pār|3 (prmosū_mū-banerjee)	དགེ་སློང་དེ་ཡང་ཕམ་པར་གྱུར་པ་ཡིན་གྱིས་། གནས་པར་མི་བྱའོ་༎
 yaḥ punar bhikṣur manuṣyaṃ vā manuṣyavigrahaṃ vā svahastena saṃcintya jīvitād vyaparopayet* |	ཡང་དགེ་སློང་གང་མིའམ་མིར་ཆགས་པ་ལ་བསམ་བཞིན་དུ་རང་གི་ལག་གིས་དར་ཏེ་སྲོག་བཅད་དམ་། དེ་ལ་མཚོན་བྱིན་ནམ་། དེ་ལ་མཚོན་ཐོགས་པ་གཉེར་ཏམ་།
 śastraṃ vainām ādhārayec chastradhārakaṃ vāsya paryeṣeta maraṇāya vainaṃ samādāpayen maraṇavarṇaṃ vāsyānusaṃvarṇayet* |	དེ་འཆིར་བཅུག་གམ་། དེ་ལ་འཆི་བའི་བསྔགས་པ་བརྗོད་ཀྱང་རུང་སྟེ་།
 evaṃ cainaṃ vadet* -- haṃbho puruṣa kiṃ tava pāpakenāśucinā durjīvitena mṛtaṃ te	དེ་ལ་འདི་སྐད་ཅེས་མི་ཁྱོད་འཚོ་བ་སྡིག་པ་། མི་གཙང་བ་ངན་པ་འདིས་ཅི་ཞིག་བྱ་སྟེ་། ཀྱེ་མི་ཁྱོད་གསོན་པ་བས་ཤི་བླའོ་ཞེས་ཟེར་ཞིང་།
 bho puruṣa jīvitād varam iti cintānumataiś cittasaṃkalpair anekaparyāyeṇa maraṇāya	སེམས་ཀྱི་འདོད་པ་དང་། སེམས་ཀྱི་ཀུན་ཏུ་རྟོག་པ་དག་གིས་རྣམ་གྲངས་དུ་མས་དེ་འཆིར་བཅུག་གམ་། དེ་ལ་འཆི་བའི་བསྔགས་པ་བརྗོད་དེ་།
 vainaṃ samādāpayen maraṇavarṇaṃ vāsya anusaṃvarṇayet sa ca tena kālaṃ kuryād ayam	དེ་ཡང་རྩོམ་པ་དེས་དུས་བྱས་ན་།
 api bhikṣuḥ pārājiko bhavaty asaṃvāsyaḥ | pār|4 (prmosū_mū-banerjee)	དགེ་སློང་དེ་ཡང་ཕམ་པར་གྱུར་པ་ཡིན་གྱིས་། གནས་པར་མི་བྱའོ་༎
 yaḥ punar bhikṣur anabhijānann aparijānann asantam asaṃvidyamānam anuttaramanuṣyadharmam	ཡང་དགེ་སློང་གང་མངོན་པར་མི་ཤེས་ཤིང་ཡོངས་སུ་མི་ཤེས་ལ་།
 alamārya viśeṣādhigamaṃ jñānaṃ vā darśanaṃ sparśavihāratāṃ vā pratijānīyād idaṃ jānāmīdaṃ	མིའི་ཆོས་བླ་མ་མཐའ་དང་འཕགས་པ་དང་། བྱེ་༄༥བ་བྲག་ཐོབ་པ་དང་། ཤེས་པ་དང་། མཐོང་བ་དང་། རེག་པར་སྤྱོད་པ་མེད་ལ་། མེད་བཞིན་དུ་འདི་ཤེས་སོ་༎
 paśyāmīti sa pareṇa samayena samanuyujyamāno vā asamanuyujyamāno vā āpanno viśuddhiṃ	འདི་མཐོང་ངོ་ཞེས་ཁས་འཆེས་པ་ལས་དེ་ལྟུང་བ་བྱུང་བ་རྣམ་པར་དག་པར་འདོད་ནས་། དུས་གཞན་ཞིག་ན་དྲིས་ཀྱང་རུང་། མ་དྲིས་ཀྱང་རུང་།
 prakṣyaivaṃ vaded ajānann evāham āyuṣmanto 'vocaṃ jānāmīty apaśyāmīti riktaṃ tucchaṃ	འདི་སྐད་ཅེས་ཚེ་དང་ལྡན་པ་དག་བདག་གིས་ནི་མི་ཤེས་པར་ཤེས་སོ་ཞེས་སྨྲས་། མ་མཐོང་བར་མཐོང་ངོ་ཞེས་སྨྲས་ཏེ་། གསོབ་། གསོག་། རྫུན་དུ་སྨྲས་སོ་ཞེས་ཟེར་ན་། མངོན་པའི་ང་རྒྱལ་མ་གཏོགས་ཏེ་།
 mṛṣāvyapalapanam anyatrābhimānāt* ayam api bhikṣuḥ pārājiko bhavaty asaṃvāsyaḥ |	དགེ་སློང་དེ་ཡང་ཕམ་པར་གྱུར་པ་ཡིན་གྱིས་། གནས་པར་མི་བྱའོ་༎
 uddiṣṭā mayāyuṣmantaś catvāraḥ pārājikā dharmā yeṣāṃ bhikṣur anyatamānyatamam āpattim	ཚེ་དང་ལྡན་པ་དག་བདག་གིས་ཕམ་པར་གྱུར་པའི་ཆོས་བཞི་པོ་དག་བཏོན་ཟིན་ཏོ་༎ དགེ་སློང་གིས་དེ་དག་ལས་ལྟུང་བ་གང་ཡང་རུང་བ་ཞིག་བྱས་ན་།
 adhyāpatya na labhate bhikṣubhiḥ sārdhaṃ saṃvāsaṃ bhogaṃ vā yathāpūrvaṃ ca tathāpaścāt pārājiko bhavaty asaṃvāsyaḥ |	ཐོག་མ་ཇི་ལྟ་བར་ཕྱིས་ཀྱང་དེ་བཞིན་ཕམ་པར་འགྱུར་ཏེ་། དགེ་སློང་རྣམས་དང་ལྷན་ཅིག་གནས་པ་དང༏་ལོངས་སྤྱོད་དུ་མི་དབང་གིས་གནས་པར་མི་བྱའོ་༎
 tatrāham āyuṣmantaḥ paripṛcchāmi -- kaścit sthātra pariśuddhāḥ	དེ་ལ་བདག་གིས་ཚེ་དང་ལྡན་པ་དག་ལ་། ཅི་འདི་ལ་ཁྱེད་ཡོངས་སུ་དག་གམ་ཞེས་དྲིའོ་༎
 dvir api trir api paripṛcchāmi -- kaścit sthātra pariśuddhāḥ	ཅི་འདི་ལ་ཁྱེད་ཡོངས་སུ་དག་གམ་ཞེས་ལན་གཉིས་ལན་གསུམ་དུ་དྲིའོ་༎ འདི་ལ་ཆེ་དང་ལྡན་པ་དག་ཡོངས་སུ་དག་ན་།
 pariśuddhā atrāyuṣmanto yasmāt tūṣṇīm evam etad dhārayāmi |	འདི་ལྟར་ཅང་མི་སྨྲ་བས་དེ་དེ་བཞིན་དུ་འཛིན་ཏོ་༎
 saṃghāvaśeṣā dharmāḥ	སྡོམ་ལ་། ཁུ་བ་འཛིན་པ་འཁྲིག་ཚིག་བསྙེན་བཀུར་སྨྱན་༎ ཁང་པ་ཁང་ཆེན་དང་ནི་གཞི་མེད་པ་༎ བག་ཙམ་དགེ་འདུན་དབྱེན་དང་དེ་རྗེས་ཕྱོགས་༎ ཁྱིམ་སུན་འབྱིན་དང་བཀའ་བློ་མི་བདེ་བའོ་༎
 ime khalv āyuṣmantas trayodaśa saṃghāvaśeṣā dharmā anvardhamāsaṃ prātimokṣasūtroddeśam āgacchanti | sa|1 (prmosū_mū-banerjee)	ཚེ་དང་ལྡན་པ་དག་དགེ་འདུན་ལྷག་མའི་ཆོས་བཅུ་༄༦ཨ་༌༎ གསུམ་པོ་འདི་དག་ནི་ཟླ་བ་ཕྱེད་ཕྱེད་ཅིང་། སོ་སོར་ཐར་པའི་མདོ་འདོན་པ་ལས་འབྱུང་ངོ་༎
 saṃcintya śukravisṛṣṭir anyatra svapnāntarāt saṃghāvaśeṣaḥ | sa|2 (prmosū_mū-banerjee)	བསམ་བཞིན་དུ་ཁུ་བ་ཕྱུང་ན་རྨི་ལམ་གྱི་མ་གཏོགས་ཏེ་། དགེ་འདུན་ལྷག་མའོ་༎
 yaḥ punar bhikṣur avalavipariṇatena cittena mātṛgrāmeṇa sārdhaṃ kāyasaṃsargaṃ samāpadyeta	ཡང་དགེ་སློང་གང་དྲལ་ཅིང་གྱུར་པའི་སེམས་ཀྱིས་བུད་མེད་ཀྱི་ཡུལ་དང་ལྷན་ཅིག་ལུས་རེག་པར་བྱེད་དམ་། ལག་པ་ནས་བཟུང་ངམ་། དཔུང་པ་ནས་བཟུང་ངམ་། ལན་བུ་ནས་བཟུང་ངམ་།
 hastagrahaṇaṃ vā bāhugrahaṇaṃ vā veṇīgrahaṇaṃ vā anyatamānyatamasya vā aṅgapratyaṅgasaṃsparśanaṃ	ཡན་ལག་དང་ཉིད་ལག་གང་ཡང་རུང་བ་ལ་ནོམ་པ་དང་། ཉུག་པ་བདག་གིར་བྱེད་ན་།
 vā aṅgamarśanaṃ svīkuryāt saṃghāvaśeṣaḥ | sa|3 (prmosū_mū-banerjee)	དགེ་འདུན་ལྷག་མའོ་༎
 yaḥ punar bhikṣur avadalavipariṇatena cittena mātṛgrāmaṃ duṣṭhulayā pāpikayā asabhyayā maithunopasaṃhitayā vācā ābhāṣeta yathāpi tāṃ yuvā yuvatiṃ saṃghāvaśeṣaḥ |	ཡང་དགེ་སློང་གང་དྲལ་ཅིང་གྱུར་པའི་སེམས་ཀྱིས་བུད་མེད་ཀྱི་ཡུལ་ལ་གནས་ངན་ལེན་གྱི་ཚིག་སྡིག་པ་ཅན་། ཚོགས་པར་མི་དབྱུང་བ་། འཁྲིག་པ་ལས་བྱུང་བ་དང་ལྡན་པ་དག་། སྐྱེས་བུས་ན་ཆུང་ལ་ཇི་ལྟ་བ་བཞིན་དུ་སྨྲས་ན་། དགེ་འདུན་ལྷག་མའོ་༎
 sa|4 (prmosū_mū-banerjee) yaḥ punar bhikṣur avadalavipariṇatena cittena mātṛgrāmasya purastād ātmanaḥ kāyaparicaryāyā saṃvarṇayed etad agraṃ mātṛsvasaḥ paricaryāṇāṃ yaduta mādṛśaṃ bhikṣuṃ śīlavantaṃ	ཡང་དགེ་སློང་གང་དྲལ་ཅིང་གྱུར་པའི་སེམས་ཀྱིས་བུད་མེད་ཀྱི་ཡུལ་གྱི་མདུན་དུ་བདག་ཉིད་ཀྱི་ལུས་ཀྱི་བསྙེན་བཀུར་བྱ་བའི་ཕྱིར་འདི་ལྟ་སྟེ་། ད་ལྟ་བུའི་དགེ་སློང་ཚུལ་ཁྲིམས་དང་ལྡན་པ་དགེ་བའི་ཆོས་ཅན་།
 kalyāṇadharmāṇaṃ brahmacāriṇam anena dharmeṇa paricared yaduta maithunopasaṃhitena saṃghāvaśeṣaḥ | sa|5 (prmosū_mū-banerjee)	ཚངས་པར་སྤྱོད་པ་ལ་འདི་ལྟར་འཁྲིག་པ་དང་ལྡན་པའི་ཆོས་འདིས་བསྙེན་བཀུར་བྱས་ན་། སྲུ་འདི་བསྙེན་བཀུར་བྱས་པ་རྣམས་ཀྱི་ནང་ན་མཆོག་ཡིན་ནོ་ཞེས་བསྔགས་པ་བརྗོད་ན་། དགེ་འདུན་ལྷག་མའོ་༎
 yaḥ punar bhikṣuḥ saṃcaritraṃ samāpadyeta striyaṃ vā puruṣamatena puruṣaṃ vā strīmatena jāyātvena vā jāritvena vā antatas tatkṣaṇikāyām api saṃghāvaśeṣaḥ | sa|6 (prmosū_mū-banerjee)	ཡང་དགེ་སློང་གང་བུད་མེད་ལ་སྐྱེས་པའི་ཚིག་དང་། སྐྱེས་པ་ལ་བུད་མེད་ཀྱི་ཚིག་གིས་ཆུང་མ་ཉིད་དམ་། མཛའ་ན་མོ་ཉིད་དུ་སྨྱན་བྱེད་ན་ཐ་ན་ཐང་འགའ་ཕྲད་པ་ཡང་རུང་སྟེ་། དགེ་འདུན་ལྷག་མའོ་༎
 svayaṃ yācitā bhikṣuṇā kuṭiṃ kārayitvā asvāmikām ātmoddeśikāṃ prāmāṇikā kuṭiḥ kārayitavyā |	༄༦བ་དགེ་སློང་གིས་བདག་གིས་བསླངས་པ་། བདག་པོ་མེད་པ་། བདག་གི་ཕྱིར་ཁང་པ་རྩིག་ཏུ་འཇུག་ན་། དགེ་སློང་དེས་ཁང་པ་ཚད་བཞིན་དུ་བརྩིག་ཏུ་ཆུག་ཅིག་། དེ་ལ་ཁང་པའི་ཚད་ནི་འདི་ཡིན་ཏེ་།
 tatredaṃ kuṭyāḥ pramāṇaṃ dairghyeṇa dvādaśa vitastayaḥ sugatavitastyā tīryak saptāntarataḥ |	ནང་གི་སྲིད་དུ་བདེ་བར་གཤེགས་པའི་མཐོའི་མཐོ་བཅུ་གཉིས་། ཞེང་དུ་མཐོ་བདུན་ནོ་༎
 tena bhikṣuṇā bhikṣavo 'bhinetavyāḥ vāstudarśanāya | abhinītair bhikṣubhir vāstu draṣṭavyam anārambhaṃ saparikramam* |	གཞི་བལྟ་བའི་ཕྱིར་དགེ་སློང་དེས་དགེ་སློང་དག་བཀྲི་བར་བྱའོ་༎ ཁྲིད་པའི་དགེ་སློང་དག་གིས་ཀྱང་གཞི་རུང་བ་དང་། རྩོད་པ་མེད་པ་དང་། བརྩམ་དུ་རུང་བར་བལྟ་བར་བྱའོ་༎
 sārambhe ced bhikṣur vāstuny aparākrame svayaṃ yācitāṃ kuṭiṃ kārayed asvāmikām ātmoddeśakāṃ	གལ་ཏེ་དགེ་སློང་གིས་གཞི་མི་རུང་བའམ་། རྩོད་པ་དང་བཅས་པའམ་། བརྩམ་དུ་མི་རུང་བར་བདག་གིས་བསླངས་པ་། བདག་པོ་མེད་པ་། བདག་གི་ཕྱིར་ཁང་པ་རྩིག་ཏུ་འཇུག་གམ་། གཞི་བལྟ་བའི་ཕྱིར་དགེ་སློང་དག་ཀྱང་མི་ཁྲིད་དམ་།
 bhikṣūṃś ca nābhinayed vāstu darśanāya anabhinītair bhikṣubhiḥ adarśitavāstuni pramāṇaṃ	དགེ་སློང་ཁྲིད་པ་དག་ལ་གཞི་སྟོན་ཏམ་།
 vātikramet saṃghāvaśeṣaḥ | sa|7 (prmosū_mū-banerjee)	ཚད་ལས་འདས་ན་དགེ་འདུན་ལྷག་མའོ་༎
 mahallakaṃ punar bhikṣuḥ vihāraṃ kārayamānāḥ sasvāmikaṃ saṃghoddeśakaṃ tena bhikṣuṇā bhikṣavo 'bhihitavyā vāstudarśanāya | ataḥ abhinītair bhikṣubhir vāstu draṣṭavam anāraṃbhaṃ saparikramam* |	དགེ་སློང་གིས་བདག་པོ་ཡོད་པ་། དགེ་འདུན་གྱི་ཕྱིར་གཙུག་ལག་ཁང་ཆེན་པོ་རྩིག་ཏུ་འཇུག་ན་། གཞི་བལྟ་བའི་ཕྱིར་དགེ་སློང་དེས་དགེ་སློང་དག་བཀྲི་བར་བྱའོ་༎ ཁྲིད་པའི་དགེ་སློང་དག་གིས་ཀྱང་གཞི་རུང་བ་དང་། རྩོད་པ་མེད་པ་དང་། བརྩམ་དུ་རུང་བར་བལྟ་བར་བྱའོ་༎ གལ་ཏེ་དགེ་སློང་གིས་གཞི་མི་རུང་བའམ་། རྩོད་པ་དང་བཅས་པའམ་།
 sāraṃbhe ced bhikṣur vāstuny aparikrame mahantaṃ vihāraṃ kārayitvā yat sasvāmikaṃ saṃghoddeśakaṃ bhikṣūṃś ca nābhinayed vāstudarśanāya saṃghāvaśeṣaḥ sa|8 (prmosū_mū-banerjee)	བརྩམ་དུ་མི་རུང་བར་བདག་པོ་ཡོད་པ་དགེ་འདུན་གྱི་ཕྱིར་གཙུག་ལག་ཁང་ཆེན་པོ་རྩིག་ཏུ་འཇུག་གམ་། གཞི་བལྟ་བའི་ཕྱིར་དགེ་སློང་དག་ཀྱང་མི་ཁྲིད་དམ་། དགེ་སློང་ཁྲིད་པ་དག་ལ་གཞི་མི་སྟོན་ན་། དགེ་འདུན་ལྷག་མའོ་༎
 yaḥ punar bhikṣur dviṣṭoddeśād apratītaḥ śuddhaṃ bhikṣuṃ amūlakena pārājikena dharmeṇānudhvaṃsayed	ཡང་དགེ་སློང་གང་ཁྲོས་ཤིང་ཞེ་སྡང་བར་༄༧ཨ་༌༎
 apy evainaṃ brahmacaryāc cyāvayeyam iti tasya ca apareṇa samayena samanuyujyamāno vā asamanuyujyamāno vā amūlakam eva svādhikaraṇaṃ bhaved bhikṣuś ca dveṣe pratiṣṭhed dveṣeṇāvocam iti saṃghāvaśeṣaḥ |	གྱུར་ནས་། ཅི་ནས་ཀྱང་འདི་ཚངས་པར་སྤྱོད་པ་དང་དབྲལ་ལོ་སྙམ་ནས་།
 sa|9 (prmosū_mū-banerjee) yaḥ punar bhikṣur dviṣṭoddeśād apratītaḥ śuddhaṃ bhikṣuṃ anyasya vā anyathābhāgīyasya adhikaraṇasya kañcid eva leśamātraṃ dharmam upādāya pārājikena dharmeṇa anudhvaṃsayed	དགེ་སློང་དག་པ་ལྟུང་བ་མེད་པ་ལ་གཞི་མེད་པར་ཕམ་པར་འགྱུར་བའི་ཆོས་ཀྱིས་སྐུར་པ་ལས་དེ་དུས་གཞན་ཞིག་ན་དྲིས་ཀྱང་རུང་། མ་དྲིས་ཀྱང་རུང་། རྩོད་པ་དེ་ཡང་གཞི་མེད་པ་ཡིན་ལ་། དགེ་སློང་ཡང་ཞེ་སྡང་ལ་གནས་པས་ཞེ་སྡང་གིས་སྨྲས་སོ་ཞེ་ན་། དགེ་འདུན་ལྷག་མའོ་༎
 apy evainaṃ brahmacaryāc cyāvayeyam iti tasya ca apareṇa samayena samanuyujyamānasya	ཡང་དགེ་སློང་ཁྲོས་ཤིང་ཞེ་སྡང་བར་གྱུར་ནས་ཅི་ནས་ཀྱང་འདི་ཚངས་པར་སྤྱོད་པ་དང་དབྲལ་ལོ་སྙམ་ནས་། དགེ་སློང་དག་པ་ལྟུང་བ་མེད་པ་ལ་གཞན་གྱི་ཆ་མ་ཡིན་པ་དང་ལོ་སྙམ་ནས་། ། མཐུན་པ་ཕམ་པར་འགྱུར་བའི་ཆོས་ཀྱིས་སྐུར་པ་ལས་དེ་དུས་གཞན་ཞིག་ལོ་སྙམ་ནས་། ། ན་། དྲིས་ཀྱང་རུང་། མ་དྲིས་ཀྱང་རུང་།
 vā samanuyujyamānasya vā anyabhāgīyaṃ tad adhikaraṇaṃ bhavati kaścid eva leśoddeśamātro	རྩོད་པ་དེ་ཡང་གཞན་གྱི་ཆ་མ་ཡིན་པ་དང་མཐུན་པ་ཡིན་ལ་། རྩོད་པ་དེ་གཞན་གྱི་ཆ་མ་ཡིན་པ་དང་མཐུན་པས་བག་ཙམ་ལས་བསམས་པ་ཙམ་གྱིས་ཆོས་འགའ་ཞིག་བླངས་པར་གྱུར་ལ་།
 dharma upātto bhavati bhikṣuś ca dveṣe pratiṣṭhed dveṣād avocam iti saṃghāvaśeṣaḥ | sa|10 (prmosū_mū-banerjee)	དགེ་སློང་ཡང་ཞེ་སྡང་ལ་གནས་པས་ཞེ་སྡང་གིས་སྨྲས་སོ་ཞེ་ན་། དགེ་འདུན་ལྷག་མའོ་༎
 yaḥ punar bhikṣuḥ samagrasya saṃghasya bhedāya parākramed bhedakaraṇasaṃvartanīyaṃ	ཡང་དགེ་སློང་གང་དགེ་འདུན་མཐུན་པ་དབྱེ་བའི་ཕྱིར་རྟུལ་བར་བྱེད་ཅིང་།
 cādhikaraṇaṃ samādhāya pragṛhya tiṣṭhet sa bhikṣur bhikṣubhir idaṃ syād vacanīyaḥ	དབྱེན་བྱེད་པར་གྱུར་པའི་རྩོད་པ་ཡང་དག་པར་བླངས་ནས་རབ་ཏུ་བཟུང་སྟེ་འདུག་ན་། དགེ་སློང་དེ་ལ་དགེ་སློང་རྣམས་ཀྱིས་འདི་སྐད་ཅེས་།
 -- mā tvam āyuṣman samagrasya saṃghasya bhedāya parākramed bhedakaraṇasaṃvartanīyaṃ	ཚེ་དང་ལྡན་པ་ཁྱོད་དགེ་འདུན་མཐུན་པ་དབྱེ་བའི་ཕྱིར་རྟུལ་པར་མ་བྱེད་ཅིག་།
 cādhikaraṇaṃ samādhāya pragṛhya tiṣṭha |	དབྱེན་བྱེད་པར་འགྱུར་བའི་རྩོད་པ་ཡང་དག་པར་བླངས་ནས་རབ་ཏུ་བཟུང་སྟེ་མ་འདུག་ཅིག་།
 sametv āyuṣman sārdhaṃ saṃghena samagro saṃghasahitaḥ saṃmodamāno 'vivadamānaḥ ekāgradharmoddeśaḥ ekakṣīrodakībhūtaḥ śāstu darśayamānaḥ sukhaṃ sparśaṃ vihāraṃ tu niśṛja tvam āyuṣman*	ཚེ་དང་ལྡན་པ་དགེ་༄༧བ་འདུན་དང་མཐུན་པར་གྱིས་ཤིག་། དགེ་འདུན་མཐུན་ཞིང་མི་ཕྱེད་ལ་ཀུན་ཏུ་དགའ་ཞིང་མི་རྩོད་དེ་། མཆོག་གཅིག་འདོན་པ་གཅིག་ཅིང་། ཆུ་དང་འོ་མ་གཅིག་ཏུ་འདྲེས་པ་ལྟ་བུར་གྱུར་ལ་། སྟོན་པའི་བསྟན་པ་ཡང་གསལ་བར་བྱེད་ན་། བདེ་བ་ལ་རེག་པར་འགྱུར་གྱིས་།
 idam evaṃrūpaṃ saṃghabhedakaraṇaṃ vastu |	ཚེ་དང་ལྡན་པ་ཁྱོད་དགེ་འདུན་འབྱེད་པར་བྱེད་པའི་གཞི་འདི་ལྟ་བུ་འདི་ཐོང་ཞིག་། ཅེས་བསྒོ་བར་བྱའོ་༎ དགེ་སློང་དེ་ལ་དགེ་སློང་རྣམས་ཀྱིས་དེ་སྐད་བསྒོ་བ་ན་།
 evaṃ cet sa bhikṣur bhikṣubhir ucyamānas tathaiva vastu samādāya pragṛhya tiṣṭhet*	གལ་ཏེ་གཞི་དེ་གཏོང་ན་དེ་ལྟ་ན་ལེགས་། གལ་ཏེ་མི་གཏོང་ན་གཞི་དེ་གཏོང་བར་བྱ་བའི་ཕྱིར་།
 śuddhas tu pratiniḥsṛjed ity evaṃ kuśalaṃ na ca pratiniḥsṛjed dvir api trir api samanuyoktavyaḥ	ལན་གཉིས་ལན་གསུམ་དུ་ཡང་དག་པར་བསྒོ་བར་བྱའོ་༎ ཡང་དག་པར་བསྟན་པར་བྱའོ་༎
 samanuśāsitavyaḥ tasya vastunaḥ pratiniḥsargāya dvir api trir api samanuyujyamānaḥ	ལན་གཉིས་ལན་གསུམ་དུ་ཡང་དག་པར་བསྒོ་།
 samanuśiṣyamānas tad vastu pratiniḥsṛjed ity evaṃ kuśalaṃ no cet pratiniḥsṛjet saṃghāvaśeṣaḥ | sa|11 (prmosū_mū-banerjee)	ཡང་དག་པར་བསྟན་པ་ན་གཞི་དེ་གཏོང་ན་དེ་ལྟ་ན་ལེགས་། གལ་ཏེ་མི་གཏོང་ན་དགེ་འདུན་ལྷག་མའོ་༎
 tasya khalu bhikṣor bhikṣavaḥ syur sahāyakāḥ vyagravādinaḥ eko vā dvau vā saṃbahulā	དགེ་སློང་དེའི་གྲོགས་བྱེད་པའི་དགེ་སློང་མི་མཐུན་པར་སྨྲ་བ་ཉིད་ཀྱི་རྗེས་སུ་ཕྱོགས་པ་གཅིག་གམ་། གཉིས་སམ་། མང་པོ་དག་ཡོད་ཅིང་།
 vā te tān bhikṣūn evaṃ vadeyuḥ -- mā yūyam āyuṣmantaḥ taṃ bhikṣuṃ kalyāṇaṃ vā pāpakaṃ	གལ་ཏེ་དེ་དག་དགེ་སློང་རྣམས་ལ་འདི་སྐད་ཅེས་། ཚེ་དང་ལྡན་པ་དག་ཁྱེད་ཅག་དགེ་ཡང་རུང་སྡིག་ཀྱང་རུང་། དགེ་སློང་འདི་ལ་ཅི་ཡང་མ་སྨྲ་ཞིག་།
 vā kiṃcid vadata tat kasmād dhetor dharmavādī āyuṣmanto bhikṣur vinayavādī ca so 'smākaṃ caiṣaś chandaṃ ca ruciñ cādāya tu vyāharati |	དེ་ཅིའི་ཕྱིར་ཞེ་ན་། ཚེ་དང་ལྡན་པ་དག་དགེ་སློང་འདི་ནི་ཆོས་སྨྲ་བ་། འདུལ་བ་སྨྲ་བ་། དགེ་སློང་འདི་ནི་ཆོས་དང་འདུལ་བ་ཡང་དག་པར་བླངས་ནས་རབ་ཏུ་བཟུང་སྟེ་རྗེས་སུ་ཐ་སྙད་འདོགས་པར་བྱེད་པ་།
 jānaṃś ca sa bhikṣur bhāṣate nājānan yac cāsya bhikṣoḥ rocate ca kṣamate ca asmākam api rocate ca kṣamate ca iti |	དགེ་སློང་འདི་ནི་ཤེས་བཞིན་དུ་སྨྲའི་། མི་ཤེས་པར་མ་ཡིན་པའི་ཕྱིར་ཏེ་། དགེ་སློང་འདི་༄༨ཨ་༌༎ གང་ལ་འདོད་ཅིང་བཟོད་པ་དེ་ལ་། བདག་ཅག་ཀྱང་འདོད་ཅིང་བཟོད་དོ་ཞེས་ཟེར་ན་།
 te bhikṣavo bhikṣubhir evaṃ syur vacanīyā -- māyuṣmanta evaṃ vadantu na ca sa bhikṣur	དགེ་སློང་དེ་དག་ལ་དགེ་སློང་རྣམས་ཀྱིས་འདི་སྐད་ཅེས་། ཚེ་དང་ལྡན་པ་དག་ཁྱེད་ཅག་དེ་སྐད་ཅེས་ཚེ་དང་ལྡན་པ་དག་ཁྱེད་ཅག་དགེ་ཡང་རུང་། སྡིག་ཀྱང་རུང་དགེ་སློང་འདི་ལ་ཅི་ཡང་མ་སྨྲ་ཞིག་། དེ་ཅིའི་ཕྱིར་ཞེ་ན་། ཚེ་དང་ལྡན་པ་དག་དགེ་སློང་འདི་ནི་།
 dharmavādī na vinayavādī adharmaṃ caiṣo 'vinayaṃ cāsmākaṃ chandaṃ ruciñ cādāya tu	ཆོས་སྨྲ་བ་འདུལ་བ་སྨྲ་བ་། དགེ་སློང་འདི་ནི་ཆོས་དང་འདུལ་བ་ཡང་དག་པར་བླངས་ནས་རབ་ཏུ་བཟུང་སྟེ་། རྗེས་སུ་ཐ་སྙད་འདོགས་པར་བྱེད་པ་། དགེ་སློང་འདི་ནི་ཤེས་བཞིན་དུ་སྨྲའི་། མི་ཤེས་པར་མ་ཡིན་པའི་ཕྱིར་ཏེ་།
 vyāharati nājānaṃś ca sa bhikṣur bhāṣate jānaṃś ca yac cāsya bikṣoḥ rocate ca kṣamate ca tavāyuṣmato 'pi saṃghabhedaḥ na rocate māyuṣmatām api saṃghabhedo rocate sametv	དགེ་སློང་འདི་གང་ལ་འདོད་ཅིང་བཟོད་པ་དེ་ལ་། བདག་ཅག་ཀྱང་འདོད་ཅིང་བཟོད་དོ་༎ ཞེས་མ་ཟེར་ཅིག་། དེ་ཅིའི་ཕྱིར་ཞེ་ན་། ཚེ་དང་ལྡན་པ་དག་དགེ་སློང་འདི་ནི་། ཆོས་སྨྲ་བ་མ་ཡིན་། འདུལ་བ་སྨྲ་བ་མ་ཡིན་གྱི་། ཚེ་དང་ལྡན་པ་དགེ་སློང་འདི་ནི་ཆོས་མ་ཡིན་པ་སྨྲ་བ་། འདུལ་བ་མ་ཡིན་པ་སྨྲ་བ་། དགེ་སློང་འདི་ནི་ཆོས་མ་ཡིན་པ་དང་། འདུལ་བ་མ་ཡིན་པ་ཡང་དག་པར་བླངས་ནས་རབ་ཏུ་བཟུང་སྟེ་། རྗེས་སུ་ཐ་སྙད་འདོགས་པར་བྱེད་པ་། དགེ་སློང་འདི་ནི་མི་ཤེས་བཞིན་དུ་སྨྲའི་། ཤེས་པར་སྨྲ་བ་མ་ཡིན་པའི་ཕྱིར་ཏེ་། དགེ་སློང་འདི་ནི་གང་ལ་འདོད་ཅིང་བཟོད་པ་ལ་། ཚེ་དང་ལྡན་པ་དག་འདོད་ཅིང་བཟོད་པར་མ་བྱེད་ཅིག་།
 āyuṣmantaḥ saṃghena samagro hi saṃgho saṃmodamāno avivadamāno ekāgradharmoddeśaḥ	ཚེ་དང་ལྡན་པ་དག་ཁྱེད་དགེ་འདུན་འབྱེད་འདོད་པར་མ་བྱེད་པར་ཚེ་དང་ལྡན་པ་དག་དགེ་འདུན་མཐུན་པ་ཉིད་དུ་འདོད་པར་གྱིས་ཤིག་། ༄༨བ་དགེ་འདུན་མཐུན་ཞིང་མི་ཕྱེད་ལ་། ཀུན་ཏུ་དགའ་ཞིང་མི་རྩོད་དེ་། མཆོག་གཅིག་འདོན་པ་གཅིག་ཅིང་། ཆུ་དང་འོ་མ་གཅིག་ཏུ་འདྲེས་པ་ལྟ་བུར་གྱུར་ལ་། སྟོན་པའི་བསྟན་པ་གསལ་བར་བྱེད་ན་།
 ekakṣīrodakībhūtaḥ śāstu darśayamānaḥ sukhaṃ sparśaṃ viharantu |	བདེ་བ་ལ་རེག་པར་གནས་པར་འགྱུར་གྱིས་།
 tiṣṭha mā tvam āyuṣman saṃghabhedāya niḥsṛja imām evaṃrūpāṃ saṃghabhedakarāṃ kathām* |	ཚེ་དང་ལྡན་པ་དགེ་འདུན་འབྱེད་པའི་རྗེས་སུ་ཕྱོགས་ཤིང་། མི་མཐུན་པར་སྨྲ་བ་འདི་ལྟ་བུ་འདི་ཐོང་ཞིག་ཅེས་བསྒོ་བར་བྱའོ་༎
 evaṃ te bhikṣavo bhikṣubhiḥ dvir api trir api samanuyoktavyāḥ samanuśāsitavyās tasya	དགེ་སློང་དེ་དག་ལ་དགེ་སློང་རྣམས་ཀྱིས་དེ་སྐད་བསྒོ་བ་ན་། གལ་ཏེ་གཞི་དེ་གཏོང་ན་དེ་ལྟ་ན་ལེགས་།
 vastunaḥ pratiniḥsargāya dvir api trir api samanuyoktavyāḥ samanuśāsitavyāḥ pratiniḥsṛjeyuḥ	གལ་ཏེ་མི་གཏོང་ན་གཞི་དེ་གཏོང་བར་བྱ་བའི་ཕྱིར་ལན་གཉིས་ལན་གསུམ་དུ་ཡང་དག་པར་བསྒོ་བར་བྱ་། ཡང་དག་པར་བསྟན་པར་བྱའོ་༎ ལན་གཉིས་ལན་གསུམ་དུ་ཡང་དག་པར་བསྒོ་། ཡང་དག་པར་བསྟན་པ་ན་གཞི་དེ་དག་གཏོང་ན་དེ་ལྟ་ན་ལེགས་།
 ity evaṃ kuśalaṃ no cet pratiniḥsṛjeyuḥ saṃghāvaśeṣaḥ | sa|12 (prmosū_mū-banerjee)	གལ་ཏེ་མི་གཏོང་ན་དགེ་འདུན་ལྷག་མའོ་༎
 saṃbahulā bhikṣavaḥ anyatamaṃ grāmaṃ vā nigamaṃ vā upaniḥśritya vihareyus te ca syuḥ kuladūṣakāḥ pāpasamācārāḥ teṣāṃ ca kulāni duṣṭāni dṛśyeran vā śrūyeran vā prajñāyeran vā |	དགེ་སློང་རབ་ཏུ་མང་པོ་དག་གྲོང་ངམ་། གྲེང་*grong?་རྡལ་ཞིག་ན་ཉེ་བར་རྟེན་ཅིང་གནས་པར་གྱུར་ལ་། དེ་དག་ཀྱང་ཁྱིམ་སུན་འབྱིན་པ་། སྡིག་པའི་ཆོས་ཀུན་ཏུ་སྤྱོད་ཅིང་། དེ་དག་གིས་ཁྱིམ་སུན་ཕྱུང་བར་མཐོང་ངམ་ཐོས་སམ་རབ་ཏུ་ཤེས་སམ་། དེ་དག་སྡིག་པ་ཀུན་ཏུ་སྤྱོད་པར་མཐོང་ངམ་ཐོས་སམ་རབ་ཏུ་ཤེས་ན་དགེ་སློང་དེ་དག་ལ་དགེ་སློང་རྣམས་ཀྱིས་འདི་སྐད་ཅེས་།
 te bhikṣavaḥ bhikṣubhir evaṃ syur vacanīyāḥ -- āyuṣmantaḥ kuladūṣakāḥ pāpasamācārāḥ	ཚེ་དང་ལྡན་པ་དག་ཁྱིམ་སུན་འབྱིན་པ་སྡིག་པའི་ཆོས་ཀུན་ཏུ་སྤྱོད་པ་དག་ཡིན་ཏེ་།
 yuṣmākaṃ kulāni duṣṭāni dṛśyante 'pi śrūyante 'pi prajñāyante 'pi yuṣmākaṃ ca te	ཕྱེད་ཀྱིས་ཁྱིམ་དག་སུན་ཕྱུང་བར་ཡང་མཐོང་ཞིང་ཐོས་ལ་། རབ་ཏུ་ཤེས་ཏེ་།
 pāpasamācārā dṛśyante 'pi śrūyante 'pi prajñāyante 'pi prakramadhvaṃ āyuṣmantaḥ yūyaṃ	ཁྱེད་སྡིག་པ་ཀུན་ཏུ་སྤྱོད་པར་ཡང་མཐོང་ཞིང་ཐོས་ལ་། རབ་ཏུ་ཤེས་ཀྱིས་། ཚེ་༄༩ཨ་༌༎
 asmād āvāsād alaṃ yuṣmākaṃ iha vāseneti |	དང་ལྡན་པ་དག་ཁྱེད་འདི་ན་གནས་པས་ཆོག་གིས་། གནས་འདི་ནས་དེང་ཞིག་ཅེས་བསྒོ་བར་བྱའོ་༎
 evaṃ cet te bhikṣavas tān bhikṣūn vadeyuḥ -- chandagāmina āyuṣmantaḥ bhikṣava dveṣagāmino	གལ་ཏེ་དེ་དག་དགེ་སློང་རྣམས་ལ་འདི་སྐད་ཅེས་། ཚེ་དང་ལྡན་པ་དག་འདི་ན་དགེ་སློང་ཁ་ཅིག་འདུན་པས་འགྲོ་བ་། ཞེ་སྡང་གིས་འགྲོ་བ་། གཏི་མུག་གིས་འགྲོ་བ་།
 mohagāmino bhayagāminaś ca evaṃrūpāyāḥ āpattyāḥ ekatya bhikṣūn pravāsayanty ekatya	འཇིགས་པས་འགྲོ་བ་དག་ཡིན་ཏེ་། འདི་ལྟར་ལྟུང་བ་འདྲ་བ་ཁོ་ན་ལས་དགེ་སློང་ཁ་ཅིག་ནི་སྐྲོད་བར་བྱེད་།
 bhikṣūn na pravāsayantīti |	ཁ་ཅིག་ནི་སྐྲོད་པར་མི་བྱེད་དོ་ཞེས་ཟེར་ན་། དགེ་སློང་དེ་དག་ལ་།
 tatra bhikṣavaḥ evaṃ syur vacanīyāḥ -- mā āyuṣmanta evaṃ vadata |	དགེ་སློང་རྣམས་ཀྱིས་འདི་སྐད་ཅེས་ཚེ་དང་ལྡན་པ་དག་ཁྱེད་དེ་སྐད་ཅེས་ཚེ་དང་ལྡན་པ་དག་འདི་ན་དགེ་སློང་ཁ་ཅིག་འདུན་པས་འགྲོ་བ་། ཞེ་སྡང་གིས་འགྲོ་བ་། གཏི་མུག་གིས་འགྲོ་བ་། འཇིགས་པས་འགྲོ་བ་དག་ཡིན་ཏེ་།
 ekatya bhikṣavaś chandagāmino dveṣagāmino mohagāmino bhayagāminaś ca evaṃrūpāyāḥ āpattyāḥ ekatya bhikṣūn pravāsayanty ekatya bhikṣūn na pravāsayantīti	འདི་ལྟར་ལྟུང་བ་འདྲ་བ་ཁོ་ན་ལས་དགེ་སློང་ཁ་ཅིག་ནི་སྐྲོད་པར་བྱེད་། ཁ་ཅིག་ནི་སྐྲོད་པར་མི་བྱེད་དོ་༎
 tat kasmād dhetoḥ |	ཞེས་མ་ཟེར་ཅིག་། དེ་ཅིའི་ཕྱིར་ཞེ་ན་། དགེ་སློང་འདི་དག་ནི་འདུན་པས་འགྲོ་བ་མ་ཡིན་། ཞེ་སྡང་གིས་འགྲོ་བ་མ་ཡིན་། གཏི་མུག་གིས་འགྲོ་བ་མ་ཡིན་།
 neme bhikṣavaś chandagāmino dveṣagāmino mohagāmino bhayagāminaś ca āyuṣmanta khalu kuladūṣakāḥ pāpasamācārāḥ yuṣmākaṃ kulāni duṣṭāni dṛśyante 'pi śrūyante 'pi pāpakāś	འཇིགས་པས་འགྲོ་བ་དག་མ་ཡིན་གྱི་འདི་ལྟར་ཚེ་དང་ལྡན་པ་དག་ཉིད་ཁྱིམ་སུན་འབྱིན་པ་སྡིག་པའི་ཆོས་ཀུན་ཏུ་སྤྱོད་པ་དག་ཡིན་ཏེ་། ཁྱེད་ཉིད་ཀྱིས་ཁྱིམ་དག་སུན་ཕྱུང་བར་ཡང་མཐོང་ཞིང་ཐོས་ལ་རབ་ཏུ་ཤེས་།
 ca yuṣmākaṃ samācārā dṛśyante 'pi śrūyante 'pi prajñāyante 'pi |	ཁྱེད་སྡིག་པ་ཀུན་ཏུ་སྤྱོད་པར་ཡང་མཐོང་ཞིང་ཐོས་ལ་རབ་ཏུ་ཤེས་པའི་ཕྱིར་ཏེ་།
 bhikṣava āyuṣmantaś chandagāmino dveṣagāmino mohagāmino bhayagāminaś ca -- niḥsṛjata imām evaṃrūpāṃ kathām* |	ཚེ་དང་ལྡན་པ་དག་འདུན་པས་འགྲོ་བ་ཞེས་བྱ་བའི་ཚིག་གི་ལམ་དང་། ཞེ་སྡང་གིས་འགྲོ་བ་། གཏི་མུག་གིས་འགྲོ་བ་། འཇིགས་པས་འགྲོ་བ་ཞེས་བྱ་བའི་ཚིག་གི་ལམ་༄༩བ་འདི་ལྟ་བུ་འདི་ཐོང་ཞིག་ཅེས་བསྒོ་བར་བྱའོ་༎ 
 te bhikṣavaḥ bhikṣubhir evaṃ bhāsitavyāḥ -- evaṃ cet pratiniḥsṛjeyuḥ ity evaṃ kuśalaṃ	དགེ་སློང་དེ་དག་ལ་དགེ་སློང་རྣམས་ཀྱིས་དེ་སྐད་ཅེས་བསྒོ་བ་ན་། གལ་ཏེ་གཞི་དེ་གཏོང་ན་དེ་ལྟན་ལེགས་། གལ་ཏེ་མི་གཏོང་ན་།
 no cet pratiniḥsṛjeyuḥ dvir api trir api samanuyoktavyāḥ samanuśāsitavyās tasya pratiniḥsargāya	གཞི་དེ་གཏོང་བར་བྱ་བའི་ཕྱིར༏་ལན་གཉིས་ལན་གསུམ་དུ་ཡང་དག་པར་བསྒོ་བར་བྱ་། ཡང་དག་པར་བསྟན་པར་བྱའོ་༎
 dvir api trir api samanuyoktavyāḥ samanuśāsitavyāḥ pratiniḥsṛjeyuḥ ity evaṃ kuśalaṃ	ལན་གཉིས་ལན་གསུམ་དུ་ཡང་དག་པར་བསྒོ་། ཡང་དག་པར་བསྟན་པ་ན་། གཞི་དེ་གཏོང་ན་དེ་ལྟ་ན་ལེགས་།
 no cet pratiniḥsṛjeyuḥ saṃghāvaśeṣaḥ | sa|13 (prmosū_mū-banerjee)	གལ་ཏེ་མི་གཏོང་ན་དགེ་འདུན་ལྷག་མའོ་༎ འདི་ན་དགེ་སློང་འགའ་ཞིག་བཀའ་བློ་མི་བདེ་བའི་རང་བཞིན་ཅན་དུ་གྱུར་ལ་།
 bhikṣur iha kaścid durvācyasvabhāvo bhavati uddeśyaparyāpannaiḥ śikṣāpadaiḥ sugatasūtraparyāpannaiḥ	དེ་ལ་དགེ་སློང་རྣམས་ཀྱིས་གདོན་པར་གཏོགས་པ་བསླབ་པའི་གཞི་རྣམས་དང་། བདེ་བར་གཤེགས་པའི་མདོར་གཏོགས་པ་རྣམས་ཀྱིས་ཆོས་དང་མཐུན་པ་དང་། འདུལ་བ་དང་མཐུན་པར་སྨྲས་པ་ན་།
 bhikṣubhiḥ sahadharmeṇa sahavinayenocyamāna ātmānam avacanīyaṃ karoti -- mā mām āyuṣmantaḥ	ཚེ་དང་ལྡན་པ་དག་ཁྱེད་ཅག་དགེ་ཡང་རུང་སྡིག་ཀྱང་རུང་།
 yūyaṃ kiṃcid vadata kalyāṇam akalyāṇaṃ vā aham api āyuṣmataḥ na kiṃcid vakṣyāmi kalyāṇam	བདག་ལ་ཅི་ཡང་མ་སྨྲ་ཞིག་། བདག་ཀྱང་དགེ་ཡང་རུང་སྡིག་ཀྱང་རུང་། ཚེ་དང་ལྡན་པ་དག་ལ་ཅི་ཡང་མི་སྨྲའོ་༎
 akalyāṇaṃ vā viramantu āyuṣmantaḥ mama vacanād aham api viraṃsyāmi yuṣmākaṃ vacanād iti |	ཚེ་དང་ལྡན་པ་དག་གིས་བདག་ལ་ཚིག་གི་ལམ་ཐོང་ཞིག་། ཁྱེད་ལ་ཡང་བདག་གིས་སྨྲས་པས་ཅི་ཞིག་བྱ་ཞེས་བདག་ཉིད་བརྗོད་པར་བྱ་བ་མ་ཡིན་པར་བྱེད་ན་། དགེ་སློང་དེ་ལ་དགེ་སློང་རྣམས་ཀྱིས་འདི་སྐད་ཅེས་།
 sa bhikṣur bhikṣubhir evaṃ syād vacanīyo -- āyuṣman uddeśyaparyāpannaiḥ śikṣāpadaiḥ sugatasūtraparyāpannaiḥ bhikṣubhiḥ sahadharmeṇa sahavinayenocyamāna ātmānam tvaṃ	ཚེ་དང་ལྡན་པ་ཁྱོད་དགེ་སློང་རྣམས་ཀྱིས་གདོན་པར་གཏོགས་པ་བསླབ་པའི་གཞི་རྣམས་དང་། བདེ་བར་གཤེགས་པའི་མདོར་གཏོགས་པ་རྣམས་ཀྱིས་ཆོས་དང་མཐུན་པ་དང་། འདུལ་བ་དང་མཐུན་པར་སྨྲས་པ་ན་། བདག་ཉིད་བརྗོད་པར་བྱ་བ་མ་ཡིན་པར་མ་བྱེད་༄༡༠ཨ་༌༎ པར་།
 avacanīyaṃ karoṣi āyuṣman vacanīyam eva ātmānaṃ karotu āyuṣmantam bhikṣavo sahadharmeṇa	ཚེ་དང་ལྡན་པས་བདག་ཉིད་བརྗོད་པར་བྱ་བ་ཁོ་ནར་གྱིས་ཤིག་། དགེ་སློང་རྣམས་ཚེ་དང་ལྡན་པ་ལ་ཆོས་དང་མཐུན་པ་དང་། འདུལ་བ་དང་མཐུན་པར་སྨྲས་པ་ན་།
 sahavinayena vadantu āyuṣmān api bhikṣūn sahadharmeṇa sahavinayena vadatu evaṃ saṃbaddhā	ཚེ་དང་ལྡན་པ་ཡང་དགེ་སློང་རྣམས་ལ་ཆོས་དང་མཐུན་པ་དང་། འདུལ་བ་དང་མཐུན་པར་སྨྲོས་ཤིག་། དེ་ཅིའི་ཕྱིར་ཞེ་ན་།
 hi tasya bhagavataḥ tathāgatasya arhato samyaksaṃbuddhasya pariṣad yad idaṃ anyonyavacanīyād anyonyāpattivyutthāpanād iti māyuṣman ātmānaṃ avacanīyaṃ karotu |	འདི་ལྟ་སྟེ་གཅིག་ལ་གཅིག་བརྗོད་པར་བྱ་བ་ཉིད་དུ་བྱེད་པ་དང་། གཅིག་ལ་གཅིག་འདོམས་ཤིང་རྗེས་སུ་སྟོན་པ་དང་། གཅིག་གིས་གཅིག་ལྟུང་བ་ལས་སློང་བ་ཉིད་དེ་ལྟ་བུས་བཅོམ་ལྡན་འདས་དེ་བཞིན་གཤེགས་པ་དགྲ་བཅོམ་པ་ཡང་དག་པར་རྫོགས་པའི་སངས་རྒྱས་དེའི་འཁོར་འདི་འཕེལ་བར་འགྱུར་གྱིས་། ཚེ་དང་ལྡན་པ་དག་བདག་ཉིད་བརྗོད་པར་བྱ་བ་མ་ཡིན་པར་བྱེད་པའི་ལས་ཀྱི་མཐའ་འདི་ལྟ་བུ་ཐོང་ཞིག་ཅེས་བསྒོ་བར་བྱའོ་༎ དགེ་སློང་དེ་ལ་དགེ་སློང་རྣམས་ཀྱིས་དེ་སྐད་བསྒོ་བ་ན་།
 sa bhikṣur bhikṣubhir evaṃ bhāsitavyaḥ -- evaṃ ced tad vastu pratiniḥsṛjed ity evaṃ	གལ་ཏེ་གཞི་དེ་གཏོང་ན་དེ་ལྟ་ན་ལེགས་།
 kuśalaṃ no cet pratiniḥsṛjed dvir api trir api samanuyoktavyaḥ samanuśāsitavyas tasya	གལ་ཏེ་མི་གཏོང་ན་གཞི་དེ་གཏོང་བར་བྱ་བའི་ཕྱིར་ལན་གཉིས་ལན་གསུམ་དུ་ཡང་དག་པར་བསྒོ་བར་བྱ་། ཡང་དག་པར་བསྟན་པར་བྱའོ་༎
 pratiniḥsargāya dvir api trir api samanuyoktavyaḥ samanuśāsitavyaḥ pratiniḥsṛjed	ལན་གཉིས་ལན་གསུམ་དུ་ཡང་དག་པར་བསྒོ་། ཡང་དག་པར་བསྟན་པ་ན་།
 tad vastu ity evaṃ kuśalaṃ no cet pratiniḥsṛjet saṃghāvaśeṣaḥ |	གཞི་དེ་གཏོང་ན་དེ་ལྟ་ན་ལེགས་། གལ་ཏེ་མི་གཏོང་ན་དགེ་འདུན་ལྷག་མའོ་༎
 uddiṣṭā mayāyuṣmantas trayodaśa saṃghāvaśeṣā dharmāḥ |	ཚེ་དང་ལྡན་པ་དག་བདག་གིས་དགེ་འདུན་ལྷག་མའི་ཆོས་བཅུ་གསུམ་པོ་དག་བཏོན་ཟིན་ཏོ་༎ དེ་དག་ལས་དགུ་ནི་ལྟུང་བ་དང་པོ་དག་ཉིད་ཀྱིས་སོ་༎
 nava prathamāpattayaś catvāro yāvattṛtīyakā yeṣāṃ bhikṣur anyatamānyatamaṃ dharmam āpanno yāvatkālaṃ jānan pratichādayati tāvatkālaṃ tena akāmataḥ paryuṣitavyam* |	བཞི་ནི་ལན་གསུམ་གྱི་བར་གྱིས་སོ་༎ དགེ་༄༡༠བ་སློང་གིས་དེ་དག་ལས་ལྟུང་བ་གང་ཡང་རུང་བ་ཞིག་བྱས་ལ་། ཇི་སྲིད་དུ་ཤེས་བཞིན་དུ་འཆབ་པར་བྱེད་པ་དེ་སྲིད་དུ་དེས་མི་འདོད་བཞིན་དུ་སྤོ་བར་བྱའོ་༎ 
 akāmataḥ paryuṣitaparivāsena bhikṣuṇā uttariṣaḍrātraṃ saṃghamānatvaṃ cartavyaṃ bhavati |	དགེ་སློང་གིས་མི་འདོད་བཞིན་དུ་སྤོ་བ་བྱས་ནས་། དེའི་འོག་ཏུ་ཞག་དྲུག་གི་བར་དགེ་འདུན་མགུ་བར་བྱ་བ་སྤྱད་པར་བྱ་བའོ་༎ དགེ་སློང་གིས་མགུ་བར་བྱ་བ་སྤྱད་ནས་། དབྱུང་བར་བྱ་བ་ལ་ཐོགས་ཏེ་ཆོས་དང་མཐུན་པར་བྱས་ལ་།
 cīrṇamānatto bhikṣur āvarhaṇapratibaddhaḥ kṛtānudharmaḥ bhikṣusaṃghasya ārādhitacitto yatra syād viṃśatigaṇo bhikṣusaṃghasya tatra ca so bhikṣur āvarhitavyaḥ |	དགེ་སློང་གིས་དགེ་འདུན་གྱི་སེམས་མགུ་བར་བྱས་ན་། གང་ན་དགེ་སློང་ཉི་ཤུའི་ཚོགས་ཀྱི་དགེ་འདུན་ཡོད་པ་དེར་། དགེ་སློང་དེ་དབྱུང་བར་བྱའོ་༎
 ekenāpi ced ūno viṃśatigaṇo bhikṣusaṃghas taṃ bhikṣum āvarhet sa ca bhikṣur anāvrīḍas te ca bhikṣavo gārhyāḥ tatra samayaḥ |	གལ་ཏེ་དགེ་སློང་ཉི་ཤུར་གཅིག་གིས་མ་ཚང་བའི་ཚོགས་ཀྱི་དགེ་འདུན་གྱིས་དགེ་སློང་དེ་འབྱིན་པར་བྱེད་ན་། དགེ་སློང་དེ་ཡང་མ་ཕྱིན་ལ་། དགེ་སློང་དེ་དག་ཀྱང་སྨད་པར་བྱ་བ་ཡིན་ཏེ་། དེ་ལ་དེ་ནི་ཆོ་ག་ཡིན་ནོ་༎
 yatrāhaṃ āyuṣmataḥ paripṛcchāmi -- kaścit sthātra pariśuddhāḥ dvir api trir api paripṛcchāmi -- kaścit sthātra pariśuddhāḥ	དེ་ལ་བདག་གིས་ཚེ་དང་ལྡན་པ་དག་ལ་ཅི་འདི་ལ་ཁྱེད་ཡོངས་སུ་དག་གམ་ཞེས་དྲིའོ་༎ ཅི་འདི་ལ་ཁྱེད་ཡོངས་སུ་དག་གམ་ཞེས་ལན་གཉིས་ལན་གསུམ་དུ་དྲིའོ་༎
 pariśuddhā atrāyuṣmanto yasmāt tūṣṇīm evaitad dhārayāmi | iii| dvāv aniyatau dharmau |	འདི་ལ་ཚེ་དང་ལྡན་པ་དག་ཡོངས་སུ་དག་ན་འདི་ལྟར་ཅང་མི་སྨྲ་བས་དེ་དེ་བཞིན་དུ་འཛིན་ཏོ་༎ སྡོམ་ལ༏་དབེན་པ་སྐྱབས་ཡོད་འདུག་པའོ་༎
 imau khalu āyuṣmantau dvau aniyatau dharmau anvardhamāsaṃ prātimokṣasūtroddeśam āgacchataḥ | aniy|1 (prmosū_mū-banerjee)	ཚེ་དང་ལྡན་པ་དག་མ་ངེས་པའི་ཆོས་གཉིས་པོ་འདི་དག་ནི་ཟླ་བ་ཕྱེད་ཕྱེད་ཅིང་སོ་སོར་ཐར་པའི་མདོ་འདོན་པ་ལས་འབྱུང་ངོ་༎
 yaḥ punar bhikṣur mātṛgrāmeṇa sārdham eka ekikayā rahasi praticchanne āsane niṣadyāṃ kalpayed alaṃ kāmayitum* |	ཡང་དགེ་སློང་གང་བུད་མེད་ཀྱི་ཡུལ་དང་ལྷན་ཅིག་གཅིག་པུ་གཅིག་བུ་དང་དབེན་པ་སྐྱབས་ཡོད་པ་ན་། འདོད་པ་བྱར་རུང་བ་སྟན་ལ་འདུག་པར་བྱེད་ཅིང་།
 sacec chrāddheyavacanopāsikā trayāṇāṃ dharmāṇām anyatamānyatamadharmeṇa vadet pārājikena	དེ་ལ་གལ་ཏེ་དགེ་བསྙེན་མ་ཡིད་ཆེས་པའི་ཚིག་དང་ལྡན་པས་ཆོས་༄༡༡ཨ་༌༎ གསུམ་པོ་ཕམ་པར་གྱུར་པའམ་།
 vā saṃghādiśeṣeṇa vā pāyantikena vā niṣadyāṃ bhikṣuḥ pratijānamānaḥ trayāṇāṃ dharmāṇām	དགེ་འདུན་ལྷག་མའམ་། ལྟུང་བྱེད་ལས་ཆོས་གང་ཡང་རུང་བས་སྨྲས་པར་གྱུར་ལ་། དགེ་སློང་གིས་འདུག་པར་ཁས་བླངས་ན་། ཆོས་གསུམ་པོ་ཕམ་པར་གྱུར་པའམ་།
 anyatamānyatamena dharmeṇa kārayitavyaḥ pārājikena vā saṃghāvaśeṣeṇa vā pāyantikena	དགེ་འདུན་གྱི་ལྷག་མའམ་། ལྟུང་བྱེད་ལས་། ཆོས་གང་ཡང་རུང་བས་བྱེད་དུ་གཞུག་ཅིང་།
 vā yena yena vā punaḥ śrāddheyavacanopāsikā taṃ bhikṣuṃ dharmeṇa vadet tena tena dharmeṇa sa bhikṣuḥ kārayitavyo 'yaṃ dharmo 'niyataḥ | aniy|2 (prmosū_mū-banerjee)	དགེ་སློང་དེ་ལ་དགེ་བསྙེན་མ་ཡིད་ཆེས་པའི་ཚིག་དང་ལྡན་པས་ཆོས་གང་དང་གང་གིས་སྨྲས་པར་གྱུར་པའི་ཆོས་དེ་དང་དེས་དགེ་སློང་དེ་བྱེད་དུ་གཞུག་སྟེ་། དེ་ནི་མ་ངེས་པའི་ཆོས་སོ་༎
 yaḥ punar bhikṣur mātṛgrāmeṇa sārdham eka ekikayā rahasi praticchanne āsane niṣadyāṃ kalpayen nālaṃ kāmayitum* |	ཡང་དགེ་སློང་གང་བུད་མེད་ཀྱི་ཡུལ་དང་ལྷན་ཅིག་གཅིག་པུ་གཅིག་དང་དབེན་པ་སྐྱབས་ཡོད་པ་ན་། འདོད་པ་བྱར་མི་རུང་བར་སྟན་ལ་འདུག་པར་བྱེད་ཅིང་།
 sacec chrāddheyavacanopāsikā dvayor dharmayoḥ anyatamānyatamadharmeṇa vadet saṃghāvaśeṣeṇa	དེ་གལ་ཏེ་དགེ་བསྙེན་མ་ཡིད་ཆེས་པའི་ཚིག་དང་ལྡན་པས་ཆོས་གཉིས་པོ་དགེ་འདུན་ལྷག་མའམ་། ལྟུང་བྱེད་ལས་ཆོས་གང་ཡང་རུང་བས་སྨྲས་པར་གྱུར་ལ་།
 vā pāyantikena vā niṣadyāṃ bhikṣuḥ pratijānato dvayor dharmayoḥ saṃghāvaśeṣeṇa vā	དགེ་སློང་གིས་འདུག་པར་ཁས་བླངས་ན་། ཆོས་གཉིས་པོ་དགེ་འདུན་ལྷག་མའམ་། ལྟུང་བྱེད་ལས་ཆོས་གང་ཡང་རུང་བས་བྱེད་དུ་གཞུག་ཅིང་།
 pāyantikena vā yena yena vā punaḥ śrāddheyavacanopāsikā taṃ bhikṣuṃ dharmeṇa vadet	དགེ་སློང་དེ་ལ་དགེ་བསྙེན་མ་ཡིད་ཆེས་པའི་ཚིག་དང་ལྡན་པས་།
 tena tena dharmeṇa sa bhikṣuḥ kārayitavyo 'yam api dharmo 'niyataḥ |	ཆོས་གང་དང་གང་གིས་སྨྲས་པར་གྱུར་པའི་ཆོས་དེ་དང་དེས་། དགེ་སློང་དེ་བྱེད་དུ་གཞུག་སྟེ་། དེ་ཡང་མ་ངེས་པའི་ཆོས་སོ་༎
 uddiṣṭā me āyuṣmantaḥ dvāv aniyatau dharmau |	ཚེ་དང་ལྡན་པ་དག་བདག་གིས་མ་ངེས་པའི་ཆོས་གཉིས་པོ་དག་བཏོན་ཟིན་ཏོ་༎
 tatrāham āyuṣmataḥ paripṛcchāmi -- kaścit sthātra pariśuddhāḥ dvir api trir api paripṛcchāmi -- kaścit sthātra pariśuddhāḥ	དེ་ལ་བདག་གིས་ཚེ་དང་ལྡན་པ་དག་ལ་ཅི་འདི་ལ་ཁྱེད་ཡོངས་སུ་དག་གམ་ཞེས་དྲིའོ་༎ ༄༡༡བ་ཅི་འདི་ལ་ཁྱེད་ཡོངས་སུ་དག་གམ་ཞེས་ལན་གཉིས་ལན་གསུམ་དུ་དྲིའོ་༎
 pariśuddhā atrāyuṣmanto yasmāt tūṣṇīm evam etad dhārayāmi | triṃśan naisargikapāyantikā dharmāḥ	འདི་ལ་ཚེ་དང་ལྡན་པ་དག་ཡོངས་སུ་དག་ན་འདི་ལྟར་ཅང་མི་སྨྲ་བས་དེ་དེ་བཞིན་དུ་འཛིན་ཏོ་༎ སྡོམ་ལ་། འཆང་བ་འབྲལ་བ་འཇོག་པ་དང་༎ འཁྲུར་འཇུག་པ་དང་ལེན་པ་དང་༎ སློང་དང་སྟོད་ག-ཡོགས་སྨད་ག-ཡོགས་བཅས་༎ རིན་ཐང་སོ་སོར་བསྐུར་བའོ་༎
 ime khalu āyuṣmantas triṃśan naisargikāḥ pāyantikā dharmā anvardhamāsaṃ prātimokṣasūtroddeśam āgacchanti | np|1 (prmosū_mū-banerjee)	ཚེ་དང་ལྡན་པ་དག་སྤང་བའི་ལྟུང་བྱེད་ཀྱི་ཆོས་སུམ་ཅུ་པོ་འདི་དག་ནི་། ཟླ་བ་ཕྱེད་ཕྱེད་ཅིང་སོ་སོར་ཐར་པའི་མདོ་འདོན་པ་ལས་འབྱུང་ངོ་༎
 niṣṭhitacīvareṇa bhikṣuṇā uddhṛte kaṭhine daśāhaparamaṃ atirekacīvaram avikalpitaṃ dhārayitavyaṃ tataḥ uttari dhārayen naisargikā pāyantikā np|2 (prmosū_mū-banerjee)	དགེ་སློང་ཆོས་གོས་ཟིན་པས་། སྲ་བརྐྱང་ཕྱུང་ན་ཞག་བཅུའི་བར་དུ་གོས་ལྷག་པ་རྣམ་པར་མ་བརྟགས་པ་བཅང་བར་བྱའོ་༎ དེ་ལས་འདས་པར་འཆང་ན་སྤང་བའི་ལྟུང་བྱེད་དོ་༎
 niṣṭhitacīvaro bhikṣuḥ uddhṛtakaṭhine ekarātram api cet trayāṇāṃ cīvarāṇām anyatamānyatamasya cīvarād bahiḥsīmāṃ vipravased anyatra saṃghasaṃmatyā	དགེ་སློང་ཆོས་གོས་ཟིན་པས་སྲ་བརྐྱང་ཕྱུང་ན་། གལ་ཏེ་ནུབ་གཅིག་ཀྱང་ཆོས་གོས་གསུམ་ལས་ཆོས་གོས་གང་ཡང་རུང་བ་དང་མཚམས་ཀྱི་ཕྱི་རོལ་ཏུ་འབྲལ་བར་བྱེད་ན༏་དགེ་འདུན་གྱིས་གནང་བ་མ་གཏོགས་ཏེ་། 
 saṃghasaṃvṛttyā] naisargikapāyantikā | np|3 (prmosū_mū-banerjee)	སྤང་བའི་ལྟུང་བྱེད་དོ་༎
 niṣṭhitacīvarasya bhikṣor uddhṛte kaṭhine utpatya akālacīvaram ākāṃkṣinā tena bhikṣuṇā tac cīvaraṃ pratigṛhītavyaṃ pratigṛhya sacet paripūryate kṣipram eva kṛtvā dhārayitavyam* |	དགེ་སློང་ཆོས་གོས་ཟིན་པས་སྲ་བརྐྱང་ཕྱུང་ན་། དུས་མ་ཡིན་པའི་གོས་ཤིག་རྙེད་ལ་འདོད་ན་དགེ་སློང་དེས་གོས་དེ་བླང་བར་བྱའོ་༎ བླངས་ནས་གལ་ཏེ་ལངས་ན་མྱུར་བ་ཁོ་ནར་གོས་སུ་བྱས་ལ་བཅང་བར་བྱའོ་༎
 no cet paripūryate māsaparamaṃ tena bhikṣuṇā tac cīvaram upanikṣiptavyaṃ satyāṃ cīvarapratyāśāyām ūnasya vā paripūrayet tataḥ uttari upanikṣipen naisargikapāyantikā | np|4 (prmosū_mū-banerjee)	གལ་ཏེ་མི་ལངས་ལ་ཁ་མ་ལངས་པ་ཁ་སྐོང་བའི་གོས་ལ་རེ་བ་ཡོད་ན་། དགེ་སློང་དེས་ཆོས་གོས་དེ་ཟླ་བ་གཅིག་གི་མཐར་གཞག་པར་བྱའོ་༎ དེ་ལས་འདས་པར་འཇོག་ན་སྤང་བའི་ལྟུང་བྱེད་དོ་༎
 yaḥ punar bhikṣur ajñātikayā bhikṣuṇyā purāṇacīvaraṃ dhāvayed raṃjayed ākoṭayed vā naisargikapāyantikā |	ཡང་དགེ་སློང་གང་དགེ་སློང་མ་ཉེ་དུ་མ་ཡིན་པ་ལ་གོས་རྙིང་པ་འཁྲུར་འཇུག་གམ་། འཚེད་དུ་འཇུག་གམ་། འཆག་ཏུ་༄༡༢ཨ་༌༎ འཇུག་ན་སྤང་བའི་ལྟུང་བྱེད་དོ་༎
 np|5 (prmosū_mū-banerjee) yaḥ punar bhikṣur ajñātikayā bhikṣuṇyā santikāc cīvaraṃ pratigṛhṇīyād anyatra parivartakān naisargikapātayantikā | np|6 (prmosū_mū-banerjee)	ཡང་དགེ་སློང་གང་དགེ་སློང་མ་ཉེ་དུ་མ་ཡིན་པ་ལས་གོས་ལེན་ན་བརྗེས་པ་མ་གཏོགས་ཏེ་། སྤང་བའི་ལྟུང་བྱེད་དོ་༎
 yaḥ punar bhikṣur ajñātigṛhapatiṃ gṛhapatipatnīṃ vopasaṃkramya cīvaraṃ vijñāpayed anyatra samayān naisargikapāyantikā |	ཡང་དགེ་སློང་གང་ཁྱིམ་བདག་གམ་། ཁྱིམ་བདག་གི་ཆུང་མ་ཉེ་དུ་མ་ཡིན་པའི་གན་དུ་སོང་སྟེ་། གོས་སློང་ན་དུས་མ་གཏོགས་ཏེ་། སྤང་བའི་ལྟུང་བྱེད་དོ་༎
 tatrāyaṃ samaya ācchinnacīvaro bhikṣur bhavati naṣṭacīvaro dagdhacīvaro ūḍhacīvaro hṛtacīvaro 'yaṃ tatra samayaḥ | np|7 (prmosū_mū-banerjee)	དེ་ལ་དུས་ནི་འདི་ཡིན་ཏེ་། དགེ་སློང་གོས་ཕྲོགས་སམ་། གོས་རླག་གམ་། གོས་ཚིག་གམ་། གོས་རླུང་གིས་ཁྱེར་རམ་། གོས་ཆུས་ཁྱེར་ན་། དེ་ལ་དེ་ནི་དུས་ཡིན་ནོ་༎
 ācchinnacīvareṇa bhikṣuṇā naṣṭacīvareṇa dagdhacīvareṇa ūḍhacīvareṇa hṛtacīvareṇājñātigṛhapatinā	དགེ་སློང་གོས་ཕྲོགས་སམ་། གོས་རླག་གམ་། གོས་ཚིག་གམ་། གོས་རླུང་གིས་ཁྱེར་རམ་། གོས་ཆུས་ཁྱེར་ན་ཁྱིམ་བདག་གམ་། ཁྱིམ་བདག་གི་ཆུང་མ་ཉེ་དུ་མ་ཡིན་པའི་གན་དུ་སོང་ལ་གོས་བསླང་བར་བྱའོ་༎
 gṛhapatipatnīṃ cīvaraṃ vijñāpayitavyaḥ taṃ cec chrāddho brāhmaṇo gṛhapatir vātyarthaṃ	དེ་ལ་གལ་ཏེ་བྲམ་ཟེའམ་། ཁྱིམ་བདག་དད་པ་ཅན་ཞིག་གིས་། དུས་ཀྱིས་གོས་མང་པོ་སྟོབས་ལ་འདོད་ན་།
 saṃbahulaiś cīvaraiḥ pravārayed ākāṃkṣatā tena bhikṣuṇā sāntarottaraparamaṃ tasmāc cīvaraṃ pratigṛhītavyaṃ tata uttari pratigṛhṇīyān naisargikā pāyantikā | np|8 (prmosū_mū-banerjee)	དགེ་སློང་དེས་དེ་ལས་གོས་སྟོད་ག-ཡོགས་སྨད་ག-ཡོགས་དང་བཅས་པའི་མཐར་ཐུག་པ་བླང་བར་བྱའོ་༎ དེ་ལས་ལྷག་པར་བེན་ན་སྤང་བའི་ལྟུང་བྱེད་དོ་༎
 bhikṣuṃ khalūddiśyājñātinā gṛhapatinā gṛhapatipatnyā vā cīvaracetanakāni pratyupasthāpitāni	དགེ་སློང་གི་ཕྱིར་ཁྱིམ་བདག་གམ་། ཁྱིམ་བདག་གི་ཆུང་མ་ཉེ་དུ་མ་ཡིན་པས་གོས་ཀྱི་རིན་དག་སྤགས་ནས་།
 syuḥ ebhir ahaṃ cīvaracetanakair evaṃrūpaṃ caivaṃrūpaṃ ca cīvaraṃ cetayitvā evaṃnāmā	བདག་གི་གོས་ཀྱི་རིན་འདི་དག་གིས་གོས་འདི་དང་འདི་ལྟ་བུ་ཞིག་ཉོས་ལ་།
 bhikṣur upasaṃkramiṣyati tam ācchādayiṣyāmi cīvareṇa kāle kalpikeneti | tatra caiko bhikṣuḥ pūrvam apravāritaḥ san kaṃcid eva vikalpaṃ pratipadya tam ajñātiṃ	དགེ་སློང་མིང་འདི་ཞེས་བྱ་བ་འོངས་པ་དང་། དེ་ལ་གོས་རུང་བ་དུས་སུ་བསྐོན་ནོ་སྙམ་པ་ལས་དེ་ན་གལ་ཏེ་དགེ་སློང་དེ་ལ་སྔར་མ་བསྟབས་པར་རྣམ་པར་རྟོག་པ་འགའ་ཞིག་བྱུང་སྟེ་། 
 gṛhapatiṃ gṛhapatipatnīṃ vopasaṃkramyaivaṃ vaded yāni tāni āyuṣmatā mām uddiśya cīvaracetanakāni	བཟང་པོ་འདོད་༄༡༢བ་པའི་ཕྱིར་ཁྱིམ་བདག་གམ་། ཁྱིམ་བདག་གི་ཆུང་མ་ཉེ་དུ་མ་ཡིན་པ་དེའི་གན་དུ་སོང་ནས་།
 pratyupasthāpitāni sādhyāyuṣmaṃs te cīvaracetanakair evaṃrūpaṃ caivaṃrūpaṃ ca cīvaraṃ cetayitvā ācchādaye 'haṃ cīvareṇa kālena kalpikeneti | abhiniṣpanne cīvare naisargikā pāyantikā | np|9 (prmosū_mū-banerjee)	འདི་སྐད་ཅེས་ཚེ་དང་ལྡན་པས་བདག་གི་ཕྱིར་གོས་ཀྱི་རིན་གང་དག་སྤགས་པའི་གོས་ཀྱི་རིན་དེ་དག་གིས་ཚེ་དང་ལྡན་པ་གོས་འདི་དང་འདི་ལྟ་བུ་ཞིག་ཉོས་ལ་བདག་ལ་གོས་རུང་བ་དུས་སུ་ལེགས་པར་སྐོན་ཅིག་ཅེས་སྨྲས་ཏེ་། གོས་གྲུབ་པ་ན་སྤང་བའི་ལྟུང་བྱེད་དོ་༎
 bhikṣuṃ khalūddiśyājñātinā gṛhapatinā gṛhapatipatnyā ca pratyekapratyekāni cīvaracetanakāni pratyupasthāpitāni syuḥ |	དགེ་སློང་གི་ཕྱིར་ཁྱིམ་བདག་དང་། ཁྱིམ་བདག་གི་ཆུང་མ་ཉེ་དུ་མ་ཡིན་པས་གོས་ཀྱི་རིན་སོ་སོ་བ་དེ་དག་སྤགས་ནས་། བདག་ཅག་གཉིས་ཀྱིས་གོས་ཀྱི་རིན་སོ་སོ་བ་འདི་དག་གིས་།
 ebhir āvāṃ pratyekapratyekaiḥ cīvaracetanakair evaṃrūpaṃ caivaṃrūpaṃ ca pratyekapratyekaṃ cīvaraṃ cetayitvā evaṃnāmā bhikṣur upasaṃkramiṣyati tam ācchādayiṣyāvaḥ | pratyekapratyekābhyāṃ cīvaracetanakābhyāṃ kāle kalpikābhyām iti |	གོས་འདི་དང་འདི་ལྟ་བུ་སོ་སོ་བདག་ཉོས་ལ་། དགེ་སློང་མིང་འདི་ཞེས་བྱ་བ་འོངས་པ་དང་། བདག་ཅག་གཉིས་ཀྱིས་སོ་སོ་ནས་དེ་ལ་གོས་རུང་བ་དུས་སུ་བསྐོན་ནོ་སྙམ་པ་ལས་།
 tatra cet sa bhikṣuḥ pūrvam apravāritaḥ san kaṃcid eva vikalpam āpatya tam ajñātigṛhapatiṃ gṛhapatipatnīṃ vopasaṃkramyaivaṃ vaded yāni tāny āyuṣmatyātmān uddiśya pratyekapratyekāni cīvaracetanakāni pratyupasthāpitāni | sādhyāyuṣmatau tau pratyekapratyekaiś cīvaracetanakair evaṃrūpaṃ caivaṃrūpaṃ ca cīvaraṃ	དེ་ན་གལ་ཏེ་དགེ་སློང་དེ་ལ་སྔར་མ་བསྟབས་པར་རྣམ་པར་རྟོག་པ་འགའ་ཞིག་བྱུང་སྟེ་། བཟང་པོ་འདོད་པའི་ཕྱིར་ཁྱིམ་བདག་དང་། ཁྱིམ་བདག་གི་ཆུང་མ་ཉེ་དུ་མ་ཡིན་པ་དེ་དག་གི་གན་དུ་སོང་ནས་འདི་སྐད་ཅེས་། ཚེ་དང་ལྡན་པ་དག་གིས་བདག་གི་ཕྱིར་གོས་ཀྱི་རིན་སོ་སོ་བ་དག་སྤགས་པའི་གོས་ཀྱི་རིན་སོ་སོ་བ་དེ་དག་གིས་ཚེ་དང་ལྡན་པ་དག་གོས་འདི་དང་འདི་ལྟ་བུ་སོ་སོ་བ་དག་ཉོས་ལ་གཉི་ག་འདུས་ཏེ་།
 cetayitvā ācchādayatām ubhāv api bhūtvā ekaikena cīvareṇa kāle kalpikena kalyāṇakāmatām upādāyābhiniṣpanne cīvare naisargikā pāyantikā |	བདག་ལ་གོས་རུང་བ་ཞིག་དུས་སུ་ལེགས་པར་སྐོན་ཅིག་།
 np|10 (prmosū_mū-banerjee)	ཅེས་སྨྲས་ཏེ་། གོས་གྲུབ་པ་ན་སྤང་བའི་ལྟུང་བྱེད་དོ་༎
 bhikṣuṃ khalūddiśya rājñā vā rājamātreṇa vā brāhmaṇena vā gṛhapatinā vā naigamena	དགེ་སློང་གི་ཕྱིར་རྒྱལ་པོའམ་། བློན་པོ་ཆེན་པོའམ་། བྲམ་ཟེའམ་། ཁྱིམ་བདག་གམ་། གྲོང་རྡལ་གྱི་མིའམ་། ཡུལ་མིའམ་།
 vā jānapadena vā dhaninā vā śreṣṭhinā vā sārthavāhena vā dūtasya haste cīvaracetanakāni anupreṣitāni syuḥ |	ནོར་ཅན་ནམ་། ཚོང་དཔོན་ནམ་། ༄༡༣ཨ་༌༎ དེད་དཔོན་གྱིས་ཕོ་ཉའི་ལག་ཏུ་གོས་ཀྱི་རིན་དག་བསྐུར་བར་གྱུར་ལ་།
 atha sa dūtas tāni cetanakāni ādāya yena sa bhikṣus tenopasaṃkrāmed upasaṃkramya taṃ bhikṣum evaṃ vaded yat khalv ārya jānīyāt tvām uddiśya rājñā vā rājamātreṇa vā	དེ་ནས་ཕོ་ཉ་དེ་གོས་ཀྱི་རིན་དེ་དག་ཁྱེར་ནས་། དགེ་སློང་དེ་ག་ལ་བ་དེར་སོང་སྟེ་ཕྱིན་ནས་། དགེ་སློང་དེ་ལ་འདི་སྐད་ཅེས་འཕགས་པ་མཁྱེན་པར་མཛོད་ཅིག་། ཁྱོད་ལ་རྒྱལ་པོའམ་། བློན་པོ་ཆེན་པོའམ་།
 brāhmaṇena vā gṛhapatinā vā naigamena vā jānapadena vā dhaninā vā śreṣṭhinā vā sārthavāhena	བྲམ་ཟེའམ་། ཁྱིམ་བདག་གམ་། གྲོང་རྡལ་གྱི་མིའམ་། ཡུལ་གྱི་མིའམ་། ནོར་ཅན་ནམ་། ཚོང་དཔོན་ནམ་། དེད་དཔོན་ཆེ་གེ་མོས་གོས་ཀྱི་རིན་འདི་དག་བསྐུར་གྱིས་།
 vā cīvaracetanakena vānupreṣitāny āryaṃ pratigṛhṇātv anukampām upādāya |	འཕགས་པས་ཐུགས་བརྩེ་བའི་སླད་དུ་འདི་དག་བཞེས་ཤིག་ཅེས་ཟེར་ན་།
 tena bhikṣuṇā sa dūta idaṃ syād vacanīyaḥ -- gacchāyuṣman dūta bhikṣūṇāṃ cīvaracetanakāni patyante parigṛhītuṃ |	དགེ་སློང་དེས་ཕོ་ཉ་དེ་ལ་འདི་སྐད་ཅེས་ཚེ་དང་ལྡན་པ་ཕོ་ཉ་། དགེ་སློང་དག་ནི་གོས་ཀྱི་རིན་དག་ལེན་དུ་མི་རུང་སྟེ་།
 cīvaraṃ tu vayaṃ labdhvā pratigṛhṇīmaḥ kāle kalpikaṃ |	བདག་ཅག་གོས་རུང་བ་དུས་སུ་རྙེད་པ་ན་ནི་ལེན་ཏོ་ཞེས་བརྗོད་པར་བྱའོ་༎
 sa dūtas taṃ bhikṣum evaṃ vaded asti kaścid āryāṇāṃ vaiyyāvṛtyakaro ya āryāṇāṃ vaiyyāvṛtyaṃ pratyanubhavatīti |	གལ་ཏེ་ཕོ་ཉ་དེས་དགེ་སློང་དེ་ལ་འདི་སྐད་ཅེས་འཕགས་པ་རྣམས་ཀྱི་ཞལ་ཏ་བགྱིད་པ་། འཕགས་པ་རྣམས་ཀྱི་ཞལ་ཏ་ཉམས་སུ་ལེན་པ་། གང་ལགས་པ་འགའ་མཆིས་སམ་ཞེས་ཟེར་ན་། དགེ་སློང་གོས་འདོད་པས་ཕོ་ཉ་ལ་འདི་སྐད་ཅེས་། ཚེ་དང་ལྡན་པ་ཕོ་ཉ་འདི་ནི་དགེ་སློང་རྣམས་ཀྱི་ཞལ་ཏ་བྱེད་པ་སྟེ་། འདི་ནི་དགེ་སློང་རྣམས་ཀྱི་ཞལ་ཏ་ཉམས་སུ་ལེན་པའོ་ཞེས་།
 cīvarārthikena bhikṣuṇā vaiyyāvṛtyakaro vyapadeṣṭavya ārāmiko vā upāsako vā ete dūta bhikṣūṇāṃ vaiyyāvṛtyakarā ete bhikṣūṇāṃ vaiyyāvṛtyaṃ pratyanubhavantīti	ཀུན་དགའི་ར་བ་པའམ་། དགེ་བསྙེན་ཞལ་ཏ་བྱེད་པ་བསྟན་པར་བྱའོ་༎
 atha sa dūtas tāni cīvaracetanakāny ādāya yena sa vaiyyāvṛtyakaras tenopasaṃkrāmet* |	དེ་ནས་ཕོ་ཉ་དེས་གོས་ཀྱི་རིན་དེ་དག་ཁྱིར་ནས་། ཞལ་ཏ་བྱེད་པ་ག་ལ་བ་དེར་འགྲོ་བར་བྱ་ཞིང་།
 upasaṃkramya taṃ vaiyyāvṛtyakaram evaṃ vadet* |	ཕྱིན་ནས་ཞལ་ཏ་བྱེད་པ་ལ་འདི་སྐད་ཅེས་ཚེས་དང་ལྡན་པ་ཞལ་ཏ་༄༡༣བ་བྱེད་པ་། ཤེས་པར་གྱིས་ཤིག་།
 khalv āyuṣman vaiyyāvṛtyakara jānīyā ebhis taṃ cīvaracetanakair evaṃrūpam caivaṃrūpaṃ	ཁྱོད་ཀྱིས་གོས་ཀྱི་རིན་འདི་དག་གིས་གོས་འདི་དང་འདི་ལྟ་བུ་ཞིག་ཉོས་ལ་།
 ca cīvaraṃ cetayitvā evaṃnāmā bhikṣur upasaṃkramiṣyati tam ācchādayethā cīvareṇa kāle kalpiteneti |	དགེ་སློང་མིང་འདི་ཞེས་བྱ་བ་འོངས་པ་དང་། དེ་ལ་གོས་རུང་བ་དུས་སུ་སྐོན་ཅིག་ཅེས་བརྗོད་པར་བྱའོ་༎
 atha sa dūtas taṃ vaiyyāvṛtyakaraṃ sādhu ca suṣṭhu ca samanuyujya samanuśiṣya yena sa bhikṣus tena saṃkrāmet* |	དེ་ནས་ཕོ་ཉ་དེས་ཞལ་ཏ་བྱེད་པ་དེ་ལ་ཤིན་ཏུ་ལེགས་པར་ཡང་དག་པར་བསྒོ་ཞིང་ཡང་དག་པར་བསྟན་ནས་དགེ་སློང་དེ་ག་ལ་བ་དེར་འགྲོ་བར་བྱ་ཞིང་ཕྱིན་ནས་།
 upasaṃkramya taṃ bhikṣum evaṃ vaded yo 'sāv āryeṇa vaiyyāvṛtyakaro vyapadiṣṭaḥ samanuśiṣṭaḥ samayena tam upasaṃkrāmethā ācchādayiṣyati sa satvāṃ cīvareṇa kāle kalpiteneti |	དགེ་སློང་དེ་ལ་འདི་སྐད་ཅེས་འཕགས་པས་ཞལ་ཏ་བགྱིད་པ་བསྟན་པ་གང་ལགས་པ་དེ་ལ་། བདག་གིས་ཡང་དག་པར་བསྟན་ལགས་ཀྱིས་དེའི་གན་དུ་བཞུད་ཅིག་དང་། དེས་ཁྱོད་ལ་གོས་རུང་བ་དུས་སུ་བསྐོན་པར་འགྱུར་རོ་༎ ཞེས་བརྗོད་པར་བྱའོ་༎
 cīvarārthikena bhikṣuṇā vaiyyāvṛtyakara upasaṃkramya dvis triś codayitavyaḥ smārayitavyo	དགེ་སློང་གོས་འདོད་པས་ཞལ་ཏ་བྱེད་པའི་གན་དུ་སོང་ནས་།
 'rthiko 'smy āyuṣman vaiyyāvṛtyakara cīvareṇārthiko 'smy āyuṣman vaiyyāvṛtyakara cīvareṇeti |	ཚེ་དང་ལྡན་པ་ཞལ་ཏ་བྱེད་པ་བདག་གོས་འདོད་དོ་༎ ཚེ་དང་ལྡན་པ་ཞལ་ཏ་བྱེད་པ་བདག་གོས་འདོད་དོ་ཞེས་ལན་གཉིས་ལན་གསུམ་དུ་བསྐུལ་བར་བྱ་། དྲན་པར་བྱའོ་༎
 dvis triś codayataḥ smārayataḥ sacet tac cīvaram abhiniṣpadyate ity evaṃ kuśalaṃ	ལན་གཉིས་ལན་གསུམ་དུ་བསྐུལ་ཞིང་དྲན་པར་བྱས་པ་ན་། གལ་ཏེ་གོས་དེ་གྲུབ་ན་དེ་ལྟ་ན་ལེགས་།
 no ced abhiniṣpadyeta catuṣpaṃcaṣaṭkṛtvaḥ paraṃ tūṣṇīm uddeśe sthātavyaṃ catuṣpaṃcaṣaṭkṛtvā	གལ་ཏེ་མ་གྲུབ་ན་ལན་བཞི་ལན་ལྔ་ལན་དྲུག་གི་བར་དུ་ཕྱོགས་སུ་ཅང་མི་ཟེར་བར་བསྡད་པར་བྱའོ་༎ ལན་བཞི་ལན་ལྔ་ལན་དྲུག་གི་བར་དུ་ཕྱོགས་སུ་ཅང་མི་སྨྲ་བར་བསྡད་བསྡད་པར་བྱའོ་༎ པ་ན་། 
 paraṃ tūṣṇahīm uddeśe sthitasya sacet tac cīvaram abhiniṣpadyeta ity evaṃ kuśalaṃ no ced abhiniṣpadyeta na uttari dhyāyacchec cīvarasyābhinivartaye abhiṣpanne cīvare	གལ་ཏེ་གོས་དེ་གྲུབ་ན་དེ་ལྟ་ན་ལེགས་། གལ་ཏེ་མ་གྲུབ་ན་། དེའི་འོག་ཏུ་གོས་བསྒྲུབ་པའི་ཕྱིར་། བརྩལ་ཏེ་གོས་གྲུབ་ན་།
 naisargikapāyantikā |	སྤང་བའི་ལྟུང་བྱེད་དོ་༎
 no ced abhiniṣpadyeta yasyā diśas tāni cīvaracetanakāny ānītāni tatra svayaṃ vā gantavyam	གལ་ཏེ་མ་གྲུབ་ན་ཕྱོགས་གང་ནས་གོས་ཀྱི་རིན་དེ་དག་འོངས་པ་དེར་བདག་འགྲོ་བར་བྱའོ་༎ ཡང་༄༡༤ཨ་༌༎
 āpto vā dūto 'nupreṣitavyaḥ yāni tāny āyuṣmadbhir evaṃnāmānaṃ bhikṣum uddiśya cīvaracetanakāny anupreṣitāni na tāni tasya bhikṣoḥ kaṃcid arthaṃ spharanti prajānātv āyuṣmantaḥ svam	ན་ཡིད་བརྟན་པའི་ཕོ་ཉ་ལས་ཚེ་དང་ལྡན་པ་དག་གིས་དགེ་སློང་ཆེ་གེ་མོའི་ཕྱིར་གོས་ཀྱི་རིན་གང་དག་བསྐུར་བ་དེ་དག་ནི་།
 arthaṃ mā vo 'rthaḥ praṇaśyatv ity ayaṃ tatra sāmayaḥ |	དགེ་སློང་དེའི་དོན་ཅིར་ཡང་མ་གྲུབ་ཀྱིས་ཤེས་པར་གྱིས་ཤིག་། ཚེ་དང་ལྡན་པ་དག་གིས་རང་གི་ནོར་ཆུད་མ་གཟན་ཅིག་ཅེས་སྤྲིང་བར་བྱ་སྟེ་། དེ་ལ་དེ་ནི་ཆོ་ག་ཡིན་ནོ་༎
 np|11 (prmosū_mū-banerjee)	སྡོམ་ལ་། སྲིན་བལ་འབའ་ཞིག་ཆ་གཉིས་དང་༎ དྲུག་དང་མཐོ་གང་ལམ་དང་ནི་༎ འཁྲུ་བ་དང་ནི་གསེར་དངུལ་དང་༎ མངོན་མཚན་ཅན་དང་ཉོ་ཚོང་ངོ་༎
 yaḥ punar bhikṣur navaṃ kauśeyasaṃstaraṃ kārayen naisargikapāyantikā | np|12 (prmosū_mū-banerjee)	ཡང་དགེ་སློང་གང་སྲིན་བལ་གྱི་སྟན་གསར་པ་བྱེད་ན་སྤང་བའི་ལྟུང་བྱེད་དོ་༎
 yaḥ punar bhikṣuḥ śuddhakālakānām eḍakaromnāṃ navaṃ saṃstaraṃ kārayen naisargikapāyantikā | np|13 (prmosū_mū-banerjee)	ཡང་དགེ་སློང་གང་ལུག་བལ་ནག་པོ་འབའ་ཞིག་གི་སྟན་གསར་པ་བྱེད་ན་། སྤང་བའི་ལྟུང་བྱེད་དོ་༎
 navaṃ bhikṣuṇā saṃstaraṃ kārayatā dvau bhāgau śuddhakālakānām eḍakaromnām ādātavyau	དགེ་སློང་གིས་སྟན་གསར་པ་བྱེད་ན་ཆ་གཉིས་ནི་ལུག་བལ་ནག་པོ་འབའ་ཞིག་ལས་གཞུག་པར་བྱའོ་༎ 
 tṛtīyo 'vadātānāṃ caturtho gocarikāṇām anādāya ced bhikṣur dvau bhāgau śuddhakālakānām	གསུམ་པ་ནི་དཀར་པོ་ལས་།
 eḍakaromnāṃ tṛtīyo 'vadātānāṃ caturtho gocarikāṇāṃ navaṃ saṃstaraṃ kārayen naisargikapāyantikā | np|14 (prmosū_mū-banerjee)	བཞི་པ་ནི་འཁོབ་བལ་ལས་གཞུག་པར་བྱའོ་༎ གལ་ཏེ་དགེ་སློང་གིས་ཆ་གཉིས་ལུག་བལ་ནག་པོ་འབའ་ཞིག་ལས་མ་བཅུག་གམ་། གསུམ་པ་དཀར་པོ་ལས་། བཞི་པ་འཁོབ་བལ་ལས་མ་བཅུག་པར་སྟན་གསར་པ་བྱེད་ན་། སྤང་བའི་ལྟུང་བྱེད་དོ་༎
 navaṃ bhikṣuṇā saṃstaraṃ kārayatā akāmaṃ ṣaḍ varṣāṇi kṛtvā dhārayitavyam* |	དགེ་སློང་གིས་སྟན་གསར་པ་བྱེད་ན་། མི་འདོད་བཞིན་དུ་ལོ་དྲུག་ཏུ་བཅང་བར་བྱའོ་༎
 arvāk ced bhikṣuḥ ṣaṇṇāṃ varṣāṇāṃ taṃ purāṇasaṃstaraṃ niḥsṛjya vā aniḥsṛjya vā anyaṃ navaṃ saṃstaraṃ kārayed anyatra saṃghasaṃmatyā [saṃghasaṃvṛtyā] naisargikapāyantikā | np|15 (prmosū_mū-banerjee)	གལ་ཏེ་དགེ་སློང་ལོ་དྲུག་ཚུན་ཆད་དུ་སྟན་རྙིང་པ་དེ་སྤངས་ཀྱང་རུང་། མ་སྤངས་ཀྱང་རུང་། སྟན་གསར་པ་གཞན་བྱེད་ན་། དགེ་འདུན་གྱིས་གནང་བ་མ་གཏོགས་ཏེ་། སྤང་བའི་ལྟུང་བྱེད་དོ་༎ དགེ་སློང་གིས་གདིང་བ་གསར་པ་བྱེད་ན་། ༄༡༤བ་སར་པ་ཁ་དོག་མི་སྡུག་པར་བྱ་བའི་ཕྱིར་།
 navaṃ bhikṣuṇā niṣadanaṃ kārayitā purāṇaniṣadanasāmantakāt sugatavitastir ādātavyā navasya durvarṇīkaraṇāya |	གདིང་བ་རྙིང་པ་བདེ་བར་གཤེགས་པའི་མཐོ་གང་འཁོར་བས་གླན་པར་བྱའོ་༎
 anādāya ced bhikṣuḥ purāṇaniṣadanasāmantakāt sugatavitastiṃ navasya durvarṇīkaraṇāya navaṃ niṣadanaṃ paribhuṃjīta naisargikapāyantikā | np|16 (prmosū_mū-banerjee)	གལ་ཏེ་དགེ་སློང་གིས་གདིང་བ་ས་བར་ཁ་དོག་མི་སྡུག་བར་བྱ་བའི་ཕྱིར་། གདིང་བ་རྙིང་པ་བདེ་བར་གཤེགས་པའི་མཐོ་གང་འཁོར་བས་མ་གླན་པར་གདིང་བ་སར་པ་སྤྱོད་ན་སྤང་བའི་ལྟུང་བྱེད་དོ་༎
 bhikṣoḥ khalv adhvapratipannasyotpadyerann eḍakaromāṇy ākāṃkṣatā tena bhikṣuṇā pratigṛhītavyāni	དགེ་སློང་ལམ་དུ་ཞུགས་པས་ལུག་བལ་དག་རྙེད་ལ་འདོད་ན་དགེ་སློང་དེས་བླང་བར་བྱའོ་༎
 pratigṛhya yāvat triyojanaparamaṃ svayaṃ hartavyāny asati hārake tata uttari pāren naisargikapāyantikā | np|17 (prmosū_mū-banerjee)	བླངས་ནས་ཁྱེར་བ་མེད་ན་དཔག་ཚད་གསུམ་གྱི་མཐའི་བར་དུ་བདག་ཉིད་ཀྱིས་བསྐུར་བར་བྱའོ་༎ དེ་ལས་འདས་པར་ཁྱེར་ན་སྤང་བའི་ལྟུང་བྱེད་དོ་༎
 yaḥ punar bhikṣur ajñātikayā bhikṣuṇyā eḍakaromāṇi dhāvayed raṃjayed vivaṭed vivaṭāpayed vā naisargikapāyantikā | np|18 (prmosū_mū-banerjee)	ཡང་དགེ་སློང་གང་དགེ་སློང་མ་ཉེ་དུ་མ་ཡིན་པ་ལ་ལུག་བལ་འཁྲུར་འཇུག་གམ་། འཚེད་དུ་འཇུག་གམ་། རྨེལ་དུ་འཇུག་ན་། སྤང་བའི་ལྟུང་བྱེད་དོ་༎
 yaḥ punar bhikṣuḥ svahastaṃ jātarūparajatam udgṛhṇīyād udgrāhanasatvā naisargikā pāyantikā | np|19 (prmosū_mū-banerjee)	ཡང་དགེ་སློང་གང་རང་གི་ལག་གིས་གསེར་དངུལ་ལེན་ཏམ་། གཞན་ལེན་དུ་འཇུག་ན་སྤང་བའི་ལྟུང་བྱེད་དོ་༎
 yaḥ punar bhikṣur nānāprakāraṃ rūpikavyavahāraṃ samāpadyeta naisargikā pāyantikā | np|20 (prmosū_mū-banerjee)	ཡང་དགེ་སློང་གང་མངོན་མཚན་ཅན་གྱི་སྤྱོད་པ་རྣམ་པ་སྣ་ཚོགས་བྱེད་ན་སྤང་བའི་ལྟུང་བྱེད་དོ་༎ 
 yaḥ punar bhikṣur nānāprakāraṃ krayavikrayaṃ samāpadyeta naisargikā pāyantikā |	ཡང་དགེ་སློང་གང་ཉོ་ཚོང་རྣམ་པ་སྣ་ཚོགས་བྱེད་ན་སྤང་བའི་ལྟུང་བྱེད་དོ་༎
 np|21 (prmosū_mū-banerjee)	སྡོམ་ལ་། ལྷུང་བཟེད་གཉིས་དང་ཐ་ག་གཉིས་༎ བྱིན་འཕྲོག་སྟོན་ཟླ་ཐ་ཆུང་དང་༎ དགོན་པ་པ་དང་རས་ཆེན་དང་༎ བསྔོས་པ་དང་ནི་གསོག་འཇོག་གོ་།
 daśāhaparamaṃ bhikṣuṇā atirekapātraṃ dhārayitavyaṃ tata uttaraṃ paridhārayen naisargikā pāyantikā |	ཡང་དགེ་སློང་གིས་ལྷུང་བཟེད་ལྷག་པ་ཞག་བཅུའི་བར་དུ་བཅད་པར་བྱའོ་༎ དེ་ལས་འདས་པར་འཆང་ན་སྤང་བའི་ལྟུང་བྱེད་དོ་༎ ཡང་དགེ་སློང་གང་། ལྷུང་བཟེད་ལྷན་བ་ལྔ་མེད་པ་སྤྱད་བཟོད་པ་ཡོད་བཞིན་དུ་། བཟང་པོ་འདོད་པའི་ཕྱིར་ལྷུང་༄༡༥ཨ་༌༎
 np|22 (prmosū_mū-banerjee) yaḥ punar bhikṣur ūnapaṃcabandhanena pātreṇa pāribhogikenānyaṃ navaṃ pātraṃ paryeṣeta | kalyāṇakāmatām upādāyābhiniṣpanne pātre naisargikā pāyantikā |	བཟེད་སར་པ་གཞན་ཚོལ་ཞིང་ལྷུང་བཟེད་གྲུབ་ན་སྤང་བའི་ལྟུང་བྱེད་དོ་༎
 tena bhikṣuṇā tat pātraṃ bhikṣuparṣady upaniḥsṛṣṭavyaḥ yaḥ tasyāṃ bhikṣuparṣadi pātraparyanto bhavati |	དགེ་སློང་དེས་ལྷུང་བཟེད་དེ་དགེ་སློང་གི་འཁོར་ལ་དབུལ་བར་བྱའོ་༎ དགེ་སློང་གི་འཁོར་དེའི་ལྷུང་བཟེད་ཐ་མར་གྱུར་པ་གང་ཡིན་པ་དེ་དགེ་སློང་དེ་ལ་།
 tat tasya bhikṣor anupradātavyam idaṃ te bhikṣoḥ pātraṃ vādhiṣṭhātavyaṃ na vikārayitavyaṃ sacen mandaṃ mandaṃ paribhoktavyaṃ yāvad bhedanaparyantam upādāya ity ayaṃ tatra samayaḥ |	དགེ་སློང་ཁྱོད་ཀྱིས་ལྷུང་བཟེད་འདི་བྱིན་གྱིས་བརླབ་པར་མི་བྱ་། གཏང་བ་མི་བྱ་། གཞན་ལ་སྦྱིན་པར་མི་བྱ་བར་ཆག་པའི་མཐར་ཐུག་གི་བར་དུ་ཁད་ཀྱིས་དལ་བུ་དལ་བུས་སྤྱད་པར་བྱའོ་༎ 
 np|23 (prmosū_mū-banerjee)	ཞེས་སྦྱིན་པར་བྱ་སྟེ་། དེ་ལ་དེ་ནི་ཆོ་ག་ཡིན་ནོ་༎
 yaḥ punar bhikṣuḥ svayaṃ yācitena sūtreṇājñātinā tantuvāyena cīvaraṃ vāyeyam iti niṣpanne cīvare naisargikā pāyantikā | np|24 (prmosū_mū-banerjee)	ཡང་དགེ་སློང་གང་རང་གི་ལག་གིས་བསླངས་པའི་དོག་པས་ཐ་ག་པ་ཉེ་དུ་མ་ཡིན་པ་ལ་འཐག་ཏུ་འཇུག་ན་། གོས་གྲུབ་ན་སྤང་བའི་ལྟུང་བྱེད་དོ་༎
 bhikṣuṃ khalūddiśyājñātiḥ gṛhapatir vā gṛhapatipatnī vājñātitantuvāyena cīvaraṃ vāyayet	དགེ་སློང་གི་ཕྱིར་ཁྱིམ་བདག་གམ་། ཁྱིམ་བདག་གི་ཆུང་མ་ཉེ་དུ་མ་ཡིན་པས་ཐ་ག་པ་ཉེ་དུ་མ་ཡིན་པ་ལ་གོས་འཐག་ཏུ་བཅུག་པ་ལས་།
 tatra cet sa bhikṣuḥ pūrvam apravāritaḥ san kaṃcid eva vikalpam āpadya tam ajñātiṃ tantuvāyam upasaṃkramyaivaṃ vadet* |	དེ་ལ་གལ་ཏེ་དགེ་སློང་དེ་ལ་སྔར་མ་བསྟབས་པར་རྣམ་པར་རྟོག་པ་འགའ་ཞིག་བྱུང་ནས་། ཐ་ག་པ་ཉེ་དུ་མ་ཡིན་པའི་གན་དུ་སོང་སྟེ་།
 yat khalv āyuṣmāṃs tantuvāya jānīyā idaṃ cīvaram asmān uddiśya ūyate sādhv āyuṣmaṃs	འདི་སྐད་ཅེས་ཚེ་དང་ལྡན་པ་ཐ་ག་པ་ཤེས་པར་གྱིས་ཤིག་། གོས་འདི་ནི་ཁོ་བོའི་ཕྱིར་འཐག་གིས་།
 tantuvāya idaṃ cīvaraṃ suvistṛtaṃ ca kuru suvilikhitaṃ ca suvitakṣitaṃ ca svākoṭitaṃ	ཚེ་དང་ལྡན་པ་ཐ་ག་པ་གོས་འདི་ཞེང་ཆེ་བ་དང་། ཁྲུན་རིང་བ་དང་། ཐར་གྱིས་ཞག་པ་དང་། ཐ་ག་རན་བཟང་བར་ལེགས་པར་གྱིས་ཤིག་།
 cāpy eva vayam āyuṣmate tantuvāyāya kāṃcid eva mātram upasaṃhariṣyāmo yaduta piṇḍapātaṃ	ཚེ་དང་ལྡན་པ་ཐ་ག་པ་འདི་ལྟར་ཁོ་བོས་གླ་རྔན་འདི་ལྟ་སྟེ་། བཟའ་བའམ་། བཅའ་བ་ཙམ་མམ་། བཟའ་རྒྱུ་ཅུང་ཟད་ཅིག་སྦྱིན་ནོ་ཞེས་སྨྲས་ནས་།
 vā piṇḍapātamātraṃ vā piṇḍapātasaṃbalaṃ vā cīvarasyābhiniṣpattaye abhiniṣpanne cīvare	དེ་ལ་གལ་ཏེ་དགེ་སློང་དེས་གོས་སྒྲུབ་པའི་ཕྱིར་༄༡༥བ་གླ་རྔན་འདི་ལྟ་སྟེ་། བཟའ་བའམ་།
 naisargikā pāyantikā | np|25 (prmosū_mū-banerjee)	བཅའ་བ་ཙམ་མམ་། བཟའ་རྒྱུ་ཅུང་ཟད་ཅིག་སྦྱིན་ཞིང་། གོས་གྲུབ་ན་སྤང་བའི་ལྟུང་བྱེད་དོ་༎
 yaḥ punar bhikṣur bhikṣoś cīvaraṃ datvā tataḥ paścād abhiṣiktaḥ kupitaś caṇḍībhūto nātmamanā ācchindyād ācchedayed vā evaṃ cainaṃ vaded ānaya bhikṣo cīvaraṃ na te bhūyo dadāmīti |	ཡང་དགེ་སློང་གང་དགེ་སློང་ལ་གེས་བྱིན་ནས་དེའི་འོག་ཏུ་ཁྲོས་འཁྲུགས་རྔམས་པར་གྱུར་ཏེ་ཡིད་མ་རངས་ནས་འཕྲོག་གམ་འཕྲོག་ཏུ་འཇུག་ཅིང་། དེ་ལ་འདི་སྐད་ཅེས་དགེ་སློང་ཁྱོད་ལ་གོས་མི་སྦྱིན་གྱིས་། ཕྱིར་བྱིན་ཅིག་ཅེས་ཟེར་ན་།
 tena bhikṣuṇā tac cīvaraṃ tac ca śeṣam upaniḥsṛṣṭavyaṃ bhuktasya ca naisargikā pāyantikā | np|26 (prmosū_mū-banerjee)	དགེ་སློང་དེས་ལྷག་མ་ཡོད་པ་ཕྱིར་སྦྱིན་པར་བྱ་ཞིང་བཏང་ན་སྤང་བའི་ལྟུང་བྱེད་དོ་༎
 daśāham āgatāyāṃ kārtikyāṃ paurṇamāsyāṃ bhikṣor utpadyetātyayakacīvaram ākāṃkṣatā	དགེ་སློང་གིས་སྟོན་ཟླ་ཐ་ཆུང་། ཉར་ཞག་བཅུས་མ་ཚང་བ་ཚུན་ཆད་དུ་བརྟད་པ་ལས་བྱུང་བའི་གོས་ཤིག་རྙེད་ལ་།
 tena bhikṣuṇā pratigṛhītavyaṃ pratigṛhya yāvac cīvaradānakālasamayād dhārayitavyaṃ	འདོད་ན་དགེ་སློང་དེས་གོས་དེ་བསླང་བར་བྱའོ་༎ བསླངས་ནས་གོས་སྦྱིན་པའི་དུས་ཀྱི་བར་དུ་བཅང་བར་བྱའོ་༎
 tata uttaraṃ dhārayen naisargikā pāyantikā | np|27 (prmosū_mū-banerjee)	དེ་ལས་འདས་པར་བཅང་ན་སྤང་བའི་ལྟུང་བྱེད་དོ་༎
 bhikṣavaḥ khalu saṃbahulāḥ āraṇyakeṣu śayanāsaneṣu na varṣakā bhavanti sāśaṅkasaṃmateṣu	དགེ་སློང་རབ་ཏུ་མང་པོ་དག་གནས་མལ་དགོན་པ་དོགས་པ་དང་བཅས་པར་གྲགས་པ་། འཇིགས་པ་དང་བཅས་པར་གྲགས་པ་།
 nānābhayasaṃmateṣu sapratibhayabhairavasaṃmateṣu ākāṃkṣatā āraṇyakena bhikṣuṇā trayāṇāṃ	འཇིགས་པ་ཐ་དད་པས་འཇིགས་སུ་རུང་བ་དང་བཅས་པར་གྲགས་པ་དག་ཏུ་དབྱར་ཕྱི་མར་གྱུར་ལ་། 
 cīvarāṇām anyatamānyatamaṃ cīvaram antargṛhe upanikṣiptavyaṃ syāt khalv āraṇyakasya	དགེ་སློང་དགོན་པ་པས་འདོད་ན་ཆོས་གོས་གསུམ་ལས་ཆོས་གོས་གང་ཡང་རུང་བ་ཁྱིམ་གཞན་དུ་གཞག་པར་བྱའོ་༎ དགེ་སློང་དགོན་པ་པ་ལ་མཚམས་ཀྱི་ཕྱི་རོལ་དུ་འགྲོ་དགོས་པ་དེ་ལྟ་བུའི་རྐྱེན་ཞིག་བྱུང་ན་། 
 bhikṣos tadrūpapratyayo bahiḥsīmāṃ gantuṃ ṣaḍrātraparamam āraṇyakena bhikṣuṇā tasmāc cīvarād bahiḥsīmāṃ vipravastavyaṃ tata uttari vipravasen naisargikā pāyantikā | np|28 (prmosū_mū-banerjee)	དགེ་སློང་དགོན་པ་པ་དེས་ཞག་དྲུག་གི་མཐའ་ཚུན་ཆད་དུ་ཆོས་གོས་དེ་དང་མཚམས་ཀྱི་ཕྱི་རོལ་ཏུ་འབྲལ་བར་བྱའོ་༎ དེ་ལས་འདས་པར་འབྲལ་ན་སྤང་བའི་ལྟུང་བྱེད་དོ་༎
 māsyaḥ śeṣo grīṣmāṇāṃ bhikṣuṇā varṣāśāṭīcīvaraṃ paryeṣitavyam ardhamāsāvaśiṣṭā kṛtvā dhārayitavyam* |	དགེ་སློང་རྣམས་ཀྱིས་སོ་ག་༄༡༦ཨ་༌༎ རྣམས་ཀྱི་ཟླ་བ་གཅིག་ལུས་ན་དབྱར་གྱི་གོས་རས་ཆེན་བཙལ་བར་བྱའོ་༎ དབྱར་ཟད་ནས་འོག་ཏུ་ཟླ་བ་ཕྱེད་ཀྱི་བར་དུ་བཅང་བར་བྱའོ་༎
 arvāk ced bhikṣuḥ śeṣo grīṣmāṇāṃ varṣāśāṭīcīvaraṃ paryeṣeta ūrdhvam ardhamāsāvaśiṣṭā varṣāḥ kṛtvā dhārayen naisargikā pāyantikā | np|29 (prmosū_mū-banerjee)	གལ་ཏེ་དགེ་སློང་གིས་སོ་ག་རྣམས་ཀྱི་ཟླ་བ་གཅིག་ལུས་པའི་སྔོན་རོལ་ཏུ་དབྱར་གྱི་གོས་རས་ཆེན་ཚོལ་བར་བྱེད་དམ་། དབྱར་ཟད་ནས་འོག་ཏུ་ཟླ་བ་ཕྱེད་ལས་ལྷག་པར་འཆང་ན་སྤང་བའི་ལྟུང་བྱེད་དོ་༎
 yaḥ punar bhikṣur jānan sāṃghikaṃ lābhaṃ pariṇatam ātmanaḥ paudgalikaṃ pariṇāmayen naisargikā pāyantikā | np|30 (prmosū_mū-banerjee)	ཡང་དགེ་སློང་གང་དགེ་འདུན་ལ་བསྔོས་པའི་རྙེད་པ་ཤེས་བཞིན་དུ་གང་ཟག་བདག་ལ་སྒྱུར་དུ་འཇུག་ན་། སྤང་བའི་ལྟུང་བྱེད་དོ་༎
 yāni tāni bhagavatā glānānāṃ bhikṣūṇāṃ sāṃpreyāṇi pratisevanīyāni bhaiṣajyāny ākhyātāni	བཅོམ་ལྡན་འདས་ཀྱིས་དགེ་སློང་ན་བ་རྣམས་ལ་ཕན་པ་སོ་སོར་བསྟེན་པར་བྱ་བའི་སྨན་གང་དག་བཀའ་སྩལ་པ་འདི་ལྟ་སྟེ་།
 tadyathā sarpis tailaṃ madhu phāṇitaṃ tāny ākāṃkṣatā glānena bhikṣuṇā saptāhaparamaṃ	ཞུན་མར་དང་། འབྲུ་མར་དང་། སྦྲང་རྩི་དང་། བུ་རམ་གྱི་དབུ་བ་དེ་དག་ལས་། དགེ་སློང་ན་བས་འདོད་ན་རང་གིས་ཞག་བདུན་པར་བྱིན་གྱིས་བརླབས་ཏེ་།
 svayam adhiṣṭhāya saṃnidhikāraparibhogena paribhoktavyāni tata uttari paribhuṃjīta naisargikā pāyantikā |	གསོག་འཇོག་གིས་ཡོངས་སུ་ལོངས་སྤྱོད་པས་ཡོངས་སུ་ལོངས་སྤྱད་པར་བྱའོ་༎ དེ་ལས་འདས་པར་ཡོངས་སུ་ལོངས་སྤྱོད་པར་བྱེད་ན་སྤང་བའི་ལྟུང་བྱེད་དོ་༎
 uddiṣṭā me āyuṣmantas triṃśan naisargikapāyantikā dharmāḥ |	ཚེ་དང་ལྡན་པ་དག་བདག་གིས་སྤང་བའི་ལྟུང་བྱེད་ཀྱི་ཆོས་སུམ་ཅུ་པོ་དག་བཏོན་ཟིན་ཏོ་༎ དེ་ལ་བདག་གིས་ཚེ་དང་ལྡན་པ་དག་ལ་།
 tatrāham āyuṣmantaḥ paripṛcchāmi -- kaścit sthātra pariśuddhāḥ	ཅི་འདི་ལ་ཁྱེད་ཡོངས་སུ་དག་གམ་ཞེས་དྲིའོ་༎
 dvir api trir api paripṛcchāmi -- kaścit sthātra pariśuddhāḥ	ཅི་འདི་ལ་ཁྱེད་ཡོངས་སུ་དག་གམ་ཞེས་ལན་གཉིས་ལན་གསུམ་དུ་དྲིའོ་༎
 pariśuddhā atrāyuṣmanto yasmāt tūṣṇīm evam etad dhārayāmi | navatiḥ pāyantikā dharmāḥ	འདི་ལ་ཚེ་དང་ལྡན་པ་དག་ཡོངས་སུ་དག་ན་། འདི་ལྟར་ཅང་མི་སྨྲ་བས་དེ་དེ་བཞིན་དུ་འཛིན་ཏོ་༎༎ བམ་པོ་གཉིས་༄༡༦བ་པ་སྟེ་ཐ་མའོ་༎ སྤྱི་སྡོམ་ནི་། ཤེས་བཞིན་དང་ནི་ས་བོན་དང་། མ་བསྐོས་པ་དང་ཡང་ཡང་དང་༎ ཆུ་དང་ཁྱིམ་དང་བསམས་བཞིན་དང་། མགྲོན་མང་རྐུན་མ་མཆོད་སྟོན་ནོ་༎ སྡོམ་ལ་། རྫུན་སྐྱོན་དགེ་སློང་ཕྲ་མ་དང་། སྐྱོ་སྔོགས་བྱེད་དང་སྟོན་པ་དང་། འདོན་དང་གནས་ངན་ལེན་དང་ཆོས་། བཤེས་ངོར་བྱེད་དང་ཁྱད་དུ་གསོད་༎
 ime khalv āyuṣmantaḥ navatiḥ pāyantikā dharmā anvardhamāsaṃ prātimokṣasūtroddeśam āgacchanti | pāy|1 (prmosū_mū-banerjee) saṃprajānan mṛṣāvādāt pāyantikā | pāy|2 (prmosū_mū-banerjee)	ཚེ་དང་ལྡན་པ་དག་ལྟུང་བྱེད་ཀྱི་ཆོས་དགུ་བཅུ་པོ་འདི་དག་ནི་ཟླ་བ་ཕྱེད་ཕྱེད་ཅིང་སོ་སོར་ཐར་པའི་མདོ་འདོན་པ་ལས་འབྱུང་ངོ་༎ ཤེས་བཞིན་དུ་བརྫུན་དུ་སྨྲ་ན་ལྟུང་བྱེད་དོ་༎
 ūnamanuṣyavādāt pāyantikā | pāy|3 (prmosū_mū-banerjee)	མིའི་སྐྱོན་ནས་སྨྲ་ན་ལྟུང་བྱེད་དོ་༎
 bhikṣupaiśunyāt pāyantikā | pāy|4 (prmosū_mū-banerjee) yaḥ punar bhikṣur jānan samagreṇa saṃghena yathādharmam adhikaraṇam upanikṣiptaṃ punaḥ karmaṇaḥ khoṭayet pāyantikā | pāy|5 (prmosū_mū-banerjee)	དགེ་སློང་ལ་ཕྲ་མ་བྱེད་ན་ལྟུང་བྱེད་དོ༏་༏ཡང་དགེ་སློང་གང་དགེ་འདུན་མཐུན་པས་ཆོས་བཞིན་དུ་རྩོད་པ་སྦྱངས་པར་ཤེས་བཞིན་དུ་ཡང་ལས་ཀྱིས་སྐྱོ་སྔོགས་བྱེད་ན་ལྟུང་བྱེད་དོ་༎
 yaḥ punar bhikṣur mātṛgrāmasyottari ṣaṭpaṃcikayā vācā dharmaṃ deśayed anyatra vijñapuruṣāt pāyantikā | pāy|6 (prmosū_mū-banerjee)	ཡང་དགེ་སློང་གང་བུད་མེད་ཀྱི་ཡུལ་ལ་ཚིག་ལྔའམ་དྲུག་ལས་ལྷག་པར་ཆོས་སྟོན་ན་། རིག་པའི་སྐྱེས་པ་མ་གཏོགས་ཏེ་ལྟུང་བྱེད་དོ་༎
 yaḥ punar bhikṣur anupasaṃpannāya pudgalāya padaśo dharmaṃ vācayet pāyantikā | pāy|7 (prmosū_mū-banerjee)	ཡང་དགེ་སློང་གང་གང་ཟག་བསྙེན་པར་མ་རྫོགས་པ་དང་ཚིག་གིས་ཆོས་འདོན་ན་ལྟུང་བྱེད་དོ་༎ ཡང་དགེ་སློང་གང་གང་ཟག་བསྙེན་པར་མ་རྫོགས་པ་ལ་གནས་ངན་ལེན་གྱི་ལྟུང་བ་བརྗོད་༎ ན་། 
 yaḥ punar bhikṣur anupasaṃpannāya pudgalāya duṣṭhulāpattim ārocayed anyatra saṃghasaṃmatyān [saṃghasaṃvṛtyā] pāyantikā | pāy|8 (prmosū_mū-banerjee) yaḥ punar bhikṣur anupasaṃpannāya pudgalāyottaraṃmanuṣyadharmam ārocayed bhūtāt pāyantikā | pāy|9 (prmosū_mū-banerjee)	དགེ་འདུན་གྱིས་གནང་བ་མ་གཏོགས་ཏེ་ལྟུང་བྱེད་དོ་༎ ཡང་དགེ་སློང་གང་གང་ཟག་བསྙེན་པར་མ་རྫོགས་པ་ལ་མིའི་ཆོས་བླ་མ་བདེན་པ་སྨྲ་ན་ལྟུང་བྱེད་དོ་༎ 
 yaḥ punar bhikṣuḥ pūrvaṃ samanujño bhūtvā tataḥ paścād evaṃ vaded yathā saṃstutikayāyuṣmantaḥ sāṃghikaṃ lābhaṃ pariṇatam ātmanaḥ paudgalikaṃ pariṇāmayantīti pāyantikā | pāy|10 (prmosū_mū-banerjee)	ཡང་དགེ་སློང་གང་སྔར་ལེགས་པར་རུང་བར་བྱས་ནས་དེའི་འོག་ཏུ་འདི་སྐད་ཅེས་ཚེ་དང་ལྡན་པ་དག་གིས་འདི་ལྟར་བཤེས་ལྟུང་བྱེད་དོ་༎ ངོར་བྱས་ཏེ་། 
 yaḥ punar bhikṣur anvardhamāsaṃ prātimokṣasūtroddeśe uddiśyamāne evaṃ vadet kiṃ punar	༄༡༧ཨ་༌༎ དགེ་འདུན་གྱི་རྙེད་པར་བསྔོས་པ་བདག་གི་གང་ཟག་ལ་བསྔོས་སོ་ཞེས་ཟེར་ན་ལྟུང་བྱེད་དོ་༎ ཡང་དགེ་སློང་གང་ཟླ་བ་ཕྱེད་ཕྱེད་ཅིང་སོ་སོར་ཐར་པའི་མདོ་གདོན་པ་འདོན་པ་ན༏་འདི་སྐད་ཅེས་ཚེ་དང་ལྡན་པ་དག་གང་དག་གིས་དགེ་སློང་རྣམས་འགྱོད་པ་དང་། ཡིད་ལ་གཅགས་པ་དང་། གནོད་པར་འགྱུར་བ་བསླབ་པའི་གཞི་ཕྲན་ཚེགས་རབ་ཏུ་ཕྲ་བ་འདི་དག་གིས་།
 ebhir āyuṣmantaḥ kṣudrānukṣudraiḥ śikṣāpadair anvardhamāsaṃ prātimokṣasūtroddeśair uccāryamānair yāni bhikṣūṇāṃ kaukṛtyāya saṃvartante ālekhāya vilekhāya vileṭhāya vipratisārāyeti śikṣāpadavilaṃghanāt pāyantikā |	ཟླ་བ་ཕྱེད་ཕྱེད་ཅིང་སོ་སོར་ཐར་པའི་མདོ་གདོན་པ་བཏོན་པ་དག་གིས་ཅི་ཞིག་བྱ་ཞེས་ཟེར་ཞིང་བསླབ་པ་ཁྱད་དུ་གསོད་ན་ལྟུང་བྱེད་དོ་༎ 
 pāy|11 (prmosū_mū-banerjee)	སྡོམ་ལ་། ས་བོན་འཕྱ་བ་བསྒོ་བ་དང་༎ ཁྲི་དང་གདིང་དང་སྐྲོད་པ་དང༏་༏ཕྱིས་གནོན་འབྱུང་བ་འདེབས་པ་དང་༎ རིམ་པ་གཉིས་སུ་རྩིག་པའོ་༎
 bījagrāmabhūtagrāmapātanapātāpanāt pāyantikā | pāy|12 (prmosū_mū-banerjee) avadhyānakṣipaṇāt pāyantikā | pāy|13 (prmosū_mū-banerjee)	ས་བོན་གྱི་ཚོགས་དང་འབྱུང་པོའི་གནས་འཇིག་གམ་འཇིག་ཏུ་འཇུག་ན་ལྟུང་བྱེད་དོ་༎
 ājñāviheṭhanāt pāyantikā |	འཕྱའམ་གཞོག་འཕྱས་བྱེད་ན་ལྟུང་བྱེད་དོ་༎
 pāy|14 (prmosū_mū-banerjee)	བསྒོ་བ་རྣ་ལ་གཟོན་ན་ལྟུང་བྱེད་དོ་༎
 yaḥ punar bhikṣuḥ sāṃghikaṃ maṃcaṃ vā pīṭhaṃ vā vṛṣiko vā biṃbopadhānacaturaśrakaṃ	ཡང་དགེ་སློང་གང་དགེ་འདུན་གྱི་ཁྲིའམ་། ཁྲིའུའམ་། སྟན་ནང་ཚངས་ཅན་ནམ་། ལ་བའམ་། སྔས་སམ་། གོར་བུ་བླ་གབ་མེད་བར་བཏིང་ངམ་།
 vā abhyavakāśe upanikṣipyoparikṣipya vā anuddhṛtānuddhṛtya vā tato viprakrāmet santaṃ	གདིང་དུ་བཅུག་ནས་མ་བསྡུས་སམ་། སྡུད་དུ་མ་བཅུག་གམ་། དགེ་སློང་འཁོད་པ་ལ་མ་བཅོལ་བར་དེ་ནས་སོང་ན་།
 bhikṣum anavalokyānyatra tadrūpāt pratyayāt pāyantikā | pāy|15 (prmosū_mū-banerjee)	དེ་འདྲ་བའི་རྐྱེན་མ་གཏོགས་ཏེ་ལྟུང་བྱེད་དོ་༎
 yaḥ punar bhikṣuḥ sāṃghike vihāre tṛṇasaṃstaraṃ vā parṇasaṃstaraṃ vā saṃstīrya vā	ཡང་དགེ་སློང་གང་དགེ་འདུན་གྱི་གཙུག་ལག་ཁང་དུ་རཙབ༹འི་གདིང་བ་དང་། ལོ་མའི་གདིང་བ་བཏིང་ངམ་། གདིང་དུ་བཅུག་ནས་མ་བསྡུས་སམ་། སྡུད་དུ་མ་བཅུག་གམ་།
 saṃstārya vā anuddhṛtyānuddhārya vā tato viprakrāmet santaṃ bhikṣum anavalokyānyatra	དགེ་སློང་འཁོད་པ་ལ་མ་༄༡༧བ་བཅོལ་བར་དེ་ནས་སོང་ན་།
 tadrūpāt pratyayāt pāyantikā | pāy|16 (prmosū_mū-banerjee)	དེ་འདྲ་བའི་རྐྱེན་མ་གཏོགས་ཏེ་ལྟུང་བྱེད་དོ་༎
 yaḥ punar bhikṣur abhiṣaktaḥ kupitaś caṇḍībhūto 'nāttamanā sāṃghikād vihārād bhikṣuṃ niṣkarṣen niṣkārṣāpayed vā anyatra tadrūpāt pratyayāt pāyantikā pāy|17 (prmosū_mū-banerjee)	ཡང་དགེ་སློང་གང་ཁྲོས་འཁྲུགས་རྔམ་པར་གྱུར་ཏེ་ཡིད་མ་རངས་ནས་དགེ་འདུན་གྱི་གཙུག་ལག་ཁང་ནས་། དགེ་སློང་སྐྲོད་དམ་སྐྲོད་དུ་འཇུག་ན་། དེ་འདྲ་བའི་རྐྱེན་མ་གཏོགས་ཏེ་ལྟུང་བྱེད་དོ་༎
 yaḥ punar bhikṣur jānan sāṃghike vihāre pūrvopagatānāṃ bhikṣūṇāṃ tataḥ paścād āgatyānupraskandyāsane niṣadyāṃ śayyāṃ vā kalpayed yasya saṃbādho bhaviṣyati sa viprakramiṣyatīti ity eva pratyayaṃ kṛtvā pāyantikā | pāy|18 (prmosū_mū-banerjee)	ཡང་དགེ་སློང་གང་དགེ་འདུན་གྱི་གཙུག་ལག་ཁང་ནས་། དགེ་སློང་དག་སྔ་ན་འཁོད་པར་ཤེས་བཞིན་དུ་ཕྱིས་འོངས་ན་སུ་ལ་གནོད་པ་དེ་འགྲོ་བར་འགྱུར་བ་དེ་ཉིད་དུ་བྱས་ཏེ་། ཕྱིས་གནོན་བྱས་ནས་སྟན་ལ་ཉལ་ལམ་འདུག་ན་ལྟུང་བྱེད་དོ་༎
 yaḥ punar bhikṣur jānan sāṃghike vihāre uparivihāyasikṛtāyāṃ kuṭikāyām āhāryapādake maṃce vā pīṭhe vā sahasā balenābhipaded vābhinipadyeta vā pāyantikā | pāy|19 (prmosū_mū-banerjee)	ཡང་དགེ་སློང་གང་དག་འདུན་གྱི་གཙུག་ལག་ཁང་གི་སྟེང་གི་ནམ་མཁའ་ལ་ཐོག་པོར་བར་ཁྲིའམ་ཁྲིའུ་རྩ་བ་འབྱུང་བར་ཤེས་བཞིན་དུ་ལྕིད་ཀྱིས་ཕབ་སྟེ་། ཉལ་ལམ་འདུག་ན་ལྟུང་བྱེད་དོ་༎
 yaḥ punar bhikṣur jānan saprāṇakenodakena tṛṇaṃ vā gomayaṃ vā mṛttikāṃ vā siñcet siñcayed vā pāyantikā | pāy|20 (prmosū_mū-banerjee)	ཡང་དགེ་སློང་གང་ཤེས་བཞིན་དུ་སྲོག་ཆགས་དང་བཅས་པའི་ཆུས་རྩའམ་། ལྕི་བའམ་། ས་ལ་འདེབས་སམ་། འདེབས་སུ་འཇུག་ན་ལྟུང་བྱེད་དོ་༎ ཡང་དགེ་སློང་གིས་། གཙུག་ལག་ཁང་ཆེན་པོ་ཞིག་བརྩིག་ཏུ་འཇུག་ན་།
 mahāntaṃ bhikṣuṇā vihāraṃ kārayitvā yāvad dvārakośārgalasthānād ālokasaṃjñinā bhūmiparikarmopādāya	སྒོའི་སྦུབས་དང་། གཏན་པ་དང་། སྣང་བའི་གནས་ཇི་ཙམ་པའི་འདུ་ཤེས་ཀྱིས་བརྟགས་པ་ནས་བཟུང་སྟེ་།
 dvau vā trayo vā chedanaparyāyāḥ saharitāḥ adhiṣṭhātavyāḥ tata uttari adhitiṣṭhet pāyantikā |	ཕ་གུའི་རིམ་པ་འཇིམ་པ་དང་བཅས་པ་གཉིས་སམ་གསུམ་བརྩིག་པར་བྱའོ་༎ དེ་ལས་ལྷག་པར་རྩིག་ན་ལྟུང་བྱེད་དོ་༎
 pāy|21 (prmosū_mū-banerjee)	སྡོམ་ལ་། མ་བསྐོས་ཉི་མ་ནུབ་པ་དང་། ཟས་དང་ཆོས་གོས་གཉིས་དག་དང་༎ དོན་མཐུན་གྲུ་དང་དབེན་པ་གཉིས་༎ དགེ་སློང་མ་ཡིས་སྦྱོར་བཅུག་པའོ་༎
 yaḥ punar bhikṣur asaṃmataḥ saṃghena bhikṣuṇīr avavadet tadrūpadharmasamanvāgamāt pāyantikā | pāy|22 (prmosū_mū-banerjee)	ཡང་དགེ་སློང་གང་དགེ་འདུན་གྱིས་མ་བསྐོས་པར་དགེ་སློང་མ་ལ་སྟོན་ན་། ཆོས་༄༡༨ཨ་༌༎ འདི་ལྟ་བུ་དང་ལྡན་པ་མ་གཏོགས་ཏེ་ལྟུང་བྱེད་དོ་༎
 saṃmataś cāpi bhikṣur saṃghena yāvat sūryāstagamanakālasamayāt pāyantikā | pāy|23 (prmosū_mū-banerjee)	དགེ་སློང་གང་དགེ་འདུན་གྱིས་བསྐོས་ཀྱང་ཉི་མ་ནུབ་ཀྱི་བར་དུ་དགེ་སློང་མ་ལ་ཆོས་སྟོན་ན་ལྟུང་བྱེད་དོ་༎
 yaḥ punar bhikṣur bhikṣum evaṃ vaded āmiṣakiṃcithetor bhikṣavo bhikṣuṇīr avadantīti pāyantikā |	ཡང་དགེ་སློང་གང་དགེ་སློང་རྣམས་ལ་འདི་སྐད་ཅེས་། དགེ་སློང་དག་ཟས་ཅུང་ཟད་ཙམ་གྱི་ཕྱིར་དགེ་སློང་མ་ལ་སྟོན་ཏོ་ཞེས་ཟེར་ན་ལྟུང་བྱེད་དོ་༎ 
 pāy|24 (prmosū_mū-banerjee) yaḥ punar bhikṣur ajñātikāyai bhikṣuṇyai cīvaraṃ dadyād anyatra parivartakāt pāyantikā |	ཡང་དགེ་སློང་གང་དགེ་སློང་མ་ཉེ་དུ་མ་ཡིན་པ་ལ་གོས་སྦྱིན་ན་ལྟུང་བྱེད་དོ་༎ 
 pāy|25 (prmosū_mū-banerjee)	དོ་༎ 
 yaḥ punar bhikṣur ajñātikāyā bhikṣuṇyāś cīvaraṃ kuryāt pāyantikā |	ཡང་དགེ་སློང་གང་དགེ་སློང་མ་ཉེ་དུ་མ་ཡིན་པའི་གོས་བྱེད་ན་ལྟུང་དོ་༎ 
 pāy|26 (prmosū_mū-banerjee)	དོ་༎ 
 yaḥ punar bhikṣur bhikṣuṇīsārtheṇa sārdham adhvānamārgaṃ pratipadyeta ato grāmāntaram api pāyantikā |	བྱེད་དོ་༎ ཡང་དགེ་སློང་གང་དགེ་སློང་མའི་དོན་མཐུན་དང་ལྷན་ཅིག་འཐམས་ནས་མགྲོན་ལམ་དུ་འཇུག་ན༏་དུས་མ་གཏོགས་ཏེ་དོ་༎ དོ་༎ བྱེད་དོ་༎ ལྟུང་བྱེད་དོ་༎ དེ་ལ་དུས་ནི་འདི་ཡིན་ཏེ་། ལམ་དོན་མཐུན་གྱིས་བགྲོད་པར་བྱ་བ་། དོགས་པ་དང་བཅས་པར་གྲགས་པ་།
 tatrāyaṃ samayaḥ sārthagamanīyo mārgo bhavati sāśaṅkasaṃmataḥ sabhayasaṃmataḥ sapratibhayabhairavasaṃmato 'yaṃ tatra samayaḥ | pāy|27 (prmosū_mū-banerjee)	འཇིགས་པ་དང་བཅས་པར་གྲགས་པ་། འཇིགས་པ་ཐ་དད་པས་འཇིགས་སུ་རུང་བ་དང་བཅས་པར་གྲགས་པ་ཞིག་ན་། དེ་ལ་དེ་ནི་དུས་ཡིན་ནོ་༎
 yaḥ punar bhikṣur bhikṣuṇīsārtheṇa sārdhaṃ saṃvidhāya ekanāvam abhirohed ūrdhvagāminīṃ vā adhogāminīṃ vānyatra tīryakpārasantaraṇāt pātayantikā	ཡང་དགེ་སློང་གང་དགེ་སློང་མའི་དོན་མཐུན་དང་ལྷན་ཅིག་འཐམས་ནས་གྲུ་གཅིག་ཏུ་འཇུག་ཅིང་། གྱེན་དུ་འགྲོའམ་ཐུར་དུ་འགྲོ་ན་ཐད་ཀར་ཕ་རོལ་ཏུ་འགྲོ་བ་མ་གཏོགས་ཏེ་། ལྟུང་བྱེད་དོ་༎
 pāy|28 (prmosū_mū-banerjee) yaḥ punar bhikṣur mātṛgrāmena sārdham eka ekayā rahasi praticchanne āsane niṣadyāṃ kalpayet pāyantikā |	ཡང་དགེ་སློང་གང་བུད་མེད་ཀྱི་ཡུལ་དང་ལྷན་ཅིག་གཅིག་པུ་གཅིག་དང་དབེན་པ་སྐྱབས་ཡོད་པ་ན་སྟན་ལ་འདུག་ན་ལྟུང་བྱེད་དོ་༎
 pāy|29 (prmosū_mū-banerjee) yaḥ punar bhikṣur bhikṣuṇyā sārdham eka ekikayā rahasi praticchanne tiṣṭhet pāyantikā | pāy|30 (prmosū_mū-banerjee)	ཡང་དགེ་སློང་གང་དགེ་སློང་མ་དང་ལྷན་ཅིག་གཅིག་པུ་གཅིག་དང་དབེན་པ་སྐྱབས་ཡོད་པ་ན་འགྲེང་ན་ལྟུང་བྱེད་དོ་༎
 yaḥ punar bhikṣur jānan bhikṣuṇīparipācitaṃ piṇḍapātaṃ paribhuṃjītānyatra pūrvaṃ gṛhisamāraṃbhāt pāyantikā | pāy|31 (prmosū_mū-banerjee)	ཡང་དགེ་སློང་གང་༄༡༨བ་ཤེས་བཞིན་དུ་དགེ་སློང་མས་སྦྱོར་དུ་བཅུག་པའི་ཟས་ཟ་ན་སྔར་ཁྱིམ་དུ་བོས་པ་མ་གཏོགས་ཏེ་། ལྟུང་བྱེད་དོ་༎ སྡོམ་ལ་། ཡང་ཡང་དང་ནི་འདུག་གནས་གཅིག་། ཕྱེ་དང་བཅའ་དང་སྟོབས་པ་དང་༎ དུས་དང་དུས་མིན་གསོག་འཇོག་དང་༎ ཁ་ནས་མིད་དང་བསོད་པ་ཉིད་༎
 paraṃparabhojanād anyatra samayāt pāyantikā |	ཡང་ཡང་ཟ་ན་དུས་མ་གཏོགས་ཏེ་། ལྟུང་བྱེད་དོ་༎
 tatrāyaṃ samayo glānasamayaḥ karmasamayaḥ adhvānamārgasamayaḥ cīvaradānakālasamayaḥ | pāy|32 (prmosū_mū-banerjee)	དེ་ལ་དུས་ནི་འདི་ཡིན་ཏེ་། ན་བ་དུས་སོ་༎ ལས་དུས་སོ་༎ ལམ་དུས་སོ༏་༏གོས་སྦྱིན་པའི་ཚེ་དུས་ཏེ་། དེ་ལ་དེ་ནི་དུས་ཡིན་ནོ་༎
 ekāvasathoṣitena bhikṣuṇā aglānenaikapiṇḍapātaḥ paribhoktavyas tataḥ uttari paribhuṃjīta pāyantikā | pāy|33 (prmosū_mū-banerjee)	འདུག་གནས་གཅིག་ཏུ་ཞག་ལོན་པའི་དགེ་སློང་མི་ན་བས་བསོད་སྙོམས་གཅིག་བཟའ་བར་བྱའོ་༎ དེ་ལས་ལྷག་པ་ཟ་ན་ལྟུང་བྱེད་དོ་༎
 bhikṣavaḥ khalu saṃbahulāḥ kulāni saṃkrāmeyus tāṃś cec chrāddhā brāhmaṇagṛhapatayas	དགེ་སློང་རབ་ཏུ་མང་པོ་དག་ཁྱིམ་རྣམས་སུ་དོང་བ་ལས་། གལ་ཏེ་དེ་དག་ལ་བྲམ་ཟེ་དང་ཁྱིམ་བདག་དད་པ་ཅན་དག་གིས་ཕྱེ་དང་འཁུར་བ་དག་དུས་ཀྱིས་སྟོབས་པར་གྱུར་ལ་།
 tv arthaṃ pravārayeyur maṇḍaiś cāpūpaiś cākāṃkṣibhis tair bhikṣubhir dvau trayo vā pātrapūrāḥ pratigrahītavyāḥ tata uttari pratigṛhṇīyuḥ pāyantikā |	འདོད་ན་དགེ་སློང་དེ་དག་གིས་ལྷུང་བཟེད་གང་བ་གཉིས་སམ་གསུམ་བླང་བར་བྱའོ་༎ དེ་ལས་ལྷག་པར་ལེན་ན་ལྟུང་བྱེད་དོ་༎
 dvau trīn vā pātrapūrān pratigṛhya tair bhikṣubhir bahirārāmaṃ gatvā santo bhikṣavaḥ saṃvibhaktavyā ātmanā ca paribhoktavyam ayaṃ tatra samayaḥ pāy|34 (prmosū_mū-banerjee)	ལྷུང་བཟེད་གང་བ་གཉིས་སམ་གསུམ་བསླངས་ནས་ཕྱི་རོལ་ཀུན་དགའ་ར་བར་སོང་ལ་། དགེ་སློང་འཁོད་པ་རྣམས་ལ་ཡང་བགོ་བཤའ་བྱ་། བདག་ཅག་ཀྱང་བཟའ་བར་བྱ་སྟེ་། དེ་ལ་དེ་ནི་ཆོ་ག་ཡིན་ནོ་༎
 yaḥ punar bhikṣur bhuktavān pravāritaḥ akṛtātiriktaṃ khādanīyabhojanīyaṃ khāded bhuñjīta vā pāyantikā | pāy|35 (prmosū_mū-banerjee)	ཡང་དགེ་སློང་གང་ཟས་ཟོས་ཟིན་ཅིང་སྤངས་པ་ལས་ལྷག་པོར་མ་བྱས་པར་བཅའ་བའམ་། བཟའ་བ་འཆའམ་ཟ་ན་ལྟུང་བྱེད་དོ་༎
 yaḥ punar bhikṣur jānan bhikṣuṃ bhuktavantaṃ akṛtātirikte khādanīyabhojanīyenetyarthaṃ	ཡང་དགེ་སློང་གང་ཤེས་བཞིན་དུ་དགེ་སློང་ཟས་ཟོས་ཟིན་ཅིང་སྤངས་པ་ལ་།
 pravārayed idam āyuṣman khāda idaṃ bhuṃkṣva ity āsvādanaprekṣī kaścid eṣa bhikṣur	སྐབས་ཚོལ་ཞིང་ཅི་ནས་ཀྱང་དགེ་སློང་འདི་ཉེས་པ་༄༡༩ཨ་༌༎
 āsvādito bhaviṣyati ity etad eva pratyayaṃ kṛtvā pāyantikā | pāy|36 (prmosū_mū-banerjee)	འབྱུང་བར་བྱའོ་སྙམ་པ་དེ་ཉིད་རྐྱེན་དུ་བྱས་ནས་ཚེ་དང་ལྡན་པ་འདི་འཆོ་ཞིག་། འདི་ཟོ་ཞིག་ཅེས་ལྷག་པོར་མ་བྱས་པའི་བཅའ་བ་དང་བཟའ་བ་དུས་ཀྱིས་སྟོབས་ན་ལྟུང་བྱེད་དོ་༎ 
 gaṇabhojanād anyatra samayāt pāyantikā |	འདུས་ཤིང་ཟ་ན་དུས་མ་གཏོགས་ཏེ་ལྟུང་བྱེད་དོ་༎
 tatrāyaṃ samayaḥ glānasamayaḥ karmasamayo 'dhvānamārgasamayo nāvādhirohaṇaṃ mahāsamājaḥ śramaṇabhaktasamayo 'yaṃ tatra samayaḥ | pāy|37 (prmosū_mū-banerjee)	དེ་ལ་དུས་ནི་འདི་ཡིན་ཏེ་། ན་བ་དུས་སོ་༎ ལས་དུས་སོ་༎ ལམ་དུས་སོ་༎ གྲུར་ཞུགས་པ་དུས་དང་། འདུས་པ་ཆེན་པོ་དང་། དགེ་སློང་གི་ཟས་དུས་ཏེ་དེ་ལ་ནི་དུས་ཡིན་ནོ་༎
 yaḥ punar bhikṣur akāle khādanīyabhojanīyaṃ khāded bhuñjīta vā pāyantikā |	ཡང་དགེ་སློང་གང་དུས་མ་ཡིན་པར་བཅའ་བའམ་བཟའ་བ་འཆའམ་ཟ་ན་ལྟུང་བྱེད་དོ་༎
 pāy|38 (prmosū_mū-banerjee) yaḥ punar bhikṣuḥ saṃnihitaṃ khādanīyabhojanīyaṃ khāded bhuñjīta vā pāyantikā | pāy|39 (prmosū_mū-banerjee)	ཡང་དགེ་སློང་གང་བཅའ་བ་དང་བཟའ་བ་གསོག་འཇོག་བྱས་པ་འཆའམ་ཟ་ན་ལྟུང་བྱེད་དོ་༎
 yaḥ punar bhikṣur adattaṃ mukhadvārāhāram āhared anyatrodakadantakāṣṭhāt pāyantikā | pāy|40 (prmosū_mū-banerjee)	ཡང་དགེ་སློང་གང་མ་བྱིན་པར་ཁ་ནས་མིད་པའི་ཟས་ཟ་ན་ཆུ་དང་སོ་ཤིང་མ་གཏོགས་ཏེ་ལྟུང་བྱེད་དོ་༎
 yāni tāni bhagavatā bhikṣūṇāṃ praṇītabhojanāny akhyātāni tadyathā kṣīraṃ dadhi navanītaṃ	བཅོམ་ལྡན་འདས་ཀྱིས་དགེ་སློང་རྣམས་ཀྱི་ཟས་བསོད་པ་གང་དག་གསུངས་པ་འདི་ལྟ་སྟེ་། འོ་མ་དང་། ཞོ་དང་། མར་དང་། ཉ་ཤ་དང་། ཤ་དང་། ཤ་སྐམ་དག་སྟེ་།
 matsyo māṃsaṃ vallūrī yaḥ punar bhikṣuḥ evaṃrūpāṇi praṇītabhojanāni ātmārtham aglānaḥ parakulebhyo vijñāpya khāded bhuñjītā vā pāyantikā |	དགེ་སློང་མི་ན་བར་བདག་ཉིད་ཀྱི་ཕྱིར་ཟས་བསོད་པ་དེ་ལྟ་བུ་དག་གཞན་གྱི་ཁྱིམ་དག་ནས་བླངས་ཏེ་འཆའམ་ཟ་ན་ལྟུང་བྱེད་དོ་༎
 pāy|41 (prmosū_mū-banerjee)	སྡོམ་ལ་། སྲོག་ཆགས་བཅས་དང་ཉལ་སར་འདུག་། འགྲེང་དང་གཅེར་བུ་དམག་དང་ནི་༎ ཞག་གཉིས་བཤམ་དཀྲུག་འགྲོ་བ་དང་༎ བརྡེག་དང་གཟས་དང་གནས་ངན་ལེན་༎
 yaḥ punar bhikṣur jānan saprāṇakam udakaṃ paribhuñjīta pāyantikā | pāy|42 (prmosū_mū-banerjee)	ཡང་དགེ་སློང་གང་ཤེས་བཞིན་དུ་སྲོག་ཆག་དང་བཅས་པའི་ཆུ་ལ་སྤྱོད་ན་ལྟུང་བྱེད་དོ་༎
 yaḥ punar bhikṣur jānan sabhojane kule anupraskandyāsane niṣadyāṃ kalpayet pāyantikā | pāy|43 (prmosū_mū-banerjee)	ཡང་དགེ་སློང་གང་ཤེས་བཞིན་དུ་ཉལ་པོ་བྱེད་པར་ཤོམ་པའི་ཁྱིམ་དུ་ཕྱིས་གནོན་༄༡༩བ་བྱེད་དེ་སྟན་ལ་འདུག་ན་ལྟུང་བྱེད་དོ་༎
 yaḥ punar bhikṣur jānan sabhojane kule praticchanne tiṣṭhet pāyantikā | pāy|44 (prmosū_mū-banerjee)	ཡང་དགེ་སློང་གང་ཤེས་བཞིན་དུ་ཉལ་པོ་བྱེད་པར་ཤོམ་པའི་ཁྱིམ་དུ་དབེན་པ་སྐྱབས་ཡོད་པར་འགྲེང་ན་ལྟུང་བྱེད་དོ་༎ ཡང་དགེ་སློང་གང་། གཅེར་བུ་པའམ་།
 yaḥ punar bhikṣur acelakāya vā acelikāyai vā parivrājakāya vā svahastaṃ khādanīyabhojanīyaṃ dadyāt pāyantikā | pāy|45 (prmosū_mū-banerjee)	གཅེར་བུ་མ་ཀུན་ཏུ་རྒྱུ་བའམ་། ཀུན་ཏུ་རྒྱུ་མོ་ལ་རང་གི་ལག་ནས་བཅའ་བའམ་བཟའ་བ་བྱིན་ན་ལྟུང་བྱེད་དོ་༎
 yaḥ punar bhikṣur udyuktāṃ senāṃ darśanāyopasaṃkrāmet pāyantikā | pāy|46 (prmosū_mū-banerjee)	ཡང་དགེ་སློང་གང་དམག་ཆས་པ་ལ་ལྟར་འགྲོ་ན་ལྟུང་བྱེད་དོ་༎
 syād bhikṣos tadrūpaḥ pratyayaḥ udyuktāṃ senāṃ darśanāya upasaṃkramituṃ dvirātraparamaṃ tena bhikṣuṇā tasyāṃ senāyāṃ vipravastavyaṃ tata uttari vipravaset pāyantikā | pāy|47 (prmosū_mū-banerjee)	ཡང་དགེ་སློང་གང་དམག་ཆས་པ་ལ་ལྟ་བར་འགྲོ་བ་དེ་ལྟ་བུའི་རྐྱེན་ཞིག་བྱུང་ན་། དགེ་སློང་དེས་དམག་དེའི་ནང་དུ་ཞག་གཉིས་ཚུན་ཆད་གནས་པར་བྱའོ་༎ དེ་ལས་ལྷག་པར་གནས་ན་ལྟུང་བྱེད་དོ་༎ དགེ་སློང་ཞག་གཉིས་དམག་དེའི་ནང་ན་གནས་པའི་ཚེ་།
 dvirātraparamam api ced bhikṣus tasyāṃ senāyāṃ vipravasāṃ udyūṣikāṃ vā gacched dhvajāgraṃ vā balāgraṃ vā senāvyūham anīkadarśanaṃ vā pratyanubhavet pāyantikā | pāy|48 (prmosū_mū-banerjee)	ཡང་གལ་ཏེ་བཤམས་པ་དཀྲུག་ཏུ་འགྲོའམ་། རྒྱལ་མཚན་གྱི་མཆོག་གམ་། དཔུང་གི་མཆོག་གམ་། ག-ཡུལ་བཤམས་པའི་དམག་ལ་ལྟ་བ་ཉམས་སུ་མྱོང་བར་བྱེད་ན་ལྟུང་བྱེད་དོ་༎
 yaḥ punar bhikṣuḥ kupitaś caṇḍībhūto 'nāttamanā bhikṣoḥ prahāraṃ dadyāt pāyantikā | pāy|49 (prmosū_mū-banerjee)	ཡང་དགེ་སློང་གང་ཁྲོས་འཁྲུགས་རྔམ་པར་གྱུར་ཏེ་། ཡིད་མ་རངས་ནས་དགེ་སློང་ལ་བརྡེག་ན་ལྟུང་བྱེད་དོ་༎
 yaḥ punar bhikṣur abhiṣaktaḥ kupitaś caṇḍībhūto 'nāttamanā bhikṣoḥ prahāram upadarśayet* antatas talaśaktikam api pāyantikā | pāy|50 (prmosū_mū-banerjee)	ཡང་དགེ་སློང་གང་ཁྲོས་འཁྲུགས་རྔམ་པར་གྱུར་ཏེ་། ཡིད་མ་རངས་ནས་དགེ་སློང་ལ་བརྡེག་པར་གཟས་ན་ཐ་ན་ཐལ་མོས་ཀྱང་རུང་སྟེ་ལྟུང་བྱེད་དོ་༎ 
 yaḥ punar bhikṣur jānan bhikṣoḥ duṣṭhulām āpattiṃ praticchādayet pāyantikā | pāy|51 (prmosū_mū-banerjee)	ཡང་དགེ་སློང་གང་ཤེས་བཞིན་དུ་དགེ་སློང་གི་གནས་ངན་ལེན་གྱི་ལྟུང་བ་འཆབ་ན་དོ་༎ ལྟུང་བྱེད་དོ་༎ སྡོམ་ལ༏་བདེ་དང་མེ་དང་འདུན་པ་དང་། བསྙེན་པར་མ་རྫོགས་ཆོས་དང་སྨྲ་༎ དགེ་ཚུལ་ཁ་དོག་བསྒྱུར་བ་དང་༎ རིན་པོ་ཆེ་དང་ཚ་བའི་དུས་༎
 yaḥ punar bhikṣur bhikṣum evaṃ vaded ehy āyuṣman kulāny upasaṃkramāvas tatra te dāpayiṣyāmi khādanīyabhojanīyaṃ yāvadāptaṃ |	ཡང་དགེ་སློང་གང་ཀླན་ཀ་ཚོལ་ཞིང་ཅི་ནས་ཀྱང་དགེ་སློང་༄༢༠ཨ་༌༎ འདི་ལ་ཀླན་ཀ་བཙལ་བར་འགྱུར་རོ་སྙམ་པ་དེ་ཉིད་རྐྱེན་དུ་བྱས་ཏེ་།
 sa tasya dāpayitvā praṇītaṃ khādanīyabhojanīyaṃ yāvadāptaṃ tataḥ paścād evaṃ vaded	དགེ་སློང་ལ་འདི་སྐད་ཅེས་ཚེ་དང་ལྡན་པ་ཚུར་ཤོག་ཁྱིམ་དག་ཏུ་འདོང་དང་། ཁྱོད་ལ་བཅའ་བ་དང་བཟའ་བ་བསོད་པ་ཅི་ཙམ་འདོད་པ་སྦྱིན་དུ་གཞུག་གོ་ཞེས་སྨྲས་ནས་། དེས་དེ་ལ་སྦྱིན་དུ་མ་བཅུག་པར་དེའི་འོག་ཏུ་འདི་སྐད་ཅེས་།
 gaccha tvam āyuṣman na mama tvayā sārdhaṃ sparśo 'pi tu ekākina eva me sparśo bhavati kathāyāṃ vā niṣadyāyāṃ vā ity udyojanaprekṣī kaścid eṣa bhikṣur udyojito bhaviṣyatīty etad eva pratyayaṃ kṛtvā pāyantikā | pāy|52 (prmosū_mū-banerjee)	ཚེ་དང་ལྡན་པ་ཁོ་བོ་ལ་ཁྱོད་དང་ལྷན་ཅིག་སྨྲ་བའམ་འདུག་པ་བདེ་བ་མ་ཡིན་གྱི་འདི་ལྟར་ཁོ་བོ་གཅིག་པུ་ཁོ་ན་སྨྲའམ་འདུག་ན་བདེས་ཁྱོད་ཉིད་སོང་ཞིག་ཅེས་ཟེར་ན་ལྟུང་བྱེད་དོ་༎ 
 yaḥ punar bhikṣur ātmārtham aglāno vitapanaprekṣī jyotiḥ samavadhavyāt samavadhāpayed vā pāyantikā | pāy|53 (prmosū_mū-banerjee)	ཡང་དགེ་སློང་གང་མི་ན་བར་བདག་ཉིད་ཀྱི་ཕྱིར་མེ་ལ་རེག་གམ་རེག་ཏུ་འཇུག་ན་ལྟུང་བྱེད་དོ་༎
 yaḥ punar bhikṣur dhārmikasaṃghakaraṇīye bhikṣoś chandaṃ datvā paścād abhiṣaktaḥ kupitaś caṇḍībhūto nāttamanā kṣepadharmam āpadyeta |	ཡང་དགེ་སློང་གང་དགེ་འདུན་གྱི་བྱ་བ་ཆོས་དང་ལྡན་པ་ལ་དགེ་སློང་ལ་འདུན་པ་ཕུལ་ནས་། དེའི་འོག་ཏུ་ཁྲོས་འཁྲུགས་རྔམ་པར་གྱུར་ཏེ་། ཡིད་མ་རངས་ནས་སྤོང་བའི་ཆོས་སུ་བྱེད་ཅིང་། འདི་སྐད་ཅེས་དགེ་སློང་འདུན་པ་ཕྱིར་བྱིན་ཅིག་།
 āhara bhikṣoś chandaṃ na te dadāmīti pāyantikā | pāy|54 (prmosū_mū-banerjee)	ཁྱོད་ལ་མི་སྦྱིན་ནོ་ཞེས་ཟེར་ན་ལྟུང་བྱེད་དོ་༎
 yaḥ punar bhikṣur anupasaṃpannena pudgalena sārdhaṃ dvirātrād ūrdhvaṃ sahāgāraśayyāṃ kalpayet pāyantikā | pāy|55 (prmosū_mū-banerjee)	ཡང་དགེ་སློང་གང་། གང་ཟག་བསྙེན་པར་མ་རྫོགས་པ་དང་ལྷན་ཅིག་ཏུ་ནུབ་གཉིས་ལས་ལྷག་པར་གནས་གཅིག་ཏུ་ཉལ་ན་ལྟུང་བྱེད་དོ་༎
 yaḥ punar bhikṣur evaṃ vadet tathāhaṃ bhagavato dharmaṃ deśitam ājānāmi yathā ye antarāyikā dharmā uktā bhagavatā te pratisevyamānā nālam antarāyāyeti so bhikṣur bhikṣubhir idaṃ syād vacanīyo mā tvam āyuṣmann evaṃ vocas tathāhaṃ bhagavato	ཡང་དགེ་སློང་གང་འདི་སྐད་ཅེས་ཇི་ལྟར་བཅོམ་ལྡན་འདས་ཀྱིས་བར་དུ་གཅོད་པའི་ཆོས་སུ་གསུངས་པ་གང་དག་ཡིན་པ་དེ་དག་བསྟེན་ཀྱང་བར་དུ་གཅོད་པར་མི་འགྱུར་ཏེ་། དེ་ལྟར་བཅོམ་ལྡན་འདས་ཀྱིས་ཆོས་བསྟན་པ་བདག་གིས་ཤེས་སོ་ཞེས་ཟེར་ན་། དགེ་སློང་དེ་ལ་དགེ་སློང་རྣམས་ཀྱིས་།
 dharmaṃ deśitam ājānāmi yathā ye antarāyikā dharmā uktā bhagavatā te ca pratisevyamānā	འདི་སྐད་ཅེས་ཚེ་དང་ལྡན་པ་ཁྱོད་ཇི་ལྟར་བཅོམ་ལྡན་འདས་ཀྱིས་བར་དུ་གཅོད་༄༢༠བ་པའི་ཆོས་སུ་གསུངས་པ་གང་དག་ཡིན་པ་དེ་དག་བསྟེན་ཀྱང་བར་དུ་གཅོད་པར་མི་འགྱུར་ཏེ་། དེ་ལྟར་བཅོམ་ལྡན་འདས་ཀྱིས་ཆོས་བསྟན་པ་བདག་གིས་ཤེས་སོ་ཞེས་དེ་སྐད་མ་ཟེར་ཅིག་།
 nālam antarāyāya iti |	བཅོམ་ལྡན་འདས་ལ་སྐུར་པ་མ་འདེབས་ཤིག་།
 mā bhagavantam abhyācakṣuḥ na sādhu bhavati bhagavato 'bhyākhyānaṃ na ca punar bhagavān	བཅོམ་ལྡན་འདས་ལ་སྐུར་པས་ལེགས་པར་མི་འགྱུར་རོ་༎ བཅོམ་ལྡན་འདས་ནི་དེ་སྐད་མི་གསུང་ངོ་༎
 evam āha anekaparyāyeṇa āyuṣmann antarāyikā dharmāḥ santaḥ antarāyikā evoktā bhagavatā	ཚེ་དང་ལྡན་པ་བར་དུ་གཅོད་པའི་ཆོས་རྣམས་ནི་། བར་དུ་གཅོད་པ་ཉིད་དོ་ཞེས་། བཅོམ་ལྡན་འདས་ཀྱིས་རྣམ་གྲངས་དུ་མར་གསུངས་ཏེ་།
 te ca pratisevyamānā alam antarāyāyeti niḥsṛja tvam āyuṣmann evaṃrūpaṃ pāpakaṃ dṛṣṭigataṃ |	དེ་དག་བསྟེན་ན་བར་དུ་གཅོད་པར་འགྱུར་གྱིས་། ཚེ་དང་ལྡན་པ་ཁྱོད་སྡིག་པ་ཅན་གྱི་ལྟ་བའི་རྣམ་པ་འདི་ལྟ་བུ་འདི་ཐོང་ཞིག་ཅེས་བསྒོ་བར་བྱའོ་༎ དགེ་སློང་དེ་ལ་དགེ་སློང་རྣམས་ཀྱིས་དེ་སྐད་བསྒོ་བ་ན་།
 so bhikṣur bhikṣubhir ucyamānas tad vastu pratiniḥsṛjed ity evaṃ kuśalaṃ no cet pratiniḥsṛjed	གལ་ཏེ་གཞི་དེ་གཏོང་ན་དེ་ལྟ་ན་ལེགས་།
 dvir api trir api samanuyoktavyaḥ samanuśāsitavyas tasya pratiniḥsargāya dvir api	གལ་ཏེ་མི་གཏོང་ན་གཞི་དེ་གཏོང་བར་བྱ་བའི་ཕྱིར་ལན་གཉིས་ལན་གསུམ་དུ་ཡང་དག་པར་བསྒོ་བར་བྱ་། ཡང་དག་པར་བསྟན་པར་བྱའོ་༎ ལན་གཉིས་ལན་གསུམ་དུ་ཡང་དག་པར་བསྒོ་། ཡང་དག་པར་བསྟན་པ་ན་།
 trir api samanuyujyamānaḥ samanuśiṣyamānas tad vastu pratiniḥsṛjed ity evaṃ kuśalaṃ	གཞི་དེ་གཏོང་ན་དེ་ལྟ་ན་ལེགས་།
 no cet pratiniḥsṛjet pāyantikā | pāy|56 (prmosū_mū-banerjee)	གལ་ཏེ་མི་གཏོང་ན་ལྟུང་བྱེད་དོ་༎
 yaḥ punar bhikṣur jānaṃs tathāvādinaṃ pudgalam akṛtānudharmāṇam apratiniḥsṛṣṭe tasmin	ཡང་དགེ་སློང་གང་ཤེས་བཞིན་དུ་དེ་སྐད་ཟེར་བའི་གང་ཟག་ཆོས་བཞིན་དུ་མ་བྱས་པ་། སྡིག་པ་ཅན་གྱི་ལྟ་བའི་རྣམ་པ་དེ་མ་སྤངས་པ་དང་གཏམ་འདྲེ་བར་བྱེད་། ཕེབས་པར་སྨྲ་བར་བྱེད་། ཀུན་ཏུ་གནས་པར་བྱེད་། ཀུན་ཏུ་ལོངས་སྤྱོད་པར་བྱེད་ཅིང་།
 pāpake dṛṣṭigate ālāpayet saṃlapet tena sārdhaṃ saṃvaset saṃbhuṃjīta sahāgāraśayyām api kalpayet pāyantikā | pāy|57 (prmosū_mū-banerjee)	དེ་དང་ལྷན་ཅིག་གནས་གཅིག་ཏུ་ཉལ་ནའང་ལྟུང་བྱེད་དོ་༎ དགེ་ཚུལ་ཞིག་ཀྱང་འདི་སྐད་ཅེས་། ཇི་ལྟར་བཅོམ་ལྡན་འདས་ཀྱིས་འདོད་པ་༄༢༡ཨ་༌༎
 śramaṇoddeśaś cāpy evaṃ vadet tathāhaṃ bhagavato dharmaṃ deśitam ājānāmi yathā ye antarāyikā dharmā uktā bhagavatā te ca pratisevyamānā nālam antarāyāyeti |	དག་ནི་བར་དུ་གཅོད་པའོ་ཞེས་གསུངས་པ་གང་དག་ཡིན་པ་དེ་དག་བསྟེན་ཀྱང་བར་དུ་གཅོད་པར་མི་འགྱུར་ཏེ་། དེ་ལྟར་བཅོམ་ལྡན་འདས་ཀྱིས་ཆོས་བསྟན་པ་བདག་གིས་ཤེས་སོ་ཞེས་ཟེར་ན་། དགེ་ཚུལ་དེ་ལ་དགེ་སློང་རྣམས་ཀྱིས་འདི་སྐད་ཅེས་།
 sa śramaṇoddeśo bhikṣubhir idaṃ syād vacanīyo mā tvam āyuṣman śramaṇoddeśa evaṃ vocaḥ	དགེ་ཚུལ་ཁྱོད་ཇི་ལྟར་བཅོམ་ལྡན་འདས་ཀྱིས་འདོད་པ་དག་ནི་བར་དུ་གཅོད་པའོ་ཞེས་གསུངས་པ་གང་ཡིན་པ་དེ་དག་བསྟེན་ཀྱང་བར་དུ་གཅོད་པར་མི་འགྱུར་ཏེ་།
 tathāhaṃ bhagavato dharmaṃ deśitam ājānāmi yathā ye antarāyikā dharmā uktā bhagavatā	དེ་ལྟར་བཅོམ་ལྡན་འདས་ཀྱིས་ཆོས་བསྟན་པ་བདག་གིས་ཤེས་སོ་ཞེས་དེ་སྐད་མ་ཟེར་ཅིག་།
 te ca pratisevyamānā nālam antarāyāyeti |	བཅོམ་ལྡན་འདས་ལ་སྐུར་པ་མ་འདེབས་ཤིག་།
 mā bhagavantam abhyācakṣuḥ na sādhu bhavati bhagavato 'bhyākhyānaṃ na ca punar bhagavān	ཁྱོད་བཅོམ་ལྡན་འདས་ལ་སྐུར་བས་ལེགས་པར་མི་འགྱུར་རོ་༎ བཅོམ་ལྡན་འདས་ནི་དེ་སྐད་མི་གསུང་ངོ་༎
 evāha anekaparyāyeṇa śramaṇoddeśa antarāyikā dhamāḥ santaḥ antarāyikā evoktā bhagavatā	ཚེ་དང་ལྡན་པ་དགེ་ཚུལ་འདོད་པ་དག་ནི་བར་དུ་གཅོད་པ་ཉིད་དོ་ཞེས་བཅོམ་ལྡན་འདས་ཀྱིས་རྣམ་གྲངས་དུ་མར་གསུངས་ཏེ་།
 te ca pratisevyamānā alam antarāyāyeti |	དེ་དག་བསྟེན་ན་བར་དུ་གཅོད་པར་འགྱུར་གྱིས་།
 niḥsṛja tvam* śramaṇoddeśa evaṃrūpaṃ dṛṣṭigatam* |	དགེ་ཚུལ་ཁྱོད་སྡིག་པ་ཅན་གྱི་ལྟ་བའི་རྣམ་པ་འདི་ལྟ་བུ་འདི་ཐོང་ཞིག་ཅེས་བསྒོ་བར་བྱའོ་༎ དགེ་ཚུལ་དེ་ལ་དགེ་སློང་རྣམས་ཀྱིས་དེ་སྐད་བསྒོ་བ་ན་།
 sa śramaṇoddeśo bhikṣubhir ucyamānas tad vastu cet pratiniḥsṛjed ity evaṃ kuśalaṃ	གལ་ཏེ་གཞི་དེ་གཏོང་ན་དེ་ལྟ་ན་ལེགས་།
 no cet pratiniḥsṛjed dvir api trir api samanuyoktavyaḥ samanuśāsitavyas tasya vastunaḥ	གལ་ཏེ་མི་གཏོང་ན་གཞི་དེ་གཏོང་བར་བྱ་བའི་ཕྱིར་ལན་གཉིས་ལན་གསུམ་དུ་ཡང་དག་པར་བསྒོ་བར་བྱ་། ཡང་དག་པར་བསྟན་པར་བྱའོ་༎
 pratiniḥsargāya dvir api trir api samanuyujyamānaḥ samanuśiṣyamānas tad vastu pratiniḥsṛjed	ལན་གཉིས་ལན་གསུམ་དུ་ཡང་དག་པར་བསྒོ་། ཡང་དག་པར་བསྟན་པ་ན་།
 ity evaṃ kuśalaṃ no cet pratiniḥsṛjet sa śramaṇoddeśo bhikṣubhir idaṃ syād vacanīyo	གཞི་དེ་གཏོང་ན་དེ་ལྟ་ན་ལེགས་། གལ་ཏེ་མི་གཏོང་ན་། དགེ་༄༢༡བ་ཚུལ་དེ་ལ་དགེ་སློང་རྣམས་ཀྱིས་དེང་ཕྱིན་ཆད་དགེ་ཚུལ་ཁྱོད་།
 'dyāgreṇāyuṣman śramaṇoddeśa nāsau bhagavāṃs tathāgataḥ arhan samyaksaṃbuddhaḥ śāstā |	བཅོམ་ལྡན་འདས་དེ་བཞིན་གཤེགས་པ་དགྲ་བཅོམ་པ་ཡང་དག་པར་རྫོགས་པའི་སངས་རྒྱས་དེ་ལ་སྟོན་པའོ་ཞེས་མ་ཟེར་ཅིག་།
 evaṃrūpasyānyatamānyatmasya brahmacāriṇaḥ pṛṣṭataḥ mā samanubadhāna yāvad apy anye	ཚངས་པ་མཚུངས་པར་སྤྱོད་པ་མཁས་པ་བླ་མའི་གནས་ལྟ་བུ་གང་ཡང་རུང་བའི་ཕྱི་བཞིན་དུ་ཡང་མ་འགྲོ་ཞིག་།
 śramaṇoddeśāḥ labhante bhikṣubhiḥ sārdhaṃ dvirātraparamaṃ sahāgāraśayyāṃ sāpi te adyāgreṇa nāsti cara careṇa mohapuruṣa naśyati |	དགེ་སློང་རྣམས་དང་། དགེ་ཚུལ་ལྷན་ཅིག་ནུབ་གཉིས་ཚུན་ཆད་གནས་གཅིག་ཏུ་ཉལ་དུ་དབང་བ་གང་ཡིན་པ་དེའང་དེང་ཕྱིན་ཆད་ཁྱོད་ལ་མེད་དེ་། མི་གཏི་མུག་ཅན་ཁྱོད་བསྙིལ་གྱིས་གཞན་དུ་སོང་ཞིག་ཅེས་བསྒོ་བར་བྱའོ་༎ ཡང་དགེ་སློང་གང་ཤེས་བཞིན་དུ་།
 yaḥ punar bhikṣur jānan tathānāśitaṃ śramaṇoddeśam upasthāpayed vā upalālayed vā tena vā sārdhaṃ sahāgāraśayyāṃ kalpayet pāyantikā | pāy|58 (prmosū_mū-banerjee)	དེ་ལྟར་བསྙིལ་བའི་དགེ་ཚུལ་ཉེ་བར་འཇོག་པར་བྱེད་དམ་། ཉེ་བར་སྟོན་པར་བྱེད་དམ་། དེ་དང་ལྷན་ཅིག་གནས་ཅིག་ཏུ་ཉལ་ན་ལྟུང་བྱེད་དོ་༎
 navaṃ khalu bhikṣuṇā cīvaraṃ pratilabhya trayāṇāṃ durvarṇīkaraṇānām anyatamānyatamaḥ nīlo vā lohito vā pīto vā durvarṇīkaraṇāya ādātavyo 'nādāya ced bhikṣus trayāṇāṃ	དགེ་སློང་གིས་གོས་གསར་པ་ཞིག་རྙེད་ན་།
 durvarṇīkaraṇānām anyatamānyatamaṃ durvaṇīkaraṇaṃ nīlaṃ vā lohitaṃ vā pītaṃ vā navaṃ	ཁ་བསྒྱུར་བ་གསུམ་པོ་སྔོན་པོའམ་། དམར་པོའམ་།
 cīvaraṃ paribhuṃjīta pāyantikā |	ངུར་སྨྲིག་ལས་གང་ཡང་རུང་བས་ཁ་དོག་བསྒྱུར་བར་བྱའོ་༎ གལ་ཏེ་དགེ་སློང་གིས་གོས་གསར་པ་ཁ་བསྒྱུར་བ་གསུམ་པོ་སྔོན་པོའམ་།
 pāy|59 (prmosū_mū-banerjee)	དམར་པོའམ་། ངུར་སྨྲིག་ལས་གང་ཡང་རུང་བར་ཁ་མ་བསྒྱུར་བར་ལོངས་སྤྱོད་ན་ལྟུང་བྱེད་དོ་༎
 yaḥ punar bhikṣu ratnaṃ vā ratnasaṃmataṃ vā svahastena udgṛhṇīyād udgrāhayed vānyatrādhyārāmagatād vādhyāvāsagatād vā pāyantikā |	ཡང་དགེ་སློང་གང་རིན་པོ་ཆེའམ་། རིན་པོ་ཆེར་སྨོས་པ་རང་གི་ལག་གིས་ལེན་ཏམ་། ལེན་དུ་འཇུག་ན་ཀུན་དགའ་ར་བར་གཏོགས་པ་ན་འདུག་པའམ་། གནས་ཁང་དུ་གཏོགས་པ་ན་འདུག་པ་མ་གཏོགས་ཏེ་ལྟུང་བྱེད་དོ་༎ དགེ་སློང་གིས་ཀུན་དགའ་ར་བར་གཏོགས་པའམ་།
 bhikṣuṇādhyārāmagataṃ vādhyāvāsagataṃ vā ratnaṃ ratnasaṃmataṃ vā udgrahītavyaṃ yasyedaṃ bhaviṣyati so hariṣyati ity evaṃ manasikṛtvā |	གནས་ཁང་དུ་གཏོགས་པ་ན་རིན་པོ་ཆེའམ་། རིན་པོ་ཆེར་སྨོས་པ་འདུག་པ་༄༢༢ཨ་༌༎ ལ་འདི་སུའི་ཡིན་པ་དེ་ལེན་པར་འགྱུར་གྲང་སྙམ་པ་དེ་ལྟ་བུའི་སེམས་ཀྱིས་བླང་བར་བྱ་སྟེ་། 
 ayaṃ tatra samayaḥ | pāy|60 (prmosū_mū-banerjee)	དེ་ལ་དེ་ནི་ཆོ་ག་ཡིན་ནོ་༎
 bhagavatā deśitam anvardhamāsaṃ snāyād anyatra samayāt tadatikramāt pāyantikā |	བཅོམ་ལྡན་འདས་ཀྱིས་ཟླ་བ་ཕྱེད་ཕྱེད་ཅིང་། ཁྲུས་བྱ་བར་གསུངས་པ་དེ་ལས་འདུམས་པར་བྱེད་ན་དུས་མ་གཏོགས་ཏེ་ལྟུང་བྱེད་དོ་༎
 ayaṃ tatra samayaḥ -- adhyardho māsaḥ śeṣo grīṣmāṇāṃ pūrvo māso varṣāṇāṃ ity ete ardhatṛtīyamāsā uṣṇasamayo 'vaśiṣṭaṃ glānasamayaḥ karmasamayo vṛṣṭisamayo vātavṛṣṭisamayo	དེ་ལ་དུས་ནི་འདི་ཡིན་ཏེ་། སོ་ག་རྣམས་ཀྱི་ཟླ་བ་ལྷག་མ་ཕྱེད་དང་གཉིས་དང་། དབྱར་རྣམས་ཀྱི་དང་པོ་དང་། ཟླ་བ་ཕྱེད་དང་གསུམ་པོ་འདི་དག་ནི་ཚ་བའི་དུས་སོ་༎ ལྷག་མ་ནི་ན་བ་དུས་སོ་༎ ལས་དུས་སོ་༎ རླུང་དུས་སོ་༎ ཆར་དུས་སོ་༎ རྫི་ཆར་དུས་ཏེ་།
 'yaṃ tatra samayaḥ |	དེ་ལ་དེ་ནི་དུས་ཡིན་ནོ་༎
 pāy|61 (prmosū_mū-banerjee)	སྡོམ་ལ་། དུད་འགྲོ་འགྱོད་པ་སོར་མོ་དང་༎ རྩེ་དང་ལྷན་ཅིག་དངངས་བྱེད་དང་༎ སྦེད་དང་གདེང་མེད་གཞི་མེད་དང་༎ སྐྱེས་པ་མེད་པར་ལམ་འགྲོ་བའོ་༎
 yaḥ punar bhikṣuḥ saṃcintya tīryagyonigataṃ prāṇinaṃ jīvitād vyaparopayet pāyantikā | pāy|62 (prmosū_mū-banerjee)	ཡང་དགེ་སློང་གང་བསམས་བཞིན་དུ་དུད་འགྲོའི་སྐྱེ་གནས་སུ་གཏོགས་པའི་སྲོག་ཆགས་གསོད་ན་ལྟུང་བྱེད་དོ་༎ 
 yaḥ punar bhikṣuḥ saṃcintya kaccid asya bhikṣor muhūrtam api tāvad aphāṣaṃ sparśaṃ bhaved etad eva pratyayaṃ kṛtvā bhikṣoḥ kaukṛtyam upasaṃharet pātayantikā | pāy|63 (prmosū_mū-banerjee)	དགེ་སློང་གང་བསམས་བཞིན་དུ་ཅི་ནས་ཀྱང་དགེ་སློང་འདི་ཡུད་ཙམ་ཞིག་ཀྱང་བདེ་བ་ལ་མི་རེག་པར་བྱའོ་སྙམ་པ་དེ་ཉིད་རྐྱེན་དོ་༎ དུ་བྱས་ཏེ་། དགེ་སློང་ལ་འགྱོད་པ་སྐྱེད་ན་ལྟུང་བྱེད་དོ་༎
 aṅgulipratodanāt pāyantikā | pāy|64 (prmosū_mū-banerjee)	སོར་མོས་ག་ག་ཚིལ་བྱེད་ན་ལྟུང་བྱེད་དོ་༎
 udakaharṣaṇāt pāyantikā | pāy|65 (prmosū_mū-banerjee)	ཆུ་ལ་རྩེ་ན་ལྟུང་བྱེད་དོ་༎
 yaḥ punar bhikṣur mātṛgrāmeṇa sārdhaṃ sahāgāraśayyāṃ kalpayet pāyantikā | pāy|66 (prmosū_mū-banerjee)	ཡང་དགེ་སློང་གང་། བུད་མེད་ཀྱི་ཡུལ་དང་ལྷན་ཅིག་གནས་གཅིག་ཏུ་ཉལ་ན་ལྟུང་བྱེད་དོ་༎
 yaḥ punar bhikṣur bhikṣuṃ bhīṣayed bhīṣāpayed vāntato hāsyaprekṣyam api pāyantikā | pāy|67 (prmosū_mū-banerjee)	ཡང་དགེ་སློང་གང་དགེ་སློང་ལ་སྡངས་པར་བྱེད་དམ་བྱེད་དུ་འཇུག་ན་། ཐ་ན་བཞད་གད་དུ་བྱ་བར་བསམས་ཀྱང་རུང་སྟེ་ལྟུང་བྱེད་དོ་༎ ཡང་དགེ་སློང་གང་དགེ་སློང་ངམ་།
 yaḥ punar bhikṣur bhikṣor vā bhikṣuṇyā vā śikṣamāṇāyā vā śrāmaṇerasya vā śrāmaṇerikāyā	དགེ་༄༢༢བ་སློང་མའམ་། དགེ་སློབ་མའམ་། དགེ་ཚུལ་ལམ་། དགེ་ཚུལ་མའི་ལྷུང་བཟེད་དམ་།
 vā pātraṃ vā cīvaraṃ vā upānahaṃ vā sūcīgharaṃ vā kāyabandhanaṃ vānyatamānyatamaṃ	ཆོས་གོས་སམ་། དྲ་བའམ་། ཕོར་བུའམ་། སྐ་རགས་སམ་། དགེ་སྦྱོང་གི་འཚོ་བའི་ཡོ་བྱད་གང་ཡང་རུང་བ་སྦེད་དམ་སྦེད་དུ་འཇུག་ན་།
 vā jīvitapariṣkāram upanidadhyād upanidhāpayet tadrūpapratyayād anyatra pāyantikā | pāy|68 (prmosū_mū-banerjee)	དེ་འདྲ་བའི་རྐྱེན་མ་གཏོགས་ཏེ་ལྟུང་བྱེད་དོ་༎
 yaḥ punar bhikṣur bhikṣoś cīvaram vikalya tataḥ paścād apratyuddhārya paribhuṃjīta pāyantikā | pāy|69 (prmosū_mū-banerjee)	ཡང་དགེ་སློང་གང་དགེ་སློང་ལ་གོས་བྱིན་ནས་དེའི་འོག་ཏུ་གདེང་མེད་པར་སྤྱོད་ན་ལྟུང་བྱེད་དོ་༎ 
 yaḥ punar bhikṣuḥ kupito 'nāttamanā pariśuddhaṃ anāpattikaṃ bhikṣuṃ amūlakena saṃghāvaśeṣeṇa dharmeṇānudhvaṃsayet pāyantikā |	ཡང་དགེ་སློང་གང་ཁྲོས་ཤིང་ཞེ་སྡང་བར་གྱུར་ནས་དགེ་སློང་དག་པ་ལྟུང་བ་མེད་དོ་༎ 
 pāy|70 (prmosū_mū-banerjee)	།
 yaḥ punar bhikṣur apuruṣayā striyā sārdhaṃ saṃvidhāyādhvamārgaṃ pratipadyetāntato grāmāntaram api pāyantikā | pāy|71 (prmosū_mū-banerjee)	ཡང་དགེ་སློང་གང་སྐྱེས་པ་མེད་པར་བུད་མེད་དང་ལྷན་ཅིག་མགྲོན་ལམ་དུ་འགྲོ་ན༏་ཐ་ན་གྲོང་བར་དུ་ཡང་རུང་སྟེ་ལྟུང་བྱེད་དོ་༎ སྡོམ་ལ་། རྐུ་དང་ཉི་ཤུ་མ་ལོན་དང་༎ རྐོ་དང་མགྲོན་དང་བསླབ་པ་དང་༎ འཐབ་དང་མི་སྨྲ་འགྲོ་བ་དང་༎ མ་གུས་ཆང་འཐུང་དུས་མིན་པའོ་༎
 yaḥ punar bhikṣuḥ steyasārthena sārdhaṃ saṃvidhāyādhvamārgaṃ pratipadyetāntato grāmāntaram api pāyantikā | pāy|72 (prmosū_mū-banerjee)	ཡང་དགེ་སློང་གང་དོན་མཐུན་པ་རྐུན་མ་དང་ལྷན་ཅིག་མགྲོན་ལམ་དུ་འགྲོ་ན་། ཐ་ན་གྲོང་བར་དུ་ཡང་རུང་སྟེ་ལྟུང་བྱེད་དོ་༎
 yaḥ punar bhikṣur ūnaviṃśavarṣaṃ pudgalaṃ bhikṣubhāvāyopasaṃpādayeta pāyantikā |	ཡང་དགེ་སློང་གང་གང་ཟག་ལོ་ཉི་ཤུ་མ་ལོན་པ་། དགེ་སློང་གི་དངོས་པོར་བསྙེན་པར་རྫོགས་པར་བྱེད་ན་ལྟུང་བྱེད་དོ་༎
 sa ca pudgalo 'nupasaṃpannas te ca bhikṣavo garhyā ayaṃ tatra samayaḥ | pāy|73 (prmosū_mū-banerjee)	གང་ཟག་དེ་ཡང་བསྙེན་པར་རྫོགས་པར་མི་འགྱུར་ལ་། དགེ་སློང་དག་ཀྱང་སྨད་པར་འགྱུར་བ་ཡིན་ཏེ་། དེ་ལ་དེ་ནི་ཆོ་ག་ཡིན་ནོ་༎
 yaḥ punar bhikṣuḥ svahastena pṛthivīṃ khanyāt khānayed vā pāyantikā | pāy|74 (prmosū_mū-banerjee)	ཡང་དགེ་སློང་གང་རང་གི་ལག་གིས་ས་རྐོའམ་། རྐོར་འཇུག་ན་ལྟུང་བྱེད་དོ་༎
 cāturmāsikapravāraṇā bhikṣuṇā svīkartavyā tatottaraṃ pāyantikā | pratyekapravāraṇāyā punaḥ punaḥ pravāraṇāyāḥ kālikapravāraṇāyā nityapravāraṇāyā anyatra ayaṃ tatra samayaḥ | pāy|75 (prmosū_mū-banerjee)	དགེ་སློང་གིས་ཟླ་བ་བཞིར་མགྲོན་དུ་བོས་པ་བདག་གིར་བྱའོ་༎ དེ་ལས་ལྷག་པར་བདག་གིར་བྱེད་ན་ལྟུང་བྱེད་དོ་༎ སོ་སོར་མགྲོན་༄༢༣ཨ་༌༎ དུ་བོས་པ་དང་། ཡང་དང་ཡང་དུ་མགྲོན་དུ་བོས་པ་དང་། དུས་ཀྱི་མགྲོན་དུ་བོས་པ་དང་། རྟག་ཏུ་མགྲོན་དུ་བོས་པ་ནི་མ་གཏོགས་ཏེ་། དེ་ལ་དེ་ནི་དུས་ཡིན་ནོ་༎
 yaḥ punar bhikṣur bhikṣubhir āyuṣmatā tvayā śikṣāyāṃ śikṣitavyam iti ucyamāna evaṃ	ཡང་དགེ་སློང་གང་དགེ་སློང་རྣམས་ཀྱིས་ཚེ་དང་ལྡན་པ་ཁྱོད་ཀྱིས་བསླབ་པ་འདི་ལ་བསླབ་པར་བྱའོ་ཞེས་བསྒོ་བ་ན་།
 vaden nāhaṃ tava bālasya mūḍhasya duṣprajñasya vacanāni śikṣiṣyāmi yāvan nāhaṃ bhikṣūn prakṣyāmi sūtradharān vinayadharān mātṛkadharān iti pāyantikā |	དེ་དག་ལ་འདི་སྐད་ཅེས་བདག་དགེ་སློང་མདོ་སྡེ་འཛིན་པ་དང་། འདུལ་བ་འཛིན་པ་དང་། མ་མོ་འཛིན་པ་རྣམས་ལ་འདྲི་བའི་བར་དུ་བྱིས་པ་། རྨོངས་པ་མི་གསལ་བ་།
 sarvajñatākāmena bhikṣuṇā śikṣāyāṃ śikṣitavyaṃ bhikṣavaḥ praṣṭavyāḥ sūtradharā vinayadharā mātṛkadharā ayaṃ tatra samayaḥ | pāy 76 (prmosū_mū-banerjee)	མི་མཁས་པ་ཁྱེད་ཀྱི་ཚིག་གིས་བསླབ་པ་འདི་ལ་མི་སློབ་པོ་ཞེས་ཟེར་ན་ལྟུང་བྱེད་དོ་༎ དགེ་སློང་ཀུན་ཤེས་པར་འདོད་པས་ཀྱང་བསླབ་པ་དེ་ལ་བསླབ་པར་བྱའོ་༎
 yaḥ punar bhikṣur bhikṣūṇāṃ kalahajātānāṃ bhaṇḍanajātānāṃ bhedagṛhītānāṃ vivādam	དགེ་སློང་མདོ་སྡེ་འཛིན་པ་དང་། འདུལ་བ་འཛིན་པ་དང་། མ་མོ་འཛིན་པ་རྣམས་ལ་ཡང་དྲི་བར་བྱ་སྟེ་། དེ་ལ་དེ་ནི་ཆོ་ག་ཡིན་ནོ་༎ ཡང་དགེ་སློང་གང་དགེ་སློང་རྣམས་འཐབ་པར་འགྱུར་། མཚང་འདྲུ་བར་འགྱུར་། མི་མཐུན་པར་འགྱུར་།
 āpannānāṃ tūṣṇīm upaśrutikas tiṣṭhed yad ete bhikṣavo vakṣyanti tad ahaṃ dhārayiṣyāmīty	རྩོད་པར་གྱུར་ཅིང་འཁོད་པ་ལས་། དགེ་སློང་འདི་དག་ཇི་སྐད་ཟེར་བ་དེ་བདག་གིས་མཉན་ཏེ་།
 etad eva pratyayaṃ kṛtvā pāyantikā | pāy|77 (prmosū_mū-banerjee)	དེ་ལྟ་དེ་ལྟར་རྗེས་སུ་ཐ་སྙད་གདགས་པར་བྱའོ་སྙམ་པ་དེ་ཉིད་རྐྱེན་དུ་བྱས་ཏེ་། ཅང་མི་སྨྲ་བར་ཉན་ནས་འདུག་ན་ལྟུང་བྱེད་དོ་༎
 yaḥ punar bhikṣuḥ saṃghe dharmikāyāṃ viniścayakathāyāṃ vartamānāyāṃ āsanāt tūṣṇīm utthāya prakrāmet santaṃ bhikṣum anavapṛcchyānyatra tadrūpapratyayāt pāyantikā | pāy|78 (prmosū_mū-banerjee)	ཡང་དགེ་སློང་གང་དགེ་འདུན་གྱི་ཆོས་དང་ལྡན་པར་གཏམ་རྣམ་པར་གཏན་ལ་འབེབས་པར་བྱུང་བ་ན༏་ཅང་མི་སྨྲ་བར་སྟན་ལས་ལངས་ཏེ་འགྲོ་ཞིང་། དགེ་སློང་འདུག་པ་ལ་མི་སྨྲ་ན་དེ་འདྲ་བའི་རྐྱེན་མ་གཏོགས་ཏེ་ལྟུང་བྱེད་དོ་ཞིང་། 
 anādaravṛttāt pāyantikā | pāy|79 (prmosū_mū-banerjee)	༎ གུས་པར་མི་བྱེད་ན་ལྟུང་བྱེད་དོ་༎
 surāmaireyamadyapānāt pāyantikā | pāy|80 (prmosū_mū-banerjee)	འབྲུའི་ཆང་དང་བཅོས་པའི་ཆང་༄༢༣བ་མྱོས་པར་འགྱུར་བ་འཐུང་ན་ལྟུང་བྱེད་དོ་༎
 yaḥ punar bhikṣur akāle grāmaṃ praviśet santaṃ bhikṣum anavapṛcchya anyatra tadrūpāt pratyayāt pāyantikā | pāy|81 (prmosū_mū-banerjee)	ཡང་དགེ་སློང་གང་དུས་མ་ཡིན་པར་གྲོང་དུ་འཇུག་ཅིང་། དགེ་སློང་འདུག་པ་ལ་ནི་མི་སྨྲ་ན་དེ་འདྲ་བའི་རྐྱེན་མ་གཏོགས་ཏེ་ལྟུང་བྱེད་དོ་༎ སྡོམ་ལ་། ཟས་བཅས་སྐྱ་རེངས་ད་གདོད་དང་༎ ཁབ་རལ་དང་ནི་ཁྲི་རྐང་དང་༎ བདལ་དང་གདིང་དང་ག-ཡན་པ་དང་༎ རས་ཆེན་བདེ་གཤེགས་ཆོས་གོས་སོ་༎
 yaḥ punar bhikṣuḥ sabhaktaḥ kule nimantritaḥ pūrvabhaktaṃ paścādbhaktaṃ kuleṣu cāritram āpadyeta santaṃ kulaṃ apratisaṃvedito 'nyatra tadrūpāt pratyayāt pāyantikā | pāy|82 (prmosū_mū-banerjee)	ཡང་དགེ་སློང་གང་། ཟས་དང་བཅས་པའི་ཁྱིམ་དུ་མགྲོན་དུ་བོས་ནས་།
 yaḥ punar bhikṣur anirgatāyāṃ rajanyām anudgate 'ruṇe anirhṛteṣu ratneṣu ratnasaṃmateṣu	སྔ་དྲོ་དང་ཕྱི་དྲོ་ཁྱིམ་དག་ཏུ་རྒྱུ་ཞིང་། ཁྱིམ་པ་འདུག་པ་ལ་མི་བསྒོ་ན་། དེ་འདྲ་བའི་རྐྱེན་མ་གཏོགས་ཏེ་ལྟུང་བྱེད་དོ་༎
 vā rājñaḥ kṣatriyasya mūrdhābhiṣiktasya indrakīlaṃ vā indrakīlasāmantakaṃ vā samatikraned	ཡང་དགེ་སློང་གང་ནམ་མ་ལངས་སྐྱ་རེངས་མ་ཤར་བར་རིན་པོ་ཆེ་དག་གམ་། རིན་པོ་ཆེར་སྨོས་པ་དག་མ་བསྡུས་པར་རྒྱལ་པོ་རྒྱལ་རིགས་སྤྱི་བོར་དབང་བསྐུར་བའི་སྒོ་གཏན་ནམ་། སྒོ་གཏན་གྱི་ཉེ་འཁོར་ལས་འདས་ན་།
 anyatra tadrūpāt pratyayāt pāyantikā | pāy|83 (prmosū_mū-banerjee)	དེ་འདྲ་བའི་རྐྱེན་མ་གཏོགས་ཏེ་ལྟུང་བྱེད་དོ་༎
 yaḥ punar bhikṣur anvardhamāsaṃ prātimokṣasūtre uddiśyamāne evaṃ vaded idānīm ahaṃ	ཡང་དགེ་སློང་གང་ཟླ་བ་ཕྱེད་ཕྱེད་ཅིང་སོ་སོར་ཐར་པའི་མདོ་གདོན་པ་འདོན་པའི་ཚེ་།
 jānāmi āyuṣmanto 'yam api kila dharmaḥ sūtragataḥ sūtraparyāyāpannoddeśyam āgacchatīti	འདི་སྐད་ཅེས་ཚེ་དང་ལྡན་པ་དག་འདི་ལྟར་ཆོས་འདི་ཡང་མདོའི་ནང་དུ་གཏོགས་། མདོའི་ནང་དུ་འདུས་པར་བདག་གིས་ད་གདོད་ཤེས་སོ་ཞེས་ཟེར་ལ་།
 tatrāyuṣmantaṃ ced bhikṣavo jānīyuḥ niṣaṇṇapūrvaṃ āyuṣmatā dvitrikṛtvaṃ poṣadhe kaḥ	དེ་ལ་གལ་ཏེ་དགེ་སློང་རྣམས་ཀྱིས་ཀྱང་། ཚེ་དང་ལྡན་པ་འདི་སྔོན་གསོ་སྦྱོང་གི་ལས་ལ་ལན་གཉིས་སམ་། གསུམ་གྱི་ཚེ་འདུག་པར་ཤེས་ཤིང་། ལན་མང་དུ་ལྟ་ཅི་སྨོས་ན་།
 punar vādo bhūya iti āyuṣmato ajñānataḥ na muktiḥ yata āpattim āpannaḥ tato yathādharmaṃ	ཚེ་དང་ལྡན་པ་དེ་མི་ཤེས་པར་མི་འགྲོ་བས་དེ་ལྟུང་བ་གང་བྱུང་བ་དེ་ཆོས་བཞིན་དུ་བྱེད་དུ་གཞུག་གི་སྟེང་དུ་ཟླ་བ་ཕྱེད་ཕྱེད་ཅིང་སོ་སོར་ཐར་པའི་མདོ་གདོན་པ་འདོན་པའི་ཚེ་། གུས་པར་བྱས་ཏེ་ཆོས་ཉན་པར་༄༢༤ཨ་༌༎ མི་བྱེད་། བླ་མར་བྱས་ཏེ་མི་བྱེད་། རུ་ཤིང་ལྟར་བྱས་ཏེ་མི་བྱེད་། ཡིད་ལ་བྱས་ཏེ་མི་བྱེད་། སེམས་རྩེ་གཅིག་ཏུ་མི་བྱེད་། རྣ་བླགས་ཏེ་མི་བྱེད་། སེམས་ཐམས་ཅད་ཀྱིས་བསམས་ཏེ་ཆོས་ཉན་པར་མི་བྱེད་པས་། ཚེ་དང་ལྡན་པ་ཁྱོད་ཀྱིས་མ་རྙེད་དེ་།
 kārayitavya uttaraṃ ca kaukṛtyam āropayitavyaṃ -- āyuṣman te alābho 'labdhaḥ durlabdho na sulabdho yat tvaṃ anvardhamāsaṃ prātimokṣasūtroddiśyamāne na satkṛtya śṛṇoṣi na gurukaroṣi nārthikaroṣi na manasikaroṣi ekāgracittenāvahitaśrotreṇa na śṛṇoṣi sarvacittasaṃkalpair api na śṛṇoṣi |	རྙེད་པ་མ་ཡིན་ཞིང་། ཉེས་པ་རྙེད་དེ་། ལེགས་པ་རྙེད་པ་མ་ཡིན་ནོ་ཞེས་འགྱོད་པར་བྱའོ་༎
 āyuṣman tatra kaukṛtyāt pāyantikā |	ཚེ་དང་ལྡན་པ་དེ་ལ་འགྱོད་པར་བྱ་བ་ནི་དེ་ཡིན་ཏེ་ལྟུང་བྱེད་དོ་༎ ཡང་དགེ་སློང་གང་།
 pāy|84 (prmosū_mū-banerjee)	བ་སོའམ་།
 yaḥ punar bhikṣur asthimayaṃ vā viṣāṇamayaṃ vā sūcigharaṃ kārayet tad bhedanāt pāyantikā | pāy|85 (prmosū_mū-banerjee)	རུས་པའམ་། རའི་ཁབ་རལ་བྱེད་དམ་བྱེད་དུ་འཇུག་ན་། བཅག་ནས་ལྟུང་བྱེད་དོ་༎ ཡང་དགེ་སློང་གིས་དགེ་འདུན་གྱི་ཁྲིའམ་།
 bhikṣuṇā saṃghasya pīṭhaṃ vā mañcaṃ kārayatā sugatāṣṭāṅgulipramāṇāḥ pādāḥ kārayitavyā anyatra adhastāt* aṭanyās tata uttaraṃ kārayec chedanāt pāyantikā | pāy|86 (prmosū_mū-banerjee)	ཁྲིའུ་བྱེད་དུ་འཇུག་ན་། རྩ་བ་བུ་གར་གཞུག་པ་མ་གཏོགས་པར་བདེ་བར་གཤེགས་པའི་སོར་བརྒྱད་ཀྱི་ཚད་དུ་བྱེད་དུ་གཞུག་པར་བྱའོ་༎ དེ་ལས་ལྷག་པར་བྱེད་དུ་འཇུག་ན་། བཅད་ནས་ལྟུང་བྱེད་དོ་༎ ཡང་དགེ་སློང་གང་།
 yaḥ punar bhikṣus tūlasaṃstṛtaṃ pīṭhaṃ vā mañcaṃ avanahed avanāhayed vā uddalanāt pāyantikā | pāy|87 (prmosū_mū-banerjee)	དགེ་འདུན་གྱི་ཁྲིའམ་། ཁྲིའུ་ལ་ཤིང་བལ་བདལ་ལམ་། བདལ་དུ་འཇུག་ན་བསྡུས་ནས་ལྟུང་བྱེད་དོ་༎ དགེ་སློང་གིས་གདིང་བ་བྱེད་དུ་འཇུག་ན་ཚད་བཞིན་དུ་བྱེད་དུ་ཆུག་ཅིག་།
 niṣīdanaṃ bhikṣuṇā kārayatā prāmāṇikaṃ kārayitavyaṃ tatredaṃ pramāṇaṃ -- dīrghato	དེ་ལ་གདིང་བའི་ཚད་ནི་འདི་ཡིན་ཏེ་། སྲིད་དུ་བདེ་བར་གཤེགས་པའི་མཐོའི་མཐོ་དོ་།
 vitastrī dve sugatavitastyās tīryak sārdhavitastir daśānāñ ca vitastis tata uttaraṃ	ཞེང་དུ་མཐོ་ཕྱེད་དང་དོ་། སྲིད་དུ་མཐོ་གང་གིས་སྲིངས་ཤིག་། དེ་ལས་ལྷག་པར་བྱེད་དུ་འཇུག་ན་།
 kārayed bhedanāt pāyantikā | pāy|88 (prmosū_mū-banerjee)	བཅད་ནས་ལྟུང་བྱེད་དོ་༎ ཡང་དགེ་སློང་གིས་ག-ཡན་པ་དགབ་པ་བྱེད་དུ་འཇུག་ན་། ཚད་བཞིན་དུ་བྱེད་དུ་ཆུག་ཅིག་།
 kaṇḍupraticchādanaṃ bhikṣuṇā kārayatā prāmāṇikaṃ kārayitavyaṃ tatredaṃ pramāṇaṃ -- dīrghataś catasro vitastayaḥ sugatavitastyas tiryag dve tata uttaraṃ kārayec chedanāt pāyantikā |	དེ་ལ་ག-ཡན་པ་དགབ་པའི་ཚད་ནི་འདི་ཡིན་ཏེ་། སྲིད་དུ་བདེ་བར་གཤེགས་པའི་མཐོའི་༄༢༤བ་མཐོ་བཞི་།
 pāy|89 (prmosū_mū-banerjee)	ཞེང་དུ་མཐོ་དོ་། དེ་ལས་ལྷག་པར་བྱེད་དུ་འཇུག་ན་། བཅད་ནས་ལྟུང་བྱེད་དོ་༎
 varṣāśāṭīcīvaraṃ bhikṣuṇā kārayatā prāmāṇikaṃ kārayitavyaṃ tatredaṃ pramāṇaṃ -- dīrghataḥ ṣaṭ vitastayaḥ sugatavitastyas tiryak sārdhe dve tata uttaraṃ kārayec chedanāt pāyantikā | pāy|90 (prmosū_mū-banerjee)	དགེ་སློང་གིས་དབྱར་གྱི་གོས་རས་ཆེན་བྱེད་དུ་འཇུག་ན་། ཚད་བཞིན་དུ་བྱེད་དུ་ཆུག་ཅིག་། དེ་ལ་དབྱར་གྱི་གོས་རས་ཆེན་གྱི་ཚད་ནི་འདི་ཡིན་ཏེ་། སྲིད་དུ་བདེ་བར་གཤེགས་པའི་མཐོའི་མཐོ་དྲུག་། ཞེང་དུ་ཕྱེད་དང་གསུམ་མོ་༎ དེ་ལས་ལྷག་པར་བྱེད་དུ་འཇུག་ན་། བཅད་ནས་ལྟུང་བྱེད་དོ་༎
 yaḥ punar bhikṣuḥ sugatacīvarapramāṇaṃ cīvaraṃ kārayed uttaraṃ vā sugatacīvarāt pāyantikā |	ཡང་དགེ་སློང་གང་། བདེ་བར་གཤེགས་པའི་ཆོས་གོས་ཀྱི་ཚད་ཀྱི་ཆོས་གོས་བྱེད་དུ་འཇུག་གམ་། བདེ་བར་གཤེགས་པའི་ཆོས་གོས་ལས་ལྷག་པར་བྱེད་དུ་འཇུག་ན་ལྟུང་བྱེད་དོ་༎ དེ་ལ་བདེ་བར་གཤེགས་པའི་ཆོས་གོས་ཀྱི་ཚད་ནི་འདི་ཡིན་ཏེ་། སྲིད་དུ་བདེ་བར་གཤེགས་པའི་མཐོའི་མཐོ་བཅུ་།
 tatredaṃ sugatacīvarapramāṇaṃ dīrghato nava vitastayaḥ tiryak ṣaḍ vitastayaḥ idaṃ sugatacīvarapramāṇam* |	ཞེང་དུ་མཐོ་དྲུག་སྟེ་། དེ་ལ་འདི་ནི་བདེ་བར་གཤེགས་པའི་ཆོས་གོས་ཀྱི་ཚད་དོ་༎
 pay|schl| uddiṣṭā mayāyuṣmanto navatiḥ pāyantikā dharmāḥ |	ཚེ་དང་ལྡན་པ་དག་བདག་གིས་ལྟུང་བྱེད་ཀྱི་ཆོས་དགུ་བཅུ་པོ་དག་བཏོན་ཟིན་ཏོ་༎
 tatrāham āyuṣmantaḥ pṛcchāmi -- kaccit sthātra pariśuddhāḥ	དེ་ལ་བདག་གིས་ཚེ་དང་ལྡན་པ་དག་ལ་། ཅི་འདི་ལ་ཁྱེད་ཡོངས་སུ་དག་གམ་ཞེས་དྲིའོ་༎ ཅི་འདི་ལ་ཁྱེད་ཡོངས་སུ་དག་གམ་ཞེས་ལན་གཉིས་ལན་གསུམ་དུ་དྲིའོ་༎
 pariśuddhā atrāyuṣmanto yasmāt tuṣṇīm evāhaṃ dhārayāmi | catvāraḥ pratideśanīyā dharmāḥ |	འདི་ལ་ཚེ་དང་ལྡན་པ་དག་ཡོངས་སུ་དག་ན་འདི་ལྟར་ཅང་མི་སྨྲ་བས་དེ་དེ་བཞིན་དུ་འཛིན་ཏོ་༎ སྡོམ་ལ་། གྲོང་དང་ཁྱིམ་གཞན་ཉིད་དང་ནི་༎ སློབ་པ་རྣམས་དང་དགོན་པ་ནི་༎ སངས་རྒྱས་ཕན་པ་གསུང་བ་ཡིས་༎ སོ་སོར་བཤགས་པར་བྱ་བར་གསུངས་༎
 ime khalv āyuṣmantaś catvāraḥ pratideśanīyā dharmā anvardhamāsaṃ prātimokṣasūtroddeśam āgacchanti | pratid|1 (prmosū_mū-banerjee)	ཚེ་དང་ལྡན་པ་དག་སོ་སོར་བཤགས་པར་བྱ་བའི་ཆོས་བཞི་པོ་འདི་དག་ནི་། ཟླ་བ་ཕྱེད་ཕྱེད་ཅིང་སོ་སོར་ཐར་པའི་མདོ་འདོན་པ་ལས་འབྱུང་ངོ་༎ ཡང་༄༢༥ཨ་༌༎
 yaḥ punar bhikṣur antagṛhaṃ piṇḍāya carantyā ajñātyā bhikṣuṇyāḥ santikāt sahastaṃ	དགེ་སློང་གང་དགེ་སློང་མ་ཉེ་དུ་མ་ཡིན་པ་ལམ་པོ་ཆེ་ན་འདུག་པ་།
 khādanīyabhojanīyaṃ pratigṛhya khāded vā bhuñjīta vā tena bhikṣuṇā bahirārāmaṃ gatvā	བསོད་སྙོམས་ཀྱི་ཕྱིར་གྲོང་དུ་འགྲོ་བ་ལས་བཅའ་བ་དང་། བཟའ་བ་རང་གི་ལག་གིས་བསླངས་ཏེ་འཆའ་འམ་ཟ་ན་། དགེ་སློང་དེས་ཕྱི་རོལ་ཀུན་དགའ་ར་བར་སོང་སྟེ་།
 bhikṣor antike pratideśayitavyam garhyam asmy āyuṣmantaḥ sthānam āpanno 'sātmyaṃ	དགེ་སློང་རྣམས་ལ་ཚེ་དང་ལྡན་པ་དག་བདག་ལ་སྨད་པའི་གནས་མི་རིགས་པ་སོ་སོར་བཤགས་པར་བྱ་བ་བྱུང་གིས་།
 pratideśanīyaṃ taṃ dharmaṃ pratideśayāmīti ayam api dharmaḥ pratideśanīyaḥ | pratid|2 (prmosū_mū-banerjee)	ཆོས་དེ་སོ་སོར་འཆགས་སོ་ཞེས་སོ་སོར་བཤགས་པར་བྱ་བ་སྟེ་། ཆོས་འདི་ནི་སོ་སོར་བཤགས་པར་བྱ་བའོ་༎
 saṃbahulā bhikṣavaḥ kuleṣu nimantritā bhuṃjīran tatra ced bhikṣuṇī vyapadeśamānā	དགེ་སློང་རབ་ཏུ་མང་པོ་དག་ཁྱིམ་རྣམས་སུ་མགྲོན་དུ་བོས་ནས་ཟན་ཟ་བའི་ཚེ་ན་།
 sthitā syād iha bhojanīyaṃ datta odanaṃ datta sūpaṃ datteti sā bhikṣuṇī bhikṣubhir	གལ་ཏེ་དགེ་སློང་མ་ཞིག་འདི་ལ་ནི་བཅའ་བ་བྱིན་ཅིག་། འདི་ལ་འབྲས་ཆན་བྱིན་ཅིག་། འདི་ལ་ནི་སྲན་ཚོད་བྱིན་ཅིག་། འདི་ལ་ནི་བཏུང་བ་བྱིན་ཅིག་། ཡང་བྱིན་ཅིག་ཅེས་བསྒོ་ཞིང་འདུག་ན་།
 evaṃ syād vacanīyā āgamayasva bhagini muhūrtaṃ yāvad bhikṣavo bhuṃjate |	དགེ་སློང་མ་དེ་ལ་དགེ་སློང་རྣམས་ཀྱིས་འདི་སྐད་ཅེས་སྲིང་མོ་ཁྱོད་དགེ་སློང་རྣམས་ཟན་ཟ་བའི་བར་དུ་རེ་ཞིག་སྡོད་ཅིག་ཅེས་བསྒོ་བར་བྱའོ་༎ 
 ekenāpi bhikṣuṇā cet tāṃ bhikṣuṇīm apasārayituṃ na vacanīyaṃ sarvair bhikṣubhiḥ bahirārāmaṃ	གལ་ཏེ་དགེ་སློང་གཅིག་གིས་ཀྱང་དགེ་སློང་མ་དེ་ལ་དེ་སྐད་སྨྲ་བ་མ་སྤོབས་བྱའོ་༎ ན་། དགེ་སློང་དེ་དག་ཐམས་ཅད་ཀྱིས་ཕྱི་རོལ་ཀུན་དགའ་རབ༹་བར་དོང་སྟེ་།
 gatvā bhikṣūṇām antike pratideśitavyaṃ garhyam āyuṣmantaḥ sthānam āpannā asātmyaṃ	དགེ་སློང་རྣམས་ལ་ཚེ་དང་ལྡན་པ་དག་བདག་ཅག་ལ་སྨད་པའི་གནས་མི་རིགས་པ་། སོ་སོར་བཤགས་པར་བྱ་བ་བྱུང་གིས་།
 pratideśanīyaṃ taṃ dharmaṃ pratideśayāma iti ayam api dharmaḥ pratideśanīyaḥ | pratid|3 (prmosū_mū-banerjee)	ཆོས་དེ་སོ་སོར་བཤགས་སོ་ཞེས་སོ་སོར་བཤགས་པར་བྱ་སྟེ་། ཆོས་འདི་ཡང་སོ་སོར་བཤགས་པར་བྱ་བའོ་༎
 yāni tāni kulāni śikṣāsaṃvṛtisaṃmatāni yaḥ punar bhikṣus tadrūpeṣu saṃghasya śaikṣeṣu	སློབ་པ་དག་གིས་ཁྱིམ་གང་དགེ་འདུན་གྱི་བསླབ་པའི་སྡོམ་པས་བསྡམས་པར་༄༢༥བ་གྱུར་ལ་།
 kuleṣu śikṣāsaṃvṛtisaṃmateṣu pūrvam apravāritasya khādanīyabhojanīyaṃ pratigṛhya	ཡང་དགེ་སློང་གང་སློབ་པ་དག་གིས་ཁྱིམ་གང་དགེ་འདུན་གྱི་བསླབ་པའི་སྡོམ་པས་བསྡམས་པ་དེ་ལྟ་བུ་དག་ཏུ་སྔར་མགྲོན་དུ་མ་བོས་པར་སོང་སྟེ་། 
 khāded bhuñjīta vā tena bhikṣuṇā bahirārāmaṃ gatvā bhikṣūṇām antike pratideśanīyaṃ	རང་གི་ལག་གིས་བཅའ་བ་དང་བཟའ་བ་བླངས་ནས་འཆའ་འམ་ཟ་ན་དགེ་སློང་དེས་ཕྱི་རོལ་ཀུན་དགའ་ར་བར་སོང་སྟེ་། དགེ་སློང་རྣམས་ལ་ཚེ་དང་ལྡན་པ་དག་བདག་ལ་སྨད་པའི་གནས་མི་རིགས་པ་།
 tat sthānam āpanno 'sātmyaṃ pratideśanīyaṃ taṃ dharmaṃ pratideśayāmīti ayam api dharmaḥ pratideśanīyaḥ | pratid|4 (prmosū_mū-banerjee)	སོ་སོར་བཤགས་པར་བྱ་བ་བྱུང་གིས་། ཆོས་དེ་སོ་སོར་བཤགས་སོ་ཞེས་སོ་སོར་བཤགས་པར་བྱ་སྟེ་། ཆོས་འདི་ཡང་སོ་སོར་བཤགས་པར་བྱའོ་༎
 yāni tāni kāni śayanāsanāni sāśaṃkasaṃmatāni sabhayasaṃmatāni sapratibhayabhairavasaṃmatāni	དགེ་འདུན་གྱི་གནས་མལ་དགོན་པ་གང་དག་དོགས་པ་དང་བཅས་པར་གྲགས་པ་། འཇིགས་པ་དང་བཅས་པར་གྲགས་པ་། འཇིགས་པ་ཐ་དད་པས་འཇིགས་སུ་རུང་བ་དང་བཅས་པར་གྲགས་པར་གྱུར་ལ་།
 yaḥ punar bhikṣus tadrūpeṣu saṃghasyāraṇyakeṣu śayaneṣu sāśaṃkasaṃmateṣu sabhayasaṃmateṣu	ཡང་དགེ་སློང་གང་དགེ་འདུན་གྱི་གནས་མལ་དགོན་པ་། གང་དག་དོགས་པ་དང་བཅས་པར་གྲགས་པ་། འཇིགས་པ་དང་བཅས་པར་གྲགས་པ་། འཇིགས་པ་ཐ་དད་པས་འཇིགས་སུ་རུང་བ་དང་བཅས་པར་གྲགས་པ་།
 sapratibhayabhairavasaṃmateṣu pūrvam apratisaṃvidyate vane bahirārāmasya khādanīyabhojanīyaṃ khāded bhuṃjīta vā tena bhikṣuṇā bhikṣūṇām antike pratideśayitavyaṃ garhyam asmy	དེ་ལྟ་བུ་དག་ཏུ་སྔར་མ་ཉུལ་བར་ཀུན་དགའ་ར་བར་ཕྱི་རོལ་ཏུ་བཅའ་བ་དང་། བཟའ་བ་བླངས་ཏེ་འཆའ་འམ་ཟ་ན་དགེ་སློང་དེས་ཕྱི་རོལ་ཀུན་དགའ་ར་བར་སོང་སྟེ་།
 āyuṣmantaḥ sthānam āpanno 'sātmyaṃ pratideśanīyaṃ taṃ dharmaṃ pratideśayāmīti ayam	དགེ་སློང་རྣམས་ལ་ཚེ་དང་ལྡན་པ་དག་བདག་ལ་སྨད་པའི་གནས་མི་རིགས་པ་། སོ་སོར་བཤགས་པར་བྱ་བ་བྱུང་གིས་། ཆོས་དེ་སོ་སོར་བཤགས་སོ་ཞེས་སོ་སོར་བཤགས་པར་བྱ་སྟེ་།
 api dharmaḥ pratideśanīyaḥ |	ཆོས་འདི་ཡང་སོ་སོར་བཤགས་པར་བྱ་བའོ་༎
 uddiṣṭā mayāyuṣmantaś catvāraḥ pratideśanīyā dharmāḥ |	ཚེ་དང་ལྡན་པ་དག་བདག་གིས་སོ་སོར་བཤགས་པར་བྱ་༄༢༦ཨ་༌༎ བའི་ཆོས་བཞི་པོ་དག་བཏོན་ཟིན་ཏོ་༎
 tatrāham āyuṣmantaḥ paripṛcchāmi -- kaccit sthātra pariśuddhāḥ	དེ་ལ་བདག་གིས་ཚེ་དང་ལྡན་པ་དག་ལ་། ཅི་འདི་ལ་ཁྱེད་ཡོངས་སུ་དག་གམ་ཞེས་དྲིའོ་༎
 dvir api trir api -- kaccit sthātra pariśuddhāḥ	ཅི་འདི་ལ་ཁྱེད་ཡོངས་སུ་དག་གམ་ཞེས་ལན་གཉིས་ལན་གསུམ་གྱི་བར་དུ་དྲིའོ་༎
 pariśuddhā āyuṣmanto yasmāt tūṣṇīm evam etad dhārayāmi |	འདི་ལ་ཚེ་དང་ལྡན་པ་དག་ཡོངས་སུ་དག་ན་འདི་ལྟར་ཅང་མི་སྨྲ་བས་དེ་དེ་བཞིན་དུ་འཛིན་ཏོ་༎ སྡོམ་ལ་། ཤམ་ཐབས་ལ་ནི་རྣམ་བདུན་དང་༎ སྟོད་ག-ཡོགས་ལ་ཡང་རྣམ་གསུམ་དང་༎ ཤིན་ཏུ་བསྡམས་ལ་སོགས་པ་ལྔ་༎ མགོ་ག-ཡོགས་ལ་སོགས་རྣམ་པ་ལྔ་༎ མཆོང་པ་ལ་སོགས་རྣམ་ལྔ་དང་༎ ལུས་ལ་སོགས་པ་རྣམ་པ་ལྔ་༎
 saṃbahulāḥ śaikṣā dharmāḥ |	འདུག་པར་བྱ་བ་དགུ་དག་དང་༎ བྱིན་ལེན་བྱ་བ་བརྒྱད་རྣམས་སོ་༎
 ime khalv āyuṣmantaḥ saṃbahulāḥ śaikṣā dharmā anvardhamāsaṃ prātimokṣasūtroddeśam āgacchanti | śai|1 (prmosū_mū-banerjee) parimaṇḍalaṃ nivāsanaṃ nivāsayiṣyāma iti śikṣā karaṇīyā | śai|2 (prmosū_mū-banerjee) nātyutkṛṣṭaṃ nivāsanaṃ nivāsayiṣyāma iti śikṣā karaṇīyā | śai|3 (prmosū_mū-banerjee) nātyavakṛṣṭaṃ nivāsanaṃ nivāsayiṣyāma iti śikṣā karaṇīyā | śai|4 (prmosū_mū-banerjee) na hastiśuṇḍakaṃ nivāsanaṃ nivāsayiṣyāma iti śikṣā karaṇīyā | śai|5 (prmosū_mū-banerjee) na tālapatraṃ nivāsanaṃ nivāsayiṣyāma iti śikṣā karaṇīyā | śai|6 (prmosū_mū-banerjee) na kulmāṣapiṇḍakaṃ nivāsanaṃ nivāsayiṣyāma iti śikṣā karaṇīyā | śai|7 (prmosū_mū-banerjee) na nāgaśīrṣakaṃ nivāsanaṃ nivāsayiṣyāma iti śikṣā karaṇīyā | śai|8 (prmosū_mū-banerjee)	ཚེ་དང་ལྡན་པ་དག་བསླབ་པའི་ཆོས་མང་པོ་འདི་དག་རྣམས་ནི་ཟླ་བ་ཕྱེད་ཕྱེད་ཅིང་སོ་སོར་ཐར་པའི་མདོ་འདོན་པ་ལས་འབྱུང་ངོ༏་༏ཤམ་ཐབས་ཟླུམ་པོར་བགོ་བར་བསླབ་པར་བྱ་། ཤམ་ཐབས་ཧ་ཅང་རྩེངས་པ་མ་ཡིན་པ་དང་། ཧ་ཅང་འཇོལ་བ་མ་ཡིན་པ་དང་། གླང་པོ་ཆེའི་སྣ་ལྟར་མ་ཡིན་པ་དང་། ཏ་ལའི་ལོ་མ་ལྟར་མ་ཡིན་པ་དང་། འབྲུའི་ཕུར་མ་ལྟར་མ་ཡིན་པ་དང་། སྦྲུལ་མགོའི་གདེངས་ཀ་ལྟར་མ་ཡིན་པར་བགོ་བར་བསླབ་པར་བྱའོ་༎
 parimaṇḍalaṃ cīvaraṃ nivāsayiṣyāma iti śikṣā karaṇīyā | śai|9 (prmosū_mū-banerjee)	ཆོས་གོས་ཟླུམ་པོར་བགོ་བར་བསླབ་པར་བྱའོ་༎
 nātyutkṛṣṭaṃ cīvaraṃ nivāsayiṣyāma iti śikṣā karaṇīyā | śai|10 (prmosū_mū-banerjee) nātyupakṛṣṭaṃ cīvaraṃ nivāsayiṣyāma iti śikṣā karaṇīyā | śai|11 (prmosū_mū-banerjee) susaṃvṛtā antargṛhe gamiṣyāma iti śikṣā karaṇīyā | śai|12 (prmosū_mū-banerjee)	ཆོས་གོས་ཧ་ཅང་རྩེངས་པ་མ་ཡིན་པ་དང་། ཧ་ཅང་འཇོལ་བ་མ་ཡིན་པར་བགོ་བར་བསླབ་པར་བྱའོ་༎
 supraticchannā antargṛhe gamiṣyāma iti śikṣā karaṇīyā | śai|13 (prmosū_mū-banerjee) alpaśabdā antargṛhe gamiṣyāma iti śikṣā karaṇīyā | śai|14 (prmosū_mū-banerjee)	ཤིན་ཏུ་བསྡམས་པ་དང་། ལེགས་པར་བགོས་པ་དང་། སྒྲ་སྐྱུངས་པ་དང་། མིག་ག-ཡེང་བར་མི་༄༢༦བ་བྱ་བ་དང་། གཉའ་ཤིང་གང་ཙམ་དུ་བལྟ་ཞིང་ཁྱིམ་གཞན་དག་ཏུ་འགྲོ་བར་བསླབ་པར་བྱའོ་༎
 anutkṣiptacakṣuṣo 'ntargṛhe gamiṣyāma iti śikṣā karaṇīyā | śai|15 (prmosū_mū-banerjee) yugamātradarśino 'ntargṛhe gamiṣyāma iti śikṣā karaṇīyā | śai|16 (prmosū_mū-banerjee) nodguṇṭhikā antargṛhaṃ gamiṣyāma iti śikṣā karaṇīyā | śai|17 (prmosū_mū-banerjee) notkṛṣṭikayā antargṛhaṃ gamiṣyāma iti śikṣā karaṇīyā | śai|18 (prmosū_mū-banerjee) notsaktikayā antargṛhaṃ gamiṣyāma iti śikṣā karaṇīyā | śai|19 (prmosū_mū-banerjee) na vyastikayā antargṛhaṃ gamiṣyāma iti śikṣā karaṇīyā | śai|20 (prmosū_mū-banerjee) na paryastikayā antargṛhaṃ gamiṣyāma iti śikṣā karaṇīyā | śai|21 (prmosū_mū-banerjee) nolambikayā antargṛhaṃ gamiṣyāma iti śikṣā karaṇīyā | śai|22 (prmosū_mū-banerjee) noṭṭambikayā antargṛhaṃ gamiṣyāma iti śikṣā karaṇīyā | śai|23 (prmosū_mū-banerjee) notkuṭakayā antargṛhaṃ gamiṣyāma iti śikṣā karaṇīyā | śai|24 (prmosū_mū-banerjee)	མགོ་མི་ག-ཡོགས་པ་དང་། མི་བརྫེ་བ་དང་། མི་གཟར་བ་དང་། གཉའ་གོང་དུ་མི་བསྣོལ་བ་དང་། ལྟག་པར་མི་བསྣོལ་བར་ཁྱིམ་གཞན་དུ་འགྲོ་བར་བསླབ་པར་བྱའོ་༎
 na nikaṭotkuṭakayā antargṛhaṃ gamiṣyāma iti śikṣā karaṇīyā | śai|25 (prmosū_mū-banerjee) na skambhākṛtā antargṛhaṃ gamiṣyāma iti śikṣā karaṇīyā | śai|26 (prmosū_mū-banerjee) na kāyapracālakaṃ antargṛhaṃ gamiṣyāma iti śikṣā karaṇīyā | śai|27 (prmosū_mū-banerjee) na bāhupracālakaṃ antargṛhaṃ gamiṣyāma iti śikṣā karaṇīyā | śai|28 (prmosū_mū-banerjee) na śīrṣapracālakaṃ gamiṣyāma iti śikṣā karaṇīyā | | śai|29 (prmosū_mū-banerjee)	མི་མཆོང་བ་དང་། མི་བརྐྱང་བ་དང་། ཙོག་པུར་མ་ཡིན་པ་དང་། བྲང་པས་མ་ཡིན་པ་དང་། དཀུར་མི་བརྟེན་པར་ཁྱིམ་གཞན་དུ་འགྲོ་བར་བསླབ་པར་བྱའོ་༎
 nāṃsotphatikayā antargṛhaṃ gamiṣyāma iti śikṣā karaṇīyā | śai|30 (prmosū_mū-banerjee) na hastasaṃlagnikayā antargṛhaṃ gamiṣyāma iti śikṣā karaṇīyā | śai|31 (prmosū_mū-banerjee) nānujñātā antargṛhe āsane niṣatsyāma iti śikṣā karaṇīyā | śai|32 (prmosū_mū-banerjee)	ལུས་མི་བསྒྱུར་བ་དང་། ལག་པ་མི་ཀྱོག་པ་དང་། མགོ་མི་བསྒྱུར་བ་དང་། ཕྲག་པ་མི་སྤྲད་པ་དང་། ལག་མི་སྦྲེལ་བར་ཁྱིམ་གཞན་དུ་འགྲོ་བར་བསླབ་པར་བྱའོ་༎
 nāprativekṣyāsanaṃ antargṛhe āsane niṣatsyāma iti śikṣā karaṇīyā | śai|33 (prmosū_mū-banerjee)	མ་བསྒོ་བར་ཁྱིམ་གཞན་དུ་སྟན་ལ་མི་འདུག་པར་བསླབ་པར་བྱ་།
 na sarvakāyaṃ samavadhāyāntargṛhe āsane niṣatsyāma iti śikṣā karaṇīyā | śai|34 (prmosū_mū-banerjee) na pāde pādam ādhāyāntargṛhe āsane niṣatsyāma iti śikṣā karaṇīyā | śai|35 (prmosū_mū-banerjee) na gulphe gulpham ādhāyāntargṛhe āsane niṣatsyāma iti śikṣā karaṇīyā | śai|36 (prmosū_mū-banerjee) na sakthani sakthi ādhāyāntargṛhe āsane niṣatsyāma iti śikṣā karaṇīyā | śai|37 (prmosū_mū-banerjee) na saṃkṣipya pādau antargṛhe āsane niṣatsyāma iti śikṣā karaṇīyā | śai|38 (prmosū_mū-banerjee) na vikṣipya pādau antargṛhe āsane niṣatsyāma iti śikṣā karaṇīyā | śai|39 (prmosū_mū-banerjee) na vyataṅgikayā antargṛhe āsane niṣatsyāma iti śikṣā karaṇīyā | śai|40 (prmosū_mū-banerjee)	སྟན་ལ་མ་བརྟགས་པ་དང་། ལུས་ཐམས་ཅད་ཀྱི་བརྗིད་ཀྱིས་མི་དབབ་པ་དང་། རྐང་པ་མི་བསྣོལ་བ་དང་། བརླ་མི་བསྣོལ་བ་དང་། ལོང་བུའི་སྟེང་དུ་ལོང་བུ་མི་བཞག་པ་དང་། རྐང་པ་མི་དགུག་པ་དང་། རྐང་པ་མི་གདང་བ་དང་། འདོམས་མི་སྣང་བར་ཁྱིམ་གཞན་དུ་སྟན་ལ་འདུག་པར་བསླབ་པར་བྱའོ་༎
 satkṛtya piṇḍapātaṃ pratigrahīṣyāma iti śikṣā karaṇīyā | śai|41 (prmosū_mū-banerjee) samatīrthikaṃ piṇḍapātaṃ pratigrahīṣyāma iti śikṣā karaṇīyā | śai|42 (prmosū_mū-banerjee) samasūpikaṃ piṇḍapātaṃ pratigrahīṣyāma iti śikṣā karaṇīyā | śai|43 (prmosū_mū-banerjee) sāvadānaṃ piṇḍapātaṃ pratigrahīṣyāma iti śikṣā karaṇīyā | śai|44 (prmosū_mū-banerjee)	ལེགས་པར་ཟས་བླང་བར་བསླབ་པར་བྱ་།
 na anāgate khādanīyabhojanīye pātram upanāmayiṣyāma iti śikṣā karaṇīyā | śai|45 (prmosū_mū-banerjee) nodanena sūpikaṃ praticchādayiṣyāma iti śikṣā karaṇīyā | śai|46 (prmosū_mū-banerjee) sūpikena vā odanaṃ bhūyaskāmatām upādāya iti śikṣā karaṇīyā | śai|47 (prmosū_mū-banerjee)	མུ་དང་ཁ་ད་ཆད་དུ་མ་ཡིན་པ་དང་། ཚོད་མ་དང་མཉམ་པར་མ་ཡིན་པ་དང་། མཐར་ཆགས་སུ་དང་། ལྷུང་བཟེད་ལ་ལྟ་བ་དང་། བཅའ་བ་དང་བཟའ་བ་མ་འོངས་པར་ལྷུང་བཟེད་མི་བཟེད་པ་དང་། ཡང་འདོད་པའི་ཕྱིར་འབྲས་ཆན་གྱིས་ཚོད་མ་མི་དགབ་།
 nopari khādanīyabhojanīyasya pātraṃ dhārayiṣyāma iti śikṣā karaṇīyā |	ཚོད་མས་འབྲས་ཆན་མི་དགབ་པ་དང་། བཅའ་བ་དང་བཟའ་བའི་སྟེང་དུ་ལྷུང་བཟེད་མི་གཟུང་བར་བསླབ་པར་༄༢༧ཨ་༌༎ བྱའོ་༎
 śai|48 (prmosū_mū-banerjee)	སྡོམ་ལ་། ཟས་ལ་ལེགས་པར་བྱ་བ་དྲུག་། ཙུག་ཙུག་ལ་སོགས་རྣམ་པ་ལྔ་། འབྲུ་ནས་ཐ་དད་བྱེད་པ་ལྔ་༎ ལག་པ་བལྡག་ལ་སོགས་པ་ལྔ་༎
 satkṛtya piṇḍapātaṃ paribhokṣyāma iti śikṣā karaṇīyā | śai|49 (prmosū_mū-banerjee) nātikhuṇḍakaṃ piṇḍapātaṃ paribhokṣyāma iti śikṣā karaṇīyā | śai|50 (prmosū_mū-banerjee) nātimahāntaṃ piṇḍapātaṃ paribhokṣyāma iti śikṣā karaṇīyā | śai|51 (prmosū_mū-banerjee) parimaṇḍalaṃ ālopam ālopayiṣyāma iti śikṣā karaṇīyā | śai|52 (prmosū_mū-banerjee) na anāgate ālope mukhadvāraṃ vivariṣyāma iti śikṣā karaṇīyā | śai|53 (prmosū_mū-banerjee) na sālopena mukhena vācaṃ pravyāhariṣyāma iti śikṣā karaṇīyā | śai|54 (prmosū_mū-banerjee) na cuccatkārakaṃ piṇḍapātaṃ paribhokṣyāma iti śikṣā karaṇīyā | śai|55 (prmosū_mū-banerjee) naśuśaśutkārakaṃ piṇḍapātaṃ paribhokṣyāma iti śikṣā karaṇīyā | śai|56 (prmosū_mū-banerjee) na thutyutkārakaṃ piṇḍapātaṃ paribhokṣyāma iti śikṣā karaṇīyā | śai|57 (prmosū_mū-banerjee)	ལེགས་པར་ཟས་བཟའ་བར་བསླབ་པར་བྱ་།
 na phuphphuphkārakaṃ piṇḍapātaṃ paribhokṣyāma iti śikṣā karaṇīyā | śai|58 (prmosū_mū-banerjee) na jihvāniścārakaṃ piṇḍapātaṃ paribhokṣyāma iti śikṣā karaṇīyā | śai|59 (prmosū_mū-banerjee) na sikthapṛthakkārakaṃ piṇḍapātaṃ paribhokṣyāma iti śikṣā karaṇīyā | śai|60 (prmosū_mū-banerjee) nāvaraṇakārakaṃ piṇḍapātaṃ paribhokṣyāma iti śikṣā karaṇīyā | śai|61 (prmosū_mū-banerjee) na gallāpahārakaṃ piṇḍapātaṃ paribhokṣyāma iti śikṣā karaṇīyā | śai|62 (prmosū_mū-banerjee)	ཁམ་ཧ་ཅང་ཆུང་བ་མ་ཡིན་པ་དང་། ཁམ་ཧ་ཅང་ཆེན་པོ་མ་ཡིན་པ་དང་། ཁམ་རན་པ་དང་། ཁམ་མ་གཟས་པར་ཁ་མི་གདང་པ་དང་། ཁ་ཁམ་གྱིས་བཀང་སྟེ་མི་སྨྲ་བར་བསླབ་པར་བྱའོ་༎
 na jihvāsphoṭakaṃ piṇḍapātaṃ paribhokṣyāma iti śikṣā karaṇīyā | śai|63 (prmosū_mū-banerjee)	ཙུག་ཙུག་མི་བྱ་བ་དང་། བལྕག་བལྕག་མི་བྱ་བ་དང་། ཧུ་ཧུ་མི་བྱ་བ་དང་། ཕུ་ཕུ་མི་བྱ་བ་དང་། ལྕེ་ཕྱུང་སྟེ་ཟས་མི་བཟའ་བར་བསླབ་པར་བྱའོ་༎
 na kavalacchedakaṃ piṇḍapātaṃ paribhokṣyāma iti śikṣā karaṇīyā | śai|64 (prmosū_mū-banerjee) na hastāvalehakaṃ piṇḍapātaṃ paribhokṣyāma iti śikṣā karaṇīyā | śai|65 (prmosū_mū-banerjee) na pātrāvalehakaṃ piṇḍapātaṃ paribhokṣyāma iti śikṣā karaṇīyā | śai|66 (prmosū_mū-banerjee) na hastasaṃdhūnakaṃ piṇḍapātaṃ paribhokṣyāma iti śikṣā karaṇīyā | śai|67 (prmosū_mū-banerjee)	འབྲུ་ནས་ཐ་དད་དུ་མི་བྱ་བ་དང་། ཕྱས་མི་གདགས་པ་དང་། མཁུར་བ་མི་སྤོ་བ་དང་། རྐན་མི་གཏོག་པ་དང་། ཁམ་འཕྲོར་མི་བཅད་པར་ཟས་བཟའ་བར་བསླབ་པར་བྱའོ་༎
 na pātrasaṃdhūnakaṃ piṇḍapātaṃ paribhokṣyāma iti śikṣā karaṇīyā | śai|68 (prmosū_mū-banerjee) na stūpākṛtim avagṛhya piṇḍapātaṃ paribhokṣyāma iti śikṣā karaṇīyā |	ལག་པ་མི་བལྡག་པ་དང་། ལྷུང་བཟེད་མི་བྱོག་*'byog?་པ་དང་། ལག་པ་མི་སྤྲུག་པ་དང་། ལྷུང་བཟེད་མི་སྐྱོམས་པ་དང་། མཆོད་རྟེན་འདྲ་བར་བཅོས་ཏེ་ཟས་མི་བཟའ་བར་བསླབ་པར་བྱའོ་༎
 śai|69 (prmosū_mū-banerjee)	སྡོམ་ལ་། འཕྱ་ལ་སོགས་པ་རྣམ་པ་བཞི་༎ ལྷུང་བཟེད་ལ་ཡང་རྣམ་པ་བཅུ་༎ འགྲེང་བར་བྱེད་ལ་སོགས་པ་ལྔ་༎ མགོ་ག-ཡོགས་ལ་སོགས་རྣམ་པ་ལྔ་༎ དོ་ཀེར་ཅན་ལ་སོགས་ལྔ་༎ གླང་ཆེན་ལ་སོགས་བཞོན་པ་ལྔ་༎ ལག་ན་འཁར་བ་ལ་སོགས་དྲུག་། ན་བ་རྣམ་པ་བཞི་རྣམས་སོ་༎
 nāvadhyānaprekṣiṇo 'ntarikasya bhikṣoḥ pātram avalokayiṣyāma iti śikṣā karaṇīyā | śai|70 (prmosū_mū-banerjee) na sāmiṣeṇa pāṇinā udakasthālakaṃ grahīṣyāma iti śikṣā karaṇīyā | śai|71 (prmosū_mū-banerjee)	དྲུང་ན་འདུག་པའི་དགེ་སློང་གི་ལྷུང་བཟེད་ལ་ཕྱས་གདགས་པའི་ཕྱིར་མི་བལྟ་བར་བསླབ་པར་བྱ་། ལག་པ་ཟས་དང་འབགས་པས་ཆུ་སྣོད་ལ་མི་བཟུང་བར་བསླབ་པར་བྱ་།
 na sāmiṣeṇodakenāntarikaṃ bhikṣuṃ sekṣyāma iti śikṣā karaṇīyā | śai|72 (prmosū_mū-banerjee)	དྲུང་ན་འདུག་༄༢༧བ་པའི་དགེ་སློང་ལ་ཟས་དང་འབགས་པའི་ཆུས་མི་གཏོར་བར་བསླབ་པར་བྱ་།
 na sāmiṣam udakam antargṛhe chorayiṣyāma iti śikṣā karaṇīyā | śai|73 (prmosū_mū-banerjee)	ཁྱིམ་པ་འདུག་པ་ལ་མ་དྲིས་པར་ཆུ་ཟས་དང་འབགས་པ་ཁྱིམ་གཞན་དུ་མི་དབོ་བར་བསླབ་པར་བྱའོ་༎ 
 na pātreṇa vighasaṃś chorayiṣyāma iti śikṣā karaṇīyā | śai|74 (prmosū_mū-banerjee)	ལྷུང་བཟེད་ཀྱི་ནང་དུ་ཟས་ཀྱི་ལྷག་མ་བླུགས་ཏེ་མི་དོར་བར་བསླབ་པར་བྱ་པར་བྱའོ་༎ 
 anāstīrṇe pṛthivīpradeśe pātraṃ sthāpayiṣyāma iti śikṣā karaṇīyā | śai|75 (prmosū_mū-banerjee)	། འོག་གཞི་མེད་པའི་ས་ཕྱོགས་སུ་ལྷུང་བཟེད་མི་བཞག་པར་བསླབ་པར་བྱ་།
 na taṭe na prapāte na prāgbhāre pātraṃ sthāpayiṣyāma iti śikṣā karaṇīyā | śai|76 (prmosū_mū-banerjee)	གད་ཀ་མ་ཡིན་པ་དང་། ག-ཡང་ས་མ་ཡིན་པ་དང་། དཀན་གཟར་པོ་མ་ཡིན་པར་ལྷུང་བཟེད་བཞག་པར་བསླབ་པར་བྱ་།
 notthitāḥ pātraṃ nirmādayiṣyāma iti śikṣā karaṇīyā | śai|77 (prmosū_mū-banerjee)	འགྲེང་སྟེ་ལྷུང་བཟེད་མི་བཀྲུ་བར་བསླབ་པར་བྱ་།
 na taṭe na prapāte na prāgbhāre pātraṃ nirmādayiṣyāma iti śikṣā karaṇīyā | śai|78 (prmosū_mū-banerjee)	གད་ཀ་མ་ཡིན་པ་དང་། ག-ཡང་ས་མ་ཡིན་པ་དང་། དཀན་གཟར་པོ་མ་ཡིན་པར་ལྷུང་བཟེད་བཀྲུ་བར་བསླབ་པར་བྱ་།
 na nadyāḥ kāryakāriṇyā pratisrotaḥ pātrodakaṃ grahīṣyāma iti śikṣā karaṇīyā | śai|79 (prmosū_mū-banerjee)	འབབ་ཆུ་དྲག་པོའི་རྒྱུན་ལས་བཟློག་སྟེ་ལྷུང་བཟེད་ཀྱིས་ཆུ་མི་བཅུ་བར་བསླབ་པར་བྱའོ་༎
 na utthitā niṣaṇṇāyāglānāya dharmaṃ deśayiṣyāma iti śikṣā karaṇīyā | śai|80 (prmosū_mū-banerjee)	མི་ན་བར་འདུག་པ་ལ་འགྲེང་སྟེ་ཆོས་མི་བཤད་པར་བསླབ་པར་བྱ་།
 na niṣaṇṇā nipaṇṇāyāglānāya dharmaṃ deśayiṣyāma iti śikṣā karaṇīyā | śai|81 (prmosū_mū-banerjee)	མི་ན་བར་ཉལ་བ་ལ་འདུག་སྟེ་ཆོས་མི་བཤད་པར་བསླབ་པར་བྱ་།
 na nīcatarake āsane niṣaṇṇā uccatarake āsane niṣaṇṇāyāglānāya dharmaṃ deśayiṣyāma iti śikṣā karaṇīyā | śai|82 (prmosū_mū-banerjee)	མི་ན་བར་སྟན་མཐོན་པོ་ལ་འདུག་པ་ལ་སྟན་དམའ་བ་ལ་འདུག་སྟེ་ཆོས་མི་བཤད་པར་བསླབ་པར་བྱ་། 
 na pṛṣṭhato gacchantaḥ purato gacchate aglānāya dharmaṃ deśayiṣyāma iti śikṣā karaṇīyā | śai|83 (prmosū_mū-banerjee)	མི་ན་བར་མདུན་དུ་འགྲོ་བ་ལ་ཕྱི་ནས་འགྲོ་ཞིང་ཆོས་མི་བཤད་པར་བསླབ་པར་བྱ་། བསླབ་པར་བྱ་། 
 nonmārgeṇa gacchanto mārgeṇa gacchate āglānāya dharmaṃ deśayiṣyāma iti śikṣā karaṇīyā | śai|84 (prmosū_mū-banerjee) nodguṇṭhikākṛtāyāglānāya dharmaṃ deśayiṣyāma iti śikṣā karaṇīyā | śai|85 (prmosū_mū-banerjee) notkṛṣṭikākṛtāyāglānāya dharmaṃ deśayiṣyāma iti śikṣā karaṇīyā | śai|86 (prmosū_mū-banerjee) notsaktikākṛtāyāglānāya dharmaṃ deśayiṣyāma iti śikṣā karaṇīyā | śai|87 (prmosū_mū-banerjee) na vyastikākṛtāyāglānāya dharmaṃ deśayiṣyāma iti śikṣā karaṇīyā | śai|88 (prmosū_mū-banerjee) na paryastikākṛtāyāglānāya dharmaṃ deśayiṣyāma iti śikṣā karaṇīyā | śai|89 (prmosū_mū-banerjee)	མི་ན་བར་ལམ་ནས་འགྲོ་བ་ལམ་གྱི་འགྲམ་ནས་འགྲོ་ཞིང་ཆོས་མི་བཤད་པར་བསླབ་པར་བྱའོ་༎
 noṣṇīṣaśirase āglānāya dharmaṃ deśayiṣyāma iti śikṣā karaṇīyā | śai|90 (prmosū_mū-banerjee)	མི་ན་བར་མགོ་ག-ཡོགས་པ་དང་། བརྫེས་པ་དང་། གཟར་བ་དང་། གཉའ་གོང་དུ་བསྣོལ་བ་དང་། ལྟག་པར་བསྣོལ་བ་ལ་ཆོས་མི་བཤད་པར་བསླབ་པར་བྱའོ་༎
 na kholāśirase āglānāya dharmaṃ deśayiṣyāma iti śikṣā karaṇīyā | śai|91 (prmosū_mū-banerjee)	མི་ན་བར་སྐྲ་དོ་ཀེར་ཅན་དང་། ཞབ༹་གྱོན་པ་དང་། མགོ་ཅོད་པན་ཅན་དང་། ༄༢༨ཨ་༌༎ མགོ་ཕྲེང་བ་ཅན་དང་། མགོ་དཀྲིས་པ་ལ་ཆོས་མི་བཤད་པར་བསླབ་པར་བྱའོ་༎
 na mauliśirase āglānāya dharmaṃ deśayiṣyāma iti śikṣā karaṇīyā | śai|92 (prmosū_mū-banerjee) na mālāśirase āglānāya dharmaṃ deśayiṣyāma iti śikṣā karaṇīyā | śai|93 (prmosū_mū-banerjee) na veṣṭitaśirase āglānāya dharmaṃ deśayiṣyāma iti śikṣā karaṇīyā | śai|94 (prmosū_mū-banerjee) na hastyārūḍhāya āglānāya dharmaṃ deśayiṣyāma iti śikṣā karaṇīyā | śai|95 (prmosū_mū-banerjee) na aśvārūḍhāya āglānāya dharmaṃ deśayiṣyāma iti śikṣā karaṇīyā | śai|96 (prmosū_mū-banerjee) na śivikārūḍhāya āglānāya dharmaṃ deśayiṣyāma iti śikṣā karaṇīyā | śai|97 (prmosū_mū-banerjee) na yānāruḍhāya āglānāya dharmaṃ deśayiṣyāma iti śikṣā karaṇīyā | śai|98 (prmosū_mū-banerjee) na pādukārūḍhāya āglānāya dharmaṃ deśayiṣyāma iti śikṣā karaṇīyā | śai|99 (prmosū_mū-banerjee) na daṇḍapāṇaye āglānāya dharmaṃ deśayiṣyāma iti śikṣā karaṇīyā | śai|100 (prmosū_mū-banerjee) na chatrapāṇaye āglānāya dharmaṃ deśayiṣyāma iti śikṣā karaṇīyā | śai|101 (prmosū_mū-banerjee) na śastrapāṇaye āglānāya dharmaṃ deśayiṣyāma iti śikṣā karaṇīyā | śai|102 (prmosū_mū-banerjee)	མི་ན་བར་གླང་པོ་ཆེ་ཞོན་པ་དང་། རྟ་ཞོན་པ་དང་། ཁྱོགས་ན་འདུག་པ་དང་། ཞོན་པའི་སྟེང་ན་འདུག་པ་དང་། མཆིལ་ལྷམ་གྱོན་པ་ལ་ཆོས་མི་བཤད་པར་བསླབ་པར་བྱའོ་༎
 na khaḍgapāṇaye āglānāya dharmaṃ deśayiṣyāma iti śikṣā karaṇīyā | śai|103 (prmosū_mū-banerjee) nāyudhapāṇaye āglānāya dharmaṃ deśayiṣyāma iti śikṣā karaṇīyā | śai|104 (prmosū_mū-banerjee) saṃnaddhāyāglānāya dharmaṃ deśayiṣyāma iti śikṣā karaṇīyā | śai|105 (prmosū_mū-banerjee)	མི་ན་བར་ལག་ན་འཁར་བ་ཐོགས་པ་དང་། ལག་ན་གདུགས་ཐོགས་པ་དང་། ལག་ན་མཚོན་ཐོགས་པ་དང་། ལག་ན་རལ་གྲི་ཐོགས་པ་དང་། ལག་ན་དགྲ་ཆ་ཐོགས་པ་དང་། གོ་ཆ་གྱོན་པ་ལ་ཆོས་མི་བཤད་པར་བསླབ་པར་བྱའོ་༎
 nāglānā utthitā uccāraprasrāvaṃ kariṣyāma iti śikṣā karaṇīyā | śai|106 (prmosū_mū-banerjee)	མི་ན་བར་འགྲེང་སྟེ་བཤང་གཅི་མི་བྱ་བར་བསླབ་པར་བྱ་།
 nāglānāḥ udake uccāraprasrāvaṃ kheṭaṃ siṃghāṇakaṃ vāntaṃ viriktaṃ chorayiṣyāma iti śikṣā karaṇīyā | śai|107 (prmosū_mū-banerjee)	མི་ན་བར་ཆུའི་ནང་དུ་བཤང་གཅི་དང་། མཆིལ་མ་དང་། སྣབས་དང་། སྐྱུགས་པ་དང་། རླུགས་པ་མི་དོར་བར་བསླབ་པར་བྱ་།
 nāglānā saharite pṛthivīpradeśe uccāraprasrāvaṃ kheṭaṃ siṃghāṇakaṃ vāntaṃ viriktaṃ chorayiṣyāma iti śikṣā karaṇīyā | śai|108 (prmosū_mū-banerjee)	མི་ན་བར་རཙབ༹་སྔོན་པོ་ཡོད་པའི་ས་ཕྱོགས་སུ་བཤང་གཅི་དང་། མཆིལ་མ་དང༏་སྣབས་དང་། སྐྱུགས་པ་དང་། རླུགས་པ་མི་དོར་བར་བསླབ་པར་བྱ་།
 nāsādhikapauruṣaṃ vṛkṣam adhirokṣyāmo 'nyatrāpada iti śikṣā karaṇīyā | uddiṣṭā me āyuṣmantaḥ saṃbahulāḥ śaikṣā dharmāḥ |	གནོད་པ་བྱུང་བ་མ་གཏོགས་པ་ཤིང་ལ་མི་གང་ཙམ་ལས་མཐོར་མི་འཛེག་པར་བསླབ་པར་བྱའོ་༎ ཚེ་དང་ལྡན་པ་དག་བདག་གིས་བསླབ་པའི་ཆོས་མང་པོ་རྣམས་བཏོན་ཟིན་ཏོ་༎
 tatrāham āyuṣmataḥ paripṛcchāmi -- kaccit sthātra pariśuddāḥ	དེ་ལ་ཚེ་དང་ལྡན་པ་དག་ཅི་འདི་ལ་ཁྱེད་ཡོངས་སུ་དག་གམ་ཞེས་དྲིའོ་༎
 dvir api trir api paripṛcchāmi -- kaccit sthātra pariśuddhāḥ	ཅི་འདི་ལ་ཁྱེད་ཡོངས་སུ་དག་གམ་ཞེས་ལན་གཉིས་ལན་གསུམ་དུ་དྲིའོ་༎
 pariśuddhā āyuṣmanto yasmāt tūṣṇīm evam etad dhārayāmi ||	འདི་ལ་ཚེ་དང་ལྡན་པ་དག་ཡོངས་སུ་དག་ན་འདི་ལྟར་ཅང་མི་སྨྲ་བས་དེ་དེ་བཞིན་དུ་འཛིན་ཏོ་༎ 
 sapta adhikaraṇaśamathā dharmāḥ	སྡོམ་ལ་། མངོན་སུམ་དྲན་པ་མ་མྱོས་དང་༎ དེ་བཞིན་༄༢༨བ་གང་མང་ངོ་བོ་ཉིད་༎ རཙབ༹་རྣམས་བཀྲམ་པ་ལྟ་བུ་དང་༎ ཁས་བླང་པར་ཡང་བྱ་བའོ་༎
 ime khalv āyuṣmantaḥ saptādhikaraṇaśamathāḥ dharmā anvardhamāsaṃ prātimokṣasūtroddeśam āgacchanti |	ཚེ་དང་ལྡན་པ་དག་རྩོད་པ་ཞི་བར་བྱ་བའི་ཆོས་བདུན་པོ་འདི་དག་ནི་། ཟླ་བ་ཕྱེད་ཕྱེད་ཅིང་སོ་སོར་ཐར་པའི་མདོ་འདོན་པ་ལས་འབྱུང་ངོ་༎
 saṃmukhavinayārhāya saṃmukhavinayaṃ dāsyāmaḥ |	མངོན་སུམ་གྱིས་འདུལ་བར་འོས་པ་ལ་མངོན་སུམ་གྱིས་འདུལ་བ་སྦྱིན་ནོ་༎
 smṛtivinayārhāya smṛtivinayaṃ dāsyāmaḥ |	དྲན་པས་འདུལ་བར་འོས་པ་ལ་དྲན་པས་འདུལ་བ་སྦྱིན་ནོ་༎
 amūḍhavinayārhāya amūḍhavinayaṃ dāsyāmaḥ |	མ་མྱོས་པས་འདུལ་བར་འོས་པ་ལ་མ་མྱོས་པས་འདུལ་བ་སྦྱིན་ནོ་༎
 yadbhūyeṣiyārhāya yadbhūyeṣiyaṃ dāsyāmaḥ |	གང་ཚུལ་ཤིང་མང་པོ་སྦྱིན་པར་འོས་པ་ལ་ཚུལ་ཤིང་མང་པོ་སྦྱིན་ནོ་༎
 tatsvabhāveṣiyārhāya tatsvabhāveṣiyaṃ dāsyāmaḥ |	དེའི་ངོ་བོ་ཉིད་ཚོལ་དུ་གཞུག་པར་འོས་པ་ལ་དེའི་ངོ་བོ་ཉིད་བཙལ་བ་སྦྱིན་ནོ་༎
 tṛṇaprastārakārhāya tṛṇaprastārakaṃ dāsyāmaḥ | pratijñākārakārhāya pratijñāṃ dāsyāmaḥ |	རཙབ༹་བཀྲམ་པ་ལྟ་བུ་འོས་པ་ལ་རཙབ༹་བཀྲམ་པ་ལྟ་བུ་སྦྱིན་ནོ་༎ གང་ཁས་བླང་བར་འོས་པ་ལ་ཁས་བླང་པ་སྦྱིན་པར་བྱའོ་༎
 utpannotpannāny adhikaraṇāny ebhiḥ saptabhir adhikaraṇaśamathair dharmair dāpayiṣyāmaḥ śamayiṣyāmo vyupaśamayiṣyāmo dharmavinaye śāstuḥ śāsane	རྩོད་པ་བྱུང་བར་གྱུར་པ་རྣམས་རྩོད་པ་ཞི་བར་བྱ་བའི་ཆོས་བདུན་པོ་འདི་དག་གིས་ཆོས་དང་། འདུལ་བ་དང་། སྟོན་པའི་བསྟན་པ་བཞིན་དུ་དུལ་བར་བྱ་། ཞི་བར་བྱ་། རྣམ་པར་ཞི་བར་བྱའོ་༎
 uddiṣṭā me āyuṣmantaḥ saptādhikaraṇaśamathā dharmāḥ | tatrāham āyuṣmataḥ paripṛcchāmi -- kaccit sthātra pariśuddhāḥ	ཚེ་དང་ལྡན་པ་དག་བདག་གིས་རྩོད་པ་ཞི་བར་བྱ་བའི་ཆོས་བདུན་པོ་དག་བཏོན་ཟིན་ཏོ་༎ དེ་ལ་བདག་གིས་ཚེ་དང་ལྡན་པ་དག་ལ་ཅི་འདི་ལ་ཁྱེད་ཡོངས་སུ་དག་གམ་ཞེས་༎ དྲིའོ་༎ 
 dvir api trir api paripṛcchāmi -- kaccit sthātra pariśuddhāḥ |	ཅི་འདི་ལ་ཁྱེད་ཡོངས་སུ་དག་གམ་ཞེས་ལན་གཉིས་ལན་གསུམ་དུ་དྲིའོ་༎
 pariśuddhā āyuṣmanto yasmāt tūṣṇīm evam evāhaṃ dhārayāmi | for the prose and verses see klaus t| schmidt: der schlußteil des prātimokṣasūtra der sarvāstivādins, text in sanskrit und tocharisch a verglichen mit den parallelversionen anderer schulen, auf grund von turfan-handschriften hrsg|, göttingen 1989 (sanskrittexte aus den turfanfunden, 13)|	འདི་ལ་ཚེ་དང་ལྡན་པ་དག་ཡོངས་སུ་དག་ན་། འདི་ལྟར་ཅང་མི་སྨྲ་བས་དེ་དེ་བཞིན་དུ་འཛིན་ཏོ་༎
 uddiṣṭaṃ me āyuṣmantaḥ prātimokṣasūtroddeśasya nidānaṃ ||	ཚེ་དང་ལྡན་པ་དག་བདག་གིས་སོ་སོར་ཐར་པའི་མདོ་གདོན་པའི་གླེང་གཞི་བཏོན་ཟིན་ཏོ་༎
 uddiṣṭāś catvāraḥ pārājikā dharmās trayodaśa saṃghāvaśeṣā dharmā dvāv aniyatau dharmau |	ཕམ་པར་གྱུར་པའི་ཆོས་བཞི་དང་། དགེ་འདུན་ལྷག་མའི་༄༢༩ཨ་༌༎
 triṃśan naiḥsargikapāyantikā dharmāḥ navati pāyantikā dharmāś catvāraḥ pratideśanīyā	ཆོས་བཅུ་གསུམ་དང་། མ་ངེས་པའི་ཆོས་གཉིས་དང་། སྤང་བའི་ལྟུང་བྱེད་ཀྱི་ཆོས་སུམ་ཅུ་དང་། ལྟུང་བྱེད་ཀྱི་ཆོས་དགུ་བཅུ་དང་། སོ་སོར་བཤགས་པར་བྱ་བའི་ཆོས་བཞི་དང་། བསླབ་པའི་ཆོས་མང་པོ་བརྒྱ་རྩ་བཅུ་གཉིས་།
 dharmāḥ saṃbahulā śaikṣā dharmāḥ saptādhikaraṇaśamathā dharmā etāvat tasya bhagavatas	རྩོད་པ་ཞི་བར་བྱ་བའི་ཆོས་བདུན་པོ་དག་བཏོན་ཟིན་ཏོ་༎
 tathāgatasyārhataḥ samyaksaṃbuddhasya sūtragataṃ sūtraparyāpannam iti yo vā punar	བཅོམ་ལྡན་འདས་དེ་བཞིན་གཤེགས་པ་དགྲ་བཅོམ་པ་ཡང་དག་པར་རྫོགས་པའི་སངས་རྒྱས་དེའི་མདོར་གཏོགས་ཤིང་། མདོར་བསྡུས་པ་ནི་འདི་དག་གོ་།
 anyo 'py āgacched dharmasyānudharmaḥ tatra sahitaiḥ samagraiḥ saṃmodamānair avivadamānais	གང་གཞན་ནས་འབྱུང་བ་ཆོས་ཀྱི་རྗེས་སུ་མཐུན་པའི་ཆོས་དེ་ལ་ཡང་།
 tīvraś cetasa ārakṣāsmṛtyapramāde yogaḥ karaṇīyaḥ || ||	ཁྱེད་རྣམས་འདུན་པ་དང་། མཐུན་པ་དང་། དགའ་བ་དང་། མི་རྩོད་པར་སེམས་ཀུན་ཏུ་བསྲུང་བ་དང་། དྲན་པ་དང་། བག་ཡོད་པས་རྣལ་འབྱོར་དུ་བྱའོ་༎
 kṣāntiḥ paramaṃ tapas titikṣā nirvāṇaṃ paramaṃ vadanti buddhāḥ |	བཟོད་པ་དཀའ་ཐུབ་དམ་པ་བཟོད་པ་ནི་༎ མྱ་ངན་འདས་པ་མཆོག་ཅེས་སངས་རྒྱས་གསུང་༎
 na hi pravrajitaḥ paropatāpī śramaṇo bhavati parān viheṭhayānaḥ || 1	རབ་ཏུ་བྱུང་བ་གཞན་ལ་གནོད་པ་དང་༎ གཞན་ལ་འཚེ་བ་དགེ་སྦྱོང་མ་ཡིན་ནོ་༎ མིག་ལྡན་འགྲོ་བ་ཡོད་པ་ཡིས་༎
 cakṣuṣmān viṣamāṇīva vidyamāne parākrame |	ཉམ་ང་བ་དག་ཇི་བཞིན་དུ་༎
 paṇḍito jīvaloke 'smin pāpāni parivarjayet || 2	མཁས་པས་འཚོ་བའི་འཇིག་རྟེན་འདིར་༎ སྡིག་པ་དག་ནི་ཡོངས་སུ་སྤོང་༎ སྐུར་པ་མི་གདབ་གནོད་མི་བྱ་༎
 anopavādī nopaghātī prātimokṣe ca saṃvaraḥ {b: anupavādo 'nupaghātaḥ} |	སོ་སོར་ཐར་པའང་བསྡམ་པར་བྱ་༎
 mātrajñatā ca bhakte 'smin prāntaṃ ca śayanāsanam*	ཟས་ཀྱི་ཚོང་ཀྱང་རིག་པར་བྱ་༎ བས་མཐའི་གནས་སུ་གནས་པར་བྱ་༎
 adhicitte samāyoga etad buddhānuśāsanam* || 3	ལྷག་པའི་སེམས་ལ་ཡང་དག་སྦྱར་༎ འདི་ནི་སངས་རྒྱས་བསྟན་པ་ཡིན་༎
 yathāpi bhramaraḥ puṣpād varṇagandhāv aheṭhayan* [yathā hi] |	ཇི་ལྟར་བུང་བ་མེ་ཏོག་ལས་༎ ཁ་དོག་དྲིལ་མི་གནོང་པར་༎ ཁུ་བ་བཞིབས་ནས་འཕུར་བ་ལྟར་༎
 ḍayate rasam ādāya evaṃ grāme muniś caret* || 4	དེ་བཞིན་ཐུབ་པ་གྲོང་དུ་རྒྱུ་༎ བདག་གི་རིགས་དང་མི་རིགས་ལ་། ༄༢༩བ་བརྟག་པར་བྱ་སྟེ་གཞན་རྣམས་ཀྱི་༎ མི་མཐུན་པ་དང་གཞན་དག་གི་།
 na pareṣāṃ vilomāni na pareṣāṃ kṛtākṛtam* | ātmanas tu samīkṣeta samāni viṣamāṇi ca || 5	བྱས་དང་མ་བྱས་རྣམས་ལ་མིན་༎
 adhicetasi mā pramādyato munino maunapadeṣu śikṣataḥ {b: prāmodyato; maunipadeṣu} |	ལྷག་པའི་སེམས་ལ་བག་བྱ་སྟེ་༎ ཐུབ་པའི་ཐུབ་གཞི་རྣམས་ལ་བསླབ་༎
 śokā na bhavanti tāyina upaśāntasya sadā smṛtimataḥ || 6	ཉེར་ཞི་རྟག་ཏུ་དྲན་པ་ཡི་༎ སྐྱོབ་པ་མྱ་ངན་མེད་པ་ཡིན་༎
 dadataḥ puṇyaṃ pravardhate vairaṃ saṃyamato na cīyate |	སྦྱིན་པས་བསོད་ནམས་རབ་ཏུ་འཕེལ་༎ ལེགས་བསྡམས་དགྲ་སོགས་མི་འགྱུར་རོ་༎
 kuśalī prajahāti pāpakaṃ kleśānāṃ kṣayatas tu nirvṛtiḥ {b: kṣayitas} || 7	དགེ་དང་ལྡན་པས་སྡིག་པ་སྤོང་༎ ཉོན་མོངས་ཟད་པས་མྱ་ངན་འདའ༎
 sarvapāpasyākaraṇaṃ kuśalasyopasaṃpadā |	སྡིག་པ་ཐམས་ཅད་མི་བྱ་སྟེ་༎ དགེ་བ་ཕུན་སུམ་ཚོགས་པར་སྤྱད་༎
 svacittaparidamanam etad buddhānuśāsanam* || 8	རང་གི་སེམས་ནི་ཡོངས་སུ་འདུལ་༎ འདི་ནི་སངས་རྒྱས་བསྟན་པ་ཡིན་༎
 kāyena saṃvaraḥ sādhu sādhu vācātha saṃvaraḥ {b: vācā ca} |	ལུས་ཀྱི་སྡོམ་པ་ལེགས་པ་སྟེ་༎ ངག་གི་སྡོམ་པའང་ལེགས་པ་ཡིན་༎
 manasā saṃvaraḥ sādhu sādhu sarvatra saṃvaraḥ |	ཡིད་ཀྱི་སྡོམ་པ་ལེགས་པ་སྟེ་༎ ཐམས་ཅད་དུ་ནི་སྡོམ་པ་ལེགས་༎
 sarvatra saṃvṛto bhikṣuḥ sarvaduḥkhāt pramucyate || 9	ཀུན་ཏུ་བསྡམས་པའི་དགེ་སློང་ནི་༎ སྡུག་བསྔལ་ཀུན་ལས་རབ་ཏུ་གྲོལ་༎
 vācānurakṣī manasā susaṃvṛtaḥ kāyena caivākuśalaṃ na kuryāt* |	ངག་རྣམས་བསྲུང་ཞིང་ཡིད་ཀྱིས་རབ་བསྡམས་ཏེ་༎ ལུས་ཀྱི་མི་དགེ་བདག་མི་བྱེད་ཅིང་༎
 etāṃs trīn karmapathān viśodhya nārāgayen mārgam ṛṣipraveditam* || 10	ལས་ལམ་གསུམ་པོ་འདི་དག་རབ་སྦྱངས་ན་༎ དྲང་སྲོང་གསུངས་པའི་ལམ་མི་འཐོབ་པར་འགྱུར་༎ སངས་རྒྱས་རྣམ་གཟིགས་གཙུག་ཏོར་ཐམས་ཅད་སྐྱོབ་༎
 buddho vipaśyī ca śikhī ca viśvabhu krakutsundaḥ kanakamuniś ca kāśyapaḥ {b:	འཁོར་བ་འཇིག་དང་གསེར་ཐུབ་འོད་སྲུང་དང་༎ ཤའཀྱ་ཐུབ་པ་གོའུ་ཏ་མ་ལྷ་ཡི་ལྷ་༎ མི་འདུལ་ཁ་ལོ་སྒྱུར་བ་བླ་ན་མེད་༎
 krakutsandaḥ} | anuttaraḥ śākyamuniś ca gautamo devātidevo naradamyasārathiḥ || 11 saptānāṃ buddhavīrāṇāṃ lokanāthāgratāyināṃ |	འཇིག་རྟེན་མགོན་པོ་སྐྱོབ་པ་མཆོག་། སངས་རྒྱས་དཔའ་བོ་བདུན་པོ་དག་།
 uddiṣṭaḥ prātimokṣo 'yaṃ vistareṇa yaśasvinām* || 12	གྲགས་ལྡན་རྣམས་ཀྱི་སོ་སོར་ཐར་༎ འདི་ནི་རབ་ཏུ་རྒྱས་པར་བཏོན་༎
 asmin sagauravā buddhā buddhānāṃ śrāvakāś ca ye |	འདི་ལ་སངས་རྒྱས་རྣམས་དང་གང་༎ སངས་རྒྱས་ཉན་ཐོས་རྣམས་ཀྱང་གུས་༎ འདི་ལ་གུས་དང་བཅས་གྱུར་པས་༎
 asmin sagauravā bhūtvā prāpnumadhvam asaṃskṛtam* {b: prāptamadhvam} || 13	འདུས་མ་བྱས་པ་ཐོབ་པར་༄༣༠ཨ་༌༎ གྱིས་༎ བརྩམ་པར་བྱ་ཞིང་འབྱུང་བར་བྱ་༎
 ārabhadhvaṃ niṣkrāmata yujyadhvaṃ buddhaśāsane |	སངས་རྒྱས་བསྟན་ལ་འཇུག་པར་བྱ་༎
 dhunīta mṛtyunaḥ sainyaṃ naḍāgāram iva kuñjaraḥ || 14	འདམ་བུའི་ཁྱིམ་ན་གླང་ཆེན་བཞིན་༎ འཆི་བདག་སྡེ་ནི་གཞོམ་པར་བྱ་༎
 yo hy asmin dharmavinaye apramattaś cariṣyati |	གང་ཞིག་རབ་ཏུ་བག་ཡོད་པར་༎ ཆོས་འདུལ་འདི་ལ་སྤྱོད་གྱུར་པ་༎
 prahāya jātisaṃsāraṃ duḥkhasyāntaṃ kariṣyati || 15	སྐྱེ་བའི་འཁོར་བ་རབ་སྤངས་ནས་༎ སྡུག་བསྔལ་ཐ་མར་བྱེད་པར་འགྱུར་༎
 anyonyaṃ śīlaguptyarhaṃ śāsanasya ca vṛddhaye |	ཕན་ཚུན་ཚུལ་ཁྲིམས་བསྲུང་བ་དང་༎ བསྟན་པ་འཕེལ་བར་བྱ་བའི་ཕྱིར་༎
 uddiṣṭaḥ prātimokṣo 'yaṃ kṛtaḥ saṃghena poṣadhaḥ || 16	སོ་སོར་ཐར་པ་འདི་བཏོན་པས་༎ དགེ་འདུན་གྱིས་ནི་གསོ་སྦྱོང་བྱས་༎
 yasyārthe sūtram uddiṣṭaṃ yasyārthe poṣadhaḥ kṛtaḥ |	གང་གི་ཕྱིར་ནི་མདོ་བཏོན་དང་༎ གང་ཕྱིར་གསོ་སྦྱོང་བྱས་གྱུར་པ་༎
 tac chīlam anurakṣadhvaṃ bālāgraṃ camaro yathā || 17	ཚུལ་ཁྲིམས་དེ་ནི་བསྲུང་བྱ་སྟེ་༎ ག-ཡག་རྔའི་རྩེ་མོ་ཇི་བཞིན་ནོ་༎
 prātimokṣasamuddeśād yat puṇyaṃ samupārjitaṃ |	སོ་སོར་ཐར་པ་བཏོན་པ་ཡི་༎ བསོད་ནམས་གྲུབ་པ་གང་ཡོད་པ་༎
 aśeṣas tena loko 'yaṃ maunīndraṃ padam āpnuyāt || 18	དེས་ནི་འཇིག་རྟེན་མ་ལུས་པ་༎ ཐུབ་དབང་གོ་འཕང་ཐོབ་པར་ཤོག་།
