skt	tib
 ratnaguṇasaṃcayagāthā | oṃ namo bhagavatyai āryaprajñāpāramitāratnaguṇasaṃcayagāthāyai | namo āryamañjuśriye |	༄༡༨༩ཨ་། །རྒྱ་གར་སྐད་དུ་། ཨའརྱ་པྲ་ཛཉའ་པ་ར་མི་ཏ་སཉཙ་ཡ་ག་ཐའ་། བོད་སྐད་དུ་། འཕགས་པ་ཤེས་རབ་ཀྱི་ཕ་རོལ་ཏུ་ཕྱིན་པ་སྡུད་པ་ཚིགས་སུ་བཅད་པ་། སངས་རྒྱས་དང་བྱང་ཆུབ་སེམས་དཔའ་ཐམས་ཅད་ལ་ཕྱག་འཚལ་ལོ་༎
 1 atha khalu bhagavāṃstāsāṃ catasṛṇāṃ parṣadāṃ saṃpraharṣaṇārthaṃ punarapīmāṃ prajñāpāramitāṃ paridīpayamānastasyāṃ velāyāmimā gāthā abhāṣata	དེ་ནས་ཡང་བཅོམ་ལྡན་འདས་ཀྱིས་འཁོར་བཞི་པོ་དེ་དག་ཡང་དག་པར་རབ་ཏུ་དགའ་བར་མཛད་པའི་ཕྱིར་ཤེས་རབ་ཀྱི་ཕ་རོལ་ཏུ་ཕྱིན་པ་འདི་སྟོན་ཅིང་། དེའི་ཚེ་ཚིགས་སུ་བཅད་པ་འདི་བཀའ་སྩལ་ཏོ་༎ དགའ་དང་གུས་དང་དད་པའི་མཆོག་ནི་ཉེར་བཞག་སྟེ་༎
 para prema gaurava prasāda upasthapitvā prajahitva āvaraṇa kleśamalātikrāntāḥ | śṛṇutā jagārthamabhiprasthita sura(vra?) tānāṃ prajñāya pāramita yatra caranti śūrāḥ || rgs_1|1 ||	སྒྲིབ་པ་ཉོན་མོངས་བསལ་ནས་དྲི་མ་ལས་འདས་པ་༎ འགྲོ་དོན་མངོན་ཞུགས་དེས་པའི་ཤེས་རབ་ཕ་རོལ་ཕྱིན་༎ གང་ལ་དཔའ་རྣམས་སྤྱོད་པ་དེ་ནི་མཉན་པར་གྱིས་༎
 yāvanti nadya pravahantiha jambudvīpe phala puṣpa auṣadhā(dhi) vanaspati rohayanti |	འཛམ་བུའི་གླིང་འདིར་ཆུ་ཀླུང་ཇི་སྙེད་ཅིག་འབབ་ཅིང་༎ མེ་ཏོག་འབྲས་ལྡན་སྨན་དང་ནགས་ཚལ་སྐྱེད་བྱེད་པ་༎
 bhūja(ta) gajendranāgapatiniśrayanovata(na) sya(?)	མ་དྲོས་གནས་པའི་ཀླུ་དབང་ཀླུ་བདག་བརྟེན་གནས་ཏེ་༎
 tasyānubhāvaśriya sābhu jagādhipasya || rgs_1|2 ||	དེ་ནི་ཀླུ་ཡི་བདག་པོ་དེ་ཡི་མཐུ་དཔལ་ཡིན་༎
 yāvanti dharma jinaśrāvaka deśayanti bhāṣanti yuktisahitāṃśca udīrayanti | paramārthasaukhyakriya tatphalaprāptitā ca sarvo ayaṃ puruṣakāru tathāgatasya || rgs_1|3 ||	རྒྱལ་བའི་ཉན་ཐོས་པ་དག་ཇི་སྙེད་ཆོས་སྟོན་དང་༎ འཆད་དང་རིགས་པ་དག་དང་ལྡན་པར་བརྗོད་པ་དང་༎ མཆོག་འཕགས་༄༡༨༩བ་བདེ་བ་བྱེད་དང་དེ་ཡི་འབྲས་ཐོབ་པ་༎ དེ་དག་ཀུན་ཀྱང་དེ་བཞིན་གཤེགས་པའི་སྐྱེས་བུའི་མཐུ་༎
 kiṃ kāraṇaṃ ya jina bhāṣati dharmanetrīṃ tatrābhiśikṣita nararṣabhaśiṣyabhūtāḥ | sākṣātkaritva yatha śikṣita deśayanti buddhānubhāva puna ātmabalānubhāvā || rgs_1|4 ||	ཅི་ཕྱིར་ཞེ་ན་རྒྱལ་བའི་ཆོས་ཚུལ་གང་བསྟན་པ་༎ དེ་ལ་མི་མཆོག་སློབ་མར་གྱུར་པས་མངོན་བསླབ་ཅིང་༎ མངོན་སུམ་བྱས་ནས་བསླབ་པ་ཇི་བཞིན་སྟོན་བྱེད་དེ་༎
 yasminna prajñavarapāramitopalabdhiḥ na ca bodhisattvaupalabdhi na cittabodheḥ |	སངས་རྒྱས་མཐུས་བྱེད་རང་གི་སྟོབས་ཀྱི་མཐུས་མ་ཡིན་༎ གང་ལ་ཤེས་རབ་ཕ་རོལ་ཕྱིན་མཆོག་མི་དམིགས་ཤིང་༎
 evaṃ śruṇitva na ca muhyati nāsti trāso so bodhi(sa)	བྱང་ཆུབ་སེམས་དཔའ་མི་དམིགས་བྱང་ཆུབ་སེམས་མི་དམིགས་༎ དེ་སྐད་ཐོས་ནས་རྨོངས་པ་མེད་ཅིང་སྐྲག་མེད་པ་༎
 ttva carate sugatāna prajñām || rgs_1|5 ||	བྱང་ཆུབ་སེམས་དཔའ་དེ་ནི་བདེ་གཤེགས་ཤེས་རབ་སྤྱོད་༎
 na ca rupa vedana na saṃjña na cetanā ca vijñāna sthānu aṇumātra na bhonti tasya |	གཟུགས་མེད་ཚོར་བ་མེད་ཅིང་འདུ་ཤེས་སེམས་པ་མེད་༎ དེ་ལ་རྣམ་ཤེས་གནས་ནི་རྡུལ་ཙམ་ཡོད་མ་ཡིན་༎
 so sarvadharmaasthito aniketacārī aparī(ri)	དེ་ཆོས་ཀུན་ལ་མི་གནས་གནས་པ་མེད་པར་སྤྱོད་༎
 gṛhīta labhate sugatāna bodhim || rgs_1|6 ||	ཡོངས་སུ་གཟུང་མེད་བདེ་གཤེགས་རྣམས་ཀྱི་བྱང་ཆུབ་འཐོབ་༎ ཇི་ལྟར་ཀུན་དུ་རྒྱུ་བ་བཟོ་སྦྱངས་ཤེས་པ་ཡིས་༎
 atha śreṇikasya abhutī parivrājakasya jñānopalambhu na hi skandhavibhāvanā ca |	དམིགས་མེད་ཕུང་པོ་རྣམ་པར་འཇིག་པ་འབྱུང་བ་ལྟར་༎
 yo bodhisattva parijānati eva dharmāṃ na ca nirvṛtiṃ spṛśati so viharāti prajñām || rgs_1|7 ||	བྱང་ཆུབ་སེམས་དཔའ་གང་ཞིག་དེ་ལྟར་ཆོས་ཤེས་པ་༎ མྱ་ངན་འདས་ལ་མི་རེག་དེ་ནི་ཤེས་རབ་གནས་༎ ཡང་འདི་ཤེས་རབ་འདི་ནི་གང་ཡིན་སུ་ཡི་ཡིན་༎
 vyuparīkṣate punarayaṃ katareṣu prajñā kasmātkuto va imi śūnyaka sarva dharmāḥ |	གང་ལས་ཡིན་ཞེས་ཆོས་འདི་ཐམས་ཅད་སྟོང་པར་རྟོག་།
 vyuparīkṣamāṇu na ca līyati nāsti trāso āsannu so bhavati bodhayi bodhisattvo || rgs_1|8 ||	ཉེ་བར་བརྟགས་ནས་ཞུམ་པ་མེད་ཅིང་སྐྲག་མེད་པ་༎ བྱང་ཆུབ་སེམས་དཔའ་དེ་ནི་བྱང་ཆུབ་ཉེ་བ་ཡིན་༎
 saci rupa saṃjña api vedana cetanā ca vijñāna skandha caratī aprajānamāno |	གལ་ཏེ་མི་ཤེས་བཞིན་དུ་གཟུགས་སུ་འདུ་ཤེས་ཤིང་༎
 imi skandha śūnya parikalpayi bodhisattvo caratī nimittaanupādapade asakto || rgs_1|9 ||	ཚོར་བ་སེམས་པ་རྣམ་ཤེས་ཕུང་པོར་སྤྱོད་བྱེད་ཅིང་༎ ཕུང་༄༡༩༠ཨ་༌༎ འདི་སྟོང་ཞེས་རྟོག་ནའང་བྱང་ཆུབ་སེམས་དཔའ་ནི་༎
 na ca rupa vedana na saṃjña na cetanāyā vijñāni yo na caratī aniketacārī |	མཚན་མ་ལ་སྤྱོད་སྐྱེ་མེད་གནས་ལ་དད་མ་ཡིན་༎ གང་ཞིག་གཟུགས་མིན་ཚོར་མིན་འདུ་ཤེས་སེམས་པ་མིན་༎ རྣམ་པར་ཤེས་ལ་མི་སྤྱོད་གནས་པ་མེད་པར་སྤྱོད་༎
 caratīti so na upagacchati prajñadhārī anupādadhī spṛśati śānti samādhi śreṣṭhām || rgs_1|10 ||	དེ་ནི་སྤྱོད་ཅེས་བྱ་བར་མི་དམིགས་ཤེས་རབ་བསྟན་༎ སྐྱེ་མེད་བློ་ལྡན་ཏིང་འཛིན་ཞི་བ་མཆོག་ལ་རེག་། བྱང་ཆུབ་སེམས་གང་དེ་ལྟར་འདིར་བདག་ཞིར་གནས་པ་༎
 evātmaśānti viharanniha bodhisattvo so vyākṛto puramakehi tathāgatehi |	དེ་ནི་སྔོན་གྱི་དེ་བཞིན་གཤེགས་པས་ལུང་བསྟན་ཡིན་༎
 na ca manyate ahu samādhitu vyutthito vā kasmārtha dharmaprakṛtiṃ parijānayitvā || rgs_1|11 ||	བདག་ནི་མཉམ་པར་བཞག་ཅེའམ་ལངས་ཞེས་རློམ་སེམས་མེད་༎ ཅི་ཕྱིར་ཞེ་ན་ཆོས་ཀྱི་རང་བཞིན་ཡོངས་ཤེས་ཕྱིར་༎
 evaṃ carantu caratī sugatāna prajñāṃ no cāpi so labhati yatra carāti dharmam |	དེ་ལྟར་སྤྱོད་ན་བདེ་གཤེགས་རྣམས་ཀྱི་ཤེས་རབ་སྤྱོད་༎ དེས་ནི་སྤྱོད་མེད་སྤྱོད་པ་ཡིན་པར་རབ་ཤེས་ཕྱིར་༎ ཆོས་གང་སྤྱོད་པ་དེ་ཡང་དམིགས་པར་མི་འགྱུར་ཏེ་༎
 caraṇaṃ ca so 'caraṇaṃ ca prajānayitvā eṣā sa prajñavarapāramitāya caryā || rgs_1|12 ||	འདི་ནི་ཤེས་རབ་ཕ་རོལ་ཕྱིན་མཆོག་སྤྱོད་པ་ཡིན་༎ གང་ཞིག་ཡོད་པ་མ་ཡིན་དེ་ནི་མེད་ཅེས་བྱ་༎
 yo 'sau na vidyati sa eṣa avidyamāno tāṃ bālu kalpayi avidya karoti vidyām |	བྱིས་པ་རྣམས་ཀྱིས་དེ་བརྟགས་ཡོད་དང་མེད་པར་བྱེད་༎ ཡོད་དང་མེད་པ་འདི་གཉིས་མེད་པའི་ཆོས་ཡིན་ཏེ་༎
 vidyā avidya ubhi eti asanta dharmā niryāti yo iti prajānati bodhisattvo || rgs_1|13 ||	བྱང་ཆུབ་སེམས་དཔའ་གང་གིས་འདི་ཤེས་ངེས་པར་འབྱུང་༎
 māyopamāṃ ya iha jānati pañca skandhāṃ na ca māya anya na ca skandha karoti anyān |	གང་འདིར་ཕུང་པོ་ལྔ་དག་སྒྱུ་མ་འདྲར་ཤེས་ཤིང་༎ སྒྱུ་མ་གཞན་དང་ཕུང་པོ་གཞན་དུ་མི་ཕྱོགས་ལ་༎
 nānātvasaṃjñavigato upaśāntacārī eṣā sa prajñavarapāramitāya caryā || rgs_1|14 ||	སྣ་ཚོགས་འདུ་ཤེས་བྲལ་ཞིང་ཉེ་བར་ཞི་སྤྱོད་པ་༎ འདི་ནི་ཤེས་རབ་ཕ་རོལ་ཕྱིན་མཆོག་སྤྱོད་པ་ཡིན་༎
 kalyāṇamitrasahitasya vipaśyakasya trāso na bheṣyati śruṇitva jināna mātrām |	དགེ་བའི་བཤེས་དང་ལྡན་ཞིང་ལྷག་མཐོང་ལྡན་གྱུར་༄༡༩༠བ་པ༏་༏རྒྱལ་བ་རྣམས་ཀྱི་ཡུམ་ཐོས་སྐྲག་པར་ཡོང་མི་འགྱུར་༎ གང་ཞིག་སྡིག་པའི་གྲོགས་ལྡན་གཞན་གྱི་དྲིང་མི་འཇོག་།
 yo pāpamitrasahito ca parapraṇeyo so āmabhājana yathodakaspṛṣṭa bhinno || rgs_1|15 ||	དེ་ནི་སྣོད་སོ་མ་བཏང་ཆུས་རེག་ཞིག་པ་བཞིན་༎ ཅི་ཕྱིར་འདི་ནི་བྱང་ཆུབ་སེམས་དཔའ་བྱ་ཞེ་ན་༎
 kiṃ kāraṇaṃ ayu pravucyati bodhisattvo sarvatra saṅgakriya icchati saṅgachedī |	ཆགས་པ་སྤྱོད་བྱེད་ཀུན་ལ་ཆགས་པ་ཟད་པར་འདོད་༎
 bodhiṃ spṛśiṣyati jināna asaṅgabhūtāṃ tasmāddhi nāma labhate ayu bodhisattvo || rgs_1|16 || mahasattva so 'tha kenocyati kāraṇena mahatāya atra ayu bheṣyati sattvarāśeḥ |	རྒྱལ་བ་རྣམས་ཀྱི་བྱང་ཆུབ་ཆགས་མེད་གྱུར་ལ་རེག་། དེས་ན་འདི་ནི་བྱང་ཆུབ་སེམས་དཔའི་མིང་འཐོབ་བོ༏་༏ཅི་ཕྱིར་དེ་ནི་སེམས་དཔའ་ཆེ་ཞེས་བྱ་ཞེ་ན་༎ 
 dṛṣṭīgatāṃ mahati chindati sattvadhātoḥ mahasattva tena hi pravucyati kāraṇena || rgs_1|17 ||	སེམས་ཅན་ཚོགས་རྣམས་མང་པོའི་མཆོག་ཏུ་གྱུར་པ་དང་༎ སེམས་ཅན་ཁམས་ཀྱི་ལྟ་རྣམས་ཆེན་པོ་གཅོད་པ་སྟེ་༎ དེ་ཕྱིར་སེམས་དཔའ་ཆེན་པོ་ཞེས་ནི་རབ་བརྗོད་དོ་༎
 mahanāyako mahatabuddhi mahānubhāvo mahayāna uttamajināna samādhirūḍho | mahatā sanaddhu namuciṃ śaṭha dharṣayiṣye mahasattva tena hi pravucyati kāraṇena || rgs_1|18 ||	གཏོང་བ་ཆེ་དང་བློ་ཆེ་བ་དང་མཐུ་ཆེ་དང་༎ རྒྱལ་བ་རྣམས་ཀྱི་ཐེག་ཆེན་མཆོག་ལ་ཞུགས་པ་དང་༎ གོ་ཆ་ཆེན་པོ་བགོས་ཤིང་བདུད་ཀྱི་སྒྱུ་འདུལ་བ་༎ དེ་ཡི་ཕྱིར་ན་སེམས་དཔའ་ཆེ་ཞེས་རབ་ཏུ་བརྗོད་༎
 māyākaro yatha catuṣpathi nirmiṇitvā mahato janasya bahu chindati śīrṣakoṭī |	དཔེར་ན་སྒྱུ་མ་མཁན་གྱིས་བཞི་མདོར་སྤྲུལ་བྱས་ཏེ་༎ སྐྱེ་བོ་ཕལ་ཆེན་མགོ་མང་བྱེ་བ་གཅོད་བྱེད་པའི་༎
 yatha te ca māya tatha jānati sarvasattvāṃ nirmāṇu sarva jagato na ca tasya trāso || rgs_1|19 ||	གསད་བྱ་དེ་དག་ཅི་འདྲ་དེ་ལྟར་བྱང་ཆུབ་སེམས་༎ འགྲོ་ཀུན་སྤྲུལ་འདྲར་རབ་ཤེས་དེ་ལ་འཇིགས་པ་མེད་༎
 rupaṃ ca saṃjña api vedana cetanā ca vijñāna bandhu na ca mukta asaṅgabhūto | evaṃ ca bodhi kramate na ca līnacitto saṃnā ha eṣa varapudgalauttamānām || rgs_1|20 || kiṃ kāraṇaṃ ayu pravucyati bodhiyāno yatrāruhitva sa nirvāpayi sarvasattvān |	གཟུགས་དང་འདུ་ཤེས་ཚོར་བ་དང་ནི་སེམས་པ་དང་༎ རྣམ་པར་ཤེས་པ་མ་བཅིངས་མ་གྲོལ་ཡོད་པ་མིན་༎ དེ་ལྟར་བྱང་ཆུབ་ལ་འཇུག་ཞུམ་པའི་སེམས་མེད་པ་༎ འདི་ནི་གང་ཟག་དམ་པ་རྣམས་ཀྱི་གོ་ཆ་མཆོག་། ཅི་ཕྱིར་འདི་ནི་བྱང་ཆུབ་ཐེག་ཆེན་བྱ་ཞེ་ན་༎ དེ་གང་ཞོན་ནས་སེམས་ཅན་ཐམས་༄༡༩༡ཨ་༌༎ ཅད་མྱ་ངན་ཟློ་༎
 ākāśatulya ayu yāna mahāvimāno sukhasaukhyakṣemabhiprāpaṇu yānaśreṣṭho || rgs_1|21 ||	ཐེག་པ་འདི་ནི་མཁའ་འདྲ་གཞལ་མེད་ཁང་ཆེན་ཏེ་༎ དགའ་སྐྱིད་བདེ་བ་མངོན་པར་ཐོབ་བྱེད་ཐེག་པའི་མཆོག་།
 na ca labhyate ya vrajate diśa āruhitvā nirvāṇaokagamanaṃ gati nopalabdhiḥ |	གང་ཞིག་ཞོན་ནས་ཕྱོགས་སུ་འགྲོ་བ་དམིགས་སུ་མེད་༎ མྱ་ངན་འདས་པར་འགྲོ་བར་གསུངས་པ་འགྲོ་མི་དམིགས་༎
 yatha agni nirvṛtu na tasya gatipracāro so tena nirvṛti pravucyati kāraṇena || rgs_1|22 ||	དཔེར་ན་མི་ཤི་དེ་ཡིས་འགྲོ་རྒྱུ་མེད་པ་བཞིན་༎ རྒྱུ་དེས་དེ་ནི་མྱ་ངན་འདས་ཞེས་རབ་ཏུ་བརྗོད་༎
 pūrvāntato na upalabhyati bodhisattvo aparāntato 'pi pratiupanna triyadhvaśuddho |	བྱང་ཆུབ་སེམས་དཔའ་སྔོན་གྱི་མཐའ་དང་ཕྱི་མཐའ་དང་༎ ད་ལྟར་བྱུང་བར་མི་དམིགས་དུས་གསུམ་དག་པ་སྟེ་༎
 yo śuddha so anabhisaṃskṛtu niṣprapañco eṣā sa prajñavarapāramitāya caryā || rgs_1|23 ||	གང་དག་དེ་ནི་འདུས་མ་བྱས་ཡིན་སྤྲོས་མེད་དེ་༎ འདི་ནི་ཤེས་རབ་ཕ་རོལ་ཕྱིན་མཆོག་སྤྱོད་པ་ཡིན་༎ བྱང་ཆུབ་སེམས་མཁས་རིག་པ་གང་གི་དུས་ཀྱི་ཚེ་༎
 yasmiṃś ca kāli samaye vidu bodhisattvo evaṃ carantu anupādu vicintayitvā |	སྐྱེ་མེད་རྣམ་པར་བསམ་སྟེ་འདི་ལྟར་སྤྱོད་བྱེད་ཅིང་༎
 mahatīṃ janeti karuṇāṃ na ca sattvasaṃjñā eṣā sa prajñavarapāramitāya caryā || rgs_1|24 ||	སྙིང་རྗེ་ཆེན་པོ་བསྐྱེད་ཀྱང་སེམས་ཅན་འདུ་ཤེས་མེད་༎ འདི་ནི་ཤེས་རབ་ཕ་རོལ་ཕྱིན་མཆོག་སྤྱོད་པ་ཡིན་༎ གལ་ཏེ་སེམས་ཅན་འདུ་ཤེས་སྡུག་བསྔལ་འདུ་ཤེས་བསྐྱེད་༎
 saci sattvasaṃjña dukhasaṃjña upādayātī hariṣyāmi duḥkha jagatīṃ kariṣyāmi artham |	འགྲོ་བ་རྣམས་ཀྱི་དོན་བྱ་སྡུག་བསྔལ་སྤང་སྙམ་སྟེ་༎
 so ātmasa(ttva)	བདག་དང་སེམས་ཅན་ཡོངས་རྟོག་བྱང་ཆུབ་སེམས་དཔའ་སྟེ་༎
 parikalpaku bodhisattvo na ca eṣa prajñavarapāramitāya caryā || rgs_1|25 ||	འདི་ནི་ཤེས་རབ་ཕ་རོལ་ཕྱིན་མཆོག་སྤྱོད་པ་ཡིན་༎ བདག་ཅི་འདྲ་བ་དེ་འདྲར་སེམས་ཅན་ཐམས་ཅད་ཤེས་༎
 yatha ātmanaṃ tatha prajānati sarvasattvāṃ yatha sarvasattva tatha prajānati sarvadharmān |	སེམས་ཅན་ཐམས་ཅད་ཅི་འདྲ་དེ་འདྲར་ཆོས་ཀུན་ཤེས་༎
 anupādupādu ubhaye avikalpamāno eṣā sa prajñavarapāramitāya caryā || rgs_1|26 ||	སྐྱེ་བ་མེད་དང་སྐྱེ་བ་གཉི་གར་མི་རྟོག་པ་༎
 yāvanti loki parikīrtita dharmanāma sarveṣupādasamatikramu nirgamitvā | amṛtaṃ ti jñānu paramaṃ na tu yo pareṇa ekārtha prajña ayu pāramiteti nāmā || rgs_1|27 ||	འདི་ནི་ཤེས་རབ་ཕ་རོལ་ཕྱིན་མཆོག་སྤྱོད་པ་ཡིན་༎ འཇིག་རྟེན་དག་ན་༄༡༩༡བ་ཆོས་མིང་ཇི་སྙེད་ཡོངས་བརྗོད་པ་༎ ཀུན་ལ་སྐྱེ་བ་དང་ནི་ཡང་དག་འདས་སྤངས་ན་༎ ཡེ་ཤེས་འཆི་མེད་དམ་པ་དེ་ལས་གཞན་མེད་ཐོབ་༎ དེ་ཕྱིར་འདི་ནི་ཤེས་རབ་ཕ་རོལ་ཕྱིན་ཅེས་བྱ་༎
 evaṃ carantu na ca kāṅkṣati bodhisattvo jñātavya yo vihara te sa upāyaprajño |	བྱང་ཆུབ་སེམས་དཔའ་གང་ཞིག་དོགས་མེད་དེ་ལྟར་སྤྱོད་༎ ཤེས་རབ་ལྡན་ཏེ་མཉམ་ཉིད་གནས་པར་ཤེས་པར་བྱ་༎
 prakṛtīasanta parijānayamāna dharmāṃ eṣā sa prajñavarapāramitāya caryā || rgs_1|28 || bhagavatyāṃ ratnaguṇasaṃcayagāthāyāṃ sarvākārajñatācaryāparivarto nāma prathamaḥ ||	ཆོས་རྣམས་རང་བཞིན་མེད་པར་ཡོངས་སུ་ཤེས་གྱུར་པ་༎ འདི་ནི་ཤེས་རབ་ཕ་རོལ་ཕྱིན་མཆོག་སྤྱོད་པ་ཡིན་༎
 rupasmi yo na sthihate na ca vedanāyāṃ saṃjñāya yo na sthihate na ca cetanāyām |	གང་ཞིག་གཟུགས་ལ་མི་གནས་ཚོར་ལ་མི་གནས་ཤིང་༎ གང་ཞིག་འདུ་ཤེས་མི་གནས་སེམས་དཔར་མི་གནས་ལ་༎
 vijñāni yo na sthihate sthitu dharmatāyāṃ eṣā sa prajñavarapāramitāya caryā || rgs_2|1 ||	རྣམ་ཤེས་གང་མི་གནས་པ་ཆོས་ཉིད་གནས་པ་སྟེ་༎ འདི་ནི་ཤེས་རབ་ཕ་རོལ་ཕྱིན་མཆོག་སྤྱོད་པ་ཡིན་༎
 nityamanityasukhaduḥkhaśubhāśubhaṃ ti ātmanyanātmi tathatā ta(tha) śūnyatāyām |	རྟག་དང་མི་རྟག་བདེ་དང་སྡུག་བསྔལ་སྡུག་མི་སྡུག་། བདག་དང་བདག་མེད་དེ་བཞིན་ཉིད་དང་དེ་བཞིན་སྟོང་༎
 phalaprāptitāya athito arahantabhūmau pratyekabhūmiathito tatha buddhabhūmau || rgs_2|2 ||	འབྲས་བུ་ཐོབ་དང་དགྲ་བཅོམ་ས་ལ་མི་གནས་ཤིང་༎ རང་རྒྱལ་ས་དང་དེ་བཞིན་སངས་རྒྱས་སར་མི་གནས་༎
 yatha nāyako 'sthitaku dhātuasaṃskṛtāyā tatha saṃskṛtāya athito aniketacārī |	ཇི་ལྟར་འདྲེན་པ་འདུས་མ་བྱས་ཁམས་མི་གནས་ཤིང་༎ དེ་བཞིན་འདུས་བྱས་ལ་ཡང་མི་གནས་གནས་མེད་སྤྱོད་༎
 evaṃ ca sthānu athito sthita bodhisattvo asthānu sthānu ayu sthānu jinena ukto || rgs_2|3 ||	དེ་ལྟར་བྱང་ཆུབ་སེམས་དཔའ་གནས་ལ་གནས་མེད་གནས་༎ གནས་མེད་གནས་ཡིན་འདི་ནི་རྒྱལ་བས་གནས་པར་གསུངས་༎
 yo icchatī sugataśrāvaka haṃ bhaveyaṃ pratyekabuddha bhaviyāṃ tatha dharmarājo |	གང་དག་བདེ་གཤེགས་ཉན་ཐོས་འགྱུར་བར་བྱ་སྙམ་དང་༎ རང་སངས་རྒྱས་དང་དེ་བཞིན་ཆོས་རྒྱལ་འགྱུར་འདོད་པ་༎
 imu kṣāntyanāgami na śakyati prāpuṇetuṃ yatha ārapāragamanāya atītadarśī || rgs_2|4 ||	བཟོད་པ་འདི་ལ་མ་བརྟེན་ཐོབ་པར་མི་ནུས་ཏེ་༎
 yo dharma bhāṣyati ya bhāṣyati bhāṣyamāṇāṃ phalaprāpta pratyayajino tatha lokanātho |	དཔེར་ན་ཕ་རོལ་ཚུ་རོལ་འགྲོ་ངོགས་མི་མཐོང་བཞིན་༎ ༄༡༩༢ཨ་༌༎ ཆོས་འཆད་པ་དང་ཉན་དང་བཤད་བྱ་གང་ཡིན་པ་༎ འབྲས་བུ་ཐོབ་དང་རྐྱེན་རྒྱལ་དེ་བཞིན་འཇིག་རྟེན་མགོན་༎ མཁས་པ་གསལ་བས་ཐོབ་པའི་མྱ་ངན་འདས་གང་ཡིན་༎
 nirvāṇato adhigato vidupaṇḍitehi sarve ta ātmaja nidṛṣṭa tathāgatena || rgs_2|5 ||	དེ་ཀུན་སྒྱུ་མ་ལྟ་བུར་དེ་བཞིན་གཤེགས་པས་བསྟན་༎
 catvāri pudgala ime na trasanti ye 'smin jinaputra satyakuśalo avivartiyaśca |	གང་ཟག་བཞི་པོ་འདི་དག་དེ་ལ་མི་སྐྲག་སྟེ་༎
 arhaṃ vidhūtamalakleśa prahīṇakāṅkṣo kalyāṇamitraparipācita yaścaturthaḥ || rgs_2|6 ||	རྒྱལ་སྲས་བདེན་ལ་མཁས་དང་ཕྱིར་མི་ལྡོག་པ་དང་༎ དགྲ་བཅོམ་དྲི་མ་བསལ་ཅིང་སོམ་ཉི་སྤངས་པ་དང་༎ བཞི་པ་དགེ་བའི་བཤེས་ཀྱིས་ཡོངས་སུ་ཟིན་པའོ་༎
 evaṃ carantu vidu paṇḍitu bodhisattvo nārhaṃmi śikṣati na pratyayabuddhabhūmau |	བྱང་ཆུབ་སེམས་དཔའ་མཁས་རིག་དེ་ལྟར་སྤྱོད་པ་ནི་༎ དགྲ་བཅོམ་ས་ལ་མི་སློབ་རྐྱེན་རྟོགས་ས་ལ་མིན༏་༏ཐམས་ཅད་མཁྱེན་ཉིད་ཆེད་དུ་སངས་རྒྱས་ཆོས་རྗེས་སློབ་༎ 
 sarvajñatāya anuśikṣati buddhadharme śikṣāaśikṣa na ya śikṣati eṣa śikṣā || rgs_2|7 ||	གང་ཞིག་སློབ་མི་སློབ་ལ་མི་སློབ་དེ་སློབ་ཡིན་༎
 na ca rupavṛddhiparihāṇiparigrahāye na ca śikṣati vividhadharmaparigrahāye |	གཟུགས་འཕེལ་ཡོངས་སུ་ཉམས་དང་ཡོངས་སུ་གཟུང་ཕྱིར་མིན་༎ ཆོས་རྣམས་སྣ་ཚོགས་ཡོངས་སུ་གཟུང་ཕྱིར་མི་སློབ་པར་༎
 sarvajñatāṃ ca parigṛhṇati śikṣamāṇo niryāyatī ya iya śikṣa guṇe ratānām || rgs_2|8 ||	སློབ་ཅིང་ཐམས་ཅད་མཁྱེན་པ་ཉིད་ཀྱང་ཡོངས་འཛིན་ལ་༎ ངེས་འབྱུང་གང་ཡིན་འདི་ནི་ཡོན་ཏན་དགའ་བའི་སློབ་༎
 rupe na prajña iti rupi na asti prajñā vijñāna saṃjña api vedana cetanā ca |	གཟུགས་ནི་ཤེས་རབ་མ་ཡིན་གཟུགས་ལ་ཤེས་རབ་མེད་༎ རྣམ་ཤེས་འདུ་ཤེས་ཚོར་དང་སེམས་པ་འདི་དག་ནི་༎
 na ca eti prajña iti teṣa na asti prajñā ākāśadhātusama tasya na cāsti bhedaḥ || rgs_2|9 || ārambaṇāna prakṛtī sa a(na)	ཤེས་རབ་མ་ཡིན་འདི་དག་ལ་ཡང་ཤེས་རབ་མེད་༎ འདི་ནི་ནམ་མཁའི་ཁམས་དང་མཚུངས་ཏེ་ཐ་དད་མེད་༎ དམིགས་པ་རྣམས་ཀྱི་རང་བཞིན་དེ་ནི་ཕ་མཐའ་མེད་༎
 ntapārā sattvāna yā ca prakṛtī sa anantapārā |	སེམས་ཅན་རང་བཞིན་གང་ཡིན་དེ་ཡང་ཕ་མཐའ་མེད་༎ ནམ་མཁའི་ཁམས་ཀྱི་རང་བཞིན་དེ་ཡང་༄༡༩༢བ་ཕ་མཐའ་མེད་༎
 ākāśadhātuprakṛtī sa anantapārā prajñā pi lokavidunāṃ sa anantapārā || rgs_2|10 || saṃjñeti nāma parikīrtitu nāyakena saṃjñāṃ vibhāviya prahāṇa vrajanti pāram |	འཇིག་རྟེན་མཁྱེན་པའི་ཤེས་རབ་དེ་ཡང་ཕ་མཐའ་མེད་༎ འདུ་ཤེས་ཚུ་རོལ་ཡིན་ཞེས་འདྲེན་པས་ཡོངས་སུ་བསྒྲགས་༎ འདུ་ཤེས་རྣམ་པར་བཤིགས་ནས་སྤོང་བ་ཕ་རོལ་འགྲོ་།
 ye atra saṃjñavigamaṃ anuprāpnuvanti te pāraprāpta sthita pāramite hu bhonti || rgs_2|11 ||	གང་དག་འདུ་ཤེས་བྲལ་བ་འདི་ནི་རྗེས་ཐོབ་པ་༎ དེ་དག་ཕ་རོལ་ཕྱིན་ནས་སྟོན་པའི་བཀའ་ལ་གནས་༎
 saci gaṅgavālukasamāni sthihitva kalpāṃ sattveti śabda parikīrtayi nāyako 'yam |	གལ་ཏེ་སྟོན་པས་ཀྱང་ནི་གངགའའི་བྱེ་སྙེད་ཀྱི་༎ བསྐལ་པར་བཞུགས་ཏེ་སེམས་ཅན་ཞེས་སྒྲ་ཡོངས་བསྒྲགས་ཀྱང་༎ གཟོད་ནས་དག་པས་སེམས་ཅན་སྐྱེ་བར་ག་ལ་འགྱུར་༎
 sattvasyupādu kutu bheṣyati ādiśuddho eṣā sa prajñavarapāramitāya caryā || rgs_2|12 ||	འདི་ནི་ཤེས་རབ་ཕ་རོལ་ཕྱིན་མཆོག་སྤྱོད་པ་ཡིན་༎
 evaṃ jino bhaṇati apratikūlabhāṇī yadahaṃ imāya varapāramitāya āsī |	གང་ཚེ་ང་ནི་ཕ་རོལ་ཕྱིན་པའི་མཆོག་འདི་དང་༎ མཐུན་པར་སྨྲ་གྱུར་དེ་ཚེ་སྔོན་གྱི་སྐྱེས་མཆོག་གིས་༎
 tada vyākṛto 'hu parāpuruṣottamena buddho bhaviṣyasi anāgataadhvanasmin || rgs_2|13 || bhagavatyāṃ ratnaguṇasaṃcayagāthāyāṃ śakraparivarto nāma dvitīyaḥ ||	མ་འོངས་པ་ཡི་དུས་ན་སངས་རྒྱས་འགྱུར་རོ་ཞེས་༎ ང་ལུང་བསྟན་པར་གྱུར་ཅེས་རྒྱལ་བ་དེ་སྐད་གསུང་༎
 ya imāṃ grahīṣyati paryāpuṇatī sa nityaṃ prajñāya pāramita yatra caranti nāthāḥ |	ཤེས་རབ་ཕ་རོལ་ཕྱིན་པ་གང་ལ་མགོན་སྤྱོད་པ་༎ འདི་ནི་གང་ཞིག་གུས་བྱས་འཛིན་དང་ཆུབ་བྱེད་པ་༎
 viṣa vahni śastra udakaṃ na kramāti tasyo otāru māru na ca vindati mārapakṣo || rgs_3|1 ||	དེ་ལ་དུག་དང་མཚོན་དང་མེ་དང་ཆུས་མི་ཚུགས་༎ བདུད་དང་བདུད་ཀྱི་ཕྱོགས་ཀྱིས་གླགས་ཀྱང་རྙེད་མི་འགྱུར་༎
 parinirvṛtasya sugatasya kareyya stūpāṃ pūjeya saptaratanāmayu kaścideva |	ལ་ལས་བདེ་གཤེགས་ཡོངས་སུ་མྱ་ངན་འདས་པ་ཡིས་༎ མཆོད་རྟེན་རིན་ཆེན་བདུན་ལས་བྱས་ཤིང་མཆོད་བྱེད་ལ་༎
 tehi prapūrṇa siya kṣetrasahasrakoṭyo yatha gaṅgavālikasamaiḥ sugatasya stūpaiḥ || rgs_3|2 ||	བདེ་བར་གཤེགས་པའི་མཆོད་རྟེན་དེ་དག་གངགའ་ཡི་༎ བྱེ་མ་སྙེད་ཀྱིས་བྱེ་བ་ཕྲག་སྟོང་ཞིང་བཀང་སྟེ་༎
 yāvanta sattva puna tāntaka kṣetrakoṭyo te sarvi pūjana kareyuranantakalpān |	ཡོངས་སུ་བརྟག་བཟུང་ཞིང་རྣམས་བྱེ་བ་མཐའ་ཡས་ན་༎ སེམས་ཅན་ཇི་སྙེད་འཁོད་པ་དེ་དག་ཐམས་ཅད་ཀྱིས་༎
 divyehi puṣpavaragandhavilepanehi kalpāṃstriyadhvaparikalpa tato 'pi bhūyaḥ || rgs_3|3 ||	ལས་གཞན་མི་བྱེད་ལྟ་ཡི་མེ་ཏོག་སྤོས་རབ་དང་༎ བྱུག་པས་དུས་གསུམ་བསྐལ་༄༡༩༣ཨ་༌༎ པའམ་དེ་བས་ལྷག་མཆོད་ལ་༎
 yaśco imāṃ sugatamāta likhitva puste yata utpatī daśabalāna vināyakānām |	གང་ཞིག་གང་ལས་རྣམ་འདྲེན་སྟོབས་བཅུ་འབྱུང་འགྱུར་བ་༎ བདེ་བར་གཤེགས་པའི་ཡུམ་འདི་གླེགས་བམ་ལ་བྲིས་ཏེ༏་༏འཆང་ཞིང་མེ་ཏོག་བྱུག་པས་བསྟི་སྟང་བྱེད་གྱུར་ན་༎ 
 dhāreyi satkarayi puṣpavilepanehi kala puṇya bhonti na sa stūpi karitva pūjām || rgs_3|4 ||	མཆོད་རྟེན་བྱས་མཆོད་བསོད་ནམས་དེས་ནི་ཆར་མི་ཕོད་༎ རྒྱལ་བའི་ཤེས་རབ་ཕ་རོལ་ཕྱིན་འདི་རིག་སྔགས་ཆེ་༎
 mahavidya prajña ayu pāramitā janānāṃ dukhadharmaśokaśamanī pṛthusattvadhātoḥ |	སེམས་ཅན་ཁམས་མང་མྱ་ངན་སྡུག་བསྔལ་ཆོས་ཞི་བྱེད་༎
 ye 'tīta ye 'pi ca daśaddiśa lokanāthā ima vidya śikṣita anuttaravaidyarājāḥ || rgs_3|5 ||	གང་དག་འདས་དང་གང་དག་ཕྱོགས་བཅུའི་འཇིག་རྟེན་མགོན་༎ རིག་སྔགས་འདི་བསླབ་སྨན་པའི་རྒྱལ་པོ་བླ་མེད་འགྱུར་༎
 ye vā caranti cariyāṃ hitasānukampām iha vidyaśikṣita vidu spṛśiṣyanti bodhim |	གང་དག་ཕན་དང་སྙིང་རྗེར་བཅས་པའི་སྤྱད་སྤྱོད་པ་༎ རིག་སྔགས་འདི་ལ་བསླབ་ནས་མཁས་པ་བྱང་ཆུབ་རེག་།
 ye saukhya saṃskṛta asaṃskṛta ye ca saukhyā sarve ca saukhya prasutā itu veditavyāḥ || rgs_3|6 ||	འདུས་བྱས་བདེ་དང་འདུས་མ་བྱས་བདེ་གང་ཡིན་པ་༎ བདེ་བ་དེ་ཀུན་འདི་ལས་འབྱུང་བར་རིག་པར་བྱ་༎
 bījāḥ prakīrṇa pṛthivīsthita saṃbhavanti sāmagri labdhva viruhanti anekarupāḥ |	ས་བོན་བཏབ་ནས་ས་ལ་གནས་ཏེ་འབྱུང་འགྱུར་བ་༎ ཚོགས་པ་རྙེད་ནས་རྣམ་མང་གཟུགས་དག་རྣམ་པར་སྐྱེ་༎
 yāvanti bodhiguṇa pāramitāśca pañca prajñāya pāramita te viruhanti sarve || rgs_3|7 ||	ཕ་རོལ་ཕྱིན་ལྔ་བྱང་ཆུབ་ཡོན་ཏན་ཇི་སྙེད་པ་༎ དེ་དག་ཀུན་ཀྱང་ཤེས་རབ་ཕ་རོལ་ཕྱིན་ལས་སྐྱེ་༎ འཁོར་ལོས་བསྒྱུར་རྒྱལ་ལམ་གང་ནས་ནི་རྟག་འགྲོ་བ་༎
 yenaiva rāja vrajate sa ha cakravartī tenaiva sapta ratanā balakāya sarve |	ལམ་དེ་ཉིད་ནས་རིན་ཆེན་བདུན་དང་དཔུང་ཚོགས་ཀུན་༎ གང་ནས་རྒྱལ་བའི་ཤེས་རབ་ཕ་རོལ་ཕྱིན་འདི་འགྲོ་།
 yenaiva prajña iya pāramitā jinānāṃ tenaiva sarvaguṇadharma samāgamanti || rgs_3|8 || bhagavatyāṃ ratnaguṇasaṃcayagāthāyāmaprameyaguṇadhāraṇapāramitāstūpasatkāraparivarto nāma tṛtīyaḥ ||	དེ་ཉིད་ནས་ནི་ཡོན་ཏན་ཆོས་ཀུན་འགྲོ་བར་འགྱུར་༎
 śakro jinena paripṛcchitu praśnamāhu saci gaṅgavālikasamā siya buddhakṣetrāḥ |	རྒྱལ་བས་བརྒྱ་བྱིན་དྲི་བ་ཡོངས་དྲིས་ལན་གསོལ་པ་༎ གལ་ཏེ་གངགའའི་བྱེ་སྙེད་༄༡༩༣བ་སངས་རྒྱས་ཞིང་གྱུར་ལ་༎
 jinadhātu sarvi paripūrita cūḍibaddhā imameva prajñavarapāramitāhu gṛhṇe || rgs_4|1 ||	དེ་ཀུན་རྒྱལ་བའི་རིང་བསྲེལ་གྱུར་བུར་གཏམས་གྱུར་ཀྱང་༎ བདག་ནི་ཤེས་རབ་ཕ་རོལ་ཕྱིན་པ་འདི་ཉིད་ལེན་༎
 kiṃ kāraṇaṃ na mi śarīri agauravatvaṃ api tū khu prajñaparibhāvita pūjayanti |	ཅི་སླད་ཅེ་ན་སྐུ་གདུང་མི་གུས་བདག་མ་ལགས་༎ འོན་ཀྱང་ཤེས་རབ་ཡོངས་སུ་བསྒོམས་པས་མཆོད་བགྱིད་དེ་༎
 yatha rājaniśrita naro labhi sarvi pūjāṃ tatha prajñapāramitaniśrita buddhadhātuḥ || rgs_4|2 ||	དཔེར་ན་རྒྱལ་པོ་བསྟེན་མི་རིམ་གྲོ་འཐོབ་པ་ལྟར་༎ སངས་རྒྱས་རིང་བསྲེལ་ཤེས་རབ་ཕ་རོལ་ཕྱིན་ལ་བརྟེན་༎
 maṇiratna sarvi guṇayukta anarghaprāpto yasmiṃ karaṇḍaki bhave sa namasyanīyaḥ |	ནོར་བུ་རིན་ཆེན་ཡོན་ཏན་ཀུན་ལྡན་རིན་ཐང་མེད་༎ ག་བ་ཚེ་གང་དུ་སྩལ་བ་དེ་ནི་ཕྱག་བགྱི་འོས་༎ དེ་ཕྱུང་གྱུར་ཀྱང་གབ་ཚེ་ལ་ནི་དགའ་བགྱིད་དེ་༎
 tasyāpi uddhṛta spṛhanti karaṇḍakasmiṃ tasyaiva te guṇa mahāratanasya bhonti || rgs_4|3 ||	ཡོན་ཏན་དེ་དག་ནོར་བུ་རིན་ཆེན་དེ་ཡི་ལགས་༎ དེ་བཞིན་ཤེས་རབ་ཕ་རོལ་ཕྱིན་མཆོག་ཡོན་ཏན་གྱིས་༎
 emeva prajñavarapāramitāguṇāni yannirvṛte 'pi jinadhātu labhanti pūjām | tasmā hu tān jinaguṇā(n) parighettukāmo so prajñapāramita gṛhṇatu eṣa mokṣo || rgs_4|4 ||	རྒྱལ་བ་མྱ་ངན་འདས་ཀྱང་རིང་བསྲེལ་མཆོད་པ་བརྙེས་༎ དེ་ལྟས་གང་ཞིག་རྒྱལ་བའི་ཡོན་ཏན་འཛིན་འཚལ་དེས་༎ ཤེས་རབ་ཕ་རོལ་ཕྱིན་བླངས་འདི་ནི་ཐར་པ་ལགས་༎ སྦྱིན་པ་སྦྱིན་པའི་སྔོན་དུ་འགྲོ་བ་ཤེས་རབ་སྟེ་༎
 pūrvaṃgamā bhavatu dānu dadantu prajñā śīle ca kṣānti tatha vīrya tathaiva dhyāne | parigrāhikā kuśaladharmaavipraṇāśe ekā ca sā api nidarśayi sarvadharmān || rgs_4| 5 ||	ཚུལ་ཁྲིམས་བཟོད་པ་བརྩོན་འགྲུས་བསམ་གཏན་དེ་བཞིན་ནོ་༎ དགེ་ཆོས་ཆུད་མི་གཟན་ཕྱིར་ཡོངས་སུ་འཛིན་པ་ཡིན་༎ འདི་ནི་ཆོས་རྣམས་ཐམས་ཅད་ཚུལ་གཅིག་སྟོན་པར་བྱེད་༎
 yatha jambudvīpi bahuvṛkṣasahasrakoṭī nānāprakāra vividhāśca anekarūpāḥ |	དཔེར་ན་འཛམ་བུ་གླིང་ན་ཤིང་རྣམས་བྱེ་བ་སྟོང་༎ རྣམ་པ་སྣ་ཚོགས་རྣམ་པ་དུ་མ་གཟུགས་མང་བ་༎ གྲིབ་མར་གྱུར་པའི་གྲངས་སུ་བརྗོད་པ་མ་གཏོགས་པར་༎
 na vi chāyanānatu bhaveta viśeṣatāpi anyatra chāyagatasaṃkhya prabhāṣamāṇā || rgs_4|6 ||	གྲིབ་མ་སྣ་ཚོགས་མེད་ཅིང་བྱེ་བྲག་ཡོད་མ་ཡིན་༎
 emeva pañca imi pāramitā jinānāṃ prajñāya pāramita nāmatayā bhavanti |	དེ་བཞིན་རྒྱལ་བའི་ཕ་རོལ་ཕྱིན་ལྔ་འདི་དག་ཀྱང་༎ ཤེས་རབ་ཕ་རོལ་ཕྱིན་པའི་མིང་༄༡༩༤ཨ་༌༎ ཉིད་ཐོབ་པར་འགྱུར་༎
 sarvajñatāya pariṇāmayamāṇa sarve ṣaḍapīha ekanayamarchati bodhināmā || rgs_4|7 || bhagavatyāṃ ratnaguṇasaṃcayagāthāyāṃ guṇaparikīrtanaparivarto nāma caturthaḥ ||	ཐམས་ཅད་མཁྱེན་པ་ཉིད་ཕྱིར་ཡོངས་སུ་བསྔོས་བྱས་ན་༎ བྱང་ཆུབ་ཅེས་བྱར་དྲུག་པོ་འདི་ཀུན་རོ་གཅིག་འགྱུར་༎ བྱང་ཆུབ་སེམས་དཔའ་གལ་ཏེ་རབ་ཏུ་མི་ཤེས་བཞིན་༎
 saci rūpa saṃjña api vedana cetanāyāṃ cittaṃ anitya pariṇāmayi bodhisattvo |	གཟུགས་དང་འདུ་ཤེས་ཚོར་དང་སེམས་པ་རྣམ་པར་ཤེས་༎ མི་རྟག་ཡོངས་སུ་སྟོན་པ་བཅོས་ལ་སྤྱོད་པ་སྟེ་༎
 pra(ti)varṇikāya carate aprajānamāno na hi dharma paṇḍita vināśa karoti jātu || rgs_5|1 ||	མཁས་པ་ནམ་ཡང་ཆོས་རྣམས་འཇིག་པར་མི་བྱེད་དོ་༎
 yasmin na rūpa api vedana cāpi saṃjñā vijñāna naiva na pi cetanayopalabdhiḥ |	གང་ལ་གཟུགས་མིན་ཚོར་མིན་འདུ་ཤེས་མི་དམིགས་ཤིང་༎
 anupādu śūnya na ya jānati sarvadharmān eṣā sa prajñavarapāramitāya caryā || rgs_5|2 ||	རྣམ་པར་ཤེས་པ་མ་ཡིན་སེམས་པ་མི་དམིགས་ལ་༎ ཆོས་ཀུན་སྐྱེ་མེད་སྟོང་པའི་ཚུལ་དུ་རབ་ཤེས་པ་༎ འདི་ནི་ཤེས་རབ་ཕ་རོལ་ཕྱིན་མཆོག་སྤྱོད་པ་ཡིན་༎
 yāvanti gaṅganadivālikatulyakṣetre tāvanti sattva arahanti vineya kaścit |	ལ་ལས་གངགའའི་ཀླུང་གི་བྱེ་སྙེད་ཞིང་རྣམས་ན་༎ སེམས་ཅན་ཇི་སྙེད་འཁོད་ཀུན་དགྲ་བཅོམ་ཉིད་བཏུལ་བས་༎
 yaścaiva prajña ima pāramitā likhitvā parasattvi pustaku dadeya viśiṣṭapuṇyaḥ || rgs_5|3 ||	གང་གིས་ཤེས་རབ་པ་རོལ་ཕྱིན་འདི་ཡིག་བྲིས་ཏེ་༎ སེམས་ཅན་མཆོག་ལ་གླེགས་བྱིན་བསོད་ནམས་ཁྱད་པར་འཕགས་༎
 kiṃ kāraṇaṃ ta iha śikṣita vādiśreṣṭhā gamayanti dharma nikhilāniha śūnyatāyām |	ཅི་ཕྱིར་ཞེ་ན་སྨྲ་མཆོག་དེ་དག་འདིར་བསླབ་ནས་༎
 yāṃ śrutva śrāvaka spṛśanti vimukti śīghraṃ pratyekabodhi spṛśayanti ca buddhabodhim || rgs_5|4 ||	ཆོས་རྣམས་མཐའ་དག་སྟོང་པ་ཉིད་དུ་འདིར་སྟོན་བྱེད་༎ དེ་དག་ཉན་ཐོས་མྱུར་དུ་རྣམ་པར་གྲོལ་ལ་རེག་། རང་རྒྱལ་བྱང་ཆུབ་དང་ནི་སངས་རྒྱས་བྱང་ཆུབ་རེག་།
 asato 'ṅkurasya drumasaṃbhavu nāsti loke kuta śākhapatraphalapuṣpaupādu tatra |	མྱུ་གུ་མེད་པར་འཇིག་རྟེན་སྡོང་བྱུང་ཡོད་མེད་ན་༎ དེ་ལ་ཡལ་འདབ་མེ་ཏོག་འབྲས་བུ་ག་ལ་འབྱུང་༎
 vina bodhicitta jinasaṃbhavu nāsti loke kuta śakrabrahmaphala śrāvakaprādubhāvaḥ || rgs_5|5 ||	བྱང་ཆུབ་སེམས་མེད་རྒྱལ་འབྱུང་འཇིག་རྟེན་ཡོད་མེད་ན་༎ འབྲས་བུ་བརྒྱ་བྱིན་ཚངས་པ་ཉན་ཐོས་ག་ལ་འབྱུང་༎ ཉི་མའི་དཀྱིལ་འཁོར་༄༡༩༤བ་གང་ཚེ་འོད་ཀྱི་དྲ་བ་འགྱེད་༎
 ādityamaṇḍalu yadā prabhajāla muñcī karmakriyāsu tada sattva parākramanti |	དེ་ཚེ་སེམས་ཅན་ལས་བྱེད་བརྩོན་པ་དེ་བཞིན་དུ་༎
 tatha bodhicitta sada lokavidusya jñāto jñānena sarvaguṇadharma samāgamanti || rgs_5|6 ||	མཁས་པ་ཤེས་ཕྱིར་འཇིག་རྟེན་བྱང་ཆུབ་སེམས་བྱུང་ན་༎ ཡེ་ཤེས་ཀྱིས་ནི་སེམས་ཅན་ཡོན་ཏན་ཆོས་དང་ལྡན༏་༏དཔེར་ན་མ་དྲོས་པ་ཡི་ཀླུ་བདག་མེད་གྱུར་ན་༎ འཛམ་བུའི་གླིང་འདིར་ཆུ་ཀླུང་འབབ་པ་ག་ལ་འགྱུར་༎
 yatha nopatapta asato bhujagādhipasya kuta nadyaprasravu bhavediha jambudvīpe |	ཆུ་ཀླུང་མེད་ན་མེ་ཏོག་འབྲས་བུ་འབྱུང་མི་འགྱུར་༎
 asatā nadīya phalapuṣpa na saṃbhaveyuḥ na ca sāgarāṇa ratanā bhavi naikarūpāḥ || rgs_5|7 ||	རྒྱ་མཚོ་ལ་ཡང་རིན་ཆེན་གཟུགས་མང་མེད་པར་འགྱུར་༎
 tatha bodhicitta asatīha tathāgatasya kuta jñānaprasravu bhavediha sarvaloke |	དེ་བཞིན་འདིར་ཡང་བྱང་ཆུབ་སེམས་མེད་བདེར་གཤེགས་ཀྱི་༎ ཡེ་ཤེས་འཇིག་རྟེན་འདི་དག་ཀུན་ཀྱང་ག་ལ་འབྱུང་༎
 jñānasya co asati nāsti guṇāna vṛddhiḥ na ca bodhi sāgarasamā na ca buddhadharmāḥ || rgs_5|8 ||	ཡེ་ཤེས་མེད་ན་ཡོན་ཏན་འཕེལ་མེད་བྱང་ཆུབ་མེད་༎ རྒྱ་མཚོ་འདྲ་བའི་སངས་རྒྱས་ཆོས་ཀྱང་མེད་པར་འགྱུར་༎
 yāvanti loki kvaci jotikaprāṇabhūtā obhāsanārtha prabha osarayanti sarve |	འཇིག་རྟེན་འདི་ན་སྣང་བྱེད་སྲོག་ཆགས་ཇི་སྙེད་པ་༎ ཀུན་གྱིས་སྣང་བར་བྱ་ཕྱིར་འོད་རྣམས་ཕྱུང་བ་བས་༎
 varasūryamaṇḍalaviniḥsṛta ekaraśmī na kalā pi jyotikagaṇe siya sarvaābhāḥ || rgs_5|9 || bhagavatyāṃ ratnaguṇasaṃcayagāthāyāṃ puṇyaparyāyaparivarto nāma pañcamaḥ ||	ཉི་མའི་དཀྱིལ་འཁོར་འོད་ཟེར་གཅིག་ཕྱུང་ཆེས་མཆོག་སྟེ་༎ སྣང་བྱེད་ཚོགས་ཀྱི་འོད་རྣམས་ཀུན་གྱིས་ཆར་མི་ཕོད་༎
 yāvanti śrāvakagaṇāḥ prasavanti puṇyaṃ dānaṃ ca śīlamapi bhāvanasaṃprayuktam |	ཉན་ཐོས་ཚོགས་རྣམས་ཇི་སྙེད་སྦྱིན་དང་ཚུལ་ཁྲིམས་དང་༎ བསྒོམ་དང་རབ་ཏུ་ལྡན་པའི་བསོད་ནམས་ཚོགས་བསྐྱེད་པའམ་༎ བྱང་ཆུབ་སེམས་དཔའི་རྗེས་སུ་ཡི་རང་སེམས་གཅིག་ལ་༎
 sa hi bodhisattva anumodana ekacitte na ca sarvaśrāvakagaṇe siya puṇyaskandho || rgs_6|1 ||	ཉན་ཐོས་ཚོགས་རྣམས་བསོད་ནམས་ཕུང་པོས་ཆར་མི་ཕོད་༎
 ye buddhakoṭiniyutā purimā vyatītā ye vā anantabahukṣetrasahasrakoṭayaḥ | tiṣṭhanti ye 'pi parinirvṛta lokanāthā deśanti dharmaratanaṃ dukhasaṃkṣayāya || rgs_6|2 ||	འདས་དུས་སྔོན་གྱི་སངས་རྒྱས་བྱེ་བ་ཁྲག་ཁྲིག་གང་༎ ཞིང་མང་མཐའ་ཡས་བྱེ་སྟོང་དག་ན་གང་བཞུགས་དང་༎ གང་ཡང་མྱ་ངན་འདས་པའི་འཇིག་རྟེན་མགོན་པོ་རྣམས་༎ སྡུག་བསྔལ་ཟད་པར་༄༡༩༥ཨ་༌༎ བྱ་ཕྱིར་རིན་ཆེན་ཆོས་སྟོན་པ་༎
 prathamaṃ upādu varabodhayi cittupādo yāvat su dharmakṣayakālu vināyakānām |	དང་པོ་བྱང་ཆུབ་མཆོག་ཏུ་སེམས་བསྐྱེད་བསྐྱེད་པ་ནས་༎ རྣམ་པར་འདྲེན་པ་རྣམས་ཀྱི་དམ་ཆོས་ཟད་ཀྱི་དུས་༎
 ekasmi tatra ciya teṣa jināna puṇyaṃ saha yukta pāramita ye 'pi ca buddhadharmāḥ || rgs_6|3 ||	དེ་བར་རྒྱལ་བ་དེ་དག་བསོད་ནམས་གང་ཡིན་པ་༎
 yaścaiva buddhatanayāna(ca) śrāvakāṇāṃ śaikṣa aśaikṣa kuśalāsrava nāsravāśca |	ཕ་རོལ་ཕྱིན་དང་ལྡན་དང་སངས་རྒྱས་ཆོས་གང་དང་༎ གང་ཡང་སངས་རྒྱས་སྲས་རྣམས་དང་ནི་ཉན་ཐོས་དང་༎ སློབ་དང་མི་སློབ་དགེ་བ་ཟག་བཅས་ཟག་མེད་པ་༎
 paripiṇḍayitva anumodayi bodhisattvo sarvaṃ ca nāmayi jagārthanidāna bodhi || rgs_6|4 ||	བསྡུས་དང་བྱང་ཆུབ་སེམས་དཔའ་རྗེས་སུ་ཡི་རང་ཞིང་༎ འགྲོ་བའི་དོན་རྒྱུ་བྱང་ཆུབ་ཕྱིར་ནི་ཐམས་ཅད་བསྔོ་༎
 pariṇāmayantu yadi vartati cittasaṃjñā tatha bodhisattvapariṇāmana sattvasaṃjñā |	ཡོངས་བསྔོ་གལ་ཏེ་སེམས་སུ་འདུ་ཤེས་འབྱུང་འགྱུར་ཞིང་༎
 saṃjñāya dṛṣṭisthitu citta trisaṅgayukto pariṇāmitaṃ na bhavatī upalabhyamānam || rgs_6|5 ||	བྱང་ཆུབ་འདུ་ཤེས་ཡོངས་བསྔོ་སེམས་ཅན་འདུ་ཤེས་ན་༎ འདུ་ཤེས་ཕྱིར་ན་ལྟ་གནས་སེམས་ནི་གསུམ་ལ་ཆགས་༎ དམིགས་པ་ཡོད་པས་ཡོངས་སུ་བསྔོས་པར་ཆུད་མ་ཡིན་༎
 saci eva jānati nirudhyati kṣīṇadharmā taccaita kṣīṇa pariṇāmayiṣyanti yatra |	གལ་ཏེ་འདི་ལྟར་ཆོས་འདི་འགག་ཅིང་ཟད་པ་དང་༎ གང་དུ་ཡོངས་སུ་བསྔོ་བ་དེ་ཡང་ཟད་པ་དང་༎ ཆོས་ཀྱིས་ཆོས་ལ་ནམ་ཡང་མི་བསྔོ་ཤེས་གྱུར་ན་༎
 na ca dharma dharmi pariṇāmayate kadācit pariṇāmitaṃ bhavati eva prajānamāne || rgs_6|6 ||	དེ་ལྟར་རབ་ཏུ་ཤེས་པས་ཡོངས་སུ་བསྔོས་པ་ཡིན་༎
 saci so nimitta kurute na ca mānayāti atha ānimitta pariṇāmita bhonti bodhau |	གལ་ཏེ་མཚན་མར་བྱེད་ན་དེ་ནི་བསྔོ་མ་ཡིན་༎ ཅི་སྟེ་མཚན་མ་མེད་ན་བྱང་ཆུབ་བསྔོ་བ་ཡིན་༎
 viṣasṛṣṭa bhojanu yathaiva kriyāpraṇīto tatha śukladharmaupalambha jinena ukto || rgs_6|7 ||	ཇི་ལྟར་དུག་དང་འདྲེས་པའི་ཁ་ཟས་བཟང་ཟ་བ་༎ དཀར་པོའི་ཆོས་ལ་དམིགས་པ་འང་དེ་འདྲར་རྒྱལ་བས་གསུངས་༎ དེ་ལྟས་འདི་ལྟར་ཡོངས་སུ་བསྔོ་བ་བསླབ་བྱ་སྟེ་༎
 tasmā hu nāmapariṇāmana śikṣitavyā yatha te jinā kuśala eva prajānayanti |	ཇི་ལྟར་རྒྱལ་བ་དེ་དག་དགེ་བ་དེ་མཁྱེན་པའི་༎
 yajjātiyo 'yaṃ prabhavo yadalakṣaṇaṃ ca anumodamī tatha tathā pariṇāmayāmi || rgs_6|8 ||	རྣམ་པ་གང་ཡིན་༄༡༩༥བ་འབྱུང་གང་མཚན་ཉིད་གང་ཡིན་ལ་༎ རྗེས་སུ་ཡི་རང་དེ་ལྟ་དེ་ལྟར་ཡོངས་སུ་བསྔོ་༎
 evaṃ ca puṇya pariṇāmayamāna bodhau na ca so hi buddha kṣipate jina uktavādī |	དེ་ལྟར་བསོད་ནམས་བྱང་ཆུབ་ཡོངས་སུ་བསྔོ་བྱེད་ན་༎ དུག་མེད་སངས་རྒྱས་མི་སྤོང་རྒྱལ་བས་གསུངས་པ་སྨྲ༏་༏དེ་ལྟར་ཡོངས་བསྔོ་དཔའ་བོ་འཇིག་རྟེན་དམིགས་ཅན་གྱིས་༎ 
 yāvanti loki upalambhikabodhisattvā abhibhonti sarvi pariṇāmayamāna śūro || rgs_6|9 || bhagavatyāṃ ratnaguṇasaṃcayagāthāyāmanumodanāparivarto nāma ṣaṣṭhamaḥ ||	བྱང་ཆུབ་སེམས་དཔའ་ཇི་སྙེད་ཐམས་ཅད་ཟིལ་གྱིས་ནོན་༎
 jātyandhakoṭiniyutānyaviunāyakānāṃ mārge akovidu kuto nagarapraveśe |	ད་མུས་ལོང་དམིགས་བུ་མེད་པ་བྱེ་བ་ཁྲག་ཁྲིག་རྣམས་༎ ལམ་ཡང་མི་ཤེས་གྲོང་ཁྱེར་འཇུག་པར་ག་ལ་འགྱུར་༎ ཤེས་རབ་མེད་ན་མིག་མེད་ཕ་རོལ་ཕྱིན་ལྔ་ནི་༎
 vina prajña pañca imi pāramitā acakṣuḥ avināyakā na prabhavanti spṛśetu bodhim || rgs_7|1 ||	དམིགས་བུ་མེད་པས་བྱང་ཆུབ་རེག་པར་ནུས་མ་ཡིན་༎
 yatrāntarasmi bhavate pragṛhīta prajñā tatu labdhacakṣu bhavatī imu nāmadheyam | yatha citrakarmapariniṣṭhita cakṣuhīno na ca tāva puṇyu labhate akaritva cakṣuḥ || rgs_7|2 ||	གང་ཚེ་ཤེས་རབ་ཀྱིས་ནི་རབ་ཏུ་ཟིན་གྱུར་པ༏་༏དེ་ཚེ་མིག་རྙེད་གྱུར་ཅིང་འདི་ཡི་མིང་ཐོབ་བོ་༎ དཔེར་ན་རི་མོའི་ལས་ནི་ཡོངས་ཟིན་མིག་མེད་པ་༎ ཇི་སྲིད་མིག་མ་བྲིས་པར་རྔན་པ་མི་ཐོབ་བཞིན་༎
 yada dharma saṃskṛta asaṃskṛta kṛṣṇaśuklo aṇumātru no labhati prajña vibhāvamānaḥ |	གང་ཚེ་འདུས་བྱས་འདུས་མ་བྱས་དང་དཀར་ནག་ཆོས་༎ ཤེས་རབ་རྣམ་པར་བཤིགས་ནས་རྡུལ་ཙམ་མི་དམིགས་ཚེ་༎
 yada prajñapāramita gacchati saṃkhya loke ākāśa yatra na pratiṣṭhitu kiṃci tatra || rgs_7|3 ||	འཇིག་རྟེན་དག་ན་ཤེས་རབ་ཕ་རོལ་ཕྱིན་གྲངས་འགྲོ་། ནམ་མཁའ་གང་ལའང་ཅུང་ཟད་མི་གནས་དེ་དང་འདྲ་༎ གལ་ཏེ་བདག་ནི་རྒྱལ་བའི་ཤེས་རབ་སྤྱད་བྱ་ཞིང་༎
 saci manyate ahu carāmi jināna prajñāṃ mociṣya sattvaniyutāṃ bahurogaspṛṣṭān |	སེམས་ཅན་སྡུག་བསྔལ་རེག་པ་ཁྲག་ཁྲིག་མང་དགྲོལ་སེམས་༎
 ayu sattvasaṃjñaparikalpaku bodhisattvo na ca eṣa prajñavarapāramitāya caryā || rgs_7|4 ||	སེམས་ཅན་འདུ་ཤེས་ཡོངས་རྟོག་བྱང་ཆུབ་སེམས་དཔའ་སྟེ་༎ དེ་ནི་ཤེས་རབ་ཕ་རོལ་ཕྱིན་མཆོག་སྤྱོད་མ་ཡིན་༎
 yo bodhisattva varapāramiteti cīrṇo paricārikā ya na ca kāṅkṣati paṇḍitehi |	བྱང་ཆུབ་སེམས་དཔའ་གང་ཞིག་སྔོན་ཆད་སྤྱོད་པའི་ཚེ་༎
 saha śrutva tasya puna bheṣyati śāstṛsaṃjñā so vā laghū anubudhiṣyati bodhi śāntām || rgs_7|5 ||	ཕ་རོལ་ཕྱིན་འདིར་སྤྱོད་པ་མཁས་པ་སོམ་ཉི་མེད་༎ ཐོས་མ་ཐག་ཏུ་དེ་ནི་སྟོན་པའི་འདུ་ཤེས་༄༡༩༦ཨ་༌༎ སྐྱེས༏་དེས་ན་བྱང་ཆུབ་ཞི་བ་མྱུར་དུ་རྟོགས་པར་འགྱུར་༎
 satkṛtya buddhaniyutāṃ paricārikāyāṃ na ca prajñapāramita śraddadhitā jinānām |	སྔོན་ཆད་ཚེ་ན་སངས་རྒྱས་ཁྲག་ཁྲིག་བཀུར་བྱས་ཀྱང་༎
 śrutvā ca so imu kṣipiṣyati so 'lpabuddhiḥ sa kṣipitva yāsyati avīcimatrāṇabhūto || rgs_7|6 ||	རྒྱལ་བའི་ཤེས་རབ་ཕ་རོལ་ཕྱིན་ལ་མ་དད་ན་༎ ཐོས་ནས་བློ་ཆུང་དེ་ཡིས་འདི་ནི་སྤོང་བྱེད་དེ་༎ སྤངས་ནས་སྐྱབས་མེད་གྱུར་པ་དེ་ནི་མནར་མེད་འགྲོ་།
 tasmā hu śraddadhata eva jināna mātāṃ yadi icchathā spṛśitu uttamabuddhajñānam |	དེ་ལྟ་བས་ན་གལ་ཏེ་སངས་རྒྱས་ཡེ་ཤེས་མཆོག་། རེག་པར་འདོད་ན་རྒྱལ་བའི་ཡུམ་འདིར་དད་པར་གྱིས་༎
 so vāṇijo yatha vrajitvana ratnadvīpaṃ mūlātu chedana karitva puna āgameyā || rgs_7|7 || bhagavatyāṃ ratnaguṇasaṃcayagāthāyāṃ nirayaparivarto nāma saptamaḥ ||	དཔེར་ན་ཚོང་པ་རིན་ཆེན་གླིང་དུ་སོང་ནས་ནི་༎ ཟོང་ཟད་སླར་ལོག་ལྟ་བུར་གྱུར་ན་མི་རུང་ངོ་༎
 rūpasya śuddhi phalaśuddhita veditavyā phalarūpaśuddhita sarvajñataśuddhimāhuḥ |	གཟུགས་ཀྱི་དག་པ་འབྲས་བུ་དག་པར་རིག་པར་བྱ་༎ འབྲས་བུ་གཟུགས་དག་ཐམས་ཅད་མཁྱེན་ཉིད་དག་པར་གསུངས་༎
 sarvajñatāya phalaśuddhita rūpaśuddhī ākāśadhātusamatāya abhinnachinnāḥ || rgs_8|1 ||	ཐམས་ཅད་མཁྱེན་ཉིད་འབྲས་བུ་དག་དང་གཟུགས་དག་པ་༎ ནམ་མཁའི་ཁམས་དང་མཚུངས་ཏེ་དབྱེར་མེད་གཅད་དུ་མེད༏་༏དཔའ་བོ་གར་སྤྱོད་ཤེས་རབ་ཕ་རོལ་ཕྱིན་པ་ཡིས་༎ ཁམས་གསུམ་ཡང་དག་འདས་ལ་རྣམ་པར་གྲོལ་བའང་མིན་༎
 traidhātukaṃ samatikrānta na bodhisattvā kleśāpanīta upapatti nidarśayanti |	ཉོན་མོངས་བསལ་བར་གྱུར་ཀྱང་སྐྱེ་བ་སྟོན་པར་བྱེད་༎
 jaravyādhimṛtyuvigatāścyuti darśayanti prajñāya pāramita yatra caranti dhīrāḥ || rgs_8|2 ||	རྒ་དང་ན་དང་འཆི་བ་མེད་ཀྱང་འཆི་འཕོ་སྟོན་༎
 nāmeva rūpi jagatī ayu paṅkasaktā saṃsāracakri bhramate 'nilacakratulye | jānitva bhrāntu jagatī mṛgavāgureva ākāśa pakṣisadṛśā vicaranti prajñāḥ || rgs_8|3 ||	འགྲོ་བ་འདི་དག་མིང་དང་གཟུགས་ཀྱི་འདམ་ལ་ཆགས་༎ རླུང་གི་འཁོར་ལོ་ལྟ་བུའི་འཁོར་བའི་འཁོར་ལོར་འཁྱམས་༎ འགྲོ་བ་འཁྲུལ་པ་རི་དབ༹གས་རྒྱར་ཚུད་འདྲར་ཤེས་ནས་༎
 rūpasmi yo na carate pariśuddhacārī vijñāna saṃjña api vedana cetanāyām |	ཤེས་རབ་ལྡན་པ་མཁའ་ལ་བྱ་བཞིན་རྣམ་པར་རྒྱུ་༎ སྤྱོད་པ་ཡོངས་དག་གང་ཞིག་གཟུགས་ལ་མི་སྤྱོད་ཅིང་༎ རྣམ་ཤེས་འདུ་ཤེས་ཚོར་༄༡༩༦བ་བ་སེམས་པར་མི་སྤྱོད་ན་༎
 evaṃ carantu parivarjayi sarvasaṅgāṃ saṅgādvimucya carate sugatāna prajñām || rgs_8|4 || bhagavatyāṃ ratnaguṇasaṃcayagāthāyāṃ viśuddhiparivarto nāmāṣṭamaḥ ||	དེ་ལྟར་སྤྱོད་པ་ཆགས་པ་ཐམས་ཅད་ཡོངས་སྤོང་ཞིང་༎
 evaṃ carantu vidu paṇḍitu bodhisattvo saṅgā uchinnu vrajate jagatī asakto |	ཆགས་ལས་རྣམ་གྲོལ་བདེ་གཤེགས་རྣམས་ཀྱི་ཤེས་རབ་སྤྱོད་༎ དེ་ལྟར་སྤྱོད་པའི་བྱང་ཆུབ་སེམས་དཔའ་མཁས་གསལ་བ་༎ ཆགས་པ་བཅད་ནས་འགྲོ་ལ་ཆགས་པ་མེད་པར་འགྲོ་།
 sūryo va rāhugrahamukta virocamāno agnīva yukta tṛṇakāṣṭhavanaṃ dahāti || rgs_9|1 ||	ཉི་མ་སྒྲ་གཅན་གཟའ་བྲལ་ལྷང་ངེར་འདུག་པ་དང་༎ མེ་བཏང་རཙབ༹་དང་ཤིང་དང་ནགས་ཚལ་སྲེག་པ་བཞིན་༎
 prakṛtīya śuddha pariśuddhimi sarvadharmāṃ prajñāya pāramita paśyati bodhisattvo |	ཆོས་རྣམས་ཐམས་ཅད་རང་བཞིན་དག་ཅིང་ཡོངས་དག་པར་༎
 na ca paśyakaṃ labhati nāpi ca sarvadharmān eṣā sa prajñavarapāramitāya caryā || rgs_9|2 || bhagavatyāṃ ratnaguṇasaṃcayagāthāyāṃ stutiparivarto nāma navamaḥ ||	བྱང་ཆུབ་སེམས་དཔའ་ཤེས་རབ་ཕ་རོལ་ཕྱིན་ལྟ་ན་༎ བྱེད་པ་པོ་ཡང་མི་དམིགས་ཆོས་ཀུན་མི་དམིགས་ཏེ་༎ འདི་ནི་ཤེས་རབ་ཕ་རོལ་ཕྱིན་མཆོག་སྤྱོད་པ་ཡིན་༎
 śakro jinasya paripṛcchati devarājo caramāṇa prajña katha yujyati bodhisattvo | aṇumātra yo na khalu yujyati skandhadhātau yo eva yujyati(sa yujyati) bodhisattvaḥ || rgs_10|1 ||	རྒྱལ་བ་ལ་ནི་ལྷ་རྒྱལ་བརྒྱ་བྱིན་གྱིས་ཞུས་པ་༎ བྱང་ཆུབ་སེམས་དཔའ་ཤེས་རབ་སྤྱོད་པ་ཇི་ལྟར་བརྩོན་༎
 cirayānaprasthitu sa vedayitavya sattvo bahubuddhakoṭinayutehi kṛtādhikāro |	ཕུང་པོ་ཁམས་ལ་རྡུལ་ཙམ་བརྩོན་པར་མི་བྱེད་ཅིང་༎
 yo śrutva dharmi imi nirmitamāyakalpāṃ na ca kāṅkṣate ayu prayujyati śikṣamāṇaḥ || rgs_10|2 ||	ཕུང་པོར་མི་བརྩོན་དེ་ནི་བྱང་ཆུབ་སེམས་དཔའི་བརྩོན་༎ གང་ཞིག་ཆོས་འདི་སྤྲུལ་དང་སྒྱུ་མ་འདྲར་ཤེས་ནས་༎ སོམ་ཉི་མེད་ཅིང་སློབ་ལ་ཕྱིར་ཞིང་སྦྱོར་བྱེད་པ་༎ སེམས་ཅན་དེ་ནི་རིང་ནས་ཐེག་ཆེན་ཞུགས་རིག་བྱ༏་༏སངས་རྒྱས་བྱེ་བ་ཁྲག་ཁྲིག་མང་ལ་ལྷག་བྱས་ཡིན་༎ 
 kāntāramārgi puruṣo bahu(bhī)	དགོན་པའི་ལམ་ནི་དཔག་ཚད་མང་པོར་ཞུགས་པའི་མིས་༎
 janehi gopāla sīma vanasaṃpada paśyate yo |	གནག་རྫི་མཚམས་ཀྱི་ནགས་ཚལ་ཕུན་སུམ་ཚོགས་མཐོང་ན་༎
 āśvāsaprāpta bhavatī na ca tasya trāso abhyāśa grāmanagarāṇa ime nimittāḥ || rgs_10|3 ||	དེ་དག་གྲོང་དང་གྲོང་ཁྱེར་ཉེ་བའི་རྟགས་སྙམ་སྟེ་༎ དབུགས་ཕྱིན་རྙེད་པར་གྱུར་ཅིང་ཆོམ་རྐུན་འཇིགས་པ་མེད་༎
 emeva prajñavarapāramitā jinānāṃ śṛṇu tāta yo labhati bodhi gaveṣamāṇaḥ |	དེ་བཞིན་བྱང་ཆུབ་ཡོངས་སུ་ཚོལ་ཚེ་རྒྱལ་རྣམས་ཀྱི་༎ ཤེས་རབ་ཕ་རོལ་༄༡༩༧ཨ་༌༎ ཕྱིན་འདི་མཉན་པ་གང་ཐོབ་པ་༎
 āśvāsaprāpta bhavatī na ca tasya trāso nārhantabhūmi na pi pratyayabuddhabhūmī || rgs_10|4 ||	དེ་ནི་དབུགས་ཕྱིན་ཐོབ་པར་གྱུར་ཅིང་འཇིགས་མེད་དེ་༎ དགྲ་བཅོམ་ས་ལ་མ་ཡིན་རྐྱེན་རྟོགས་ས་ལ་མིན་༎
 puruṣo hi sāgarajalaṃ vraji paśyanāya saci paśyate drumavanaspatiśailarājam |	མི་ཞིག་རྒྱ་མཚོའི་ཆུ་ནི་བལྟ་ཕྱིར་འགྲོ་བ་ཡིས་༎ གལ་ཏེ་ཤིང་དང་ནགས་ཚལ་རི་མཐོང་ད་རུང་རིང་༎ ཅི་སྟེ་རྟགས་མ་མཐོང་ན་རྒྱ་མཚོ་ཆེན་པོ་ནི་༎
 athavā na paśyati nimitta nikāṅkṣa bhoti a(bhyāśa) to mahasamudra na so 'tidūre || rgs_10|5 ||	ཉེ་བར་གྱུར་ཏོ་སྙམ་སྟེ་དེ་ལ་སོམ་ཉི་མེད་༎
 emeva bodhivaraprasthitu veditavyo śruṇamāṇa prajña imi pāramitā jinānām |	དེ་ལྟར་བྱང་ཆུབ་དམ་པར་རབ་ཞུགས་རྒྱལ་བ་ཡི་༎ ཤེས་རབ་ཕ་རོལ་ཕྱིན་པ་འདི་ཉན་རིག་པར་བྱ་༎
 yadyāpi saṃmukha na vyākṛtu nāyakeno tathapi spṛśiṣyati nacireṇa hu buddhabodhim || rgs_10|6 ||	རྣམ་པར་འདྲེན་པས་མངོན་སུམ་ལུང་བསྟན་མ་གྱུར་ཀྱང་༎ སངས་རྒྱས་བྱང་ཆུབ་རིང་པོར་མི་ཐོགས་བདག་རེག་འགྱུར་༎ དཔྱིད་དུས་བཟང་ལ་སྡོང་པོ་ལོ་མ་ལྷགས་གྱུར་ན་༎
 suvasanti kāli patite tṛṇapatraśākhā nacireṇa patraphalapuṣpa samāgamanti |	ཡལ་གས་རིང་པོར་མི་ཐོགས་ལོ་འབྲས་མེ་ཏོག་སྐྲུན་༎
 prajñāya pāramita yasyimu hastaprāptā nacireṇa bodhivara prāpsyati nāyakānām || rgs_10|7 ||	ཤེས་རབ་ཕ་རོལ་ཕྱིན་འདི་སུ་ཡི་ལག་ཐོབ་པ་༎ རིང་པོར་མི་ཐོགས་འདྲེན་པ་རྣམས་ཀྱི་བྱང་ཆུབ་འཐོབ་༎
 yatha istri gurviṇi ya ceṣṭati vedanābhi jñātavyu kālu ayamasya prajāyanāya |	དཔེར་ན་བུད་མེད་སྦྲུམ་གང་སྡུག་བསྔལ་ཉེན་གྱུར་ན་༎ དེ་ནི་དེ་ཡི་བཙའ་བའི་དུས་ལ་བབ་ཅེས་བྱ་༎
 tatha bodhisattva śruṇamāṇu jināna prajñāṃ rati chanda vīkṣati spṛśiṣyati bodhi śīghram || rgs_10|8 ||	དེ་བཞིན་བྱང་ཆུབ་སེམས་དཔའ་རྒྱལ་བའི་ཤེས་རབ་ཉན་༎ དགའ་དང་འདུན་པ་སྐྱེད་པ་མྱུར་དུ་བྱང་ཆུབ་རེག་།
 caramāṇu prajñavarapāramitāya yogī na ca rūpavṛddhi na ca paśyati pārihāṇim |	ཤེས་རབ་ཕ་རོལ་ཕྱིན་མཆོག་སྤྱོད་ཚེ་རྣལ་འབྱོར་པ་༎ གཟུགས་ཀྱི་འཕེལ་བ་དང་ནི་ཡོངས་སུ་འགྲིབ་མི་མཐོང་༎
 dharmā adharma imu paśyati dharmadhātuṃ na ca nirvṛtiṃ spṛśati so viharāti prajñām || rgs_10|9 ||	གང་ཞིག་ཆོས་དང་ཆོས་མིན་ཆོས་དབྱིངས་མི་མཐོང་ཞིང་༎ མྱ་ངན་འདས་ལ་མི་རེག་དེ་ནི་ཤེས་རབ་གནས་༎
 caramāṇu yo na iha kalpayi buddhadharmāṃ bala ṛddhipāda na ca kalpayi bodhi śāntām |	གང་ཞིག་འདིར་སྤྱོད་སངས་རྒྱས་ཆོས་རྣམས་མི་རྟོག་སྟེ་༎ སྟོབས་དང་༄༡༩༧བ་རྫུ་འཕྲུལ་རྐང་པ་བྱང་ཆུབ་ཞི་མི་རྟོག་། རྣམ་པར་མི་རྟོག་རྟོག་བྲལ་བྱིན་གྱི་རླབས་ཀྱིས་སྤྱོད་༎
 avikalpakalpavigato 'dhiṣṭhānacārī eṣā sa prajñavarapāramitāya caryā || rgs_10|10 || bhagavatyāṃ ratnaguṇasaṃcayagāthāyāṃ dhāraṇīguṇaparivarto nāma daśamaḥ ||	འདི་ནི་ཤེས་རབ་ཕ་རོལ་ཕྱིན་མཆོག་སྤྱོད་པ་ཡིན་༎
 buddhaṃ subhūti paripṛcchati vādicandraṃ kyantantarāyu bhaviṣyanti guṇe ratānām |	སྨྲ་བའི་ཟླ་བ་སངས་རྒྱས་ལ་ནི་རབ་འབྱོར་ཞུས༏་༏ཡོན་ཏན་དགའ་བ་རྣམས་ཀྱི་བར་དུ་གཅོད་གང་ལགས་༎ སྟོན་པས་བཀའ་སྩལ་བར་དུ་གཅོད་པར་འགྱུར་མང་སྟེ་༎
 bahu antarāyu bhaviṣyanti bhaṇāti śāsta tatu alpamātra parikīrtayiṣyāmi tāvat || rgs_11|1 ||	དེ་ལས་རེ་ཞིག་ཅུང་ཟད་ཙམ་ཞིག་ཡོངས་སུ་བརྗོད་༎
 pratibhāna neka vividhāni upapadyiṣyanti likhamāna prajña imu pāramitā jinānām |	རྒྱལ་བའི་ཤེས་རབ་ཕ་རོལ་ཕྱིན་འདི་ཡིག་འབྲི་ཚེ་༎ སྤོབས་པ་ཐ་དད་རྣམ་པ་དུ་མ་འབྱུང་འགྱུར་ཞིང་༎ འགྲོ་བའི་དོན་མ་བྱས་པར་གློག་བཞིན་མྱུར་དུ་ཡང་༎ ཡོངས་སུ་ཉམས་པར་འགྱུར་བ་འདི་ནི་བདུད་ཀྱི་ལས་༎ འདི་བཤད་ཚེ་ན་ཁ་ཅིག་སོམ་ཉི་ཟ་འགྱུར་ཏེ་༎
 yuta śīghra vidyuta yathā parihāyiṣyanti akaritva artha jagatī imu mārakarma || rgs_11|2 || kāṅkṣā ca keṣaci bhaviṣyati bhāṣamāṇe na mamātra nāma parikīrtitu nāyakena |	འདྲེན་པས་འདིར་ནི་བདག་གི་མིང་ཡང་ཡོངས་མ་བརྗོད་༎
 na ca jāti bhūmi parikīrtitu nāpi gotraṃ na ca so śruṇiṣyati kṣipiṣyati mārakarma || rgs_11|3 ||	རིགས་དང་ས་དང་རུས་ཀྱང་ཡོངས་སུ་མ་བརྗོད་ཅེས་༎ དེ་ནི་ཉན་པར་མི་འགྱུར་སྤོང་འགྱུར་བདུད་ཀྱི་ལས་༎ དེ་ལྟར་མི་ཤེས་དེ་དག་རྩ་བ་བོང་ནས་ནི་༎
 evaṃ ta mūlamapahāya ajānamāno śākhāpalāśa parieṣayiṣyanti mūḍhāḥ |	རྨོངས་པས་ཡལ་ག་དག་དང་འདབ་མ་ཚོལ་བར་འགྱུར་༎
 hastiṃ labhitva yatha hastipadaṃ gaveṣe tatha prajñapāramita śrutva sūtrānta eṣet || rgs_11|4 ||	གླང་པོ་རྙེད་ཀྱང་གླང་པོའི་རྗེས་ནི་ཚོལ་བ་ལྟར་༎ ཤེས་རབ་ཕ་རོལ་ཕྱིན་ཐོས་མདོ་ཚོལ་དེ་བཞིན་ནོ་༎ དཔེར་ན་ལ་ལས་རོ་བརྒྱ་ལྡན་པའི་ཟས་རྙེད་ལ་༎
 yatha bhojanaṃ śatarasaṃ labhiyāna kaścit mārgeṣu ṣaṣṭiku labhitva sa bhojanāgryam |	ཟས་མཆོག་རྙེད་ནས་ཟས་ངན་ཚོལ་བར་བྱེད་པ་ལྟར་༎
 tatha bodhisattva ima pāramitāṃ labhitvā (a) rhantabhūmi(ta) gaveṣayiṣyanti bodhim || rgs_11|5 ||	བྱང་ཆུབ་སེམས་དཔའ་ཕ་རོལ་ཕྱིན་པ་འདི་རྙེད་ནས་༎ དགྲ་བཅོམ་ས་ཡིས་བྱང་ཆུབ་ཚོལ་བྱེད་དེ་བཞིན་ནོ་༎
 satkārakāma bhaviṣyanti ca lābhakāmāḥ sāpekṣacitta kulasaṃstavasaṃprayuktāḥ |	བསྟི་སྟང་འདོད་པར་འགྱུར་ཞིང་རྙེད་པ་འདོད་འགྱུར་དང་༎ ལྟ་དང་བཅས་པའི་སེམས་ཀྱིས་ཁྱིམ་འདྲིས་བྱེད་ལྡན་༄༡༩༨ཨ་༌༎ ཞིང་༎
 choritva dharma kariṣyanti adharmakāryaṃ patha hitva utpathagatā ima mārakarma || rgs_11|6 ||	ཆོས་བཏང་ནས་ནི་ཆོས་མིན་བྱ་བ་སྤྱོད་འགྱུར་བ་༎ ལམ་བོར་ལམ་གོལ་འགྲོ་བ་འདི་ནི་བདུད་ཀྱི་ལས་༎
 ye cāpi tasmi samaye imu dharma śreṣṭhaṃ śruṇanāya chandika utpādayiṣyanti śraddhām |	གང་དག་དེ་ཡི་ཚེ་ན་འདུན་ཅིང་དད་གྱུར་ནས་༎ ཆོས་ཀྱི་དམ་པ་འདི་ནི་ཉན་དུ་སོང་བ་ལས་༎ དེ་དག་གིས་ནི་ཆོས་སྨྲ་བྱ་བ་ལྡན་རིག་ནས་༎
 te dharmabhāṇaka viditvana kāryayuktaṃ premāpanīta gamiṣyanti sudurmanāśca || rgs_11|7 ||	དགའ་བ་མེད་ཅིང་ཡིད་མི་བདེ་བར་གྱུར་ནས་འགྲོ་༎
 imi mārakarma bhaviṣyanti ya tasmi kāle anye ca neka vividhā bahu antarāyā | yehī samākulikṛtā bahu bhikṣu tatra prajñāya pāramita etu na dhārayanti || rgs_11|8 ||	དེ་ཡི་ཚེ་ན་བདུད་ཀྱི་ལས་འདི་འབྱུང་བར་འགྱུར༏་༏དེ་ཚེ་གང་དག་གིས་ནི་དགེ་སློང་མང་དཀྲུགས་ནས་༎ ཤེས་རབ་ཕ་རོལ་ཕྱིན་འདི་འཛིན་པར་མི་འགྱུར་བའི་༎ བར་དུ་གཅོད་པ་རྣམ་མང་གཞན་ཡང་འབྱུང་བར་འགྱུར་༎
 ye te bhavanti ratanā ya anarghaprāptā te durlabhā bahupratyarthika nityakālam |	རིན་ཆེན་རིན་ཐང་མེད་པ་རྙེད་གྱུར་གང་དག་ཡིན་༎ དེ་དག་དཀོན་ལ་དུས་རྣམས་རྟག་ཏུ་འཚེ་བའང་མང་༎ དེ་བཞིན་རྒྱལ་བའི་ཤེས་རབ་ཕ་རོལ་ཕྱིན་པ་མཆོག་།
 emeva prajñavarapāramitā jinānāṃ durlābhu dharmaratanaṃ baddupadravaṃ ca || rgs_11|9 ||	རིན་ཆེན་ཆོས་ཀྱང་དཀོན་ལ་རྟག་ཏུ་འཚེ་བའང་མང་༎
 navayānaprasthita sa sattva parīttabuddhiḥ ya imaṃ durlābhu dharmaratanaṃ parāpuṇanti |	ཐེག་པར་གསར་དུ་ཞུགས་པའི་སེམས་ཅན་བློ་ཆུང་བ་༎ གང་ཞིག་དཀོན་པའི་རིན་ཆེན་འདི་ནི་མ་རྙེད་ན་༎ དེ་ལ་བར་ཆད་བྱ་ཕྱིར་བདུད་ནི་སྤྲོ་བར་འགྱུར་༎
 māro 'tra utsuku bhaviṣyati antarāye buddhā daśaddiśi parigrahasaṃprayuktāḥ || rgs_11|10 || bhagavatyāṃ ratnaguṇasaṃcayagāthāyāṃ mārakarmaparivarto nāmaikādaśamaḥ ||	ཕྱོགས་བཅུའི་སངས་རྒྱས་དེ་དག་ཡོངས་སུ་འཛིན་ལ་སྦྱོར་༎
 mātrāya putra bahu santi gilāni kāye te sarvi durmanasa tatra prayujyayeyuḥ |	མ་ཞིག་ན་བར་གྱུར་ལ་བུ་ནི་མང་ཡོད་པ་༎ དེ་ཀུན་ཡིད་མི་བདེ་ཞིང་དེ་ལ་རིམ་གྲོ་བྱེད་༎ དེ་བཞིན་ཕྱོགས་བཅུའི་འཇིག་རྟེན་ཁམས་ཀྱི་སངས་རྒྱས་ཀྱང་༎ ཡུམ་གྱུར་ཤེས་རབ་དམ་པ་འདི་ལ་དགོངས་པ་མཛད་༎
 emeva buddha(piṃ) daśaddiśi lokadhātau ima prajñapāramita mātra samanvāharanti || rgs_12|1 || ye 'tīta ye 'pi ca daśaddiśi lokanāthā itu te prasūta bhaviṣyantyanāgatāśca |	གང་དག་འདས་དང་ཕྱོགས་བཅུའི་འཇིག་རྟེན་མགོན་གང་དང་༎ མ་འོངས་དུས་ན་འབྱུང་འགྱུར་དེ་དག་འདི་༄༡༩༨བ་ལས་འབྱུང་༎
 loka(sya) darśika janetri jināna mātā parasattvacittacaritāna nidarśitā(kā) ca || rgs_12|2 ||	འཇིག་རྟེན་སྟོན་པ་རྒྱལ་བ་རྣམས་ཀྱི་སྐྱེད་བྱེད་ཡུམ་༎ སེམས་ཅན་གཞན་དང་སེམས་ཀྱི་སྤྱོད་པ་སྟེན་པར་བྱེད་༎
 lokasya yā tathata yā tathatārhatānāṃ |	འཇིག་རྟེན་དེ་བཞིན་ཉིད་དང་དགྲ་བཅོམ་དེ་བཞིན་ཉིད་༎
 pratyekabuddhatathatā tathatā jinānām |	རང་རྒྱལ་དེ་བཞིན་ཉིད་དང་རྒྱལ་སྲས་དེ་བཞིན་ཉིད་༎
 ekaiva bhāvavigatā tathatā ananyā prajñāya pāramita buddha tathāgatena || rgs_12|3 ||	གཅིག་པ་ཉིད་དེ་དངོས་བྲལ་གཞན་མིན་དེ་བཞིན་ཉིད་༎ ཤེས་རབ་ཕ་རོལ་ཕྱིན་པ་དེ་བཞིན་གཤེགས་པས་མཁྱེན་༎ མཁས་པ་འཇིག་རྟེན་གནས་སམ་མྱ་ངན་འདས་ཀྱང་རུང་༎
 tiṣṭhantu lokavidunāṃ parinirvṛtānāṃ [sthita eṣa dharmataniyāma śūnyadharmā |	ཆོས་ཉིད་སྐྱོན་མེད་ཆོས་རྣམས་སྟོང་པ་འདི་གནས་ཏེ་༎ བྱང་ཆུབ་སེམས་དཔས་དེ་བཞིན་ཉིད་འདི་རྗེས་སུ་རྟོགས་༎
 tāṃ bodhisattva tathatāmanubuddhayanti tasmā hu buddha kṛta nāma tathāgatebhiḥ || rgs_12|4 ||	དེ་ཕྱིར་དེ་བཞིན་གཤེགས་ཞེས་སངས་རྒྱས་མཚན་གསོལ་ཏོ་༎
 ayu gocaro daśabalāna vināyakānāṃ] prajñāya pāramita ramyavanāśritānām |	ཤེས་རབ་ཕ་རོལ་ཕྱིན་པའི་དགའ་ཚལ་ལ་བརྟེན་པ་༎ སྟོབས་བཅུ་རྣམ་འདྲེན་རྣམས་ཀྱི་སྤྱོད་ཡུལ་འདི་ཡིན་ཏེ་༎
 dukhitāṃśca sattva triapāya samuddharanti na pi sattvasaṃjña api teṣu kadāci bhoti || rgs_12|5 ||	སེམས་ཅན་སྡུག་བསྔལ་ངན་སོང་གསུམ་ལས་ཡོངས་འདོན་ཀྱང་༎ དེ་དག་ནམ་ཡང་སེམས་ཅན་འདུ་ཤེས་འགྱུར་བ་མེད་༎
 siṃho yathaiva girikandari niśrayitvā nadate achambhi mṛga kṣudraka trāsayanto |	དཔེར་ན་སེངགེ་རི་སུ་ལ་བརྟེན་ནས་འཇིགས་མེད་པར་༎ རི་དབ༹གས་ཕྲ་མོ་མང་སྐྲག་བྱེད་ཅིང་སྒྲ་སྒྲོག་ལྟར་༎
 tatha prajñapāramitaniśraya narāṇa siṃho nadate achambhi pṛthutīrthika trāsayanto || rgs_12|6 ||	མི་ཡི་སེངགེ་ཤེས་རབ་ཕ་རོལ་ཕྱིན་བརྟེན་ནས་༎ མུ་སྟེགས་ཅན་མང་སྐྲག་བྱེད་འཇིག་རྟེན་སྒྲ་ཡང་སྒྲོག་།
 ākāśaniśrita yathaiva hi sūrya[raśmi] tāpetimāṃ dharaṇi darśayate ca rūpam |	དཔེར་ན་ནམ་མཁར་གནས་པའི་ཉི་མའི་འོད་ཟེར་ནི་༎ ས་འདི་སྐེམ་པར་བྱེད་ཅིང་གཟུགས་ཀྱང་རབ་ཏུ་སྟོན་༎ དེ་བཞིན་ཆོས་རྒྱལ་ཤེས་རབ་ཕ་རོལ་ཕྱིན་བརྟེན་པ་༎
 tatha prajñapāramitaniśrita dharmarājo tāpeti tṛṣṇanadi dharma nidarśayāti || rgs_12|7 ||	སྲེད་པའི་ཆུ་ཀླུང་སྐེམ་ཞིང་ཆོས་ཀྱང་རབ་ཏུ་སྟོན་༎
 rūpasya darśanu adarśanu vedanāye saṃjñāya darśanu adarśanu cetanāye |	གཟུགས་རྣམས་མི་མཐོང་ཚོར་བ་དག་ཀྱང་མི་མཐོང་ཞིང་༎ འདུ་ཤེས་༄༡༩༩ཨ་༌༎ མཐོང་བ་མེད་ལ་སེམས་པ་མི་མཐོང་ཞིང་༎
 vijñānacittamanudarśanu yatra nāsti aya dharmadarśanu nidiṣṭu tathāgatena || rgs_12|8 ||	གང་ལ་རྣམ་པར་ཤེས་དང་སེམས་ཡིད་མཐོང་མེད་པ་༎ འདི་ནི་ཆོས་མཐོང་ཡིན་ཞེས་དེ་བཞིན་གཤེགས་པས་བསྟན་༎
 ākāśa dṛṣṭu iti sattva pravyāharanti nabhadarśanaṃ kutu vimṛṣyatha etamartham | tatha dharmadarśanu nidiṣṭa tathāgatena na hi darśanaṃ bhaṇitu śakya nidarśanena || rgs_12|9 || bhagavatyāṃ ratnaguṇasaṃcayagāthāyāṃ lokasaṃdarśanaparivarto nāma dvādaśamaḥ ||	ནམ་མཁའ་མཐོང་ཞེས་སེམས་ཅན་ཚིག་ཏུ་རབ་བརྗོད་པ་༎ ནམ་མཁའ་ཇི་ལྟར་མཐོང་ཞེས་དོན་འདི་བརྟག་པར་གྱིས་༎ དེ་ལྟར་ཆོས་མཐོང་བ་ཡང་དེ་བཞིན་གཤེགས་པས་བསྟན་༎ མཐོང་བ་དཔེར་གཞན་གྱིས་ནི་བསྙད་པར་ནུས་མ་ཡིན་༎
 yo eva paśyati sa paśyati sarvadharmān sarvānamātyakiriyā ti upekṣya rājā |	གང་གིས་དེ་ལྟར་མཐོང་བ་དེ་ཡིས་ཆོས་ཀུན་མཐོང་༎ རྒྱལ་པོ་བཏང་སྙོམས་འདུག་ཅིང་བློན་པོ་ཀུན་བྱེད་ལྟར་༎
 yāvanti buddhakriya dharmata śrāvakāṇāṃ prajñāya pāramita sarva karoti tāni || rgs_13|1 ||	སངས་རྒྱས་མཛད་དང་ཉན་ཐོས་ཆོས་རྣམས་ཇི་སྙེད་པ་༎ དེ་དག་ཐམས་ཅད་ཤེས་རབ་ཕ་རོལ་ཕྱིན་པ་བྱེད་༎
 na ca rāja grāma vrajate na ca rājyarāṣṭrān sarvaṃ ca ādadati so viṣayātu āyam |	རྒྱལ་པོ་གྲོང་དུ་མི་འགྲོ་ཡུལ་འཁོར་མི་འགྲོ་བར་༎ རང་གི་ཡུལ་ན་འདུ་བ་ཐམས་ཅད་སྡུད་པ་ལྟར་༎
 na ca bodhisattva calate kvaci dharmatāyāṃ sarvāṃśca ādadati ye guṇa buddhadharme || rgs_13|2 || bhagavatyāṃ ratnaguṇasaṃcayagāthāyāmacintyaparivarto nāma trayodaśamaḥ ||	བྱང་ཆུབ་སེམས་དཔའི་ཆོས་ཉིད་གང་དུའང་མི་འགྲོ་ལ་༎ སངས་རྒྱས་ས་ཡི་ཡོན་ཏན་གང་ཡིན་ཐམས་ཅད་སྡུད་༎ གང་ལ་བདེ་གཤེགས་བྱང་ཆུབ་སེམས་དཔའ་དད་བརྟན་ཡོད་༎
 yasyāmi śraddha sugate dṛḍha bodhisattvo varaprajñapāramitaāśayasaṃprayogo |	ཤེས་རབ་ཕ་རོལ་ཕྱིན་པ་མཆོག་ལ་བསམ་སྦྱོར་བ་༎ ཉན་ཐོས་རང་རྒྱལ་ས་གཉིས་ཤིན་ཏུ་འདས་བྱས་ནས་༎
 atikramya bhūmidvaya śrāvakapratyayānāṃ laghu prāpsyate anabhibhū(tu) jināna bodhim || rgs_14|1 ||	ཟིལ་གྱིས་མི་ནོན་རྒྱལ་བའི་བྱང་ཆུབ་མྱུར་དུ་འཐོབ་༎
 sāmudriyāya yatha nāvi praluptikāye bhṛtakaṃ manuṣya tṛṇakāṣṭhamagṛhṇamāno |	དཔེར་ན་རྒྱ་མཚོར་འཇུག་པའི་གྲུ་ནི་ཆག་གྱུར་ལ་༎ མི་གང་རོ་འམ་རཙབ༹་འམ་ཤིང་ནི་མི་འཛིན་པ་༎ ཆུ་དབུས་འཇིགས་པར་འགྱུར་ཏེ་ངོགས་སུ་ཕྱིན་མི་འགྱུར་༎
 vilayaṃ prayāti jalamadhya aprāptatīro yo gṛhṇate vrajati pārasthalaṃ prayāti || rgs_14|2 ||	གང་ཞིག་འཛིན་པ་རྒྱ་མཚོའི་ཕ་རོལ་ཕྱིན་པར་འགྱུར་༎ ༄༡༩༩བ་དེ་ལྟར་དད་ལྡན་དང་བ་ཐོབ་པ་གང་ཞིག་ནི་༎ ཤེས་རབ་ཕ་རོལ་ཕྱིན་ཡུམ་རྗེས་སུ་མི་འཇུག་མིན་༎
 emeva śraddhasaṃgato ya prasādaprāpto prajñāya pāramita mātra vivarjayanti | saṃsārasāgara tadā sada saṃsaranti jātījarāmaraṇaśokataraṃgabhaṅge || rgs_14|3 || ye te bhavanti varaprajñaparigṛhītā bhāvasvabhāvakuśalā paramārthadarśī |	དེ་དག་ཐབས་ཀྱི་ཡོན་ཏན་ཤེས་རབ་ཡོངས་ཟིན་ན་༎
 te puṇyajñānadhanasaṃbhṛtayānapātrāḥ paramādbhutāṃ sugatabodhi spṛśanti śīghram || rgs_14|4 || ghaṭake apakvi yatha vāri vaheya kācit jñātavyu kṣipra ayu bhetsyati durbalatvāt |	མཆོག་ཏུ་རྨད་བྱུང་བདེ་གཤེགས་བྱང་ཆུབ་མྱུར་དུ་རེག་།
 paripakvi vāri ghaṭake vahamānu mārge na ca bhedanādbhayamupaiti ca svasti geham || rgs_14|5 ||	དཔེར་ན་ལ་ལས་རྫ་སོ་མ་བཏང་ཆུ་སྐྱེད་ན་༎ ཉམ་ཆུང་ཕྱིར་ནི་མྱུར་དུ་འཇིག་པར་རིག་པར་བྱ་༎ སོ་བཏང་བུམ་པར་ཆུ་སྐྱེད་ལམ་དུ་འཇིག་པ་ཡིས་༎ འཇིགས་པ་མེད་ཅིང་བདེ་བར་ཁྱིམ་དུ་ཕྱིན་པར་འགྱུར་༎ དེ་བཞིན་བྱང་ཆུབ་སེམས་དཔའ་དད་པ་མང་གྱུར་ཀྱང་༎
 kiṃcāpi śraddhabahulo siya bodhisattvo prajñāvihīna vilayaṃ laghu prāpuṇāti |	ཤེས་རབ་རྣམ་པར་ཉམས་ཤིང་མྱུར་དུ་མ་རུངས་འགྱུར་༎
 taṃ caiva śraddha parigṛhṇayamāna prajñā atikramya bodhidvaya prāpsyati agrabodhim || rgs_14|6 ||	དེ་བས་ཤེས་རབ་ཀྱིས་ནི་ཡོངས་སུ་ཟིན་གྱུར་ན་༎ ས་གཉིས་ཤིན་ཏུ་འདས་ཏེ་བྱང་ཆུབ་མཆོག་ཐོབ་འགྱུར་༎
 nāvā yathā aparikarmakṛtā samudre vilayamupaiti sadhanā saha vāṇijebhiḥ |	དཔེར་ན་བཅོས་ལེགས་མ་བྱས་གྲུ་ནི་རྒྱ་མཚོའི་ནང་༎ ནོར་དང་བཅས་ཤིང་སྟོང་པར་བཅས་ཏེ་འཇིག་པར་འགྱུར་༎
 sā caiva nāva parikarmakṛtā suyuktā na ca bhidyate dhanasamagramupaiti tīram || rgs_14|7 ||	གྲུ་དེ་ལེགས་པར་བཅོས་ལེགས་བྱས་དང་ལྡན་གྱུར་ན་༎ མི་འཇིག་ནོར་དང་བཅས་པར་ངོགས་སུ་ཕྱིན་པར་འགྱུར་༎
 emeva śraddhaparibhāvitu bodhisattvo prajñāvihīnu laghu bodhimupaiti hānim |	དེ་ལྟར་བྱང་ཆུབ་སེམས་དཔའ་དད་པས་ཡོངས་བསྒོས་ཀྱང་༎ ཤེས་རབ་མེད་ན་བྱང་ཆུབ་ལས་ནི་མྱུར་ཉམས་འགྱུར་༎
 so caiva prajñavarapāramitāsuyukto 'kṣato 'nupāhatu spṛśāti jināna bodhim || rgs_14|8 ||	དེ་ཉིད་ཤེས་རབ་ཕ་རོལ་ཕྱིན་པ་མཆོག་ལྡན་ན་༎ མ་རྨས་མ་ཉམས་རྒྱལ་བའི་བྱང་ཆུབ་རེག་པར་འགྱུར་༎
 puruṣo hi jīrṇa dukhito śataviṃśavarṣo kiṃcāpi utthitu svayaṃ na prabhoti gantum |	ལོ་བརྒྱ་ཉི་ཤུ་ལོན་ཏེ་རྒས་ཤིང་སྡུག་བསྔལ་མི་༎ ལངས་ཀྱང་བདག་ཉིད་འགྲོ་བར་ནུས་པ་མ་ཡིན་ཏེ་༎
 so vāmadakṣiṇadvaye puruṣe gṛhīte patanādbhayaṃ na bhavate vrajate sukhena || rgs_14|9 ||	དེ་ནི་ག-ཡས་ག-ཡོན་གཉིས་ནས་མི་ཡིས་བསྟེན་བྱས་ན་༎ འགྱེལ་བའི་འཇིགས་པ་མེད་ཅིང་བདེ་བླག་འགྲོ་བར་༄༢༠༠ཨ་༌༎ འགྱུར༏་༏དེ་བཞིན་བྱང་ཆུབ་སེམས་དཔའ་ཤེས་རབ་སྟོབས་ཆུང་བ་༎
 emeva prajña iha durbalu bodhisattvo kiṃcāpi prasthihati bhajyati antareṇa |	རབ་ཏུ་ཞུགས་པར་གྱུར་ཀྱང་རབ་ཏུ་ཉམས་པར་འགྱུར་༎
 so vā upāyabalaprajñaparigṛhīto na ca bhajyate spṛśati bodhi nararṣabhāṇām || rgs_14|10 ||	དེ་ཉིད་ཐབས་དང་ཤེས་རབ་མཆོག་གིས་ཡོངས་ཟིན་ན་༎ མི་ཉམས་དེ་བཞིན་གཤེགས་ཀྱི་བྱང་ཆུབ་རེག་པར་འགྱུར་༎
 bhagavatyāṃ ratnaguṇasaṃcayagāthāyāmaupamyaparivarto nāma caturdaśamaḥ ||	བྱང་ཆུབ་སེམས་དཔའ་དང་པོའི་ལས་ཀྱི་སར་གནས་གང་༎
 yo ādikarma sthitu bhūmiya bodhisattvo adhyāśayena vara prasthita buddhabodhim |	ལྷག་པའི་བསམ་པས་སངས་རྒྱས་བྱང་ཆུབ་མཆོག་ཞུགས་པ་༎
 tehī suśiṣyagurugauravasaṃprayukto kalyāṇamitra sada sevayitavya vijñaiḥ || rgs_15|1 ||	སློབ་མ་བཟང་པོ་བླ་མར་གུས་ལྡན་དེ་དག་གིས་༎ བླ་མ་མཁས་པ་རྣམས་ལ་རྟག་ཏུ་བསྟེན་པར་བྱ་༎
 kiṃ kāraṇaṃ tatu guṇāgamu paṇḍitānāṃ prajñāya pāramita te anuśāsayanti |	ཅི་ཕྱིར་ཞེ་ན་མཁས་པའི་ཡོན་ཏན་དེ་ལས་འབྱུང་༎ དེ་དག་ཤེས་རབ་ཕ་རོལ་ཕྱིན་པ་རྗེས་སུ་སྟོན་༎
 evaṃ jino bhaṇati sarvaguṇāgradhārī kalyāṇamitramupaniśrita buddhadharmāḥ || rgs_15|2 ||	སངས་རྒྱས་ཆོས་རྣམས་དགེ་བའི་བཤེས་ལ་བསྟེན་ཏོ་ཞེས་༎ ཡོན་ཏན་ཀུན་གྱི་མཆོག་མངའ་རྒྱལ་བ་དེ་སྐད་གསུངས་༎
 dānaṃ ca śīlamapi kṣānti tathaiva vīryaṃ dhyānāni prajña pariṇāmayitavya bodhau |	སྦྱིན་དང་ཚུལ་ཁྲིམས་བཟོད་ཅིང་དེ་བཞིན་བརྩོན་འགྲུས་དང་༎ བསམ་གཏན་ཤེས་རབ་བྱང་ཆུབ་ཡོངས་སུ་བསྔོ་བར་གྱིས་༎
 na ca bodhiskandha vimṛśitva parāmṛśeyā ye ādikarmika na deśayitavya evam || rgs_15|3 ||	བྱང་ཆུབ་ཕུང་པོར་ཞེན་ནས་མཆོག་འཛིན་མ་བྱེད་ཅེས་༎ དང་པོའི་ལས་ཅན་དེ་ལ་དེ་སྐད་བསྟན་པར་བྱ་༎
 evaṃ caranta guṇasāgara vādicandrāḥ trāṇā bhavanti jagatī śaraṇā ca lenā |	དེ་ལྟར་སྤྱོད་པ་ལེགས་མཚོ་སྨྲ་བའི་ཟླ་བ་རྣམས་༎ འགྲོ་བའི་སྐྱབས་དང་དཔུང་གཉེན་དང་ནི་གནས་ཡིན་ཏེ་༎
 gati buddhi dvīpa pariṇāyaka arthakāmāḥ pradyota ulka varadharmakathī akṣobhyāḥ || rgs_15|4 ||	རྟེན་དང་བློ་དང་གླིང་དང་ཡོངས་འདྲེན་དོན་འདོད་པ་༎ གསལ་བྱེད་སྒྲོན་མ་ཆོས་མཆོག་སྨྲ་བ་མི་འཁྲུགས་ཡིན་༎ གྲགས་ཆེན་ལྡན་རྣམས་བྱ་དཀའི་གོ་ཆ་གྱོན་བྱེད་དེ་༎
 saṃnāhu duṣkarū mahāyaśu saṃnahantī na ca skandhadhātu na ca āyatanaiḥ sanaddhāḥ |	ཕུང་པོ་ཁམས་དང་སྐྱེ་མཆེད་རྣམས་ཀྱི་གོ་ཆ་མིན་༎
 tribhi yānasaṃjñavigatā aparigṛhītā avivartikā acalitāśca akopyadharmāḥ || rgs_15|5 ||	ཐེག་གསུམ་༄༢༠༠བ་འདུ་ཤེས་བྲལ་ཞིང་ཡོངས་སུ་བཟུང་བ་ནི་༎ མི་ལྡོག་ག-ཡོ་བ་མེད་ཅིང་མི་འཁྲུགས་ཆོས་ཅན་ཡིན་༎ དེ་དག་དེ་འདྲའི་ཆོས་དང་ལྡན་ཞིང་སྤྲོས་པ་མེད་༎
 te eva dharmasamudāgata niṣprapañcā kāṅkṣāvilekhavimatīvigatārthayuktāḥ |	ཐེ་ཚོམ་སོམ་ཉི་ཡིད་གཉིས་བྲལ་ཞིང་དོན་དང་ལྡན་༎
 prajñāya pāramita śrutva na sīdayanti aparapraṇeya avivartiya veditavyāḥ || rgs_15|6 ||	ཤེས་རབ་ཕ་རོལ་ཕྱིན་པ་ཐོས་ནས་མི་ནུར་བ་༎ གཞན་གྱི་དྲིང་མི་འཇོག་ཅིང་མི་ལྡོག་རིག་པར་བྱ་༎ འདྲེན་པ་རྣམས་ཀྱི་ཆོས་འདི་ཟབ་སྟེ་མཐོང་བར་དཀའ༎
 gambhīra dharma ayu durdṛśu nāyakānāṃ na ca kenacīdadhigato na ca prāpuṇanti |	སུས་ཀྱང་རྟོགས་པ་མེད་ཅིང་ཐོབ་པར་གྱུར་མེད་པ་༎ དེ་ཕྱིར་ཕན་མཛད་བརྩེར་ལྡན་བྱང་ཆུབ་བརྙེས་ནས་འདི་༎
 etārthu bodhimadhigamya hitānukampī alpotsuko ka imu jñāsyati sattvakāyo || rgs_15|7 ||	སེམས་ཅན་ཚོགས་སུས་ཤེས་སྙམ་ཐུགས་ཁྲལ་ཆུང་བར་མཛད་༎ སེམས་ཅན་རྣམས་ནི་གནས་ལ་དགའ་ཞིང་ཡུལ་རྣམས་འདོང་༎
 sattvaśca ālayarato viṣayābhilāṣī sthita agrahe abudha yo mahaandhabhūto | dharmo anālayu anāgrahu prāpitavyo lokena sārdha ayu vigrahu prādubhūto || rgs_15|8 || bhagavatyāṃ ratnaguṇasaṃcayagāthāyāṃ devaparivarto nāma pañcadaśamaḥ ||	འཛིན་ལ་གནས་ཤིང་མི་མཁས་བླུན་རྨོངས་མུན་པ་བཞིན་༎ ཐོབ་པར་བྱ་བའི་ཆོས་ནི་གནས་མེད་འཛིན་མེད་དེ་༎ དེས་ན་འཇིག་རྟེན་དག་དང་རྩོད་པ་འབྱུང་བ་ཡིན་༎
 ākāśadhātu purimādiśi dakṣiṇāyāṃ tatha paścimottaradiśāya anantapārā |	ནམ་མཁའི་ཁམས་ནི་ཤར་གྱི་ཕྱོགས་དང་ལྷོ་ཕྱོགས་དང་༎ དེ་བཞིན་ནུབ་ཀྱི་ཕྱོགས་དང་བྱང་ཕྱོགས་ཕ་མཐའ་ཡས་༎ སྟེང་དང་འོག་དང་ཕྱོགས་བཅུའི་ཇི་སྙེད་རྣམས་ནའང་ཡོད་༎
 uparādharāya daśaddiśi yāvadasti nānātvatā na bhavate na viśeṣaprāptā || rgs_16|1 ||	ཐ་དད་གྱུར་པ་མེད་ཅིང་བྱེ་བྲག་གྱུར་པ་མེད་༎
 atikrānta yā tathata yā tathatā aprāptā pratyutpanna yā tathata yā tathatārhatānām |	འདས་པའི་དེ་བཞིན་ཉིད་གང་མ་ཕྱིན་དེ་བཞིན་ཉིད་༎ ད་ལྟར་དེ་བཞིན་ཉིད་གང་དགྲ་བཅོམ་དེ་བཞིན་ཉིད་༎
 yā sarvadharmatathatā tathatārhatānāṃ sarveṣa dharmatathatā na viśeṣaprāptā || rgs_16|2 ||	ཆོས་ཀུན་དེ་བཞིན་ཉིད་གང་དགྲ་བཅོམ་དེ་བཞིན་ཉིད་༎ ཆོས་ཀྱི་དེ་བཞིན་ཉིད་འདི་ཐམས་ཅད་བྱེ་བྲག་མེད་༎
 yo bodhisattva imi icchati prāpuṇetuṃ nānātvadharmavigatāṃ sugatāna bodhim |	བདེ་གཤེགས་བྱང་ཆུབ་ཐ་དད་ཆོས་དང་བྲལ་གྱུར་པ་༎ འདི་ནི་བྱང་ཆུབ་སེམས་དཔའ་གང་ཞིག་ཐོ་བ་༄༢༠༡ཨ་༌༎ འདོད་པ་༎ ཐབས་དང་ལྡན་པས་ཤེས་རབ་ཕ་རོལ་ཕྱིན་ལ་སྦྱོར་༎
 prajñāya pāramita yujyatu yāya yukto vina prajña nāstyadhigamo naranāyakānām || rgs_16|3 ||	འདྲེན་པའི་ཤེས་རབ་མེད་ན་ཐོབ་པར་འགྱུར་མ་ཡིན་༎
 pakṣisya yojanaśataṃ mahatātmabhāvo pañcāśatā pi abalobhayakṣīṇapakṣo |	བྱ་ཞིག་ལུས་ཆེ་དཔག་ཆེད་བརྒྱ་རྩ་ལྔ་བཅུ་པར་༎ གྱུར་ལ་འདབ་གཤོག་ཟད་དེ་ཉམས་རྩལ་ཡོད་མིན་ན་༎
 so trāyatriṃśabhavanādiṣu jambudvīpe ātmānamosariyi taṃ vilayaṃ vrajeyyā || rgs_16|4 ||	དེ་ཡིས་སུམ་ཅུ་རྩ་གསུམ་གནས་ནས་འཛམ་གླིང་འདིར་༎ བདག་ཉིད་མཆོངས་ན་དེར་ནི་ཉམས་ཉེས་འགྱུར་བ་ཡིན་༎
 yadyāpi pañca ima pāramitā jinānāṃ bahukalpakoṭiniyutāṃ samudānayeyyā |	རྒྱལ་བ་རྣམས་ཀྱི་ཕ་རོལ་ཕྱིན་པ་ལྔ་འདི་ཡང་༎ བསྐལ་པ་བྱེ་བ་ཁྲག་ཁྲིག་མང་པོར་བསྒྲུབས་བྱས་ཤིང་༎ སྨོན་ལམ་མཐའ་ཡས་རྒྱ་ཆེན་འཇིག་རྟེན་རྟག་བརྟེན་ཀྱང་༎
 praṇidhīnanantavipulāṃ sada sevya loke anupāya prajñavikalā pari śrāvakatve || rgs_16|5 ||	ཐབས་མེད་ཤེས་རབ་བྲལ་བ་ཉན་ཐོས་ཉིད་དུ་བྱུང་༎ སངས་རྒྱས་ཐེག་པ་འདི་ལ་ངེས་པར་འབྱུང་འདོད་གང་༎
 niryāyanāya ya icchati buddhajñāne samacitta sarvajagatī pitṛmātṛsaṃjñā |	འགྲོ་བ་ཀུན་ལའང་སེམས་སྙོམས་ཕ་མའི་འདུ་ཤེས་དང་༎ ཕན་པའི་སེམས་དང་བྱམས་པའི་ཡིད་ཀྱིས་བརྟུལ་བྱ་ཞིང་༎
 hitacitta maitramana eva parākrameyyā akhilārjavo mṛdugirāya parākrameyyā || rgs_16|6 || bhagavatyāṃ ratnaguṇasaṃcayagāthāyāṃ tathatāparivarto nāma ṣoḍaśamaḥ ||	ཐ་བ་མེད་ཅིང་དྲང་ལ་ཚིག་འཇམ་སྨྲ་བར་བྱ་༎
 sthaviro subhūti paripṛcchati lokanāthaṃ araṇāya liṅga bhaṇahī guṇasāgarāṇām |	འཇིག་རྟེན་མགོན་ལ་གནས་བརྟན་རབ་འབྱོར་ཡོངས་ཞུས་པ་༎ ཡོན་ཏན་རྒྱ་མཚོ་ཉོན་མོངས་མ་མཆིས་རྟགས་བསྟན་གསོལ་༎
 avivartiyā yatha bhavanti mahānubhāvā tāṃ vyākuruṣva jinaguṇāna pradeśamātram || rgs_17|1 ||	མཐུ་ཆེ་བ་དག་ཇི་ལྟར་སླར་ལྡོག་མི་འགྱུར་བ་༎ དེ་ལྟར་ཡོན་ཏན་ཕྱོགས་ཙམ་རྒྱལ་བས་ལུང་བསྟན་གསོལ་༎ ཐ་དད་འདུ་ཤེས་བྲལ་ཞིང་རིགས་པ་ལྡན་ཚིག་སྨྲ་༎
 nānātvasaṃjñavigatā gira yuktabhāṇī na ca anya te śramaṇa brāhmaṇa āśrayanti |	དགེ་སྦྱོང་དག་དང་བྲམ་ཟེ་གཞན་ལ་རྟེན་མི་བྱེད་༎
 triyapāyavarjita vidū sadakāli bhonti daśabhiśca te kuśalakarmapathebhi yuktā || rgs_17|2 ||	མཁས་པ་དུས་རྣམས་རྟག་པར་ངན་སོང་གསུམ་པོ་སྤངས་༎ དེ་དག་དགེ་བཅུའི་ལས་ཀྱི་ལམ་ལ་མངོན་པར་༄༢༠༡བ་བརྩོན༏་༏ཟང་ཟིང་མེད་པར་འགྲོ་ལ་ཆོས་ནི་རྗེས་སུ་སྟོན་༎ 
 dharmaṃ nirāmiṣu jagasyanuśāsayanti ekāntadharmaniyatāḥ sada snigdhavākyāḥ |	ཆོས་ལ་གཅིག་ཏུ་དགའ་ཞིང་རྟག་ཏུ་ཚིག་འཇམ་ལྡན་༎
 sthiticaṃkramaṃ śayaniṣadya susaṃprajānā yugamātraprekṣiṇa vrajantyabhrāntacintā || rgs_17|3 ||	འགྲོ་འཆག་ཉལ་དང་འདུག་པར་ཤེས་བཞིན་རབ་ཏུ་ལྡན་༎ གཉའ་ཤིང་གང་ཙམ་ལྟ་ཞིང་འགྲོ་ལས་སེམས་འཁྲུལ་མེད་༎ གཙང་བྱས་གཙང་མའི་གོས་འཆང་གསུམ་པོ་དབེན་ཞིང་དག་།
 śuciśaucaambaradharā trivivekaśuddhā na ca lābhakāma vṛṣabhā sada dharmakāmāḥ |	རྙེད་འདོད་མ་ཡིན་ཁྱུ་མཆོག་རྟག་ཏུ་ཆོས་འདོད་པ་༎ བདུད་ཀྱི་ཡུལ་ལས་འདས་ཤིང་གཞན་གྱི་དྲིང་མི་འཇོག་།
 mārasyatītaviṣayā aparapraṇeyā catudhyānadhyāyi na ca niśrita tatra dhyāne || rgs_17|4 ||	བསམ་གཏན་བཞི་ལ་བསམ་གཏན་བསམ་གཏན་དེར་མི་གནས་༎
 na ca kīrtikāma na ca krodhaparītacittā gṛhibhūta nitya anadhyoṣita sarva vastuṃ |	གྲགས་པ་འདོད་པ་མ་ཡིན་ཁྲོ་བས་སེམས་དཀྲིས་མེད་༎ ཁྱིམ་པར་གྱུར་ཀྱང་རྟག་ཏུ་དངོས་པོ་ཀུན་མ་ཆགས་༎
 na ca jīvikāviṣayabhoga gaveṣayanti abhicāramantra na ca istriprayogamantrāḥ || rgs_17|5 ||	འཚོ་བའི་ཕྱིར་ནི་ཡངས་ལོངས་སྤྱོད་ཚོལ་མི་བྱེད་༎
 na ca ādiśanti puruṣaiḥ striya icchakarmāṃ pravivikta prajñavarapāramitābhiyuktāḥ |	དྲག་ཤུལ་སྤྱོད་སྔགས་མི་བྱེད་བུད་མེད་སྦྱོར་སྔགས་མིན་༎ འདོད་པའི་ལས་ཅན་ཕོ་མོར་འགྱུར་ཞེས་སྟོན་མི་བྱེད་༎
 kalahāvivādavigatā dṛḍhamaitracittā sarvajñakāma sada śāsani nimnacittāḥ || rgs_17|6 ||	རབ་ཏུ་དབེན་པའི་ཤེས་རབ་ཕ་རོལ་ཕྱིན་མཆོག་བརྩོན་༎ འཐབ་དང་རྩོད་དང་བྲལ་ཞིང་བྱམས་པའི་སེམས་ཀྱང་བསྟེན་༎ ཀུན་མཁྱེན་འདོད་ཅིང་བསྟན་ལ་རྟག་ཏུ་གཞོལ་སེམས་ལྡན་༎ མཐའ་འཁོབ་ཀླ་ཀློའི་སྐྱེ་བོ་ཡུལ་མཐའ་རྣམ་པར་སྤངས་༎
 pratyantamlecchajanavarjitaantadeśāḥ svakabhūmi kāṅkṣavigatāḥ sada merukalpāḥ |	རང་གི་ས་ལ་དོགས་མེད་རྟག་ཏུ་རི་རབ་འདྲ་༎
 dharmārtha jīvita tyajanti prayuktayogā avivartiyāna imi liṅga prajānitavyā || rgs_17|7 || bhagavatyāṃ ratnaguṇasaṃcayagāthāyāmavinivartanīyaliṅgākāraparivarto nāma saptadaśamaḥ ||	ཆོས་ཕྱིར་སྲོག་ཀྱང་འདོར་ཞིང་རྣལ་འབྱོར་རབ་ཏུ་བརྩོན་༎ མི་ལྡོག་རྟགས་ནི་འདི་དག་ཡིན་པར་ཤེས་པར་བྱ་༎
 gambhīra rupa api vedana cetanā ca vijñāna saṃjña prakṛtī animittaśāntā | kāṇḍena gādha yatha sāgari eṣamāṇo prajñāya skandha vimṛṣitva alabdhagādhā || rgs_18|1 ||	གཟུགས་དང་ཚོར་དང་འདུ་ཤེས་སེམས་པ་རྣམ་ཤེས་རྣམས་༎ ཟབ་སྟེ་རང་བཞིན་མཚན་མ་མེད་ཅིང་རབ་ཞི་བ་༎ དཔེར་ན་མདའ་ཡིས་རྒྱ་མཚོའི་གཏིང་༄༢༠༢ཨ་༌༎ ཐུག་ཚོལ་བ་ལྟར་༎ ཤེས་རབ་ཀྱིས་ནི་བརྟགས་ན་ཕུང་པོའི་གཏིང་མི་རྙེད་༎
 yo bodhisattva imu budhyati eva dharmāṃ gambhīrayānaparamārthanirupalepān |	བྱང་ཆུབ་སེམས་དཔའ་གང་ཞིག་དེ་ལྟར་ཟབ་གྱུར་ཅིང་༎
 yasmin na skandha na pi āyatanaṃ na dhātu kiṃ vā svapuṇyasamudāgamu kiṃci tasya || rgs_18|2 ||	ཐེག་པ་དོན་དམ་ཆགས་མེད་གང་ལ་ཕུང་པོ་དང་༎ ཁམས་དང་སྐྱེ་མཆེད་ཡོད་མིན་ཆོས་འདི་རྟོགས་པ་དེའི་༎ བསོད་ནམས་ཡང་དག་འགྲུབ་པ་དེ་ལས་ཅི་ཞིག་ཡོད་༎
 yatha rāgadharmacaritaḥ puruṣaḥ striyāye saṃketa kṛtva alabhantu vivartayeyā |	དཔེར་ན་འདོད་ཆགས་ཆོས་ལ་སྤྱོད་པའི་སྐྱེས་བུ་ཞིག་། བུད་མེད་དུས་བཏབ་དེ་དང་མ་ཕྲད་དེ་ཡི་ནི་༎
 yāvanti cittacaritā divasena tasya tāvanta kalpa anubudhyati bodhisattvo || rgs_18|3 ||	ཉིན་གཅིག་སེམས་ཀྱི་རྣམ་རྟོག་སྤྱོད་པ་ཇི་སྙེད་པ་༎
 yo bodhisattva bahukalpasahasrakoṭayo dānaṃ dadeyu vimalaṃ tatha śīla rakṣe |	དེ་སྙེད་བསྐལ་པར་བྱང་ཆུབ་སེམས་དཔས་ཐོབ་པར་འགྱུར་༎ བྱང་ཆུབ་སེམས་དཔའ་གང་ཞིག་བསྐལ་མང་བྱེ་སྟོང་དུ་༎ དགྲ་བཅོམ་རང་རྒྱལ་སྦྱིན་བྱེད་ཚུལ་ཁྲིམས་སྲུང་བྱེད་ཀྱང་༎
 yaścaiva prajñavarapāramitāprayukto dharmaṃ bhaṇeya kala puṇya na dānaśīle || rgs_18|4 ||	གང་ཞིག་ཤེས་རབ་ཕ་རོལ་ཕྱིན་མཆོག་ལྡན་པའི་ཆོས་༎ བརྗོད་པའི་ལེགས་པ་སྦྱིན་དང་ཚུལ་ཁྲིམས་ཆར་མི་ཕོད་༎
 yo bodhisattva varaprajña vibhāvayanto tata utthito kathayi dharma nirupalepam |	བྱང་ཆུབ་སེམས་དཔའ་གང་ཞིག་ཤེས་རབ་མཆོག་བསྒོམས་ཏེ་༎ དེ་ལས་ལངས་ནས་གོས་པ་མེད་པའི་ཆོས་བརྗོད་ཅིང་༎
 taṃ cāpi nāmayi jagārthanidāna bodhau nāsti triloka śubha tena samaṃ bhaveyā || rgs_18|5 ||	དེ་ཡང་འགྲོ་བའི་དོན་དུ་བྱང་ཆུབ་རྒྱུར་བསྔོ་ན༏་༏དགེ་བ་དེ་དང་མཉམ་པ་འཇིག་རྟེན་གསུམ་ན་མེད་༎ 
 taṃ caiva puṇya puna khyāyati riktameva tatha śūnya tuccha vaśikaṃ ca asārakaṃ ca |	བསོད་ནམས་དེ་དང་གསོག་དང་དེ་བཞིན་སྟེང་པ་དང་༎ གསོབ་དང་ཡ་མ་བརླ་དང་སྙིང་པོ་མེད་ཤེས་པ་༎
 evaṃ carantu caratī sugatāna prajñāṃ caramāṇu puṇyu parigṛhṇati aprameyam || rgs_18|6 ||	དེ་ལྟར་བདེ་གཤེགས་རྣམས་ཀྱི་ཤེས་རབ་སྤྱད་སྤྱོད་ན་༎ སྤྱོད་ཚེ་བསོད་ནམས་དཔག་ཏུ་མེད་པ་ཡོངས་སུ་འཛིན་༎
 abhilāpamātra ima jānati sarvadharmāṃ buddhena deśita prayukta prakāśitāṃśca |	སངས་རྒྱས་ཀྱིས་བཤད་རབ་ཏུ་སྤྱོད་ཅིང་རབ་བསྟན་པའི་༎ ཆོས་འདི་ཐམས་༄༢༠༢བ་ཅད་བརྗོད་པ་ཙམ་དུ་ཟད་ཤེས་ན་༎
 kalpāna koṭinayutāṃ bahu bhāṣamāṇo na ca kṣīyate na ca vivardhati dharmadhātuḥ || rgs_18|7 ||	བསྐལ་པ་བྱེ་བ་ཁྲག་ཁྲིག་མང་པོར་བརྗོད་བྱས་ཀྱང་༎ ཆོས་ཀྱི་དབྱིངས་ལ་ཟད་པ་མེད་ཅིང་འཕེལ་བ་མེད་༎ རྒྱལ་བ་རྣམས་ཀྱི་ཕ་རོལ་ཕྱིན་ཅེས་བྱ་བ་གང་༎
 ye cāpi pañca imi pāramitā jinānām ete 'pi dharma parikīrtita nāmamātrāḥ | pariṇāmayāti na ca manyati bodhisattvo na ca hīyate spṛśati uttamabuddhabodhim || rgs_18|8 || bhagavatyāṃ ratnaguṇasaṃcayagāthāyāṃ śūnyatāparivarto nāmāṣṭādaśamaḥ	ཆོས་དེ་རྣམས་ཀྱང་མིང་ཙམ་དུ་ནི་ཡོངས་སུ་བསྒྲགས་༎ ཡོངས་བསྔོ་རློམ་སེམས་མེད་པའི་བྱང་ཆུབ་སེམས་དཔའ་ནི་༎ ཉམས་པ་མེད་ཅིང་སངས་རྒྱས་བྱང་ཆུབ་མཆོག་རེག་འགྱུར༏་འབྲུ་མར་སྙིང་པོ་འབར་བ་འཕྲད་པ་དང་པོ་ཡིས་༎ སྙིང་པོ་ཚིག་མིན་དེ་མེད་པར་ཡང་དེ་མི་ཚིག་།
 tailasya varti jvalitā prathame nipāte na ca dagdha varti asatā na vinā ya dagdhā | na hi arci paścimanipāta sa varti dagdhā asatā pi paścima na dahyati dīpavarti || rgs_19|1 ||	མེ་ལྕེ་ཕྲད་པ་ཐམས་སྙིང་པོ་ཚིག་མིན་ལ་༎ མེ་ལྕེ་ཐ་མ་མེད་པར་སྙིང་པོ་ཚིག་མིན་ལྟར་༎
 prathameva citta spṛśatī na ca agrabodhim asatā na tasya spṛśatā puna śakya bhonti |	དང་པོའི་སེམས་ཀྱིས་བྱང་ཆུབ་མཆོག་རེག་མ་ཡིན་ལ་༎ དེ་མེད་པར་ཡང་དེ་ལ་རེག་པར་ནུས་མ་ཡིན་༎ ཐ་མའི་སེམས་ཀྱིས་བྱང་ཆུབ་ཞི་བ་ཐོབ་མིན་ལ་༎
 na ca citta paścima śivāmanuprāpuṇāti asatā na tasya puna prāpaṇanāya śakyam || rgs_19|2 ||	དེ་མེད་པར་ཡང་དེ་འཐོབ་ནུས་པ་མ་ཡིན་ནོ་༎
 bījātu stamba phala puṣpa samāgamanti so vāniruddha asato na hi tasya vṛkṣo |	ས་བོན་ལས་ནི་མྱུ་གུ་མེ་ཏོག་འབྲས་བུ་འབྱུང༏་༏དེ་ཡང་འགག་ལ་ཤིང་ཡང་མེད་པ་དེ་མིན་ལྟར་༎ 
 emeva citta prathamaṃ tu nidāna bodheḥ so vā niruddha asato na hi tasya bodhiḥ || rgs_19|3 || bījaṃ pratītya ca bhavedyavaśālikādes tattatphalaṃ na ca tadasti na cāpi nāsti | utpattito bhavati bodhiriyaṃ jinānāṃ bhāvasvabhāvavigatā bhavatīha māyā || rgs_19|4 ||	དེ་བཞིན་དང་པོའི་སེམས་ཀྱང་བྱང་ཆུབ་རྒྱུ་ཡིན་ཏེ་༎ དེ་ཡང་འགག་ལ་བྱང་ཆུབ་མེད་པ་དེ་མ་ཡིན་༎
 udakabindu kumbha paripūryati stokastokaṃ prathame nipāti anupūrva sa paścimena |	ཆུ་ཡི་ཐིགས་པས་བུམ་པ་དང་པོ་ཐ་མའི་བར་༎ རིམ་གྱིས་ཉུང་དུ་ཉུང་དུས་དེ་ཡོངས་འགེངས་པ་ལྟར་༎
 emeva citta prathamaṃ varabodhihetur anupūrva śuklaguṇapūrṇa bhavanti buddhāḥ || rgs_19|5 ||	དེ་བཞིན་དང་པོའི་སེམས་ཀྱང་བྱང་ཆུབ་མཆོག་རྒྱུ་སྟེ་༎ རིམ་གྱིས་དཀར་པོའི་ཡོན་ཏན་རྫོགས་པའི་སངས་རྒྱས་འགྱུར་༎
 śūnyānimittapraṇidhiṃ caramāṇu dharmā na ca nirvṛtiṃ spṛśati no ca nimittacārī |	སྟོང་པ་མཚན་མེད་སྨོན་པ་མེད་པར་ཆོས་སྤྱོད་ཅིང་༎ མྱ་ངན་འདས་ལ་མི་རེག་མཚན་མར་མི་སྤྱོད་པ་༎ དཔེར་ན་མཉན་པ་༄༢༠༣ཨ་༌༎
 yatha nāviko kuśala gacchati ārapāram ubhayānti asthitu na tiṣṭhati arṇavesmin || rgs_19|6 ||	མཁས་པ་ཕར་འགྲོ་ཚུར་འགྲོ་ཡང་༎ མཐའ་གཉིས་མི་གནས་རྒྱ་མཚོར་གནས་པ་མེད་པ་བཞིན་༎ དེ་ལྟར་སྤྱོད་པའི་བྱང་ཆུབ་སེམས་དཔའ་འདི་སྙམ་བདག་།
 evaṃ carantu na ca manyati bodhisattvo ahu vyākṛto daśabalehi spṛśeya bodhim |	སྟོབས་བཅུས་ལུང་བསྟན་བྱང་ཆུབ་རེག་འགྱུར་རློམ་སེམས་མེད་༎
 na ca trāsu bodhi bhavate na ihāsti kiṃcid evaṃ carantu caratī sugatāna prajñām || rgs_19|7 ||	འདི་ལ་ཅི་ཡང་མེད་ཅེས་བྱང་ཆུབ་སྐྲག་པ་མེད་༎ དེ་ལྟར་སྤྱོད་པ་བདེ་གཤེགས་ཤེས་རབ་སྤྱོད་པ་ཡིན་༎
 kāntāramārgi durabhikṣi savyādhi lokāṃ paśyitva nāsti bhaya uttari saṃnahante |	འཇིག་རྟེན་དགོན་པའི་ལམ་དང་མུ་གེ་ནད་བཅས་པར་༎ མཐོང་ནས་སྐྲག་པ་མེད་ཅིང་དེ་ནས་གོ་གྱོན་ཏེ་༎
 aparāntakoṭi sada yukta prajānamāno aṇumātra kheda manaso na upādiyāti || rgs_19|8 || bhagavatyāṃ ratnaguṇasaṃcayagāthāyāṃ gaṅgadevābhaginīparivarto nāmaikānnaviṃśatimaḥ ||	ཕྱི་མའི་མུ་མཐར་རྟག་ཏུ་བརྩོན་ཞིང་རབ་ཤེས་ནས་༎ ཡོངས་སུ་སྐྱོ་བའི་ཡིད་ནི་རྡུལ་ཙམ་སྐྱེད་མི་བྱེད་༎
 puna bodhisattva caramāṇu jināna prajñāṃ anupāda skandha imi jānati ādiśūnyān |	བྱང་ཆུབ་སེམས་དཔའ་རྒྱལ་པའི་ཤེས་རབ་སྤྱོད་བྱེད་ཅིང་༎ ཕུང་པོ་འདི་དག་གདོད་ནས་སྟོང་ཞིང་སྐྱེ་མེད་ཤེས་༎
 asamāhito karuṇa prekṣati sattvadhātum atrāntare na parihāyati buddhadharmān || rgs_20|1 ||	མཉམ་པར་མ་བཞག་སེམས་ཅན་ཁམས་ལ་སྙིང་རྗེ་འཇུག་། བར་སྐབས་དེར་ཡང་སངས་རྒྱས་ཆོས་ལས་ཡོངས་མི་ཉམས་༎
 puruṣo yathā kuśala sarvaguṇairupeto balavān dudharṣu kṛtayogya kalāvidhijño |	དཔེར་ན་སྐྱེས་བུ་མཁས་པ་ཡོན་ཏན་དང་ལྡན་ཞིང་༎ སྟོབས་ལྡན་མི་ཐུབ་བརྩོན་བྱས་སྒྱུ་རྩལ་ཆོག་ཤེས་༎
 iṣvastrapāramigato pṛthuśilpayukto māyāvidhijñaparamo jagadarthakāmo || rgs_20|2 ||	འཕོང་དང་བཟོ་གནས་མང་པོའི་ཕ་རོལ་ཕྱིན་གྱུར་ཅིང་༎ སྒྱུ་མ་སྒྲུབ་ཤེས་འགྲོ་དོན་རབ་ཏུ་འདོད་པ་ཞིག་།
 mātā pitā ca parigṛhya saputradāraṃ kāntāramārgi pratipadya bahūamitro |	ཕ་དང་མ་དང་ཆུང་མར་བཅས་པ་ཡོངས་བསྡུས་ནས་༎
 so nirmiṇitva puruṣān bahu śūravīrān kṣemeṇa gatva puna gehamupāgameyyā || rgs_20|3 ||	དག་བྱེད་མང་བ་དགོན་པའི་ལམ་དུ་ཕྱིན་པ་དང་༎ དེ་ཡིས་དཔའ་ཞིང་རྟུལ་ཕོད་སྐྱེས་བུ་མང་?་སྤྲུལ་ཏེ་༎ བདེ་བར་སོང་ཞིང་ཕྱིར་ཡང་ཁྱིམ་དུ་འོང་བ་ལྟར་༎
 emeva yasmi samaye vidu bodhisattvo mahamaitri sarvi upabandhati sattvadhātau |	དེ་བཞིན་དེ་ཚེ་བྱང་ཆུབ་སེམས་དཔའ་མཁས་པ་ཡང་༎ ༄༢༠༣བ་སེམས་ཅན་ཁམས་རྣམས་ཀུན་དུ་སྙིང་རྗེ་ཆེ་བསྐྱེད་ཅིང་༎
 caturo sa māra atikramya dvaye ca bhūmim asmin samādhi sthitu no ca spṛśāti bodhim || rgs_20|4 ||	བདུད་བཞི་དག་དང་ས་གཉིས་ལས་ཀྱང་རབ་འདས་ནས་༎ ཏིང་འཛིན་མཆོག་ལ་གནས་ཤིང་བྱང་ཆུབ་རེག་མི་བྱེད་༎
 ākāśaniśrita samīraṇa āpaskandho ta hi niśritā iha mahāpṛthivī jagacca |	མཁའ་ལ་རླུང་བརྟེན་དེ་ལ་ཆུ་ཡི་ཕུང་པོ་བརྟེན་༎ དེ་ལ་ས་ཆེན་འདི་བརྟེན་དེ་ལ་འགྲོ་བ་བརྟེན་༎ སེམས་ཅན་ལས་ལ་སྤྱོད་པའི་རྒྱུ་ནི་དེ་འདྲ་སྟེ་༎
 sattvāna karmaupabhoganidānameva ākāśasthānu kutu cintayi etamartham || rgs_20|5 ||	ནམ་མཁའ་གང་ལ་གནས་ཡིན་དོན་འདི་བསམ་པར་གྱིས་༎ དེ་བཞིན་བྱང་ཆུབ་སེམས་དཔའ་སྟོང་པ་ཉིད་གནས་པ་༎ འགྲོ་ལ་སེམས་ཅན་ཤེས་པའི་སྨོན་ལམ་བརྟེན་ཅན་གྱི་༎
 emeva śūnyatapratiṣṭhitu eṣa sattvo jagati kriyāṃ vividha darśayate vicitrām | sattvāna jñānapraṇidhānaadhiṣṭhānameva na ca nirvṛtiṃ spṛśati śūnyata nāsti sthānam || rgs_20|6 ||	བྱ་བ་རྣམ་པ་སྣ་ཚོགས་དུ་མ་སྟོན་བྱེད་ཅིང་༎ མྱ་ངན་འདས་ལ་མི་རེག་སྟོང་པར་གནས་པ་མེད་༎
 yasmiṃśca kāli vidu paṇḍitu bodhisattvo caratī imāṃ pravara śūnya samādhi śāntām |	གང་གི་ཚེ་ན་བྱང་ཆུབ་སེམས་དཔའ་མཁས་གསལ་བ་༎ སྟོང་པ་ཞི་བའི་ཏིང་འཛིན་དམ་པ་འདི་སྤྱོད་པ་༎ བར་སྐབས་དེར་ནི་མཚན་མ་རབ་ཏུ་སྒོམ་མི་བྱེད་༎
 atrāntare na ca nimitta prabhāvitavyo na ca ānimittasthitu śānta praśāntacārī || rgs_20|7 ||	མཚན་མ་མེད་པར་གནས་ཤིང་ཞི་ལ་རབ་ཞི་སྤྱོད་༎ བར་སྣང་འཕུར་བའི་བྱ་ལ་གནས་ཡོད་མ་ཡིན་ཏེ་༎
 pakṣisya nāsti padu gacchata antarīkṣe no cāpi tatra sthitu no ca patāti bhūmau |	དེ་ན་གནས་པ་མ་ཡིན་ས་ལ་ལྷུང་མི་འགྱུར་༎
 tatha bodhisattva caramāṇu vimokṣadvāre na ca nirvṛtiṃ spṛśati no ca nimittacārī || rgs_20|8 ||	དེ་ལྟར་བྱང་ཆུབ་སེམས་དཔའ་རྣམ་ཐར་སྒོར་སྤྱོད་པ༏་༏མྱ་ངན་འདས་ལ་མི་རེག་མཚན་མར་སྤྱོད་མ་ཡིན་༎ 
 iṣvastraśikṣita yathā puruṣodha kāṇḍaṃ kṣepitva anya puna kāṇḍa paraspareṇa |	དཔེར་ན་འཕོང་བསླབ་སྐྱེས་བུས་གནམ་དུ་མདའ་འཕངས་ཏེ་༎ མདའ་གཞན་དག་ནི་ཕྱི་བཞིན་བརྒྱུད་མར་ཡོང་བཏགས་ཏེ་༎
 patanāya tasya purimasya na deya bhūmim ākāṅkṣamāṇa puruṣasya pateya kāṇḍam || rgs_20|9 ||	སྔ་མའི་མདའ་དེ་ས་ལ་ལྟུང་བའི་སྐབས་མི་འབྱེད་༎ མི་དེ་འདོད་ན་མདའ་དེ་ས་ལ་ལྟུང་བར་འགྱུར་༎ དེ་ལྟར་ཤེས་རབ་ཕ་རོལ་ཕྱིན་པ་མཆོག་སྤྱོད་པ་༎
 emeva prajñavarapāramitāṃ caranto prajñā upāya bala ṛddhi vicāramāṇo |	ཤེས་རབ་ཐབས་སྟོབས་རྫུ་འཕྲུལ་གྱིས་༄༢༠༤ཨ་༌༎ ནི་རྣམ་སྤྱོད་པ་༎
 tāvanna tāṃ paramaśūnyata prāpuṇoti yāvanna te kuśalamūla bhavanti pūrṇāḥ || rgs_20|10 ||	དེ་དག་དགེ་བའི་རྩ་བ་ཇི་སྲིད་མ་རྫོགས་པ་༎ དེ་སྲིད་སྟོང་ཉིད་དམ་པ་དེ་ནི་ཐོབ་མི་བྱེད་༎ དཔེར་ན་དགེ་སློང་རྫུ་འཕྲུལ་སྟོབས་མཆོག་ལྡན་པ་ཞིག་།
 bhikṣū yathā paramaṛddhibalenupeto gagane sthito yamaka kurvati prātihāryāṃ |	ནམ་མཁར་གནས་ཏེ་གཅིག་ཅར་ཆོ་འཕྲུལ་རྣམ་པར་འཕྲུལ་༎
 gaticaṃkramaṃ śayaniṣadya nidarśayāti na nivartate na pi ca khidyati yāva tatra || rgs_20|11 ||	འགྲོ་དང་འཆག་པ་དང་ནི་ཉལ་དང་འདུག་པ་སྟོན་༎ དེ་ནི་སྐྱོ་བ་མེད་ཅིང་དེ་ལ་དུབ་པ་མེད་༎
 emeva śūnyatasthito vidu bodhisattvo jñānarddhipāramigato aniketacārī |	དེ་བཞིན་བྱང་ཆུབ་སེམས་དཔའ་མཁས་པ་སྟོང་གནས་ཤིང་༎ ཡེ་ཤེས་རྫུ་འཕྲུལ་ཕ་རོལ་སོན་ལ་གནས་པ་མེད་༎ འགྲོ་བ་དག་ལ་བྱ་བ་རྣམ་པ་མཐའ་ཡས་སྟོན་༎
 vividhāṃ kriyāṃ jagati darśayate anantāṃ na ca bhajyatī na pi ca khidyati kalpakoṭī || rgs_20|12 ||	བསྐལ་པ་བྱེ་བར་སྐྱོ་བ་མེད་ཅིང་དུབ་པ་མེད༏་༏དཔེར་ན་མི་འགའ་ག-ཡང་ས་ཆེན་པོར་འདུག་བྱེད་ཅིང་༎ 
 puruṣā yathā mahaprapāti sthihitva kecid ubhi pāṇi chatradvaya gṛhṇa upakṣayeyyā |	ལག་པ་གཉི་གས་གདུགས་གཉིས་འཛིན་ཅིང་ནམ་མཁའ་ལ་༎ མཆོང་བར་བྱེད་ཅིང་ག-ཡང་ས་ཆེན་པོར་ལུས་བོར་ན་།
 ākāli vāyuravasṛjya mahāprapāte no ca prapāta patiyāti na yāva tatra || rgs_20|13 ||	ལྟུང་བར་མི་འགྱུར་ཇི་སྲིད་དེར་ནི་འགྲོ་བར་འགྱུར་༎
 emeva sthitva karuṇāṃ vidu bodhisattvo prajñāupāyadvayachatraparigṛhīto |	དེ་བཞིན་བྱང་ཆུབ་སེམས་དཔའ་མཁས་པ་སྙིང་རྗེར་གནས་༎ ཐབས་དང་ཤེས་རབ་གཉིས་ཀྱི་གདུགས་ནི་ཡོངས་བཟུང་སྟེ་༎ ཆོས་རྣམས་སྟོང་པ་མཚན་མེད་སྨོན་པ་མེད་རྟོག་ཅིང་༎
 śūnyānimittapraṇidhiṃ vimṛṣāti dharmān na ca nirvṛtiṃ spṛśati paśyati dharmacārī || rgs_20|14 ||	མྱ་ངན་འདས་ལ་རེག་པ་མེད་ལ་ཆོས་ཀྱང་མཐོང་༎
 ratanārthiko yatha vrajitvana ratnadvīpaṃ labdhvāna ratna puna gehamupāgameyyā |	དཔེར་ན་རིན་ཆེན་འདོད་པ་རིན་ཆེན་གླིང་སོང་སྟེ་༎ རིན་ཆེན་རྙེད་ནས་ཕྱིར་ཡང་ཁྱིམ་དུ་འོངས་འགྱུར་བ་༎
 kiṃcāpi tatra sukha jīvati sārthavāho api duḥkhito manasi bhoti sa jātisaṃgho || rgs_20|15 ||	དེར་ནི་དེད་དཔོན་འབའ་ཞིག་བདེ་བར་འཚོ་བྱེད་ཅིང་༎ གཉེན་བཤེས་ཚོགས་ཡིད་མི་བདེར་འཇོག་པ་མིན་པ་ལྟར་༎
 emeva śūnyata vrajitvana ratnadvīpaṃ labdhvāna dhyāna bala indriya bodhisattvo |	དེ་བཞིན་བྱང་ཆུབ་སེམས་དཔའ་སྟོང་ཉིད་རིན་༄༢༠༤བ་གྱི༏་༏གླིང་དུ་སོང་སྟེ་བསམ་གཏན་དབང་པོ་སྟོབས་ཐོབ་པ་༎ 
 kiṃcāpi nirvṛti spṛśedabhinandamāno api sarvasattva dukhitā manasī bhavanti || rgs_20|16 ||	མྱ་ངན་འདས་ལ་རེག་པ་འབའ་ཞིག་མངོན་དགའ་ཞིང་༎ སེམས་ཅན་སྡུག་བསྔལ་ཡིད་དུ་འཇོག་པར་འགྱུར་མ་ཡིན༏་༏་དཔེར་ན་དོན་གཉེར་ཚོང་པ་རྒྱུས་ཤེས་བྱ་བའི་ཕྱིར་༎ 
 abhyantare ya nagare nigame ca grāme kāmārtha vāṇiju yathā gami jānanāya |	བར་གྱི་གྲོང་ཁྱེར་གྲོང་རྡལ་གང་ཡིན་བདེ་བར་འགྲོ་།
 no cāpi tatra sthihatī na ca ratnadvīpe na ca geha mārgi kuśalo puna bhoti vijño || rgs_20|17 ||	དེར་ཡང་མི་གནས་རིན་ཆེན་གླིང་དུའང་མི་གནས་ལ་༎ རིག་པ་ཁྱིམ་དུ་མི་གནས་མ་ལ་མཁས་པར་འགྱུར་༎
 tatha jñāna śrāvakavimuktisapratyayānāṃ sarvatra bhoti kuśalo vidu bodhisattvo |	དེ་བཞིན་བྱང་ཆུབ་སེམས་དཔའ་གསལ་དེ་ཉན་ཐོས་དང་༎ རང་རྒྱལ་རྣམས་ཀྱི་ཤེས་པ་རྣམ་གྲོལ་ཀུན་ལ་མཁས་༎
 no cāpi tatra sthihate na ca buddhajñāne na ca saṃskṛte bhavati mārgavidū vidhijño || rgs_20|18 ||	དེ་ལ་མི་གནས་སངས་རྒྱས་ཡེ་ཤེས་གནས་མ་ཡིན་༎ འདུས་མ་བྱས་ལ་མི་གནས་ལམ་གྱི་ཚུལ་ཤེས་ཡིན་༎
 yaṃ kāli maitri jagatī anubandhayitvā śūnyānimittapraṇidhī carate samādhim |	གང་ཚེ་འགྲོ་ལ་བྱམས་པས་རྗེས་སུ་འབྲེལ་བྱས་ནས་༎ ཏིང་འཛིན་སྟོང་པ་མཚན་མེད་སྨོན་པ་མེད་སྤྱོད་པ་༎ དེ་ནི་མྱ་ངན་འདས་པ་ཐོབ་པར་འགྱུར་ཞེ་འམ་༎
 asthānameva yadi nirvṛti prāpuṇeyā athavāpi saṃskṛta sa prajñapanāya śakyaḥ || rgs_20|19 ||	འདུས་བྱས་ཡིན་པར་གདགས་ནུས་དེ་ནི་གནས་མེད་དེ་༎
 yatha nirmito puruṣa no va adṛśyakāyo nāmena vā puna sa prajñapanāya śakyaḥ |	དཔེར་ན་སྤྲུལ་པའི་མི་ལུས་མི་སྣང་མ་ཡིན་ཞིང་༎
 tatha bodhisattva caramāṇu vimokṣadvāraṃ nāmena vā puna sa prajñapanāya śakyaḥ || rgs_20|20 || yadi pṛcchamāna cari indriya bodhisattvo gambhīradharmaparidīpana no karoti |	དེ་ནི་མིང་གིས་ཀྱང་ནི་གདགས་པར་ནུས་པ་ལྟར༏་༏དེ་བཞིན་བྱང་ཆུབ་སེམས་དཔའ་རྣམ་ཐར་སྒོར་སྤྱོད་པ་༎ དེ་ནི་མིང་གིས་ཀྱང་ནི་གདགས་པར་ནུས་པ་ཡིན་༎
 śūnyānimitta avivartiyabodhidharmāṃ na ca śocatī na ca sa vyākṛtu veditavyo || rgs_20|21 ||	གལ་ཏེ་སྤྱོད་པ་དང་ནི་དབང་པོ་ཡོངས་དྲིས་ལ་༎ བྱང་ཆུབ་སེམས་དཔའ་སྟོང་པ་མཚན་མ་མེད་པའི་ཆོས་༎ ཡོངས་སུ་མི་སྟོན་ཕྱིར་མི་ལྡོག་པའི་ས་ཡི་ཆོས་༎ མི་འཆད་དེ་ནི་ལུང་མ་བསྟན་པ་ཡིན་རིག་བྱ་༎ དགྲ་བཅོམ་ས་དང་རྐྱེན་གྱི་སངས་རྒྱས་ཡེ་ཤེས་དང་༎ ཁམས་༄༢༠༥ཨ་༌༎
 arhantabhūmimapi pratyayabuddhabhūmau traidhātukaṃ na spṛśate supināntare 'pi |	གསུམ་དག་ན་རྨི་ལམ་ན་ཡང་མི་འདོད་ཅིང་༎
 buddhāṃśca paśyati katheti janasya dharmaṃ avivartiyeti ayu vyākṛtu veditavyo || rgs_20|22 ||	སངས་རྒྱས་རྣམས་མཐོང་འགྲོ་ལ་ཆོས་ཀྱང་སྟོན་བྱེད་པ་༎ དེ་ནི་མི་ལྡོག་ལུང་བསྟན་ཡིན་པར་རིག་པར་བྱ་༎ རྨི་ལམ་ན་ནི་སེམས་ཅན་ངན་སོང་གསུམ་གནས་མཐོང་༎
 triapāyaprāptu supinasmi viditva sattvān praṇidheti tatkṣaṇa apāya ucchoṣayeyam |	སྐད་ཅིག་དེ་ལ་ངན་སོང་རྒྱུན་གཅོད་སྨོན་ལམ་འདེབས་༎
 satyādhiṣṭhāni praśameti sa cāgniskandham avivartiyeti ayu vyākṛtu veditavyo || rgs_20|23 ||	བདེན་པའི་བྱིན་གྱི་རླབས་ཀྱིས་མེ་ཡི་ཕུང་པོ་ཞི་༎ དེ་ནི་མི་ལྡོག་ལུང་བསྟན་ཡིན་པར་རིག་པར་བྱ་༎
 bhūtagrahā vividha vyādhaya martyaloke satyādhiṣṭhāni praśameti hitānukampī |	མི་ཡི་འཇིག་རྟེན་འབྱུང་པོའི་གདོན་དང་ནད་མང་བ་༎ ཕན་དང་སྙིང་བརྩེར་ལྡན་པའི་བདེན་པའི་བྱིན་གྱིས་ཞི་༎
 na ca tena manyanupapadyati nāpi mānam avivartiyeti ayu vyākṛtu veditavyaḥ || rgs_20|24 ||	འོན་ཀྱང་སློ་མ་སེམས་མེད་ཅིང་ང་རྒྱལ་སྐྱེ་མེད་པ་༎
 bhagavatyāṃ ratnaguṇasaṃcayagāthāyāmupāyakauśalyamīmāṃsāparivarto nāma viṃśatitamaḥ ||	དེ་ནི་མི་ལྡོག་ལུང་བསྟན་ཡིན་པར་རིག་པར་བྱ་༎
 athavāsya manyanupapadyati vyākṛto 'smi satyādhiṣṭhāna vividhāni samṛddhyayanti |	ཅི་སྟེ་དེ་ནི་བདེན་པའི་བྱིན་བརླབས་སྣ་ཚོགས་དག་། འབྱོར་པས་བདག་ལུང་བསྟན་སྙམ་རློམ་སེམས་འབྱུང་བ་འམ་༎
 yadi anya vyākṛtaku manyati bodhisattvo jñātavya manyanasthito ayu alpabuddhiḥ || rgs_21|1 ||	གལ་ཏེ་བྱང་ཆུབ་སེམས་དཔའ་གཞན་གྱི་ལུང་བསྟན་རློམ་༎ རློམ་སེམས་གནས་པ་དེ་ནི་བློ་ཆུང་ཤེས་པར་བྱ་༎
 nāmādhiṣṭhāna puna māra upāgamitvā evaṃ vadiṣyati idaṃ tava nāmadheyam |	མིང་གི་གཞི་ལས་བདུད་ནི་ཉེ་བར་འོངས་གྱུར་ནས་༎
 mātāpitāya anusaptamupaiti vaṃśo buddho yadā bhavi idaṃ tava nāmadheyam || rgs_21|2 || dhutavṛtta yādṛśu sa bheṣyati yuktayogī pūrvaṃ pi tubhya imi āsi guṇovarūpā |	འདི་སྐད་སྨྲ་སྟེ་འདི་ནི་ཁྱོད་དང་ཕ་མ་དང་༎ ཁྱོད་ཀྱི་བདུན་མེས་བརྒྱུད་ཀྱི་བར་གྱི་མིང་ཡིན་ཞིང་༎ གང་ཚེ་ཁྱོད་ནི་སངས་རྒྱས་འགྱུར་བའི་མིང་འདི་ཡིན་༎ སྦྱངས་སྡོམ་རྣལ་འབྱོར་ལྡན་པ་ཅི་འདྲ་འབྱུང་འགྱུར་ལ་༎ ཁྱོད་སྔོན་ཡོན་ཏན་ཚུལ་ཡང་འདི་འདྲ་ཞེས་བརྗོད་དེ་༎
 yo eva śrutva abhimanyati bodhisattvo jñātavyu māru paryutthitu alpabuddhiḥ || rgs_21|3 ||	དེ་སྐད་གང་ཐོས་རློམ་སེམས་བྱང་ཆུབ་སེམས་དཔའ་ནི་༎ བདུད་ཀྱིས་ཡོངས་སུ་བསླང་ཞིང་བློ་ཆུང་༄༢༠༥བ་རིག་པར་བྱ་༎
 pravivikta grāmanagare girikandarāṇi raṇyā vivikta vanaprastha niṣevamāṇo | ātmānukarṣi para paṃsayi bodhisattvo jñātavyu māru paryutthitu alpabuddhiḥ || rgs_21|4 ||	རབ་ཏུ་དབེན་པའི་གྲོང་དང་གྲོང་ཁྱེར་རི་སུལ་དང་༎ དགོན་པ་དབེན་པ་ནགས་ཁྲོད་རབ་ཏུ་སྟེན་བྱེད་ཅིང་༎ བདག་སྟོད་གཞན་ལ་སྨོད་པའི་བྱང་ཆུབ་སེམས་དཔའ་ནི་༎ བདུད་ཀྱིས་ཡོངས་སུ་བསླང་ཞིང་བློ་ཆུང་རིག་པར་བྱ་༎
 grāme ca rāṣṭri nigame viharanti nityaṃ rahapratyayāni spṛhatāṃ janayanti tatra |	རྟག་ཏུ་གྲོང་དང་ཡུལ་འཁོར་གྲོང་རྡལ་གནས་བྱེད་ཅིང་༎
 anyatra sattvaparipācanabodhiyuktā eṣo viveku kathito sugatātmajānām || rgs_21|5 ||	སེམས་ཅན་སྨིན་བྱེད་བྱང་ཆུབ་བརྩོན་པ་མ་གཏོགས་པར་༎ དེ་ནི་དགྲ་བཅོམ་རང་རྒྱལ་འདོད་པ་གཞན་མི་བསྐྱེད་༎ འདི་ནི་བདེ་བར་གཤེགས་པའི་སྲས་ཀྱི་དབེན་པར་གསུངས་༎
 yo pañcayojanaśate girikandareṣu vyālāvakīrṇi nivasedbahuvarṣakoṭī |	གང་ཞིག་དཔག་ཚད་ལྔ་བརྒྱ་ཡོད་པའི་རི་ཡི་སུལ་༎
 no cā viveku imu jānati bodhisattvo saṃkīrṇa so viharate adhimānaprāptaḥ || rgs_21|6 ||	སྦྲུལ་གྱིས་གང་བར་ལོ་མང་བྱེ་བར་གནས་བྱེད་ཀྱང་༎ དབེན་པ་འདི་མི་ཤེས་པའི་བྱང་ཆུབ་སེམས་དཔའ་དེ་༎ ལྷག་པའི་ང་རྒྱལ་རྙེད་ནས་འདྲེ་པར་གནས་པ་ཡིན་༎
 so caṃkramārthamabhiyuktakabodhisattvān baladhyānaindriyavimokṣasamādhiprāptān |	བྱང་ཆུབ་སེམས་དཔའ་འགྲོ་བའི་དོན་བརྩོན་བསམ་གཏན་དང་༎ སྟོབས་དང་དབང་པོ་རྣམ་ཐར་ཏིང་འཛིན་ཐོབ་དེ་ལ་༎
 abhimanyate na imi raṇyavivekacārī na vivekagocaru ayaṃ hi jinena ukto || rgs_21|7 ||	འདི་ནི་དགོན་དབེན་སྤྱོད་པ་མིན་སྙམ་བརྙས་བྱེད་པ་༎ དེ་ནི་བདུད་ཀྱི་སྤྱོད་ཡུལ་གནས་ཞེས་རྒྱལ་བས་གསུངས་༎
 grāmānti yo viharate athavā araṇye dvayayānacittavigato niyato 'grabodhim |	གང་ཞིག་གྲོང་ངམ་འོན་ཏེ་དགོན་པར་གནས་ཀྱང་རུང་༎ ཐེག་པ་གཉིས་ཀྱི་སེམས་བྲལ་བྱང་ཆུབ་མཆོག་ངེས་ན་༎
 eṣo viveku jagadarthabhiprasthitānāṃ ātmā kṣiṇoti tulayeya sa bodhisattvo || rgs_21|8 || bhagavatyāṃ ratnaguṇasaṃcayagāthāyāṃ mārakarmaparivarto nāmaikaviṃśatitamaḥ |	འདི་ནི་འགྲོ་དོན་ཞུགས་པ་རྣམས་ཀྱི་དབེན་པ་སྟེ་༎ བྱང་ཆུབ་སེམས་དཔའ་དྲོད་སྙོམས་དེ་ནི་བདག་ཉིད་ཉམས་༎
 tasmā hu mānu nihanitvana paṇḍitena guruāśayena varabodhi gaveṣamāṇaḥ |	དེ་ལྟ་བས་ན་བྱང་ཆུབ་དམ་པ་ཚོལ་བ་ཡི་༎ བསམ་པ་དྲག་ལྡན་མཁས་པས་ང་རྒྱལ་ངེས་བཅོམ་སྟེ་༎
 vaidyo va ātura svarogacikitsanārthaṃ kalyāṇamitra bhajitavya atandritena || rgs_22|1 ||	ནད་པའི་ཚོགས་ཀྱིས་གོས་ཕྱིར་སྨན་པ་བསྟེན་༄༢༠༦ཨ་༌༎ པ་ལྟར་༎ ག-ཡེལ་བ་མེད་པར་དགེ་བའི་བཤེས་གཉེན་བསྟེན་པར་བྱ་༎
 buddhā ya bodhivaraprasthita bodhisattvā kalyāṇamitra imi pāramitā nidiṣṭāḥ |	སངས་རྒྱས་བྱང་ཆུབ་མཆོག་ཞུགས་བྱང་ཆུབ་སེམས་དཔའ་དག་། ཕ་རོལ་ཏུ་ཕྱིན་དང་བཅས་ཏེ་དགེ་བའི་བཤེས་སུ་བསྟེན་༎ དེ་དག་རྗེས་སུ་སྟོན་བྱེད་འདི་ནི་སྒྲུབ་པ་ཡིས་༎
 te cānuśāsaka iyaṃ pratipattibhūmī duvi kāraṇena anubudhyati buddhabodhim || rgs_22|2 ||	རྒྱུ་རྣམ་གཉིས་ཀྱིས་སངས་རྒྱས་བྱང་ཆུབ་མྱུར་དུ་རྟོགས་༎
 atikrāntanāgata jinā sthita ye diśāsu sarveṣu mārgu ayu pāramitā ananyo |	རྒྱལ་བ་འདས་དང་མ་བྱོན་ཕྱོགས་བཅུ་གང་བཞུགས་པ༏་༏ཀུན་ལམ་ཕ་རོལ་ཕྱིན་པ་འདི་ཡིན་གཞན་མ་ཡིན་༎ 
 obhāsa ulka varabodhayi prasthitānām āloka śāstri imi pāramitā pradiṣṭāḥ || rgs_22|3 ||	ཕ་རོལ་ཕྱིན་འདི་བྱང་ཆུབ་མཆོག་ལ་ཞུགས་རྣམས་ཀྱི་༎ གསལ་དང་སྒྲོན་དང་སྣང་དང་སྟོན་མཆོག་ཡིན་ཞེས་བཤད་༎
 yatha prajñapāramita śūnyata lakṣaṇena tathalakṣaṇā ya imi jānati sarvadharmān |	ཇི་ལྟར་ཤེས་རབ་ཕ་རོལ་ཕྱིན་པ་མཚན་ཉིད་སྟོང་༎ ཆོས་འདི་ཐམས་ཅད་མཚན་ཉིད་དེ་དང་འདྲར་ཤེས་ཤིང་༎ ཆོས་རྣམས་སྟོང་ཞིང་མཚན་མ་མེད་པར་རབ་ཤེས་ན་༎
 śūnyānalakṣaṇa prajānayamāna dharmān evaṃ carantu caratī sugatāna prajñām || rgs_22|4 ||	དེ་ལྟར་སྤྱོད་པ་བདེ་གཤེགས་ཤེས་རབ་སྤྱོད་པ་ཡིན་༎
 āhārakāma parikalpayamāna sattvāḥ saṃsāri yuktamanasaḥ sada saṃsmaranti | ahu mahya dharma ubhi eti abhūta śūnyā ākāśagaṇṭhi ayu ātmana baddha bāle || rgs_22|5 ||	སེམས་ཅན་ཡོངས་སུ་རྟོག་པས་ཟས་ལ་འདོད་བྱེད་ཅིང་༎ འཁོར་བར་ཆགས་པའི་ཡིད་དང་ལྡན་རྣམས་རྟག་ཏུ་འཁོར་༎ བདག་དང་བདག་གི་ཆོས་གཉིས་ཡང་དག་མིན་སྟོང་སྟེ་༎ བྱིས་པ་བདག་ཉིད་ཀྱིས་ནི་མཁའ་ལ་མདུད་པ་བོར་༎ དཔེར་ན་དོགས་པའི་འདུ་ཤེས་ཀྱིས་ནི་དུག་བསླངས་པ་༎
 yatha śaṅkitena viṣasaṃjñata abhyupaiti no cāsya koṣṭhagatu so viṣu pātyate ca |	དུག་དེ་ཁོང་དུ་སོང་བ་མེད་ཀྱང་བརྒྱལ་བར་འགྱུར་༎ དེ་བཞིན་བྱིས་པ་བདག་དང་བདག་གིར་ཁས་ལེན་པ་༎
 emeva bālupagato ahu mahya eṣo ahasaṃjñi jāyi mriyate ca sadā abhūto || rgs_22|6 || yatha udgraho tatha prakāśitu saṃkileśo vyodāna ukta ahu mahya anopalabdhi |	བདག་དེར་འདུ་ཤེས་ཡང་དག་མིན་རྟོག་སྐྱེ་ཞིང་འཆི་༎ ཇི་ལྟར་འཛིན་པ་དེ་ལྟར་ཀུན་ནས་ཉོན་མོངས་༄༢༠༦བ་བསྟན༏་༏བདག་དང་བདག་གིར་མི་དམིགས་རྣམ་པར་བྱང་བར་གསུངས་༎ 
 na hi atra kaści yo kliśyati śudhyate vā prajñāya pāramita budhyati bodhisattve || rgs_22|7 ||	འདི་ལ་གང་ཡང་ཉོན་མོངས་རྣམ་དག་འགྱུར་མེད་པར་༎ བྱང་ཆུབ་སེམས་དཔས་ཤེས་རབ་ཕ་རོལ་ཕྱིན་པ་རྟོགས་༎
 yāvanta sattva nikhile iha jambudvipe te sarvi bodhivaracitta upādayitvā |	འཛམ་བུའི་གླིང་ན་སེམས་ཅན་ཇི་སྙེད་མ་ལུས་པ་༎ དེ་དག་ཐམས་ཅད་བྱང་ཆུབ་མཆོག་ཏུ་སེམས་བསྐྱེད་ནས་༎
 dānaṃ daditva bahuvarṣasahasrakoṭīḥ sarvaṃ ca nāmayi jagārthanidāna bodhau || rgs_22|8 ||	ལོ་སྟོང་བྱེ་བ་མང་པོར་སྦྱིན་པ་བྱིན་བྱས་ལ་༎ ཀུན་ཀྱང་འགྲོ་བའི་དོན་ཕྱིར་བྱང་ཆུབ་རྒྱུར་བསྔོ་ཡང་༎ གང་ཞིག་ཤེས་རབ་ཕ་རོལ་ཕྱིན་ལ་མངོན་བརྩོན་པ་༎
 yaścaiava prajñavarapāramitābhiyukto divasaṃ pi antamaśa ekanuvartayeyā |	ཐ་ན་ཉི་མ་གཅིག་ཅིག་རྗེས་སུ་མཐུན་བྱེད་ན་༎
 kalapuṇya so na bhavatī iha dānaskandho tadatandritena sada osaritavya prajñā || rgs_22|9 ||	དེ་ལ་སྦྱིན་པའི་ཕུང་པོས་བསོད་ནམས་ཆར་མི་ཕོད་༎ དེ་ཕྱིར་ག-ཡེལ་མེད་རྟག་ཏུ་ཤེས་རབ་འཇུག་པར་བྱ་༎ ཤེས་རབ་ཕ་རོལ་ཏུ་ཕྱིན་མཆོག་སྤྱོད་པའི་རྣལ་འབྱོར་པ་༎
 caramāṇu prajñavarapāramitāya yogī mahatīṃ janeti karuṇāṃ na ca sattvasaṃjñā |	སྙིང་རྗེ་ཆེན་པོ་བསྐྱེད་ཅིང་སེམས་ཅན་འདུ་ཤེས་མེད་༎ དེ་ཚེ་མཁས་པ་འགྲོ་བ་ཀུན་གྱི་སྦྱིན་གནས་འགྱུར་༎
 tada bhonti sarvajagatī vidu dakṣiṇīyā satataṃ amoghu paribhuñjati rāṣṭrapiṇḍam || rgs_22|10 ||	རྟག་ཏུ་ཡུལ་འཁོར་བསོད་སྙོམས་དོན་ཡོད་ཡོངས་སུ་སྤྱོད་༎ བྱང་ཆུབ་སེམས་དཔའ་གང་འདིར་ཡུན་རིང་འབྲེལ་པ་ཡི་༎
 cirabuddhadevamanujān triapāyi sattvān parimocituṃ ya iha icchati bodhisattvo |	ལྷ་མི་ངན་སོང་གསུམ་གྱི་སེམས་ཅན་དགྲོལ་བའི་ཕྱིར་༎
 pṛthumārgu tīru upadarśayi sattvadhātau prajñāya pāramita yukta divā ca rātrau || rgs_22|11 ||	ལམ་ཡངས་ཕ་རོལ་སེམས་ཅན་ཁམས་ལ་དོན་འདོད་པ་༎ ཉིན་མཚན་ཤེས་རབ་ཕ་རོལ་ཏུ་ཕྱིན་ལ་བརྩོན་པར་བྱ་༎
 puruṣo ya agru ratanasya alabdhapūrvo aparasmi kāli puna labdhva bhaveya tuṣṭo | sa ha labdhva nāśayi puno 'pi pramādabhūto nāśitva duḥkhi satataṃ ratanābhikāṅkṣī || rgs_22|12 ||	མི་ཞིག་སྔོན་ཆད་མ་རྙེད་པ་ཡི་རིན་ཆེན་མཆོག་། དུས་གཞན་ཞིག་ན་རྙེད་པར་གྱུར་ཏེ་དགའ་བ་ལས༏་༏རྙེད་མ་ཐག་ཏུ་བག་མེད་གྱུར་ཏེ་སྟོར་ན་ནི་༎ སྟོར་བས་རིན་ཆེན་མངོན་འདོད་རྟག་ཏུ་སྡུག་བསྔལ་ལོ་༎
 emeva bodhivaraprasthita ratnatulyo prajñāya pāramita yogu na riñcitavyo |	དེ་ལྟར་བྱང་ཆུབ་མཆོག་ཞུགས་རིན་ཆེན་ལྟ་བུ་ཡི་༎ ཤེས་རབ་ཕ་རོལ་ཕྱིན་༄༢༠༧ཨ་༌༎ ལ་རྣལ་འབྱོར་དོར་མི་བྱ་༎
 ratanaṃ va labdhva gṛhamāṇu abhinnasattvo anubuddhayati tvarito śivamabhyupaiti || rgs_22|13 || bhagavatyāṃ ratnaguṇasaṃcayagāthāyāṃ kalyāṇamitraparivarto nāma dvāviṃśatitamaḥ ||	རིན་ཆེན་རྙེད་ནས་བླངས་ཏེ་རབ་ཏུ་བརྩོན་བཀྲིས་ནས་༎
 udayāti sūryu vigatāśca marīcimālā vidhamitva sarva tamasākulamandhakāram |	མྱུར་དུ་འགྲོ་བར་བྱེད་པ་ཞི་བར་འགྱུར་བ་བཞིན་༎ ཉི་མ་སྤྲིན་དང་བྲལ་བའི་འོད་ཟེར་དྲ་བ་ཅན་༎ མུན་ནག་ཐིབས་པོའི་མུན་པ་ཐམས་ཅད་འཇོམས་འཆར་བ་༎
 avibhonti sarva krimijotikaprāṇabhūtāṃ sarvāṃśca tārakagaṇānapi candraābhām || rgs_23|1 || emeva prajñavarapāramitāṃ caranto vidhamitva dṛṣṭigahanaṃ vidu bodhisattvo |	སྲིན་བུ་མེ་ཁྱེར་སྲོག་ཆགས་འབྱུང་པོ་ཐམས་ཅད་དང་༎ སྐར་མའི་ཚོགས་དང་ཟླ་བའི་འོད་ཀུན་ཟིལ་གྱིས་གནོན་༎
 abhibhonti sarvajagatī rahapratyayāṃśca śūnyānimittacarito pṛthu bodhisattvo || rgs_23|2 ||	དེ་བཞིན་བྱང་ཆུབ་སེམས་དཔའ་ཤེས་རབ་ཕ་རོལ་ཕྱིན་༎ མཆོག་སྤྱོད་སྟོང་བ་དང་ནི་མཚན་མ་མེད་སྤྱོད་པ་༎ མཁས་པས་ལྟ་བའི་ཐིབས་པོ་བཅོམ་ནས་འགྲོ་ཀུན་དང་༎ དགྲ་བཅོམ་རང་རྒྱལ་བྱང་ཆུབ་སེམས་མང་ཟིལ་གྱིས་གནོན་༎
 yatha rājaputra dhanadāyaku arthakāmo sarveṣu śreṣṭha bhavate abhigāminīye |	དཔེར་ན་རྒྱལ་པོའི་བུ་ཞིག་ནོར་སྟེར་དོན་འདོད་པ་༎ ཀུན་གྱི་གཙོ་བོར་གྱུར་ཏེ་མངོན་པར་འགྲོ་བྱ་འོས་༎
 sa hyeṣa etarahi sattva pramocayāti prāgeva rājyasthitu bheṣyati paṭṭadhārī || rgs_23|3 ||	འདི་ནི་ད་ལྟར་ན་ཡང་སེམས་ཅན་མང་དགའ་བྱེད་༎ ཐབས་ཐོབ་གྱུར་ཏེ་རྒྱལ་སྲིད་གནས་ན་སྨོས་ཅི་དགོས་༎
 emeva prajñacarito vidu bodhisattvo amṛtasya dāyaku priyo marumānuṣāṇām | ayu eṣa eṣati hi sattvasukhābhiyukto prāgeva yāva sthitu bheṣyati dharmarājo || rgs_23|4 || bhagavatyāṃ ratnaguṇasaṃcayagāthāyāṃ śakraparivarto nāma trayoviṃśatitamaḥ ||	དེ་ལྟར་ཤེས་རབ་སྤྱོད་མཁས་བྱང་ཆུབ་སེམས་དཔའ་ཡང་༎ བདུད་རྩི་སྦྱིན་པར་བྱེད་ཅིང་ལྷ་དང་མི་རྣམས་དགའ༎ འདི་ནི་ད་ལྟར་ན་ཡང་སེམས་ཅན་མང་ཕན་བརྩོན་༎ ཆོས་ཀྱི་རྒྱལ་པོར་གནས་པར་གྱུར་ན་སྨོས་ཅི་དགོས་༎
 māro 'pi tasmi samaye bhavate saśalyo śokātu duḥkhitu anantamano 'lpasthāmo |	དེ་ཡི་ཚེ་ན་བདུད་ནི་ཟུག་རྡུ་ལྡན་པར་འགྱུར་༎ མྱ་ངན་ཉམ་ཐག་སྡུག་བསྔལ་ཡིད་བདེ་ཉམ་ཆུང་བ་༎
 diśadāha ulka kṣipate bhayadarśanārthaṃ kathameṣa dīnamanaso bhavi bodhisattvo || rgs_24|1 ||	ཇི་ལྟར་བྱང་ཆུབ་སེམས་དཔའ་འདི་ཡིད་ནུར་འགྱུར་ཞེས་༎ འཇིགས་པ་བསྟན་ཕྱིར་ཕྱོགས་རྣམས་སྲེག་ཅིང་སྐར་མདའ་གཏོང་༎ ༄༢༠༧བ་གང་ཚེ་མཁས་པ་དེ་དག་བསམ་པ་རབ་ལྡན་ཞིང་༎
 [yatha te bhavanti vidu āśayasaṃprayuktā divarātri prajñavarapāramitārthadarśī] | tada kāyacitta khagapakṣisatulyabhūtā avatāru so kutu labhiṣyati kṛṣṇabandhuḥ || rgs_24|2 ||	ཉིན་མཚན་ཤེས་རབ་ཕ་རོལ་ཕྱིན་པ་མཆོག་དོན་ལྟ༏་༏དེ་ཚེ་ལུས་སེམས་དག་ནི་མཁའ་འགྲོ་བྱ་ལྟར་གྱུར་༎ ནག་པོའི་རྩ་ལག་རྣམས་ཀྱིས་གླགས་རྙེད་ག་ལ་འགྱུར་༎ གང་ཚེ་བྱང་ཆུབ་སེམས་དཔའ་འཐབ་དང་རྩོད་གྱུར་ཅིང་༎
 kalahāvivādupagatā yada bodhisattvā bhonti parasparaviruddhaka ruṣṭacittāḥ |	ཕན་ཚུན་མི་མཐུན་ཁྲོས་པའི་སེམས་དང་ལྡན་གྱུར་པ་༎
 tada māra tuṣṭu bhavatī paramaṃ udagro ubhi eti dūra bhaviṣyanti jināna jñāne || rgs_24|3 ||	དེ་ཚེ་བདུད་ནི་དགའ་ཞིང་མཆོག་ཏུ་ཉམས་བདེར་འགྱུར་༎ དེ་གཉིས་རྒྱལ་བའི་ཡེ་ཤེས་ལས་ནི་རིང་འགྱུར་སྙམ་༎ དེ་གཉིས་རིང་དུ་འགྱུར་ཞིང་ཤ་ཟ་འདྲ་བར་འགྱུར་༎ གཉི་ག་རང་གི་དམ་བཅས་ཉམས་པར་བྱེད་པར་འགྱུར་༎ སྡང་ཞིང་བཟོད་དང་བྲལ་ལ་བྱང་ཆུབ་ག་ལ་ཡོད་༎
 ubhi eti dūri bhaviṣyanti piśācatulyā ubhi eti ātma kariṣyanti pratijñahānim | duṣṭāna kṣāntivikalāna kuto 'sti bodhi tada māru tuṣṭu bhavatī namucīsapakṣo || rgs_24|4 ||	དེ་ཚེ་བདུད་རྣམས་ཕྱོགས་དང་བཅས་ཏེ་དགའ་བར་འགྱུར་༎ ལུང་བསྟན་མ་ཐོབ་བྱང་ཆུབ་སེམས་དཔའ་གང་ཞིག་གིས་༎
 yo bodhisattva ayu vyākṛtu vyākṛtasmiṃ cittaṃ pradūṣayi vivādu samārabheyyā |	ལུང་བསྟན་ཐོབ་ལ་སེམས་ཁྲོས་རྩོད་པ་རྩོམ་བྱེད་ན་༎
 yāvanti cittakṣaṇikā khiladoṣayuktās tāvanta kalpa puna saṃnahitavya bhonti || rgs_24|5 ||	ཐ་བ་སྐྱོན་ལྡན་སེམས་ཀྱི་སྐད་ཅིག་ཇི་སྙེད་པ་༎ དེ་སྙེད་བསྐལ་པར་གཞི་ནས་གོ་ཆ་བགོ་དགོས་སོ་༎
 atha tasyupadyati matīti aśobhanā ti kṣāntīya pāramita bodhi spṛśanti buddhāḥ |	སངས་རྒྱས་བཟོད་པའི་ཕ་རོལ་ཕྱིན་པས་བྱང་ཆུབ་རེག་། སེམས་འདི་བཟང་བ་མིན་སྙམ་དྲན་པ་སྐྱེད་བྱེད་ཅིང་༎
 pratidarśayāti puna āyati saṃvarāṇi apayāti vā sa iha śikṣati buddhadharme || rgs_24|6 || bhagavatyāṃ ratnaguṇasaṃcayagāthāyāmabhimānaparivarto nāma caturviṃśatitamaḥ ||	སོ་སོར་འཆགས་པར་བྱེད་ཅིང་ཕྱིས་ཀྱང་སྡོམ་བྱེད་ལ་༎
 yo śikṣamāṇu na upaiti kahiṃci śikṣāṃ na ca śikṣakaṃ labhati nāpi ca śikṣadharmān |	དགའ་བར་མི་བྱེད་འདི་ནི་སངས་རྒྱས་ཆོས་འདིར་སློབ་༎ གང་ཞིག་སློབ་ཚེ་བསླབ་པ་གང་ཡང་ཁས་མི་ལེན་༎
 śikṣā aśikṣa ubhayo avikalpamāno yo śikṣate sa iha śikṣati buddhadharme || rgs_25|1 ||	སློབ་པ་པོ་དང་བསླབ་པའི་ཆོས་རྣམས་མི་དམིགས་ཤིང་༎ བསླབ་དང་བསླབ་པ་མ་ཡིན་འདི་གཉིས་མི་རྟོག་པ་༎ དེ་ལྟར་གང་སློབ་དེ་ནི་སངས་རྒྱས་ཆོས་འདིར་༄༢༠༨ཨ་༌༎ སློབ༏་༏བྱང་ཆུབ་སེམས་དཔའ་གང་ཞིག་དེ་ལྟའི་བསླབ་འདི་ཤེས་༎
 yo bodhisattva imu jānati eva śikṣāṃ na sa jātu śikṣavikalo bhavate duśīlo |	དེ་ནི་གཞན་ཡང་བསླབ་ཉམས་ཚུལ་ཁྲིམས་འཆལ་མི་འགྱུར་༎ དེ་ནི་སངས་རྒྱས་ཆོས་བརྙེས་བྱ་ཕྱིར་འདི་ལ་སློབ་༎
 ārādhiteṣu iha śikṣati buddhadharmaṃ śikṣātiśikṣakuśalo ti nirūpalambho || rgs_25|2 ||	དེ་ནི་བསླབ་ལ་མཁས་ཏེ་དེ་ནི་དམིགས་པ་མེད་༎ མཁས་པ་འོད་བྱེད་རྣམས་ཀྱིས་ཤེས་རབ་དེ་ལྟར་སློབ་༎
 śikṣantu eva vidu prajña prabhaṃkarāṇāṃ notpadyate akuśalamapi ekacittam |	དགེ་བ་མ་ཡིན་སེམས་གཅིག་ཙམ་ཡང་སྐྱེད་མི་བྱེད་༎ ཉི་མ་མཁའ་ལ་འགྲོ་བའི་ཟེར་གྱིས་ཟིལ་གནོན་པའི་༎
 sūrye yathā gagani gacchati antarīkṣe raśmīgate na sthihate purato 'ndhakāram || rgs_25|3 ||	མདུན་གྱི་བར་སྣང་ལ་ནི་མུན་པ་མི་གནས་བཞིན་༎
 prajñāya pāramita śikṣita saṃskṛtānāṃ sarveṣa pāramita bhontiha saṃgṛhītāḥ |	ཤེས་རབ་ཕ་རོལ་ཕྱིན་ལ་བསླབ་པ་བྱས་རྣམས་ཀྱི་༎ ཕ་རོལ་ཕྱིན་པ་ཐམས་ཅད་འདིར་ནི་འདུས་པར་འགྱུར་༎
 satkāyadṛṣṭi yatha ṣaṣṭi duve ca dṛṣṭī antargatāstathami pāramitā bhavanti || rgs_25|4 ||	འཇིག་ཚོགས་ལྟ་བར་ལྟ་བ་དྲུག་ཅུ་གཉིས་འདུས་ལྟར་༎ དེ་བཞིན་ཕ་རོལ་ཕྱིན་པ་འདི་དག་འདུས་པར་གསུངས་༎
 yatha jīvitendriya niruddhi ya kecidanye bhontī niruddha pṛthu indriya yāvadasti |	དཔེར་ན་སྲོག་གེ་དབང་པོ་འགག་ན་དབང་པོ་གཞན་༎ གང་དག་ཇི་སྙེད་ཡོད་པ་ཐམས་ཅད་འགག་པར་འགྱུར་༎
 emeva prajñacarite vidu uttamānāṃ sarveta pāramita ukta ya saṃgṛhītā || rgs_25|5 ||	དེ་ལྟར་ཤེས་རབ་སྤྱོད་པ་མཁས་པ་མཆོག་རྣམས་ཀྱི་༎ ཕ་རོལ་ཕྱིན་པ་ཐམས་ཅད་འདིར་ནི་འདུས་པར་གསུངས་༎
 ye cāpi śrāvakaguṇā tatha pratyayānāṃ sarveṣu bhonti vidu śikṣitu bodhisattvā |	བྱང་ཆུབ་སེམས་མཁས་ཉན་ཐོས་ཡོན་ཏན་གང་དག་དང་༎ དེ་བཞིན་རང་རྒྱལ་ཡོན་ཏན་ཀུན་ལ་སློབ་བྱེད་ཅིང་༎
 no cāpi tatra sthihatāna spṛheti teṣām ayu śikṣitavyamati śikṣati etamartham || rgs_25|6 || bhagavatyāṃ ratnaguṇasaṃcayagāthāyāṃ śikṣāparivarto nāma pañcaviṃśatimaḥ ||	དེ་དག་དེ་ལ་མི་གནས་འདོད་པ་མི་བསྐྱེད་དེ་༎ འདི་ནི་བདག་གིས་བསླབ་བྱ་ཡིན་སྙམ་དེ་ཕྱིར་སློབ་༎
 avivartiyasya varabodhayi prasthitasya yo cittupādu anumoditu āśayena |	མི་ལྡོག་བྱང་ཆུབ་མཆོག་ལ་རབ་ཏུ་ཞུགས་པ་ཡི་༎ སེམས་བསྐྱེད་པ་ལ་བསམ་པ་ཐག་པས་ཡི་༄༢༠༨བ་རང་བ༏་༏སྟོང་གསུམ་རི་རབ་སྲང་ལ་གཞལ་བས་ཚད་གཟུང་རུང་༎ རྗེས་སུ་ཡི་རང་དགེ་བ་དེ་ནི་དེ་ལྟ་མིན་༎ དགེ་བ་དོན་གཉེར་ཕན་འདོད་སེམས་ཅན་ཇི་སྙེད་པ་༎
 trisahasra meru tulayitva siyāpramāṇo na tveva tasya kuśalasyanumodanāye || rgs_26|1 || yāvanta sattva kuśalārthika mokṣakāmā sarveṣa bhonti anumoditu puṇyarāśi |	ཀུན་གྱི་བསོད་ནམས་ཕུང་པོ་ལ་ཡང་ཡི་རང་འགྱུར་༎
 sattvarthi te jinaguṇa ananta prāpuṇitvā dāsyanti dharma jagatī dukhasaṃkṣayāye || rgs_26|2 ||	དེ་ཕྱིར་དེ་དག་རྒྱལ་བའི་ཡོན་ཏན་ཐོབ་གྱུར་ནས་༎ སྡུག་བསྔལ་ཟད་པར་བྱ་ཕྱིར་འཇིག་རྟེན་ཆོས་སྦྱིན་བྱེད་༎
 yo bodhisattva avikalpaku sarvadharmān śūnyānimitta parijānati niṣprapañcān |	བྱང་ཆུབ་སེམས་དཔའ་གང་ཞིག་མི་རྟོག་ཆོས་རྣམས་ཀུན་༎ སྟོང་དང་མཚན་མ་མེད་དང་སྤྲོས་མེད་ཡོངས་ཤེས་པ་༎
 na ca prajña bodhi parieṣati āśayena so yukta prajñavarapāramitāya yogī || rgs_26|3 ||	དེ་ནི་ཤེས་རབ་གཉིས་ཀྱིས་བྱང་ཆུབ་ཚོལ་མི་བྱེད་༎ རྣལ་འབྱོར་པ་དེ་ཤེས་རབ་ཕ་རོལ་ཕྱིན་མཆོག་བརྩོན་༎
 ākāśadhātu gaganasya siyā virodho na hi tena tasya kutu kenacideṣa prāptā |	ནམ་མཁའི་ཁམས་དེ་དང་ནི་ནམ་མཁའ་དེར་འགལ་བ་༎ ཡོད་པ་མ་ཡིན་གང་གིས་ཀྱང་ནི་དེ་མ་ཐོབ་༎
 emeva prajñacarito vidu bodhisattvo abhyovakāśasadṛśo upaśāntacārī || rgs_26|4 ||	དེ་བཞིན་ཤེས་རབ་སྤྱོད་མཁས་བྱང་ཆུབ་སེམས་དཔའ་ཡང་༎ ནམ་མཁའ་ལྟ་བུ་ཡིན་ཏེ་ཉེ་བར་ཞི་བར་སྤྱོད་༎ སྐྱེ་བོའི་དབུས་ན་སྒྱུ་མའི་སྐྱེས་བུ་འདི་སྙམ་དུ་༎
 yatha māyakārapuruṣasya na eva bhoti te śiṣya māṃ janata so ca karoti kāryam |	སྐྱེ་བོ་འདི་མགུ་བྱ་སྙམ་མི་སེམས་དེ་ཡང་བྱེད་༎
 paśyanti taṃ vividha kāryu nidarśayantaṃ na ca tasya kāyu na pi citta na nāmadheyam || rgs_26|5 ||	རྫུ་འཕྲུལ་སྣ་ཚོགས་རབ་ཏུ་སྟོན་པར་བྱེད་མཐོང་ཡང་༎ དེ་ལ་ལུས་མེད་སེམས་མེད་མིང་ཡང་ཡོད་མ་ཡིན་༎
 emeva prajñacarite na kadāci bhoti buddhitva bodhi jagatī parimocayitvā |	དེ་བཞིན་ཤེས་རབ་སྤྱོད་པ་ནམ་ཡང་འདི་སྙམ་དུ་༎ བྱང་ཆུབ་རྟོགས་ནས་འགྲོ་བ་ཡོངས་སུ་དགྲོལ་མི་སེམས་༎ སྐྱེ་བ་སྣ་ཚོགས་དང་ནི་བྱ་བ་མང་ལྡན་པ་༎
 ātmopapatti vividhāṃ kriyasaṃprayogāṃ darśeti māyasadṛśo na vikalpacārī || rgs_26|6 ||	སྒྱུ་མ་ལྟ་བུར་སྟོན་ཀྱང་རྣམ་པར་མི་རྟོག་སྤྱོད་༎
 yatha buddha nirmita karoti ca buddhakāryaṃ na ca tasyupadyati mado karamāṇu kiṃcit |	དཔེར་ན་སངས་རྒྱས་སྤྲུལ་པ་སངས་རྒྱས་མཛད་པ་བྱེད་༎ བྱེད་པ་དེ་ལ་དྲེགས་པ་ཅུང་ཟད་སྐྱེད་མི་འགྱུར་༎
 emeva prajñacarito vidu bodhisattvo darśeti sarva kriya nirmitamāyatulyam || rgs_26|7 ||	དེ་བཞིན་ཤེས་༄༢༠༩ཨ་༌༎ རབ་སྤྱོད་མཁས་བྱང་ཆུབ་སེམས་དཔའ་ཡང་༎ སྤྲུལ་པ་སྒྱུ་མ་བཞིན་དུ་བྱ་བ་ཐམས་ཅད་སྟོན་༎
 palagaṇḍa dakṣa vidunā kṛtu dāruyantro puruṣe stritulya sa karoti ha sarvakāryam |	ཤིང་མཁན་བཟོ་བོ་མཁས་པས་སྐྱེས་པ་བུད་མེད་དང་༎ འདྲ་བའི་བཟོ་བྱས་དེ་ཡང་བྱ་བ་ཐམས་ཅད་བྱེད་༎
 emeva prajñacarito vidu bodhisattvo jñānena sarva kriya kurvati nirvikalpo || rgs_26|8 || bhagavatyāṃ ratnaguṇasaṃcayagāthāyāṃ māyopamaparivarto nāma ṣaḍviṃśatimaḥ ||	དེ་བཞིན་ཤེས་རབ་སྤྱོད་མཁས་བྱང་ཆུབ་སེམས་དཔའ་ཡང་༎ རྣམ་པར་མི་རྟོག་ཡེ་ཤེས་བྱ་བ་ཐམས་ཅད་བྱེད་༎
 evaṃ carantu vidu nā pṛthudevasaṃghāḥ kṛtaañjalīpuṭa praṇamya namasyayanti |	དེ་ལྟར་སྤྱོད་མཁས་རྣམས་ལ་ལྷ་ཚོགས་མང་པོ་དག་། ཐལ་མོ་སྦྱར་བ་བཏུད་ནས་ཕྱག་ཀྱང་འཚལ་བར་བྱེད་༎
 buddhā pi yāvata daśaddiśi lokadhātau guṇavarṇamālaparikīrtana kurvayanti || rgs_27|1 ||	ཕྱོགས་བཅུའི་འཇིག་རྟེན་ཁམས་ཀྱི་སངས་རྒྱས་ཇི་སྙེད་པའང་༎ ཡོན་ཏན་བསྔགས་པའི་ཕྲེང་བ་ཡོངས་སུ་རྗོད་པར་མཛད་༎
 yāvanti gaṅganadivālisame hi kṣetre sattvā ta sarvi parikalpa bhaveyu mārāḥ |	གངགའའི་ཀླུང་མཉམ་ཞིང་ན་སེམས་ཅན་ཇི་སྙེད་པ་༎ དེ་ཀུན་ཡོངས་སུ་བརྟག་པ་བཟུང་སྟེ་བདུད་གྱུར་ལ་༎
 ekaika roma puna tāntaka nirmiṇeyyā sarve na śakya karaṇe vidu antarāyam || rgs_27|2 ||	བ་སྤུ་ཉག་རེ་ལས་ཀྱང་དེ་སྙེད་སྤྲུལ་བྱས་ཀྱང་༎ དེ་དག་ཀུན་གྱིས་མཁས་ལ་བར་ཆད་བྱ་མི་ནུས་༎
 catukāraṇehi balavāṃ vidu bodhisattvo bhavate dugharṣu catumāraasaṃprakampyo |	རྒྱུ་རྣམ་བཞི་ཡིས་བྱང་ཆུབ་སེམས་དཔའ་མཁས་སྟོབས་ལྡན་༎ བདུད་བཞིས་ཐུབ་པར་དཀའ་ཞིང་བསྐྱོད་པར་མི་ནུས་ཏེ་༎
 śūnyāvihāri bhavate na ca sattvatyāgī yathavādi sattvakaruṇānugatāvasthānaḥ || rgs_27|3 ||	སྟོང་པར་གནས་དང་སེམས་ཅན་ཡོངས་སུ་མི་གཏོང་དང་༎ ཇི་སྐད་སྨྲས་བཞིན་བྱེད་དང་བདེ་གཤེགས་བྱིན་བརླབས་ཅན་༎ དེ་བཞིན་གཤེགས་ཡུམ་ཤེས་པ་ཕ་རོལ་ཕྱིན་པ་འདི་༎
 yo bodhisattva adhimucyati bhāṣyamāṇām ima prajñapāramita māta tathāgatānām |	འཆད་ཚེ་བྱང་ཆུབ་སེམས་དཔའ་གང་ཞིག་མོས་བྱེད་ཅིང་༎
 pratipattiyā ca abhiyujyati āśayena sarvajñatāya abhiprasthitu veditavyo || rgs_27|4 || na ca dharmadhātutathatāya upaiti sthānaṃ bhavatī athānasthita so laghu antarīkṣe |	བསམ་པ་ཐག་པས་བསྒྲུབ་པར་མངོན་པར་བརྩོན་བྱེད་ན་༎ དེས་པ་ཐམས་ཅད་མཁྱེན་པ་ཉིད་ལ་ཞུགས་རིག་བྱ་༎ ཆོས་དབྱིངས་དེ་བཞིན་ཉིད་༄༢༠༩བ་ལ་གནས་པར་མི་འགྱུར་ཞིང་༎ དཔེར་ན་བར་སྣང་སྤྲིན་བཞིན་གནས་པ་མེད་པར་གནས་༎
 vidyādharo va abhilambhu vanābhiprāyā khagu kālahīna druma mantrabalādhiṣṭhāno || rgs_27|5 ||	རིག་སྔགས་འཆང་བ་གནས་མེད་མཁའ་རྒྱུ་གནས་འདོད་པ་༎ སྔགས་མཐུས་དུས་མིན་མེ་ཏོག་ལྡན་ཞིང་བྱིན་གྱིས་རློབ་༎
 evaṃ carantu vidu paṇḍitu bodhisattvo na ca budhyakaṃ labhati nāpi ca buddhadharmān | na ca deśikaṃ na pi ca paśyaka dharmatāyāṃ śāntaiṣiṇāmayu vihāra guṇe ratānām || rgs_27|6 ||	དེ་ལྟར་སྤྱོད་པའི་བྱང་ཆུབ་སེམས་དཔའ་མཁས་གསལ་བ་༎ རྟོགས་པར་བྱེད་དང་སངས་རྒྱས་ཆོས་རྣམས་དམིགས་མི་འགྱུར་༎ འཆད་པར་བྱེད་དང་ཆོས་འདོད་ལྟ་བར་བྱེད་མི་དམིགས་༎ འདི་ནི་ཞི་འདོད་ཡོན་ཏན་དགའ་བའི་གནས་པ་ཡིན་༎ དགྲ་བཅོམ་རྣམ་ཐར་དེ་བཞིན་གཤེགས་ཀྱི་མ་གཏོགས་པར་༎ གནས་པ་འདི་ནི་ཉན་ཐོས་རང་རྒྱལ་བཅས་པ་ཡི་༎
 yāvanta śrāvakavihāra sapratyayānāṃ śāntā samādhipraśame sukhasaṃprayuktā |	གནས་པ་ཞི་བའི་ཏིང་འཛིན་རབ་ཞི་བདེ་ལྡན་པ་༎
 arhanvimokṣa sthapayitva tathāgatānāṃ sarveṣu agra ayu vihāru niruttaraśca || rgs_27|7 ||	ཇི་སྙེད་ཀུན་གྱི་མཆོག་དང་གོང་ན་མེད་པ་ཡིན་༎ འདབ་ཆགས་མཁའ་ལ་གནས་ཀྱང་ལྟུང་བར་འགྱུར་མ་ཡིན་༎
 ākāśi pakṣi viharāti na co patāti dakamadhyi matsya viharāti na co marāti |	ཉ་ནི་ཆུ་ལ་གནས་ཀྱང་འཚུབས་ཏེ་འཆི་བ་མེད་༎
 emeva dhyānabalapāragu bodhisattvo śūnyāvihāri na ca nirvṛti prāpuṇāti || rgs_27|8 ||	དེ་ལྟར་བྱང་ཆུབ་སེམས་དཔའ་བསམ་གཏན་སྟོབས་དག་གི་། ཕ་རོལ་སོན་པ་སྟོང་གནས་མྱ་ངན་འདའ་མི་འགྱུར་༎
 yo sarvasattvaguṇaagratu gantukāmo agraṃ spṛśeya paramādbhuta buddhajñānam | agraṃ dadeya vara uttamadharmadānam imu agru sevatu vihāru hitaṃkarāṇām || rgs_27|9 || bhagavatyāṃ ratnaguṇasaṃcayagāthāyāṃ sāraparivarto nāma saptaviṃśatimaḥ ||	སེམས་ཅན་ཀུན་གྱི་ཡོན་ཏན་མཆོག་ཏུ་འགྲོ་བ་དང་༎ སངས་རྒྱས་ཡེ་ཤེས་མཆོག་ཏུ་རྨད་བྱུང་མཆོག་རེག་དང་༎ ཆོས་ཀྱི་སྦྱིན་པ་རབ་མཆོག་དམ་པ་སྦྱིན་འདོད་གང་༎ ཕན་མཛད་རྣམས་ཀྱི་གནས་མཆོག་འདི་ལ་བརྟེན་པར་གྱིས་༎ བསླབ་པ་འདི་ནི་འདྲེན་པས་བསླབ་པ་ཡོངས་བརྗོད་པ་༎
 yāvanti śikṣa paridīpita nāyakena sarveṣa śikṣa ayu agru niruttarā ca |	བསླབ་པ་ཇི་སྙེད་ཀུན་གྱི་མཆོག་དང་གོང་ན་མེད་༎
 yaḥ sarvaśikṣavidu icchati pāra gantum imu prajñapāramita śikṣati buddhaśikṣām || rgs_28|1 ||	མཁས་པ་གང་ཞིག་བསླབ་ཀུན་ཕ་རོལ་འགྲོ་འདོད་པས་། ༄༢༡༠ཨ་༌༎ སངས་རྒྱས་བསླབ་པ་ཤེས་རབ་ཕ་རོལ་ཕྱིན་འདིར་སློབས་༎ འདི་ནི་ཆོས་གཏེར་མཆོག་དང་ཆོས་མཛོད་དམ་པ་ཡིན་༎
 agraṃ nidhāna ayu uttamadharmakośa buddhāna gotrajananaṃ sukhasaukhyagañjo |	སངས་རྒྱས་རིགས་ཡིན་འགྲོ་བའི་བདེ་དང་སྐྱིད་པའི་མཛོད་༎
 atikrāntanāgata daśaddiśi lokanāthā itu te prasūta na ca kṣīyati dharmadhātuḥ || rgs_28|2 ||	འདས་དང་མ་བྱོན་ཕྱོགས་བཅུའི་འཇིག་རྟེན་མགོན་པོ་རྣམས་༎ དེ་དག་འདི་ལས་འཁྲུངས་ཀྱང་ཆོས་དབྱིངས་ཟད་མི་འགྱུར་༎
 yāvanti vṛkṣa phalapuṣpavanaspatī yā sarve ca medinisamudgata prādubhūtāḥ |	ཤིང་དང་འབྲས་བུ་མེ་ཏོག་ནགས་ཚལ་ཇི་སྙེད་པ་༎ དེ་དག་ཐམས་ཅད་ས་ལས་ཡང་དག་འབྱུང་ཞིང་འཐོན་༎
 na ca medinī kṣayamupaiti na cāpi vṛddhiṃ na ca khidyatī na parihāyati nirvikalpā || rgs_28|3 ||	འོན་ཀྱང་ས་ལ་ཟད་པ་མེད་ཅིང་འཕེལ་བ་མེད་༎ ཡོངས་སུ་མི་ཉམས་རྣམ་པར་མི་རྟོག་སྐྱོ་བ་མེད་༎
 yāvanta buddhasama śrāvakapratyayāśca marutaśca sarvajagatī sukhasaukhyadharmāḥ |	སངས་རྒྱས་སྲས་དང་ཉན་ཐོས་རང་རྒྱལ་ལྷ་རྣམས་དང་༎ འགྲོ་བ་ཀུན་གྱི་བདེ་སྐྱིད་ཆོས་རྣམས་ཇི་སྙེད་པ་༎ དེ་ཀུན་ཤེས་རབ་ཕ་རོལ་ཕྱིན་པ་མཆོག་ལས་བྱུང་༎
 sarve ti prajñavarapāramitāprasūtā na ca kṣīyate na ca vivardhati jātu prajñā || rgs_28|4 ||	ཤེས་རབ་རྣམས་ཀྱང་ཟད་པ་མེད་ཅིང་འཕེལ་བ་མེད་༎
 yāvanta sattva mṛdumadhyamutkṛṣṭa loke sarve avidyaprabhavā sugatena uktāḥ | sāmagripratyayu pravartati duḥkhayantro na ca yantra kṣīyati avidya na cāpi vṛddhiḥ || rgs_28|5 ||	སེམས་ཅན་ཐ་མ་འབྲིང་དང་མཆོག་གྱུར་ཇི་སྙེད་པ་༎ དེ་ཀུན་མ་རིག་ལས་བྱུང་བདེ་བར་གཤེགས་པས་གསུངས་༎ རྐྱེན་རྣམས་ཚོགས་ནས་སྡུག་བསྔལ་འཁྲུལ་འཁོར་རབ་ཏུ་འབྱུང་༎ མ་རིག་འཁྲུལ་འཁོར་འདི་ནི་ཟད་མེད་འཕེལ་བ་མེད་༎
 yāvanti jñāna nayadvāra uyāyamūlāḥ sarve ti prajñavarapāramitāprasūtāḥ | sāmagripratyaya pravartati jñānayantro na ca prajñapāramita vardhati hīyate vā || rgs_28|6 ||	ཡེ་ཤེས་ཚུལ་སྒོ་ཐབས་དང་རྩ་བ་ཇི་སྙེད་པ་༎ དེ་ཀུན་ཤེས་རབ་ཕ་རོལ་ཕྱིན་པ་མཆོག་ལས་བྱུང་། རྐྱེན་རྣམས་ཚོགས་ནས་ལས་ཀྱི་འཁྲུལ་འཁོར་རབ་ཏུ་འབྱུང་༎
 yo tu pratītyasamutpādu anudbhavāye imu prajña akṣayata budhyati bodhisattvo |	ཤེས་རབ་ཕ་རོལ་ཕྱིན་ལ་ཟད་མེད་འཕེལ་བ་མེད་༎ བྱང་ཆུབ་སེམས་དཔའ་གང་ཞིག་རྟེན་ཅིང་འབྲེལ་འབྱུང་ལ་༎ སྐྱེ་༄༢༡༠བ་མེད་ཟད་པ་མེད་པར་ཤེས་རབ་འདི་ཤེས་ཏེ་༎
 so sūrya abhrapaṭale yatha muktaraśmī vidhamitvavidyapaṭalaṃ bhavate svayaṃbhūḥ || rgs_28|7 || bhagavatyāṃ ratnaguṇasaṃcayagāthāyāmavakīrṇakusumaparivarto nāmāṣṭāviṃśatimaḥ || caturbhī ca dhyāna viharanti mahānubhāvā na ca ālayo na pi ca niśrayu kurvayāti |	ཉི་མ་སྤྲིན་མེད་འོད་ཟེར་འཕྲོ་བས་མུན་བསལ་ལྟར་༎ མ་རིག་ཐིབས་པོ་བཅོམ་ནས་རང་བྱུང་ཐོབ་པར་འགྱུར་༎ མཐུ་ཆེན་ལྡན་པ་བསམ་གཏན་བཞིས་ཀྱང་གནས་བྱེད་ལ་༎ རྟེན་པར་བྱེད་པ་མ་ཡིན་གནས་པར་བྱེད་པ་མེད་༎ འོན་ཀྱང་བསམ་གཏན་ཡན་ལག་བཅས་པ་བཞི་པོ་འདི་༎
 api kho punāśrayu ime catudhyāna sāṅgā bheṣyanti bodhivarauttamaprāpaṇāya || rgs_29|1 ||	བྱང་ཆུབ་དམ་པ་མཆོག་ཐོབ་པ་ཡི་རྟེན་དུ་འགྱུར་༎
 dhyāne sthito 'tra bhavatī varaprajñalābhī ārūpyarūpi ca samādhi catasra śreṣṭhā |	ཤེས་རབ་མཆོག་ཐོབ་བསམ་གཏན་དག་ལ་གནས་པ་ནི་༎ གཟུགས་མེད་ཏིང་འཛིན་དམ་པ་བཞི་ཡང་ཉམས་སུ་མྱོང་༎
 upakāribhūta imi dhyāna varāgrabodhau na punāsravakṣati sa śikṣati bodhisattvo || rgs_29|2 ||	བསམ་གཏན་འདི་དག་བྱང་ཆུབ་དམ་པ་མཆོག་ལ་ཕན་༎ བྱང་ཆུབ་སེམས་དཔའ་ཟག་པ་ཟད་ཕྱིར་སློབ་པ་མིན་༎
 āścaryamadbhutamidaṃ guṇasaṃcayānāṃ dhyāne samādhi viharanti nimitta nāsti |	འདི་ནི་ཡོན་ཏན་གསོག་པའི་ངོ་མཚར་རྨད་བྱུང་སྟེ་༎ བསམ་གཏན་ཏིང་ངེ་འཛིན་ལ་གནས་ནས་མཚན་མ་མེད་༎ དེ་ལ་གནས་རྣམས་གལ་ཏེ་ལུས་ནི་ཞིག་གྱུར་ནས་༎
 tatra sthitāna yadi bhajyati ātmabhāvo puna kāmadhātu upapadyati yathābhiprāyā || rgs_29|3 ||	བསམ་པ་ཇི་བཞིན་འདོད་པའི་ཁམས་སུ་ཡང་སྐྱེའོ་༎
 yatha jambudvīpaka manuṣya alabdhapūrvā divi devauttamapurā anuprāpuṇeyā |	དཔེར་ན་འཛམ་གླིང་མི་ཞིག་སྔོན་ཆད་ལྷ་ཡུལ་གྱི་༎
 paśyitva te viṣaya tatra parigṛhītā punarāgameya na ca niśrayu tatra kuryāt || rgs_29|4 ||	ལྷ་ཡི་གྲོང་ཁྱེར་མཆོག་ཏུ་མ་ཕྱིན་ཕྱིས་སོང་སྟེ་༎ དེ་ནི་ཡོངས་སུ་བཟུང་བའི་ཡུལ་དེ་རྣམས་མཐོང་ནས་༎ ཕྱིར་འདིར་འོངས་པར་གྱུར་ན་ཆགས་པར་མི་བྱེད་ལྟར་༎
 emeva te guṇadharā varabodhisattvā dhyāne samādhi viharitva prayuktayogī |	དེ་བཞིན་བྱང་ཆུབ་སེམས་དཔའ་ཡོན་ཏན་མཆོག་འཆང་བ་༎ རྣལ་འབྱོར་བརྩོན་ཏེ་བསམ་གཏན་ཏིང་འཛིན་ལ་གནས་ནས་༎ ཕྱིར་ཡང་འདོད་པའི་ཁམས་སུ་གནས་ཏེ་ཆགས་པ་མེད་༎
 puna kāmadhātusthita bhonti anopaliptā padmeva vāriṇi aniśrita bāladharme || rgs_29|5 ||	ཆུ་ཡི་པདམ་བཞིན་དུ་བྱིས་པའི་ཆོས་མི་གནས་༎
 anyatra sattvaparipācana kṣetraśodhī paripūraṇārtha imi pāramitā mahātmā |	བདག་ཉིད་ཆེན་པོ་སེམས་ཅན་ཡོངས་༄༢༡༡ཨ་༌༎ སུ་སྨིན་བྱ་དང་༎ ཞིང་སྦྱང་ཕ་རོལ་ཕྱིན་རྫོགས་དོན་བྱེད་ཁོ་ནར་ཟད་༎ བྱང་ཆུབ་ཡོན་ཏན་ཕ་རོལ་ཕྱིན་ཉམས་འགྱུར་འོང་ཞེས་༎
 ārūpyadhātuupapatti na prārthayantī yatreha bodhiguṇapāramitāna hāni || rgs_29|6 ||	གཟུགས་མེད་ཁམས་སུ་སྐྱེ་བ་དོན་དུ་གཉེར་མི་བྱེད་༎
 yatha kaścideva puruṣo ratanaṃ nidhānaṃ labdhvā tu tatra spṛhabuddhi na saṃjaneyyā | ekāki so puna gṛhītva parasmi kāle gṛhṇitva geha praviśitva na bhoti lubdho || rgs_29|7 ||	དཔེར་ན་མི་ཞིག་རིན་ཆེན་གཏེར་རྣམས་རྙེད་གྱུར་ནས་༎ དེ་ལ་འདོད་པའི་བློ་ནི་བསྐྱེད་པར་མ་བྱས་ལ་༎ དེས་ཀྱང་དུས་གཞན་ཞིག་ན་དེ་དག་ཡོངས་བསླངས་ཤིང་༎ བླངས་ནས་ཁྱིམ་དུ་སོང་སྟེ་ཆགས་པར་མི་བྱེད་ལྟར་༎
 emeva dhyāna catureva samādhi śāntāṃ labdhvāna prīti sukhadāṃ vidu bodhisattvāḥ |	དེ་བཞིན་བྱང་ཆུབ་སེམས་དཔའ་མཁས་པ་དགའ་བ་དང་༎ བདེ་སྦྱིན་བསམ་གཏན་ཏིང་འཛིན་ཞི་བ་བཞི་ཐོབ་ནས་༎
 avasṛjya dhyānasukhaprītisamādhilābhaṃ puna kāmadhātu praviśanti jagānukampī || rgs_29|8 || yadi bodhisattva viharāti samādhidhyāne rahapratyayāni spṛhabuddhi na saṃjaneyyā |	བསམ་གཏན་བདེ་ལྡན་བསམ་གཏན་ཏིང་འཛིན་ཐོབ་བཏང་སྟེ་༎ འགྲོ་ལ་སྙིང་བརྩེར་ལྡན་པ་ཕྱིར་ཡང་འདོད་ཁམས་འཇུག་། གལ་ཏེ་བྱང་ཆུབ་སེམས་དཔའ་ཏིང་འཛིན་བསམ་གཏན་གནས༏་༏དགྲ་བཅོམ་རང་རྒྱལ་ཐེག་པར་འདོད་པའི་བློ་བསྐྱེད་ན་༎ 
 asamāhito bhavati uddhatakṣiptacitto parihīnabuddhiguṇa nāvika bhinnanāvo || rgs_29|9 ||	མཉམ་པར་མ་བཞག་རྒོད་ཅིང་སེམས་ག-ཡེངས་གྱུར་པ་སྟེ་༎
 kiṃcāpi rūpamapi śabda tathaiva gandho rasa sparśa kāmaguṇa pañcabhi yukta bhogī |	སངས་རྒྱས་ཡོན་ཏན་ཡོངས་ཉམས་མཉན་པ་གྲུ་ཞིག་བཞིན༏་༏གཞན་ཡང་གཟུགས་དང་སྒྲ་དང་དེ་བཞིན་དྲི་དང་རོ་༎ རེག་དང་འདོད་པའི་ཡོན་ཏན་ལྔ་ལ་བརྩོན་གྱུར་ཀྱང་༎
 rahapratyayāna vigato 'nantabodhisattvo satataṃ samāhitu prajānayitavya śūro || rgs_29|10 ||	དགྲ་བཅོམ་རང་རྒྱལ་ཐེག་བྲལ་བྱང་ཆུབ་སེམས་དགའ་ན་༎ དཔའ་བོ་རྟག་ཏུ་མཉམ་བཞག་ཡིན་པར་ཤེས་པར་བྱ་༎ སེམས་ཅན་གང་ཟག་གཞན་ཕྱིར་སེམས་པ་རྣམ་དག་པ་༎
 parasattvapudgalanidāna viśuddhasattvā vicaranti vīryabalapāramitābhiyuktāḥ |	བརྩོན་འགྲུས་ཕ་རོལ་ཕྱིན་ལ་མངོན་བརྩོན་རྣམ་པར་སྤྱོད་༎
 yatha kumbhadāsi avaśāvaśa bhartikasya tatha sarvasattvavaśatāmupayānti dhīrāḥ || rgs_29|11 ||	༄༢༡༡བ་དཔེར་ན་བྲན་མོ་ཆུ་ཆུན་དབང་མེད་རྗེ་བོའི་དབང་༎ དེ་བཞིན་དཔའ་རྣམས་སེམས་ཅན་ཀུན་གྱི་དབང་གིས་འགྲོ་།
 na ca svāmikasya prativākyu dadāti dāsī ākruṣṭa cāpi athavā sada tāḍitā vā |	སྤྱོད་བ་བྱས་སམ་འོན་ཏེ་རྟག་ཏུ་བརྡེག་ཀྱང་རུང་༎ བྲན་མོ་རྗེ་བོ་ལ་ནི་བཟློག་ཚིག་མི་སྨྲ་ཡི་༎
 ekāntatrastamanasā sa bhayābhibhūtā māmeva so anu vadhiṣyati kāraṇena || rgs_29|12 ||	འདི་ཡིས་བདག་ནི་བསད་པར་འགྱུར་དུ་འོང་སྙམ་ནས་༎ ཤིན་ཏུ་སྐྲག་པའི་ཡིད་ཀྱིས་འཇིགས་བཅས་ཟིལ་གྱིས་གནོན་༎
 emeva bodhivaraprasthitu bodhisattvo tiṣṭheya sarvajagatī yatha preṣyabhūto |	དེ་བཞིན་བྱང་ཆུབ་ཆེད་དུ་བྱང་ཆུབ་མཆོག་ཞུགས་པ་༎ འགྲོ་བ་ཀུན་ལ་བྲན་གྱུར་བཞིན་དུ་གནས་པར་བྱ་༎
 anu bodhiāgamu guṇāna ca pāripūrī tṛṇa agni kāṣṭhaprabhavo dahate tameva || rgs_29|13 ||	འདི་ལས་བྱང་ཆུབ་འཐོབ་ཅིང་ཡོན་ཏན་རྫོགས་པར་འགྱུར་༎ རཙབ༹་དང་ཤིང་ལས་མེ་བྱུང་བས་ནི་དེ་ཉིད་བསྲེག་།
 avasṛjya ātma sugatāṃ parasattvakārye abhiyukta rātridiva niṣpratikāṅkṣacitto |	བདག་གི་བདེ་བ་བཏང་ནས་རེ་བ་མེད་སེམས་ཀྱིས་༎ སེམས་ཅན་གཞན་གྱི་དགོས་ལ་ཉིན་མཚན་མངོན་པར་བརྩོན་༎
 māteva ekasutake paricāryamāṇo adhyāśaye na parikhinna upasthiheti || rgs_29|14 || bhagavatyāṃ ratnaguṇasaṃcayagāthāyāmanugamaparivarto nāmaikūnatriṃśatimaḥ ||	བུ་གཅིག་པ་ལ་མ་ནི་རིམ་གྲོ་བྱེད་པ་ལྟར་༎ བསམ་པ་ཐག་པས་རྣམ་པར་སྐྱོ་མེད་གནས་པར་གྱིས་༎ བྱང་ཆུབ་སེམས་དཔའ་གང་ཞིག་ཡུན་རིང་འཁོར་འདོད་ཅིང་༎
 yo bodhisattva cirasaṃsaraṇābhiprāyo sattvārtha kṣetrapariśodhanayuktayogī |	སེམས་ཅན་དོན་དང་ཞིང་སྦྱོང་བརྩོན་པའི་རྣལ་འབྱོར་པ་༎ སྐྱོ་བའི་བློ་ནི་རྡུལ་ཙམ་སྐྱེ་བར་མི་འགྱུར་ན་༎
 na ca khedabuddhi aṇumātra upādiyāti so vīryapāramitayukta atandritaśca || rgs_30|1 ||	དེ་ནི་བརྩོན་འགྲུས་ཕ་རོལ་ཕྱིན་ལྡན་ག-ཡེལ་བ་མེད་༎
 saci kalpakoṭi gaṇaye vidu bodhisattvo cirasaṃjña bodhi samudāniya tena duḥkhe | ciraduḥkha bheṣyati samācaramāṇu dharmaṃ tatu vīryapāramitahīna kusīdarūpo || rgs_30|2 ||	བྱང་ཆུབ་སེམས་དཔའ་མི་མཁས་བསྐལ་པ་བྱེ་བ་བགྲང་༎ གལ་ཏེ་རིང་བར་འདུ་ཤེས་སྡུག་བསྔལ་བྱང་ཆུབ་སྒྲུབ་༎ ཡང་དག་ཆོས་སྒྲུབ་བྱེད་ཚེ་ཡུན་རིང་སྡུག་བསྔལ་འགྱུར་༎ དེས་ན་བརྩོན་འགྲུས་ཕ་རོལ་ཕྱིན་ཉམས་ལེ་ལོ་ཅན་༎
 prathamaṃ upādu varabodhayi cittupādo so vā anuttaraśivāmanuprāpuṇeyā |	བྱང་ཆུབ་མཆོག་ཏུ་སེམས་བསྐྱེད་དང་པོ་ནས་བཟུང་སྟེ་༎ བྱང་ཆུབ་བླ་ན་མེད་པ་༄༢༡༢ཨ་༌༎ ཐོབ་པར་གྱུར་གྱི་བར་༎
 rātriṃdivaikamanasā tamadhiṣṭhiheyā ārambhavīrya vidu paṇḍitu veditavyo || rgs_30|3 ||	ཉིན་མཚན་གཅིག་ཙམ་དུ་ནི་ཡིད་ལ་སེམས་བྱེད་ན་༎ མཁས་པ་གསལ་བས་བརྩོན་འགྲུས་བརྩམས་པར་རིག་པར་བྱ་༎ གལ་ཏེ་འགའ་ཞིག་འདི་སྐད་རི་རབ་རི་བཤིག་པའི་༎
 saci kaścideva vadayeya sumeruśailaṃ bhinditva paśca adhigamyasi agrabodhim |	རྗེས་ལ་བྱང་ཆུབ་མཆོག་ཐོབ་འགྱུར་ཞེས་སྨྲ་བ་ལས་༎ ཅི་སྟེ་སྐྱོ་བའི་བློ་སྐྱེད་ཚད་ཀྱང་སེམས་བྱེད་ན་༎
 saci khedabuddhi kurute ca pramāṇabuddhiṃ kausīdyaprāpta bhavate tada bodhisattvo || rgs_30|4 ||	དེ་ཚེ་བྱང་ཆུབ་སེམས་དཔའ་ལེ་ལོར་གྱུར་པ་ཡིན་༎
 atha tasyupadyati matī kimutālpamātraṃ kṣaṇamātra bhasma nayatī vilayaṃ sumerum |	ཅི་སྟེ་དེ་ནི་འདི་ཙམ་ཚོད་ལྟ་ཅི་དཀའ་ཞེས་༎ སྐད་ཅིག་ཙམ་ལ་རི་རབ་ཐལ་བར་བརླག་སེམས་བསྐྱེད་༎
 ārambhavīrya bhavate vidu bodhisattvo nacireṇa bodhivara lapsyati nāyakānām || rgs_30|5 ||	བྱང་ཆུབ་སེམས་དཔའ་མཁས་པ་བརྩོན་འགྲུས་བརྩམས་པ་སྟེ༏་༏རིང་པོར་མི་ཐོགས་འདྲེན་པའི་བྱང་ཆུབ་མཆོག་ཐོབ་འགྱུར་༎ 
 saci kāyacittavacasā ca parākrameyyā paripācayitva jagatī kariṣyāmi artham | kausīdyaprāpta bhavatī sthitu ātmasaṃjñaiḥ nairātmabhāvanavidūri nabhaṃ va bhūmeḥ || rgs_30|6 ||	འགྲོ་བ་ཡོངས་སུ་སྨིན་པར་བྱས་ནས་དོན་བྱ་ཞེས་༎ གལ་ཏེ་ལུས་དང་ངག་དང་ཡིད་ཀྱིས་བརྩོན་བྱེད་ན་༎ བདག་ཏུ་འདུ་ཤེས་གནས་པས་ལེ་ལོར་གྱུར་པ་སྟེ་༎ ཐམས་ཅད་མཁྱེན་པ་ཉིད་ལས་རིང་འགྱུར་གནམ་ས་བཞིན་༎
 yasminna kāyu na pi citta na sattvasaṃjñā saṃjñāvivarti sthitu advayadharmacārī |	གང་ཚེ་ལུས་དང་སེམས་དང་སེམས་ཅན་འདུ་ཤེས་མེད་༎ འདུ་ཤེས་རྣམ་པར་ལོག་ནས་གཉིས་སུ་མེད་ཆོས་སྤྱོད་༎
 ayu vīryapāramita ukta hitaṃkareṇa ākāṅkṣamāṇu śivamacyutamagrabodhim || rgs_30|7 ||	འདི་ནི་བྱང་ཆུབ་ཞི་བ་མི་ཉམས་མཆོག་འདོད་པའི་༎ བརྩོན་འགྲུས་ཕ་རོལ་ཕྱིན་ཅེས་ཕན་པ་མཛད་པས་གསུངས་༎
 paruṣaṃ śruṇitva vacanaṃ parato duruktaṃ paritoṣayāti susukhaṃ vidu bodhisattvo |	གལ་ཏེ་གཞན་ལས་ངན་བརྗོད་ཚིག་རྩུབ་ཐོས་གྱུར་ན་༎ བདག་བདེ་ཡིན་ཞེས་བྱང་ཆུབ་སེམས་དཔའ་མཁས་པ་དགའ༎
 ko bhāṣate ka śṛṇute kutu kasya kena so yukta kṣāntivarapāramitāya vijño || rgs_30|8 ||	སུ་སྨྲ་སུས་ཐོས་གང་གིས་གང་ཞིག་གང་གི་ཕྱིར་༎ བཟོད་པའི་ཕ་རོལ་ཕྱིན་༄༢༡༢བ་མཆོག་ལྡན་པ་མཛངས་པ་ཡིན་༎
 so bodhisattva kṣamate guṇadharmayukto yaścaiva ratnabharitaṃ trisahasra dadyāt |	བྱང་ཆུབ་སེམས་དཔའ་གང་ཞིག་བཟོད་པའི་ལེགས་ཆོས་ལྡན་༎ གང་ཞིག་སྟོང་གསུམ་རིན་ཆན་བཀང་སྟེ་འཇིག་རྟེན་མཁྱེན་༎ སངས་རྒྱས་རྣམས་དང་དགྲ་བཅོམ་རང་རྒྱལ་ཕུལ་བྱས་པ་༎
 buddhāna lokavidunārhatapratyayānāṃ kalapuṇya so na bhavate iha dānaskandhe || rgs_30|9 ||	སྦྱིན་པའི་ཕུང་པོས་དེ་ལ་བསོད་ནམས་ཆར་མི་ཕོད་༎
 kṣāntīsthitasya pariśudhyati ātmabhāvo dvātriṃśalakṣaṇaprabhāva anantapāro |	བཟོད་ལ་གནས་པའི་ལུས་ནི་ཡོངས་སུ་དག་འགྱུར་ཏེ་༎ སུམ་ཅུ་རྩ་གཉིས་མཚན་དང་མཐུ་སྟོབས་ཕ་མཐའ་ཡས་༎
 [sattvāna śūnyavaradharma niśāmayātī priyu bhoti sarvajagatī kṣamamāṇu vijño || rgs_30|10 ||	སེམས་ཅན་རྣམས་ལ་ཆོས་རབ་སྟོང་པ་སྒྲོག་པར་བྱེད་༎ འདི་ནི་བཟོད་ལྡན་དེ་ལ་འགྲོ་བ་དགར་འགྱུར་མཁས་༎
 saci kaści candanapuṭaṃ grahiyāna sattvo abhyokireya gurupremata bodhisattvam |	གལ་ཏེ་སེམས་ཅན་ལ་ལས་ཙནདན་ཕུར་མ་བླངས་༎ རབ་གུས་བྱང་ཆུབ་སེམས་དཔའ་ལ་ནི་ཉུག་བྱེད་ལ་༎
 dvitīyo 'pi] agni sakale śirasi kṣipeyā ubhayatra tulyu manu tena upāditavyo || rgs_30|11 ||	གཞན་ཞིག་མེ་མདག་མགོ་ལ་འཐོར་བྱེད་གཉི་ག་ལ་༎ དེ་ཡིས་མཉམ་ཞིང་སྙོམས་པའི་ཡིད་ནི་བསྐྱེད་པར་བྱ་༎
 evaṃ kṣamitva vidu paṇḍitu bodhisattvo taṃ cittupādu pariṇāmayi agrabodhau |	བྱང་ཆུབ་སེམས་དཔའ་མཁས་པ་དེ་ལྟར་བཟོད་བྱས་ནས་༎ སེམས་བསྐྱེད་དེ་ནི་བྱང་ཆུབ་མཆོག་ཏུ་ཡོངས་བསྔོས་ན་༎
 yāvanti kṣānti rahapratyayasattvadhātoḥ abhibhoti sarvajagatī kṣamamāṇu śūraḥ || rgs_30|12 ||	དཔའ་བོ་འཇིག་རྟེན་ཀུན་ལ་བཟོད་པས་དགྲ་བཅོམ་དང་༎ རང་རྒྱལ་སེམས་ཅན་ཁམས་མང་ཇི་སྙེད་ཟིལ་གྱིས་གནོན་༎
 kṣamamāṇu eva puna citta upāditavyo narakeṣu tiryayamaloki aneka duḥkhā |	བཟོད་བྱེད་འདི་སྙམ་དུ་ཡང་སེམས་ནི་བསྐྱེད་བྱ་སྟེ་༎ སེམས་དམྱལ་དུད་འགྲོ་གཤིན་རྗེའི་འཇིག་རྟེན་སྡུག་བསྔལ་མང་༎
 anubhūya kāmaguṇahetu akāmakārā kasmā hu adya na kṣameya nidāna bodhau || rgs_30|13 ||	འདོད་པའི་ཡོན་ཏན་རྒྱུ་ཡིས་དབང་མེད་གནོད་མྱོང་ན་༎ བྱང་ཆུབ་ཆེད་དུ་ཅི་ཕྱིར་ད་གཟོད་མི་བྱ་སྙམ་༎
 kaśadaṇḍaśastravadhabandhanatāḍanāśca śirachedakarṇacaraṇākaranāsachedāḥ |	ལྕག་དབྱིག་མཚོན་དང་བསད་དང་བཅིང་དང་བརྡེག་པ་དང་༎ མགོ་གཅོད་པ་དང་རྣ་བ་རྐང་ལག་སྣ་གཅོད་དང་༎ འཇིག་རྟེན་སྡུག་༄༢༡༣ཨ་༌༎ བསྔལ་ཇི་སྙེད་བདག་གིས་བཟོད་སྙམ་པ་༎
 yāvanti duḥkha jagatī ahu tatsahāmi kṣāntīya pāramita tiṣṭhati bodhisattvo || rgs_30|14 || bhagavatyāṃ ratnaguṇasaṃcayagāthāyāṃ sadāpraruditaparivarto nāma triṃśatimaḥ ||	བྱང་ཆུབ་སེམས་དཔའ་བཟོད་པའི་ཕ་རོལ་ཕྱིན་ལ་གནས་༎
 śīlena udgata bhavanti samādhikāṅkṣī sthita gocare daśabalāna akhaṇḍaśīlāḥ |	ཚུལ་ཁྲིམས་ཀྱིས་ནི་ཞི་བ་འདོད་རྣམས་འཕགས་པར་འགྱུར་། སྟོབས་བཅུའི་སྤྱོད་ཡུལ་གནས་ཤིང་ཚུལ་ཁྲིམས་ཉམས་པ་མེད་༎
 yāvanti saṃvarakriya anuvartayanti tāṃ sarvasattvahita bodhayi nāmayanti || rgs_31|1 ||	སྡོམ་པའི་བྱ་བ་ཇི་སྙེད་ཀུན་གྱི་རྗེས་སུ་འཇུག་།
 saci pratyayānarahabodhi spṛhāṃ janeti [duḥśīla bhoti]viduṣāṃ tatha chidracārī |	སེམས་ཅན་ཀུན་ལ་ཕན་ཕྱིར་དེ་ཡང་བྱང་ཆུབ་བསྔོ་༎ གལ་ཏེ་རང་རྒྱལ་དགྲ་བཅོམ་བྱང་ཆུབ་རེག་འདོད་ན་༎ ཚུལ་ཁྲིམས་འཆལ་ཞིང་མི་མཁས་དེ་བཞིན་སྤྱོད་པ་ཉམས་༎
 atha bodhi uttamaśivāṃ pariṇāmayanti sthitu śīlapāramita kāmaguṇebhi yukto || rgs_31|2 ||	ཅི་སྟེ་བྱང་ཆུབ་ཞི་བ་མཆོག་ཏུ་ཡོངས་བསྔོ་ན་༎ འདོད་ཡོན་བརྩོན་ཡང་ཚུལ་ཁྲིམས་ཕ་རོལ་ཕྱིན་ལ་གནས་༎
 yo dharma bodhiguṇaāgamu sūratānāṃ so śīlaarthu guṇadharmasamanvitānām |	ཆོས་གང་དེས་པའི་བྱང་ཆུབ་ཡོན་ཏན་འབྱུང་འགྱུར་བ་༎ དེ་ཡི་ཡོན་ཏན་ཆོས་ལྡན་རྣམས་ཀྱི་ཚུལ་ཁྲིམས་དོན་༎
 yo dharma bodhiguṇahāni hitaṃkarāṇāṃ duḥśīlatā ayu prakāśitu nāyakena || rgs_31|3 ||	ཆོས་གང་ཕན་བྱེད་རྣམས་ཀྱི་བྱང་ཆུབ་ཡོངས་ཉམས་པ་༎ འདི་ནི་ཚུལ་ཁྲིམས་འཆལ་ཅེས་རྣམ་པར་འདྲེན་པས་གསུངས་༎
 yadi pañca kāmaguṇa bhuñjati bodhisattvo buddhaṃ ca dharma śaraṇāgatu āryasaṃgham |	གལ་ཏེ་བྱང་ཆུབ་སེམས་དཔའ་འདོད་ཡོན་ལྔ་སྤྱོད་ཀྱང་༎ སངས་རྒྱས་ཆོས་དང་འཕགས་པའི་དགེ་འདུན་སྐྱབས་སོང་སྟེ་༎
 sarvajñatā ca manasī bhaviṣyāmi buddho sthitu śīlapāramita vedayitavya vijño || rgs_31|4 ||	སངས་རྒྱས་འགྲུབ་བྱ་སྙམ་དུ་ཀུན་མཁྱེན་ཡིད་བྱེད་ན་༎ མཁས་པ་ཚུལ་ཁྲིམས་ཕ་རོལ་ཕྱིན་གནས་རིག་པར་བྱ་༎
 yadi kalpakoṭi daśabhī kuśalaiḥ pathebhiś caramāṇu pratyayarahatvaspṛhāṃ janeti |	གལ་ཏེ་བསྐལ་པ་བྱེ་བར་དགེ་བའི་ལས་ལམ་བཅུ༏་༏སྤྱོད་ཀྱང་རང་རྒྱལ་དགྲ་བཅོམ་ཉིད་ལ་འདོད་བསྐྱེད་ན་༎ 
 tada khaṇḍaśīlu bhavate api chidraśīlo pārājiko gurutaro ayu cittupādo || rgs_31|5 ||	དེ་ཚེ་ཚུལ་ཁྲིམས་སྐྱོན་བྱུང་ཚུལ་ཁྲིམས་ཉམས་པ་ཡིན་༎ སེམས་བསྐྱེད་དེ་ནི་ཕས་ཕམ་པས་ཀྱང་ཤིན་ཏུ་ལྕི་༎ ཚུལ་༄༢༡༣བ་ཁྲིམས་སྲུང་ཞིང་བྱང་ཆུབ་མཆོག་ཏུ་ཡོངས་བསྔོ་ལ་༎
 rakṣantu śīla pariṇāmayi agrabodhiṃ na ca tena manyati na ātmana karṣayethā |	དེ་ཡིས་རློམ་སེམས་མེད་ཅིང་བདག་བསྟོད་མི་བྱེད་ལ་༎
 ahusaṃjñatā ca parivarjita sattvasaṃjñā sthitu śīlapāramiti vucyati bodhisattvo || rgs_31|6 ||	ང་ཡི་འདུ་ཤེས་སེམས་ཅན་འདུ་ཤེས་ཡོངས་སུ་སྤངས་༎
 yadi bodhisattva caramāṇu jināna mārge imi śīlavānimi duśīla karoti sattvān |	བྱང་ཆུབ་སེམས་དཔའ་ཚུལ་ཁྲིམས་ཕ་རོལ་ཕྱིན་གནས་བརྗོད་༎ གལ་ཏེ་བྱང་ཆུབ་སེམས་དཔའ་རྒྱལ་བའི་ལམ་སྦྱོད་པ་༎ སེམས་ཅན་འདི་དག་ཁྲིམས་ལྡན་འདི་དག་ཁྲིམས་འཆལ་ཞེས་༎
 nānātvasaṃjñaprasṛto paramaṃ duśīlo api chidraśīlu na tu so pariśuddhaśīlo || rgs_31|7 ||	སྣ་ཚོགས་འདུ་ཤེས་ཞུགས་བ་ཤིན་ཏུ་ཚུལ་ཁྲིམས་འཆལ་༎ ཚུལ་ཁྲིམས་ཉམས་ཤིང་དེ་ལ་ཡོངས་དག་ཚུལ་ཁྲིམས་མེད་༎
 yasyo na asti ahasaṃjña na sattvasaṃjñā saṃjñāvirāgu kutu tasya asaṃvaro 'sti | yasyo na saṃvari asaṃvari manyanāsti ayu śīlasaṃvaru prakāśitu nāyakena || rgs_31|8 ||	གང་ལ་བདག་གི་འདུ་ཤེས་སེམས་ཅན་འདུ་ཤེས་མེད་༎ འདུ་ཤེས་འདོད་ཆགས་བྲལ་ལ་སྡོམ་མིན་ག་ལ་ཡོད༏་༏གང་ལ་སྡོམ་དང་སྡོམ་པ་མ་ཡིན་རློམ་སེམས་མེད་༎ འདི་ནི་ཚུལ་ཁྲིམས་སྡོམ་པར་རྣམ་པར་འདྲེན་པས་གསུངས་༎ སེམས་ཅན་དག་པ་གང་ཞིག་དེ་ལྟར་ཁྲིམས་ལྡན་པ་༎
 yo evaśīlasamanvāgatu niṣprapañco anapekṣako bhavati sarvapriyāpriyeṣu |	སྡུག་དང་མི་སྡུག་ཀུན་ལ་ལྟ་བ་མེད་པ་ཡིན་༎
 śirahastapāda tyajamāna adīnacitto sarvāstityāgi bhavate satataṃ alīno || rgs_31|9 ||	མགོ་དང་རྐང་ལག་གཏོང་ཞིང་ཞུམ་པའི་སེམས་ཀྱང་མེད་༎ བདོག་པ་ཐམས་ཅད་གཏོང་ཞིང་རྟག་ཏུ་ཞེན་པ་མེད་༎
 jñātvā ca dharmaprakṛtīṃ vaśikā nirātmyaṃ ātmāna māṃsa tyajamānu adīnacitto |	ཆོས་རྣམས་རང་བཞིན་བདག་མེད་ཡ་མ་བརླར་ཤེས་ནས་༎ བདག་གི་ཤ་ཡང་གཏོང་ལ་ཞུམ་པའི་སེམས་མེད་ན་༎
 prāgeva vastu tada bāhira nātyajeyā asthānameta yadi matsari so kareyā || rgs_31|10 || ahasaṃjñatastu mamatā bhavate ca rāgo kutu tyāgabuddhi bhaviṣyati sā muhānām |	དེ་ཚེ་ཕྱི་རོལ་དངོས་པོ་གཏོང་བ་སྨོས་ཅི་དགོས་༎ གལ་ཏེ་སེར་སྣ་བྱེད་པ་དེ་ནི་གནས་མེད་དོ་༎ བདག་ཏུ་འདུ་ཤེས་དངོས་ལ་བདག་གིར་འཛིན་པས་ཆགས་༎ བླུན་པོ་རྣམས་ལ་གཏོང་བའི་བློ་ལྟ་ག་ལ་ཡོད་༎
 mātsarya preta bhavate upapadyayātī athavā manuṣya tada bhoti daridrarūpo || rgs_31|11 ||	སེར་སྣ་ཅན་ནི་ཡི་དབ༹གས་གནས་སུ་སྐྱེ་བར་འགྱུར་༎ ཅི་སྟེ་མིར་སྐྱེས་ན་ཡང་དེ་ཚེ་དབུལ་པོར་འགྱུར་༎ དེ་ཚེ་༄༢༡༤ཨ་༌༎
 tada bodhisattva imi jñātva daridrasattvān dānādhimukta bhavatī sada muktatyāgī |	བྱང་ཆུབ་སེམས་དཔའ་སེམས་ཅན་དབུལ་ཤེས་ནས་༎ གཏོང་ལ་མོས་པར་འགྱུར་ཞིང་རྟག་ཏུ་ལྷུག་པར་གཏོང་༎ གླིང་བཞི་ལེགས་པར་བརྒྱན་པ་མཆིལ་མའི་ཐལ་བ་འདྲ་༎
 catvāri dvīpi samalaṃkṛtu kheṭatulyaṃ dattvā udagra bhavate na hi dvīpalabdho || rgs_31|12 ||	བྱིན་ནས་དགའ་བར་འགྱུར་གྱི་གླིང་ཐོབ་དེ་ལྟ་མིན་༎ བྱང་ཆུབ་སེམས་དཔའ་མཁས་པ་གསལ་བ་སྲིད་གསུམ་གྱི་༎
 dānaṃ daditva vidu paṇḍitu bodhisattvo yāvanti sattva tribhave samanvāharitvā |	སེམས་ཅན་ཇི་སྙེད་དེ་དག་ཀུན་ལ་སྦྱིན་པ་འདི་༎
 sarveṣu teṣu bhavate ayu dattadānaṃ taṃ cāgrabodhi pariṇāmayate jagārtham || rgs_31|13 ||	བྱིན་པར་གྱུར་ཅིག་སྙམ་དུ་སེམས་ནས་སྦྱིན་གྱུར་ལ་༎ དེ་ཡང་འགྲོ་བའི་དོན་ཕྱིར་བྱང་ཆུབ་མཆོག་ཏུ་བསྔོ་༎
 na ca vastuniśrayu karoti daditva dānaṃ vidu pāku naiva pratikāṅkṣati so kadācit |	སྦྱིན་པ་བྱིན་ནས་དངོས་ལ་གནས་པར་བྱེད་པ་མེད་༎ དེ་ནི་ནམ་དུའང་རྣམ་པར་སྨིན་ལ་རེ་བ་མེད་༎
 evaṃ tyajitva bhavate vidu sarvatyāgī alpaṃ tyajitva labhate bahu aprameyam || rgs_31|14 ||	དེ་ལྟར་གཏོང་བ་མཁས་པ་ཐམས་ཅད་གཏོང་བ་སྟེ་༎ ཆུང་ངུ་བཏང་ལ་མང་པོ་དཔག་ཏུ་མེད་པར་འགྱུར་༎
 yāvanta sattva tribhave nikhilena asti te sarvi dāna dadayanti anantakalpān | buddhānuloki vidu nārhatipratyayānāṃ yāvanti śrāvakaguṇān parikalpa sthāne || rgs_31|15 ||	སྲིད་པ་གསུམ་ན་སེམས་ཅན་མ་ལུས་ཇི་སྙེད་པ་༎ ཡོངས་སུ་བརྟག་པ་བཟུང་སྟེ་དེ་དག་ཐམས་ཅད་ཀྱིས་༎ འཇིག་རྟེན་མཁྱེན་པ་སངས་རྒྱས་དགྲ་བཅོམ་རང་རྒྱལ་ལ་༎ བསྐལ་པ་མཐའ་ཡས་སྦྱིན་བྱིན་ཉན་ཐོས་ལེགས་ཚོལ་ན་༎
 yaśco upāyakuśalo vidu bodhisattvo teṣāṃ sa puṇyakriyavastvanumodayitvā |	བྱང་ཆུབ་སེམས་དཔའ་མཁས་པ་ཐབས་མཁས་གང་ཞིག་གིས་༎ དེ་དག་བསོད་ནམས་བྱ་བའི་དངོས་ལ་ཡི་རང་ནས་༎
 sattvārtha agravarabodhayi nāmayeyā abhibhoti sarvajagatī pariṇāmayukto || rgs_31|16 ||	སེམས་ཅན་དོན་དུ་བྱང་ཆུབ་མཆོག་རབ་ཡོངས་བསྔོ་ན་༎ ཡོངས་སུ་བསྔོ་བས་འགྲོ་བ་ཐམས་ཅད་ཟིལ་གྱིས་གནོན་༎
 kācasya vā maṇina rāśi siyā mahanto vaiḍūryaratna abhibhoti sa sarva eko |	ནོར་བུ་འཆིང་བུའི་ཕུང་པོ་ཆེན་པོར་གྱུར་པ་ཡང་༎ རིན་ཆེན་བེཨེ་དའུརྱ་གཅིག་དེ་ཀུན་ཟིལ་གྱིས་གནོན་༎ དེ་བཞིན་འགྲོ་ཀུན་སྦྱིན་པའི་༄༢༡༤བ་ཕུང་པོ་རྒྱ་ཆེན་ཀུན་༎
 emeva sarvajagatī pṛthu dānaskandho abhibhoti sarvapariṇāmaku bodhisattvo || rgs_31|17 ||	རྗེས་སུ་ཡི་རང་བྱང་ཆུབ་སེམས་དཔས་ཟིལ་གྱིས་གནོན་༎
 yadi bodhisattva dadamāna jagasya dānaṃ mamatāṃ na tatra karayenna ca vastuprema |	གལ་ཏེ་བྱང་ཆུབ་སེམས་དཔས་འགྲོ་ལ་སྦྱིན་བྱིན་ནས་༎ དེ་ལ་བདག་གིར་མི་བྱེད་དངོས་པོ་ཕངས་མེད་ན་༎
 tatu vardhate kuśalamūla mahānubhāvo candro va tatra prabhamaṇḍalu śuklapakṣe || rgs_31|18 || bhagavatyāṃ ratnaguṇasaṃcayagāthāyāṃ dharmodgataparivarto nāmaikatriṃśatimaḥ ||	དེ་བས་དགེ་བའི་རྩ་བ་རྒྱ་ཆེན་འཕེལ་འགྱུར་ཏེ་༎ སྤྲིན་མེད་འོད་ལྡན་ཟླ་དཀྱིལ་ཡར་གྱི་ངོ་བཞིན་ནོ་༎
 dānena pretagati chindati bodhisattvo dāridrakaṃ ca chinatī tatha sarvakleśān |	བྱང་ཆུབ་སེམས་དཔའི་སྦྱིན་པས་ཡི་དབ༹གས་འགྲོ་བ་གཅོད་༎ དབུལ་བ་དང་ནི་དེ་བཞིན་ཉོན་མོངས་ཐམས་ཅད་གཅོད་༎
 bhogāṃścanantavipulāṃ labhate caranto dānena sattva paripācayi kṛcchraprāptān || rgs_32|1 || śīlena tīryagati varjayi nekarupām aṣṭau ca akṣaṇa kṣaṇāṃ labhate sa nityam |	སྤྱོད་ཚེ་ལོངས་སྤྱོད་མཐའ་ཡས་རྒྱས་པ་ཐོབ་པར་འགྱུར་༎ སྦྱིན་པས་སྡུག་བསྔལ་གྱུར་བའི་སེམས་ཅན་ཡོངས་སྨིན་བྱེད་༎ ཁྲིམས་ཀྱིས་དུད་འགྲོའི་འགྲོ་བ་དུ་མའི་ངོ་བོ་དང་༎ མི་ཁོ་མ་བརྒྱད་སྤོང་དེ་ཡིས་དལ་བ་རྟག་ཏུ་རྙེད་༎
 kṣāntīya rupa labhate paramaṃ udāraṃ suvarṇacchavi priyu jagasya udīkṣaṇīyo || rgs_32|2 ||	བཟོད་པས་གཟུགས་བཟང་དམ་པ་རྒྱ་ཆེན་ཐོབ་འགྱུར་ཏེ་༎ གསེར་མདོག་སྡུག་ཅིང་འགྲོ་བས་བལྟ་བའི་འོས་སུ་འགྱུར་༎
 vīryeṇa śuklaguṇa hāni na abhyupaiti jñānaṃ ananta labhate jinakośagañjam |	བརྩོན་འགྲུས་ཀྱིས་ནི་དཀར་པོའི་ཡོན་ཏན་འགྲིབ་མི་འགྱུར་༎ ཡེ་ཤེས་མཐའ་ཡས་རྒྱལ་བའི་བང་མཛོད་རྙེད་པར་འགྱུར་༎
 dhyānena kāmaguṇa utsṛjate jugupsyān vidyā abhijña abhinirharate samādhim || rgs_32|3 ||	བསམ་གཏན་གྱིས་ནི་འདོད་པའི་ཡོན་ཏན་སྨད་པ་འདོར་༎ རིག་དང་མངོན་པར་ཤེས་དང་ཏིང་འཛིན་མངོན་པར་སྒྲུབ་༎
 prajñāya dharmaprakṛtī parijānayitvā traidhātukānta samatikramate apāyān |	ཤེས་རབ་ཀྱིས་ནི་ཆོས་ཀྱི་རང་བཞིན་ཡོངས་ཤེས་ནས་༎ ཁམས་གསུམ་མ་ལུས་པ་ལས་ཡང་དག་འདའ་བར་འགྱུར་༎
 vartitva cakraratanaṃ puruṣarṣabhāṇāṃ deśeti dharma jagatī dukhasaṃkṣayāye || rgs_32|4 ||	མི་ཡི་ཁྱུ་མཆོག་འཁོར་ལོ་རིན་ཆེན་བསྐོར་བྱས་ནས་༎ སྡུག་བསྔལ་ཟད་པར་བྱ་ཕྱིར་འགྲོ་ལ་ཆོས་ཀྱང་སྟོན་༎
 paripūrayitva imi dharma sa bodhisattvo api kṣetraśuddhi parigṛhṇati sattvaśuddhim |	ཆོས་འདི་ཡོངས་རྫོགས་བྱས་ནས་བྱང་ཆུབ་སེམས་དཔའ་དེ་༎ ཡོངས་དག་ཞིང་དང་སེམས་ཅན་དག་པ་ཡོངས་སུ་༄༢༡༥ཨ་༌༎ འཛིན༏་༏སངས་རྒྱས་རྒྱུད་དང་ཆོས་ཀྱི་རྒྱུད་ཀྱང་ཡོངས་སུ་འཛིན་༎
 api buddhavaṃśa parigṛhṇati dharmavaṃśaṃ tatha saṃghavaṃśa parigṛhṇati sarvadharmān || rgs_32|5 ||	དེ་བཞིན་དགེ་འདུན་རྒྱུད་དང་ཆོས་ཀུན་ཡོངས་སུ་འཛིན་༎
 vaidyottamo jagati rogacikitsakārī prajñopadeśa kathito ayu bodhimārgo |	འགྲོ་བའི་ནད་གསོ་མཛད་པ་སྨན་བའི་མཆོག་གྱུར་པས་༎
 nāmena ratnaguṇasaṃcaya bodhimārgaḥ taṃ sarvasattva itu mārgatu prāpnuvanti || rgs_32|6 ||	ཤེས་རབ་བསྟན་པ་བྱང་ཆུབ་ལམ་ལྡན་འདི་གསུངས་ཏེ་༎ མིང་ནི་ཡོན་ཏན་རིན་ཆེན་སྡུད་པ་བྱང་ཆུབ་ལམ་༎ ལམ་འདི་སེམས་ཅན་ཀུན་གྱིས་ཐོབ་པར་བྱ་ཕྱིར་བཤད་༎
 bhagavatyāṃ ratnaguṇasaṃcayagāthāyāṃ parīndanāparivarto nāma dvātriṃśatimaḥ || [ācāryaharibhadrakṛtā praśastiḥ] | lokaṃ prāpayituṃ sukhena padavīṃ saṃpaddūyāvāhinīṃ kāruṇyāhitacetasā bhagavatā buddhena saṃdīpitam | śrutvā te 'khiladharmatattvanilayaṃ sūtraṃ samādānato gatvā sthānamaharniśaṃ nijamalaṃ dhmāyantu ye 'bhyāgatāḥ || rgs_hpr_1 || kāle 'smin bahudṛṣṭisaṃkulakalau pāṭhe 'pi dūraṃ gate gāthābhedamanekapustakagataṃ dṛṣṭvādhunā nyāyataḥ | kūpaṃ vādigajendrakumbhadaraṇe bhadreṇa yā śodhitā lokārthaṃ hariṇā mayā suvihitā seyaṃ budhairgṛhyatām || rgs_hpr_2 ||	འཕགས་པ་ཤེས་རབ་ཀྱི་ཕ་རོལ་ཏུ་ཕྱིན་པ་སྡུད་པ་ཚིགས་སུ་བཅད་པ་རྫོགས་སོ་༎༎
