skt	tib
 (vaidya 340) mañjuśrīparivartāparaparyāyā saptaśatikā prajñāpāramitā | oṃ namo bhagavatyai āryaprajñāpāramitāyai |	༄༡༢༣བ་། །རྒྱ་གར་སྐད་དུ་། ཨའརྱ་སཔཏ་ཤ་ཏི་ཀ་ནའ་མ་པྲཛཉའ་པ་ར་མི་ཏ་མ་ཧའ་ཡ་ན་སའུ་ཏྲ་། བོད་སྐད་དུ་། འཕགས་པ་ཤེས་རབ་ཀྱི་ཕ་རོལ་ཏུ་ཕྱིན་པ་བདུན་བརྒྱ་པ་ཞེས་བྱ་བ་ཐེག་པ་ཆེན་པོའི་མདོ་། བམ་པོ་དང་པོ་། སངས་རྒྱས་དང་བྱང་ཆུབ་སེམས་དཔའ་ཐམས་ཅད་ལ་ཕྱག་འཚལ་ལོ་༎
 evaṃ mayā śrutam |	འདི་སྐད་བདག་གིས་ཐོས་པ་དུས་གཅིག་ན་།
 ekasmin samaye bhagavān śrāvastyāṃ viharati sma jetavane 'nāthapiṇḍadasyārāme mahatā bhikṣusaṃghena sārdhaṃ paripūrṇena arhadbhikṣusahasreṇa, bodhisattvānāṃ ca mahāsattvānāṃ mahāsaṃnāhasaṃnaddhānāṃ paripūrṇairdaśabhirbodhisattvaśatasahasraiḥ sārdhaṃ sarvairavinivartanīyairanuttarāyāḥ samyaksaṃbodheḥ | tadyathā - mañjuśriyā ca kumārabhūtena, maitreyeṇa ca, asaṅgapratibhānena ca, anikṣiptadhureṇa ca,	བཅོམ་ལྡན་འདས་མཉན་ཡོད་ན་རྒྱལ་བུ་རྒྱལ་བྱེད་ཀྱི་ཚལ་མགོན་མེད་ཟས་སྦྱིན་གྱི་ཀུན་དགའ་ར་བ་ན་དགེ་སློང་སྟོང་ཐམ་པའི་དགེ་སློང་གི་དགེ་འདུན་ཆེན་པོ་དང་ཐབས་ཅིག་ཏུ་བཞུགས་སོ་༎ བྱང་ཆུབ་སེམས་དཔའ་སེམས་དཔའ་ཆེན་པོ་གོ་ཆ་བགོས་པ་ས་ཡ་ཐམས་ཅད་ཀྱང་བླ་ན་མེད་པ་ཡང་དག་པར་རྫོགས་པའི་བྱང་ཆུབ་ལས་ཕྱིར་མི་ལྡོག་པ་ཤ་སྟག་ལ་འདི་ལྟ་སྟེ་༎ ། འཇམ་དཔལ་གཞོན་ནུར་གྱུར་པ་དང་། བྱམས་པ་དང་། སྤོབས་པ་ཐམས་ཅད་མེད་དང་། བརྩོན་པ་མི་འདོར་བ་དང་། དེ་དག་ལ་སོགས་པ་བྱང་ཆུབ་སེམས་དཔའ་ས་ཡ་དང་ཡང་ཐབས་ཅིག་གོ་། དེ་ནས་འཇམ་དཔལ་གཞོན་ནུར་གྱུར་པ་དེ་བཞིན་གཤེགས་པ་ལ་བལྟ་བ་དང་། ཕྱག་བྱ་བ་དང་། བསྙེན་བཀུར་བྱ་བའི་ཕྱིར་སྐྱ་རེངས་ཤར་བའི་དུས་ཀྱི་ཚེ་རང་གི་གནས་ནས་བྱུང་༄༡༢༤ཨ་༌༎
 evaṃpramukhairdaśabhirbodhisattvaśatasahasraiḥ || atha khalu mañjuśrīḥ kumārabhūto 'ruṇodgatakālasamaye svakādvihārānniṣkramya yena tathāgatavihārastenopasaṃkrāmat | upasaṃkramya vihārasya bahirdvāre sthito 'bhūttathāgatasya darśanāya vandanāya paryupāsanāya |	སྟེ་དེ་བཞིན་གཤེགས་པའི་ཕོ་བྲང་གི་སྒོ་ག་ལ་བ་དེར་སོང་ནས་ཕྱིན་པ་དང་། ཕོ་བྲང་གི་སྒོའི་ཕྱི་རོལ་ཏུ་འདུག་གོ་།
 athāyuṣmānapi śāradvatīputraḥ svakādvihārānniṣkramya yena tathāgatavihārastenopasaṃkrāmadbhagavato darśanāya vandanāya paryupāsanāya | athāyuṣmānapi pūrṇo maitrāyaṇīputraḥ, āyuṣmānapi mahāmaudgalyāyanaḥ, āyuṣmānapi mahākāśyapaḥ,	དེ་ནས་ཚེ་དང་ལྡན་པ་ཤའ་རདབ༹་ཏིའི་བུ་ཡང་བཅོམ་ལྡན་འདས་ལ་བལྟ་བ་དང་། ཕྱག་བྱ་བ་དང་། བསྙེན་བཀུར་བྱ་བའི་ཕྱིར་རང་གི་གནས་ནས་བྱུང་སྟེ་དེ་བཞིན་གཤེགས་པའི་ཕོ་བྲང་ག་ལ་བ་དེར་སོང་ངོ་༎ 
 āyuṣmānapi mahākātyāyanaḥ, āyuṣmānapi mahākauṣṭhilaḥ, anye ca mahāśrāvakāḥ svakasvakebhyo vihārebhyo niṣkramya yena bhagavato vihārastenopasaṃkrāntāḥ,	དེ་ནས་ཚེ་དང་ལྡན་པ་བྱམས་མའི་བུ་གང་པོ་དང་། ཚེ་དང་ལྡན་པ་མོཨོ་དགལ་གྱི་བུ་ཆེན་པོ་དང་། ཚེ་དང་ལྡན་པ་འོད་སྲུང་ཆེན་པོ་དང་། ཚེ་དང་ལྡན་པ་ཀ་ཏཡའ་ཡའི་བུ་ཆེན་པོ་དང་། ཚེ་དང་ལྡན་པ་གསུས་པོ་ཆེ་དང་། དེ་དག་ཐམས་ཅད་དང་། གཞན་ཡང་ཉན་ཐོས་ཆེན་པོ་རྣམས་རང་རང་གི་གནས་ནས་བྱུང་སྟེ་བཅོམ་ལྡན་འདས་ཀྱི་ཕོ་བྲང་ག་ལ་བ་དེར་སོང་ནས་ཕྱིན་པ་དང་། ཕྱོགས་གཅིག་ཏུ་འཁོད་དོ༏།
 upasaṃkramya ekānte tasthuḥ || atha khalu bhagavānabhikrāntābhikrāntaṃ mahāśrāvakasaṃnipātaṃ viditvā svakādvihārānniṣkramya bahirdvārasyaikānte prajñapta evāsane nyaṣīdat	དེ་ནས་བཅོམ་ལྡན་འདས་ཀྱིས་ཉན་ཐོས་ཆེན་པོ་རྣམས་འོངས་ཤིང་ལྷགས་ཏེ་འདུས་པར་མཁྱེན་ནས་བདག་གི་ཕོ་བྲང་ནས་བྱུང་སྟེ་ཕོ་བྲང་གི་ཕྱི་རོལ་གྱི་ཕྱོགས་གཅིག་ཏུ་གདན་བཏིང་བ་ལ་བཞུགས་སོ་༎ 
 niṣadya ca bhagavān jānanneva āyuṣmantaṃ śāradvatīputramāmantrayate sma - kutastvaṃ śāradvatīputra kalyamevāgatya tathāgatavihāradvāre sthitaḥ?	བཞུགས་ནས་ཀྱང་བཅོམ་ལྡན་འདས་ཀྱིས་མཁྱེན་བཞིན་དུ་ཚེ་དང་ལྡན་པ་ཤའ་རདབ༹་ཏིའི་བུ་ལ་བཀའ་སྩལ་པ་། ཤའ་རདབ༹་ཏིའི་བུ་། ཁྱོད་ཅིའི་ཕྱིར་ཞོགས་པས་འོངས་ཏེ་དེ་བཞིན་གཤེགས་པའི་ཕོ་བྲང་གི་སྒོ་ན་འདུག་།
 evamukte āyuṣmān śāradvatīputro bhagavantametadavocat - sarvaprathamataraṃ bhagavan mañjuśrīḥ kumārabhūtastathāgatavihāradvāre sthitaḥ,	དེ་སྐད་ཅེས་བཀའ་སྩལ་པ་དང་། བཅོམ་ལྡན་འདས་ལ་ཚེ་དང་ལྡན་པ་ཤའ་རདབ༹་ཏིའི་བུས་འདི་སྐད་ཅེས་གསོལ་ཏོ་༎ བཅོམ་ལྡན་འདས་། ཐམས་ཅད་ཀྱི་ཐོག་མ་ཉིད་དུ་འཇམ་དཔལ་གཞོན་ནུར་གྱུར་པ་དེ་བཞིན་གཤེགས་པའི་ཕོ་བྲང་གི་ཆབ་༄༡༢༤བ་སྒོར་མཆིས་སོ་༎ བདག་ནི་།
 paścādvayaṃ bhagavantaṃ draṣṭukāmāḥ ||	བཅོམ་ལྡན་འདས་ལ་བལྟ་བར་འཚལ་བའི་སླད་དུ་སླད་ཀྱིས་མཆིས་སོ་༎
 atha khalu bhagavān jānanneva mañjuśriyaṃ kumārabhūtamāmantrayate sma - satyaṃ kila	དེ་ནས་བཅོམ་ལྡན་འདས་ཀྱིས་མཁྱེན་བཞིན་དུ་འཇམ་དཔལ་གཞོན་ནུར་གྱུར་པ་ལ་བཀའ་སྩལ་པ་། འཇམ་དཔལ་།
 tvaṃ mañjuśrīḥ sarvaprathamataraṃ tathāgatavihāradvāre sthitastathāgatasya darśanāya vandanāya paryupāsanāya ca?	ཁྱོད་དེ་བཞིན་གཤེགས་པ་ལ་བལྟ་བ་དང་། ཕྱག་བྱ་བ་དང་། བསྙེན་བཀུར་བྱ་བའི་ཕྱིར་ཐམས་ཅད་ཀྱི་ཐོག་མ་ཉིད་དུ་དེ་བཞིན་གཤེགས་པའི་ཕོ་བྲང་གི་སྒོ་ན་འདུག་པ་བདེན་ནམ་།
 evamukte mañjuśrīḥ kumārabhūto bhagavantametadavocat - evametat bhagavan,	དེ་སྐད་ཅེས་བཀའ་སྩལ་པ་དང་། བཅོམ་ལྡན་འདས་ལ་འཇམ་དཔལ་གཞོན་ནུར་གྱུར་པས་འདི་སྐད་ཅེས་གསོལ་ཏོ་༎ བཅོམ་ལྡན་འདས་། དེ་དེ་ལྟ་ལགས་།
 evametat sugata,	བདེ་བར་གཤེགས་པ་། དེ་དེ་ལྟ་ལགས་ཏེ་།
 prathamataramasmyāgataḥ svakādvihārānniṣkramya yena tathāgatavihārastenopasaṃkrāntaḥ, upasaṃkramya ekānte sthito bhagavato darśanāya vandanāya paryupāsanāya |	བདག་དེ་བཞིན་གཤེགས་པ་ལ་བལྟ་བ་དང་། ཕྱག་བགྱི་བ་དང་། བསྙེན་བཀུར་བགྱི་བའི་སླད་དུ་ཐམས་ཅད་ཀྱི་ཐོག་མ་ཉིད་དུ་རང་གི་གནས་ནས་བྱུང་སྟེ་དེ་བཞིན་གཤེགས་པའི་ཕོ་བྲང་ག་ལ་བ་དེར་མཆིས་ནས་ཕྱོགས་གཅིག་ཏུ་མཆིས་སོ་༎
 tatkasya hetoḥ?	དེ་ཅིའི་སླད་དུ་ཞེ་ན་། བཅོམ་ལྡན་འདས་། འདི་ལྟར་། བདག་ནི་།
 tathā hi bhagavan atṛpto 'haṃ tathāgatasya darśanena vandanena paryupāsanena ca |	དེ་བཞིན་གཤེགས་པ་ལ་བལྟ་བ་དང་། ཕྱག་བགྱི་བ་དང་། བསྙེན་བཀུར་བགྱི་བས་མ་ངོམས་པའི་སླད་དུའོ་༎ བཅོམ་ལྡན་འདས་། འདི་ལྟར་།
 yadapyahaṃ bhagavan tathāgatamupasaṃkramāmi darśanāya vandanāya paryupāsanāya, tatsarvasattvānāmarthāya | sacedbhagavan (saptaś, vaidya 341)	བདག་དེ་བཞིན་གཤེགས་པ་ལ་བལྟ་བ་དང་། ཕྱག་བགྱི་བ་དང་། བསྙེན་བཀུར་བགྱི་བའི་སླད་དུ་མཆིས་པ་དེ་ཡང་སེམས་ཅན་ཐམས་ཅད་ཀྱི་དོན་གྱི་སླད་དུ་སྟེ་། བཅོམ་ལྡན་འདས་། གལ་ཏེ་དེ་བཞིན་གཤེགས་པ་ལ་བལྟ་བ་དང་། ཕྱག་བགྱི་བ་དང་། བསྙེན་བཀུར་བགྱི་བ་ཇི་ལྟར་བདག་གིས་མཐོང་བ་དང་། ཇི་ལྟར་བདག་ཕྱག་༄༡༢༥ཨ་༌༎
 tathāgato draṣṭavyo vanditavyaḥ paryupāsitavyaḥ, evaṃ draṣṭavyaḥ,	བགྱིད་པ་དང་། ཇི་ལྟར་བདག་བསྙེན་བཀུར་བགྱིད་པ་དེ་ལྟར་བལྟ་བར་བགྱིའོ་༎
 evaṃ vanditavyaḥ,	དེ་ལྟར་ཕྱག་བགྱིའོ་༎
 evaṃ paryupāsitavyaḥ, yathāhaṃ paśyāmi yathāhaṃ vande yathāhaṃ paryupāse |	དེ་ལྟར་བསྙེན་བཀུར་བགྱིའོ་༎ དེ་ལྟར་ན་།
 evaṃ tathāgato dṛṣṭo bhavati vanditaḥ paryupāsitaśca |	དེ་བཞིན་གཤེགས་པ་མཐོང་བ་ནས་བསྙེན་བཀུར་བགྱིས་པའི་བར་དུ་འགྱུར་རོ་༎
 ahaṃ ca bhagavan sarvasattvānāṃ kṛtaśastathāgataṃ paśyāmi |	བཅོམ་ལྡན་འདས་། བདག་ནི་། སེམས་ཅན་ཐམས་ཅད་ཀྱི་སླད་དུ་དེ་བཞིན་གཤེགས་པ་ལ་བལྟ་བ་ལགས་སོ་༎ བཅོམ་ལྡན་འདས་ཀྱིས་བཀའ་སྩལ་པ་།
 bhagavānāha - kathaṃ mañjuśrīstathāgato draṣṭavyo yāvat paryupāsitavyaḥ?	འཇམ་དཔལ་། དེ་བཞིན་གཤེགས་པ་ལ་ཇི་ལྟར་བལྟ་།
 mañjuśrīrāha - tathatākāreṇa tathāgataṃ paśyāmi avikalpākāreṇa anupalambhayogena,	འཇམ་དཔལ་གྱིས་གསོལ་པ་། མི་དམིགས་པའི་ཚུལ་གྱིས་དེ་བཞིན་ཉིད་ཀྱི་རྣམ་པ་དང་། རྣམ་པར་མི་རྟོག་པའི་རྣམ་པར་དེ་བཞིན་གཤེགས་པ་ལ་བལྟ་བར་བགྱིའོ་༎
 evamanutpādākāreṇa tathāgataṃ paśyāmi, yāvad abhāvākāreṇa tathāgataṃ paśyāmi | na ca tathatā samudāgacchati,	དེ་བཞིན་གཤེགས་པ་ལ་མི་སྐྱེ་བའི་རྣམ་པར་བལྟ་བ་ནས་དངོས་པོ་མ་མཆིས་པའི་རྣམ་པའི་བར་དུ་དེ་བཞིན་གཤེགས་པ་ལ་བལྟ་བར་བགྱིའོ་༎ དེ་བཞིན་ཉིད་ལ་ཀུན་ནས་འབྱུང་བ་མ་ཡིན་ཏེ་།
 evaṃ tathāgataṃ paśyāmi |	དེ་ལྟར་དེ་བཞིན་གཤེགས་པ་ལ་བལྟ་བར་བགྱིའོ་༎ དེ་བཞིན་ཉིད་ནི་།
 na tathatā bhavati na vibhavati,	འབྱུང་བའང་མ་ལགས་། འཇིག་པའང་མ་ལགས་ཏེ་།
 evaṃ tathāgataṃ paśyāmi |	དེ་ལྟར་དེ་བཞིན་གཤེགས་པ་ལ་བལྟ་བར་བགྱིའོ་༎ དེ་བཞིན་ནི་། ཡུལ་ན་མི་གནས་།
 na tathatā deśasthā na pradeśasthā,	ཕྱོགས་ན་མི་གནས་ཏེ་།
 evaṃ tathāgataṃ paśyāmi |	དེ་ལྟར་དེ་བཞིན་གཤེགས་པ་ལ་བལྟ་བར་བགྱིའོ་༎
 na tathatā atītā na anāgatā na pratyutpannā,	དེ་བཞིན་ཉིད་ནི་། འདས་མ་ལགས་། མ་འོངས་པ་མ་ལགས་། ད་ལྟར་བྱུང་བ་མ་ལགས་ཏེ་།
 evaṃ tathāgataṃ paśyāmi |	དེ་ལྟར་དེ་བཞིན་གཤེགས་པ་ལ་བལྟ་བར་བགྱིའོ་༎
 na tathatā dvayaprabhāvitā nādvayaprabhāvitā,	དེ་བཞིན་ཉིད་ནི་། གཉིས་ཀྱིས་རབ་ཏུ་སྐྱེ་བ་མ་ལགས་། གཉིས་སུ་མ་མཆིས་པས་རབ་༄༡༢༥བ་ཏུ་ཕྱེ་བ་ཡང་མ་ལགས་ཏེ་།
 evaṃ tathāgataṃ paśyāmi |	དེ་ལྟར་དེ་བཞིན་གཤེགས་པ་ལ་བལྟ་བར་བགྱིའོ་༎ དེ་བཞིན་ཉིད་ནི་།
 na tathatā saṃkliśyate na vyavadāyate,	ཀུན་ནས་ཉོན་མོངས་པར་འགྱུར་བ་མ་ལགས་། རྣམ་པར་བྱང་བར་འགྱུར་བ་མ་ལགས་ཏེ་།
 evaṃ tathāgataṃ paśyāmi |	དེ་ལྟར་དེ་བཞིན་གཤེགས་པ་ལ་བལྟ་བར་བགྱིའོ་༎ དེ་བཞིན་ཉིད་ནི་།
 na tathatā utpadyate na nirudhyate,	མི་སྐྱེ་མི་འགག་པ་སྟེ་།
 evaṃ tathāgataṃ paśyāmi |	དེ་ལྟར་དེ་བཞིན་གཤེགས་པ་ལ་བལྟ་བར་བགྱིའོ་༎
 evaṃ tathāgato dṛṣṭo bhavati vanditaḥ paryupāsitaśca |	དེ་ལྟར་དེ་བཞིན་གཤེགས་པ་མཐོང་བ་དང་། ཕྱག་བགྱིས་པ་དང་། བསྙེན་བཀུར་བགྱིས་པར་འགྱུར་རོ་༎
 evamukte bhagavān mañjuśriyaṃ kumārabhūtametadavocat - evaṃ paśyaṃstvaṃ mañjuśrīḥ kiṃ paśyasi?	དེ་སྐད་ཅེས་གསོལ་པ་དང་། བཅོམ་ལྡན་འདས་ཀྱིས་འཇམ་དཔལ་གཞོན་ནུར་གྱུར་པ་ལ་འདི་སྐད་ཅེས་བཀའ་སྩལ་ཏོ་༎ འཇམ་དཔལ་། ཁྱོད་ཀྱིས་དེ་ལྟར་བལྟས་ན༏་ཅི་ཞིག་མཐོང་།
 mañjuśrīrāha - evaṃ paśyannahaṃ bhagavan na kiṃcitpaśyāmi |	འཇམ་དཔལ་གྱིས་གསོལ་པ་། བཅོམ་ལྡན་འདས་། བདག་གིས་དེ་ལྟར་བལྟས་ན་། ཅི་ཡང་མཐོང་བ་མ་མཆིས་སོ་༎
 evamahaṃ paśyan na kasyaciddharmasyotpādaṃ paśyāmi na nirodhaṃ paśyāmi ||	བཅོམ་ལྡན་འདས་། དེ་བཞིན་དུ་བདག་གིས་ཆོས་གང་ཡང་སྐྱེ་བ་ཡང་མ་མཐོང་། འགག་པ་ཡང་མ་མཐོང་ངོ་༎
 athāyuṣmān śāradvatīputro mañjuśriyaṃ kumārabhūtametadavocat - duṣkarakārakastvaṃ mañjuśrīḥ,	དེ་ནས་ཚེ་དང་ལྡན་པ་ཤའ་ར་ར་དབ༹་ཏིའི་བུས་འཇམ་དཔལ་གཞོན་ནུར་གྱུར་པ་ལ་འདི་སྐད་ཅེས་སྨྲས་སོ་༎ འཇམ་དཔལ་།
 yastvaṃ tathāgatamevaṃ paśyasi evaṃ paryupāsse, yasya ca te sarvasattvānāmantike mahāmaitrī pratyupasthitā |	ཁྱོད་ཀྱིས་དེ་བཞིན་གཤེགས་པ་ལ་དེ་ལྟར་མཐོང་བ་དང་། དེ་ལྟར་བསྙེན་བཀུར་བྱས་པ་གང་ཡིན་པ་དང་། ཁྱོད་ཀྱིས་བྱམས་པ་ཆེན་པོ་སེམས་ཅན་ཐམས་ཅད་ལ་ཉེ་བར་གནས་ཀྱང་ཁྱོད་ལ་སེམས་ཅན་དུ་དམིགས་པ་དང་། 
 na ca te kācitsattvopalabdhiḥ sattvābhiniveśo vā |	སེམས་ཅན་དུ་མངོན་པར་ཞེན་པ་ཅི་ཡང་མེད་ཅིང་།
 sarvasattvaparinirvāṇāya cāsi pratipannaḥ | na ca te kaścitsattvābhiniveśaḥ pravartate |	སེམས་ཅན་ཐམས་ཅད་ཡོངས་སུ་མྱ་ངན་ལས་བཟླ་བའི་ཕྱིར་ཞུགས་ཀྱང་ཁྱོད་ལ་སེམས་ཅན་དུ་མངོན་པར་ཞེན་པ་གང་ཡང་མི་༄༡༢༦ཨ་༌༎
 sarvasattvānāṃ ca te kṛtaśaḥ saṃnāhaḥ saṃnaddhaḥ | sa cānupalambhayogena yāvadabhāvayogena |	འབྱུང་བ་དང་། ཁྱོད་མི་དམིགས་པའི་ཚུལ་དང་། དངོས་པོ་མེད་པའི་ཚུལ་དང་། སྒྱིད་ལུག་པ་མེད་པའི་ཚུལ་གྱིས་སེམས་ཅན་ཐམས་ཅད་ཀྱི་ཆེད་དུ་གོ་ཆ་བགོས་པ་དེ་ནི་། ཁྱོད་དཀའ་བ་བྱེད་པའོ་༎
 evamukte mañjuśrīḥ kumārabhūtaḥ āyuṣmantaṃ śāradvatīputrametadavocat - evametad bhadanta śāradvatīputra yathā kathayasi |	དེ་སྐད་ཅེས་སྨྲས་པ་དང་། འཇམ་དཔལ་གཞོན་ནུར་གྱུར་པས་ཚེ་དང་ལྡན་པ་ཤའ་ར་དབ༹་ཏིའི་བུ་ལ་འདི་སྐད་ཅེས་སྨྲས་སོ་༎ བཙུན་པ་ཤའ་ར་དབ༹་ཏིའི་བུ་། ཇི་སྐད་སྨྲས་པ་དེ་དེ་བཞིན་ཏེ་།
 sarvasattvaparinirvāṇāya saṃnāhaścaiṣa saṃnaddhaḥ |	སེམས་ཅན་ཐམས་ཅད་ཡོངས་སུ་མྱ་ངན་ལས་བཟླ་བའི་ཕྱིར་གོ་ཆ་འདི་ཡང་བགོས་ཏེ་།
 na ca me kācit sattvopalabdhirvā sattvābhiniveśo vā |	བདག་ལ་སེམས་ཅན་དུ་དམིགས་པ་དང་། སེམས་ཅན་ལ་མངོན་པར་ཞེན་པ་གང་ཡང་མེད་དོ༏་༏བཙུན་པ་ཤའ་ར་དབ༹་ཏིའི་བུ་། གོ་ཆ་དེ་ནི་།
 nāyaṃ bhadanta śāradvatīputra saṃnāha evaṃ saṃnaddhaḥ - kathamahaṃ sattvadhātorūnatvaṃ vā kuryāṃ pūrṇatvaṃ vā?	ཇི་ལྟར་བདག་གིས་སེམས་ཅན་གྱི་ཁམས་དབྲི་བའམ་གང་བར་བྱ་ཞེས་དེ་ལྟར་མ་བགོས་སོ་༎
 sacedbhadanta śāradvatīputra parikalpamupādāya ekaikasmin buddhakṣetre gaṅgānadīvālukopamā buddhā bhagavanto bhaveyuḥ,	བཙུན་པ་ཤའ་ར་དབ༹་ཏིའི་བུ་། ཡོངས་སུ་བརྟག་པ་ཉེ་བར་བཟུང་སྟེ་། གལ་ཏེ་སངས་རྒྱས་ཀྱི་ཞིང་རེ་རེ་ན་གངགའའི་ཀླུང་གི་བྱེ་མ་སྙེད་ཀྱི་སངས་རྒྱས་བཅོམ་ལྡན་འདས་རྣམས་བཞུགས་ཏེ་།
 ekaikaśca tathāgato gaṅgānadīvālukopamān kalpāṃstiṣṭhet sarātriṃdivaṃ ca dharmaṃ deśayamānaḥ,	དེ་བཞིན་གཤེགས་པ་དེ་དག་སོ་སོ་ནས་ཉིན་མཚན་དུ་ཆོས་སྟོན་ཏེ་། གངགའའི་ཀླུང་གི་བྱེ་མ་སྙེད་ཀྱི་བསྐལ་པར་བཞུགས་པར་གྱུར་ལ་།
 ekaikayā dharmadeśanayā yāvanto gaṅgānadīvālukāsamairbuddhairbhagavadbhiḥ sattvā vinītāḥ, tāvataḥ sattvānekaikastathāgataḥ ekaikayā dharmadeśanayā vinayet, evamapi kṛtvā naiva sattvadhātorūnatvaṃ vā pūrṇatvaṃ vā prajñāyate | tatkasmāddhetoḥ?	གངགའའི་ཀླུང་གི་བྱེ་མ་སྙེད་ཀྱི་སངས་རྒྱས་བཅོམ་ལྡན་འདས་རྣམས་ཀྱི་ཆོས་བསྟན་པ་རེ་རེས་སེམས་ཅན་ཇི་སྙེད་བཏུལ་བ་དེ་སྙེད་ཀྱི་སེམས་ཅན་དེ་བཞིན་གཤེགས་པ་རེ་རེས་ཆོས་བསྟན་པ་རེ་རེས་བཏུལ་བར་གྱུར་དུ་ཟིན་ཀྱང་སེམས་ཅན་གྱི་ཁམས་ལ་བྲི་བའམ་གང་པར་མངོན་པ་མེད་དོ་༎ དེ་ཅིའི་ཕྱིར་ཞེ་༄༡༢༦བ་ན༏་སེམས་ཅན་དབེན་པ་དང་། སེམས་ཅན་སེམས་ཅན་མ་ཡིན་པའི་ཕྱིར་ཏེ་། བཙུན་པ་ཤའ་རདབ༹་ཏིའི་བུ་།
 sattvaviviktatvāt sattvāsattvād bhadanta śāradvatīputra sattvadhātorna conatvaṃ vā pūrṇatvaṃ vā prajñāyate ||	སེམས་ཅན་གྱི་ཁམས་ནི་། བྲི་བའམ་གང་བར་མི་མངོན་ནོ་༎
 evamukte āyuṣmān śāradvatīputro mañjuśriyaṃ kumārabhūtametadavocat - yadi mañjuśrīḥ sattvaviviktatvāt sattvāsattvāt sattvadhātornaivonatvaṃ na pūrṇatvaṃ vā prajñāyate,	དེ་སྐད་ཅེས་སྨྲས་པ་དང་། ཚེ་དང་ལྡན་པ་ཤའ་རདབ༹་ཏིའི་བུས་འཇམ་དཔལ་གཞོན་ནུར་གྱུར་པ་ལ་འདི་སྐད་ཅེས་སྨྲས་སོ་༎ འཇམ་དཔལ་། གལ་ཏེ་སེམས་ཅན་དབེན་པ་དང་། སེམས་ཅན་སེམས་ཅན་མ་ཡིན་པའི་ཕྱིར་སེམས་ཅན་གྱི་ཁམས་བྲི་བ་དང་། གང་བར་མངོན་ན་།
 tatkasyedānīṃ bodhimabhisaṃbudhya dharmaṃ deśayiṣyasi?	འོ་ན་བྱང་ཆུབ་མངོན་པར་རྫོགས་པར་སངས་རྒྱས་ནས་སུ་ལ་ཆོས་སྟོན་།
 evamukte mañjuśrīḥ kumārabhūta āyuṣmantaṃ śāradvatīputrametadavocat - yadā tāvadbhadanta śāradvatīputra atyantatayā sattvānupalabdhiḥ, tatko 'trābhisaṃbhotsyate? (saptaś, vaidya 342) kasya vā dharmaṃ deśayiṣyate?	དེ་སྐད་ཅེས་སྨྲས་པ་དང་། འཇམ་དཔལ་གཞོན་ནུར་གྱུར་པས་ཚེ་དང་ལྡན་པ་ཤའ་རདབ༹་ཏིའི་བུ་ལ་འདི་སྐད་ཅེས་སྨྲས་སོ་༎ བཙུན་པ་ཤའ་རདབ༹་ཏིའི་བུ་། གང་གི་ཚེ་སེམས་ཅན་ཤིན་ཏུ་མི་དམིགས་པ་དེའི་ཚེ་སུ་ཞིག་མངོན་པར་རྫོགས་པར་འཚང་རྒྱ་། སུ་ལ་ཆོས་བསྟན་པར་བྱ་།
 tatkasmāddhetoḥ?	དེ་ཅིའི་ཕྱིར་ཞེ་ན་།
 tathā hi bhadanta śāradvatīputra atyantatayā sarvadharmānupalabdhiḥ ||	བཙུན་པ་ཤའ་རདབ༹་ཏིའི་བུ་། འདི་ལྟར་ཆོས་ཐམས་ཅད་ཤིན་ཏུ་མི་དམིགས་པའི་ཕྱིར་རོ་༎
 atha khalu bhagavān mañjuśriyaṃ kumārabhūtametadavocat - yadā tāvanmañjuśrīḥ atyantatayā sarvadharmānupalabdhiḥ,	དེ་ནས་བཅོམ་ལྡན་འདས་ཀྱིས་འཇམ་དཔལ་གཞོན་ནུར་གྱུར་པ་ལ་འདི་སྐད་ཅེས་བཀའ་སྩལ་ཏོ༏་༏འཇམ་དཔལ་། གང་གི་ཚེ་ཆོས་ཐམས་ཅད་ཤིན་ཏུ་མི་དམིགས་པ་དེའི་ཚེ་། ཅི་། སེམས་ཅན་དུའང་འདོགས་སམ་།
 tatkimidānīṃ sattvamapi prajñāpayiṣyasi? api ca | sacenmañjuśrīḥ kaścidevaṃ pṛcchet - kiyantaḥ sattvā iti,	ཡང་གལ་ཏེ་འཇམ་དཔལ་ཁྱོད་ལ་འགའ་ཞིག་སེམས་ཅན་ཇི་སྙེད་ཡོད་ཅེས་དེ་སྐད་འདྲི་ན་།
 kiṃ tasya tvaṃ vadeḥ?	དེ་ལ་ཁྱོད་ཀྱིས་ཇི་སྐད་བྱ་།
 mañjuśrīrāha - tasyāhaṃ bhagavan evaṃ pṛṣṭa evaṃ vadeyam - yāvanta eva buddhadharmā iti |	འཇམ་དཔལ་གྱིས་གསོལ་པ་། བཅོམ་ལྡན་འདས་། དེ་སྐད་འདྲི་བ་དེ་ལ་བདག་གིས་འདི་སྐད་དུ་། སངས་རྒྱས་ཀྱི་ཆོས་ཇི་སྙེད་པ་དེ་སྙེད་དོ་༎ ཞེས་༄༡༢༧ཨ་༌༎
 saced bhagavan punarapi pṛcchet - kiyatpramāṇaḥ sattvadhāturiti,	བགྱིའོ༏་༏བཅོམ་ལྡན་འདས་། གལ་ཏེ་ཡང་སེམས་ཅན་གྱི་ཁམས་ཀྱི་ཚད་ཇི་ཙམ་ཞེས་འདྲི་ན་།
 tasyāhaṃ bhagavan evaṃ pṛṣṭa evaṃ vadeyam - yatpramāṇo buddhaviṣayaḥ [iti] ||	དེ་སྐད་འདྲི་བ་དེ་ལ་བདག་གིས་འདི་སྐད་དུ་། སངས་རྒྱས་ཀྱི་ཡུལ་གྱི་ཚད་ཇི་ཙམ་པ་དེ་ཙམ་མོ་༎ ཞེས་བགྱིའོ་༎ བཅོམ་ལྡན་འདས་ཀྱིས་བཀའ་སྩལ་པ་།
 bhagavānāha - sacetpunarapi te mañjuśrīḥ kaścidevaṃ pṛcchet - kiṃparyāpannaḥ sattvadhāturiti,	འཇམ་དཔལ་། ཁྱོད་ལ་གལ་ཏེ་ཡང་ལ་ལ་ཞིག་འདི་སྐད་དུ་། སེམས་ཅན་གྱི་ཁམས་གང་དུ་གཏོགས་ཞེས་འདྲི་ན་།
 kiṃ tasya tvaṃ vadeḥ?	དེ་ལ་ཁྱོད་ཀྱིས་ཇི་སྐད་བྱ་།
 mañjuśrīrāha - tasyāhaṃ bhagavan evaṃ pṛṣṭa evaṃ vadeyam - yatparyāpannānutpādācintyatā [iti] ||	འཇམ་དཔལ་གྱིས་གསོལ་པ་། བཅོམ་ལྡན་འདས་། དེ་སྐད་འདྲི་བ་དེ་ལ་བདག་གིས་འདི་སྐད་དུ་། སྐྱེ་བ་མེད་པ་བསམ་གྱིས་མི་ཁྱབ་པ་གང་དུ་གཏོགས་པར་གཏོགས་སོ་༎ ཞེས་བགྱིའོ་༎ བཅོམ་ལྡན་འདས་ཀྱིས་བཀའ་སྩལ་པ་།
 bhagavānāha - sacetpunarapi te mañjuśrīḥ kaścidevaṃ pṛcchet - kiṃpratiṣṭhitaḥ sattvadhāturiti,	འཛམ་དཔལ་། གལ་ཏེ་ཡང་ལ་ལ་ཞིག་ཁྱོད་ལ་འདི་སྐད་དུ་། སེམས་ཅན་གྱི་ཁམས་ཅི་ལ་གནས་ཞེས་འདྲི་ན་།
 kiṃ tasya tvaṃ vadeḥ?	དེ་ལ་ཁྱོད་ཀྱིས་ཇི་སྐད་བྱ་། འཇམ་དཔལ་གྱིས་གསོལ་པ་།
 mañjuśrīrāha - tasyāhaṃ bhagavan evaṃ pṛṣṭa evaṃ vadeyam - yatpratiṣṭhito 'nutpādadhātuḥ tatpratiṣṭhitaḥ sattvadhāturiti ||	བཅོམ་ལྡན་འདས་། དེ་སྐད་འདྲི་བ་དེ་ལ་བདག་གིས་འདི་སྐད་དུ་། སྐྱེ་བ་མེད་པའི་ཁམས་ཅི་ལ་གནས་པ་དེ་ལ་སེམས་ཅན་གྱི་ཁམས་ཀྱང་གནས་སོ་༎ ཞེས་བགྱིའོ་༎
 bhagavānāha - yasmin samaye tvaṃ mañjuśrīḥ prajñāpāramitāṃ bhāvayasi, tadā kutra pratiṣṭhitāṃ prajñāpāramitāṃ bhāvayasi?	བཅོམ་ལྡན་འདས་ཀྱིས་བཀའ་སྩལ་པ་། འཇམ་དཔལ་། ཁྱོད་གང་གི་ཚེ་ཤེས་རབ་ཀྱི་ཕ་རོལ་ཏུ་ཕྱིན་པ་སྒོམ་པ་དེའི་ཚེ་ཅི་ལ་གནས་ཏེ་ཤེས་རབ་ཀྱི་ཕ་རོལ་ཏུ་ཕྱིན་པ་སྒོམ་། འཇམ་དཔལ་གྱིས་གསོལ་པ་།
 mañjuśrīrāha - yasminnahaṃ bhagavan samaye prajñāpāramitāṃ bhāvayāmi,	བཅོམ་ལྡན་འདས་།
 apratiṣṭhito 'haṃ tasmin samaye prajñāpāramitāṃ bhāvayāmi ||	གང་གི་ཚེ་བདག་ཤེས་རབ་ཀྱི་ཕ་རོལ་ཏུ་ཕྱིན་པ་སྒོམ་པའི་ཚེ་མི་གནས་པར་ཤེས་རབ་ཀྱི་ཕ་རོལ་ཏུ་ཕྱིན་པ་༄༡༢༧བ་སྒོམ་ལགས་སོ་༎ བཅོམ་ལྡན་འདས་ཀྱིས་བཀའ་སྩལ་པ་།
 bhagavānāha - apratiṣṭhitasya te mañjuśrīḥ kā prajñāpāramitābhāvanā?	འཇམ་དཔལ་། མི་གནས་པ་ལ་ཤེས་རབ་ཀྱི་ཕ་རོལ་ཏུ་ཕྱིན་པ་སྒོམ་དུ་ཡང་ཅི་ཡོད་།
 mañjuśrīrāha - saiva bhagavan prajñāpāramitābhāvanā yanna kvacitpratiṣṭhānam ||	འཇམ་དཔལ་གྱིས་གསོལ་པ་། བཅོམ་ལྡན་འདས་། གང་ཅི་ལ་ཡང་མི་གནས་པ་དེ་ཉིད་ཤེས་རབ་ཀྱི་ཕ་རོལ་ཏུ་ཕྱིན་པ་བསྒོམ་པ་ལགས་སོ་༎ 
 bhagavānāha - yasmin samaye tvaṃ mañjuśrīḥ prajñāpāramitāṃ bhāvayasi,	བཅོམ་ལྡན་འདས་ཀྱིས་བཀའ་སྩལ་པ་། འཇམ་དཔལ་།
 kataratte kuśalamūlaṃ tasmin samaye upacayaṃ gacchati apacayaṃ vā?	ཁྱོད་གང་གི་ཚེ་ཤེས་རབ་ཀྱི་ཕ་རོལ་ཏུ་ཕྱིན་པ་སྒོམ་པ་དེའི་ཚེ་ཁྱོད་ཀྱི་དགེ་བའི་རྩ་བ་གང་འཕེལ་བའམ་འབྲི་བར་འགྱུར་།
 mañjuśrīrāha - na me bhagavan tasmin samaye kiṃcitkuśalamūlamupacayaṃ gacchati apacayaṃ vā |	འཇམ་དཔལ་གྱིས་གསོལ་པ་། བཅོམ་ལྡན་འདས་། དེའི་ཚེ་བདག་གི་དགེ་བའི་རྩ་བ་འཕེལ་བའམ་འབྲི་བར་འགྱུར་བ་ཅི་ཡང་མ་མཆིས་སོ་༎ བཅོམ་ལྡན་འདས་།
 nāsau prajñāpāramitāṃ bhāvayati yasya kasyaciddharmasya upacayo vā apacayo vā bhavati |	གང་ལ་ཆོས་འགའ་ཞིག་འཕེལ་བའམ་འདྲི་བ་མཆིས་ན་།
 na sā bhagavan prajñāpāramitābhāvanā veditavyā,	དེ་ནི་། ཤེས་རབ་ཀྱི་ཕ་རོལ་ཏུ་ཕྱིན་པ་བསྒོམ་པ་མ་ལགས་ཏེ་། བཅོམ་ལྡན་འདས་།
 yā kasyaciddharmasya upacayāya vā apacayāya vā pratyupasthitā |	གང་ཆོས་གང་ཡང་ཆོས་འགའ་ཞིག་འཕེལ་བའི་སླད་དུའམ་། འབྲི་བའི་སླད་དུ་ཉེ་བར་གནས་པ་དེ་ནི་།
 sā bhagavan prajñāpāramitābhāvanā yā naiva pṛthagjanadharmān jahāti,	ཤེས་རབ་ཀྱི་ཕ་རོལ་ཏུ་ཕྱིན་པ་བསྒོམ་པ་མ་ལགས་པར་རིག་པར་བགྱིའོ་༎ བཅོམ་ལྡན་འདས་། གང་སོ་སོའི་སྐྱེ་བོའི་ཆོས་རྣམས་ཀྱང་མི་སྤོང་ལ་།
 nāpi buddhadharmānupādatte |	སངས་རྒྱས་ཀྱི་ཆོས་རྣམས་ཀྱང་མི་ལེན་པ་དེ་ནི་། ཤེས་རབ་ཀྱི་ཕ་རོལ་ཏུ་ཕྱིན་པ་བསྒོམ་པ་ལགས་སོ་༎
 tatkasmāddhetoḥ?	དེ་ཅིའི་སླད་དུ་ཞེ་ན་། བཅོམ་ལྡན་འདས་། འདི་ལྟར་།
 tathā hi bhagavan prajñāpāramitābhāvanā na kasyaciddharmasyopalambhena pratyupasthitā yaṃ dharmaṃ prajahyādupādadīta vā |	ཤེས་རབ་ཀྱི་ཕ་རོལ་ཏུ་ཕྱིན་བསྒོམ་པ་ནི་། ཆོས་གང་སྤང་བའམ་བླང་བར་དམིགས་པས་ཆོས་གང་ལ་ཡང་མི་གནས་པའི་སླད་དུའོ་༎ བཅོམ་ལྡན་འདས་།
 sā bhagavan prajñāpāramitābhāvanā yā naiva saṃsāradoṣānupayāti na nirvāṇaguṇān |	གང་འཁོར་བའི་སྐྱོན་དུ་ཡང་མི་མཆི་ཞིང་། མྱ་ངན་ལས་འདས་པའི་༄༡༢༨ཨ་༌༎ ཡོན་ཏན་དུ་ཡང་མི་མཆིབ་?་དེ་། ཤེས་རབ་ཀྱི་ཕ་རོལ་ཏུ་ཕྱིན་པ་བསྒོམ་པ་ལགས་སོ་༎
 tatkasmāddhetoḥ?	དེ་ཅིའི་སླད་དུ་ཞེ་ན་། བཅོམ་ལྡན་འདས་། འདི་ལྟར་།
 tathā hi bhagavan saṃsārameva tāvann samanupaśyāmi,	འཁོར་བ་ཉིད་ཀྱང་མི་མཐོང་ན་།
 kaḥ punarvādaḥ saṃsāradoṣān |	འཁོར་བའི་སྐྱོན་ལྟ་སྨོས་ཀྱང་མི་འཚལ་།
 nirvāṇameva tāvannopalabhe,	མྱ་ངན་ལས་འདས་པ་ཉིད་ཀྱང་མི་དམིགས་ན་།
 kaḥ punarvādo nirvāṇaguṇān drakṣyāmi |	མྱ་ངན་ལས་འདས་པའི་ཡོན་ཏན་ལྟ་སྨོས་ཀྱང་ཅི་འཚལ་ཏེ་། བཅོམ་ལྡན་འདས་། གང་ཆོས་གང་ལ་ཡང་བླང་བའམ་།
 sā bhagavan prajñāpāramitābhāvanā yanna kasyaciddharmasyādānaṃ vā grahaṇaṃ vā niḥsaraṇaṃ vā |	བཟུང་བའམ་། དོར་བ་མ་མཆིས་པ་དེ་། ཤེས་རབ་ཀྱི་ཕ་རོལ་ཏུ་ཕྱིན་པ་བསྒོམ་པ་ལགས་སོ་༎
 sā bhagavan prajñāpāramitābhāvanā yā na kasyaciddharmasya hānirvā vṛddhirvopalabhyate |	བཅོམ་ལྡན་འདས་། གང་ཆོས་གང་ལ་ཡང་འགྲིབ་པ་དང་། འཕེལ་བ་མི་དམིགས་པ་དེ་། ཤེས་རབ་ཀྱི་ཕ་རོལ་ཏུ་ཕྱིན་པ་བསྒོམ་པ་ལགས་སོ་༎
 tatkasmāddhetoḥ? na hi bhagavan anutpādo hīyate vā vardhate vā | (saptaś, vaidya 343) yaivaṃ bhagavan bhāvanā,	དེ་ཅིའི་ཕྱིར་ཞེ་ན་། བཅོམ་ལྡན་འདས་། སྐྱེ་བ་མ་མཆིས་པ་ལ་འགྲིབ་པ་དང་། འཕེལ་བ་མ་མཆིས་པའི་སླད་དུའོ་༎ བཅོམ་ལྡན་འདས་།
 sā prajñāpāramitābhāvanā |	གང་དེ་ལྟར་བསྒོམ་པ་དེ་། ཤེས་རབ་ཀྱི་ཕ་རོལ་ཏུ་ཕྱིན་པ་བསྒོམ་པ་ལགས་སོ་༎ བཅོམ་ལྡན་འདས་།
 sā prajñāpāramitābhāvanā yā na kaṃciddharmamutpādayati vā nirodhayati vā |	གང་ཆོས་གང་ཡང་སྐྱེ་བའམ་། འགག་པར་མི་བགྱིད་པ་དེ་། ཤེས་རབ་ཀྱི་ཕ་རོལ་ཏུ་ཕྱིན་པ་བསྒོམ་པ་ལགས་སོ་༎ བཅོམ་ལྡན་འདས་།
 sā bhagavan prajñāpāramitābhāvanā yā na kasyaciddharmasyonatvaṃ vā pūrṇatvaṃ vā karoti |	གང་ཆོས་གང་ལ་ཡང་འགྲིབ་པའམ་། རྒྱས་པར་མི་བགྱིད་པ་དེ་། ཤེས་རབ་ཀྱི་ཕ་རོལ་ཏུ་ཕྱིན་པ་བསྒོམ་པ་ལགས་ཏེ་།
 yā bhagavan evaṃ bhāvanā,	བཅོམ་ལྡན་འདས་། གང་དེ་ལྟར་བསྒོམ་པ་དེ་།
 saiva prajñāpāramitābhāvanā |	ཤེས་རབ་ཀྱི་ཕ་རོལ་ཏུ་ཕྱིན་པ་བསྒོམ་པ་ལགས་སོ་༎ བཅོམ་ལྡན་འདས་།
 punaraparaṃ bhagavan sā prajñāpāramitabhāvanā yā naivācintyān dharmān prārthayate na prādeśikān | api tu khalu punarbhagavan tadapi na saṃvidyate yatprārthayate,	གཞན་ཡང་བསམ་གྱིས་མི་ཁྱབ་པའི་ཆོས་༄༡༢༨བ་ལ་ཡང་མི་སྨོན་ཅིང་ཉི་ཚེ་བ་ལ་མི་སྨོན་གྱི་། བཅོམ་ལྡན་འདས་།
 yena prārthayate, yatra prārthayate |	གང་ལ་སྨོན་པ་དང་། གང་གིས་སྨོན་བ་དེ་ཉིད་མ་མཆིས་པ་དེ་།
 evaṃ bhāvanā bhagavan prajñāpāramitābhāvanā |	ཤེས་རབ་ཀྱི་ཕ་རོལ་ཏུ་ཕྱིན་པ་བསྒོམ་པ་ལགས་ཏེ་། བཅོམ་ལྡན་འདས༏་དེ་ལྟར་བསྒོམས་ན་། ཤེས་རབ་ཀྱི་ཕ་རོལ་ཏུ་ཕྱིན་པ་བསྒོམ་པ་ལགས་སོ་༎ བཅོམ་ལྡན་འདས་། ཤེས་རབ་ཀྱི་ཕ་རོལ་ཏུ་ཕྱིན་པ་སྒོམ་པ་ནི་། འདི་ལྟར་།
 evaṃ pratyupasthitā ime dharmā agrāḥ ime dharmā hīnā iti |	ཆོས་འདི་དག་ནི་། མཆོག་གོ་། ཆོས་འདི་དག་ནི་། ཐ་མའོ་༎ ཞེས་བགྱི་བར་ཉེ་བར་མི་གནས་ཤིང་།
 nāpi tān dharmānupalabhate yeṣāṃ dharmāṇāmagratā vā hīnatā vā syāt |	ཆོས་གང་དག་མཆོག་དང་། ཐ་མར་འགྱུར་བའི་ཆོས་དེ་དག་ཀྱང་མི་དམིགས་ཏེ་།
 evaṃ prajñāpāramitābhāvanāyogamanuyuktaḥ kulaputraḥ sarvadharmān nopalabhate |	དེ་ལྟར་ཤེས་རབ་ཀྱི་ཕ་རོལ་ཏུ་ཕྱིན་པ་སྒོམ་པའི་རྣལ་འབྱོར་ལ་བརྩོན་པའི་རིགས་ཀྱི་བུ་ནི་། ཆོས་ཐམས་ཅད་མི་དམིགས་སོ་༎ བཅོམ་ལྡན་འདས་།
 na bhagavan prajñāpāramitābhāvanā kaṃciddharmamagraṃ vā hīnaṃ vā kalpayati |	ཤེས་རབ་ཀྱི་ཕ་རོལ་ཏུ་ཕྱིན་པ་སྒོམ་པ་ནི་། ཆོས་གང་ཡང་མཆོག་ཅེས་བྱ་བའམ་། ཐ་མ་ཞེས་མི་རྟོག་གོ་།
 tatkasmāddhetoḥ? na hi bhagavan anutpādasya kiṃcidagraṃ vā hīnaṃ vā,	དེ་ཅིའི་སླད་དུ་ཞེ་ན་། བཅོམ་ལྡན་འདས་། སྐྱེ་བ་མ་མཆིས་པ་ལ་མཆོག་གམ་།
 nāpi tathatāyā bhūtakoṭyāḥ,	ཐ་མ་ཞེས་བགྱི་བ་གང་ཡང་མ་མཆིས་པའི་སླད་དུའོ་༎
 yāvat sarvadharmāṇāṃ kiṃcidagraṃ vā hīnaṃ vā |	དེ་བཞིན་ཉིད་དང་། ཡང་དག་པའི་མཐའ་དང་། ཆོས་ཐམས་ཅད་ཀྱི་བར་ལ་ཡང་མཆོག་གམ་།
 evaṃ bhāvanā bhagavan prajñāpāramitābhāvanā ||	ཐ་མ་མ་མཆིས་ཏེ་། དེ་ལྟར་བསྒོམས་ན་། ཤེས་རབ་ཀྱི་ཕ་རོལ་ཏུ་ཕྱིན་པ་བསྒོམ་པ་ལགས་སོ་༎
 evamukte bhagavān mañjuśriyaṃ kumārabhūtamāmantrayate sma - na punarmañjuśrīḥ agrā buddhadharmāḥ?	དེ་སྐད་ཅེས་གསོལ་པ་དང་། བཅོམ་ལྡན་འདས་ཀྱིས་འཇམ་དཔལ་གཞོན་ནུར་གྱུར་པ་ལ་འདི་སྐད་ཅེས་བཀའ་སྩལ་ཏོ་༎ འཇམ་དཔལ་། སངས་རྒྱས་ཀྱི་ཆོས་རྣམས་མཆོག་མ་ཡིན་ནམ་།
 mañjuśrīrāha - agrāhyatvādbhagavan agrā buddhadharmāḥ |	འཇམ་དཔལ་གྱིས་གསོལ་པ་། བཅོམ་ལྡན་འདས་། ༄༡༢༩ཨ་༌༎ གཟུང་དུ་མ་མཆིས་པའི་སླད་དུ་སངས་རྒྱས་ཀྱི་ཆོས་རྣམས་ནི་། མཆོག་ལགས་སོ་༎
 tatkiṃ punarbhagavan sarvadharmāḥ śūnyā iti tathāgatenābhisaṃbuddhāḥ?	བཅོམ་ལྡན་འདས་། ཆོས་ཐམས་ཅད་སྟོང་པར་དེ་བཞིན་གཤེགས་པས་མངོན་པར་རྫོགས་པར་སངས་རྒྱས་པ་ལགས་སམ་། བཅོམ་ལྡན་འདས་ཀྱིས་བཀའ་སྩལ་པ་།
 bhagavānāha - evametanmañjuśrīḥ śūnyāḥ sarvadharmāstathāgatenābhisaṃbuddhāḥ |	འཇམ་དཔལ་། དེ་དེ་བཞིན་ཏེ་། དེ་བཞིན་གཤེགས་པས་ཆོས་ཐམས་ཅད་སྟོང་པར་མངོན་པར་རྫོགས་པར་སངས་རྒྱས་སོ་༎
 mañjuśrīrāha - tatkiṃ punarbhagavan śūnyatāyā agratā vā hīnatā prajñāyate?	འཇམ་དཔལ་གྱིས་གསོལ་པ་། བཅོམ་ལྡན་འདས་། སྟོང་པ་ཉིད་ལ་མཆོག་གམ་། ཐ་མ་ཞེས་བགྱི་བ་མཆིས་ལགས་སམ་།
 bhagavānāha - sādhu sādhu mañjuśrīḥ,	བཅོམ་ལྡན་འདས་ཀྱིས་བཀའ་སྩལ་པ་། འཇམ་དཔལ་། ལེགས་སོ་། ལེགས་སོ་༎
 evametanmañjuśrīḥ yathā kathayasi |	འཇམ་དཔལ་། དེ་དེ་བཞིན་ཏེ་། ཇི་སྐད་སྨྲས་པ་བཞིན་ནོ་༎
 na punarmañjuśrīḥ anuttarā buddhadharmāḥ?	འཇམ་དཔལ་། སངས་རྒྱས་ཀྱི་ཆོས་རྣམས་བླ་ན་མེད་པ་མ་ཡིན་ནམ་།
 mañjuśrīrāha - evametadbhagavan anuttarā buddhadharmāḥ |	འཇམ་དཔལ་གྱིས་གསོལ་པ་། དེ་དེ་ལྟ་ལགས་ཏེ་། སངས་རྒྱས་ཀྱི་ཆོས་རྣམས་ནི་། བླ་ན་མ་མཆིས་པ་ལགས་སོ་༎
 tatkasmāddhetoḥ?	དེ་ཅིའི་སླད་དུ་ཞེ་ན་། བཅོམ་ལྡན་འདས་། འདི་ལྟར་།
 tathā hi bhagavan teṣvaṇurapi dharmo na saṃvidyate nopalabhyate |	དེ་དག་ལ་ཆོས་ཅུང་ཟད་ཙམ་ཡང་མ་མཆིས་ཤིང་མི་དམིགས་ཏེ་། དེ་བས་ན་།
 na te anuttarā buddhadharmāḥ |	སངས་རྒྱས་ཀྱི་ཆོས་དེ་དག་ནི་། བླ་ན་མ་མཆིས་པའོ་༎ བཅོམ་ལྡན་འདས་། གཞན་ཡང་སངས་རྒྱས་ཀྱི་ཆོས་རྣམས་སྒྲུབ་པར་ཡང་མི་བགྱིད་ལ་།
 punaraparaṃ bhagavan sā prajñāpāramitābhāvanā yā na buddhadharmāṇāmārādhanāya saṃvartate na pṛgjanadharmāṇāṃ prahāṇāya saṃvartate |	སོ་སོའི་སྐྱེ་བོའི་ཆོས་རྣམས་སྤོང་བར་ཡང་མི་བགྱིད་ཅིང་།
 na buddhadharmāṇāṃ vinayitrī,	སངས་རྒྱས་ཀྱི་ཆོས་རྣམས་འདུལ་བ་ཡང་མ་ལགས་ལ་།
 na saṃdhārayitrī |	འཛིན་པའང་མ་ལགས་པ་དེ་།
 evaṃ bhāvanā bhagavan prajñāpāramitābhāvanā ||	ཤེས་རབ་ཀྱི་ཕ་༄༡༢༩བ་རོལ་ཏུ་ཕྱིན་པ་བསྒོམ་པ་ལགས་སོ་༎
 punaraparaṃ sā bhagavan prajñāpāramitābhāvanā draṣṭavyā yā na kaṃciddharmaṃ cintayati na vijānīte |	བཅོམ་ལྡན་འདས་། གཞན་ཡང་ཆོས་གང་ལ་ཡང་མི་སེམས་ལ་རྣམ་པར་མི་རིག་པ་དེ་། ཤེས་རབ་ཀྱི་ཕ་རོལ་ཏུ་ཕྱིན་པ་བསྒོམ་པ་ལགས་སོ་༎
 bhagavānāha - na tvaṃ mañjuśrīḥ buddhadharmāṃścintayasi?	བཅོམ་ལྡན་འདས་ཀྱིས་བཀའ་སྩལ་པ་། འཇམ་དཔལ་། ཁྱོད་སངས་རྒྱས་ཀྱི་ཆོས་རྣམས་ལ་མི་སེམས་སམ་།
 mañjuśrīrāha - no bhagavan | cintayeyamahaṃ bhagavan buddhadharmān,	འཇམ་དཔལ་གྱིས་གསོལ་པ་། བཅོམ་ལྡན་འདས་།
 sacedahaṃ buddhadharmāṇāṃ pariniṣpattiṃ paśyeyam | na bhagavan prajñāpāramitābhāvanā kasyaciddharmasya vikalpena pratyupasthitā - ime pṛthagjanadharmāḥ,	གལ་ཏེ་བདག་གིས་སངས་རྒྱས་ཀྱི་ཆོས་རྣམས་ཡོངས་སུ་གྲུབ་པར་མཐོང་ན་ནི་། བདག་སངས་རྒྱས་ཀྱི་ཆོས་རྣམས་ལ་སེམས་ལགས་སོ་༎ བཅོམ་ལྡན་འདས་། ཤེས་རབ་ཀྱི་ཕ་རོལ་ཏུ་ཕྱིན་པ་སྒོམ་པ་ནི་། འདི་དག་ནི་། སོ་སོའི་སྐྱེ་བོའི་ཆོས་སོ་༎
 ime śrāvaka dharmāḥ,	འདི་དག་ནི་། ཉན་ཐོས་ཀྱི་ཆོས་སོ་༎ འདི་དག་ནི་།
 ime pratyekabuddhadharmāḥ ime samyaksaṃbuddhadharmā iti |	རང་སངས་རྒྱས་ཀྱི་ཆོས་སོ་༎ འདི་དག་ནི་། ཡང་དག་པར་རྫོགས་པའི་སངས་རྒྱས་ཀྱི་ཆོས་སོ་༎ ཞེས་ཆོས་གང་ལ་ཡང་རྣམ་པར་རྟོག་པས་ཉེ་བར་གནས་པ་མ་ལགས་སོ་༎
 tatkasmāddhetoḥ?	དེ་ཅིའི་སླད་དུ་ཞེ་ན་། བཅོམ་ལྡན་འདས་།
 tameva bhagavan dharmaṃ prajñāpāramitābhāvanāyogamanuyuktaḥ kulaputro nopalabhate,	ཤེས་རབ་ཀྱི་ཕ་རོལ་ཏུ་ཕྱིན་པ་སྒོམ་པའི་རྣལ་འབྱོར་ལ་བརྩོན་པའི་རིགས་ཀྱི་བུས་ཆོས་དེ་ཉིད་ཀྱང་མི་དམིགས་ཏེ་།
 yasyaitān dharmān pṛthagjanadharmān vā nirdiśet,	གང་ལ་ཆོས་དེ་དག་སོ་སོའི་སྐྱེ་བོའི་ཆོས་ཞེས་བརྗོད་པའམ་།
 śaikṣadharmān vā nirdiśet,	སློབ་པའི་ཆོས་ཞེས་བརྗོད་པའམ་།
 aśaikṣadharmān vā nirdiśet,	མི་སློབ་པའི་ཆོས་ཞེས་བརྗོད་པའམ་།
 samyaksaṃbuddhadharmān vā nirdiśet |	རང་སངས་རྒྱས་ཀྱི་ཆོས་ཞེས་བརྗོད་པའམ་། ཡང་དག་པར་རྫོགས་པའི་སངས་རྒྱས་ཀྱི་ཆོས་ཞེས་བརྗོད་པ་ཡང་མཐའ་ལས་འདས་བའི་ཆོས་ཉིད་ལགས་པས་ཆོས་དེ་མི་དམིགས་ཤིང་།
 tānatyantatayā dharmān na samanupaśyāmi |	ཡང་དག་པར་རྗེས་སུ་མི་མཐོང་༄༡༣༠ཨ་༌༎ བའི་སླད་དུའོ་༎
 evaṃ bhāvanā bhagavan prajñāpāramitābhāvanā |	བཅོམ་ལྡན་འདས་། དེ་ལྟར་བསྒོམས་ན་། ཤེས་རབ་ཀྱི་ཕ་རོལ་ཏུ་ཕྱིན་པ་བསྒོམ་པ་ལགས་སོ་༎
 na bhagavan prajñāpāramitābhāvanāyogamanuyuktasya kulaputrasyaivaṃ bhavati - ayaṃ kāmadhātuḥ,	བཅོམ་ལྡན་འདས་། ཤེས་རབ་ཀྱི་ཕ་རོལ་ཏུ་ཕྱིན་པ་སྒོམ་པའི་རྣལ་འབྱོར་ལ་བརྩོན་པའི་རིགས་ཀྱི་བུ་ནི་། འདི་ལྟར་། འདི་ནི་། འདོད་པའི་ཁམས་སོ་༎
 ayaṃ rūpadhātuḥ,	འདི་ནི་། གཟུགས་ཀྱི་ཁམས་སོ་༎
 ayamārūpyadhātuḥ,	འདི་ནི་། གཟུགས་མེད་པའི་ཁམས་སོ་༎
 yāvad ayaṃ nirodhadhāturiti |	ཞེས་བགྱི་བ་ནས་འདི་ནི་། འགོག་པའི་དབྱིངས་སོ་༎ ཞེས་བགྱི་བའི་བར་དུ་ཡང་མི་ཤེས་སོ་༎
 tatkasmāddhetoḥ?	དེ་ཅིའི་སླད་དུ་ཞེ་ན་། བཅོམ་ལྡན་འདས་། འདི་ལྟར་།
 tathā hi sa bhagavan na kaściddharmaḥ, yo nirodhadharmaṃ samanupaśyati |	དེས་འགོག་པའི་ཆོས་གང་ལགས་པའི་ཆོས་དེ་གང་ཡང་མི་མཐོང་སྟེ་།
 evaṃ bhāvanā bhagavan prajñāpāramitābhāvanā veditavyā ||	བཅོམ་ལྡན་འདས་། དེ་ལྟར་སྒོམ་པ་ནི་། ཤེས་རབ་ཀྱི་ཕ་རོལ་ཏུ་ཕྱིན་པ་བསྒོམ་པར་རིག་པར་བགྱིའོ་༎ བཅོམ་ལྡན་འདས་།
 (saptaś, vaidya 344) punaraparaṃ bhagavan eṣā sā prajñāpāramitābhāvanā yā na kasyaciddharmasyopakāraṃ vā apakāraṃ vā karoti |	གཞན་ཡང་གང་ཆོས་གང་ལ་ཡང་ཕན་པའམ་། གནོད་པ་མི་བགྱིད་པ་དེ་། ཤེས་རབ་ཀྱི་ཕ་རོལ་ཏུ་ཕྱིན་པ་བསྒོམ་པ་ལགས་སོ་༎
 na hi bhagavan prajñāpāramitābhāvanā buddhadharmāṇāṃ dhātrī,	བཅོམ་ལྡན་འདས་། ཤེས་རབ་ཀྱི་ཕ་རོལ་ཏུ་ཕྱིན་པ་སྒོམ་པ་ནི་། སངས་རྒྱས་ཀྱི་ཆོས་རྣམས་སྦྱིན་པར་བགྱིད་པ་ཡང་མ་ལགས་།
 na pṛthagjanadharmāṇāmācchetrī | eṣaiva sā bhagavan prajñāpāramitābhāvanā yā naiva pṛthagjanadharmāṇāṃ nirodhaḥ,	སོ་སོའི་སྐྱེ་བོའི་ཆོས་རྣམས་གཅོད་པར་བགྱིད་པ་ཡང་མ་ལགས་སོ་༎ བཅོམ་ལྡན་འདས་།
 na buddhadharmāṇāṃ nirodhaḥ,	གང་སོ་སོའི་སྐྱེ་བོའི་ཆོས་རྣམས་ཀྱང་མི་འགོག་ལ་།
 na buddhadharmāṇāṃ pratilambhaḥ ||	སངས་རྒྱས་ཀྱི་ཆོས་རྣམས་ཀྱང་མི་འཐོབ་པ་དེ་། ཤེས་རབ་ཀྱི་ཕ་རོལ་ཏུ་ཕྱིན་པ་བསྒོམ་པ་ལགས་སོ་༎
 evamukte bhagavān mañjuśriyaṃ kumārabhūtametadavocat - sādhu sādhu mañjuśrīḥ yastvamimamevaṃrūpaṃ gambhīraṃ dharmaṃ deśayasi |	དེ་སྐད་ཅེས་གསོལ་པ་དང་། བཅོམ་ལྡན་འདས་ཀྱིས་འཇམ་དཔལ་གཞོན་ནུར་༄༡༣༠བ་གྱུར་པ་ལ་འདི་སྐད་ཅེས་བཀའ་སྩལ་ཏོ་༎ འཇམ་དཔལ་། ཁྱོད་ཀྱིས་ཟབ་མོ་འདི་ལྟ་བུ་འདི་བསྟན་པ་ལེགས་སོ་༎ ལེགས་སོ་༎ འཇམ་དཔལ་།
 sthāpitā te mañjuśrīriyaṃ mudrā bodhisattvānāṃ mahāsattvānām, ābhimānikānāṃ ca śrāvakāṇām, aupalambhikānāṃ ca bodhisattvayānikānāṃ ca yathābhūtaṃ pratibodhāya |	ཁྱོད་ཀྱིས་བྱང་ཆུབ་སེམས་དཔའ་སེམས་དཔའ་ཆེན་པོ་རྣམས་དང་། ཉན་ཐོས་ཀྱི་ཐེག་པ་པ་མངོན་པའི་ང་རྒྱལ་ཅན་རྣམས་དང་། བྱང་ཆུབ་སེམས་དཔའི་ཐེག་པ་པ་དམིགས་པ་ཅན་རྣམས་ཡང་དག་པ་ཇི་ལྟ་བ་བཞིན་དུ་རྟོགས་པར་བྱ་བའི་ཕྱིར་རྒྱ་འདི་བཞག་གོ་། འཇམ་དཔལ་།
 na te mañjuśrīḥ kulaputrā vā kuladuhitaro vā ekabuddhaparyupāsitā bhaviṣyanti naikabuddhāvaropitakuśalamūlāḥ,	རིགས་ཀྱི་བུའམ་།
 ye imaṃ gambhīraṃ prajñāpāramitānirdeśaṃ śrutvā notrasiṣyanti na saṃtrasiṣyanti na saṃtrāsamāpatsyante | api tu khalu punarmañjuśrīḥ atikramya te buddhasahasrāvaropitakuśalamūlā bhaviṣyanti, ye imaṃ gambhīraṃ prajñāpāramitānirdeśaṃ śrutvā adhimokṣyanti,	རིགས་ཀྱི་བུ་མོ་གང་དག་ཤེས་རབ་ཀྱི་ཕ་རོལ་ཏུ་ཕྱིན་པ་ཟབ་མོ་བསྟན་པ་འདི་ཐོས་ནས་མི་སྐྲག་། 
 notrasiṣyanti na saṃtrasiṣyanti na saṃtrāsamāpatsyante ||	མི་དངང་། དངང་པར་མི་འགྱུར་བ་དེ་དག་ནི་། སངས་རྒྱས་གཅིག་ལ་བསྙེན་བཀུར་བྱས་པ་མ་ཡིན་། སངས་རྒྱས་གཅིག་ལ་དགེ་བའི་རྩ་བ་བསྐྱེད་པ་མ་ཡིན་ནོ་༎
 evamukte mañjuśrīḥ kumārabhūto bhagavantametadavocat - pratibhāti me bhagavan bhūyasyā mātrayā prajñāpāramitānirdeśaḥ |	དེ་སྐད་ཅེས་བཀའ་སྩལ་པ་དང་། བཅོམ་ལྡན་འདས་ལ་འཇམ་དཔལ་གཞོན་ནུར་གྱུར་བས་འདི་སྐད་ཅེས་གསོལ་ཏོ་༎ བཅོམ་ལྡན་འདས་། བདག་ནི་། ཤེས་རབ་ཀྱི་ཕ་རོལ་ཏུ་ཕྱིན་པ་རྒྱ་ཆེར་སྟོན་པར་སྤོབས་ལགས་སོ་༎ བཅོམ་ལྡན་འདས་ཀྱིས་བཀའ་སྩལ་པ་། འཇམ་དཔལ་།
 pratibhātu te mañjuśrīḥ, iti bhagavānasyāvocat |	སྤོབས་པར་གྱིས་ཤིག་། འཇམ་དཔལ་གྱིས་གསོལ་པ་།
 mañjuśrīrāha - eṣā sā bhagavan prajñāpāramitābhāvanā yā na kasyaciddharmasya sthitimupalabhate nāsthitim |	བཅོམ་ལྡན་འདས་། གང་ཆོས་གང་གི་གནས་པ་མི་དམིགས་པ་དང་། མི་གནས་པ་ཡང་མི་དམིགས་པ་དེ་། ཤེས་རབ་ཀྱི་ཕ་རོལ་ཏུ་ཕྱིན་པ་བསྒོམ་པ་ལགས་སོ་༎
 tatkasmāddhetoḥ?	དེ་ཅིའི་སླད་དུ་ཞེ་ན་། ཆོས་ཐམས་ཅད་ནི་།
 asthitatvātsarvadharmāṇāṃ nopalabhate | eṣaiva sa bhagavan prajñāpāramitābhāvanā veditavyā,	མི་གནས་པའི་སླད་དུ་མི་དམིགས་པ་སྟེ་། བཅོམ་ལྡན་འདས་༎
 yā na kasyaciddharmasyādhyālambanāya pratyupasthitā |	གང་ཆོས་གང་ལ་༄༡༣༡ཨ་༌༎ ཡང་ལྷག་པར་དམིགས་པའི་སླད་དུ་ཉེ་བར་མི་གནས་པ་དེ་། ཤེས་རབ་ཀྱི་ཕ་རོལ་ཏུ་ཕྱིན་པ་བསྒོམ་པར་རིག་པར་བགྱིའོ་༎
 tatkasya hetoḥ?	དེ་ཅིའི་སླད་དུ་ཞེ་ན་། བཅོམ་ལྡན་འདས་།
 tathā hi bhagavan nirālambanāḥ sarvadharmāḥ |	འདི་ལྟར་། ཆོས་ཐམས་ཅད་ནི་། དམིགས་པ་མ་མཆིས་པའི་སླད་དུ་སྟེ་།
 evaṃ bhāvanā bhagavan prajñāpāramitābhāvanā ||	བཅོམ་ལྡན་འདས་། དེ་ལྟར་བསྒོམ་པ་ནི་། ཤེས་རབ་ཀྱི་ཕ་རོལ་ཏུ་ཕྱིན་པ་བསྒོམ་པ་ལགས་སོ་༎
 punaraparaṃ bhagavan sā prajñāpāramitābhāvanā draṣṭavyā yatra buddhadharmā api nābhimukhībhavanti kutaḥ punaḥ pratyekabuddhadharmāḥ |	བཅོམ་ལྡན་འདས༏་གཞན་ཡང་གང་ལ་སངས་རྒྱས་ཀྱི་ཆོས་རྣམས་ཀྱང་མངོན་དུ་མི་འགྱུར་ན་། སངས་རྒྱས་ཀྱི་ཆོས་རྣམས་ལྟ་སྨོས་ཀྱང་ཅི་འཚལ་།
 nāpi śrāvakadharmā abhimukhībhavanti,	ཉན་ཐོས་ཀྱི་ཆོས་རྣམས་ཀྱང་མངོན་དུ་མི་འགྱུར་ན་།
 kaḥ punarvādaḥ pṛthagjanadharmāṇām ||	སོ་སོའི་སྐྱེ་བོའི་ཆོས་རྣམས་ལྟ་སྨོས་ཀྱང་ཅི་འཚལ་བ་དེ་།
 punaraparaṃ bhagavan sā prajñāpāramitābhāvanā yā(yāṃ?)	ཤེས་རབ་ཀྱི་ཕ་རོལ་ཏུ་ཕྱིན་པ་བསྒོམ་པར་བལྟ་བར་བགྱིའོ་༎
 bhāvanāmāgamya acintyānapi buddhadharmānacintyā buddhadharmā iti na vikalpamāpadyate |	བཅོམ་ལྡན་འདས་། གཞན་ཡང་སྒོམ་པ་གང་ལ་བརྟེན་ནས་སངས་རྒྱས་ཀྱི་ཆོས་རྣམས་བསམ་གྱིས་མི་ཁྱབ་པ་ལ་ཡང་སངས་རྒྱས་ཀྱི་ཆོས་རྣམས་བསམ་གྱིས་མི་ཁྱབ་བོ་༎ ཞེས་རྣམ་པར་མི་རྟོག་པ་དེ་། ཤེས་རབ་ཀྱི་ཕ་རོལ་ཏུ་ཕྱིན་པ་བསྒོམ་པ་ལགས་སོ་༎
 seyaṃ bhagavan prajñāpāramitābhāvanā bodhisattvānāṃ mahāsattvānāṃ sarvadharmāvikalpāya draṣṭavyā ||	བཅོམ་ལྡན་འདས༏་ཤེས་རབ་ཀྱི་ཕ་རོལ་ཏུ་ཕྱིན་པ་སྒོམ་པ་འདི་ནི་། བྱང་ཆུབ་སེམས་དཔའ་སེམས་དཔའ་ཆེན་པོ་རྣམས་ཀྱི་ཆོས་ཐམས་ཅད་རྣམ་པར་མི་རྟོག་པར་བལྟ་བར་བགྱིའོ་༎ བཅོམ་ལྡན་འདས་།
 punaraparaṃ bhagavan sā prajñāpāramitābhāvanā yā(yāṃ?) bhāvanāmāgamya sarvadharmān buddhadharmān paśyati, sarvadharmānacintyadharmān paśyatyasamanupaśyanatayā |	གཞན་ཡང་སྒོམ་པ་གང་ལ་བརྟེན་ནས་མཐོང་བ་མ་མཆིས་པར་ཆོས་ཐམས་ཅད་སངས་རྒྱས་ཀྱི་ཆོས་སུ་མཐོང་བ་དང་། ཆོས་ཐམས་ཅད་བསམ་གྱིས་མི་ཁྱབ་པའི་ཆོས་སུ་མཐོང་བ་དེ་། ཤེས་༄༡༣༡བ་རབ་ཀྱི་ཕ་རོལ་ཏུ་ཕྱིན་པ་བསྒོམ་པ་ལགས་སོ་༎ རིགས་ཀྱི་བུའམ་།
 bahubuddhaśatasahasraparyupāsitāste bhagavan kulaputrāḥ kuladuhitaraśca bhaviṣyanti ye imaṃ prajñāpāramitānirdeśaṃ śrutvā adhimokṣyante nottrasiṣyanti na saṃtrasiṣyanti	རིགས་ཀྱི་བུ་མོ་གང་དག་ཤེས་རབ་ཀྱི་ཕ་རོལ་ཏུ་ཕྱིན་པ་བསྟན་པ་འདི་ཐོས་ནས་མི་སྐྲག་། 
 na saṃtrāsamāpātsyante ||	མི་དངང་། དངང་བར་མི་འགྱུར་བ་དེ་དག་སངས་རྒྱས་བརྒྱ་སྟོང་མང་པོ་ལ་བསྙེན་བཀུར་བགྱིད་པར་འགྱུར་རོ་༎ བཅོམ་ལྡན་འདས་།
 punaraparaṃ bhagavan sā prajñāpāramitābhāvanā yāṃ na kaściddharmaḥ saṃkliśyate vā vyavadāyate vā samanupaśyati |	གཞན་ཡང་གང་ཀུན་ནས་ཉོན་མོངས་པའམ་། རྣམ་པར་བྱང་པའི་ཆོས་གང་ཡང་ཡང་དག་པར་རྗེས་སུ་མ་མཐོང་བ་དེ་། ཤེས་རབ་ཀྱི་ཕ་རོལ་ཏུ་ཕྱིན་པ་བསྒོམ་པ་ལགས་ཏེ་།
 evaṃ bhāvanā bhagavan prajñāpāramitābhāvanā |	བཅོམ་ལྡན་འདས་། དེ་ལྟར་བསྒོམས་ན་། ཤེས་རབ་ཀྱི་ཕ་རོལ་ཏུ་ཕྱིན་པ་བསྒོམ་པ་ལགས་སོ་༎
 sā caiṣā bhagavan prajñāpāramitābhāvanā yā naiva pṛthagjananānātvaṃ karoti, na śrāvakanānātvam, na pratyekabuddhanānātvam, yāvat samyaksaṃbuddhanānātvaṃ ca karoti |	བཅོམ་ལྡན་འདས་། ཤེས་རབ་ཀྱི་ཕ་རོལ་ཏུ་ཕྱིན་པ་སྒོམ་པ་དེ་ནི་། སོ་སོའི་སྐྱེ་བོ་དང་། ཉན་ཐོས་དང་། རང་སངས་རྒྱས་དང་། ཡང་དག་པར་རྫོགས་པའི་སངས་རྒྱས་ཀྱི་བར་དུ་ཡང་ཐ་དད་དུ་མི་བགྱིད་པ་སྟེ་།
 eṣā sā bhagavan prajñāpāramitābhāvanā ||	བཅོམ་ལྡན་འདས་། དེ་ནི་། ཤེས་རབ་ཀྱི་ཕ་རོལ་ཏུ་ཕྱིན་པ་བསྒོམ་པ་ལགས་སོ་༎
 (saptaś, vaidya 345) atha khalu bhagavān mañjuśriyaṃ kumārabhūtamāmantrayate sma - kiyantastvayā mañjuśrīḥ tathāgatāḥ paryupāsitāḥ?	དེ་ནས་བཅོམ་ལྡན་འདས་ཀྱིས་འཇམ་དཔལ་གཞོན་ནུར་གྱུར་པ་ལ་བཀའ་སྩལ་པ་། འཇམ་དཔལ་། ཁྱོད་ཀྱིས་དེ་བཞིན་གཤེགས་པ་ཇི་སྙེད་ཅིག་ལ་བསྙེན་བཀུར་བྱས་།
 mañjuśrīrāha - yāvanto bhagavan māyāpuruṣasya cittacaitasikā niruddhāḥ,	འཇམ་དཔལ་གྱིས་གསོལ་པ་། བཅོམ་ལྡན་འདས་། སྒྱུ་མའི་སྐྱེས་བུའི་སེམས་དང་སེམས་ལས་བྱུང་བ་ཇི་སྙེད་འགག་པ་དེ་སྙེད་ལགས་ཏེ༏་བཅོམ་ལྡན་འདས་། 
 iyanto mayā bhagavan tathāgatāḥ paryupāsitāḥ |	བདག་གིས་དེ་བཞིན་གཤེགས་པ་དེ་སྙེད་ལ་བསྙེན་བཀུར་བགྱིས་སོ་༎
 bhagavānāha - na tvaṃ mañjuśrīḥ buddhadharmasaṃsthitaḥ?	བཅོམ་ལྡན་འདས་ཀྱིས་བཀའ་སྩལ་པ་། འཇམ་དཔལ་། ཁྱོད་སངས་རྒྱས་ཀྱི་ཆོས་ལ་ཡང་དག་༄༡༣༢ཨ་༌༎ པར་མ་ཞུགས་སམ་།
 mañjuśrīrāha - kaścitpunarbhagavan sa dharma upalabhyate yo na buddhadharmasaṃsthitaḥ?	འཇམ་དཔལ་གྱིས་གསོལ་པ་། བཅོམ་ལྡན་འདས་། གང་སངས་རྒྱས་ཀྱི་ཆོས་ལ་ཡང་དག་པར་ཞུགས་པའི་ཆོས་དེ་གང་ཡང་དམིགས་སུ་མཆིས་སམ་།
 bhagavānāha - kasya punarmañjuśrīḥ ete buddhadharmāḥ?	བཅོམ་ལྡན་འདས་ཀྱིས་བཀའ་སྩལ་པ་། འཇམ་དཔལ་། འོ་ན་སངས་རྒྱས་ཀྱི་ཆོས་དེ་དག་སུ་ལ་ཡོད་།
 mañjuśrīrāha - bhagavan tava tāvadete buddhadharmā iti nāma na saṃvidyate nopalabhyate,	འཇམ་དཔལ་གྱིས་གསོལ་པ་། བཅོམ་ལྡན་འདས་ཉིད་ལ་ཡང་སངས་རྒྱས་ཀྱི་ཆོས་ཞེས་བགྱི་བ་དེ་དག་གི་མིང་ཡང་མ་མཆིས་ཏེ་མི་དམིགས་ན་།
 kutaḥ punaranyeṣāṃ bhaviṣyati?	གཞན་རྣམས་ལ་མཆིས་པར་འགྱུར་བ་ལྟ་ཅི་སྨོས་།
 bhagavānāha - prāptā te mañjuśrīrasaṅgatā?	བཅོམ་ལྡན་འདས་ཀྱིས་བཀའ་སྩལ་པ་། འཇམ་དཔལ་། ཁྱོད་ཀྱིས་ཆགས་པ་མེད་པ་ཉིད་རྙེད་དམ་།
 mañjuśrīrāha - tadyadā tāvadahaṃ bhagavan na saṅgataiva,	འཇམ་དཔལ་གྱིས་གསོལ་པ་། བཅོམ་ལྡན་འདས་། བདག་ཉིད་ཆགས་པ་མ་མཆིས་པ་ཉིད་ལགས་ན་།
 tatkiṃ bhūyo 'hamasaṅgatāmanuprāpsyāmi?	བདག་གིས་ཡང་ཆགས་པ་མ་མཆིས་པ་ཉིད་ཐོབ་པར་འགྱུར་རམ་།
 bhagavānāha - tatkiṃ niṣaṇṇo 'si mañjuśrīrbodhimaṇḍe?	བཅོམ་ལྡན་འདས་ཀྱིས་བཀའ་སྩལ་པ་། འཇམ་དཔལ་། ཁྱོད་ཅི་བྱང་ཆུབ་ཀྱི་སྙིང་པོ་ལ་འདུག་གམ་།
 mañjuśrīrāha - bhagavāneva tāvadbodhimaṇḍe na niṣaṇṇaḥ,	འཇམ་དཔལ་གྱིས་གསོལ་པ་།
 kathaṃ punarahaṃ niṣatsyāmi bhūtakoṭiṃ pramāṇīkṛtya?	ཡང་དག་པའི་མཐའ་བརྩན་པར་བགྱིས་ན་། བཅོམ་ལྡན་འདས་ཉིད་ཀྱང་བྱང་ཆུབ་ཀྱི་སྙིང་པོ་ལ་མ་ཞུགས་ན་། བདག་ལྟ་མཆིས་པར་ཇི་ལྟར་འགྱུར་།
 bhagavānāha - bhūtakoṭiriti mañjuśrīḥ kasyaitadadhivacanam?	བཅོམ་ལྡན་འདས་ཀྱིས་བཀའ་སྩལ་པ་། འཇམ་དཔལ་། ཡང་དག་པའི་མཐའ་ཞེས་བྱ་བ་དེ་གང་གི་ཚིག་བླ་དབ༹གས་ཡིན་། འཇམ་དཔལ་གྱིས་གསོལ་པ་།
 mañjuśrīrāha - bhūtakoṭiriti bhagavan satkāyasyaitadadhivacanam |	བཅོམ་ལྡན་འདས་། ཡང་དག་པའི་མཐའ་༄༡༣༢བ་ཞེས་བགྱི་བ་དེ་ནི་། འཇིག་ཚོགས་ཀྱི་ཚིག་བླ་དབ༹གས་ལགས་སོ་༎
 bhagavānāha - kiṃ saṃdhāya mañjuśrīrevaṃ vadasi?	བཅོམ་ལྡན་འདས་ཀྱིས་བཀའ་སྩལ་པ་། འཇམ་དཔལ་། ཁྱོད་ཅི་ལས་བསམ་སྟེ་དེ་སྐད་སྨྲ་།
 mañjuśrīrāha - asanneṣa bhagavan kāyo na satkāyaḥ |	འཇམ་དཔལ་གྱིས་གསོལ་པ༏་བཅོམ་ལྡན་འདས་། ཚོགས་དེ་ནི་། མ་མཆིས་པ་སྟེ་། འཇིག་ཚོགས་མ་ལགས་པས་། དེ་ནི་།
 naiṣa saṃkrāmati na viṣaṃkrāmati |	མི་འཕོ་ལ་འཕོ་བ་དང་བྲལ་བ་ཡང་མ་ལགས་ཏེ་། དེའི་སླད་དུ་ཚོགས་འདི་ནི་།
 tenaiṣa kāyo 'satkāya ||	འཇིག་ཚོགས་མ་ལགས་སོ་༎
 atha khalvāyuṣmān śāradvatīputro bhagavantametadavocat - niyatāste bhagavan bodhisattvā mahāsattvā bhaviṣyanti bodhaye,	དེ་ནས་བཅོམ་ལྡན་འདས་ལ་ཚེ་དང་ལྡན་པ་ཤའ་རདབ༹་ཏིའི་བུས་འདི་སྐད་ཅེས་གསོལ་ཏོ་༎ བཅོམ་ལྡན་འདས་།
 ye imaṃ prajñāpāramitānirdeśaṃ śrutvā adhimokṣyante notrasiṣyanti na saṃtrasiṣyanti saṃtrāsamāpatsyante ||	བྱང་ཆུབ་སེམས་དཔའ་སེམས་དཔའ་ཆེན་པོ་གང་དག་ཤེས་རབ་ཀྱི་ཕ་རོལ་ཏུ་ཕྱིན་པ་བསྟན་པ་འདི་ཐོས་ནས་མོས་ཏེ་མི་སྐྲག་། མི་དངང་། དངང་བར་མི་འགྱུར་བ་དེ་དག་ནི་།
 atha khalu maitreyo bodhisattvo mahāsattvo bhagavantametadavocat - āsannībhūtāste bhagavan bodhisattvā mahāsattvā bhaviṣyanti bodhaye,	བྱང་ཆུབ་ཏུ་ངེས་པར་འགྱུར་བ་ལགས་སོ་༎ དེ་ནས་བཅོམ་ལྡན་འདས་ལ་བྱང་ཆུབ་སེམས་དཔའ་སེམས་དཔའ་ཆེན་པོ་བྱམས་པས་འདི་སྐད་ཅེས་གསོལ་ཏོ་༎ བཅོམ་ལྡན་འདས་།
 ye imaṃ prajñāpāramitānirdeśaṃ śrutvā adhimokṣyante,	བྱང་ཆུབ་སེམས་དཔའ་སེམས་དཔའ་ཆེན་པོ་གང་དག་ཤེས་རབ་ཀྱི་ཕ་རོལ་ཏུ་ཕྱིན་པ་བསྟན་པ་འདི་ཐོས་ནས་མོས་ཏེ་མི་སྐྲག་།
 notrasiṣyanti na saṃtrasiṣyanti na saṃtrāsamāpatsyante |	མི་དངང་། དངང་བར་མི་འགྱུར་བ་དེ་དག་ནི་། བྱང་ཆུབ་ལ་ཉེ་བར་གྱུར་པ་ལགས་སོ་༎
 tatkasmāddhetoḥ?	དེ་ཅིའི་སླད་དུ་ཞེ་ན་། བཅོམ་ལྡན་འདས་།
 eṣaiva bhagavan paramā bodhiḥ, yaiṣāṃ dharmāṇāmanubodhanā ||	གང་ཆོས་དེ་དག་རྗེས་སུ་རྟོགས་པ་དེ་ཉིད་བྱང་ཆུབ་མཆོག་ལགས་པའི་སླད་དུའོ་༎
 atha khalu mañjuśrīḥ kumārabhūto bhagavantametadavocat - buddhā eva te bhagavan bodhisattvā mahāsattvā draṣṭavyāḥ,	དེ་ནས་བཅོམ་ལྡན་འདས་ལ་འཇམ་དཔལ་གཞོན་ནུར་གྱུར་བས་འདི་སྐད་ཅེས་གསོལ་ཏོ་༎ བཅོམ་ལྡན་འདས་།
 ye imaṃ prajñāpāramitānirdeśaṃ śrutvā adhimokṣyante,	༄༡༣༣ཨ་༌༎ བྱང་ཆུབ་སེམས་དཔའ་སེམས་དཔའ་ཆེན་པོ་གང་དག་ཤེས་རབ་ཀྱི་ཕ་རོལ་ཏུ་ཕྱིན་པ་བསྟན་པ་འདི་ཐོས་ནས་མོས་ཏེ་མི་སྐྲག་།
 notrasiṣyanti na saṃtrasiṣyanti na saṃtrāsamāpatsyante |	མི་དངང་། དངང་བར་མི་འགྱུར་བ་དེ་དག་ནི༏་སངས་རྒྱས་ཉིད་དུ་བལྟ་བར་བགྱིའོ་༎
 tatkasmāddhetoḥ?	དེ་ཅིའི་སླད་དུ་ཞེ་ན་། བཅོམ་ལྡན་འདས་།
 buddha iti paramārthato 'nutpādasyaitadadhivacanam ||	སངས་རྒྱས་ཞེས་བགྱི་བ་དེ་ནི་། དོན་དམ་པར་ན་སྐྱེ་བ་མ་མཆིས་པའི་ཚིག་བླ་དབ༹གས་ལགས་པའི་སླད་དུའོ་༎
 atha khalu nirālambā bhaginī bhagavantametadavocat - na te bhagavan bodhisattvā mahāsattvāḥ pṛthagjanadharmān śrāvakadharmān pratyekabuddhadharmān samyaksaṃbuddhadharmānadhyāmbiṣyante,	དེ་ནས་བཅོམ་ལྡན་འདས་ལ་སྲིང་མོ་དམིགས་པ་མེད་པས་འདི་སྐད་ཅེས་གསོལ་ཏོ་༎ བཅོམ་ལྡན་འདས་།
 ye imaṃ prajñāpāramitānirdeśaṃ śrutvā adhimokṣyante,	བྱང་ཆུབ་སེམས་དཔའ་སེམས་དཔའ་ཆེན་པོ་གང་དག་ཤེས་རབ་ཀྱི་ཕ་རོལ་ཏུ་ཕྱིན་པ་ཐོས་ནས་མོས་ཏེ་མི་སྐྲག་།
 notrasiṣyanti na saṃtrasiṣyanti na saṃtrāsamāpatsyante | tatkasmāddhetoḥ?	མི་དངང་། དངང་བར་མི་འགྱུར་བ་དེ་དག་ནི་། སོ་སོའི་སྐྱེ་བོའི་ཆོས་རྣམས་དང་། ཉན་ཐོས་ཀྱི་ཆོས་རྣམས་དང་། རང་སངས་རྒྱས་ཀྱི་ཆོས་རྣམས་དང་། ཡང་དག་པར་རྫོགས་པའི་སངས་རྒྱས་ཀྱི་ཆོས་རྣམས་ལ་ལྷག་པར་དམིགས་པར་མི་འགྱུར་བ་ལགས་སོ་༎ དེ་ཅིའི་སླད་དུ་ཞེ་ན་། བཅོམ་ལྡན་འདས་།
 tathā hi bhagavan nirālambāḥ sarvadharmā asaṃvidyamānatvāt |	འདི་ལྟར་། ཆོས་ཐམས་ཅད་ནི་། མ་མཆིས་པའི་སླད་དུ་མི་དམིགས་པ་སྟེ་།
 tenaiṣāmālambanaṃ na saṃvidyate ||	དེའི་སླད་དུ་དེ་དག་ལ་དམིགས་པ་མ་མཆིས་སོ་༎
 atha khalu bhagavānāyuṣmantaṃ śāradvatīputramāmantrayate sma - evametacchāradvatīputra, evametat |	དེ་ནས་བཅོམ་ལྡན་འདས་ཀྱིས་ཚེ་དང་ལྡན་པ་ཤའ་རདབ༹་ཏིའི་བུ་ལ་བཀའ་སྩལ་པ༏་དེ་དེ་བཞིན་ནོ་༎ ཤའ་རདབ༹་ཏིའི་བུ་དེ་དེ་བཞིན་ཏེ་།
 niyatāste kulaputrāḥ kuladuhitaraśca bhaviṣyanti bodhaye, ye imaṃ prajñāpāramitānirdeśaṃ śrutvā adhimokṣyante,	རིགས་ཀྱི་བུ་དང་། རིགས་ཀྱི་བུ་མོ་གང་དག་ཤེས་རབ་ཀྱི་ཕ་རོལ་ཏུ་ཕྱིན་པ་ཟབ་མོ་བསྟན་པ་འདི་ཐོས་ནས་མོས་ཏེ་མི་སྐྲག་།
 nottrasanti na saṃtrasanti na saṃtrāsamāpatsyante |	མི་དངང་། ༄༡༣༣བ་དངང་བར་མི་འགྱུར་བ་དེ་དག་ནི་།
 avinivartanīyabhūmau tvaṃ (saptaś, vaidya 346)	བྱང་ཆུབ་ཏུ་ངེས་པར་འགྱུར་རོ་༎ ཤའ་རདབ༹་ཏིའི་བུ་།
 śāradvatīputra pratiṣṭhitāṃstān kulaputrān kuladuhitaraśca jānīṣva, ye imaṃ prajñāpāramitānirdeśaṃ śrutvā adhimokṣyante,	རིགས་ཀྱི་བུ་དང་། རིགས་ཀྱི་བུ་མོ་གང་དག་ཤེས་རབ་ཀྱི་ཕ་རོལ་ཏུ་ཕྱིན་པ་ཟབ་མོ་བསྟན་པ་འདི་ཐོས་ནས་མོས་ཏེ་མི་སྐྲག་།
 nottrasiṣyanti na saṃtrasiṣyanti na saṃtrāsamāpatsyante,	མི་དངང་། དངང་བར་མི་འགྱུར་ཞིང་། སྤྱི་བོས་ལེན་པ་དེ་དག་ནི་། ཕྱིར་མི་ལྡོག་པའི་ས་ལ་གནས་པ་ཡིན་པར་ཁྱོད་ཀྱིས་ཤེས་པར་གྱིས་ཤིག་། ཤའ་རདབ༹་ཏིའི་བུ་། གང་དག་ཤེས་རབ་ཀྱི་ཕ་རོལ་ཏུ་ཕྱིན་པ་བསྟན་པ་འདི་ཐོས་ནས་མོས་ཏེ་མི་སྐྲག་། མི་དངང་།
 mūrdhnā ca pratigrahīṣyanti | te te śāradvatīputra paramadānapatayo bhaviṣyanti mahādānapatayo viśiṣṭadānapatayaḥ |	དངང་བར་མི་འགྱུར་བ་དེ་དང་དེ་དག་ནི་། སྦྱིན་བདག་དམ་པར་འགྱུར་བ་། སྦྱིན་བདག་ཆེན་པོར་འགྱུར་། སྤྱིན་བདག་ཁྱད་པར་དུ་འཕགས་པར་འགྱུར་རོ་༎ ཤའ་རདབ༹་ཏིའི་བུ་།
 te te śāradvatīputra śīlasaṃpannā bhaviṣyanti paramaśīlavantaḥ paramaviśiṣṭaśīlaguṇapathaprāptāḥ,	དེ་དང་དེ་དག་ནི་། ཚུལ་ཁྲིམས་ཕུན་སུམ་ཚོགས་པར་འགྱུར་། ཚུལ་ཁྲིམས་དང་ལྡན་པའི་མཆོག་ཏུ་འགྱུར་། ཚུལ་ཁྲིམས་དང་ལྡན་པའི་ཁྱད་པར་དུ་འཕགས་པར་འགྱུར་། ཚུལ་ཁྲིམས་ཀྱི་ཡོན་ཏན་གྱི་ལམ་རྙེད་པར་འགྱུར་རོ་༎ ཤའ་རདབ༹་ཏིའི་བུ་།
 ye imaṃ prajñāpāramitānirdeśaṃ śrutvā adhimokṣyante,	གང་དག་ཤེས་རབ་ཀྱི་ཕ་རོལ་ཏུ་ཕྱིན་པ་བསྟན་པ་འདི་ཐོས་ནས་མོས་ཏེ་མི་སྐྲག་།
 nottrasiṣyanti na saṃtrasiṣyanti na saṃtrāsamāpatsyante | te te śāradvatīputra paramayā kṣāntyā,	མི་དངང་། དངང་བར་མི་འགྱུར་བ་དེ་དང་དེ་དག་ནི་།
 parameṇa vīryeṇa, paramairdhyānaiḥ, paramayā apratisamayā prajñayā samanvāgatā bhaviṣyanti |	བཟོད་པའི་མཆོག་དང་། བརྩོན་འགྲུས་ཀྱི་མཆོག་དང་། བསམ་གཏན་གྱི་མཆོག་དང་། མཚུངས་པ་མེད་པའི་ཤེས་རབ་ཀྱི་མཆོག་དང་ལྡན་པར་འགྱུར་རོ་༎ ཤའ་རདབ༹་ཏིའི་བུ་།
 te te śāradvatīputra bodhisattvā mahāsattvā yāvat sarvakāravaropetena sarvajñajñānena samanvāgatā bhaviṣyanti, ye imaṃ prajñāpāramitānirdeśaṃ śrutvā adhimokṣyante,	བྱང་ཆུབ་སེམས་དཔའ་སེམས་དཔའ་ཆེན་པོ་གང་དག་ཤེས་རབ་ཀྱི་ཕ་རོལ་ཏུ་ཕྱིན་པ་བསྟན་པ་འདི་ཐོས་ཏེ་མི་སྐྲག་།
 notrasiṣyanti na saṃtrasiṣyanti na saṃtrāsamāpatsyante ||	མི་དངང་། དངང་བར་༄༡༣༤ཨ་༌༎ མི་འགྱུར་བ་དེ་དག་ནི་། རྣམ་པ་ཐམས་ཅད་ཀྱི་མཆོག་དང་ལྡན་པའི་ཐམས་ཅད་མཁྱེན་པའི་ཡེ་ཤེས་དང་ལྡན་པའི་བར་དུ་འགྱུར་རོ་༎ 
 punaraparaṃ bhagavan mañjuśriyaṃ kumārabhūmetadavocat - kaṃ punastvaṃ mañjuśrīḥ arthavaśaṃ saṃpaśyan icchasyanuttarāṃ samyaksaṃbodhimabhisaṃboddhum?	བཅོམ་ལྡན་འདས་ཀྱིས་འཇམ་དཔལ་གཞོན་ནུར་གྱུར་པ་ལ་གཞན་ཡང་འདི་སྐད་ཅེས་བཀའ་འགྱུར་རོ་༎ སྩལ་ཏོ་༎ འཇམ་དཔལ་། ཁྱོད་ཀྱིས་དོན་གྱི་དབང་ཅི་ཞིག་མཐོང་ན་། བླ་ན་མེད་པ་ཡང་དག་པར་རྫོགས་པའི་བྱང་ཆུབ་མངོན་པར་རྫོགས་པར་འཚང་རྒྱ་བར་མི་འདོད་། འཇམ་དཔལ་གྱིས་གསོལ་པ་།
 mañjuśrīrāha - sacedahaṃ bhagavan bodhaye saṃpratiṣṭheyam,	བཅོམ་ལྡན་འདས་། གལ་ཏེ་བདག་བྱང་ཆུབ་ཏུ་ཞུགས་ན་ནི་།
 evamahamiccheyamabhisaṃboddhum |	དེ་ལྟར་ན་། བདག་མངོན་པར་རྫོགས་པར་འཚང་རྒྱ་བར་ཡང་འཚལ་ན་། བཅོམ་ལྡན་འདས་།
 nāhaṃ bhagavan bodhiṃ prārthayāmi |	བདག་ནི་། བྱང་ཆུབ་ཏུ་སྨོན་པ་མ་ལགས་སོ་༎
 tatkasmāddhetoḥ?	དེ་ཅིའི་སླད་དུ་ཞེ་ན་།
 bodhirevaiṣa yo 'yaṃ mañjuśrīḥ kumārabhūtaḥ ||	འཇམ་དཔལ་གཞོན་ནུར་གྱུར་པ་གང་ལགས་པ་དེ་བྱང་ཆུབ་ཉིད་དོ་༎
 evamukte bhagavān mañjuśriyaṃ kumārabhūtametadavocat - sādhu sādhu mañjuśrīḥ,	དེ་སྐད་ཅེས་གསོལ་པ་དང་། བཅོམ་ལྡན་འདས་ཀྱིས་འཇམ་དཔལ་གཞོན་ནུར་གྱུར་པ་ལ་འདི་སྐད་ཅེས་བཀའ་སྩལ་ཏོ་༎ འཇམ་དཔལ་།
 yastvamimānyevaṃrūpāṇi gambhīrāṇi gambhīrāṇi sthānāni nirdiśasi |	ཁྱོད་ཟབ་མོ་ཟབ་པའི་གནས་འདི་ལྟ་བུ་འདི་སྟོན་པ་ལེགས་སོ་༎ ལེགས་སོ་༎ འདི་ལྟར་། ཁྱོད་ནི་།
 yathāpi tvaṃ pūrvajinakṛtādhikāro 'nupalambhaciracaritabrahmacaryaḥ |	སྔོན་གྱི་རྒྱལ་བ་ལ་བྱ་བ་བྱས་པ་སྟེ་། མི་དམིགས་པར་ཚངས་པར་སྤྱོད་པ་ཡུན་རིང་དུ་སྤྱོད་པའོ་༎
 mañjuśrīrāha - labdha eva bhagavan dharmaḥ syāt,	འཇམ་དཔལ་གྱིས་གསོལ་པ་། བཅོམ་ལྡན་འདས་།
 yadyahamanupalambhacārī syām ||	གལ་ཏེ་བདག་མི་དམིགས་པར་སྤྱོད་པ་ལགས་ན་ནི་། ཆོས་ཐོབ་པ་ཉིད་དུ་འགྱུར་བ་ལགས་སོ་༎
 evamukte bhagavān mañjuśriyaṃ kumārabhūtametadavocat - paśyasi tvaṃ mañjuśrīrimāṃ mama śrāvakasaṃpadam?	དེ་སྐད་ཅེས་གསོལ་པ་དང་། ༄༡༣༤བ་བཅོམ་ལྡན་འདས་ཀྱིས་འཇམ་དཔལ་གཞོན་ནུར་གྱུར་པ་ལ་འདི་སྐད་ཅེས་བཀའ་སྩལ་ཏོ་༎ འཇམ་དཔལ་། ཁྱོད་ཀྱིས་ངའི་ཉན་ཐོས་ཕུན་སུམ་ཚོགས་པ་འདི་དག་མཐོང་ངམ་།
 mañjuśrīrāha paśyāmi bhagavan |	འཇམ་དཔལ་གྱིས་གསོལ་པ་། བཅོམ་ལྡན་འདས་། མཐོང་ལགས་སོ་༎
 bhagavānāha - kathaṃ paśyasi?	བཅོམ་ལྡན་འདས་ཀྱིས་བཀའ་སྩལ་པ་། ཇི་ལྟར་ཅི་འདྲ་བར་མཐོང་། འཇམ་དཔལ་གྱིས་གསོལ་པ་།
 mañjuśrīrāha - tathāhaṃ bhagavan paśyāmi yathā naiva pṛthagjanāna paśyāmi,	བཅོམ་ལྡན་འདས་།
 naiva śaikṣān paśyāmi, naivāśaikṣān paśyāmi | nāpi paśyāmi,	ཇི་ལྟར་སོ་སོའི་སྐྱེ་བོར་མི་མཐོང་བ་དང་། སློབ་པར་མི་མཐོང་བ་དང་། མི་སློབ་པར་མི་མཐོང་བ་དང་། མཐོང་བ་ཡང་མ་མཆིས་།
 nāpi naiva paśyāmi, evaṃ paśyāmi | yannaiva bahūn paśyāmi,	མ་མཐོང་བ་ཡང་མ་མཆིས་པ་དེ་ལྟར་མཐོང་ངོ་༎
 nāpyalpakān paśyāmi | yannaiva vinītān paśyāmi, nāpyavinītān paśyāmi ||	འདི་ལྟར་མང་དུ་ཡང་མི་མཐོང་བ་དང་། ཉུང་དུ་ཡང་མི་མཐོང་བ་དང་། དུལ་བར་ཡང་མི་མཐོང་བ་དང་། མ་དུལ་བར་ཡང་མི་མཐོང་བ་དེ་ལྟར་མཐོང་ངོ་༎
 atha khalvāyuṣmān śāradvatīputro mañjuśriyaṃ kumārabhūtametadavocat - yastvaṃ mañjuśrīḥ śrāvakayānikānevaṃ paśyasi,	དེ་ནས་ཚེ་དང་ལྡན་པ་ཤའ་རདབ༹་ཏིའི་བུས་འཇམ་དཔལ་གཞོན་ནུར་གྱུར་པ་ལ་འདི་སྐད་ཅེས་སྨྲས་སོ་༎ འཇམ་དཔལ་། ཁྱོད་ཀྱིས་ཉན་ཐོས་ཀྱི་ཐེག་པ་པ་རྣམས་དེ་ལྟར་མཐོང་ན་།
 samyaksaṃbuddhayānikān punastvaṃ kathaṃ paśyasi?	ཡང་དག་པར་རྫོགས་པའི་སངས་རྒྱས་ཀྱི་ཐེག་པ་པ་རྣམས་ཁྱོད་ཀྱིས་ཇི་ལྟར་མཐོང་།
 mañjuśrīrāha - bodhisattva iti bhadanta śāradvatīputra nāma dharmaṃ na samanupaśyāmi,	འཇམ་དཔལ་གྱིས་སྨྲས་པ་། བཙུན་པ་ཤའ་རདབ༹་ཏིའི་བུ་། བྱང་ཆུབ་སེམས་དཔའ་ཞེས་བྱ་བའི་ཆོས་ཀྱང་རྗེས་སུ་མི་མཐོང་།
 bodhāya saṃprasthita iti nāma dharmaṃ na samanupaśyāmi |	བྱང་ཆུབ་ཏུ་ཞུགས་པ་ཞེས་བྱ་བའི་ཆོས་ཀྱང་རྗེས་སུ་མི་མཐོང་།
 bodhāya caratīti nāma dharmaṃ na samanupaśyāmi |	བྱང་ཆུབ་ཀྱི་ཕྱིར་སྤྱོད་དོ་༎ ཞེས་བྱ་བའི་ཆོས་ཀྱང་རྗེས་སུ་མི་མཐོང་།
 abhisaṃbudhyata iti nāma dharmaṃ na samanupaśyāmi |	མངོན་པར་རྫོགས་པར་སངས་རྒྱས་ཞེས་བྱ་བའི་ཆོས་ཀྱང་རྗེས་སུ་མི་མཐོང་བ་སྟེ་།
 evaṃ bhadanta śāradvatīputra samyaksaṃbuddhayānikān paśyāmi |	བཙུན་པ་ཤའ་རདབ༹་ཏིའི་བུ་། ཡང་དག་པར་རྫོགས་༄༡༣༥ཨ་༌༎ པའི་སངས་རྒྱས་ཀྱི་ཐེག་པ་པ་དག་དེ་ལྟར་མཐོང་ངོ་༎
 śāradvatīputra āha - tathāgataṃ punastvaṃ mañjuśrīḥ kathaṃ paśyasi?	ཤའ་རདབ༹་ཏིའི་བུས་སྨྲས་པ་། འཇམ་དཔལ་། ཁྱོད་ཀྱིས་དེ་བཞིན་གཤེགས་པ་ཇི་ལྟར་མཐོང་།
 mañjuśrīrāha - tiṣṭhatu bhadanta śāradvatīputra mahānāgaḥ |	འཇམ་དཔལ་གྱིས་སྨྲས་པ༏་བཙུན་པ་ཤའ་རདབ༹་ཏིའི་བུ་། གླང་པོ་ཆེན་པོ་ཞོག་ཅིག་།
 mā mahānāgaṃ ghaṭṭaya ||	གླང་པོ་ཆེན་པོ་མ་བསྐྱོད་ཅིག་།
 evamukte āyuṣmān śāradvatīputro mañjuśriyaṃ kumārabhūtametadavocat - buddha iti mañjuśrīḥ kasyaitadadhivacanam?	དེ་སྐད་ཅེས་སྨྲས་པ་དང་། ཚེ་དང་ལྡན་པ་ཤའ་རདབ༹་ཏིའི་བུས་འཇམ་དཔལ་གཞོན་ནུར་གྱུར་པ་ལ་འདི་སྐད་ཅེས་སྨྲས་སོ་༎ འཇམ་དཔལ་། སངས་རྒྱས་ཞེས་བྱ་བ་དེ་གང་གི་ཚིག་བླ་དབ༹གས་།
 mañjuśrīrāha - yatpunarbhadanta śāradvatīputra ucyate ātmeti,	འཇམ་དཔལ་གྱིས་སྨྲས་པ་། བཙུན་པ་ཤའ་རདབ༹་ཏིའི་བུ་།
 kasyaitadadhivacanam?	བདག་ཅེས་བྱ་བ་དེ་གང་གི་ཚིག་བླ་དབ༹གས་། ཤའ་རདབ༹་ཏིའི་བུས་སྨྲས་པ་། འཇམ་དཔལ་།
 śāradvatīputra āha - anutpādasyaitanmañjuśrīradhivacanaṃ yaduta ātmeti |	འདི་ལྟ་སྟེ་། བདག་ཅེས་བྱ་བ་དེ་ནི་། སྐྱེ་བ་མེད་པའི་ཚིག་བླ་དབ༹གས་སོ་༎
 mañjuśrīrāha - (saptaś, vaidya 347)	འཇམ་དཔལ་གྱིས་སྨྲས་པ་།
 evametadbhadanta śāradvatīputra yasyaitadadhivacanamātmeti,	བཙུན་པ་ཤའ་རདབ༹་ཏིའི་བུ་། དེ་དེ་བཞིན་ཏེ་། བདག་ཅེས་བྱ་བ་དེ་གང་གི་ཚིག་བླ་དབ༹གས་ཡིན་པ་སངས་རྒྱས་ཞེས་བྱ་བ་དེ་ཡང་དེའི་ཚིག་བླ་དབ༹གས་སོ་༎ བཙུན་པ་ཤའ་རདབ༹་ཏིའི་བུ་། ཡང་འདི་ལྟ་སྟེ་།
 tasyaitadadhivacanaṃ buddha iti |	སངས་རྒྱས་ཞེས་བྱ་བ་དེ་ནི་། གཞི་མེད་བའི་ཚིག་བླ་དབ༹གས་སོ་༎
 api tu bhadanta śāradvatīputra apadādhivacanametad yadidamucyate buddha iti |	བཙུན་པ་ཤའ་རདབ༹་ཏིའི་བུ་། སངས་རྒྱས་ཞེས་བྱ་བ་དེ་ནི་། ཚིག་གིས་ཤེས་པར་བྱ་བར་དཀའ་བའོ་༎
 na hyetadbhadanta śāradvatīputra vācābhirvijñāpayituṃ buddha iti | vāgapi bhadanta śāradvatīputra na sukarā nirūpayitum - iyaṃ vāgiti,	བཙུན་བ་ཤའ་རདབ༹་ཏིའི་བུ་། ཚིག་ཀྱང་འདི་ནི་། ཚིག་གོ་། ཞེས་བརྟག་པར་དཀའ་ན་།
 kutaḥ punarbuddha iti |	སངས་རྒྱས་ཞེས་བྱ་བ་ལྟ་ཅི་སྨོས་།
 api tu bhadanta śāradvatīputra yadevaṃ vadasi - kasyaitadadhivacanaṃ buddha iti,	བཙུན་པ་ཤའ་རདབ༹་ཏིའི་བུ་། སངས་རྒྱས་ཞེས་བྱ་བ་དེ་གང་གི་ཚིག་བླ་དབ༹གས་ཞེས་དེ་སྐད་སྨྲས་བ་ནི་།
 yo na samudāgato notpanno na nirotsyate,	གང་ཡང་དག་པར་མ་གྲུབ་པ་༄༡༣༥བ་དང་། མ་སྐྱེས་པ་དང་། མི་འགག་པ་སྟེ་།
 yo na kenaciddharmeṇa samanvāgato nāpyatra kiṃcitpadamabhedam,	གང་ཆོས་གང་དང་ཡང་མི་ལྡན་པ་དེ་ལ་གཞི་ཅི་ཡང་མེད་ཅིང་། གཞི་དབྱེར་མེད་ལ་གཞི་མེད་པ་སྟེ་། བཙུན་པ་ཤའ་རདབ༹་ཏིའི་བུ་། འདི་ལྟ་སྟེ་།
 apadasyaitadbhadanta śāradvatīputra adhivacanaṃ yaduta buddha iti |	སངས་རྒྱས་ཞེས་བྱ་བ་དེ་ནི་། དེའི་ཚིག་བླ་དབ༹གས་སོ་༎ བཙུན་པ་ཤའ་རདབ༹་ཏིའི་བུ་།
 tathāgataṃ bhadanta śāradvatīputra paryeṣitukāmena ātmā paryeṣitavyaḥ |	དེ་བཞིན་གཤེགས་པ་ཚོལ་བར་འདོད་པས་ནི་། བདག་བཙལ་བར་བྱའོ་༎
 ātmeti bhadanta śāradvatīputra buddhasyaitadadhivacanam |	བཙུན་པ་ཤའ་རདབ༹་ཏིའི་བུ་། བདག་ཅེས་བྱ་བ་དེ་ནི་། སངས་རྒྱས་ཀྱི་ཚིག་བླ་དབ༹གས་ཏེ་།
 yathā ātmā atyantatayā na saṃvidyate nopalabhyate, tathā buddho 'pyatyantatayā na saṃvidyate nopalabhyate | yathā ātmā na kenaciddharmeṇa vacanīyaḥ,	ཇི་ལྟར་བདག་ཅེས་བྱ་བ་ཤིན་ཏུ་མེད་ཅིང་མི་དམིགས་པ་དེ་བཞིན་དུ་སངས་རྒྱས་ཀྱང་ཤིན་ཏུ་མེད་ཅིང་མི་དམིགས་སོ་༎
 tathā buddho 'pi na kenaciddharmeṇa vacanīyaḥ |	ཇི་ལྟར་བདག་ཅེས་བྱ་བའི་ཆོས་གང་གིས་ཀྱང་ཚིག་ཏུ་བརྗོད་པ་མ་ཡིན་པ་དེ་བཞིན་དུ་སངས་རྒྱས་ཀྱི་ཆོས་གང་གིས་ཀྱང་ཚིག་ཏུ་བརྗོད་པ་མ་ཡིན་ནོ་༎
 yatra na kācitsaṃkhyā,	གང་ལ་གྲངས་སུ་བྱ་བ་མེད་པ་དེ་ནི་།
 sa ucyate buddha iti |	སངས་རྒྱས་ཞེས་བྱ་སྟེ་།
 na caitadbhadanta śāradvatīputra sukaramājñātumātmeti yadadhivacanam,	བཙུན་པ་ཤའ་རདབ༹་ཏིའི་བུ་། བདག་ཅེས་བྱ་བའི་གཞིའི་ཚིག་བླ་དབ༹གས་དེ་ནི་། ཤེས་པར་སླ་བ་མ་ཡིན་ནོ་༎
 evametadbhadanta śāradvatīputra na sukaramājñātuṃ buddha iti yadadhivacanam ||	བཙུན་པ་ཤའ་རདབ༹་ཏིའི་བུ་། དེ་བཞིན་དུ་སངས་རྒྱས་ཞེས་བྱ་བའི་གཞིའི་ཚིག་བླ་དབ༹གས་འདི་ཡང་ཤེས་པར་སླ་བ་མ་ཡིན་ནོ་༎ 
 atha khalvāyuṣmān śāradvatīputro bhagavantametadavocat - nāyaṃ bhagavan mañjuśrīḥ kumārabhūtastathā deśayati yathā ādikarmikā bodhisattvā ājānīyuḥ	དེ་ནས་བཅོམ་ལྡན་འདས་ལ་ཚེ་དང་ལྡན་པ་ཤའ་རདབ༹་ཏིའི་བུས་འདི་སྐད་ཅེས་གསོལ་ནོ་༎ ཏོ་༎ བཅོམ་ལྡན་འདས་། འཇམ་དཔལ་གཞོན་ནུར་གྱུར་པ་འདི་ནི་།
 evamukte mañjuśrīḥ kumārabhūtaḥ āyuṣmantaṃ śāradvatīputrametadavocat - nāhaṃ bhadanta śāradvatīputra tathā deśayāmi yathā kṛtāvino 'pyarhanta ājñāsyanti |	ཇི་ལྟར་ལས་དང་པོ་པས་འཚལ་བར་འགྱུར་བ་དེ་ལྟ་བུ་མི་སྟོན་ཏོ་༎ དེ་སྐད་ཅེས་གསོལ་པ་དང་། འཇམ་དཔལ་གཞོན་ནུར་གྱུར་པས་ཚེ་དང་ལྡན་པ་ཤའ་རདབ༹་ཏིའི་བུ་ལ་འདི་སྐད་ཅེས་སྨྲས་སོ་༎ བཙུན་པ་ཤའ་རདབ༹་ཏིའི་བུ་། ཁོ་བོ་ནི་། ཇི་ལྟར་དགྲ་༄༡༣༦ཨ་༌༎ བཅོམ་པ་བྱས་པ་རྟོགས་པ་ཅན་གྱིས་ཀྱང་ཤེས་པར་འགྱུར་བ་དེ་ལྟ་བུའི་ཆོས་མི་སྟོན་ཏོ་༎ ཁོ་བོ་ནི་།
 nāpyahaṃ tathā deśayāmi yathā kaścidvijñāsyati |	ཇི་ལྟར་སུས་ཀྱང་ཤེས་པར་འགྱུར་བ་དེ་ལྟ་བུར་ཡང་མི་སྟོན་ཏོ་༎
 tatkasmāddhetoḥ?	དེ་ཅིའི་ཕྱིར་ཞེ་ན་། བྱང་ཆུབ་ནི་། སུས་ཀྱང་མ་ཤེས་།
 na bodhiḥ kenacidvijñātā,	སུས་ཀྱང་རྣམ་པར་མ་ཤེས་།
 nāpi saṃbuddhā,	སུས་ཀྱང་མངོན་པར་རྫོགས་པར་མ་རྟོགས་།
 na dṛṣṭā,	མ་མཐོང་།
 na śrutā,	མ་ཐོས་།
 na smṛtā,	མ་དྲན་།
 notpāditā,	མ་སྐྱེས་།
 na nirodhitā,	མ་འགག་།
 noddiṣṭā, nopadeśitā |	མ་སྨྲས༏་མ་བསྟན་པའི་ཕྱིར་རོ་༎
 etāvadeva bhadanta śāradvatīputra yāvatā bodhiḥ |	བཙུན་པ་ཤའ་རདབ༹་ཏིའི་བུ་། བྱང་ཆུབ་དེ་ལྟ་བུ་སྟེ་།
 sā ca bodhirna bhāvo nāpyabhāvaḥ |	བྱང་ཆུབ་དེའང་དངོས་པོ་མ་ཡིན་ནོ་༎
 tatkasmāddhetoḥ?	དེ་ཅིའི་ཕྱིར་ཞེ་ན་།
 na bodhyā kiṃcidabhisaṃboddhavyam,	བྱང་ཆུབ་ཀྱིས་མངོན་པར་རྫོགས་པར་འཚང་རྒྱ་བར་བྱ་བ་ཅི་ཡང་མེད་ཅིང་།
 nāpi bodhirbodhimabhisaṃbudhyate ||	བྱང་ཆུབ་ཀྱང་བྱང་ཆུབ་ཀྱིས་མངོན་པར་རྫོགས་པར་འཚང་རྒྱ་བ་མ་ཡིན་པའི་ཕྱིར་རོ་༎
 śāradvatīputra āha - na mañjuśrīrbhagavatā dharmadhāturabhisaṃbuddhaḥ?	ཤའ་རདབ༹་ཏིའི་བུས་སྨྲས་པ་། འཇམ་དཔལ་། བཅོམ་ལྡན་འདས་ཀྱིས་ཆོས་ཀྱི་དབྱིངས་མངོན་པར་རྫོགས་པར་སངས་མ་རྒྱས་སམ་།
 mañjuśrīrāha - na bhadanta śāradvatīputra bhagavatā dharmadhāturabhisaṃbuddhaḥ |	འཇམ་དཔལ་གྱིས་སྨྲས་པ་། བཙུན་པ་ཤའ་རདབ༹་ཏིའི་བུ་།
 tatkasmāddhetoḥ?	དེ་ནི་། མ་ཡིན་ནོ་༎ དེ་ཅིའི་ཕྱིར་ཞེ་ན་།
 tathā hi bhadanta śāradvatīputra dharmadhātureva bhagavān |	བཙུན་པ་ཤའ་རདབ༹་ཏིའི་བུ་། འདི་ལྟར་། ཆོས་ཀྱི་དབྱིངས་ཉིད་བཅོམ་ལྡན་འདས་ཡིན་པའི་ཕྱིར་རོ་༎
 sacedbhadanta śāradvatīputra bhagavatā dharmadhāturabhisaṃbuddhaḥ syāt,	བཙུན་པ་ཤའ་རདབ༹་ཏིའི་བུ་། གལ་ཏེ་བཅོམ་ལྡན་འདས་ཀྱིས་ཆོས་ཀྱི་དབྱིངས་མངོན་པར་རྫོགས་པར་སངས་རྒྱས་པར་གྱུར་ན་།
 tadyo 'sāvanutpādadhātuḥ sa nirudhyo bhavet |	འོ་ན་ནི་གང་སྐྱེ་བ་མེད་པའི་དབྱིངས་དེ་དང་ཡང་འགལ་བར་འགྱུར་རོ་༎
 api tu bhadanta śāradvatīputra sa eva dharmadhāturbodhiḥ |	བཙུན་པ་ཤའ་རདབ༹་ཏིའི་བུ་། ཆོས་ཀྱི་དབྱིངས་དེ་ཉིད་བྱང་ཆུབ་བོ་༎
 tatkasmāddhetoḥ?	དེ་ཅིའི་ཕྱིར་ཞེ་ན་།
 niḥsattvo hi dharmadhātuḥ |	ཆོས་ཀྱི་དབྱིངས་ནི་།
 abhāvāḥ sarvadharmā iti bodheradhivacanametat,	སེམས་ཅན་མེད་པའི་ཕྱིར་༄༡༣༦བ་རོ༏་༏ཆོས་ཐམས་ཅད་ངོ་བོ་ཉིད་མེད་པའོ་༎ ཞེས་བྱ་བ་དེ་ནི་། བྱང་ཆུབ་ཀྱི་ཚིག་བླ་དབ༹གས་ཏེ་། དེ་ནི་།
 yo 'sau dharmadhāturiti saṃkhyāṃ gacchati |	ཆོས་ཀྱི་དབྱིངས་ཀྱི་གྲངས་སུ་འགྲོ་བའོ་༎
 tatkasmāddhetoḥ?	དེ་ཅིའི་ཕྱིར་ཞེ་ན་།
 sarvadharmā hyanānātvaṃ buddhaviṣayataḥ |	ཆོས་ཐམས་ཅད་ནི་། སངས་རྒྱས་ཀྱི་ཡུལ་དུ་ཐ་དད་པ་མེད་པའི་ཕྱིར་རོ་༎
 anānātvamiti bhadanta śāradvatīputra avijñaptikaṃ padametat |	བཙུན་པ་ཤའ་རདབ༹་ཏིའི་བུ་། ཐ་དད་པ་མེད་ཅེས་བྱ་བ་དེ་ནི་། རྣམ་པར་རིག་པ་མེད་པའོ་༎ བཙུན་པ་ཤའ་རདབ༹་ཏིའི་བུ་།
 avijñaptikamiti bhadanta śāradvatīputra naitacchakyaṃ vijñāpayituṃ saṃskṛtatvena vā yāvad asaṃskṛtatvena vā |	རྣམ་པར་རིག་པ་མེད་པ་ཞེས་བྱ་བ་དེ་ནི་། རྣམ་པར་ཤེས་པར་མི་ནུས་པ་སྟེ་། འདུས་བྱས་སུ་རྣམ་པར་རིག་པར་མི་ནུས་པ་ནས་འདུས་མ་བྱས་ཀྱི་བར་དུའང་རྣམ་པར་རིག་པར་མི་ནུས་པ་སྟེ་།
 na tatra kācidvijñaptiḥ,	དེ་ལ་རྣམ་པར་རིག་པ་གང་ཡང་མེད་པས་།
 tena tadavijñaptikam |	དེས་ན་དེ་རྣམ་པར་རིག་པ་མེད་པའོ་༎
 sarvadharmā hi bhadanta śāradvatīputra avijñaptikāḥ |	བཙུན་པ་ཤའ་རདབ༹་ཏིའི་བུ་། ཆོས་ཐམས་ཅད་ནི་། རྣམ་པར་རིག་པར་མི་ནུས་པ་སྟེ་།
 tatkasmāddhetoḥ?	དེ་ཅིའི་ཕྱིར་ཞེ་ན་། འདི་ལྟར་། ཆོས་ཐམས་ཅད་ནི་།
 tathā hi sarvadharmāṇāṃ prādurbhāvo nāsti yasmin sthitvā vijñapyeran |	གང་ལ་གནས་ཏེ་། རྣམ་པར་རིག་པར་འགྱུར་བའི་སྐྱེ་བ་མེད་པའི་ཕྱིར་རོ་༎
 ye 'pyamī ānantaryaprasṛtā acintyaprasṛtāḥ, te |	གང་དག་མཚམས་མེད་ལ་ཞུགས་པ་དེ་དག་ནི་། བསམ་གྱིས་མི་ཁྱབ་པ་ལ་ཞུགས་པའོ་༎
 ye ca acintyaprasṛtā bhūtaprasṛtāste |	གང་དག་བསམ་གྱིས་མི་ཁྱབ་པ་ལ་ཞུགས་པ་དེ་དག་ནི་།
 tatkasmāddhetoḥ?	ཡང་དག་པ་ལ་ཞུགས་པའོ༏་༏དེ་ཅིའི་ཕྱིར་ཞེ་ན་།
 bhūtamiti bhadanta śāradvatīputra abhedapadametat |	བཙུན་པ་ཤའ་རདབ༹་ཏིའི་བུ་། ཡང་དག་པ་ཞེས་བྱ་བ་དེ་ནི་། གཞི་མེད་པའི་ཕྱིར་རོ་༎
 ye 'pi acintyadharmasamanvāgatāḥ, (saptaś, vaidya 348)	གང་དག་བསམ་གྱིས་མི་ཁྱབ་པ་དང་ལྡན་པ་དེ་དག་ནི་།
 naiva te svargagāminaḥ,	མཐོ་རིས་སུ་འགྲོ་བ་མ་ཡིན་།
 na apāyagāminaḥ,	ངན་སོང་དུ་འགྲོ་བ་མ་ཡིན་།
 na parinirvāṇagāminaḥ |	མྱ་ངན་ལས་འདས་པར་འགྲོ་བ་མ་ཡིན་ནོ་༎
 tatkasmāddhetoḥ?	དེ་ཅིའི་ཕྱིར་ཞེ་ན་། བསམ་གྱིས་མི་ཁྱད་པ་ནི་།
 na hi acintyaṃ gamanāgamanena pratyupasthitam,	འགྲོ་བ་དང་། མི་འགྲོ་བར་ཉེ་བར་གནས་པ་མ་ཡིན་པ་ནས་མྱ་ངན་ལས་འདས་པའི་༄༡༣༧ཨ་༌༎
 yāvat na parinirvāṇaṃ gamanāgamanena pratyupasthitam |	བར་དུ་འགྲོ་བ་དང་། མི་འགྲོ་བར་ཉེ་བར་གནས་པ་མ་ཡིན་པའི་ཕྱིར་རོ་༎
 ye 'pi bhadanta śāradvatīputra catasṛṣu mūlāpattiṣvavasthitāḥ, amūle te 'vasthitāḥ | tatkasmāddhetoḥ?	བཙུན་པ་ཤའ་རདབ༹་ཏིའི་བུ་། གང་དག་ལྟུང་བའི་རྩ་བ་བཞི་ལ་གནས་པ་དེ་དག་ཀྱང་རྩ་བ་མེད་པ་ལ་གནས་པའོ་༎ དེ་ཅིའི་ཕྱིར་ཞེ་ན་།
 na hi bhadanta śāradvatīputra anutpādasya mūlaṃ vā agraṃ vā iṣyate |	བཙུན་པ་ཤའ་རདབ༹་ཏིའི་བུ་། སྐྱེ་བ་མེད་པ་ལ་རྩ་བའམ་། རྩེ་མོ་ཞེས་བྱ་བ་མེད་པའི་ཕྱིར་རོ་༎
 amūlo bhikṣuriti apratiṣṭhitasya bhikṣoretadadhivacanam |	རྩ་བ་མེད་པའི་དགེ་སློང་ཞེས་བྱ་བ་དེ་ནི་། མི་གནས་པའི་དགེ་སློང་གི་ཚིག་བླ་དབ༹གས་སོ་༎ རྩོད་པ་བྱུང་བ་ཞེས་བྱ་བ་དེ་ནི་།
 utpannamadhikaraṇamiti adhikasamāropasyaitadadhivacanam |	ལྷག་པར་སྒྲོལ་འདོགས་པ་ཞེས་བྱ་བའི་ཚིག་བླ་དབ༹གས་སོ་༎
 adhikasamārope bhadanta sāradvatīputra caran loke dakṣiṇīyo bhavati |	བཙུན་པ་ཤའ་རདབ༹་ཏིའི་བུ་། ལྷག་པར་སྒྲོ་འདོགས་པ་ལ་སྤྱོད་པ་ནི་། འཇིག་རྟེན་ལ་སྦྱིན་གནས་སུ་འགྱུར་རོ་༎
 tatkasmāddhetoḥ?	དེ་ཅིའི་ཕྱིར་ཞེ་ན་། འདི་ལྟར་།
 tathā hi samaḥ so 'dhikasamāropaḥ |	མཉམ་པ་དེ་ལ་ལྷག་པར་སྒྲོ་བཏགས་པའི་ཕྱིར་རོ་༎
 śrāddho bhadanta śāradvatīputra bhikṣurnārhati śraddhādeyaṃ paribhoktum |	བཙུན་པ་ཤའ་རདབ༹་ཏིའི་བུ་། དགེ་སློང་དད་པ་ནི་། དད་པས་བྱིན་པ་སྤྱོད་པའི་འོས་མ་ཡིན་ནོ་༎
 aśrāddho bhadanta śāradvatīputra bhikṣurarhati śraddhādeyaṃ paribhoktum |	བཙུན་པ་ཤའ་རདབ༹་ཏིའི་བུ་། དགེ་སློང་མ་དད་པ་ནི་། དད་པས་བྱིན་པ་སྤྱད་པའི་འོས་སོ་༎ བཙུན་པ་ཤའ་རདབ༹་ཏིའི་བུ་།
 kalpito bhadanta śāradvatīputra bhikṣurnārhati śraddhādeyaṃ paribhoktum |	རུང་བ་ཅན་གྱི་དགེ་སློང་ནི་། དད་པས་བྱིན་པ་སྤྱད་པའི་འོས་མ་ཡིན་ནོ༏་༏བཙུན་པ་ཤའ་རདབ༹་ཏིའི་བུ་།
 akalpiko bhadanta śāradvatīputra bhikṣurarhati śraddhādeyaṃ paribhoktum |	རུང་བ་ཅན་མ་ཡིན་པའི་དགེ་སློང་ནི་། དད་པས་བྱིན་པ་སྤྱད་པའི་འོས་སོ་༎
 asamupahatanetrīko bhikṣurarhan kṣīṇāsrava ityucyate ||	ཚུལ་ཡང་དག་པར་མ་བཅོས་པའི་དགེ་སློང་ནི་། དགྲ་བཅོམ་པ་ཟག་པ་ཟད་པ་ཞེས་བྱའོ་༎
 śāradvatīputra āha - kiṃ saṃdhāya mañjuśrīrevaṃ vadasi?	ཤའ་རདབ༹་ཏིའི་བུས་སྨྲས་པ་། འཇམ་དཔལ་། ཅི་ལས་བསམ་སྟེ་དེ་སྐད་ཅེས་སྨྲ་།
 mañjuśrīrāha - na samatā samupahatā,	འཇམ་དཔལ་གྱིས་སྨྲས་པ་།
 yā samatā saiva sā netrī |	མཉམ་པ་ཉིད་གང་མཉམ་པ་ཉིད་ཡང་དག་པར་འཇོམས་པར་མི་བྱེད་པ་དེ་ཉིད་༄༡༣༧བ་ཚུལ་ཡིན་ཏེ་། 
 idaṃ saṃdhāya bhadanta śāradvatīputra evaṃ vadāmi - asamupahatanetrīko bhikṣurarhan kṣīṇāsrava ityucyate | anuttīrṇabhaya(bhava?)	བཙུན་པ་ཤའ་རདབ༹་ཏིའི་བུ་། དེ་ལ་བསམ་ནས་ཚུལ་ཡང་དག་པར་མ་བཅོས་པའི་དགེ་སློང་ནི་། དགྲ་བཅོམ་པ་ཟག་པ་ཟད་པ་ཞེས་བྱའོ་༎ ཞེས་དེ་སྐད་ཅེས་སྨྲས་སོ་༎
 iti bhadanta śāradvatīputra arhataḥ kṣīṇāsravasyaitadadhivacanam |	བཙུན་པ་ཤའ་རདབ༹་ཏིའི་བུ་། འཇིགས་པ་ལས་མ་བརྒལ་བ་ཞེས་བྱ་བ་དེ་ནི་། དགྲ་བཅོམ་པ་ཟག་པ་ཟད་པ་ཞེས་བྱ་བའི་ཚིག་བླ་དབ༹གས་སོ་༎
 śāradvatīputra āha - kiṃ saṃdhāya mañjuśrīrevaṃ vadasi?	ཤའ་རདབ༹་ཏིའི་བུས་སྨྲས་པ་། འཇམ་དཔལ་། ཅི་ལས་བསམ་སྟེ་དེ་སྐད་སྨྲ་།
 mañjuśrīrāha - aṇūnyapi tasya bhayāni na saṃvidyante |	འཇམ་དཔལ་གྱིས་སྨྲས་པ་། དེའི་འཇིགས་པ་ཅུང་ཟད་ཙམ་ཡང་མེད་ན་།
 tatkimuttariṣyati? idaṃ saṃdhāya bhadanta śāradvatīputra evaṃ vadāmi - anuttīrṇabhaya iti arhataḥ kṣīṇāsravasyaitadadhivacanamiti ||	ཅི་ཞིག་ལས་བརྒལ་བར་འགྱུར་།
 śāradvatīputra āha - anutpannakṣāntika iti mañjuśrīḥ kasyaitadadhivacanam?	ཤའ་རདབ༹་ཏིའི་བུས་སྨྲས་པ་། འཇམ་དཔལ་། མ་སྐྱེས་པའི་བཟོད་པ་ཅན་ཞེས་བྱ་བ་དེ་གང་གི་ཚིག་བླ་དབ༹གས་།
 mañjuśrīrāha - yena bhadanta śāradvatīputra aṇurapi dharmo notpāditaḥ,	འཇམ་དཔལ་གྱིས་སྨྲས་པ་། བཙུན་པ་ཤའ་རདབ༹་ཏིའི་བུ་།
 sa ucyate 'nutpannakṣāntika iti ||	གང་གིས་ཆོས་ཅུང་ཟད་ཙམ་ཡང་མ་བསྐྱེད་པ་དེ་མ་སྐྱེས་བའི་བཟོད་པ་ཅན་ཞེས་བྱའོ་༎ ཤའ་རདབ༹་ཏིའི་བུས་སྨྲས་པ་།
 śāradvatīputra āha - avinīto bhikṣuriti mañjuśrīḥ kasyaitadadhivacanam?	འཇམ་དཔལ་། དགེ་སློང་མ་དུལ་བ་ཞེས་བྱ་བ་དེ་། གང་གི་ཚིག་བླ་དབ༹གས་། འཇམ་དཔལ་གྱིས་སྨྲས་པ་།
 mañjuśrīrāha - avinīto bhikṣuriti bhadanta śāradvatīputra arhataḥ kṣīṇāsravasyaitadadhivacanam |	བཙུན་པ་ཤའ་རདབ༹་ཏིའི་བུ་། དགེ་སློང་མ་དུལ་བ་ཞེས་བྱ་བ་དེ་ནི་། དགྲ་བཅོམ་པ་ཟག་པ་ཟད་པའི་ཚིག་བླ་དབ༹གས་སོ་༎
 tatkasmāddhetoḥ?	དེ་ཅིའི་ཕྱིར་ཞེ་ན་། མ་དུལ་བ་ནི་། དུལ་ལ་།
 avinayo hi vinītaḥ,	དུལ་བ་ནི་།
 na vinayo vinītaḥ |	མ་དུལ་བས་། བཙུན་པ་ཤའ་རདབ༹་ཏིའི་བུ་།
 idaṃ saṃdhāya bhadanta śāradvatīputra evaṃ vadāmi - avinīto bhikṣuriti arhataḥ kṣīṇāsravasyaitadadhivacanam ||	འདི་ལས་བསམ་སྟེ་དགེ་སློང་མ་དུལ་བ་ཞེས་བྱ་བ་དེ་ནི་། དགྲ་བཅོམ་པ་ཟག་པ་ཟད་པའི་ཚིག་བླ་དབ༹གས་སོ་༎ ཞེས་དེ་སྐད་སྨྲས་སོ་༎ བཙུན་པ་ཤའ་རདབ༹་ཏིའི་བུ་།
 śāradvatīputra āha - adhicitte caratīti mañjuśrīḥ kasyaitadadhivacanam?	ལྷག་པའི་སེམས་ལ་སྤྱོད་དོ་༎ ཞེས་བྱ་བ་དེ་ནི་། སོ་སོའི་སྐྱེ་བོའི་ཚིག་བླ་དབ༹གས་སོ་༎
 mañjuśrīrāha - adhicitte caratīti bhadanta śāradvatīputra pṛthagjanasyaitadadhivacanam |	ཤའ་རདབ༹་ཏིའི་༄༡༣༨ཨ་༌༎
 śāradvatīputra āha - kiṃ saṃdhāya mañjuśrīrevaṃ vadasi?	བུས་སྨྲས་པ་། འཇམ་དཔལ་། ཅི་ལས་བསམ་སྟེ་དེ་སྐད་སྨྲ་།
 mañjuśrīrāha - tathā hi bhadanta śāradvatīputra so 'dhikaroti ||	འཇམ་དཔལ་གྱིས་སྨྲས་པ་། བཙུན་པ་ཤའ་རདབ༹་ཏིའི་བུ་། འདི་ལྟར་།
 evamukte āyuṣmān śāradvatīputro mañjuśriyaṃ kumārabhūtametadavocat - sādhu sādhu mañjuśrīḥ,	དེས་ལྷག་པར་བྱེད་པའི་ཕྱིར་རོ༏་༏དེ་སྐད་ཅེས་སྨྲས་པ་དང་། ཚེ་དང་ལྡན་པ་ཤའ་རདབ༹་ཏིའི་བུས་འཇམ་དཔལ་གཞོན་ནུར་གྱུར་པ་ལ་འདི་སྐད་ཅེས་སྨྲས་སོ་༎ འཇམ་དཔལ་།
 yathā arhan kṣīṇāsravastathā kathayasi |	ཁྱོད་ཀྱིས་དགྲ་བཅོམ་པ་ཟག་པ་ཟད་པ་ཇི་ལྟ་བ་དེ་བཞིན་དུ་སྨྲས་པ་ལེགས་སོ་༎ ལེགས་སོ་༎
 mañjuśrīrāha - evametadbhadanta śāradvatīputra yathā vadasi |	འཇམ་དཔལ་གྱིས་སྨྲས་པ་། བཙུན་པ་ཤའ་རདབ༹་ཏིའི་བུ་། དེ་དེ་བཞིན་ཏེ་། ཇི་སྐད་སྨྲས་པ་བཞིན་ནོ་༎
 kṣīṇāsravo 'smi, na cārhan |	ཁོ་བོ་ནི་། ཟག་པ་ཟད་མོད་ཀྱི་། དགྲ་བཅོམ་པ་མ་ཡིན་ནོ་༎
 tatkasmāddhetoḥ?	དེ་ཅིའི་ཕྱིར་ཞེ་ན་། བཙུན་པ་ཤའ་རདབ༹་ཏིའི་བུ་། འདི་ལྟར་།
 tathā hi bhadanta śāradvatīputra kṣīṇā me āsravāḥ ḥrāvakabhūmau vā pratyekabuddhabhūmau vā |	ཉན་ཐོས་ཀྱི་ས་དང་། རང་སངས་རྒྱས་ཀྱི་སར་ཁོ་བོའི་བསམ་པ་ཟད་པའི་ཕྱིར་ཏེ་། བཙུན་པ་ཤའ་རདབ༹་ཏིའི་བུ་།
 anena bhadanta ḥāradvatīputra paryāyeṇa kṣīṇāsravo na cārhan ||	རྣམ་གྲངས་འདིས་ན་། ཁོ་བོ་ཟག་པ་ཟད་མོད་ཀྱི་། དགྲ་བཅོམ་པ་ནི་།
 (saptaś, vaidya 349) atha khalu bhagavān mañjuśriyaṃ kumārabhūtametadavocat - syānmañjuśrīḥ	མ་ཡིན་ནོ་༎ དེ་ནས་བཅོམ་ལྡན་འདས་ཀྱིས་འཇམ་དཔལ་གཞོན་ནུར་གྱུར་པ་ལ་འདི་སྐད་ཅེས་བཀའ་སྩལ་ཏོ་༎ འཇམ་དཔལ་།
 paryāyo yadbodhisattvo mahāsattvo bodhimaṇḍe niṣaṇṇo 'bhavyo 'nuttarāṃ samyaksaṃbodhimabhisaṃboddhum?	བྱང་ཆུབ་སེམས་དཔའ་སེམས་དཔའ་ཆེན་པོ་བྱང་ཆུབ་ཀྱི་སྙིང་པོར་འདུག་ལ་། བླ་ན་མེད་པ་ཡང་དག་པར་རྫོགས་པའི་བྱང་ཆུབ་མངོན་པར་རྫོགས་པར་འཚང་རྒྱ་བའི་སྐལ་པ་མེད་པར་འགྱུར་བའི་རྣམ་གྲངས་ཡོད་དམ་། འཇམ་དཔལ་གྱིས་གསོལ་པ་། བཅོམ་ལྡན་འདས་།
 mañjuśrīrāhasyādbhagavan paryāyaḥ yabdodhisattvo mahāsattvo bodhimaṇḍe niṣaṇṇaḥ abhavyo 'nuttarāṃ samyaksaṃbodhimabhisaṃboddhum |	བྱང་ཆུབ་སེམས་དཔའ་སེམས་དཔའ་ཆེན་པོ་བྱང་ཆུབ་ཀྱི་སྙིང་པོ་༄༡༣༨བ་ལ་མཆིས་ལ་། བླ་ན་མེད་པ་ཡང་དག་པར་རྫོགས་པའི་བྱང་ཆུབ་མངོན་པར་རྫོགས་པར་འཚང་རྒྱ་བའི་སྐལ་བ་མ་མཆིས་པར་འགྱུར་བའི་རྣམ་གྲངས་མཆིས་སོ་༎
 tatkasya hetoḥ?	དེ་ཅིའི་སླད་དུ་ཞེ་ན་།
 tathā hi bodhāvaṇurapi dharmo na saṃvidyate nopalabhyate |	འདི་ལྟར༏་བྱང་ཆུབ་ལ་ཅུང་ཟད་ཙམ་གྱི་ཆོས་ཀྱང་མ་མཆིས་ཤིང་མི་དམིགས་པས་།
 tenocyate 'nuttarā samyaksaṃbodhiriti |	དེའི་སླད་དུ་བླ་ན་མེད་པ་ཡང་དག་པར་རྫོགས་པའི་བྱང་ཆུབ་ཅེས་བགྱིའོ་༎
 sā ca bodhiranutpannā | tatra na kaściddharmaḥ saṃvidyate nopalabhyate,	བྱང་ཆུབ་དེ་ཡང་མ་སྐྱེས་པ་སྟེ་།
 yo bodhimaṇḍe niṣīdet,	དེ་ལ་གང་བྱང་ཆུབ་ཀྱི་སྙིང་པོ་ལ་མཆིས་པའམ་།
 yo vā bodhimabhisaṃbudhyet,	སུ་བྱང་ཆུབ་མངོན་པར་རྫོགས་པར་འཚང་རྒྱ་བའམ་། གང་གིས་བྱང་ཆུབ་མངོན་པར་རྫོགས་པར་འཚང་རྒྱ་བའམ་།
 yena vā bodhirabhisaṃbudhyeta,	བྱང་ཆུབ་གང་མངོན་པར་རྫོགས་པར་འཚང་རྒྱ་བའམ་།
 yo vā bodhimaṇḍāduttiṣṭhediti |	གང་བྱང་ཆུབ་ཀྱི་སྙིང་པོ་ལས་ལྡང་བ་གང་ཡང་མ་མཆིས་ཤིང་མི་དམིགས་ཏེ་། བཅོམ་ལྡན་འདས་།
 anena bhagavan paryāyeṇa abhavyo bodhisattvo mahāsattvo bodhimaṇḍe niṣaṇṇo 'nuttarāṃ samyaksaṃbodhimabhisaṃboddhum ||	རྣམ་གྲངས་འདིས་ན་། བྱང་ཆུབ་སེམས་དཔའ་སེམས་དཔའ་ཆེན་པོ་བྱང་ཆུབ་ཀྱི་སྙིང་པོར་མཆིས་ལ་། བླ་ན་མེད་པ་ཡང་དག་པར་རྫོགས་པའི་བྱང་ཆུབ་མངོན་པར་རྫོགས་པར་འཚང་རྒྱ་བའི་སྐལ་བ་མ་མཆིས་སོ་༎ 
 evamukte bhagavān mañjuśriyaṃ kumārabhūtametadavocat - bodhiriti mañjuśrīḥ kasyaitadadhivacanam?	དེ་སྐད་ཅེས་གསོལ་པ་དང་། བཅོམ་ལྡན་འདས་ཀྱིས་འཇམ་དཔལ་གཞོན་ནུར་གྱུར་པ་ལ་འདི་སྐད་ཅེས་བཀའ་སྩལ་ཏོ་༎ འཇམ་དཔལ་། བྱང་ཆུབ་ཅེས་བྱ་བ་དེ་། གང་གི་ཚིག་བླ་དབ༹གས་། འཇམ་དཔལ་གྱིས་གསོལ་པ་།
 mañjuśrīrāha - bodhiriti bhagavan pañcānāmānantaryāṇāmetadadhivacanam |	བཅོམ་ལྡན་འདས་། བྱང་ཆུབ་ཅེས་བགྱི་བ་དེ་ནི་། མཚམས་མ་མཆིས་པ་ལྔ་པོ་དེ་དག་གི་ཚིག་བླ་དབ༹གས་སོ་༎
 tatkasmāddhetoḥ?	དེ་ཅིའི་སླད་དུ་ཞེ་ན་། བཅོམ་ལྡན་འདས་། འདི་ལྟར་། དངོས་པོ་མ་མཆིས་པས་༄༡༣༩ཨ་༌༎
 tathā hi bodhiprakṛtikānyeva tāni pañcānantaryāṇi abhāvatvāt |	མཚམས་མ་མཆིས་པ་ལྔ་པོ་དེ་དག་ཉིད་བྱང་ཆུབ་ཀྱི་རང་བཞིན་ཏེ་།
 tenaiṣā bodhirānantaryaprakṛtikā,	དེའི་སླད་དུ་བྱང་ཆུབ་དེ་ནི་། མཚམས་མ་མཆིས་པ་ལྔའི་རང་བཞིན་ཅན་ལགས་སོ་༎
 anantaryāṇāmabhisaṃbudhyanā bodhiḥ,	མཚམས་མ་མཆིས་པ་རྣམས་མངོན་པར་རྫོགས་པར་རྟོགས་པ་བྱང་ཆུབ་མ་ལགས་།
 na ca pratyakṣībhāvanā sarvadharmeṣu bodhiḥ |	ཆོས་ཐམས་ཅད་མངོན་སུམ་དུ་གྱུར་པ་ཡང་བྱང་ཆུབ་མ་ལགས་སོ་༎
 tatkasmāddhetoḥ?	དེ་ཅིའི་སླད་དུ་ཞེ་ན་།
 sarvadharmā hi atyantatayā apratyakṣāḥ |	ཆོས་ཐམས་ཅད་ནི་། ཤིན་ཏུ་མངོན་སུམ་མ་ལགས་ཏེ་།
 te na kenacidabhisaṃbuddhāḥ,	དེ་དག་གང་གིས་ཀྱང་མངོན་པར་རྫོགས་པར་མ་རྟོགས་།
 na dṛṣṭāḥ,	མ་མཐོང་།
 na jñātāḥ,	མ་ཐོས་།
 yāvat na viditāḥ |	མ་འཚལ་བ་ནས་མ་རྟོགས་པའི་བར་གྱི་སླད་དུ་སྟེ་།
 evameṣā bodhiḥ |	དེ་ལྟ་བུ་དེ་ནི་། བྱང་ཆུབ་བོ་༎ དེ་ལྟ་ལགས་ཀྱིས་ཀྱང་བཅོམ་ལྡན་འདས་། མངོན་པའི་ང་རྒྱལ་ཅན་དག་གིས་ནི་།
 api tu khalu punarbhagavan abhimānikaiḥ sthāpitānyetāni abhisaṃbudhāni(ddhā? ) , yāvat pratyakṣīkṛtāni ||	མངོན་པར་རྫོགས་པར་སངས་རྒྱས་པ་ནས་མངོན་སུམ་དུ་བགྱི་བའི་བར་དུ་དེ་དག་བཞག་གོ་།
 evamukte bhagavān mañjuśriyaṃ kumārabhūtametadavocat - kiṃ te mañjuśrīḥ mamāntike evaṃ bhavati - tathāgato me tathāgata iti?	དེ་སྐད་ཅེས་གསོལ་པ་དང་། བཅོམ་ལྡན་འདས་ཀྱིས་འཇམ་དཔལ་གཞོན་ནུར་གྱུར་པ་ལ་འདི་སྐད་ཅེས་བཀའ་སྩལ་ཏོ་༎ འཇམ་དཔལ་། ཅི་ཁྱོད་ང་ལ་འདི་སྙམ་དུ་། དེ་བཞིན་གཤེགས་པ་ནི་། བདག་གི་དེ་བཞིན་གཤེགས་པའོ་༎ སྙམ་དུ་སེམས་སམ་།
 mañjuśrīrāha - no hīdaṃ bhagavan |	འཇམ་དཔལ་གྱིས་གསོལ་པ་། བཅོམ་ལྡན་འདས་། དེ་ནི་། མ་ལགས་སོ་༎
 tatkasmāddhetoḥ?	དེ་ཅིའི་སླད་དུ་ཞེ་ན་། བཅོམ་ལྡན་འདས་། འདི་ལྟར་། དེ་བཞིན་གཤེགས་པ་ནི་།
 na me bhagavan evaṃ bhavet - tathāgato me tathāgata iti |	བདག་གི་དེ་བཞིན་གཤེགས་པའོ་༎ སྙམ་དུ་མི་སེམས་པའི་སླད་དུའོ་༎
 tatkasmāddhetoḥ?	དེ་ཅིའི་སླད་དུ་ཞེ་ན་། བཅོམ་ལྡན་འདས་། འདི་ལྟར་།
 [tathā caiva tathatā ca] yathā ca tathātā,	དེ་བཞིན་༄༡༣༩བ་ཉིད་ནི་།
 tathā caiṣa tathāgataḥ |	དེ་བཞིན་གཤེགས་པ་ཉིད་དེ་།
 tathā hi bhagavan na tathatā tathāgataṃ vijñapayati,	དེ་བཞིན་གཤེགས་པ་ཉིད་ཀྱིས་དེ་བཞིན་གཤེགས་པ་རྣམ་པར་རིག་པར་མི་བགྱིད་ཅིང་།
 nāpi tathāgatastathatāṃ vijñapayati |	དེ་བཞིན་གཤེགས་པས་ཀྱང་དེ་བཞིན་ཉིད་རྣམ་པར་རིག་པར་མི་བགྱིད་པའི་སླད་དུའོ་༎
 tatkasmāddhetoḥ?	དེ་ཅིའི་སླད་དུ་ཞེ་ན་། བཅོམ་ལྡན་འདས་། འདི་ལྟར་།
 tathā hi bhagavan paramārthato 'bhāvā tathatā | abhāvastathāgataḥ |	དོན་དམ་པར་ན་དེ་བཞིན་ཉིད་དངོས་པོ་མ་མཆིས་ཤིང་དེ་བཞིན་གཤེགས་པ་ཡང་དངོས་པོ་མ་མཆིས་པའི་སླད་དུའོ་༎ བཅོམ་ལྡན་འདས་། དེ་བས་ན་།
 tasmāttarhi bhagavan na me evaṃ bhavati - tathāgato me tathāgata iti |	བདག་ནི་། འདི་སྙམ་དུ་། དེ་བཞིན་གཤེགས་པ་བདག་གི་དེ་བཞིན་གཤེགས་པའོ་༎ སྙམ་དུ་མི་དམིགས་སོ་༎
 api tu tathāgata iti bhagavan nāmadheyamātrametat |	བཅོམ་ལྡན་འདས་། དེ་བཞིན་གཤེགས་པ་ཞེས་བགྱི་བ་དེ་ནི་། མིང་ཙམ་དུ་བས་ན་།
 tat kataro 'sau tathāgato yatra me evaṃ bhaviṣyati - tathāgato me tathāgata iti? bhagavānāha - sa(tat?)	གང་ལ་བདག་འདི་སྙམ་དུ་།
 saṃśayaste mañjuśrīstathāgate?	དེ་བཞིན་གཤེགས་པ་ནི་། བདག་གི་དེ་བཞིན་གཤེགས་པའོ་༎ སྙམ་དུ་སེམས་པར་འགྱུར་བའི་དེ་བཞིན་གཤེགས་པ་དེ་གང་ལགས༏་བཅོམ་ལྡན་འདས་ཀྱིས་བཀའ་སྩལ་པ་། འཇམ་དཔལ་། ཁྱོད་དེ་བཞིན་གཤེགས་པ་ལ་ཐེ་ཚོམ་ཟའམ་།
 mañjuśrīrāha - no hīdaṃ bhagavan |	འཇམ་དཔལ་གྱིས་གསོལ་པ་། བཅོམ་ལྡན་འདས་། དེ་ནི་།
 syādatra me bhagavan saṃśayaḥ,	མ་ལགས་སོ་༎ བཅོམ་ལྡན་འདས་།
 sacet kācittathāgatapariniṣpattiḥ syat,	གལ་ཏེ་དེ་བཞིན་གཤེགས་པ་བྱུང་ངམ་།
 tathāgatotpattirvā tathāgataparinirvāṇaṃ vā ||	དེ་བཞིན་གཤེགས་པ་ཡོངས་སུ་མྱ་ངན་ལས་འདས་པ་ཡང་རུང་སྟེ་། དེ་བཞིན་གཤེགས་པར་ཡོངས་སུ་གྲུབ་པ་འགའ་ཞིག་མཆིས་ན་ནི་། དེ་ལ་བདག་ཐེ་ཚོམ་འཚལ་ལོ་༎
 evamukte bhagavān mañjuśriyaṃ kumārabhūtametadavocat - na tava mañjuśrīrevaṃ bhavati - utpannastathāgata iti?	དེ་སྐད་ཅེས་གསོལ་པ་དང་། བཅོམ་ལྡན་འདས་ཀྱིས་འཇམ་དཔལ་གཞོན་ནུར་གྱུར་པ་ལ་འདི་སྐད་ཅེས་བཀའ་སྩལ་ཏོ་༎ འཇམ་དཔལ་། ཁྱོད་དེ་བཞིན་༄༡༤༠ཨ་༌༎ གཤེགས་པ་བྱུང་ངོ་༎ སྙམ་དུ་མི་སེམས་སམ་།
 mañjuśrīrāha - syānme bhagavan utpannastathāgata iti,	འཇམ་དཔལ་གྱིས་གསོལ་པ་། བཅོམ་ལྡན་འདས་།
 saceddharmadhātorutpattiḥ syāt ||	གལ་ཏེ་ཆོས་ཀྱི་དབྱིངས་ལ་བྱུང་བ་མཆིས་ན་ནི་། བདག་དེ་བཞིན་གཤེགས་པ་བྱུང་ངོ་༎ སྙམ་དུ་སེམས་པར་འགྱུར་རོ་༎
 bhagavānāha - nādhimucyase tvaṃ mañjuśrīḥ gaṅgānadīvālukopamā buddhā bhagavantaḥ parinirvṛtā iti?	བཅོམ་ལྡན་འདས་ཀྱིས་བཀའ་སྩལ་པ་། འཇམ་དཔལ་། ཁྱོད་སངས་རྒྱས་བཅོམ་ལྡན་འདས་གངགའའི་ཀླུང་གི་བྱེ་མ་སྙེད་ཡོངས་སུ་མྱ་ངན་ལས་འདའ་བར་ཁྱོད་མི་མོས་སམ་། 
 mañjuśrīrāha - kaścit punarbhagavan ekaviṣayā buddha bhagavanto yadidamacintyaviṣayāḥ? (saptaś, vaidya 350)	འཇམ་དཔལ་གྱིས་གསོལ་པ་། བཅོམ་ལྡན་འདས་། སངས་རྒྱས་བཅོམ་ལྡན་འདས་རྣམས་འདི་ལྟར་བསམ་གྱིས་མི་ཁྱབ་པའི་ཡུལ་དུ་ཡུལ་གཅིག་པ་མ་ལགས་སམ་། 
 bhagavānāha - evametanmañjuśrīḥ,	བཅོམ་ལྡན་འདས་ཀྱིས་བཀའ་སྩལ་པ་། འཇམ་དཔལ་། དེ་དེ་བཞིན་ཏེ་།
 ekaviṣayā buddhā bhagavanto yadidamacintyaviṣayāḥ |	སངས་རྒྱས་བཅོམ་ལྡན་འདས་རྣམས་ནི་། འདི་ལྟར་། བསམ་གྱིས་མི་ཁྱབ་པའི་ཡུལ་དུ་ཡུལ་གཅིག་གོ་།
 mañjuśrīrāha - kaścitpunarbhagavan etarhi tiṣṭhati?	འཇམ་དཔལ་གྱིས་གསོལ་པ་། བཅོམ་ལྡན་འདས་། ད་ལྟར་བཞུགས་སམ་།
 bhagavānāha - evametanmañjuśrīḥ |	བཅོམ་ལྡན་འདས་ཀྱིས་བཀའ་སྩལ་པ་། འཇམ་དཔལ་། དེ་དེ་བཞིན་ནོ་༎
 mañjuśrīrāha - tena hi bhagavan ete gaṅgānadīvālukopamā buddhā bhagavanto na parinirvṛtāḥ |	འཇམ་དཔལ་གྱིས་གསོལ་པ་། བཅོམ་ལྡན་འདས་། དེའི་སླད་དུ་གངགའའི་ཀླུང་གི་བྱེ་མ་སྙེད་ཀྱི་སངས་རྒྱས་བཅོམ་ལྡན་འདས་དེ་དག་ཡོངས་སུ་མྱ་ངན་ལས་མ་འདས་སོ་༎
 tatkasmāddhetoḥ?	དེ་ཅིའི་སླད་དུ་ཞེ་ན་། བཅོམ་ལྡན་འདས་།
 tathā hi bhagavan ekaviṣayā buddhā bhagavanto yadidamacintyaviṣayāḥ |	སངས་རྒྱས་བཅོམ་ལྡན་འདས་རྣམས་ནི་། འདི་ལྟར་བསམ་གྱིས་མི་ཁྱབ་པའི་ཡུལ་དུ་ཡུལ་གཅིག་པའི་སླད་དུ་སྟེ་།
 na ca acintyatā utpadyate nirudhyate vā |	བསམ་གྱིས་མི་ཁྱབ་པ་ཉིད་ནི་། སྐྱེ་བ་མ་ལགས་། འགག་པ་མ་ལགས་༄༡༤༠བ་སོ༏་༏བཅོམ་ལྡན་འདས་།
 tasmādbhagavan bhagavato vā abhisaṃbuddhena (ddhasya?)	དེ་བས་ན་། བཅོམ་ལྡན་འདས་ཉིད་ཀྱིས་མངོན་པར་རྫོགས་པར་སངས་རྒྱས་ན་།
 ye 'pi te anāgate 'dhvani tathagatā arhantaḥ samyaksaṃbuddhā bhaviṣyanti, abhisaṃbuddhā eva te |	གང་དག་མ་མཆིས་པའི་དུས་ན་དེ་བཞིན་གཤེགས་པ་དགྲ་བཅོམ་པ་ཡང་དག་པར་རྫོགས་པའི་སངས་རྒྱས་སུ་འགྱུར་བ་དེ་དག་ཀྱང་དེ་བཞིན་དུ་མངོན་པར་རྫོགས་པར་སངས་རྒྱས་པ་ཉིད་དོ་༎
 tatkasmāddhetoḥ?	དེ་ཅིའི་སླད་དུ་ཞེ་ན་།
 na hi acintyatā atītā vā anāgatā vā pratyutpannā vā | tasmādbhagavan vibhramasteṣāṃ lokasaṃniveśaḥ |	བསམ་གྱིས་མི་ཁྱབ་པ་ལ་འདས་པའམ་། མ་འོངས་པའམ་། ད་ལྟར་ཞེས་བགྱི་བ་མ་མཆིས་པའི་སླད་དུའོ་༎ བཅོམ་ལྡན་འདས་། དེ་བས་ན་། སུ་དག་འདི་སྙམ་དུ་། དེ་བཞིན་ཉིད་དང་། དེ་བཞིན་གཤེགས་པ་སྐྱེས་སོ་༎
 prapañcayanti te bhagavan lokasaṃniveśaṃ yeṣāmevaṃ bhavati - utpannastathāgato yāvat parinirvāsyati veti ||	ཞེས་བགྱི་བ་ནས་ཡོངས་སུ་མྱ་ངན་ལས་འདས་པའི་བར་དུ་སེམས་པ་དེ་དག་གི་འཇིག་རྟེན་གནས་པ་ནི་། འཁྲུལ་པ་སྟེ་། བཅོམ་ལྡན་འདས་། དེ་དག་ནི་། འཇིག་རྟེན་གནས་པ་འཕྲོས་པར་བགྱིད་པ་ལགས་སོ་༎
 evamukte bhagavān mañjuśriyaṃ kumārabhūtametadavocat - tena hi tvaṃ mañjuśrīḥ idaṃ tathāgatācintyam,	དེ་སྐད་ཅེས་གསོལ་པ་དང་། བཅོམ་ལྡན་འདས་ཀྱིས་འཇམ་དཔལ་གཞོན་ནུར་གྱུར་པ་ལ་འདི་སྐད་ཅེས་བཀའ་སྩལ་ཏོ་༎ འཇམ་དཔལ་། དེའི་ཕྱིར་ཁྱོད་ཀྱིས་དེ་བཞིན་གཤེགས་པའི་བསམ་གྱིས་མི་ཁྱབ་པ་། བསམ་དུ་མེད་པ་།
 acintyaṃ niścintyaṃ tathāgatasya vā agrata udāhārairudāhareḥ,	བསམ་གྱིས་མི་ལང་བ་། བསམ་པ་ལས་འདས་པ་འདི་དེ་བཞིན་གཤེགས་པའམ་།
 avaivartikasya bodhisattvasya mahāsattvasya vā arhato vā kṣīṇāsravasya |	ཕྱིར་མི་ལྡོག་པའི་བྱང་ཆུབ་སེམས་དཔའ་སེམས་དཔའ་ཆེན་པོའམ་། དགྲ་བཅོམ་པ་ཟག་པ་ཟད་པའི་མངོན་དུ་བརྗོད་ན་རྗོད་ཅིག་།
 tatkasmāddhetoḥ?	དེ་ཅིའི་ཕྱིར་ཞེ་ན་། འདི་ལྟར་།
 tathā hi te śrutvā naivānujñāsyanti,	དེ་དག་ནི་། ཐོས་ནས་བསྔགས་པར་ཡང་མི་འགྱུར་།
 naiva pratikrokṣyanti |	སྤོང་བར་ཡང་མི་འགྱུར་བའི་ཕྱིར་རོ་༎
 tatkasmāddhetoḥ?	དེ་ཅིའི་ཕྱིར་ཞེ་ན་། འདི་ལྟར་།
 tathā hi taccintyamacintyaṃ niścintyam |	༄༡༤༡ཨ་༌༎ འདི་བསམ་གྱིས་མི་ཁྱབ་པ་། དཔག་ཏུ་མེད་པ་། བསམ་གྱིས་མི་ལང་བའི་ཕྱིར་རོ་༎ འཇམ་དཔལ་གྱིས་གསོལ་པ་། བཅོམ་ལྡན་འདས་།
 mañjuśrīrāha - acintyānāṃ niścintyānāṃ bhagavan sarvadharmāṇāṃ ko 'trānujñāsyati vā pratikrokṣyati vā?	ཆོས་ཐམས་ཅད་བསམ་གྱིས་མི་ཁྱབ་ཅིང་བསམ་དུ་མ་མཆིས་པ་འདི་ལ་སུ་ཞིག་བསྔགས་པའམ་སྤོང་བར་འགྱུར་། 
 bhagavānāha - yathaiva mañjuśrīḥ tathāgato niścintyaḥ,	བཅོམ་ལྡན་འདས་ཀྱིས་བཀའ་སྩལ་པ་། འཇམ་དཔལ་།
 tathaiva pṛthagjanā api niścintyāḥ |	ཇི་ལྟར་དེ་བཞིན་གཤེགས་པ་བསམ་གྱིས་མི་ལང་བདེ་ལྟར་སོ་སོའི་སྐྱེ་བོ་རྣམས་ཀྱང་བསམ་གྱིས་མི་ལང་བ་ཡིན་ནམ་།
 mañjuśrīrāha - pṛthagjanā api bhagavan tathaiva niścintyāḥ?	འཇམ་དཔལ་གྱིས་གསོལ་པ་། བཅོམ་ལྡན་འདས་། སོ་སོའི་སྐྱེ་བོ་རྣམས་ཀྱང་དེ་བཞིན་དུ་བསམ་གྱིས་མི་ལང་བ་ལགས་སོ་༎
 bhagavānāha - evametanmañjuśrīḥ |	བཅོམ་ལྡན་འདས་ཀྱིས་བཀའ་སྩལ་པ་། འཇམ་དཔལ་། དེ་དེ་བཞིན་ནོ་༎
 tatkasmāddhetoḥ?	དེ་ཅིའི་ཕྱིར་ཞེ་ན་། འདི་ལྟར་། བསམ་པ་ཐམས་ཅད་ནི་།
 tathā hi sarvāṇyacintyāni niścintyāni |	བསམ་གྱིས་མི་ལང་བའི་ཕྱིར་རོ་༎
 mañjuśrīrāha - tatkasmādbhagavānevamāha - yathaiva tathāgato niścintyaḥ,	འཇམ་དཔལ་གྱིས་གསོལ་པ་། བཅོམ་ལྡན་འདས་།
 evaṃ pṛthagjanā api niścintyā iti?	འོ་ན་ཇི་ལྟར་དེ་བཞིན་གཤེགས་པ་བསམ་གྱིས་མི་ལང་བ་དེ་བཞིན་དུ་སོ་སོའི་སྐྱེ་བོ་རྣམས་ཀྱང་བསམ་གྱིས་མི་ལང་བའོ་༎ ཞེས་བཅོམ་ལྡན་འདས་ཀྱིས་ཅིའི་སླད་དུ་དེ་སྐད་ཅེས་བཀའ་སྩལ་པ་དང་། བཅོམ་ལྡན་འདས་།
 nanu bhagavan pṛthagjanatvamapi niścintyam |	སོ་སོའི་སྐྱེ་བོ་ཉིད་ཀྱང་བསམ་གྱིས་མི་ལང་བ་མ་ལགས་སམ་།
 tatkasmāddhetoḥ?	དེ་ཅིའི་སླད་དུ་ཞེ་ན་།
 niścintyā hi bhagavan sarvadharmāḥ | ye kecidbhagavan parinirvāṇāya prasthitāḥ,	བཅོམ་ལྡན་འདས་ཆོས་ཐམས་ཅད་བསམ་གྱིས་མི་ལང་བའི་སླད་དུ་བཅོམ་ལྡན་འདས་གང་ལ་ལ་དག་མྱ་ངན་ལས་འདས་པའི་སླད་དུ་ཞུགས་ན་། བཅོམ་ལྡན་འདས་།
 vihariṣyante te bhagavan |	དེ་དག་ནི་།
 tatkasmāddhetoḥ?	ཉམ་ཐག་པར་འགྱུར་༄༡༤༡བ་རོ༏་༏དེ་ཅིའི་སླད་ཞེ་ན་།
 yaiva niścintyatā tadeva parinirvāṇam |	གང་བསམ་གྱིས་མི་ལང་པ་དེ་ཉིད་མྱ་ངན་ལས་འདས་པ་ལགས་པའི་སླད་དུ་སྟེ་། བཅོམ་ལྡན་འདས་།
 tasmāttarhi bhagavan nāsti niścintyatāyāṃ nānātvam |	དེའི་སླད་དུ་བསམ་གྱིས་མི་ལང་བ་ལ་ཐ་དད་པ་མ་མཆིས་སོ༏་༏བཅོམ་ལྡན་འདས་།
 ye 'pi bhagavan evamāhuḥ - ime pṛthagjanadharmāḥ,	གང་དག་འདི་སྐད་དུ་། འདི་དག་ནི་། སོ་སོའི་སྐྱེ་བོའི་ཆོས་རྣམས་སོ་༎
 ime āryadharmā iti,	འདི་དག་ནི་། འཕགས་པའི་ཆོས་རྣམས་སོ་༎
 te idaṃ vacanīyāḥ - kalyāṇamitrāṇi tāvatparyupāsadhvam,	ཞེས་མཆིས་པ་དེ་དག་ལ་རེ་ཞིག་དགེ་བའི་བཤེས་གཉེན་རྣམས་ལ་བསྙེན་བཀུར་གྱིས་ཤིག་དང་། དེ་ནས་བཟོད་པ་འདི་དག་ནི་། སོ་སོའི་སྐྱེ་བོའི་ཆོས་རྣམས་སོ་༎ འདི་དག་ནི་།
 tataḥ paścājjñāsyatha - ime pṛthagjanadharmāḥ ime āryadharmā iti ||	འཕགས་པའི་ཆོས་རྣམས་སོ་༎ ཞེས་བྱ་བར་ཤེས་པར་འགྱུར་རོ་༎ ཞེས་དེ་དག་ལ་འདི་སྐད་བརྗོད་པར་བགྱིའོ་༎
 evamukte bhagavān mañjuśriyaṃ kumārabhūtametadavocat - icchasi tvaṃ mañjuśrīḥ tathāgataṃ sarvasattvānāmagryam?	དེ་སྐད་ཅེས་གསོལ་པ་དང་། བཅོམ་ལྡན་འདས་ཀྱིས་འཇམ་དཔལ་གཞོན་ནུར་གྱུར་པ་ལ་འདི་སྐད་ཅེས་བཀའ་སྩལ་ཏོ་༎ འཇམ་དཔལ་། ཁྱོད་དེ་བཞིན་གཤེགས་པ་སེམས་ཅན་ཐམས་ཅད་ཀྱི་མཆོག་ཏུ་འདོད་དམ་། འཇམ་དཔལ་གྱིས་གསོལ་པ་།
 mañjuśrīrāha - iccheyamahaṃ bhagavan tathāgataṃ sarvasattvānāmagryam,	བཅོམ་ལྡན་འདས་།
 sacediha kācitsattvapariniṣpattiḥ syāt |	གལ་ཏེ་འདི་ལ་སེམས་ཅན་དུ་ཡོངས་སུ་གྲུབ་པ་འགའ་ཞིག་མཆིས་ན་ནི་། བདག་དེ་བཞིན་གཤེགས་པ་སེམས་ཅན་ཐམས་ཅད་ཀྱི་མཆོག་ཏུ་འཚལ་ལོ་༎
 bhagavānāha - icchasi tvaṃ mañjuśrīḥ tathāgatamacintyadharmasamanvāgatam?	བཅོམ་ལྡན་འདས་ཀྱིས་བཀའ་སྩལ་པ་། འཇམ་དཔལ་། ཁྱོད་དེ་བཞིན་གཤེགས་པ་བསམ་གྱིས་མི་ཁྱབ་པའི་ཆོས་དང་ལྡན་པར་འདོད་དམ་། འཇམ་དཔལ་གྱིས་གསོལ་པ་།
 mañjuśrīrāha - iccheyamahaṃ bhagavan tathāgatamacintyadharmasamanvāgatam,	བཅོམ་ལྡན་འདས་།
 sacetkaścidacintyadharmasamanvāgataḥ syāt ||	གལ་ཏེ་བསམ་པའི་ཆོས་དང་ལྡན་པ་འགའ་ཞིག་མཆིས་ན་ནི་། བདག་དེ་བཞིན་གཤེགས་པ་བསམ་གྱིས་མི་ཁྱབ་༄༡༤༢ཨ་༌༎ པའི་ཆོས་དང་ལྡན་པར་འཚལ་ལོ་༎ བཅོམ་ལྡན་འདས་ཀྱིས་བཀའ་སྩལ་པ་།
 bhagavānāha - icchasi punastvaṃ mañjuśrīrevam - ime śrāvakāstathāgatena vinītā iti?	འཇམ་དཔལ་། ཁྱོད་འདི་ལྟར་། ཉན་ཐོས་འདི་དག་ནི་། དེ་བཞིན་གཤེགས་པས་བཏུལ་ཏོ་༎ ཞེས་བྱ་བར་འདོད་དམ་། འཇམ་དཔལ་གྱིས་གསོལ་པ་།
 mañjuśrīrāha - iccheyamahaṃ bhagavan evam - ime śrāvakāstathāgatena vinītā iti,	བཅོམ་ལྡན་འདས་།
 sacet kaścidacintyadhātuvinayaṃ (saptaś, vaidya 351) gacchet |	གལ་ཏེ་ལ་ལ་ཞིག་བསམ་གྱིས་མི་ཁྱབ་པའི་དབྱིངས་འདུལ་བར་འགྱུར་ན་ནི་། བདག་ཉན་ཐོས་འདི་དག་དེ་བཞིན་གཤེགས་པས་བཏུལ་ཏོ་༎ ཞེས་བགྱི་བར་དེ་ལྟར་འཚལ་ལོ་༎ བཅོམ་ལྡན་འདས་།
 na bhagavan buddhotpādaḥ kaśyacidupakāreṇa vā apakāreṇa vā pratyupasthitaḥ |	སངས་རྒྱས་འབྱུང་བ་ནི་། གང་ལ་ཕན་པའམ་། གནོད་པར་ཡང་ཉེ་བར་གནས་པ་མ་ལགས་སོ་༎
 taktasmāddhetoḥ?	དེ་ཅིའི་སླད་དུ་ཞེ་ན་།
 tathā hi sthita eṣa dhātuḥ,	འདི་ལྟར་། དབྱིངས་འདི་ནི་། གནས་པ་ཉིད་དང་། དབྱིངས་འདི་ནི་།
 asaṃkīrṇa eṣa dhātuḥ,	མ་འདྲེས་པ་ཉིད་དེ་།
 yaduta acintyadhātuḥ |	འདི་ལྟ་སྟེ་། བསམ་གྱིས་མི་ཁྱབ་པའི་དབྱིངས་ལགས་པའི་སླད་དུའོ་༎
 tasmiśca dhātau na śrāvakanānātvam,	དབྱིངས་དེ་ལ་ནི་།
 yāvat na pṛthagjananānātvamupalabhyate ||	ཉན་ཐོས་ཐ་དད་པ་ནས་སོ་སོའི་སྐྱེ་བོ་ཐ་དད་པའི་བར་དུ་མི་དམིགས་སོ་༎ བཅོམ་ལྡན་འདས་ཀྱིས་བཀའ་སྩལ་པ་།
 bhagavānāha - na tvaṃ mañjuśrīrevamicchasi - anuttaraṃ puṇyakṣetraṃ tathāgata iti?	འཇམ་དཔལ་། ཁྱོད་འདི་ལྟར་། དེ་བཞིན་གཤེགས་པ་བསོད་ནམས་ཀྱི་ཞིང་བླ་ན་མེད་པ་ཡིན་པར་མི་འདོད་དམ་། འཇམ་དཔལ་གྱིས་གསོལ་པ་། བཅོམ་ལྡན་འདས་།
 mañjuśrīrāha - abhāvatvābhdagavan puṇyakṣetraṃ tathagataḥ,	དངོས་པོ་མ་མཆིས་པའི་སླད་དུ་དེ་བཞིན་གཤེགས་པ་བསོད་ནམས་ཀྱི་ཞིང་སྟེ་།
 tenaitadanuttaraṃ puṇyakṣetram |	དེའི་སླད་དུ་དེ་ནི་། བསོད་ནམས་ཀྱི་ཞིང་བླ་ན་མ་མཆིས་པའོ་༎ དེ་ནི་།
 yenaitatpuṇyakṣetraṃ nāpuṇyakṣetram,	ཞིང་གང་བ་མ་ལགས་། ཞིང་མ་གང་བ་ཡང་མ་ལགས་ཤིང་། ཞིང་མ་ལགས་པ་ཡང་༄༡༤༢བ་མ་ལགས་ཏེ་།
 tenaitadanuttaraṃ puṇyakṣetram |	དེའི་སླད་དུ་དེ་ནི་། བསོད་ནམས་ཀྱི་ཞིང་བླ་ན་མ་མཆིས་པའོ་༎ བཅོམ་ལྡན་འདས་།
 api tu khalu punarbhagavan nātra kaściddharmaḥ samudāgacchati na kṣīyate |	ཡང་དེ་ལ་ཆོས་གང་ཡང་ཡང་དག་པར་འགྲུབ་པར་མི་འགྱུར་། བསམ་པར་མི་འགྱུར་ཏེ་།
 evaṃ tatpuṇyakṣetram |	དེ་ལྟར་ན་། དེ་བསོད་ནམས་ཀྱི་ཞིང་ལགས་སོ་༎
 tatra ca bījaṃ prakṣiptaṃ na vivardhate na parihīyate |	དེ་ལ་ས་བོན་བཏབ་པ་ནི་། རྣམ་པར་མི་འཕེལ་ཞིང་ཡོངས་སུ་མི་འགྲིབ་བོ་༎
 bhagavānāha - kiṃ saṃdhāya mañjuśrīrevaṃ vadasi - tatra kṣetre bījamavaropitaṃ na vivardhate na parihīyate iti?	བཅོམ་ལྡན་འདས་ཀྱིས་བཀའ་སྩལ་པ་། འཇམ་དཔལ་། ཁྱོད་ཀྱིས་ཅི་ལས་བསམ་སྟེ་ཞིང་དེ་ལ་ས་བོན་བཏབ་པ་རྣམ་པར་མི་འཕེལ་ཞིང་ཡོངས་སུ་མི་འགྲིབ་བོ་༎ ཞེས་དེ་སྐད་སྨྲ་།
 mañjuśrīrāha - tathā hi bhagavan acintyaṃ tatkṣetram,	འཇམ་དཔལ་གྱིས་གསོལ་པ་། བཅོམ་ལྡན་འདས་། འདི་ལྟར་། ཞིང་དེ་ནི་། བསམ་གྱིས་མི་ཁྱབ་པ་སྟེ་།
 evaṃ tatpuṇyakṣetram ||	དེ་ལྟར་ན་། དེ་བསོད་ནམས་ཀྱི་ཞིང་ལགས་སོ་༎
 atha khalu tasyāṃ velāyāṃ buddhānubhāvena ṣaḍvikāraṃ mahāpṛthivīcālo 'bhūt,	དེ་ནས་དེའི་ཚེ་སངས་རྒྱས་ཀྱི་མཐུས་ས་ཆེན་པོ་རྣམ་པ་དྲུག་ཏུ་ག-ཡོས་པར་གྱུར་ཏོ་༎
 ṣoḍaśānāṃ ca bhikṣusahasrāṇāmanupādāyāsravebhyaścittāni vimuktāni,	དགེ་སློང་ཁྲི་དྲུག་སྟོང་ནི་། ལེན་པ་མེད་པར་ཟག་པ་རྣམས་ལས་སེམས་རྣམ་པར་གྲོལ་ལོ་༎
 saptānāṃ bhikṣuṇīśatānāṃ trayāṇāṃ copāsakaśatānāṃ catvāriṃśataścopāsikāsahasrāṇāṃ ṣaṣṭeśca kāmāvacarāṇāṃ devakoṭīniyutaśatānāṃ virajo vigatamalaṃ dharmeṣu dharmacakṣurutpannam ||	དགེ་སློང་མ་བདུན་བརྒྱ་དང་། དགེ་བསྙེན་མ་སུམ་བརྒྱ་དང་། དགེ་བསྙེན་མ་བཞི་ཁྲི་དང་། འདོད་པ་ན་སྤྱོད་པའི་ལྷ་བྱེ་བ་ཁྲག་ཁྲིག་དྲུག་ཅུ་ནི་།
 atha khalvāyuṣmānānanda utthāyāsanādekāṃsacīvaraṃ prāvṛtya dakṣiṇaṃ jānumāṇḍalaṃ pṛthivyāṃ pratiṣṭhāpya yena bhagavāṃstenāñjaliṃ praṇamya bhagavantametadavocat - ko bhagavan hetuḥ,	ཆོས་ཀྱི་མིག་རྡུལ་དང་བྲལ་ཞིང་དྲི་མ་མེད་པ་སྐྱེས་སོ་༎ དེ་ནས་ཚེ་དང་ལྡན་པ་ཀུན་དགའ་བོ་སྟན་ལས་ལངས་ཏེ་ཆོས་གོས་ཕྲག་པ་གཅིག་ལ་གཟར་ནས་པུས་མོ་ག-ཡས་པའི་ལྷ་ང་ས་ལ་བཙུགས་ཏེ་བཅོམ་ལྡན་འདས་ག་ལ་བ་དེ་ལོགས་སུ་ཐལ་མོ་སྦྱར་བ་བཏུད་ནས་བཅོམ་ལྡན་འདས་ལ་འདི་སྐད་ཅེས་གསོལ་ཏོ་༎ བཅོམ་ལྡན་འདས་།
 kaḥ pratyayo 'sya mahataḥ pṛthivīcālasya loke prādurbhāvāya?	འཇིག་རྟེན་དུ་དོགས་ཆེར་ག-ཡོས་པ་བྱུང་བ་འདིའི་རྒྱུ་གང་ལགས་། རྐྱེན་གང་ལགས་།
 evamukte bhagavānāyuṣmāntamānandametadavocat - ayamānanda puṇyakṣetranirdeśo nāma dharmaparyāyaḥ pūrvakairapi buddhairbhagavadbhirasminneva pṛthivīpradeśe bhāṣitaḥ | ayamānanda hetuḥ,	༄༡༤༣ཨ་༌༎ དེ་སྐད་ཅེས་གསོལ་པ་དང་། བཅོམ་ལྡན་འདས་ཀྱིས་ཚེ་དང་ལྡན་པ་ཀུན་དགའ་བོ་ལ་འདི་སྐད་ཅེས་བཀའ་སྩལ་ཏོ་༎ ཀུན་དགའ་བོ་། བསོད་ནམས་ཀྱི་ཞིང་བསྟན་པ་ཞེས་བྱ་བའི་ཆོས་ཀྱི་རྣམ་གྲངས་འདི་སྔོན་གྱི་སངས་རྒྱས་བཅོམ་ལྡན་འདས་རྣམས་ཀྱིས་ཀྱང་ས་ཕྱོགས་འདི་ཉིད་དུ་གསུངས་ཏེ་། 
 ayaṃ pratyayo 'sya mahataḥ pṛthivīcālasya loke prādurbhāvāya ||	ཀུན་དགའ་བོ་། འཇིག་རྟེན་དུ་ས་ག-ཡོས་པ་བྱུང་བ་འདིའི་རྒྱུ་ནི་། དེ་ཡིན་ནོ༏་༏རྐྱེན་ནི་། དེ་ཡིན་ནོ་༎ དེ་ནས་བཅོམ་ལྡན་འདས་ལ་ཚེ་དང་ལྡན་པ་ཤའ་རདབ༹་ཏིའི་བུས་འདི་སྐད་ཅེས་གསོལ་ཏོ་༎ བཅོམ་ལྡན་འདས་། འཇམ་དཔལ་། འདི་ནི་། བསམ་གྱིས་མི་ཁྱབ་པའི་དཔལ་ལོ་༎ དེ་ཅིའི་སླད་དུ་ཞེ་ན་། འདི་ལྟར་། འདིའི་སྤོབས་པ་གང་དང་གང་ལགས་པའི་སྤོབས་པ་དེ་དང་དེ་ཉིད་བསམ་གྱིས་མི་ཁྱབ་པ་ཉིད་ལགས་སོ་༎ དེ་ནས་བཅོམ་ལྡན་འདས་ཀྱིས་འཇམ་དཔལ་གཞོན་ནུར་གྱུར་པ་ལ་བཀའ་སྩལ་པ་། འཇམ་དཔལ་། དགེ་སློང་ཤའ་རདབ༹་ཏིའི་བུས་ཚིག་ཇི་སྐད་སྨྲས་པ་དེ་དེ་བཞིན་ཏེ་། འཇམ་དཔལ་གཞོན་ནུར་གྱུར་པའི་སྤོབས་པ་གང་དང་གང་ཡིན་པའི་སྤོབས་པ་དེ་དག་ཐམས་ཅད་ནི་། བསམ་གྱིས་མི་ཁྱབ་པ་ཉིད་དོ་༎ དེ་སྐད་ཅེས་བཀའ་སྩལ་པ་དང་། བཅོམ་ལྡན་འདས་ལ་འཇམ་དཔལ་གཞོན་ནུར་གྱུར་པས་འདི་སྐད་ཅེས་གསོལ་ཏོ་༎ བཅོམ་ལྡན་འདས་། བསམ་གྱིས་མི་ཁྱབ་པ་ནི་། སྤོབས་པར་མི་འགྱུར་རོ་༎ གལ་ཏེ་བསམ་གྱིས་མི་ཁྱབ་པ་སྤོབས་པར་འགྱུར་ན་ནི་། བསམ་དུ་མ་མཆིས་པ་ཉིད་དུ་འགྱུར་། ཡང་གང་བསམ་གྱིས་མི་ཁྱབ་པ་མ་༄༡༤༣བ་ལགས་པའི་བསམ་གྱིས་མི་ཁྱབ་པ་ནི་། ཅི་ཡང་མ་མཆིས་སོ་༎ བཅོམ་ལྡན་འདས་། སྒྲ་ཐམས་ཅད་ནི་། བསམ་གྱིས་མི་ཁྱབ་པ་སྟེ་། བསམ་གྱིས་མི་ཁྱབ་པ་ཉིད་ནི་། སྒྲ་མ་ལགས་སོ་༎ སྒྲ་མ་ལགས་པ་དང༏་སྒྲ་མ་ལགས་པ་ཡང་མ་ལགས་པ་ནི་། བསྟན་པར་མི་ནུས་སོ་༎ བཅོམ་ལྡན་འདས་ཀྱིས་བཀའ་སྩལ་པ་། འཇམ་དཔལ་། ཁྱོད་བསམ་གྱིས་མི་ཁྱབ་པའི་ཏིང་ངེ་འཛིན་ལ་སྙོམས་པར་འཇུག་གམ༏་འཇམ་དཔལ་གྱིས་གསོལ་པ་། བཅོམ་ལྡན་འདས་། དེ་ནི་། མ་ལགས་ཏེ་། བསམ་གྱིས་མི་ཁྱབ་པའི་ཏིང་འཛིན་ལ་བདག་སྙོམས་པར་མི་འཇུག་གོ་། དེ་ཅིའི་སླད་དུ་ཞེ་ན་། བཅོམ་ལྡན་འདས་། འདི་ལྟར་། བདག་ཉིད་བསམ་གྱིས་མི་ཁྱབ་པའི་ཏིང་ངེ་འཛིན་ལགས་པའི་སླད་དུའོ་༎ བཅོམ་ལྡན་འདས་། གལ་ཏེ་བདག་བསམ་དུ་རུང་བ་ལགས་ན་ནི་། བདག་བསམ་གྱིས་མི་ཁྱབ་པའི་ཏིང་འཛིན་ལ་སྙོམས་པར་འཇུག་གོ་། བཅོམ་ལྡན་འདས་། ཏིང་ངེ་འཛིན་ཅེས་བགྱི་བ་དེ་ནི་། བསམ་དུ་མ་མཆིས་པ་། བསམ་གྱིས་མི་ཁྱབ་པ་། བསམ་གྱིས་མི་ལང་བ་ལགས་ན་། ཇི་ལྟར་བསམ་གྱིས་མི་ཁྱབ་པའི་ཏིང་ངེ་འཛིན་ལ་སྙོམས་པར་འཇུག་པར་བགྱི་། དེ་ལྟ་ལགས་ཀྱིས་ཀྱང་བཅོམ་ལྡན་འདས་། བདག་སྔོན་ལས་དང་པོ་པའི་ཚེ་ན་བསམ་གྱིས་མི་ཁྱབ་པའི་ཏིང་ངེ་འཛིན་ལ་སྙོམས་པར་འཇུག་གོ་། སྙམ་དུ་དེ་སྙམ་བསམ་པར་གྱུར་ཏོ་༎ བཅོམ་ལྡན་འདས་། དེ་ལྟར་ན་། བདག་བསམ་གྱིས་མི་ཁྱབ་པའི་ཏིང་ངེ་འཛིན་ལ་སྙོམས་པར་འཇུག་གོ་། སྙམ་དུ་ཡང་དེ་ལ་སེམས་པ་ཀུན་དུ་འབྱུང་བ་མ་༄༡༤༤ཨ་༌༎ མཆིས་སོ་༎ བཅོམ་ལྡན་འདས་། འདི་ལྟ་སྟེ་། དཔེར་ན་། འཕོང་གི་སློབ་དཔོན་ནི་། སྔོན་ལས་དང་པོ་པའི་ས་ན་སློབ་པའི་ཚེ་འདི་སྙམ་དུ་། བ་ལང་གི་ཕུར་པ་དག་ལ་ཕོག་པར་བྱའོ་༎ སྙམ་དུ་སེམས་སོ་༎ དེ་གང་གི་ཚེ་སྐྲ་ལ་ཕོག་པར་གྲུབ་པར་གྱུར་པ་དེའི་ཚེ་འདི་ལྟར་སྐྲ་ལ་ཕོག་པར་ལེགས་པར་ལོབས་པའི་སླད་དུ་དེ་ཡང་འདི་སྙམ་དུ་། བདག་གིས་བ་ལང་གི་ཕུར་པ་དག་ལ་ཕོག་པར་བྱའོ་༎ སྙམ་དུ་སེམས་པ་མི་འབྱུང་ངོ་༎ ཅི་སྟེ་གང་གི་ཚེ་སྐྲ་ལ་ཕོག་པར་འཚལ་བ་དེའི་ཚེ་བསྒྲིམ་མི་འཚལ་བར་ཕོག་པར་འགྱུར་རོ་༎ བཅོམ་ལྡན་འདས་། དེ་བཞིན་དུ་བདག་སྔོན་ནི་། བསམ་གྱིས་མི་ཁྱབ་པའི་ཏིང་ངེ་འཛིན་ལ་སྙོམས་པར་འཇུག་གོ་། སྙམ་དུ་དེ་སྙམ་བསམ་པར་གྱུར་ཏོ་༎ གང་གི་ཚེ་བདག་གི་ཏིང་ངེ་འཛིན་དེ་ལ་སྙོམས་པར་ཞུགས་ནས་ཏིང་འཛིན་འདིས་གནས་པ་དེའི་ཚེ་བདག་སླར་ཡང་ཏིང་ངེ་འཛིན་འདིས་གནས་པར་བགྱིའོ་༎ སྙམ་དུ་མི་སེམས་སོ་༎ དེ་ཅིའི་སླད་དུ་ཞེ་ན་། གང་དང་གང་གི་ཚེ་ཏིང་ངེ་འཛིན་འདིས་གནས་པ་དེ་དང་དེའི་ཚེ་ཏིང་ངེ་འཛིན་འདི་གདགས་སུ་མ་མཆིས་པའི་སླད་དུའོ་༎ དེ་ནས་བཅོམ་ལྡན་འདས་ལ་ཚེ་དང་ལྡན་པ་ཤའ་རདབ༹་ཏིའི་བུས་འདི་སྐད་ཅེས་གསོལ་ཏོ་༎ བཅོམ་ལྡན་འདས་། འཇམ་དཔལ་གཞོན་ནུར་གྱུར་པ་ནི་། བསམ་གྱིས་མི་ཁྱབ་པའི་ཏིང་ངེ་འཛིན་གནས་པ་དེའི་ཚེ་འདི་ལ་ཡིད་མི་རྟོན་ན་། བཅོམ་ལྡན་འདས་། བསམ་གྱིས་མི་ཁྱབ་པའི་ཏིང་ངེ་འཛིན་འདི་བས་ཆེས་ཞི་༄༡༤༤བ་པའི་ཏིང་ངེ་འཛིན་གཞན་ལྟ་མཆིས་སམ་། དེ་ནས་འཇམ་དཔལ་གཞོན་ནུར་གྱུར་པས་ཚེ་དང་ལྡན་པ་ཤའ་རདབ༹་ཏིའི་བུ་ལ་འདི་སྐད་ཅེས་སྨྲས་སོ་༎ བཙུན་པ་ཤའ་རདབ༹་ཏིའི་བུ་། འདི་སྐད་དུ་བསམ་གྱིས་མི་ཁྱབ་པའི་ཏིང་ངེ་འཛིན་བས་ཆེས་ཞི་བའི་ཏིང་ངེ་འཛིན་གཞན་ལྟ་མཆིས་སམ་ཞེས་འདྲི་ན་། བཙུན་པ་ཤའ་རདབ༹་ཏིའི་བུ་། ཁྱོད་ཀྱིས་བསམ་གྱིས་མི་ཁྱབ་པའི་ཏིང་ངེ་འཛིན་འདི་ཞི་བ་ཡིན་པར་ཇི་ལྟར་ཤེས་། བཙུན་པ་ཤའ་རདབ༹་ཏིའི་བུ་། གལ་ཏེ་བསམ་གྱིས་མི་ཁྱབ་པའི་ཏིང་ངེ་འཛིན་འདི་ཡོད་ཅིང་དམིགས་ན་ནི་། བསམ་གྱིས་མི་ཁྱབ་པའི་ཏིང་ངེ་འཛིན་འདི་བས་ཆེས་ཞི་བའི་ཏིང་ངེ་འཛིན་གཞན་ཡོད་པར་འགྱུར་རོ་༎ ཤའ་རདབ༹་ཏིའི་བུས་སྨྲས་པ་། འཇམ་དཔལ་། བསམ་གྱིས་མི་ཁྱབ་པའི་ཏིང་ངེ་འཛིན་འདི་མེད་ཅིང་མི་དམིགས་པ་ཡིན་ནམ་། འཇམ་དཔལ་གྱིས་སྨྲས་པ་། བཙུན་པ་ཤའ་རདབ༹་ཏིའི་བུ་། འདི་ལྟར་། དེ་ནི་། བསམ་གྱིས་མི་ཁྱབ་པའི་ཏིང་ངེ་འཛིན་ཏེ་། དེ་བས་ན་། བསམ་གྱིས་མི་ཁྱབ་པའི་ཏིང་ངེ་འཛིན་འདི་ནི་། མེད་དེ་། མི་དམིགས་པའོ་༎ དེ་ལྟ་མོད་ཀྱི་། བཙུན་པ་ཤའ་རདབ༹་ཏིའི་བུ་། བསམ་གྱིས་མི་ཁྱབ་པའི་ཏིང་འཛིན་མ་ཐོབ་པ་ནི་། སུ་ཡང་མེད་དོ་༎ བཙུན་པ་ཤའ་རདབ༹་ཏིའི་བུ་། སེམས་ཅན་ཐམས་ཅད་ཀྱང་བསམ་གྱིས་མི་ཁྱབ་པའི་ཏིང་ངེ་འཛིན་ཐོབ་བོ་༎ དེ་ཅིའི་ཕྱིར་ཞེ་ན་། བསམ་པ་ཐམས་ཅད་བསམ་གྱིས་མི་ཁྱབ་པ་ཡིན་ལ་། གང་བསམ་གྱིས་མི་ཁྱབ་པ་དེ་ནི་། བསམ་གྱིས་མི་ཁྱབ་པའི་ཏིང་ངེ་འཛིན་ཏེ་། དེ་བས་ན་། སེམས་ཅན་ཐམས་ཅད་བསམ་གྱིས་མི་ཁྱབ་པའི་༄༡༤༥ཨ་༌༎ ཏིང་ངེ་འཛིན་འདི་ཐོབ་བོ་༎༎ བམ་པོ་གཉིས་པ་སྟེ་། ཐ་མ་། དེ་ནས་བཅོམ་ལྡན་འདས་ཀྱིས་འཇམ་དཔལ་གཞོན་ནུར་གྱུར་པ་ལ་འདི་སྐད་ཅེས་བཀའ་སྩལ་ཏོ་༎ འཇམ་དཔལ༏་ཁྱོད་ཀྱིས་ཟབ་མོ་ཟབ་པའི་གནས་འདི་ལྟ་བུ་ཐམས་ཅད་བསྟན་པ་ལེགས་སོ་༎ ལེགས་སོ་༎ འདི་ལྟར་། འཇམ་དཔལ་། ཁྱོད་ནི་། སྔོན་གྱི་རྒྱལ་བ་ལ་བྱ་བ་བྱས་པ་སྟེ་། མི་དམིགས་པར་ཚངས་པར་སྤྱོད་པ་ཡུན་རིང་དུ་སྤྱད་པའོ་༎ ཅི་། འཇམ་དཔལ་ཁྱོད་ཤེས་རབ་ཀྱི་ཕ་རོལ་ཏུ་ཕྱིན་པ་ལ་གནས་ཏེ་། དེ་སྐད་སྨྲའོ་༎ སྙམ་དུ་སེམས་སམ་། འཇམ་དཔལ་གྱིས་གསོལ་པ་། བཅོམ་ལྡན་འདས༏་གལ་ཏེ་བདག་འདི་ལྟར་། ཤེས་རབ་ཀྱི་ཕ་རོལ་ཏུ་ཕྱིན་པ་ལ་གནས་ནས་འདི་སྐད་མཆི་ན་ནི་། འོ་ན་དམིགས་པ་ལ་གནས་ཏེ་དེ་སྐད་མཆི་བར་འགྱུར་། བདག་ཏུ་འདུ་ཤེས་པ་ལ་གནས་ནས་དངོས་པོའི་འདུ་ཤེས་ཀྱི་བར་ལ་གནས་ཏེ་དེ་སྐད་མཆི་བར་འགྱུར་རོ་༎ དེ་བས་ན་། ཤེས་རབ་ཀྱི་ཕ་རོལ་ཏུ་ཕྱིན་པ་ལ་གནས་ཏེ་འདི་སྐད་ཅེས་མི་མཆིའོ་༎ དེ་ཅིའི་སླད་དུ་ཞེ་ན་། བཅོམ་ལྡན་འདས་། གལ་ཏེ་ཤེས་རབ་ཀྱི་ཕ་རོལ་ཏུ་ཕྱིན་པ་ལ་གནས་སུ་གྱུར་ཏམ་། ཅི་སྟེ་གནས་མ་ལགས་པ་ཞིག་ཏུ་གྱུར་ན་། ཤེས་རབ་ཀྱི་ཕ་རོལ་ཏུ་ཕྱིན་པ་མ་ལགས་པར་འགྱུར་རོ་༎ བཅོམ་ལྡན་འདས༏་བདག་གི་གནས་ནི་། ཤེས་རབ་ཀྱི་ཕ་རོལ་ཏུ་ཕྱིན་པའི་གནས་ཏེ་། གནས་མ་མཆིས་པ་། ཀུན་ནས་བྱུང་བ་མ་མཆིས་པ་། གོ་སྐབས་མ་མཆིས་པ་། འབྱུང་བ་མ་མཆིས་པ་ལགས་༄༡༤༥བ་སོ༏་༏དེ་ལྟར་ན་། གནས་དེ་ནི་། ཆོས་གང་གི་གནས་ཀྱང་མ་ལགས་སོ་༎ དེའི་སླད་དུ་གནས་དེ་ནི་། བསམ་གྱིས་མི་ཁྱབ་པའི་གནས་ཏེ་། ཤེས་རབ་ཀྱི་ཕ་རོལ་ཏུ་ཕྱིན་པའི་གནས་ལགས་སོ་༎ བཅོམ་ལྡན་འདས་།
