skt	tib
 (vaidya 75) vajracchedikā nāma triśatikā prajñāpāramitā |	༄༢༡༥ཨ་། །རྒྱ་གར་སྐད་དུ་། ཨའརྱ་བཛྲ་ཙཚེ་ད་ཀ་ནའ་མ་པྲ་ཛཉའ་པ་ར་མི་ཏ་མ་ཧའ་ཡ་ན་སའུ་ཏྲ་། བོད་སྐད་དུ་། འཕགས་པ་ཤེས་རབ་ཀྱི་ཕ་རོལ་ཏུ་ཕྱིན་པ་རྡོ་རྗེ་གཅོད་པ་ཞེས་བྱ་བ་ཐེག་པ་ཆེན་པོའི་མདོ་། 
 | namo bhagavatyā āryaprajñāpāramitāyai ||	སངས་རྒྱས་དང་བྱང་ཆུབ་སེམས་དཔའ་ཐམས་ཅད་ལ་ཕྱག་འཚལ་ལོ་༎
 evaṃ mayā śrutam |	འདི་སྐད་བདག་གིས་ཐོས་པ་དུས་གཅིག་ན་།
 ekasmin samaye bhagavān śrāvastyāṃ viharati sma jetavane' nāthapiṇḍadasyārāme mahatā bhikṣusaṃghena sārthaṃ trayodaśabhirbhikṣuśataiḥ saṃbahulaiśca bodhisattvairmahāsattvaiḥ |	བཅོམ་ལྡན་འདས་མཉན་དུ་ཡོད་པ་ན་རྒྱལ་བུ་རྒྱལ་བྱེད་ཀྱི་ཚལ་མགོན་མེད་ཟས་སྦྱིན་གྱི་ཀུན་དགའ་ར་བ་ན་དགེ་སློང་སྟོང་ཉིས་བརྒྱ་ལྔ་བཅུའི་དགེ་སློང་གི་དགེ་འདུན་ཆེན་པོ་དང་། བྱང་ཆུབ་སེམས་དཔའ་སེམས་དཔའ་ཆེན་པོ་རབ་ཏུ་མང་པོ་དང་ཐབས་གཅིག་ཏུ་བཞུགས་ཏེ་།
 atha khalu bhagavān pūrvāhṇakālasamaye nivāsya pātracīvaramādāya śrāvastīṃ mahānagarīṃ piṇḍāya prāvikṣat |	དེ་ནས་བཅོམ་ལྡན་འདས་སྔ་དྲོའི་དུས་ཀྱི་ཚེ་ཤམ་ཐབས་དང་ཆོས་གོས་སྐུ་ལ་གསོལ་ཏེ་ལྷུང་བཟེད་༄༢༡༥བ་བསྣམས་ནས་མཉན་ཡོད་ཀྱི་གྲོང་ཁྱེར་ཆེན་པོར་བསོད་སྙོམས་ཀྱི་ཕྱིར་ཞུགས་སོ་༎
 atha khalu bhagavān śrāvastīṃ mahānagarīṃ piṇḍāya caritvā kṛtabhaktakṛtyaḥ paścādbhaktapiṇḍapātapratikrāntaḥ pātracīvaraṃ pratiśāmya pādau prakṣālya nyaṣīdatprajñapta evāsane paryaṅkamābhujya ṛjuṃ kāyaṃ praṇidhāya pratimukhīṃ smṛtimupasthāpya |	དེ་ནས་བཅོམ་ལྡན་འདས་མཉན་ཡོད་ཀྱི་གྲོང་ཁྱེར་ཆེན་པོར་བསོད་སྙོམས་ཀྱི་ཕྱིར་གཤེགས་ནས་བསོད་སྙོམས་ཀྱི་ཞལ་ཟས་མཇུག་ཏུ་གསོལ་ཏེ་ཟས་ཀྱི་བྱ་བ་མཛད་ནས་ཟས་ཕྱི་མའི་བསོད་སྙོམས་སྤངས་པས་། ལྷུང་བཟེད་དང་ཆོས་གོས་བཞག་ནས་ཞབས་བསིལ་ཏེ་གདན་བཤམས་པ་ལ་སྐྱིལ་མོ་ཀྲུང་བཅས་ནས་སྐུ་དྲང་པོར་བསྲང་སྟེ་དྲན་པ་མངོན་དུ་བཞག་། ནས་བཞུགས་སོ་༎ 
 atha khalu saṃbahulā bhikṣavo yena bhagavāṃstenopasaṃkrāman | upasaṃkramya bhagavataḥ pādau śirobhirabhivandya bhagavantaṃ triṣpradakṣiṇīkṛtya ekānte nyaṣīdan || 1 ||	དེ་ནས་དགེ་སློང་མང་པོ་བཅོམ་ལྡན་འདས་ག་ལ་བ་དེར་དོང་སྟེ་ལྷགས་ནས་བཅོམ་ལྡན་འདས་ཀྱི་ཞབས་ལ་མགོ་བོས་ཕྱག་འཚལ་ཏེ་བཅོམ་ལྡན་འདས་ལ་ལན་གསུམ་བསྐོར་བ་བྱས་ནས་ཕྱོགས་གཅིག་ཏུ་འཁོད་དོ་༎
 tena khalu punaḥ samayenāyuṣmān subhutistasyāmeva parṣadi saṃnipatito 'bhūtsaṃniṣaṇṇaḥ |	ཡང་དེའི་ཚེ་ཚེ་དང་ལྡན་པ་རབ་འབྱོར་འཁོར་དེ་ཉིད་དུ་འདུས་པར་གྱུར་ཏེ་འདུག་གོ་།
 atha khalvāyuṣmān subhūtirutthāyāsanādekāṃsamuttarāsaṅgaṃ kṛtvā dakṣiṇaṃ jānumaṇḍalaṃ pṛthivyāṃ pratiṣṭhāpya yena bhagavāṃstenāñjaliṃ praṇamya bhagavantametadavocat - āścaryaṃ bhagavan,	དེ་ནས་ཚེ་དང་ལྡན་པ་རབ་འབྱོར་སྟན་ལས་ལངས་ཏེ་བླ་གོས་ཕྲག་པ་གཅིག་ཏུ་གཟར་ནས་པུས་མོ་ག-ཡས་པའི་ལྷ་ང་ས་ལ་བཙུགས་ཏེ་བཅོམ་ལྡན་འདས་ག་ལ་བ་དེ་ལོགས་སུ་ཐལ་མོ་སྦྱར་བ་བཏུད་དེ་བཅོམ་ལྡན་འདས་ལ་འདི་སྐད་ཅེས་གསོལ་ཏོ་༎ བཅོམ་ལྡན་འདས་།
 paramāścaryaṃ sugata, yāvadeva tathāgatenārhatā samyaksaṃbuddhena bodhisattvā mahāsattvā anuparigṛhītāḥ parameṇānugraheṇa |	དེ་བཞིན་གཤེགས་པ་དགྲ་བཅོམ་པ་ཡང་དག་པར་རྫོགས་པའི་སངས་རྒྱས་ཀྱིས་བྱང་ཆུབ་སེམས་དཔའ་སེམས་དཔའ་ཆེན་པོ་རྣམས་ལ་ཕན་གདགས་པའི་དམ་པ་ཇི་སྙེད་པས་ཕན་བཏགས་པ་དང་། དེ་བཞིན་གཤེགས་པ་དགྲ་བཅོམ་པ་ཡང་དག་པར་རྫོགས་པའི་༄༢༡༦ཨ་༌༎
 āścaryaṃ bhagavan yāvadeva tathāgatenārhatā samyaksaṃbuddhena bodhisattvā mahāsattvāḥ parīnditāḥ paramayā parīndanayā |	སངས་རྒྱས་ཀྱིས་བྱང་ཆུབ་སེམས་དཔའ་སེམས་དཔའ་ཆེན་པོ་རྣམས་ཡོངས་སུ་གཏད་པའི་དམ་པ་ཇི་སྙེད་པས་ཡོངས་སུ་གཏད་པ་ནི་། བཅོམ་ལྡན་འདས་། ངོ་མཚར་ལགས་སོ་༎ བདེ་བར་གཤེགས་པ་། ངོ་མཚར་ལགས་སོ་༎ བཅོམ་ལྡན་འདས་།
 tatkathaṃ bhagavan bodhisattvayānasaṃprasthitena kulaputreṇa vā kuladuhitrā vā sthātavyaṃ kathaṃ pratipattavyaṃ kathaṃ cittaṃ pragrahītavyam?	བྱང་ཆུབ་སེམས་དཔའི་ཐེག་པ་ལ་ཡང་དག་པར་ཞུགས་པས་ཇི་ལྟར་གནས་པར་བགྱི་། ཇི་ལྟར་བསྒྲུབ་པར་བགྱི་། ཇི་ལྟར་སེམས་རབ་ཏུ་གཟུང་བར་བགྱི་།
 evamukte bhagavānāyuṣmantaṃ subhūtimetadavocat - sādhu sādhu subhūte,	དེ་སྐད་ཅེས་གསོལ་པ་དང་། བཅོམ་ལྡན་འདས་ཀྱིས་ཚེ་དང་ལྡན་པ་རབ་འབྱོར་ལ་འདི་སྐད་ཅེས་བཀའ་སྩལ་ཏོ༏་༏རབ་འབྱོར་། ལེགས་སོ་༎ ལེགས་སོ་༎
 evametatsubhūte,	རབ་འབྱོར་། དེ་དེ་བཞིན་ནོ་༎
 evametadyathā vadasi |	དེ་དེ་བཞིན་ཏེ་།
 anuparigṛhītāstathāgatena bodhisattvā mahāsattvāḥ parameṇānugraheṇa |	དེ་བཞིན་གཤེགས་པས་བྱང་ཆུབ་སེམས་དཔའ་སེམས་དཔའ་ཆེན་པོ་རྣམས་ལ་ཕན་གདགས་པའི་དམ་པས་ཕན་བཏགས་སོ་༎ 
 parīnditāstathāgatena bodhisattvā mahāsattvāḥ paramayā parīndanayā |	དེ་བཞིན་གཤེགས་པས་བྱང་ཆུབ་སེམས་དཔའ་སེམས་དཔའ་ཆེན་པོ་རྣམས་ལ་ཡོངས་སུ་གཏད་པའི་དམ་པས་ཡོངས་སུ་གཏད་དོ་༎ རབ་འབྱོར་།
 tena hi subhūte śṛṇu, sādhu ca suṣṭhu ca manasi kuru, bhāṣiṣye 'haṃ te - yathā bodhisattvayānasaṃprasthitena sthātavyaṃ yathā pratipattavyaṃ yathā cittaṃ pragrahītavyam |	དེའི་ཕྱིར་ཉོན་ལ་ལེགས་པར་རབ་ཏུ་ཡིད་ལ་ཟུངས་ཤིག་དང་། བྱང་ཆུབ་སེམས་དཔའི་ཐེག་པ་ལ་ཡང་དག་པར་ཞུགས་པས་ཇི་ལྟར་གནས་པར་བྱ་བ་དང་། ཇི་ལྟར་བསྒྲུབ་པར་བྱ་བ་དང་། ཇི་ལྟར་སེམས་རབ་ཏུ་གཟུང་བར་བྱ་བ་ངས་ཁྱོད་ལ་བཤད་དོ་༎
 evaṃ bhagavan ityāyuṣyān subhūtirbhagavataḥ pratyaśrauṣīt ||2 ||	བཅོམ་ལྡན་འདས་། དེ་བཞིན་ནོ་༎ ཞེས་གསོལ་ནས་ཚེ་དང་ལྡན་པ་རབ་འབྱོར་བཅོམ་ལྡན་འདས་༄༢༡༦བ་ཀྱི་ལྟར་ཉན་པ་དང་། བཅོམ་ལྡན་འདས་ཀྱིས་འདི་སྐད་ཅེས་བཀའ་སྩལ་ཏོ་༎ རབ་འབྱོར་།
 bhagavānasyaitadavocat - iha subhūte bodhisattvayānasaṃprasthitenaiva cittamutpādayitavyam	འདི་ལ་བྱང་ཆུབ་སེམས་དཔའི་ཐེག་པ་ལ་ཡང་དག་པར་ཞུགས་པས་འདི་སྙམ་དུ་།
 - yāvantaḥ subhūte sattvāḥ sattvadhātau sattvasaṃgraheṇa saṃgṛhītā aṇḍajā vā jarāyujā	བདག་གིས་ཇི་ཙམ་སེམས་ཅན་དུ་བསྡུ་བས་བསྡུས་པ་སྒོ་ང་ལས་སྐྱེས་པའམ་། མངལ་ནས་སྐྱེས་པའམ་། དྲོད་གཤེར་ལས་སྐྱེས་པའམ་། བརྫུས་ཏེ་སྐྱེས་པའམ་། གཟུགས་ཅན་ནམ་།
 vā saṃsvedajā vā aupapādukā vā rūpiṇo vā arūpiṇo vā saṃjñino vā asaṃjñino vā naivasaṃjñino nāsaṃjñino vā,	གཟུགས་མེད་པའམ་། འདུ་ཤེས་ཅན་ནམ་། འདུ་ཤེས་མེད་པའམ་། འདུ་ཤེས་མེད་འདུ་ཤེས་མེད་མིན་ནམ་།
 yāvān kaścitsattvadhātuḥ prajñapyamānaḥ prajñapyate, te ca mayā sarve 'nupadhiśeṣe nirvāṇadhātau parinirvāpayitavyāḥ |	སེམས་ཅན་གྱི་ཁམས་ཇི་ཙམ་སེམས་ཅན་དུ་གདགས་པས་བཏགས་པ་དེ་དག་ཐམས་ཅད་ཕུང་པོ་ལྷག་མ་མེད་པའི་མྱ་ངན་ལས་འདས་པའི་དབྱིངས་སུ་ཡོངས་སུ་མྱ་ངན་ལས་བཟླའོ་༎
 evamaparimāṇānapi sattvān parinirvāpya na kaścitsattvaḥ parinirvāpito bhavati |	དེ་ལྟར་སེམས་ཅན་ཚད་མེད་པ་ཡོངས་སུ་མྱ་ངན་ལས་བཟླས་ཀྱང་སེམས་ཅན་གང་ཡང་ཡོངས་སུ་མྱ་ངན་ལས་བཟླས་པར་གྱུར་པ་མེད་དོ་༎ སྙམ་དུ་སེམས་བསྐྱེད་པར་བྱའོ་༎
 tatkasya hetoḥ?	དེ་ཅིའི་ཕྱིར་ཞེ་ན་། རབ་འབྱོར་།
 sacetsubhūte bodhisattvasya sattvasaṃjñā pravarteta,	གལ་ཏེ་བྱང་ཆུབ་སེམས་དཔའ་སེམས་ཅན་དུ་འདུ་ཤེས་འཇུག་ན་།
 na sa bodhisattva iti vaktavyaḥ |	དེ་བྱང་ཆུབ་སེམས་དཔའ་ཞེས་མི་བྱ་བའི་ཕྱིར་རོ་༎
 tatkasya hetoḥ?	དེ་ཅིའི་ཕྱིར་ཞེ་ན་། རབ་འབྱོར་།
 na sa subhūte bodhisattvo vaktavyo yasya sattvasaṃjñā pravarteta,	གང་སེམས་ཅན་དུ་འདུ་ཤེས་འཇུག་གམ་།
 jīvasaṃjñā vā pudgalasaṃjñā va pravarteta || 3 ||	སྲོག་ཏུ་འདུ་ཤེས་འཇུག་གམ་། གང་ཟག་ཏུ་འདུ་ཤེས་འཇུག་ན་། དེ་བྱང་ཆུབ་སེམས་དཔའ་ཞེས་མི་བྱ་བའི་ཕྱིར་རོ་༎
 (vajr, vaidya 76) api tu khalu punaḥ subhute na bodhisattvena vastupratiṣṭhitena dānaṃ dātavyam,	ཡང་རབ་འབྱོར་། བྱང་ཆུབ་སེམས་དཔས་དངོས་པོ་ལ་མི་གནས་པར་སྦྱིན་པ་སྦྱིན་ནོ་༎
 na kvacitpratiṣṭhitena dānaṃ dātavyam |	ཆོས་གང་ལ་ཡང་མི་གནས་པར་༄༢༡༧ཨ་༌༎ སྦྱིན་པ་སྦྱིན་ནོ་༎
 na rūpapratiṣṭhitena dānaṃ dātavyam |	གཟུགས་ལའང་མི་གནས་པར་སྦྱིན་པ་སྦྱིན་པར་བྱའོ་༎
 na śabdagandharasaspraṣṭavyadharmeṣu pratiṣṭhitena dānaṃ dātavyam |	སྒྲ་དང་། དྲི་དང་། རོ་དང་། རེག་བྱ་དང་། ཆོས་ལའང་མི་གནས་པར་སྦྱིན་པ་སྦྱིན་ནོ༏་༏རབ་འབྱོར་།
 evaṃ hi sūbhūte bodhisattvena mahāsattvena dānaṃ dātavyaṃ yathā na nimittasaṃjñāyāmapi pratitiṣṭhet |	ཅི་ནས་མཚན་མར་འདུ་ཤེས་པ་ལའང་མི་གནས་པ་དེ་ལྟར་བྱང་ཆུབ་སེམས་དཔས་སྦྱིན་པ་སྦྱིན་ནོ་༎ 
 tatkasya hetoḥ?	དེ་ཅིའི་ཕྱིར་ཞེ་ན་། རབ་འབྱོར་།
 yaḥ subhūte bodhisattvo 'pratiṣṭhito dānaṃ dadāti,	བྱང་ཆུབ་སེམས་དཔའ་གང་མི་གནས་པར་སྦྱིན་པ་སྦྱིན་པ་དེའི་བསོད་ནམས་ཀྱི་ཕུང་པོ་ནི་། རབ་འབྱོར་།
 tasya subhūte puṇyaskandhasya na sukaraṃ pramāṇāmudgrahītum |	ཚད་གཟུང་བར་སླ་བ་མ་ཡིན་པའི་ཕྱིར་རོ་༎
 tatkiṃ manyase subhūte sukaraṃ pūrvasyāṃ diśi ākāśasya pramāṇamudgrahītum?	རབ་འབྱོར་། འདི་ཇི་སྙམ་དུ་སེམས་། ཤར་ཕྱོགས་ཀྱི་ནམ་མཁའི་ཚད་གཟུང་བར་སླའམ་།
 subhūtirāha - no hīdaṃ bhagavan |	རབ་འབྱོར་གྱིས་གསོལ་པ་། བཅོམ་ལྡན་འདས་། དེ་ནི་།
 bhagavānāha - evaṃ dakṣiṇapaścimottarāsu adha ūrdhvaṃ digvidikṣu samantāddaśasu dikṣu sukaramākāśasya pramāṇamudgrahītum?	མ་ལགས་སོ་༎ བཅོམ་ལྡན་འདས་ཀྱིས་བཀའ་སྩལ་པ་། དེ་བཞིན་དུ་ལྷོ་དང་། ནུབ་དང་། བྱང་དང་། སྟེང་དང་། འོག་གི་ཕྱོགས་དང་། ཕྱོགས་མཚམས་དང་། ཕྱོགས་བཅུའི་ནམ་མཁའི་ཚད་གཟུང་བར་སླའམ་།
 subhūtirāha - no hīdaṃ bhagavan |	རབ་འབྱོར་གྱིས་གསོལ་པ་། བཅོམ་ལྡན་འདས་། དེ་ནི་། མ་ལགས་སོ་༎ བཅོམ་ལྡན་འདས་ཀྱིས་བཀའ་སྩལ་པ་།
 bhagavānāha - evameva subhūte yo bodhisattvo 'pratiṣṭhito dānaṃ dadāti, tasya subhūte puṇyaskandhasya na sukaraṃ pramāṇamudgrahītum | evaṃ hi subhūte bodhisattvayānasaṃprasthitena dānaṃ dātavyaṃ yathā na nimittasaṃjñāyāmapi pratitiṣṭhet || 4 ||	རབ་འབྱོར་། དེ་བཞིན་དུ་བྱང་ཆུབ་སེམས་དཔའ་གང་མི་གནས་པའི་སྦྱིན་པ་སྦྱིན་པ་དེའི་བསོད་ནམས་ཀྱི་ཕུང་པོ་ཡང་ཚད་གཟུང་བར་སླ་བ་མ་ཡིན་ནོ་༎ རབ་འབྱོར་།
 tatkiṃ manyase subhūte lakṣaṇasaṃpadā tathāgato draṣṭavyaḥ?	འདི་ཇི་སྙམ་དུ་སེམས་། མཚན་ཕུན་སུམ་ཚོགས་པས་དེ་བཞིན་གཤེགས་པར་བལྟའམ་།
 subhūtirāha - no hīdaṃ bhagavan |	རབ་འབྱོར་གྱིས་གསོལ་པ་། བཅོམ་ལྡན་འདས་། ༄༢༡༧བ་དེ་ནི༏་མ་ལགས་ཏེ་།
 na lakṣaṇasaṃpadā tathāgato draṣṭavyaḥ |	མཚན་ཕུན་སུམ་ཚོགས་པས་དེ་བཞིན་གཤེགས་པར་མི་བལྟའོ་༎
 tatkasya hetoḥ?	དེ་ཅིའི་སླད་དུ་ཞེ་ན་།
 yā sā bhagavan lakṣaṇasaṃpattathāgatena bhāṣitā saivālakṣaṇasaṃpat |	དེ་བཞིན་གཤེགས་པས་མཚན་ཕུན་སུམ་ཚོགས་པར་གང་གསུངས་པ་དེ་ཉིད་མཚན་ཕུན་སུམ་ཚོགས་པ་མ་མཆིས་པའི་སླད་དུའོ་༎
 evamukte bhagavānāyuṣmantaṃ subhūtimetadavocat yāvatsubhūte lakṣaṇasaṃpat tāvanmṛṣā,	དེ་སྐད་ཅེས་གསོལ་པ་དང་། བཅོམ་ལྡན་འདས་ཀྱིས་ཚེ་དང་ལྡན་པ་རབ་འབྱོར་ལ་འདི་སྐད་ཅེས་བཀའ་སྩལ་ཏོ་༎ རབ་འབྱོར་འདི་ཇི་སྙམ་དུ་སེམས་། མཚན་ཕུན་སུམ་ཚོགས་པ་དེ་ཙམ་དུ་རྫུན་ནོ་༎
 yāvadalakṣaṇasaṃpat tāvanna mṛṣeti hi lakṣaṇālakṣaṇatastathāgato draṣṭavyaḥ || 5 ||	ཇི་ཙམ་དུ་མཚན་ཕུན་སུམ་ཚོགས་པ་མེད་པ་དེ་ཙམ་དུ་མི་རྫུན་ཏེ་། དེ་ལྟར་དེ་བཞིན་གཤེགས་པ་ལ་མཚན་དང་མཚན་མེད་པར་བལྟའོ་༎
 evamukte āyuṣmān subhūtirbhagavantametadavocat - asti bhagavan |	དེ་སྐད་ཅེས་བཀའ་སྩལ་པ་དང་། བཅོམ་ལྡན་འདས་ལ་ཚེ་དང་ལྡན་པ་རབ་འབྱོར་གྱིས་འདི་སྐད་ཅེས་གསོལ་ཏོ་༎ བཅོམ་ལྡན་འདས་།
 kecitsattvā bhaviṣyantyanāgate 'dhvani paścime kāle paścime samaye paścimāyāṃ pañcaśatyāṃ saddharmavipralopakāle vartamāne,	མ་འོངས་པའི་དུས་ལྔ་བརྒྱ་ཐ་མ་ལ་དམ་པའི་ཆོས་རབ་ཏུ་རྣམ་པར་འཇིག་པར་འགྱུར་བ་ན་སེམས་ཅན་གང་ལ་ལ་དག་འདི་ལྟ་བུའི་མདོ་སྡེའི་ཆིག་བཤད་པ་འདི་ལ་ཡང་དག་པར་འདུ་ཤེས་བསྐྱེད་པར་འགྱུར་བ་ལྟ་མཆིས་སམ་། བཅོམ་ལྡན་འདས་ཀྱིས་བཀའ་སྩལ་པ་། རབ་འབྱོར་། ཁྱོད་འདི་སྐད་དུ་།
 ye imeṣvevaṃrūpeṣu sūtrāntapadeṣu bhāṣyamāṇeṣu bhūtasaṃjñāmutpādayiṣyanti | api tu khalu punaḥ subhūte bhaviṣyantyanāgate 'dhvani bodhisattvā mahāsattvāḥ paścime	མ་འོངས་པའི་དུས་ལྔ་བརྒྱ་ཐ་མ་ལ་དམ་པའི་ཆོས་རབ་ཏུ་རྣམ་པར་འཇིག་པར་འགྱུར་བ་ན་སེམས་ཅན་གང་ལ་ལ་དག་འདི་ལྟ་བུའི་མདོ་སྡེའི་ཚིག་བཤད་པ་འདི་ལ་ཡང་དག་པར་འདུ་ཤེས་བསྐྱེད་པར་འགྱུར་བ་ལྟ་མཆིས་སམ་ཞེས་མ་ཟེར་ཅིག་། ཡང་རབ་འབྱོར་།
 kāle paścime samaye paścimāyāṃ pañcaśatyāṃ saddharmavipralope vartamāne guṇavantaḥ	མ་འོངས་པའི་དུས་ལྔ་༄༢༡༨ཨ་༌༎ བརྒྱ་ཐ་མ་ལ་དམ་པའི་ཆོས་རབ་ཏུ་རྣམ་པར་འཇིག་པར་འགྱུར་བ་ན་བྱང་ཆུབ་སེམས་དཔའ་སེམས་དཔའ་ཆེན་པོ་ཚུལ་ཁྲིམས་དང་ལྡན་པ་། ཡོན་ཏན་དང་ལྡན་པ་།
 śīlavantaḥ prajñāvantaśca bhaviṣyanti, ye imeṣvevaṃrūpeṣu sūtrāntapadeṣu bhāṣyamāṇeṣu bhūtasaṃjñāmutpāadayiṣyanti |	ཤེས་རབ་དང་ལྡན་པ་དག་འབྱུང་སྟེ་།
 na khalu punaste subhūte bodhisattvā mahāsattvā ekabuddhaparyupāsitā bhaviṣyanti,	རབ་འབྱོར་། བྱང་ཆུབ་སེམས་དཔའ་སེམས་དཔའ་ཆེན་པོ་དེ་དག་ཀྱང་སངས་རྒྱས་གཅིག་ལ་བསྙེན་བཀུར་བྱས་པ་མ་ཡིན་། 
 naikabuddhāvaropitakuśalamūlā bhaviṣyanti |	སངས་རྒྱས་གཅིག་ལ་དགེ་བའི་རྩ་བ་བསྐྱེད་པ་མ་ཡིན་གྱི་།
 api tu khalu punaḥ subhūte anekabuddhaśatasahasraparyupāsitā anekabuddhaśatasahasrāvaropitakuśalamūlāste bodhisattvā mahāsattvā bhaviṣyanti,	རབ་འབྱོར་། སངས་རྒྱས་བརྒྱ་སྟོང་མང་པོ་ལ་བསྙེན་བཀུར་བྱས་ཤིང་། སངས་རྒྱས་བརྒྱ་སྟོང་དུ་མ་ལ་དགེ་བའི་རྩ་བ་དག་བསྐྱེད་པའི་བྱང་ཆུབ་སེམས་དཔའ་སེམས་དཔའ་ཆེན་པོ་དག་འབྱུང་ངོ་༎ རབ་འབྱོར་།
 ye imeṣvevaṃrūpeṣu sūtrāntapadeṣu bhāṣyamāṇeṣu ekacittaprasādamapi pratilapsyante |	གང་དག་འདི་ལྟ་བུའི་མདོ་སྡེའི་ཚིག་བཤད་པ་འདི་ལ་སེམས་དད་པ་གཅིག་ཙམ་རྙེད་པར་འགྱུར་བ་དེ་དག་ནི༏་རབ་འབྱོར་།
 jñātāste subhūte tathāgatena buddhajñānena,	དེ་བཞིན་གཤེགས་པས་མཁྱེན་ཏོ་༎ རབ་འབྱོར་། དེ་དག་ནི་།
 dṛṣṭāste subhūte tathāgatena buddhacakṣuṣā, buddhāste subhūte tathāgatena |	དེ་བཞིན་གཤེགས་པས་གཟིགས་ཏེ་།
 sarve te subhūte aprameyamasaṃkhyeyaṃ puṇyaskandhaṃ prasaviṣyanti pratigrahīṣyanti |	རབ་འབྱོར་། སེམས་ཅན་དེ་དག་ཐམས་ཅད་ནི་། བསོད་ནམས་ཀྱི་ཕུང་པོ་དཔག་ཏུ་མེད་པ་བསྐྱེད་ཅིང་རབ་ཏུ་སྡུད་པར་འགྱུར་རོ་༎
 tatkasya hetoḥ?	དེ་ཅིའི་ཕྱིར་ཞེ་ན་། རབ་འབྱོར་། བྱང་ཆུབ་སེམས་དཔའ་སེམས་དཔའ་ཆེན་པོ་དེ་དག་ནི་།
 na hi subhūte teṣāṃ bodhisattvānāṃ mahāsattvānāmātmasaṃjñā pravartate,	བདག་ཏུ་འདུ་ཤེས་འཇུག་པར་མི་འགྱུར་ཞིང་།
 na sattvasaṃjñā,	སེམས་ཅན་དུ་འདུ་ཤེས་པ་མ་ཡིན་།
 na jīvasaṃjñā,	སྲོག་ཏུ་འདུ་ཤེས་པ་མ་ཡིན་ཏེ་།
 na pudgalasaṃjñā pravartate |	གང་ཟག་ཏུའང་འདུ་ཤེས་འཇུག་པར་མི་འགྱུར་བའི་ཕྱིར་རོ་༎ རབ་འབྱོར་།
 nāpi teṣāṃ subhūte bodhisattvānāṃ mahāsattvānāṃ dharmasaṃjñā pravartate | evaṃ nādharmasaṃjñā |	བྱང་ཆུབ་༄༢༡༨བ་སེམས་དཔའ་སེམས་དཔའ་ཆེན་པོ་དེ་དག་ཆོས་སུ་འདུ་ཤེས་པ་དང་། ཆོས་མེད་པར་ཡང་འདུ་ཤེས་མི་འཇུག་སྟེ་།
 nāpi teṣāṃ subhūte saṃjñā nāsaṃjñā pravartate |	དེ་དག་ནི་། འདུ་ཤེས་དང་། འདུ་ཤེས་མེད་པར་ཡང་འདུ་ཤེས་འཇུག་པར་མི་འགྱུར་རོ་༎
 tatkasya hetoḥ?	དེ་ཅིའི་ཕྱིར་ཞེ་ན་། རབ་འབྱོར་།
 sacetsubhūte teṣāṃ bodhisattvānāṃ mahāsattvānāṃ dharmasaṃjñā pravarteta,	གལ་ཏེ་བྱང་ཆུབ་སེམས་དཔའ་སེམས་དཔའ་ཆེན་པོ་དེ་དག་ཆོས་སུ་འདུ་ཤེས་འཇུག་ན་།
 sa eva teṣāmātmagrāho bhavet,	དེ་ཉིད་དེ་དག་གི་བདག་ཏུ་འཛིན་པར་འགྱུར་ཞིང་།
 sattvagrāho jīvagrāhaḥ pudgalagrāho bhavet |	སེམས་ཅན་དུ་འཛིན་པ་དང་། སྲོག་ཏུ་འཛིན་པ་དང་། གང་ཟག་ཏུ་འཛིན་པར་འགྱུར་བའི་ཕྱིར་རོ་༎
 sacedadharmasaṃjñā pravarteta, sa eva teṣāmātmagrāho bhavet, sattvagrāho (vajr, vaidya 77)	གལ་ཏེ་ཆོས་མེད་པར་འཇུག་ནའང་དེ་ཉིད་དེ་དག་གི་བདག་ཏུ་འཛིན་པར་འགྱུར་ཞིང་།
 jīvagrāhaḥ pudgalagrāha iti |	སེམས་ཅན་དུ་འཛིན་པ་དང་། སྲོག་ཏུ་འཛིན་པ་དང་། གང་ཟག་ཏུ་འཛིན་པར་འགྱུར་བའི་ཕྱིར་རོ་༎
 tatkasya hetoḥ?	དེ་ཅིའི་ཕྱིར་ཞེ་ན་། ཡང་རབ་འབྱོར་།
 na khalu punaḥ subhūte bodhisattvena mahāsattvena dharma udgrahītavyo nādharmaḥ |	བྱང་ཆུབ་སེམས་དཔས་ཆོས་ཀྱང་ལོག་པར་གཟུང་བར་མི་བྱ་སྟེ་། ཆོས་མ་ཡིན་པ་ཡང་མི་གཟུང་བའི་ཕྱིར་རོ་༎ དེ་བས་ན་།
 tasmādiyaṃ tathāgatena saṃdhāya vāgbhāṣitā - kolopamaṃ dharmaparyāyamājānadbhidharmā eva prahātavyāḥ prāgevādharmā iti || 6 ||	དེ་ལས་དགོངས་ཏེ་དེ་བཞིན་གཤེགས་པས་ཆོས་ཀྱི་རྣམ་གྲངས་འདི་གཟིངས་ལྟ་བུར་ཤེས་པ་རྣམས་ཀྱིས་ཆོས་རྣམས་ཀྱང་སྤང་བར་བྱ་ན་། ཆོས་མ་ཡིན་པ་རྣམས་ལྟ་ཅི་སྨོས་ཞེས་གསུངས་སོ་༎
 punaraparaṃ bhagavānāyuṣmantaṃ subhūtimetadavocat - tatkiṃ manyase subhūte,	གཞན་ཡང་བཅོམ་ལྡན་འདས་ཀྱིས་ཚེ་དང་ལྡན་པ་རབ་འབྱོར་ལ་འདི་སྐད་ཅེས་བཀའ་སྩལ་ཏོ༏་༏རབ་འབྱོར་། འདི་ཇི་སྙམ་དུ་སེམས་།
 asti sa kaściddharmo yastathāgatenānuttarā samyaksaṃbodhirityabhisaṃbuddhaḥ,	དེ་བཞིན་གཤེགས་པས་གང་བླ་ན་མེད་པ་ཡང་དག་པར་རྫོགས་པའི་བྱང་ཆུབ་མངོན་པར་རྫོགས་པར་སངས་རྒྱས་པའི་ཆོས་དེ་གང་ཡང་ཡོད་༄༢༡༩ཨ་༌༎
 kaścidvā dharmastathāgatena deśitaḥ?	དམ༏་དེ་བཞིན་གཤེགས་པས་ཆོས་གང་ཡང་བསྟན་ཏམ་།
 evamukte āyuṣmān subhūtirbhagavantametadavocat - yathāhaṃ bhagavan bhagavato bhāṣitasyārthamājānāmi,	དེ་སྐད་ཅེས་བཀའ་སྩལ་པ་དང་། བཅོམ་ལྡན་འདས་ལ་ཚེ་དང་ལྡན་པ་རབ་འབྱོར་གྱིས་འདི་སྐད་ཅེས་གསོལ་ཏོ་༎ བཅོམ་ལྡན་འདས་། བཅོམ་ལྡན་འདས་ཀྱིས་གསུངས་པའི་དོན་འདི་བདག་གིས་འཚལ་བ་ལྟར་ན་།
 nāsti sa kaściddharmo yastathāgatena anuttarā samyaksaṃbodhirityabhisaṃbuddhaḥ, nāsti dharmo yastathāgatena deśitaḥ |	དེ་བཞིན་གཤེགས་པས་གང་བླ་ན་མེད་པ་ཡང་དག་པར་རྫོགས་པའི་བྱང་ཆུབ་མངོན་པར་རྫོགས་པར་སངས་རྒྱས་པའི་ཆོས་དེ་གང་ཡང་མ་མཆིས་སོ་༎ དེ་བཞིན་གཤེགས་པས་གང་བསྟན་པའི་ཆོས་དེ་གང་ཡང་མ་མཆིས་སོ་༎
 tatkasya hetoḥ?	དེ་ཅིའི་སླད་དུ་ཞེ་ན་།
 yo 'sau tathāgatena dharmo 'bhisaṃbuddho deśito vā,	དེ་བཞིན་གཤེགས་པས་ཆོས་གང་ཡང་མངོན་པར་རྫོགས་པར་སངས་རྒྱས་པའམ་བསྟན་པ་དེ་ནི་།
 agrāhyaḥ so 'nabhilapyaḥ |	གཟུང་དུ་མ་མཆིས་། བརྗོད་དུ་མ་མཆིས་ཏེ་།
 na sa dharmo nādharmaḥ |	དེ་ནི་། ཆོས་ཀྱང་མ་ལགས་། ཆོས་མ་མཆིས་པ་ཡང་མ་ལགས་པའི་སླད་དུའོ་༎
 tatkasya hetoḥ?	དེ་ཅིའི་སླད་དུ་ཞེ་ན་།
 asaṃskṛtaprabhāvitā hyāryapudgalāḥ || 7 ||	འཕགས་པའི་གང་ཟག་རྣམས་ནི་། འདུས་མ་བགྱིས་ཀྱིས་རབ་ཏུ་ཕྱེ་བའི་སླད་དུའོ་༎ བཅོམ་ལྡན་འདས་ཀྱིས་བཀའ་སྩལ་པ་། རབ་འབྱོར་།
 bhagavānāha - tatkiṃ manyase subhūte yaḥ kaścitkulaputro vā kuladuhitā vā imaṃ trisāhasramahāsāhasraṃ lokadhātuṃ saptaratnaparipūrṇaṃ kṛtvā tathāgatebhyo 'rhadbhayaḥ samyaksaṃbuddhebhyo dānaṃ dadyāt,	འདི་ཇི་སྙམ་དུ་སེམས་། རིགས་ཀྱི་བུའམ་། རིགས་ཀྱི་བུ་མོ་གང་ལ་ལ་ཞིག་གིས་སྟོང་གསུམ་གྱི་སྟོང་ཆེན་པོའི་འཇིག་རྟེན་གྱི་ཁམས་འདི་རིན་པོ་ཆེ་སྣ་བདུན་གྱིས་རབ་ཏུ་གང་བར་བྱས་ཏེ་སྦྱིན་པ་བྱིན་ན་།
 api nu sa kulaputro vā kuladuhitā vā tatonidānaṃ bahu puṇyaskandhaṃ prasunuyāt |	རིགས་ཀྱི་བུའམ་། རིགས་ཀྱི་བུ་མོ་དེ་གཞི་དེ་ལས་བསོད་ནམས་ཀྱི་ཕུང་པོ་མང་དུ་བསྐྱེད་དམ་།
 subhūtirāha - bahu bhagavan,	༄༢༡༩བ་རབ་འབྱོར་གྱིས་གསོལ་པ་། བཅོམ་ལྡན་འདས་། མང་ལགས་སོ་༎ བདེ་བར་གཤེགས་པ་། མང་ལགས་ཏེ་།
 bahu sugata sa kulaputro vā kuladuhitā vā tatonidānaṃ puṇyaskandhaṃ prasunuyāt | tatkasya hetoḥ?	རིགས་ཀྱི་བུའམ་། རིགས་ཀྱི་བུ་མོ་དེ་གཞི་དེ་ལས་བསོད་ནམས་ཀྱི་ཕུང་པོ་མང་དུ་བསྐྱེད་དོ༏་༏དེ་ཅིའི་སླད་དུ་ཞེ་ན་། བཅོམ་ལྡན་འདས་།
 yo 'sau bhagavan puṇyaskandhastathāgatena bhāṣitaḥ, askandhaḥ sa tathāgatena bhāṣitaḥ |	བསོད་ནམས་ཀྱི་ཕུང་པོ་དེ་ཉིད་ཕུང་པོ་མ་མཆིས་པའི་སླད་དུ་སྟེ་། དེས་ན་།
 tasmāttathāgato bhāṣate - puṇyaskandhaḥ puṇyaskandha iti |	དེ་བཞིན་གཤེགས་པས་བསོད་ནམས་ཀྱི་ཕུང་པོ་བསོད་ནམས་ཀྱི་ཕུང་པོ་༎ ཞེས་གསུངས་སོ་༎ བཅོམ་ལྡན་འདས་ཀྱིས་བཀའ་སྩལ་པ་།
 bhagavānāha - yaśca khalu punaḥ subhūte kulaputro vā kuladuhitā va imaṃ trisāhasramahāsāhasraṃ	རབ་འབྱོར་། རིགས་ཀྱི་བུའམ་། རིགས་ཀྱི་བུ་མོ་གང་གིས་སྟོང་གསུམ་གྱི་སྟོང་ཆེན་པོའི་འཇིག་རྟེན་གྱི་ཁམས་འདི་རིན་པོ་ཆེ་སྣ་བདུན་གྱིས་རབ་ཏུ་གང་བར་བྱས་ཏེ་སྦྱིན་པ་བྱིན་པ་བས་།
 lokadhātuṃ saptaratnaparipūrṇaṃ kṛtvā tathāgatebhyo 'rhadbhyaḥ samyaksaṃbuddhebhyo dānaṃ dadyāt, yaśca ito dharmaparyāyādantaśaścatuṣpādikāmapi gāthāmudgṛhya parebhyo vistareṇa deśayet saṃprakāśayet,	གང་གིས་ཆོས་ཀྱི་རྣམ་གྲངས་འདི་ལས་ཐ་ན་ཚིག་བཞི་པའི་ཚིགས་སུ་བཅད་པ་གཅིག་ཙམ་བཟུང་ནས་གཞན་དག་ལ་ཡང་འཆད་ཅིང་ཡང་དག་པར་རབ་ཏུ་སྟོན་ན་།
 ayameva tatonidānaṃ bahutaraṃ puṇyaskandhaṃ prasunuyādaprameyasaṃkhyeyam | tatkasya hetoḥ?	དེ་གཞི་དེ་ལས་བསོད་ནམས་ཀྱི་ཕུང་པོ་ཆེས་མང་དུ་གྲངས་མེད་དཔག་ཏུ་མེད་པ་བསྐྱེད་དོ་༎ དེ་ཅིའི་ཕྱིར་ཞེ་ན་།
 atonirjātā hi subhūte tathāgatānāmarhatāṃ samyaksaṃbuddhānāmanuttarā samyaksaṃbodhiḥ,	རབ་འབྱོར་། དེ་བཞིན་གཤེགས་པ་དགྲ་བཅོམ་པ་ཡང་དག་པར་རྫོགས་པའི་སངས་རྒྱས་རྣམས་ཀྱི་བླ་ན་མེད་པ་ཡང་དག་པར་རྫོགས་པའི་བྱང་ཆུབ་ནི་། འདི་ལས་བྱུང་སྟེ་།
 atonirjātāśca buddhā bhagavantaḥ |	སངས་རྒྱས་བཅོམ་ལྡན་འདས་རྣམས་ཀྱང་འདི་ལས་སྐྱེས་པའི་ཕྱིར་རོ་༎
 tatkasya hetoḥ?	དེ་ཅིའི་ཕྱིར་ཞེ་ན་། རབ་འབྱོར་།
 buddhadharmā buddhadharmā iti subhūte abuddhadharmāścaiva te tathāgatena bhāṣitāḥ |	སངས་རྒྱས་ཀྱི་ཆོས་རྣམས་སངས་རྒྱས་ཀྱི་ཆོས་རྣམས་ཞེས་བྱ་བ་ནི་། སངས་རྒྱས་ཀྱི་ཆོས་དེ་དག་མེད་པར་དེ་བཞིན་གཤེགས་༄༢༢༠ཨ་༌༎ པས་གསུངས་པའི་ཕྱིར་ཏེ་།
 tenocyante buddhadharmā iti || 8 ||	དེས་ན་། སངས་རྒྱས་ཀྱི་ཆོས་རྣམས་ཞེས་བྱའོ་༎ རབ་འབྱོར་།
 tatkiṃ manyase subhūte api nu srotaāpannasyaivaṃ bhavati - mayā srotaāpattiphalaṃ prāptamiti?	འདི་ཇི་སྙམ་དུ་སེམས་། རྒྱུན་དུ་ཞུགས་པ་འདི་སྙམ་དུ་། བདག་གིས་རྒྱུན་དུ་ཞུགས་པའི་འབྲས་བུ་ཐོབ་བོ་སྙམ་དུ་སེམས་སམ་།
 subhūtirāha - no hīdaṃ bhagavan | na srotaāpannasyaivaṃ bhavati - mayā srotaāpattiphalaṃ prāptamiti |	རབ་འབྱོར་གྱིས་གསོལ་པ་། བཅོམ་ལྡན་འདས་། དེ་ནི་།
 tatkasya hetoḥ?	མ་ལགས་སོ་༎ དེ་ཅིའི་སླད་དུ་ཞེ་ན་། བཅོམ་ལྡན་འདས་།
 na hi sa bhagavan kaṃciddharmamāpannaḥ,	དེ་ནི་། ཅི་ལའང་ཞུགས་པ་མ་མཆིས་པའི་སླད་དུ་སྟེ་།
 tenocyate srotaāpanna iti |	དེས་ན་། རྒྱུན་དུ་ཞུགས་པ་ཞེས་བགྱིའོ་༎ གཟུགས་ལའང་མ་ཞུགས་། སྒྲ་ལ་མ་ལགས་། དྲི་ལ་མ་ལགས་།
 na rūpamāpanno na śabdān na gandhān na rasān na spraṣṭavyān dharmānāpannaḥ |	རོ་ལ་མ་ལགས་། རེག་བྱ་ལ་མ་ལགས་། ཆོས་ལའང་མ་ཞུགས་ཏེ་།
 tenocyate srotaāpanna iti |	དེས་ན་། རྒྱུན་དུ་ཞུགས་པ་ཞེས་བགྱིའོ་༎
 sacedbhagavan srotaāpannasyaivaṃ bhavet - mayā srotaāpattiphalaṃ prāptamiti,	བཅོམ་ལྡན་འདས་། གལ་ཏེ་རྒྱུན་དུ་ཞུགས་པ་དེ་འདི་སྙམ་དུ་། བདག་གིས་རྒྱུན་དུ་ཞུགས་པའི་འབྲས་བུ་ཐོ་བ་བོ༏་༏སྙམ་དུ་སེམས་པར་གྱུར་ན་།
 sa eva tasyātmagrāho bhavet,	དེ་ཉིད་དེའི་བདག་ཏུ་འཛིན་པར་འགྱུར་ལགས་སོ་༎
 sattvagrāho jīvagrāhaḥ pudgalagrāho bhavediti ||	སེམས་ཅན་དུ་འཛིན་པ་དང་། སྲོག་ཏུ་འཛིན་པ་དང་། གང་ཟག་ཏུ་འཛིན་པར་འགྱུར་ལགས་སོ་༎ བཅོམ་ལྡན་འདས་ཀྱིས་བཀའ་སྩལ་པ་། རབ་འབྱོར་།
 bhagavānāha - tatkiṃ manyase subhūte api nu sakṛdāgāmina evaṃ bhavati - mayā sakṛdāgāmiphalaṃ prāptamiti?	འདི་ཇི་སྙམ་དུ་སེམས་། ལན་གཅིག་ཕྱིར་འོང་བ་འདི་སྙམ་དུ་། བདག་གིས་ལན་གཅིག་ཕྱིར་འོང་བའི་འབྲས་བུ་ཐོབ་བོ་༎ སྙམ་དུ་སེམས་སམ་།
 subhūtirāha - no hīdaṃ bhagavan | sa sakṛdāgāmina evaṃ bhavati - mayā (vajr, vaidya 78) sakṛdāgāmiphalaṃ prāptamiti |	རབ་འབྱོར་གྱིས་གསོལ་པ་། བཅོམ་ལྡན་འདས་། དེ་ནི་།
 tatkasya hetoḥ?	མ་ལགས་སོ་༎ དེ་ཅིའི་སླད་དུ་ཞེ་ན་།
 na hi sa kaściddharmo yaḥ sakṛdāgāmitvamāpannaḥ |	གང་ལན་གཅིག་ཕྱིར་འོང་བ་ཉིད་དུ་ཞུགས་པའི་ཆོས་དེ་གང་ཡང་མ་༄༢༢༠བ་མཆིས་པའི་སླད་དུ་སྟེ་། 
 tenocyate sakṛdāgāmīti ||	དེས་ན་། ལན་གཅིག་ཕྱིར་འོང་བ་ཞེས་བགྱིའོ་༎ བཅོམ་ལྡན་འདས་ཀྱིས་བཀའ་སྩལ་པ་།
 bhagavānāha - tatkiṃ manyase subhūte api nu anāgāmina evaṃ bhavati - mayānāgāmiphalaṃ prāptamiti?	རབ་འབྱོར་། འདི་ཇི་སྙམ་དུ་སེམས་། ཕྱིར་མི་འོང་བ་འདི་སྙམ་དུ་། བདག་གིས་ཕྱིར་མི་འོང་བའི་འབྲས་བུ་ཐོབ་བོ་༎ སྙམ་དུ་སེམས་སམ་།
 subhūtirāha - no hīdaṃ bhagavan | na anāgāmina evaṃ bhavati - mayā anāgāmiphalaṃ prāptamiti |	རབ་འབྱོར་གྱིས་གསོལ་པ་། བཅོམ་ལྡན་འདས་དེ་ནི་། མ་ལགས་སོ་༎
 tatkasya hetoḥ?	དེ་ཅིའི་སླད་དུ་ཞེ་ན་།
 na hi sa bhagavan kaściddharmo yo 'nāgāmitvamāpannaḥ |	གང་ཕྱིར་མི་འོང་བ་ཉིད་དུ་ཞུགས་པའི་ཆོས་དེ་གང་ཡང་མ་མཆིས་པའི་སླད་དུ་སྟེ་།
 tenocyate anāgāmīti ||	དེས་ན་། ཕྱིར་མི་འོང་བ་ཞེས་བགྱིའོ་༎ བཅོམ་ལྡན་འདས་ཀྱིས་བཀའ་སྩལ་པ་། རབ་འབྱོར་།
 bhagavānāha - tatkiṃ manyase subhūte api nu arhata evaṃ bhavati - mayā arhattvaṃ prāptamiti?	འདི་ཇི་སྙམ་དུ་སེམས་། དགྲ་བཅོམ་པ་འདི་སྙམ་དུ་། བདག་གིས་དགྲ་བཅོམ་པ་ཉིད་ཐོབ་བོ་༎ སྙམ་དུ་སེམས་སམ་།
 subhūtirāha - no hīdaṃ bhagavan | nārhata evaṃ bhavati - mayā arhattvaṃ prāptamiti |	རབ་འབྱོར་གྱིས་གསོལ་པ་། བཅོམ་ལྡན་འདས་། དེ་ནི་།
 tatkasya hetoḥ?	མ་ལགས་སོ་༎ དེ་ཅིའི་སླད་དུ་ཞེ་ན་།
 na hi sa bhagavan kaściddharmo yo 'rhannāma | tenocyate - arhanniti |	གང་དགྲ་བཅོམ་པ་ཞེས་བགྱི་བའི་ཆོས་དེ་གང་ཡང་མ་མཆིས་པའི་སླད་དུའོ་༎
 sacedbhagavan arhata evaṃ bhavet - mayā arhattvaṃ prāptamiti,	བཅོམ་ལྡན་འདས་། གལ་ཏེ་དགྲ་བཅོམ་པ་འདི་སྙམ་དུ་། བདག་གིས་དགྲ་བཅོམ་པ་ཉིད་ཐོབ་བོ་༎
 sa eva tasyātmagrāho bhavet,	སྙམ་དུ་སེམས་པར་གྱུར་ན་། དེ་ཉིད་དེའི་བདག་ཏུ་འཛིན་པར་འགྱུར་ལགས་སོ་༎
 sattvagrāho jīvagrāhaḥ pudgalagrāho bhavet | tatkasya hetoḥ?	སེམས་ཅན་དུ་འཛིན་པ་དང་། སྲོག་ཏུ་འཛིན་པ་དང་། གང་ཟག་ཏུ་འཛིན་པར་འགྱུར་ལགས་སོ་༎
 ahamasmi bhagavaṃstathāgatenārhatā samyaksaṃbuddhena araṇāvihāriṇāmagryo nirdiṣṭaḥ |	བཅོམ་ལྡན་འདས༏་བདག་ནི་། དེ་བཞིན་གཤེགས་པ་དགྲ་བཅོམ་པ་ཡང་དག་པར་རྫོགས་པའི་སངས་རྒྱས་ཀྱིས་ཉོན་མོངས་པ་མེད་པར་གནས་པ་རྣམས་ཀྱི་མཆོག་ཏུ་བསྟན་ཏེ་། བཅོམ་ལྡན་འདས་།
 ahamasmi bhagavan arhan vītarāgaḥ |	༄༢༢༡ཨ་༌༎ བདག་འདོད་ཆགས་དང་བྲལ་བ་དགྲ་བཅོམ་པ་ལགས་ཀྱང་། བཅོམ་ལྡན་འདས་།
 na ca me bhagavannevaṃ bhavati - arhannasmyahaṃ vītarāga iti |	བདག་འདི་སྙམ་དུ་། བདག་ནི་། དགྲ་བཅོམ་པའོ་༎ སྙམ་དུ་མི་སེམས་ལགས་སོ་༎
 sacenmama bhagavannevaṃ bhavet - mayā arhattvaṃ prāptamiti,	བཅོམ་ལྡན་འདས་། གལ་ཏེ་བདག་འདི་སྙམ་དུ་། བདག་གིས་དགྲ་བཅོམ་པ་ཉིད་ཐོབ་བོ་༎ སྙམ་དུ་སེམས་པར་གྱུར་ན་། དེ་བཞིན་གཤེགས་པས་བདག་ལ་རིགས་ཀྱི་བུ་རབ་འབྱོར་ནི་། ཉོན་མོངས་པ་མེད་པར་གནས་པ་རྣམས་ཀྱི་མཆོག་ཡིན་ཏེ་། ཅི་ལའང་མི་གནས་པས་ན་། ཉོན་མོངས་པ་མེད་པར་གནས་པ་།
 na māṃ tathāgato vyākariṣyadaraṇāvihāriṇāmagryaḥ subhūtiḥ kulaputro na kvacidviharati, tenocyate araṇāvihārī araṇāvihārīti || 9 ||	ཉོན་མོངས་པ་མེད་པར་གནས་པ་ཞེས་ལུང་མི་སྟོན་ལགས་སོ་༎ བཅོམ་ལྡན་འདས་ཀྱིས་བཀའ་སྩལ་པ་།
 bhagavānāha - tatkiṃ manyase subhūte - asti sa kaściddharmo yastathāgatena dīpaṃkarasya tathāgatasyārhata - samyaksaṃbuddhasyāntikādudgṛhītaḥ?	རབ་འབྱོར་། འདི་ཇི་སྙམ་དུ་སེམས་། དེ་བཞིན་གཤེགས་པས་དེ་བཞིན་གཤེགས་པ་དགྲ་བཅོམ་པ་ཡང་དག་པར་རྫོགས་པའི་སངས་རྒྱས་མར་མེ་མཛད་ལས་གང་བླངས་པའི་ཆོས་དེ་གང་ཡང་ཡོད་དམ་། 
 subhūtirāha - no hīdaṃ bhagavan |	རབ་འབྱོར་གྱིས་གསོལ་པ་། བཅོམ་ལྡན་འདས་། དེ་ནི་།
 nāsti sa kaściddharmo yastathāgatena dīpaṃkarasya tathāgatasyārhataḥ samyaksaṃbuddhasyāntikādudgṛhītaḥ ||	མ་ལགས་ཏེ་། དེ་བཞིན་གཤེགས་པས་དེ་བཞིན་གཤེགས་པ་དགྲ་བཅོམ་པ་ཡང་དག་པར་རྫོགས་པའི་སངས་རྒྱས་མར་མེ་མཛད་ལས་གང་བླངས་པའི་ཆོས་དེ་གང་ཡང་མ་མཆིས་སོ་༎ བཅོམ་ལྡན་འདས་ཀྱིས་བཀའ་སྩལ་པ་།
 bhagavānāha - yaḥ kaścitsubhūte bodhisattva evaṃ vadet - ahaṃ kṣetravyūhān niṣpādayiṣyāmīti,	རབ་འབྱོར་། བྱང་ཆུབ་སེམས་དཔའ་གང་ལ་ལ་ཞིག་འདི་སྐད་དུ་། བདག་གིས་ཞིང་བཀོད་པ་རྣམས་བསྒྲུབ་པར་བྱའོ་༎ ཞེས་ཟེར་ན་། དེ་ནི་།
 sa vitathaṃ vadet |	མི་བདེན་པར་སྨྲ་བའོ་༎
 tatkasya hetoḥ?	དེ་ཅིའི་ཕྱིར་ཞེ་ན་། ༄༢༢༡བ་རབ་འབྱོར་།
 kṣetravyūhāḥ kṣetravyūhā iti subhūte avyūhāste tathāgatena bhāṣitāḥ |	ཞིང་བཀོད་པ་རྣམས་ཞིང་བཀོད་པ་རྣམས་ཞེས་བྱ་བ་ནི་། བཀོད་པ་དེ་དག་མེད་པར་དེ་བཞིན་གཤེགས་པས་གསུངས་པའི་ཕྱིར་ཏེ་།
 tenocyante kṣetravyūhā iti |	དེས་ན་། ཞིང་བཀོད་པ་རྣམས་ཞེས་བྱའོ་༎ རབ་འབྱོར༏་དེ་ལྟ་བས་ན་།
 tasmāttarhi subhūte bodhisattvena mahāsattvena evamapratiṣṭhitaṃ cittamutpādayitavyaṃ yanna kvacitpratiṣṭhitaṃ cittamutpādayitavyam |	བྱང་ཆུབ་སེམས་དཔའ་སེམས་དཔའ་ཆེན་པོས་འདི་ལྟར་མི་གནས་པར་སེམས་བསྐྱེད་པར་བྱའོ་༎ ཅི་ལའང་མི་གནས་པར་སེམས་བསྐྱེད་པར་བྱའོ་༎ གཟུགས་ལའང་མི་གནས་པར་སེམས་བསྐྱེད་པར་བྱའོ་༎
 na rūpapratiṣṭhitaṃ cittamutpādayitavyaṃ na śabdagandharasaspraṣṭavyadharmapratiṣṭhitaṃ cittamutpādayitavyam |	སྒྲ་དང་། དྲི་དང་། རོ་དང་། རེག་བྱ་དང་། ཆོས་ལའང་མི་གནས་པར་སེམས་བསྐྱེད་པར་བྱའོ་༎ རབ་འབྱོར་། འདི་ལྟ་སྟེ་།
 tadyathāpi nāma subhūte puruṣo bhavedupetakāyo mahākāyo yattasyaivaṃ rūpa ātmabhāvaḥ syāt tadyathāpi nāma sumeruḥ parvatarājaḥ |	དཔེར་ན་། སྐྱེས་བུ་ཞིག་ལུས་འདི་ལྟ་བུར་གྱུར་ཏེ་། འདི་ལྟ་སྟེ་། རིའི་རྒྱལ་པོ་རི་རབ་ཙམ་དུ་གྱུར་ན་།
 tatkiṃ manyase subhūte api nu mahān sa ātmabhāvo bhavet?	རབ་འབྱོར་། འདི་ཇི་སྙམ་དུ་སེམས་། ལུས་དེ་ཆེ་བ་ཡིན་ནམ་།
 subhūtirāha - mahān sa bhagavān,	རབ་འབྱོར་གྱིས་གསོལ་པ་། བཅོམ་ལྡན་འདས༏་ལུས་དེ་ཆེ་བ་ལགས་སོ་༎ བདེ་བར་གཤེགས་པ་།
 mahān sugata sa ātmabhāvo bhavet |	ལུས་དེ་ཆེ་ལགས་སོ་༎
 tatkasya hetoḥ?	དེ་ཅིའི་སླད་དུ་ཞེ་ན་།
 ātmabhāva ātmabhāva iti bhagavan na bhāvaḥ sa tathāgatena bhāṣitaḥ |	དེ་བཞིན་གཤེགས་པས་དེ་དངོས་པོ་མ་མཆིས་པར་གསུངས་པའི་སླད་དུ་སྟེ༏་དེས་ན་།
 tenocyata ātmabhāva iti |	ལུས་ཞེས་བགྱིའོ་༎
 na hi bhagavan sa bhāvo nābhāvaḥ |	དེ་དངོས་པོ་མ་མཆིས་པར་དེ་བཞིན་གཤེགས་པས་གསུངས་ཏེ་།
 tenocyate ātmabhāva iti || 10 ||	དེས་ན་། ལུས་ཆེ་ཞེས་བགྱིའོ་༎ བཅོམ་ལྡན་འདས་ཀྱིས་བཀའ་སྩལ་པ་།
 bhagavānāha - tatkiṃ manyase subhūte - yāvatyo gaṅgāyāṃ mahānadyāṃ vālukāstāvatya eva gaṅgānadyo bhaveyuḥ?	རབ་འབྱོར༏་འདི་ཇི་སྙམ་དུ་སེམས་། གངགའའི་ཀླུང་གི་བྱེ་མ་ཇི་སྙེད་པ་གངགའའི་ཀླུང་ཡང་དེ་སྙེད་ཁོ་ནར་གྱུར་ན་།
 tāsu yā vālukāḥ, api nu tā bahvayo bhaveyuḥ?	དེ་དག་གི་བྱེ་མ་གང་ཡིན་པ་དེ་དག་མང་བ་ཡིན་ནམ་། རབ་འབྱོར་གྱིས་༄༢༢༢ཨ་༌༎
 subhūtirāha - tā eva tāvadbhagavan bahvayo gaṅgānadyo bhaveyuḥ, prāgeva yāstāsu gaṅgānadīṣu vālukāḥ |	གསོལ་པ་། བཅོམ་ལྡན་འདས་། གངགའའི་ཀླུང་དེ་དག་ཉིད་ཀྱང་མང་ལགས་ན་། དེ་དག་གི་བྱེ་མ་ལྟ་སྨོས་ཀྱང་མི་འཚལ་།
 bhagavānāha - (vajr, vaidya 79)	བཅོམ་ལྡན་འདས་ཀྱིས་བཀའ་སྩལ་པ་། རབ་འབྱོར་།
 ārocayāmi te subhūte,	ཁྱོད་མོས་པར་བྱ་།
 prativedayāmi te |	ཁྱོད་ཀྱིས་ཁོང་དུ་ཆུད་པར་བྱའོ་༎
 yāvatyastāsu gaṅgānadīṣu vālukā bhaveyustāvato lokadhātūn kaścideva strī vā puruṣo vā saptaratnaparipurṇaṃ kṛtvā tathāgatebhyo 'rhadbhayaḥ samyaksaṃbuddhebhyo dānaṃ dadyāt,	གངགའའི་ཀླུང་དེ་དག་གི་བྱེ་མ་ཇི་སྙེད་པ་དེ་སྙེད་ཀྱི་འཇིག་རྟེན་གྱི་ཁམས་ཀྱི་སྐྱེས་པའམ་། བུད་མེད་གང་ལ་ལ་ཞིག་གིས་རིན་པོ་ཆེ་སྣ་བདུན་གྱིས་རབ་ཏུ་གང་བར་བྱས་ཏེ་དེ་བཞིན་གཤེགས་པ་དགྲ་བཅོམ་པ་ཡང་དག་པར་རྫོགས་པའི་སངས་རྒྱས་རྣམས་ལ་སྦྱིན་པ་བྱིན་ན་། ། རབ་འབྱོར་།
 tat kiṃ manyase subhūte - api nu sā strī vā puruṣo vā tatonidānaṃ bahu puṇyaskandhaṃ prasunuyāt?	འདི་ཇི་སྙམ་དུ་སེམས་། སྐྱེས་པའམ་བུད་མེད་དེ་། གཞི་དེ་ལས་བསོད་ནམས་མང་དུ་བསྐྱེད་དམ་།
 subhūtirāha - bahu bhagavan,	རབ་འབྱོར་གྱིས་གསོལ་པ་། བཅོམ་ལྡན་འདས་། མང་ལགས་སོ་༎ བདེ་བར་གཤེགས་པ་།
 bahu sugata strī vā puruṣo vā tatonidānaṃ puṇyaskandhaṃ prasunuyādaprameyamasaṃkhyeyam |	མང་ལགས་ཏེ༏་སྐྱེས་པའམ་བུད་མེད་དེ་། གཞི་དེ་ལས་བསོད་ནམས་མང་དུ་བསྐྱེད་དོ་༎ བཅོམ་ལྡན་འདས་ཀྱིས་བཀའ་སྩལ་པ་། རབ་འབྱོར་།
 bhagavānāha - yaśca khalu punaḥ subhūte strī vā puruṣo vā tāvato lokadhātūn saptaratnaparipūrṇaṃ kṛtvā tathāgatebhyo 'rhadbhayaḥ samyaksaṃbuddhebhyo dānaṃ dadyāt,	གང་གིས་འཇིག་རྟེན་གྱི་ཁམས་དེ་སྙེད་རིན་པོ་ཆེ་སྣ་བདུན་གྱིས་རབ་ཏུ་གང་བར་བྱས་ཏེ་དེ་བཞིན་གཤེགས་པ་དགྲ་བཅོམ་པ་ཡང་དག་པར་རྫོགས་པའི་སངས་རྒྱས་རྣམས་ལ་སྦྱིན་པ་བྱིན་པ་བས་། 
 yaśca kulaputro vā kuladuhitā vā ito dharmaparyāyādantaśaścatuṣpādikāmapi gāthāmudgṛhya parebhyo deśayet saṃprakāśayet,	གང་གིས་ཆོས་ཀྱི་རྣམ་གྲངས་འདི་ལས་ཐ་ན་ཚིག་བཞི་པའི་ཚིགས་སུ་བཅད་པ་ཙམ་བཟུང་ནས་གཞན་དག་ལ་ཡང་བཤད་དེ་ཡང་དག་པར་རབ་ཏུ་བསྟན་ན་།
 ayameva tatonidānaṃ bahutaraṃ puṇyaskandhaṃ prasunuyādaprameyamasaṃkhyeyam || 11 ||	དེ་ཉིད་དེའི་གཞི་དེ་ལས་བསོད་ནམས་ཆེས་༄༢༢༢བ་མང་དུ་གྲངས་མེད་དཔག་ཏུ་མེད་པ་བསྐྱེད་དོ་༎ ཡང་རབ་འབྱོར་།
 api tu khalu punaḥ subhute yasmin pṛthivīpradeśe ito dharmaparyāyādantaśaścatuṣpādikāmapi gāthāmudgṛhya bhāṣyeta vā saṃprakāśyeta vā,	ས་ཕྱོགས་གང་ན་ཆོས་ཀྱི་རྣམ་གྲངས་འདི་ལས་ཐ་ན་ཚིག་བཞི་པའི་ཚིགས་སུ་བཅད་པ་ཙམ་འདོན་ཏམ་། བཏོན་པའི་ས་ཕྱོགས་དེ་།
 sa pṛthivīpradeśaścaityabhūto bhavet sadevamānuṣāsurasya lokasya,	ལྷ་དང་། མི་དང་། ལྷ་མ་ཡིན་དུ་བཅས་པའི་འཇིག་རྟེན་གྱི་མཆོད་རྟེན་དུ་གྱུར་པ་ཡིན་ན་།
 kaḥ punarvādo ye imaṃ dharmaparyāyaṃ sakalasamāptaṃ dhārayiṣyanti vācayiṣyanti paryavāpsyanti, parebhyaśca vistareṇa saṃprakāśayiṣyanti | parameṇa te subhūte āścaryeṇa samanvāgatā bhaviṣyanti |	སུ་ཞིག་ཆོས་ཀྱི་རྣམ་གྲངས་འདི་ལེན་པ་དང་། འཛིན་པ་དང་། ཀློག་པ་དང་། ཀུན་ཆུབ་པར་བྱེད་པ་དང་། ཚུལ་བཞིན་དུ་ཡིད་ལ་བྱེད་པ་དེ་། ངོ་མཚར་རབ་དང་ལྡན་པར་གྱུར་པ་ལྟ་ཅི་སྨོས་།
 tasmiṃśca subhūte pṛthivīpradeśe śāstā viharatyanyatarānyataro vā vijñagurusthānīyaḥ || 12 ||	ས་ཕྱོགས་དེ་ན་སྟོན་པ་ཡང་བཞུགས་ཏེ་། བླ་མའི་གནས་གཞན་དག་ཀྱང་གནས་སོ་༎
 evamukte āyuṣmān subhūtirbhagavantametadavocat - ko nāma ayaṃ bhagavan dharmaparyāyaḥ,	དེ་སྐད་ཅེས་བཀའ་སྩལ་པ་དང་། བཅོམ་ལྡན་འདས་ལ་ཚེ་དང་ལྡན་པ་རབ་འབྱོར་གྱིས་འདི་སྐད་ཅེས་གསོལ་ཏོ་༎ བཅོམ་ལྡན་འདས་། ཆོས་ཀྱི་རྣམ་གྲངས་འདིའི་མིང་ཅི་ལགས་།
 kathaṃ cainaṃ dhārayāmi?	ཇི་ལྟར་གཟུང་བར་བགྱི་།
 evamukte bhagavānāyuṣmantaṃ subhūtimetadavocat - prajñāpāramitā nāmāyaṃ subhūte dharmaparyāyaḥ |	དེ་སྐད་ཅེས་གསོལ་པ་དང་། བཅོམ་ལྡན་འདས་ཀྱིས་ཚེ་དང་ལྡན་པ་རབ་འབྱོར་ལ་འདི་སྐད་ཅེས་བཀའ་སྩལ་ཏོ་༎ རབ་འབྱོར་། ཆོས་ཀྱི་རྣམ་གྲངས་འདི་ཤེས་རབ་ཀྱི་ཕ་རོལ་ཏུ་ཕྱིན་པ་ཞེས་བྱ་སྟེ་།
 evaṃ cainaṃ dhāraya |	འདི་དེ་ལྟར་ཟུངས་ཤིག་།
 tatkasya hetoḥ?	དེ་ཅིའི་ཕྱིར་ཞེ་ན་། རབ་འབྱོར་།
 yaiva subhūte prajñāpāramitā tathāgatena bhāṣitā, saiva apāramitā tathāgatena bhāṣitā |	དེ་བཞིན་གཤེགས་པས་ཤེས་རབ་ཀྱི་ཕ་རོལ་ཏུ་ཕྱིན་པ་གང་གསུངས་པ་དེ་ཉིད་ཕ་རོལ་ཏུ་ཕྱིན་པ་མེད་པའི་ཕྱིར་ཏེ་།
 tenocyate prajñāpāramiteti ||	དེས་ན་། ཤེས་རབ་ཀྱི་ཕ་རོལ་ཏུ་ཕྱིན་པ་ཞེས་བྱའོ་༎ རབ་འབྱོར་།
 tatkiṃ manyase subhūte - api nu asti sa kaściddharmo yastathāgatena bhāṣitaḥ?	འདི་ཇི་སྙམ་དུ་སེམས་། དེ་བཞིན་གཤེགས་པས་གང་གསུངས་པའི་ཆོས་དེ་གང་༄༢༢༣ཨ་༌༎ ཡང་ཡོད་དམ་།
 subhūtirāha - no hīdaṃ bhagavan |	རབ་འབྱོར་གྱིས་གསོལ་པ་། བཅོམ་ལྡན་འདས་།
 nāsti sa kaściddharmo yastathāgatena bhāṣitaḥ ||	དེ་བཞིན་གཤེགས་པས་གང་གསུངས་པའི་ཆོས་དེ་དག་གང་ཡང་མ་མཆིས་སོ་༎ བཅོམ་ལྡན་འདས་ཀྱིས་བཀའ་སྩལ་པ་།
 bhagavānāha - tatkiṃ manyase subhūte - yāvat trisāhasramahāsāhasre lokadhātau pṛthivīrajaḥ kaccit, tadbahu bhavet?	རབ་འབྱོར་། འདི་ཇི་སྙམ་དུ་སེམས་། སྟོང་གསུམ་གྱི་སྟོང་ཆེན་པོའི་འཇིག་རྟེན་གྱི་ཁམས་ན་སའི་རྡུལ་ཕྲ་རབ་ཇི་སྙེད་ཡོད་པ་དེ་མང་བ་ཡིན་ནམ་།
 subhūtirāha - bahu bhagavan,	རབ་འབྱོར་གྱིས་གསོལ་པ་། བཅོམ་ལྡན་འདས་།
 bahu sugata pṛthivīrajo bhavet |	སའི་རྡུལ་དེ་མང་ལགས་སོ་༎ བདེ་བར་གཤེགས་པ་། མང་ལགས་སོ་༎
 tatkasya hetoḥ? yattadbhagavan pṛthivīrajastathāgatena bhāṣitam,	དེ་ཅིའི་སླད་དུ་ཞེ་ན་། བཅོམ་ལྡན་འདས་། སའི་རྡུལ་གང་ལགས་པ་དེ་།
 arajastadbhagavaṃstathāgatena bhāṣitam |	རྡུལ་མ་མཆིས་པར་དེ་བཞིན་གཤེགས་པས་གསུངས་པའི་སླད་དུ་སྟེ་།
 tenocyate pṛthivīraja iti |	དེས་ན་། སའི་རྡུལ་ཞེས་བགྱིའོ་༎
 yo 'pyasau lokadhātustathāgatena bhāṣitaḥ, adhātuḥ sa tathāgatena bhāṣitaḥ |	འཇིག་རྟེན་གྱི་ཁམས་གང་ལགས་པ་དེ་ཁམས་མ་མཆིས་པར་དེ་བཞིན་གཤེགས་པས་གསུངས་ཏེ་།
 tenocyate lokadhāturiti ||	དེས་ན་། འཇིག་རྟེན་གྱི་ཁམས་ཞེས་བགྱིའོ་༎ བཅོམ་ལྡན་འདས་ཀྱིས་བཀའ་སྩལ་པ་།
 bhagavānāha - tatkiṃ manyase subhūte dvātriṃśanmahāpuruṣalakṣaṇaistathāgato 'rhan samyaksaṃbuddho draṣṭavyaḥ?	རབ་འབྱོར་། འདི་ཇི་སྙམ་དུ་སེམས་། སྐྱེས་བུ་ཆེན་པོའི་མཚན་སུམ་ཅུ་རྩ་གཉིས་པོ་དེ་དག་གིས་དེ་བཞིན་གཤེགས་པ་དགྲ་བཅོམ་པ་ཡང་དག་པར་རྫོགས་པའི་སངས་རྒྱས་སུ་བལྟའམ་།
 subhūtirāha - no hīdaṃ bhagavan | dvātriṃśanmahāpuruṣalakṣaṇaistathāgato 'rhan samyaksaṃbuddho (vajr, vaidya 80) draṣṭavyaḥ |	རབ་འབྱོར་གྱིས་གསོལ་པ་། བཅོམ་ལྡན་འདས་། དེ་ནི་།
 tatkasya hetoḥ?	མ་ལགས་སོ་༎ དེ་ཅིའི་སླད་དུ་ཞེ་ན་།
 yāni hi tāni bhagavan dvātriṃśanmahāpuruṣalakṣaṇāni tathāgatena bhāṣitāni, alakṣaṇāni tāni bhagavaṃstathāgatena bhāṣitāni |	སྐྱེས་བུ་ཆེན་པོའི་མཚན་སུམ་ཅུ་རྩ་གཉིས་པོ་གང་དག་དེ་བཞིན་གཤེགས་པས་གསུངས་པ་དེ་དག་མཚན་མ་མཆིས་པར་དེ་བཞིན་༄༢༢༣བ་གཤེགས་པས་གསུངས་པའི་སླད་དུ་སྟེ་།
 tenocyante dvātriṃśanmahāpuruṣalakṣaṇānīti ||	དེས་ན་། དེ་བཞིན་གཤེགས་པའི་མཚན་སུམ་ཅུ་རྩ་གཉིས་ཞེས་བགྱིའོ་༎ བཅོམ་ལྡན་འདས་ཀྱིས་བཀའ་སྩལ་པ་།
 bhagavānāha - yaśca khalu punaḥ subhūte strī vā puruṣo vā dine dine gaṅgānadīvālukāsamānātmabhāvān parityajet, evaṃ parityajan gaṅgānadīvālukāsamān kalpāṃstānātmabhāvān parityajet,	ཡང་རབ་འབྱོར་། སྐྱེས་པའམ་བུད་མེད་གང་གིས་ལུས་གངགའའི་ཀླུང་གི་བྱེ་མ་སྙེད་ཡོངས་སུ་བཏང་བ་བས་།
 yaśca ito dharmaparyāyadantaśaścatuṣpādikāmapi gāthāmudgṛhyaparebhyo deśayet saṃprakāśayet,	གང་གིས་ཆོས་ཀྱི་རྣམ་གྲངས་འདི་ལས་ཐ་ན་ཚིག་བཞི་པའི་ཚིགས་སུ་བཅད་པ་ཙམ་བཟུང་སྟེ་གཞན་དག་ལ་ཡང་བསྟན་ན་།
 ayameva tatonidānaṃ bahutaraṃ puṇyaskandhaṃ prasunuyādaprameyamasaṃkhyeyam || 13 ||	དེ་གཞི་དེ་ལས་བསོད་ནམས་ཆེས་མང་དུ་གྲངས་མེད་དཔག་ཏུ་མེད་པ་བསྐྱེད་དོ་༎
 atha khalvāyuṣmān subhūtirdharmavegenāśrūṇi prāmuñcat |	དེ་ནས་ཚེ་དང་ལྡན་པ་རབ་འབྱོར་ཆོས་ཀྱི་ཤུགས་ཀྱིས་མཆི་མ་ཕྱུང་སྟེ༏་དེས་མཆིམ་ཕྱིས་ནས་བཅོམ་ལྡན་འདས་ལ་འདི་སྐད་ཅེས་གསོལ་ཏོ་༎ འདི་ལྟར་ཆོས་ཀྱི་རྣམ་གྲངས་འདི་དེ་བཞིན་གཤེགས་པས་གསུངས་པ་ནི་།
 so 'śrūṇi pramṛjya bhagavantametadavocat - āścaryaṃ bhagavan,	བཅོམ་ལྡན་འདས་།
 paramāścaryaṃ sugata, yāvadayaṃ dharmaparyāyastathāgatena bhāṣito 'grayānasaṃprasthitānāṃ sattvānāmarthāya,	ངོ་མཚར་ལགས་སོ་༎
 śreṣṭhayānasaṃprasthitānāmarthāya,	བདེ་བར་གཤེགས་པ་། ངོ་མཚར་ལགས་སོ་༎ བཅོམ་ལྡན་འདས་།
 yato me bhagavan jñānamutpannam | na mayā bhagavan jātvevaṃrūpo dharmaparyāyaḥ śrutapūrvaḥ |	བདག་གི་ཡེ་ཤེས་སྐྱེས་ཚུན་ཆད་བདག་གིས་ཆོས་ཀྱི་རྣམ་གྲངས་འདི་སྔོན་ནམ་ཡང་མ་ཐོས་སོ་༎ བཅོམ་ལྡན་འདས་།
 parameṇa te bhagavan āścaryeṇa samanvāgatā bodhisattvā bhaviṣyanti, ye iha sūtre bhāṣyamāṇe śrutvā bhūtasaṃjñāmutpādayiṣyanti |	མདོ་བཤད་པ་འདི་ལ་གང་དག་ཡང་དག་པར་འདུ་ཤེས་བསྐྱེད་པར་འགྱུར་བའི་སེམས་ཅན་དེ་དག་ནི་། ངོ་མཚར་རབ་དང་ལྡན་པར་འགྱུར་ལགས་སོ་༎
 tatkasya hetoḥ?	དེ་ཅིའི་སླད་དུ་ཞེ་ན༏་བཅོམ་ལྡན་འདས་།
 yā caiṣā bhagavan bhūtasaṃjñā, saiva abhūtasaṃjñā |	ཡང་དག་པར་འདུ་ཤེས་པ་གང་ལགས་པ་དེ་ཉིད་འདུ་ཤེས་མ་མཆིས་པའི་སླད་དུ་སྟེ་།
 tasmāttathāgato bhāṣatebhūtasaṃjñā bhḥtasaṃjñeti ||	དེ་བས་ན་། ཡང་དག་པར་འདུ་ཤེས་ཡང་དག་པར་འདུ་ཤེས་ཞེས་དེ་༄༢༢༤ཨ་༌༎ བཞིན་གཤེགས་པས་གསུངས་སོ་༎
 na mama bhagavan āścaryaṃ yadahamimaṃ dharmaparyāyaṃ bhāṣyamāṇamavakalpayāmi adhimucye |	བཅོམ་ལྡན་འདས་། བདག་ཆོས་ཀྱི་རྣམ་གྲངས་འདི་བཤད་པ་ལ་རྟོག་ཅིང་མོས་པ་ནི་། བདག་ལ་མོས་པ་མ་ལགས་ཀྱི༏་བཅོམ་ལྡན་འདས་།
 ye 'pi te bhagavan sattvā bhaviṣyantyanāgate 'dhvani paścime kāle paścime samaye paścimāyāṃ pañcaśatyāṃ saddharmavipralope vartamāne,	སླད་མའི་ཚེ་སླད་མའི་དུས་ལྔ་བརྒྱ་ཐ་མ་ལ་སེམས་ཅན་གང་དག་ཆོས་ཀྱི་རྣམ་གྲངས་འདི་ལེན་པ་དང་། 
 ye imaṃ bhagavan dharmaparyāyamudgrahīṣyanti dhārayiṣyanti vācayiṣyanti paryavāpsyanti, parebhyaśca vistareṇa saṃprakāśayiṣyanti,	འཛིན་པ་དང་། ཀློག་པ་དང་། ཀུན་ཆུབ་པར་བགྱིད་པ་དེ་དག་ནི་།
 te paramāścaryeṇa samanvāgatā bhaviṣyanti |	ངོ་མཚར་རབ་དང་ལྡན་པར་འགྱུར་ལགས་སོ་༎ ཡང་བཅོམ་ལྡན་འདས་། དེ་དག་ནི་།
 api tu khalu punarbhagavan na teṣāmātmasaṃjñā pravartiṣyate,	བདག་ཏུ་འདུ་ཤེས་འཇུག་པར་མི་འགྱུར་།
 na sattvasaṃjñā na jīvasaṃjñā na pudgalasaṃjñā pravartiṣyate, nāpi teṣāṃ kācitsaṃjñā nāsaṃjñā pravartate |	སེམས་ཅན་དུ་འདུ་ཤེས་པ་དང་། སྲོག་ཏུ་འདུ་ཤེས་པ་དང་། གང་ཟག་ཏུ་འདུ་ཤེས་འཇུག་པར་མི་འགྱུར་ལགས་སོ་༎
 tatkasya hetoḥ?	དེ་ཅིའི་སླད་དུ་ཞེ་ན་། བཅོམ་ལྡན་འདས་།
 yā sā bhagavan ātmasaṃjñā, saivāsaṃjñā | yā sattvasaṃjñā jīvasaṃjñā pudgalasaṃjñā, saivāsaṃjñā |	བདག་ཏུ་འདུ་ཤེས་པ་དང་། སེམས་ཅན་དུ་འདུ་ཤེས་པ་དང་། སྲོག་ཏུ་འདུ་ཤེས་པ་དང་། གང་ཟག་ཏུ་འདུ་ཤེས་པ་གང་ལགས་པ་དེ་དག་ཉིད་འདུ་ཤེས་མ་མཆིས་པའི་སླད་དུའོ་༎
 tatkasya hetoḥ?	དེ་ཅིའི་སླད་དུ་ཞེ་ན་།
 sarvasaṃjñāpagatā hi buddha bhagavantaḥ ||	སངས་རྒྱས་བཅོམ་ལྡན་འདས་རྣམས་ནི་། འདུ་ཤེས་ཐམས་ཅད་དང་བྲལ་བའི་སླད་དུའོ་༎
 evamukte bhagavānāyuṣmantaṃ subhūtimetadavocat - evametat subhūte, evametat |	དེ་སྐད་ཅེས་གསོལ་པ་དང་། བཅོམ་ལྡན་འདས་ཀྱིས་ཚེ་དང་ལྡན་པ་རབ་འབྱོར་ལ་འདི་སྐད་ཅེས་བཀའ་སྩལ་ཏོ་༎ རབ་འབྱོར༏་དེ་དེ་བཞིན་ནོ་༎ དེ་དེ་བཞིན་ཏེ་།
 paramāścaryasamanvāgatāste sattvā bhaviṣyanti, ye iha subhūte sūtre bhāṣyamāṇe notrasiṣyanti na (vajr, vaidya 81) saṃtrasiṣyanti na saṃtrāsamāpatsyante |	མདོ་འདི་བཤད་པ་འདི་ལ་གང་དག་མི་སྐྲག་མི་དང་བཞིང་དངང་བར་མི་འགྱུར་བའི་སེམས་ཅན་དེ་དག་ནི་། ངོ་མཚར་རབ་དང་ལྡན་པར་༄༢༢༤བ་འགྱུར་རོ་༎
 tatkasya hetoḥ?	དེ་ཅིའི་ཕྱིར་ཞེ་ན་། རབ་འབྱོར་།
 paramapāramiteyaṃ subhūte tathāgatena bhāṣitā yadutāpāramitā | yāṃ ca subhūte tathāgataḥ paramapāramitāṃ bhāṣate,	ཕ་རོལ་ཏུ་ཕྱིན་པ་དམ་པ་འདི་ནི་། དེ་བཞིན་གཤེགས་པས་གསུངས་ཏེ་།
 tāmaparimāṇā api buddhā bhagavanto bhāṣante |	ཕ་རོལ་ཏུ་ཕྱིན་པ་དམ་པ་གང་དག་དེ་བཞིན་གཤེགས་པས་གསུངས་པ་དེ༏་སངས་རྒྱས་བཅོམ་ལྡན་འདས་དཔག་ཏུ་མེད་པ་རྣམས་ཀྱིས་ཀྱང་གསུངས་པའི་ཕྱིར་ཏེ་། 
 tenocyante paramapāramiteti ||	དེས་ན་། ཕ་རོལ་ཏུ་ཕྱིན་པ་དམ་པ་ཞེས་བྱའོ་༎
 api tu khalu punaḥ subhute yā tathāgatasya kṣāntipāramitā,	ཡང་རབ་འབྱོར་།
 saiva apāramitā |	དེ་བཞིན་གཤེགས་པའི་བཟོད་པའི་ཕ་རོལ་ཏུ་ཕྱིན་པ་གང་ཡིན་པ་དེ་ཉིད་ཕ་རོལ་ཏུ་ཕྱིན་པ་མེད་དོ་༎ 
 tatkasya hetoḥ?	དེ་ཅིའི་ཕྱིར་ཞེ་ན་། རབ་འབྱོར་།
 yadā me subhūte kalirājā aṅgapratyaṅgamāṃsānyacchaitsīt,	གང་གི་ཚེ་ཀ་ལིངཀའི་རྒྱལ་པོས་ངའི་ཡན་ལག་དང་། ཉིང་ལག་རྣམ་པར་བཅད་པར་གྱུར་པ་དེའི་ཚེ་ང་ལ་བདག་ཏུ་འདུ་ཤེས་སམ་།
 nāsīnme tasmin samaye ātmasaṃjñā vā sattvasaṃjñā vā jīvasaṃjñā vā pudgalasaṃjñā vā,	སེམས་ཅན་དུ་འདུ་ཤེས་སམ་། སྲོག་ཏུ་འདུ་ཤེས་སམ་། གང་ཟག་ཏུ་འདུ་ཤེས་ཀྱང་མ་བྱུང་ཞིང་།
 nāpi me kācitsaṃjñā vā asaṃjñā vā babhūva |	ང་ལ་འདུ་ཤེས་ཅི་ཡང་མེད་ལ་། འདུ་ཤེས་མེད་པར་གྱུར་པ་ཡང་མ་ཡིན་པའི་ཕྱིར་རོ་༎
 tatkasya hetoḥ?	དེ་ཅིའི་ཕྱིར་ཞེ་ན་། རབ་འབྱོར་།
 sacenme subhūte tasmin samaye ātmasaṃjñā abhaviṣyat,	གལ་ཏེ་དེའི་ཚེ་བདག་ཏུ་འདུ་ཤེས་བྱུང་ན་།
 vyāpādasaṃjñāpi me tasmin samaye 'bhaviṣyat |	དེའི་ཚེ་གནོད་སེམས་ཀྱི་འདུ་ཤེས་ཀྱང་འབྱུང་ལ་།
 sacetsattvasaṃjñā jīvasaṃjñā pudgalasaṃjñābhaviṣyat,	སེམས་ཅན་དུ་འདུ་ཤེས་པ་དང་། སྲོག་ཏུ་འདུ་ཤེས་པ་དང་། གང་ཟག་ཏུ་འདུ་ཤེས་པ་བྱུང་ན་།
 vyāpādasaṃjñāpi me tasmin samaye 'bhaviṣyat | tatkasya hetoḥ?	དེའི་ཚེ་གནོད་སེམས་ཀྱི་འདུ་ཤེས་ཀྱང་འབྱུང་བའི་ཕྱིར་རོ་༎ རབ་འབྱོར་།
 abhijānāmyahaṃ subhūte atīte 'dhvani pañca jātiśatāni yadahaṃ kṣāntivādī ṛṣirabhūvam | tatrāpi me nātmasaṃjñā babhūva,	ངས་མངོན་པར་ཤེས་ཏེ༏་འདས་པའི་དུས་ན་ང་ཚེ་རབས་ལྔ་བརྒྱར་བཟོད་པར་སྨྲ་བ་ཞེས་བྱ་བའི་དྲང་སྲོང་དུ་གྱུར་པ་དེ་ན་ཡང་ང་ལ་བདག་ཏུ་འདུ་ཤེས་མ་བྱུང་།
 na sattvasaṃjñā, na jīvasaṃjñā,	སེམས་ཅན་དུ་འདུ་ཤེས་པ་དང་། སྲོག་ཏུ་འདུ་ཤེས་༄༢༢༥ཨ་༌༎
 na pudgalasaṃjñā babhūva |	པ་དང་། གང་ཟག་ཏུ་འདུ་ཤེས་པ་མ་བྱུང་ངོ་༎
 tasmāttarhi subhūte bodhisattvena mahāsattvena sarvasaṃjñā vivarjayitvā anuttarāyāṃ samyaksaṃbodhau cittamutpādayitavyam |	རབ་འབྱོར་། དེ་ལྟ་བས་ན་། བྱང་ཆུབ་སེམས་དཔའ་སེམས་དཔའ་ཆེན་པོས་འདུ་ཤེས་ཐམས་ཅད་རྣམ་པར་སྤངས་ཏེ་བླ་ན་མེད་པ་ཡང་དག་པར་རྫོགས་པའི་བྱང་ཆུབ་ཏུ་སེམས་བསྐྱེད་པར་བྱའོ་༎ 
 na rūpapratiṣṭhitaṃ cittamutpādayitavyam,	གཟུགས་ལ་མི་གནས་པར་སེམས་བསྐྱེད་པར་བྱའོ་༎
 na śabdagandharasaspraṣṭavyadharmapratiṣṭhitaṃ cittamutpādayitavyam, na dharmapratiṣṭhitaṃ cittamutpādayitavyam,	སྒྲ་དང་། དྲི་དང་། རོ་དང་། རེག་བྱ་དང་། ཆོས་ལའང་མི་གནས་པར་སེམས་བསྐྱེད་པར་བྱའོ་༎
 nādharmapratiṣṭhitaṃ cittamutpādayitavyam,	ཆོས་མེད་པ་ལའང་མི་གནས་པར་སེམས་བསྐྱེད་པར་བྱའོ་༎
 na kvacitpratiṣṭhitaṃ cittamutpādayitavyam |	ཅི་ལའང་མི་གནས་པར་སེམས་བསྐྱེད་པར་བྱའོ་༎
 tatkasya hetoḥ?	དེ་ཅིའི་ཕྱིར་ཞེ་ན་།
 yatpratiṣṭhitaṃ tadevāpratiṣṭhitam |	གནས་པ་གང་ཡིན་པ་དེ་ཉིད་མི་གནས་པའི་ཕྱིར་ཏེ་།
 tasmādeva tathāgato bhāṣate - apratiṣṭhitena bodhisattvena dānaṃ dātavyam | na rūpaśabdagandharasasparśadharmapratiṣṭhitena dānaṃ dātavyam ||	དེ་བས་ན་། དེ་བཞིན་གཤེགས་པས་འདི་སྐད་དུ་། བྱང་ཆུབ་སེམས་དཔས་མི་གནས་པར་སྦྱིན་པ་སྦྱིན་པར་བྱའོ་༎ ཞེས་གསུངས་སོ་༎
 api tu khalu punaḥ subhūte bodhisattvena evaṃrūpo dānaparityāgaḥ kartavyaḥ sarvasattvānāmarthāya | tatkasya hetoḥ?	ཡང་རབ་འབྱོར་། བྱང་ཆུབ་སེམས་དཔས་འདི་ལྟར་སེམས་ཅན་ཐམས་ཅད་ཀྱི་དོན་གྱི་ཕྱིར་སྦྱིན་པ་ཡོངས་སུ་གཏང་བར་བྱའོ་༎ 
 yā caiṣā subhūte sattvasaṃjñā, saiva asaṃjñā |	སེམས་ཅན་དུ་འདུ་ཤེས་པ་གང་ཡིན་པ་དེ་ཉིད་ཀྱང་འདུ་ཤེས་མེད་པ་སྟེ་།
 ya evaṃ te sarvasattvāstathāgatena bhāṣitāsta eva asattvāḥ |	དེ་བཞིན་གཤེགས་པས་སེམས་ཅན་ཐམས་ཅད་ཅེས་གང་གསུངས་པ་དེ་བདག་ཉིད་ཀྱང་མེད་པའོ་༎
 tatkasya hetoḥ?	དེ་ཅིའི་ཕྱིར་ཞེ་ན་། རབ་འབྱོར་། དེ་བཞིན་གཤེགས་པ་ནི་།
 bhūtavādī subhūte tathāgataḥ,	ཡང་དག་པར་གསུང་པ་།
 satyavādī tathāvādī ananyathāvādī tathāgataḥ,	བདེན་པར་གསུང་བ་། དེ་བཞིན་ཉིད་དུ་གསུང་བ་སྟེ་། དེ་བཞིན་གཤེགས་པ་ནི་།
 na vitathavādī tathāgataḥ ||	མ་ནོར་བ་དེ་བཞིན་ཉིད་གསུང་བའི་ཕྱིར་རོ་༎
 api tu khalu punaḥ subhūte yastathāgatena dharmo 'bhisaṃbuddho deśito nidhyātaḥ,	༄༢༢༥བ་ཡང་རབ་འབྱོར་། དེ་བཞིན་གཤེགས་པས་ཆོས་གང་མངོན་པར་རྫོགས་པར་སངས་རྒྱས་པའམ་། བསྟན་པ་དེ་ལ་ནི་།
 na tatra satyaṃ na mṛṣā |	བདེན་པ་ཡང་མེད་། རྫུན་པ་ཡང་མེད་དོ་༎ རབ་འབྱོར་།
 tadyathāpi nāma subhūte puruṣo 'ndhakārapraviṣṭo na kiṃcidapi paśyet,	འདི་ལྟ་སྟེ༏་དཔེར་ན་། མིག་དང་ལྡན་པའི་མི་ཞིག་མུན་པར་ཞུགས་ན་ཅི་ཡང་མི་མཐོང་བ་དེ་བཞིན་དུ་གང་དངོས་པོར་ལྷུང་བས་སྦྱིན་པ་ཡོངས་སུ་གཏོང་བའི་བྱང་ཆུབ་སེམས་དཔར་བལྟའོ༏་༏རབ་འབྱོར་། འདི་ལྟ་སྟེ་།
 evaṃ vastupatito bodhisattvo draṣṭavyo yo vastupatito dānaṃ parityajati | tadyathāpi nāma subhūte cakṣuṣmān puruṣaḥ prabhātāyāṃ rātrau sūrye 'bhyudgate nānavidhāni rūpāṇi paśyet, evamavastupatito bodhisattvo draṣṭavyo yo 'vastupatito dānaṃ parityajati ||	དཔེར་ན་། ནམ་ལངས་ཏེ་ཉི་མ་ཤར་ནས་མིག་དང་ལྡན་པའི་མིས་གཟུགས་རྣམ་པ་སྣ་ཚོགས་དག་མཐོང་བ་དེ་བཞིན་དུ་གང་དངོས་པོར་མ་ལྷུང་བས་སྦྱིན་པ་ཡོངས་སུ་གཏོང་བའི་བྱང་ཆུབ་སེམས་དཔར་བལྟའོ་༎ ཡང་རབ་འབྱོར་།
 api tu khalu punaḥ subhūte ye kulaputrā vā kuladuhitaro vā imaṃ dharmaparyāyamudgrahīṣyanti dhārayiṣyanti vācayiṣyanti paryavāpsyanti, parebhyaśca vistareṇa saṃprakāśayiṣyanti, (vajr, vaidya 82)	རིགས་ཀྱི་བུའམ་། རིགས་ཀྱི་བུ་མོ་གང་དག་ཆོས་ཀྱི་རྣམ་གྲངས་འདི་ལེན་པ་དང་། འཛིན་པ་དང་། ཀློག་པ་དང་། ཀུན་ཆུབ་པར་བྱེད་པ་དང་། གཞན་དག་ལ་ཡང་རྒྱ་ཆེར་ཡང་དག་པར་རབ་ཏུ་སྟོན་པ་དེ་དག་ནི་།
 jñātāste subhūte tathāgatena buddhajñānena,	དེ་བཞིན་གཤེགས་པས་མཁྱེན་། དེ་དག་ནི་།
 dṛṣṭāste subhūte tathāgatena buddhacakṣuṣā, buddhāste tathāgatena |	དེ་བཞིན་གཤེགས་པས་གཟིགས་ཏེ་།
 sarve te subhūte sattvā aprameyamasaṃkhyeyaṃ puṇyaskandhaṃ prasaviṣyanti pratigrahīṣyanti || 14 ||	སེམས་ཅན་དེ་དག་ཐམས་ཅད་ནི་། བསོད་ནམས་ཀྱི་ཕུང་པོ་དཔག་ཏུ་མེད་པ་བསྐྱེད་པར་འགྱུར་རོ་༎ ཡང་རབ་འབྱོར་།
 yaśca khalu punaḥ subhūte strī vā puruṣo vā purvāhṇakālasamaye gaṅgānadīvālukāsamānātmabhāvān parityajet, evaṃ madhyāhnakālasamaye gaṅgānadīvālukāsamānātmabhāvān parityajet,	སྐྱེས་པའམ་། བུད་མེད་གང་ཞིག་སྔ་དྲོའི་དུས་ཀྱི་ཚེ་ལུས་གངགའའི་ཀླུང་གི་བྱེ་མ་སྙེད་ཡོངས་སུ་གཏོང་ལ་། ཕྱེད་ཀྱི་དུས་དང་། ཕྱི་དྲོའི་དུས་ཀྱི་ཚེ་ཡང་ལུས་གངགའའི་ཀླུང་གི་བྱེ་མ་སྙེད་ཡོངས་སུ་གཏོང་སྟེ་། རྣམ་གྲངས་འདི་ལྟ་༄༢༢༦ཨ་༌༎
 sāyāhnakālasamaye gaṅgānadīvālukāsamānātmabhāvān parityajet, anena paryāyeṇa bahūni kalpakoṭiniyutaśatasahasrāṇyātmabhāvān parityajet,	བུར་བསྐལ་པ་བྱེ་བ་ཁྲག་ཁྲིག་འབུམ་ཕྲག་དུ་མར་ལུས་ཡོངས་སུ་གཏོང་བ་བས་།
 yaścemaṃ dharmaparyāyaṃ śrutvā na pratikṣipet,	གང་གིས་ཆོས་ཀྱི་རྣམ་གྲངས་འདི་ཐོས་ནས་མི་སྤོང་ན་།
 ayameva tatonidānaṃ bahutaraṃ puṇyaskandhaṃ prasunuyādaprameyamasaṃkhyeyam,	དེ་ཉིད་གཞི་དེ་ལས་བསོད་ནམས་ཆེས་མང་དུ་གྲངས་མེད་དཔག་ཏུ་མེད་པ་བསྐྱེད་ན་།
 kaḥ punarvādo yo likhitvā udgṛhṇīyāddhārayedvācayetparyavāpnuyāt, parebhyaśca vistareṇa saṃprakāśayet ||	གང་གིས་ཡི་གེར་བྲིས་ནས་ལེན་པ་དང་། འཛིན་པ་དང་། ཀློག་པ་དང་། ཀུན་ཆུབ་པར་བྱེད་པ་དང་། གཞན་དག་ལ་ཡང་རྒྱ་ཆེར་ཡང་དག་པར་རབ་ཏུ་སྟོན་པ་ལྟ་ཅི་སྨོས་།
 api tu khalu punaḥ subhūte acintyo 'tulyo 'yaṃ dharmaparyāyaḥ |	ཡང་རབ་འབྱོར་། ཆོས་ཀྱི་རྣམ་གྲངས་འདི་ནི་། བསམ་གྱིས་མི་ཁྱབ་ཅིང་མཚུངས་པ་མེད་དེ་།
 ayaṃ ca subhūte dharmaparyāyastathāgatena bhāṣito 'grayānasaṃprasthitānāṃ sattvānāmarthāya,	ཆོས་ཀྱི་རྣམ་གྲངས་འདི་ནི༏་ཐེག་པ་མཆོག་ལ་ཡང་དག་པར་ཞུགས་པའི་སེམས་ཅན་རྣམས་ཀྱི་དོན་དང་། 
 śreṣṭhayānasaṃprasthitānāṃ sattvānāmarthāya |	ཐེག་པ་ཕུལ་དུ་ཕྱིན་པ་ལ་ཡང་དག་པར་ཞུགས་པའི་སེམས་ཅན་རྣམས་ཀྱི་དོན་གྱི་ཕྱིར་དེ་བཞིན་གཤེགས་པས་གསུངས་སོ་༎
 ye imaṃ dharmaparyāyamudgrahīṣyanti dhārayiṣyanti vācayiṣyanti paryavāpsyanti, parebhyaśca vistareṇa saṃprakāśayiṣyanti, jñātāste subhūte tathāgatena buddhajñānena, dṛṣṭāste subhūte tathāgatena buddhacakṣuṣā,	གང་དག་ཆོས་ཀྱི་རྣམ་གྲངས་འདི་ལེན་པ་དང་། འཛིན་པ་དང་། ཀློག་པ་དང་། ཀུན་ཆུབ་པར་བྱེད་པ་དང་། གཞན་དག་ལ་ཡང་རྒྱ་ཆེར་ཡང་དག་པར་རབ་ཏུ་སྟོན་པ་དེ་དག་ནི་།
 buddhāste tathāgatena |	དེ་བཞིན་གཤེགས་པས་མཁྱེན་། དེ་དག་ནི་།
 sarve te subhūte sattvā aprameyeṇa puṇyaskandhenāṃ samanvāgatā bhaviṣyanti |	དེ་བཞིན་གཤེགས་པས་གཟིགས་ཏེ་། སེམས་ཅན་དེ་དག་ཐམས་ཅད་ནི་། བསོད་ནམས་ཀྱི་ཕུང་པོ་དཔག་ཏུ་མེད་པ་དང་ལྡན་པར་འགྱུར་རོ་༎
 acintyenātulyenāmāpyenāparimāṇena puṇyaskandhena samanvāgatā bhaviṣyanti |	བསོད་ནམས་ཀྱི་ཕུང་པོ་བསམ་གྱིས་མི་ཁྱབ་པ་དང་། མཚུངས་པ་མེད་པ་དང་། གཞལ་དུ་མེད་པ་དང་། ཚད་མེད་པ་དང་ལྡན་༄༢༢༦བ་པར་འགྱུར་ཏེ་།
 sarve te subhūte sattvāḥ samāṃśena bodhiṃ dhārayiṣyanti vacayiṣyanti paryavāpsyanti |	སེམས་ཅན་དེ་དག་ཐམས་ཅད་ངའི་བྱང་ཆུབ་ཕྲག་པ་ལ་ཐོགས་པར་འགྱུར་རོ་༎
 tatkasya hetoḥ?	དེ་ཅིའི་ཕྱིར་ཞེ་ན་། རབ་འབྱོར་།
 na hi śakyaṃ subhūte ayaṃ dharmaparyāyo hīnādhimuktiakaiḥ sattvaiḥ śrotum,	དམན་པ་ལ་མོས་པ་རྣམས་ཀྱིས་ཆོས་ཀྱི་རྣམ་གྲངས་འདི་མཉན་པར་མི་ནུས་ཏེ་།
 nātmadṛṣṭikairna sattvadṛṣṭikairna jīvadṛṣṭikairna pudgaladṛṣṭikaiḥ |	བདག་ཏུ་ལྟ་བ་རྣམས་ཀྱིས་མ་ཡིན་། སེམས་ཅན་དུ་ལྟ་བ་རྣམས་ཀྱིས་མ་ཡིན་། སྲོག་ཏུ་ལྟ་བ་རྣམས་ཀྱིས་མ་ཡིན་ཞིང་།
 nābodhisattvapratijñai sattvaiḥ śakyamayaṃ dharmaparyāyaḥ śrotuṃ vā udgrahītuṃ vā dhārayituṃ vā vācayituṃ vā paryavāptuṃ vā | nedaṃ sthānaṃ vidyate ||	གང་ཟག་ཏུ་ལྟ་བ་རྣམས་ཀྱིས་མཉན་པ་དང་། བླང་བ་དང་། གཟུང་བ་དང་། ཀློག་པ་དང་། ཀུན་ཆུབ་པར་བྱེད་མི་ནུས་ཏེ་། དེ་ནི་། གནས་མེད་པའི་ཕྱིར་རོ་༎
 api tu khalu punaḥ subhūte yatra pṛthivīpradeśe idaṃ sūtraṃ prakaśayiṣyate,	ཡང་རབ་འབྱོར་། ས་ཕྱོགས་གང་ན་མདོ་སྡེ་འདི་སྟོན་པའི་ས་ཕྱོགས་དེ་།
 pūjanīyaḥ sa pṛthivīpradeśo bhaviṣyati sadevamānuṣāsurasya lokasya |	ལྷ་དང་། མི་དང་། ལྷ་མ་ཡིན་དུ་བཅས་པའི་འཇིག་རྟེན་གྱིས་མཆོད་པར་འོས་པར་འགྱུར་རོ་༎
 vandanīyaḥ pradakṣiṇīyaśca sa pṛthivīpradeśo bhaviṣyati,	ས་ཕྱོགས་དེ་ཕྱག་བྱ་བར་འོས་པ་དང་། བསྐོར་བ་བྱ་བར་འོས་པར་ཡང་འགྱུར་རོ་༎
 caityabhūtaḥ sa pṛthivīpradeśo bhaviṣyati || 15 ||	ས་ཕྱོགས་དེ་ནི་། མཆོད་རྟེན་ལྟ་བུར་འགྱུར་རོ་༎ རབ་འབྱོར་།
 api tu ye te subhūte kulaputrā vā kuladuhitaro vā imānevaṃrūpān sūtrāntānudgrahīṣyanti dhārayiṣyanti vācayiṣyanti paryavāpsyanti, yoniśaśca manasikariṣyanti, parebhyaśca vistareṇa saṃprakāśayiṣyanti,	རིགས་ཀྱི་བུའམ་རིགས་ཀྱི་བུ་མོ་གང་དག་འདི་ལྟ་བུའི་མདོ་སྡེའི་ཚིག་འདི་དག་ལེན་པ་དང་། འཛིན་པ་དང་། ཀློག་པ་དང་། ཀུན་ཆུབ་པར་བྱེད་པ་དེ་དག་ནི་།
 te paribhūtā bhaviṣyanti, suparibhūtāśca bhaviṣyanti |	མནར་བར་འགྱུར་། ཤིན་ཏུ་མནར་བར་འགྱུར་རོ་༎
 tatkasya hetoḥ?	དེ་ཅིའི་ཕྱིར་ཞེ་ན་། རབ་འབྱོར་།
 yāni ca teṣāṃ subhūte sattvānāṃ paurvajanmikānyaśubhāni karmāṇi kṛtānyapāyasaṃvartanīyāni, (vajr, vaidya 83)	སེམས་ཅན་དེ་དག་གིས་ཚེ་རབས་སྔ་མའི་མི་དགེ་བའི་ལས་ངན་སོང་དུ་སྐྱེ་བར་འགྱུར་བ་གང་དག་བྱས་པ་དག་ཚེ་འདི་ཉིད་ལ་མནར་བས་། 
 dṛṣṭa eva dharme paribhūtatayā tāni paurvajanmikānyaśubhāni karmāṇi kṣapayiṣyanti,	ཚེ་རབས་སྔ་མའི་མི་དགེ་བའི་ལས་དེ་དག་འབྱང་བར་འགྱུར་ཏེ་།
 buddhabodhiṃ cānuprāpsyanti ||	སངས་རྒྱས་ཀྱི་བྱང་༄༢༢༧ཨ་༌༎ ཆུབ་ཀྱང་འཐོབ་པར་འགྱུར་བའི་ཕྱིར་རོ་༎
 abhijānāmyahaṃ subhūte atīte 'dhvanyasaṃkhyeyaiḥ kalpairasaṃkhyeyatarairdīpaṃkarasya	རབ་འབྱོར་། ངས་མངོན་པར་ཤེས་ཏེ་། འདས་པའི་དུས་བསྐལ་པ་གྲངས་མེད་པའི་ཡང་ཆེས་གྲངས་མེད་པ་ན་།
 tathāgatasyārhataḥ samyaksaṃbuddhasya pareṇa paratareṇa caturaśītibuddhakoṭiniyutaśatasahasrāṇyabhūvan ye mayārāgitāḥ, ārāgya na virāgitāḥ |	དེ་བཞིན་གཤེགས་པ་དགྲ་བཅོམ་པ་ཡང་དག་པར་རྫོགས་པའི་སངས་རྒྱས་མར་མེ་མཛད་ཀྱི་ཕ་རོལ་གྱི་ཡང་ཆེས་ཕ་རོལ་ན་། སངས་རྒྱས་བྱེ་བ་ཁྲག་ཁྲིག་འབུམ་ཕྲག་བརྒྱད་ཅུ་རྩ་བཞི་དག་བྱུང་བ་ངས་མཉེས་པར་བྱས་ཏེ་། མཉེས་པར་བྱས་ནས་ཐུགས་མ་ཕྱུང་བར་བྱས་ཏེ་། རབ་འབྱོར་།
 yacca mayā subhūte te buddhā bhagavanta ārāgitāḥ, ārāgya na virāgitāḥ,	སངས་རྒྱས་བཅོམ་ལྡན་འདས་དེ་དག་ངས་མཉེས་པར་བྱས་ནས་ཐུགས་བྱུང་བར་མ་བྱས་པ་གང་ཡིན་པ་དང་། 
 yacca paścime kāle paścime samaye paścimāyāṃ pañcaśatyāṃ saddharmavipralopakāle vartamāne imānevaṃrūpān sūtrāntānudgrahīṣyanti dhārayiṣyanti vācayiṣyanti paryavāpsyanti, parebhyaśca vistareṇa saṃprakāśayiṣyanti,	ཕྱི་མའི་དུས་ལྔ་བརྒྱ་ཐ་མར་གྱུར་པ་ན་། མདོ་སྡེ་འདི་ལེན་པ་དང་། འཛིན་པ་དང་། ཀློག་པ་དང་། ཀུན་ཆུབ་པར་བྱེད་པ་གང་ཡིན་པ་ལས་།
 asya khalu punaḥ subhūte puṇyaskandhasyāntikādasau paurvakaḥ puṇyaskandhaḥ śatatamīmapi kalāṃ nopaiti,	རབ་འབྱོར་། བསོད་ནམས་ཀྱི་ཕུང་པོ་འདི་ལ་བསོད་ནམས་ཀྱི་ཕུང་པོ་སྔ་མས་བརྒྱའི་ཆར་ཡང་མི་ཕོད་།
 sahasratamīmapi śatasahasratamīmapi koṭimamipi koṭiśatatamīmapi koṭiśatasahasratamīmapi koṭiniyutaśatasahasratamīmapi | saṃkhyāmapi kalāmapi gaṇanāmapi upamāmapi upaniṣadamapi yāvadaupamyamapi na kṣamate ||	སྟོང་གི་ཆ་དང་། འབུམ་གྱི་ཆ་དང་། གྲངས་དང་། ཆ་དང་། བགྲང་བ་དང་། དཔེ་དང་། ཟླ་དང་། རྒྱུར་ཡང་མི་བཟོད་དོ་༎ རབ་འབྱོར་།
 sacetpunaḥ subhūte teṣāṃ kulaputrāṇāṃ kuladuhitṝṇāṃ vā ahaṃ puṇyaskandhaṃ bhāṣeyam, yāvatte kulaputrā vā kuladuhitaro vā tasmin samaye puṇyaskandhaṃ prasaviṣyanti, pratigrahīṣyanti,	གལ་ཏེ་དེའི་ཚེ་རིགས་ཀྱི་བུའམ་རིགས་ཀྱི་བུ་མོ་དག་བསོད་ནམས་ཀྱི་ཕུང་པོ་ཇི་སྙེད་རབ་ཏུ་འཛིན་པར་འགྱུར་བའི་རིགས་ཀྱི་བུའམ་རིགས་ཀྱི་བུ་མོ་དེ་དག་གི་བསོད་ནམས་ཀྱི་ཕུང་པོ་ངས་བརྗོད་ན་། སེམས་ཅན་རྣམས་མྱོ་མྱོ་པོར་འགྱུར་ཏེ་།
 unmādaṃ sattvā anuprāpnuyuścittavikṣepaṃ vā gaccheyuḥ |	སེམས་འཁྲུགས་པར་འགྱུར་རོ་༎
 api tu khalu punaḥ subhūte acintyo 'tulyo 'yaṃ dharmaparyāyastathāgatena bhāṣitaḥ |	ཡང་རབ་འབྱོར་། ཆོས་ཀྱི་རྣམ་༄༢༢༧བ་གྲངས་འདི་བསམ་གྱིས་མི་ཁྱབ་སྟེ་།
 asya acintya eva vipākaḥ pratikāṅkṣitavyaḥ || 16 ||	འདིའི་རྣམ་པར་སྨིན་པ་ཡང་བསམ་གྱིས་མི་ཁྱབ་པ་ཉིད་དུ་རིག་པར་བྱའོ་༎
 atha khalvāyuṣmān subhūtirbhagavantametadavocat - kathaṃ bhagavan bodhisattvayānasaṃprasthitena sthātavyam,	དེ་ནས་བཅོམ་ལྡན་འདས་ལ་ཚེ་དང་ལྡན་པ་རབ་འབྱོར་གྱིས་འདི་སྐད་ཅེས་གསོལ་ཏོ་༎ བཅོམ་ལྡན་འདས་། བྱང་ཆུབ་སེམས་དཔའི་ཐེག་པ་ལ་ཡང་དག་པར་ཞུགས་པས་ཇི་ལྟར་གནས་པར་བགྱི་།
 kathaṃ pratipattavyam,	ཇི་ལྟར་བསྒྲུབ་པར་བགྱི་།
 kathaṃ cittaṃ pragrahītavyam?	ཇི་ལྟར་སེམས་རབ་ཏུ་གཟུངས་བར་བགྱི་། བཅོམ་ལྡན་འདས་ཀྱིས་བཀའ་སྩལ་པ་།
 bhagavānāha - iha subhūte bodhisattvayānasaṃprasthitena evaṃ cittamutpādayitavyam - sarve sattvā mayā anupadhiśeṣe nirvāṇadhātau parinirvāpayitavyāḥ	རབ་འབྱོར་། འདི་ལ་བྱང་ཆུབ་སེམས་དཔའི་ཐེག་པ་ལ་ཡང་དག་པར་ཞུགས་པས་འདི་སྙམ་དུ་། བདག་གིས་སེམས་ཅན་ཐམས་ཅད་ཕུང་པོ་ལྷག་མ་མེད་པའི་མྱ་ངན་ལས་འདས་པའི་དབྱིངས་སུ་ཡོངས་སུ་མྱ་ངན་ལས་བཟླའོ་༎
 evaṃ sa sattvān parinirvāpya na kaścitsattvaḥ parinirvāpito bhavati |	དེ་ལྟར་སེམས་ཅན་རྣམས་ཡོངས་སུ་མྱ་ངན་ལས་བཟླས་ཀྱང་སེམས་ཅན་གང་ཡང་ཡོངས་སུ་མྱ་ངན་ལས་བཟླས་པར་གྱུར་པ་མེད་དོ་༎ སྙམ་དུ་སེམས་བསྐྱེད་པར་བྱའོ་༎
 tatkasya hetoḥ?	དེ་ཅིའི་ཕྱིར་ཞེ་ན་། རབ་འབྱོར་།
 sacetsubhūte bodhisattvasya sattvasaṃjñā pravarteta,	གལ་ཏེ་བྱང་ཆུབ་སེམས་དཔའ་སེམས་ཅན་དུ་འདུ་ཤེས་འཇུག་ན་།
 na sa bodhisattva iti vaktavyaḥ |	བྱང་ཆུབ་སེམས་དཔའ་ཞེས་མི་བྱ་ལ་།
 jīvasaṃjñā vā yāvatpudgalasaṃjñā vā pravarteta, na sa bodhisattva iti vaktavyaḥ |	གང་ཟག་གི་བར་དུ་འདུ་ཤེས་འཇུག་ན་ཡང་དེ་བྱང་ཆུབ་སེམས་དཔའ་ཞེས་མི་བྱ་བའི་ཕྱིར་རོ་༎ 
 tatkasya hetoḥ?	དེ་ཅིའི་ཕྱིར་ཞེ་ན་། རབ་འབྱོར་།
 nāsti subhūte sa kaściddharmo yo bodhisattvayānasaṃprasthito nāma ||	གང་བྱང་ཆུབ་སེམས་དཔའི་ཐེག་པ་ལ་ཡང་དག་པར་ཞུགས་པ་ཞེས་བྱ་བའི་ཆོས་དེ་གང་ཡང་མེད་པའི་ཕྱིར་རོ་༎ རབ་འབྱོར་།
 (vajr, vaidya 84) tatkiṃ manyase subhūte asti sa kaściddharmo yastathāgatena dīpaṃkarasya tathāgatasyāntikādanuttarāṃ samyaksaṃbodhimabhisaṃbuddhaḥ?	འདི་ཇི་སྙམ་དུ་སེམས་། དེ་བཞིན་༄༢༢༨ཨ་༌༎ གཤེགས་པས་དེ་བཞིན་གཤེགས་པ་མར་མེ་མཛད་ལས་གང་བླ་ན་མེད་པ་ཡང་དག་པར་རྫོགས་པའི་བྱང་ཆུབ་མངོན་པར་རྫོགས་པར་སངས་རྒྱས་པའི་ཆོས་དེ་གང་ཡང་ཡོད་དམ་།
 evamukte āyuṣmān subhūtirbhagavantametadavocat - yathāhaṃ bhagavato bhāṣitasyārthamājānāmi,	དེ་སྐད་ཅེས་བཀའ་སྩལ་པ་དང་། བཅོམ་ལྡན་འདས་ལ་ཚེ་དང་ལྡན་པ་རབ་འབྱོར་གྱིས་འདི་སྐད་ཅེས་གསོལ་ཏོ་༎
 nāsti sa bhagavan kaściddharmo yastathāgatena dīpaṃkarasya tathāgatasyārhataḥ samyaksaṃbuddhasyāntikādanuttarāṃ samyaksaṃbodhimabhisaṃbuddhaḥ	བཅོམ་ལྡན་འདས༏་དེ་བཞིན་གཤེགས་པས་དེ་བཞིན་གཤེགས་པ་མར་མེ་མཛད་ལས་གང་བླ་ན་མེད་པ་ཡང་དག་པར་རྫོགས་པའི་བྱང་ཆུབ་མངོན་པར་རྫོགས་པར་སངས་རྒྱས་པའི་ཆོས་དེ་ཡང་མ་མཆིས་སོ་༎ དེ་སྐད་ཅེས་གསོལ་པ་དང་། བཅོམ་ལྡན་འདས་ཀྱིས་ཚེ་དང་ལྡན་པ་རབ་འབྱོར་ལ་འདི་སྐད་ཅེས་བཀའ་སྩལ་ཏོ་༎
 evamukte bhagavānāyuṣmantaṃ subhūtimetadavocat - evametatsubhūte, evametat |	རབ་འབྱོར་། དེ་དེ་བཞིན་ནོ་༎ དེ་དེ་བཞིན་ཏེ་།
 nāsti subhūte sa kaściddharmo yastathāgatena dīpaṃkarasya tathāgatasyārhataḥ samyaksaṃbuddhasyāntikādanuttarāṃ samyaksaṃbodhimabhisaṃbuddhaḥ	དེ་བཞིན་གཤེགས་པས་དེ་བཞིན་གཤེགས་པ་མར་མེ་མཛད་ལས་གང་བླ་ན་མེད་པ་ཡང་དག་པར་རྫོགས་པའི་བྱང་ཆུབ་མངོན་པར་རྫོགས་པར་སངས་རྒྱས་པའི་ཆོས་དེ་གང་ཡང་མེད་དོ་༎ རབ་འབྱོར་།
 sacetpunaḥ subhūte kaściddharmastathāgatenābhisaṃbuddho 'bhaviṣyat,	གལ་ཏེ་དེ་བཞིན་གཤེགས་པས་གང་མངོན་པར་རྫོགས་པར་སངས་རྒྱས་པའི་ཆོས་དེ་འགའ་ཞིག་ཡོད་པར་གྱུར་ན་། 
 na māṃ dīpaṃkarastathāgato vyākariṣyat - bhaviṣyasi tvaṃ māṇava anāgate 'dhvani śākyamunirnāma tathāgato 'rhan samyaksaṃbuddha iti |	དེ་བཞིན་གཤེགས་པ་མར་མེ་མཛད་ཀྱིས་ང་ལ་བྲམ་ཟེའི་ཁྱེའུ་། ཁྱོད་མ་འོངས་པའི་དུས་ན་དེ་བཞིན་གཤེགས་པ་དགྲ་བཅོམ་པ་ཡང་དག་པར་རྫོགས་པའི་སངས་རྒྱས་ཤའཀྱ་ཐུབ་པ་༄༢༢༨བ་ཞེས་བྱ་བར་འགྱུར་རོ་༎ ཞེས་ལུང་མི་སྟོན་པ་ཞིག་ན་།
 yasmāttarhi subhūte tathāgatenārhatā samyaksaṃbuddhena nāsti sa kaściddharmo yo 'nuttarāṃ samyaksaṃbodhimabhisaṃbuddhaḥ,	རབ་འབྱོར་། འདི་ལྟར་དེ་བཞིན་གཤེགས་པས་གང་བླ་ན་མེད་པ་ཡང་དག་པར་རྫོགས་པའི་བྱང་ཆུབ་མངོན་པར་རྫོགས་པར་སངས་རྒྱས་པའི་ཆོས་དེ་གང་ཡང་མེད་པས་། 
 tasmādahaṃ dīpaṃkareṇa tathāgatena vyākṛta - bhaviṣyasi tvaṃ māṇava anāgate 'dhvani śākyamunirnāma tathāgato 'rhan samyaksaṃbuddha |	དེའི་ཕྱིར་དེ་བཞིན་གཤེགས་པ་མར་མེ་མཛད་ཀྱིས་ངལ་བྲམ་ཟེའི་ཁྱེའུ་། ཁྱོད་མ་འོངས་པའི་དུས་ན་དེ་བཞིན་གཤེགས་པ་དགྲ་བཅོམ་པ་ཡང་དག་པར་རྫོགས་པའི་སངས་རྒྱས་ཤའཀྱ་ཐུབ་པ་ཞེས་བྱ་བར་འགྱུར་རོ་༎ ཞེས་ལུང་བསྟན་ཏོ་༎
 tatkasya hetoḥ?	དེ་ཅིའི་ཕྱིར་ཞེ་ན་། རབ་འབྱོར་།
 tathāgata iti subhūte bhūtatathatāyā etadadhivacanam | tathāgata iti subhūte anutpādadharmatāyā etadadhivacanam | tathāgata iti subhūte dharmocchedasyaitadadhivacanam | tathāgata iti subhūte atyantānutpannasyaitadadhivacanam | tatkasya hetoḥ? eṣa subhūte anutpādo yaḥ paramārthaḥ |	དེ་བཞིན་གཤེགས་པ་ཞེས་བྱ་བ་ནི་། ཡང་དག་པ་དེ་བཞིན་ཉིད་ཀྱི་ཚིག་བླ་དབ༹གས་ཡིན་པའི་ཕྱིར་རོ་༎ རབ་འབྱོར་།
 yaḥ kaścitsubhūte evaṃ vadet - tathāgatenārhatā samyaksaṃbuddhena anuttarā samyaksaṃbodhirabhisaṃbuddheti,	གང་ལ་ལ་ཞིག་འདི་སྐད་དུ་། དེ་བཞིན་གཤེགས་པ་དགྲ་བཅོམ་པ་ཡང་དག་པར་རྫོགས་པའི་སངས་རྒྱས་ཀྱིས་བླ་ན་མེད་པ་ཡང་དག་པར་རྫོགས་པའི་བྱང་ཆུབ་མངོན་པར་རྫོགས་པར་སངས་རྒྱས་སོ་༎ ཞེས་ཟེར་ན་།
 sa vitathaṃ vadet | abhyācakṣīta māṃ sa subhūte asatodgṛhītena |	དེ་ལོག་པར་སྨྲ་བ་ཡིན་ནོ་༎
 tatkasya hetoḥ -?	དེ་ཅིའི་ཕྱིར་ཞེ་ན་། རབ་འབྱོར་།
 nāsti subhūte sa kaściddharmo yastathāgatena anuttarāṃ samyaksaṃbodhimabhisaṃbuddhaḥ |	དེ་བཞིན་གཤེགས་པས་གང་བླ་ན་མེད་པ་ཡང་དག་པར་རྫོགས་པའི་བྱང་ཆུབ་མངོན་པར་རྫོགས་པར་སངས་རྒྱས་པའི་ཆོས་དེ་གང་ཡང་མེད་པའི་ཕྱིར་རོ་༎ རབ་འབྱོར་།
 yaśca subhūte tathāgatena dharmo 'bhisaṃbuddho deśito vā tatra na satyaṃ na mṛṣā |	དེ་བཞིན་གཤེགས་པས་ཆོས་གང་མངོན་པར་རྫོགས་པར་སངས་རྒྱས་པ་དེ་ལ་བདེན་པ་ཡང་མེད་། རྫུན་པ་ཡང་མེད་དེ་། དེ་བས་ན་།
 tasmāttathāgato bhāṣate - sarvadharmā buddhadharmā iti | tatkasya hetoḥ?	དེ་བཞིན་གཤེགས་པས་ཆོས་ཐམས་ཅད་སངས་རྒྱས་༄༢༢༩ཨ་༌༎ ཀྱི་ཆོས་སོ་༎ ཞེས་གསུངས་ངོ་༎
 sarvadharmā iti subhūte adharmāstathāgatena bhāṣitāḥ |	རབ་འབྱོར་། ཆོས་ཐམས་ཅད་ཅེས་བྱ་བ་ནི་། དེ་དག་ཐམས་ཅད་ཆོས་མེད་པ་ཡིན་ཏེ་།
 tasmāducyante sarvadharmā buddhadharmā iti ||	དེ་བས་ན་། ཆོས་ཐམས་ཅད་སངས་རྒྱས་ཀྱི་ཆོས་ཞེས་བྱའོ་༎ རབ་འབྱོར་།
 tadyathāpi nāma subhūte puruṣo bhavedupetakāyo mahākāyaḥ?	འདི་ལྟ་སྟེ་། དཔེར་ན་། མི་ཞིག་ལུས་དང་ལྡན་ཞིང་ལུས་ཆེན་པོར་གྱུར་པ་བཞིན་ནོ་༎
 āyuṣmān subhūtirāha - yo 'sau bhagavaṃstathāgatena puruṣo bhāṣita upetakāyo mahākāya iti,	ཚེ་དང་ལྡན་པ་རབ་འབྱོར་གྱིས་གསོལ་པ༏་བཅོམ་ལྡན་འདས་། དེ་བཞིན་གཤེགས་པས་མི་ཞིག་ལུས་དང་ལྡན་ཞིང་ལུས་ཆེན་པོ་ཞེས་གང་གསུངས་པ་དེ་།
 akāyaḥ sa bhagavaṃstathāgatena bhāṣitaḥ |	དེ་བཞིན་གཤེགས་པས་ལུས་མ་མཆིས་པར་གསུངས་ཏེ་།
 tenocyate upetakāyo mahākāya iti ||	དེས་ན་། ལུས་དང་ལྡན་ཞིང་ལུས་ཆེན་པོ་ཞེས་བགྱིའོ་༎
 bhagavānāha - evametatsubhūte |	བཅོམ་ལྡན་འདས་ཀྱིས་བཀའ་སྩལ་པ་། རབ་འབྱོར་། དེ་དེ་བཞིན་ཏེ་།
 yo bodhisattva evaṃ vadet - ahaṃ sattvān parinirvāpayiṣyāmiti,	བྱང་ཆུབ་སེམས་དཔའ་གང་འདི་སྐད་དུ་། བདག་གིས་སེམས་ཅན་རྣམས་ཡོངས་སུ་མྱ་ངན་ལས་བཟླའོ་༎ ཞེས་ཟེར་ན་།
 na sa bodhisattva iti vaktavyaḥ |	དེ་བྱང་ཆུབ་སེམས་དཔའ་ཞེས་མི་བྱའོ་༎
 tatkasya hetoḥ?	དེ་ཅིའི་ཕྱིར་ཞེ་ན་། རབ་འབྱོར་།
 asti subhūte sa kaściddharmo yo bodhisattvo nāma?	གང་བྱང་ཆུབ་སེམས་དཔའ་ཞེས་བྱ་བའི་ཆོས་དེ་གང་ཡང་ཡོད་དམ་།
 subhūtirāha - no hīdaṃ bhagavan | nāsti sa kaściddharmo yo bodhisattvo (vajr, vaidya 85) nāma | bhagavānāha - sattvāḥ sattvā iti subhūte asattvāste tathāgatena bhāṣitāḥ,	རབ་འབྱོར་གྱིས་གསོལ་པ་། བཅོམ་ལྡན་འདས་། དེ་ནི་། མ་མཆིས་ལགས་སོ་༎ བཅོམ་ལྡན་འདས་ཀྱིས་བཀའ་སྩལ་པ་། རབ་འབྱོར་།
 tenocyante sattvā iti |	དེ་བས་ན་།
 tasmāttathāgato bhāṣate - nirātmānaḥ sarvadharmā nirjīvā niṣpoṣā niṣpudgalāḥ sarvadharmā iti ||	དེ་བཞིན་གཤེགས་པས་ཆོས་ཐམས་ཅད་ནི་། སེམས་ཅན་མེད་པ་། སྲོག་མེད་པ་། གང་ཟག་མེད་པའོ་༎ ཞེས་གསུང་ངོ་༎
 yaḥ subhūte bodhisattva evaṃ vadet - ahaṃ kṣetravyūhānniṣpādayiṣyāmīti, sa vitathaṃ vadet |	རབ་༄༢༢༩བ་འབྱོར༏་བྱང་ཆུབ་སེམས་དཔའ་གང་ཞིག་འདི་སྐད་དུ་། བདག་གིས་ཞིང་བཀོད་པ་རྣམས་བསྒྲུབ་བོ་༎ ཞེས་ཟེར་ན་། དེ་ཡང་དེ་བཞིན་དུ་བརྗོད་པར་བྱའོ་༎
 tatkasya hetoḥ?	དེ་ཅིའི་ཕྱིར་ཞེ་ན་།
 kṣetravyūhāḥ kṣetravyūhā iti subhūte avyūhāste tathāgatena bhāṣitāḥ |	རབ་འབྱོར་ཞིང་བཀོད་པ་རྣམས་ཞིང་བཀོད་པ་རྣམས་ཞེས་བྱ་བ་དེ་ནི་། དེ་དག་བཀོད་པ་མེད་པར་དེ་བཞིན་གཤེགས་པས་གསུངས་པའི་ཕྱིར་ཏེ་།
 tenocyante kṣetravyūhā iti ||	དེས་ན་ཞིང་བཀོད་པ་རྣམས་ཞེས་བྱའོ་༎
 yaḥ subhūte bodhisattvo nirātmāno dharmā nirātmāno dharmā ityadhimucyate,	རབ་འབྱོར༏་བྱང་ཆུབ་སེམས་དཔའ་གང་ཞིག་ཆོས་རྣམས་ནི་། བདག་མེད་པའོ་༎ ཆོས་རྣམས་ནི་། བདག་མེད་པའོ་༎
 tathāgatenārhatā samyaksaṃbuddhena bodhisattvo mahāsattva ityākhyātaḥ || 17 ||	ཞེས་མོས་པ་དེ་ནི་། དེ་བཞིན་གཤེགས་པ་དགྲ་བཅོམ་པ་ཡང་དག་པར་རྫོགས་པའི་སངས་རྒྱས་ཀྱིས་བྱང་ཆུབ་སེམས་དཔའ་བྱང་ཆུབ་སེམས་དཔའོ་༎ ཞེས་བརྗོད་དོ་༎
 bhagavānāha - tatkiṃ manyase subhūte - saṃvidyate tathāgatasya māṃsacakṣuḥ?	རབ་འབྱོར་། འདི་ཇི་སྙམ་དུ་སེམས་། དེ་བཞིན་གཤེགས་པ་ལ་ཤའི་སྤྱན་མངའམ་།
 subhūtirāha - evametadbhagavan,	རབ་འབྱོར་གྱིས་གསོལ་པ་། བཅོམ་ལྡན་འདས་། དེ་དེ་ལྟ་ལགས་ཏེ་།
 saṃvidyate tathāgatasya māṃsacakṣuḥ |	དེ་བཞིན་གཤེགས་པ་ལ་ཤའི་སྤྱན་མངའོ་༎ བཅོམ་ལྡན་འདས་ཀྱིས་བཀའ་སྩལ་པ་།
 bhagavānāha - tatkiṃ manyase subhūte saṃvidyate tathāgatasya divyaṃ cakṣuḥ?	རབ་འབྱོར་། འདི་ཇི་སྙམ་དུ་སེམས་། དེ་བཞིན་གཤེགས་པ་ལ་ལྷའི་སྤྱན་མངའམ་།
 subhūtirāha - evametadbhagavan,	རབ་འབྱོར་གྱིས་གསོལ་པ་། བཅོམ་ལྡན་འདས་། དེ་དེ་ལྟ་ལགས་ཏེ་།
 saṃvidyate tathāgatasya divyaṃ cakṣuḥ |	དེ་བཞིན་གཤེགས་པ་ལ་ལྷའི་སྤྱན་མངའོ་༎ བཅོམ་ལྡན་འདས་ཀྱིས་བཀའ་སྩལ་པ་།
 bhagavānāha - tatkiṃ manyase subhūte saṃvidyate tathāgatasya prajñācakṣuḥ?	རབ་འབྱོར་། འདི་ཇི་སྙམ་དུ་སེམས་། དེ་བཞིན་གཤེགས་པ་ལ་ཤེས་རབ་ཀྱི་སྤྱན་མངའམ་། རབ་འབྱོར་།
 subhūtirāha - evametadbhagavan,	༄༢༣༠ཨ་༌༎ གྱིས་གསོལ་པ་། བཅོམ་ལྡན་འདས་། དེ་དེ་ལྟ་ལགས་ཏེ་།
 saṃvidyate tathāgatasya prajñācakṣuḥ |	དེ་བཞིན་གཤེགས་པ་ལ་ཤེས་རབ་ཀྱི་སྤྱན་མངའོ་༎ བཅོམ་ལྡན་འདས་ཀྱིས་བཀའ་སྩལ་པ་།
 bhagavānāha - tatkiṃ manyase subhūte saṃvidyate tathāgatasya dharmacakṣuḥ?	རབ་འབྱོར་། འདི་ཇི་སྙམ་དུ་སེམས་། དེ་བཞིན་གཤེགས་པ་ལ་ཆོས་ཀྱི་སྤྱན་མ་ངའམ་།
 subhūtirāha - evametadbhagavan,	རབ་འབྱོར་གྱིས་གསོལ་པ་། བཅོམ་ལྡན་འདས་། དེ་དེ་ལྟ་ལགས་ཏེ་།
 saṃvidyate tathāgatasya dharmacakṣuḥ |	དེ་བཞིན་གཤེགས་པ་ལ་ཆོས་ཀྱི་སྤྱན་མངའོ་༎ བཅོམ་ལྡན་འདས་ཀྱིས་བཀའ་སྩལ་པ་།
 bhagavānāha - tatkiṃ manyase subhūte saṃvidyate tathāgatasya buddhacakṣuḥ?	རབ་འབྱོར་། འདི་ཇི་སྙམ་དུ་སེམས་། དེ་བཞིན་གཤེགས་པ་ལ་སངས་རྒྱས་ཀྱི་སྤྱན་མངའམ་།
 subhūtirāha - evametadbhagavan,	རབ་འབྱོར་གྱིས་གསོལ་པ་། བཅོམ་ལྡན་འདས་། དེ་དེ་ལྟ་ལགས་ཏེ་།
 saṃvidyate tathāgata buddhacakṣuḥ |	དེ་བཞིན་གཤེགས་པ་ལ་སངས་རྒྱས་ཀྱི་སྤྱན་མངའོ་༎ བཅོམ་ལྡན་འདས་ཀྱིས་བཀའ་སྩལ་པ་།
 bhagavānāha - tatkiṃ manyase subhūte yāvantyo gaṅgāyāṃ mahānadyāṃ vālukāḥ, api nu tā vālukāstathāgatena bhāṣitāḥ? subhūtirāha - evametadbhagavan, evametat sugata | bhāṣitāstathāgatena vālukāḥ | bhagavānāha - tatkiṃ manyase subhūte yāvatyo gaṅgāyāṃ mahānadyāṃ vālukāḥ,	རབ་འབྱོར་། འདི་ཇི་སྙམ་དུ་སེམས་། གངགའའི་ཀླུང་གི་བྱེ་མ་ཇི་སྙེད་པ་གངགའའི་ཀླུང་ཡང་དེ་སྙེད་དུ་གྱུར་ལ་།
 tāvatya eva gaṅgānadyo bhaveyuḥ, tāsu vā vālukāḥ, tāvantaśca lokadhātavo bhaveyuḥ,	དེ་དག་གི་བྱེ་མ་ཇི་སྙེད་པ་དེ་སྙེད་ཀྱི་འཇིག་རྟེན་གྱི་ཁམས་སུ་གྱུར་ན་།
 kaccidbahavaste lokadhātavo bhaveyuḥ?	འཇིག་རྟེན་གྱི་ཁམས་དེ་དག་ཅི་མང་བ་ཡིན་ནམ་།
 subhūtirāha - evametadbhagavan,	རབ་འབྱོར་གྱིས་གསོལ་པ་། བཅོམ་ལྡན་འདས་།
 evametat sugata |	དེ་དེ་ལྟ་ལགས་ཏེ་།
 bahavaste lokadhātavo bhaveyuḥ |	འཇིག་རྟེན་གྱི་ཁམས་དེ་དག་མང་བ་ལགས་སོ་༎ བཅོམ་ལྡན་འདས་ཀྱིས་བཀའ་སྩལ་པ་། རབ་འབྱོར་།
 bhagavānāha - yāvantaḥ subhūte teṣu lokadhātuṣu sattvāḥ, teṣāmahaṃ nānābhāvāṃ cittadhārāṃ prajānāmi | tatkasya hetoḥ? cittadhārā cittadhāreti subhūte adhāraiṣā tathāgatena bhāṣitā,	འཇིག་རྟེན་གྱི་ཁམས་དེ་དག་ན་སེམས་ཅན་ཇི་སྙེད་ཡོད་པ་དེ་དག་གི་བསམ་པ་ཐ་༄༢༣༠བ་དད་པའི་སེམས་ཀྱི་རྒྱུན་ངས་རབ་ཏུ་ཤེས་སོ་༎ དེ་ཅིའི་ཕྱིར་ཞེ་ན་། རབ་འབྱོར་། སེམས་ཀྱི་རྒྱུན་ཞེས་བྱ་བ་ནི་། དེ་རྒྱུན་མེད་པར་དེ་བཞིན་གཤེགས་པས་གསུངས་པའི་ཕྱིར་ཏེ་།
 tenocyate cittadhāreti |	དེས་ན༏་སེམས་ཀྱི་རྒྱུན་ཞེས་བྱའོ་༎
 tatkasya hetoḥ?	དེ་ཅིའི་ཕྱིར་ཞེ་ན་། རབ་འབྱོར་།
 atītaṃ subhūte cittaṃ nopalabhyate |	འདས་པའི་སེམས་ཀྱང་དམིགས་སུ་མེད་།
 anāgataṃ cittaṃ nopalabhyate |	མ་འོངས་པའི་སེམས་ཀྱང་དམིགས་སུ་མེད་།
 pratyutpannaṃ cittaṃ nopalabhyate || 18 ||	ད་ལྟར་བྱུང་བའི་སེམས་ཀྱང་དམིགས་སུ་མེད་པའི་ཕྱིར་རོ་༎ རབ་འབྱོར་། འདི་ཇི་སྙམ་དུ་སེམས་།
 tatkiṃ manyase subhūte yaḥ kaścitkulaputro vā kuladuhitā vā imaṃ trisāhasramahāsāhasraṃ lokadhātuṃ saptaratnaparipūrṇaṃ kṛtvā tathāgatebhyo 'rhadbhayaḥ samyaksaṃbuddhebhyo dānaṃ dadyāt, api nu (vajr, vaidya 86)	གང་གིས་སྟོང་གསུམ་གྱི་སྟོང་ཆེན་པོའི་འཇིག་རྟེན་གྱི་ཁམས་འདི་རིན་པོ་ཆེ་སྣ་བདུན་གྱིས་ཡོངས་སུ་གང་བར་བྱས་ཏེ་སྦྱིན་པ་བྱིན་ན་།
 sa kulaputro vā kuladuhitā vā tatonidānaṃ bahu puṇyaskandhaṃ prasunuyāt?	རིགས་ཀྱི་བུའམ་། རིགས་ཀྱི་བུ་མོ་དེ་། གཞི་དེ་ལས་བསོད་ནམས་མང་དུ་བསྐྱེད་དམ་།
 subhūtirāha - bahu bhagavan,	རབ་འབྱོར་གྱིས་གསོལ་པ་། བཅོམ་ལྡན་འདས་། མང་ལགས་སོ་༎
 bahu sugata |	བདེ་བར་གཤེགས་པ་། མང་ལགས་སོ་༎
 bhagavānāha - evametatsubhūte, evametat |	བཅོམ་ལྡན་འདས་ཀྱིས་བཀའ་སྩལ་པ་། རབ་འབྱོར་། དེ་དེ་བཞིན་ནོ་༎
 bahu sa kulaputro vā kuladuhitā vā tatonidānaṃ puṇyaskandhaṃ prasunuyādaprameyamasaḥkhyeyam | tatkasya hetoḥ? puṇyaskandhaḥ puṇyaskandha iti subhūte askandhaḥ sa tathāgatena bhāṣitaḥ | tenocyate puṇyaskandha iti |	དེ་དེ་བཞིན་ཏེ་། རིགས་ཀྱི་བུའམ༏་རིགས་ཀྱི་བུ་མོ་དེ་། གཞི་དེ་ལས་བསོད་ནམས་ཀྱི་ཕུང་པོ་མང་དུ་བསྐྱེད་དོ་༎
 sacet punaḥ subhūte puṇyaskandho 'bhaviṣyat,	རབ་འབྱོར་། གལ་ཏེ་བསོད་ནམས་ཀྱི་ཕུང་པོ་བསོད་ནམས་ཀྱི་ཕུང་པོར་གྱུར་ན་།
 na tathāgato 'bhāṣiṣyat puṇyaskandhaḥ puṇyaskandha iti || 19 ||	བསོད་ནམས་ཀྱི་ཕུང་པོ་བསོད་ནམས་ཀྱི་ཕུང་པོ་ཞེས་དེ་བཞིན་གཤེགས་པས་མི་གསུང་ངོ་༎ རབ་འབྱོར་།
 tatkiṃ manyase subhūte rūpakāyapariniṣpattyā tathāgato draṣṭavyaḥ?	འདི་ཇི་སྙམ་དུ་སེམས་། གཟུགས་ཀྱི་སྐུ་ཡོངས་སུ་གྲུབ་པས་དེ་བཞིན་གཤེགས་༄༢༣༡ཨ་༌༎ པར་བལྟའམ་།
 subhūtirāha - no hīdaṃ bhagavan |	རབ་འབྱོར་གྱིས་གསོལ་པ་། བཅོམ་ལྡན་འདས་། དེ་ནི་།
 na rūpakāyapariniṣpattyā tathāgato draṣṭavyaḥ |	མ་ལགས་ཏེ་། གཟུགས་ཀྱི་སྐུ་ཡོངས་སུ་གྲུབ་པས་དེ་བཞིན་གཤེགས་པར་མི་བལྟའོ་༎
 tatkasya hetoḥ?	དེ་ཅིའི་སླད་དུ་ཞེ་ན་། བཅོམ་ལྡན་འདས་།
 rūpakāyapariniṣpattī rūpakāyapariniṣpattiriti bhagavan apariniṣpattireṣā tathāgatena bhāṣitā |	གཟུགས་ཀྱི་སྐུ་ཡོངས་སུ་གྲུབ་པ་། གཟུགས་ཀྱི་སྐུ་ཡོངས་སུ་རྫོགས་པ་ཞེས་བགྱི་བ་ནི་། དེ་ཡོངས་སུ་གྲུབ་པ་མ་མཆིས་པར་དེ་བཞིན་གཤེགས་པས་གསུངས་པའི་སླད་དུ་སྟེ་།
 tenocyate rūpakāyapariniṣpattiriti ||	དེས་ན་། གཟུགས་ཀྱི་སྐུ་ཡོངས་སུ་གྲུབ་པ་ཞེས་བགྱིའོ་༎
 bhagavānāha - tatkiṃ manyase subhūte lakṣaṇasaṃpadā tathāgato draṣṭavyaḥ?	བཅོམ་ལྡན་འདས་ཀྱིས་བཀའ་སྩལ་པ༏་རབ་འབྱོར་། འདི་ཇི་སྙམ་དུ་སེམས་། མཚན་ཕུན་སུམ་ཚོགས་པས་། དེ་བཞིན་གཤེགས་པར་བལྟའམ་།
 subhūtirāha - no hīdaṃ bhagavān |	རབ་འབྱོར་གྱིས་གསོལ་པ་། བཅོམ་ལྡན་འདས་། དེ་ནི༏་མ་ལགས་ཏེ་།
 na lakṣaṇasaṃpadā tathāgato draṣṭavyaḥ |	མཚན་ཕུན་སུམ་ཚོགས་པས་དེ་བཞིན་གཤེགས་པར་མི་བལྟའོ་༎
 tatkasya hetoḥ?	དེ་ཅིའི་སླད་དུ་ཞེ་ན་།
 yaiṣā bhagavan lakṣaṇasaṃpattathāgatena bhāṣitā,	དེ་བཞིན་གཤེགས་པས་མཚན་ཕུན་སུམ་ཚོགས་པར་གང་གསུངས་པ་དེ་།
 alakṣaṇasaṃpadeṣā tathāgatena bhāṣitā |	མཚན་ཕུན་སུམ་ཚོགས་པ་མ་མཆིས་པར་དེ་བཞིན་གཤེགས་པས་གསུངས་པའི་སླད་དུ་སྟེ་།
 tenocyate lakṣaṇasaṃpaditi || 20 ||	དེས་ན་། མཚན་ཕུན་སུམ་ཚོགས་པ་ཞེས་བགྱིའོ་༎ བཅོམ་ལྡན་འདས་ཀྱིས་བཀའ་སྩལ་པ་། རབ་འབྱོར་།
 bhagavānāha - tatkiṃ manyase subhūte api nu tathāgatasyaivaṃ bhavati - mayā dharmo deśita iti? subhūtirāha - no hīdaṃ bhagavan tathāgatasyaivaṃ bhavati - mayā dharmo deśita iti |	འདི་ཇི་སྙམ་དུ་སེམས་། དེ་བཞིན་གཤེགས་པ་འདི་སྙམ་དུ་། ངས་ཆོས་བསྟན་ཏོ་ཞེས་དགོངས་སོ་༎ སྙམ་ན་། ༄༢༣༡བ་རབ་འབྱོར་། དེ་ལྟར་མི་བལྟ་སྟེ་། དེ་བཞིན་གཤེགས་པས་གང་བསྟན་པའི་ཆོས་དེ་གང་ཡང་མེད་དོ་༎
 bhagavānāha - yaḥ subhūte evaṃ vadet - tathāgatena dharmo deśita iti, sa vitathaṃ vadet |	རབ་འབྱོར་། སུ་ཞིག་འདི་སྐད་དུ་། དེ་བཞིན་གཤེགས་པས་ཆོས་བསྟན་ཏོ༏་༏ཞེས་ཟེར་ན་། རབ་འབྱོར་། དེ་ནི་།
 abhyācakṣīta māṃ sa subhūte asatodgṛhītena |	མེད་པ་དང་། ལོག་པར་ཟིན་པས་ང་ལ་སྐུར་བར་འགྱུར་རོ་༎
 tatkasya hetoḥ?	དེ་ཅིའི་ཕྱིར་ཞེ་ན་། རབ་འབྱོར་།
 dharmadeśanā dharmadeśaneti subhūte nāsti sa kaściddharmo yo dharmadeśanā nāmopalabhyate ||	ཆོས་བསྟན་པ་ཞེས་བྱ་བ་དམིགས་པར་འགྱུར་བའི་ཆོས་བསྟན་པ་ཆོས་བསྟན་པ་ཞེས་བྱ་བ་དེ་། གང་ཡང་མེད་པའི་ཕྱིར་རོ་༎
 evamukte āyuṣmān subhūtirbhagavantametadavocat - asti bhagavan kecitsattvā bhaviṣyantyanāgate	དེ་ནས་བཅོམ་ལྡན་འདས་ལ་ཚེ་དང་ལྡན་པ་རབ་འབྱོར་གྱིས་འདི་སྐད་གསོལ་ཏོ་༎ བཅོམ་ལྡན་འདས་།
 'dhvani paścime kāle paścime samaye paścimāyāṃ pañcaśatyāṃ saddharmavipralope vartamāne, ya imānevaṃrūpān dharmān śrutvā abhiśraddhāsyanti |	མ་འོངས་པའི་དུས་ན་སེམས་ཅན་གང་དག་འདི་ལྟ་བུའི་ཆོས་བསྟན་པ་འདི་ཐོས་ནས་མངོན་པར་ཡིད་ཆེས་པར་འགྱུར་བ་མཆིས་སམ་།
 bhagavānāha - na te subhūte sattvā nāsattvāḥ |	བཅོམ་ལྡན་འདས་ཀྱིས་བཀའ་སྩལ་པ༏་རབ་འབྱོར་། དེ་དག་ནི་། སེམས་ཅན་ཡང་མ་ཡིན་། སེམས་ཅན་མེད་པ་ཡང་མ་ཡིན་ནོ་༎
 tatkasya hetoḥ?	དེ་ཅིའི་ཕྱིར་ཞེ་ན་། རབ་འབྱོར་། སེམས་ཅན་རྣམས་ཞེས་བྱ་བ་ནི་།
 sattvāḥ sattvā iti subhūte sarve te subhūte asattvāstathāgatena bhāṣitāḥ |	དེ་བཞིན་གཤེགས་པས་དེ་དག་སེམས་ཅན་མེད་པར་གསུངས་པའི་ཕྱིར་ཏེ་།
 tenocyante sattvā iti || 21 ||	དེས་ན་། སེམས་ཅན་རྣམས་ཞེས་བྱའོ་༎ རབ་འབྱོར་།
 tatkiṃ manyase subhūte - api nu asti sa kaściddharmaḥ, yastathāgatenānuttarāṃ samyaksaṃbodhimabhisaṃbuddhaḥ?	འདི་ཇི་སྙམ་དུ་སེམས་། དེ་བཞིན་གཤེགས་པས་གང་བླ་ན་མེད་པ་ཡང་དག་པར་རྫོགས་པའི་བྱང་ཆུབ་མངོན་པར་རྫོགས་པར་སངས་རྒྱས་པའི་ཆོས་དེ་གང་ཡང་ཡོད་དམ་།
 @ āyuṣmān subhūtirāha - no hīdaṃ bhagavan |	ཚེ་དང་ལྡན་པ་རབ་འབྱོར་གྱིས་གསོལ་པ་།
 nāsti sa bhagavan kaściddharmo yastathāgatenānuttarāṃ samyaksaṃbodhimabhisaṃbuddhaḥ |	༄༢༣༢ཨ་༌༎ བཅོམ་ལྡན་འདས་། དེ་བཞིན་གཤེགས་པས་གང་བླ་ན་མེད་པ་ཡང་དག་པར་རྫོགས་པའི་བྱང་ཆུབ་མངོན་པར་རྫོགས་པར་སངས་རྒྱས་པའི་ཆོས་དེ་གང་ཡང་མ་མཆིས་ལགས་སོ་༎ བཅོམ་ལྡན་འདས་ཀྱིས་བཀའ་སྩལ་པ་།
 bhagavānāha - evametatsubhūte, evametat |	རབ་འབྱོར་། དེ་དེ་བཞིན་ནོ་༎ དེ་དེ་བཞིན་ཏེ་།
 aṇurapi tatra dharmo na saṃvidyate nopalabhyate |	དེ་ཆོས་ཅུང་ཟད་ཀྱང་མེད་ཅིང་མི་དམིགས་ཏེ་།
 tenocyate anuttarā samyaksaṃbodhiriti || 22 ||	དེས་ན་། བླ་ན་མེད་པ་ཡང་དག་པར་རྫོགས་པའི་བྱང་ཆུབ་ཅེས་བྱའོ་༎ ཡང་རབ་འབྱོར་། ཆོས་དེ་ནི་། མཉམ་པ་སྟེ་།
 (vajr, vaidya 87) api tu khalu punaḥ subhūte samaḥ sa dharmo na tatra kaścidviṣamaḥ |	དེ་ལ་མི་མཉམ་པ་གང་ཡང་མེད་པས་དེས་ན་།
 tenocyate anuttarā samyaksaṃbodhiriti |	བླ་ན་མེད་པ་ཡང་དག་པར་རྫོགས་པའི་བྱང་ཆུབ་ཅེས་བྱའོ་༎ བླ་ན་མེད་པ་ཡང་དག་པར་རྫོགས་པའི་བྱང་ཆུབ་དེ་ནི་།
 nirātmatvena niḥsattvatvena nirjīvatvena niṣpudgalatvena samā sā anuttarā samyaksaṃbodhiḥ sarvaiḥ kuśalairdharmairabhisaṃbudhyate | tatkasya hetoḥ?	བདག་མེད་པ་དང་། སེམས་ཅན་མེད་པ་དང་། སྲོག་མེད་པ་དང་། གང་ཟག་མེད་པར་མཉམ་པ་སྟེ་། དགེ་བའི་ཆོས་ཐམས་ཅད་ཀྱིས་མངོན་པར་རྫོགས་པར་འཚང་རྒྱའོ་༎
 kuśalā dharmāḥ kuśalā dharmā iti subhūte adharmāścaiva te tathāgatena bhāṣitāḥ |	རབ་འབྱོར་། དགེ་བའི་ཆོས་རྣམས་དགེ་བའི་ཆོས་རྣམས་ཞེས་བྱ་བ་ནི་། དེ་དག་དེ་བཞིན་གཤེགས་པས་ཆོས་མེད་པ་ཉིད་དུ་གསུངས་ཏེ་།
 tenocyante kuśalā dharmā iti || 23 ||	དེས་ན་དགེ་བའི་ཆོས་རྣམས་ཞེས་བྱའོ་༎ ཡང་རབ་འབྱོར་། རིགས་ཀྱི་བུའམ་།
 yaśca khalu punaḥ subhute strī vā puruṣo vā yāvantastrisāhasramahāsāhasre lokadhātau sumeravaḥ parvatarājānaḥ, tāvato rāśīn saptānāṃ ratnānāmabhisaṃhṛtya tathāgatebhyo 'rhadbhayaḥ samyaksaṃbuddhebhyo dānaṃ dadyāt,	རིགས་ཀྱི་བུ་མོ་གང་ལ་ལ་ཞིག་གིས་སྟོང་གསུམ་གྱི་སྟོང་ཆེན་པོའི་འཇིག་རྟེན་གྱི་ཁམས་ན་རིའི་རྒྱལ་པོ་རི་རབ་གང་དག་ཇི་སྙེད་༄༢༣༢བ་ཡོད་པ་དེ་ཙམ་གྱི་རིན་པོ་ཆེ་སྣ་བདུན་གྱི་ཕུང་པོ་མངོན་པར་བསྡུས་ཏེ་སྦྱིན་པ་བྱིན་པ་བས་། 
 yaśca kulaputro vā kuladuhitā vā itaḥ prajñāpāramitāyā dharmaparyāyādantaśaścatuṣpādikāmapi gāthāmudgṛhya parebhyo deśayet,	གང་གིས་ཤེས་རབ་ཀྱི་ཕ་རོལ་ཏུ་ཕྱིན་པ་འདི་ལས་ཐ་ན་ཚིག་བཞི་པའི་ཚིགས་སུ་བཅད་པ་ཙམ་བཟུང་ནས་གཞན་དག་ལ་པ་བས་། ཡང་བསྟན་ན་། རབ་འབྱོར་།
 asya subhūte puṇyaskandhasya asau paurvakaḥ puṇyaskandhaḥ śatatamīmapi kalāṃ nopaiti, yāvadupaniṣadamapi na kṣamate || 24 ||	བསོད་ནམས་ཀྱི་ཕུང་པོ་འདི་ལ་བསོད་ནམས་ཀྱི་ཕུང་པོ་སྔ་མ་དེས་བརྒྱའི་ཆར་ཡང་མི་ཕོད་པ་ནས་རྒྱུའི་བར་དུ་ཡང་ཉེ་བར་མི་བཟོད་དོ་༎ རབ་འབྱོར་།
 tatkiṃ manyase subhūte - api nu tathāgatasyaivaṃ bhavati - mayā sattvāḥ parimocitā iti?	འདི་ཇི་སྙམ་དུ་སེམས་། དེ་བཞིན་གཤེགས་པ་འདི་སྙམ་དུ་། ངས་སེམས་ཅན་རྣམས་དཀྲོལ་ལོ་ཞེས་དགོངས་སོ་༎
 na khalu punaḥ subhūte evaṃ draṣṭavyam |	སྙམ་ན་། རབ་འབྱོར་། དེ་དེ་ལྟར་མི་བལྟའོ་༎
 tatkasya hetoḥ?	དེ་ཅིའི་ཕྱིར་ཞེ་ན་། རབ་འབྱོར་།
 nāsti subhūte kaścitsattvo yastathāgatena parimocitaḥ |	དེ་བཞིན་གཤེགས་པས་གང་བཀྲོལ་བའི་སེམས་ཅན་དེ་དག་གང་ཡང་མེད་པའི་ཕྱིར་རོ་༎
 yadi punaḥ subhūte kaścitsattvo 'bhaviṣyadyastathāgatena parimocitaḥ syāt,	རབ་འབྱོར་། གལ་ཏེ་དེ་བཞིན་གཤེགས་པས་སེམས་ཅན་གང་ལ་ལ་ཞིག་བཀྲོལ་བར་གྱུར་ན་།
 sa eva tathāgatasyātmagrāho 'bhaviṣyat,	དེ་ཉིད་དེ་བཞིན་གཤེགས་པའི་བདག་ཏུ་འཛིན་པར་འགྱུར་།
 sattvagrāho jīvagrāhaḥ pudgalagrāho 'bhaviṣyat |	སེམས་ཅན་དུ་འཛིན་པ་དང་། སྲོག་ཏུ་འཛིན་པ་དང་། གང་ཟག་ཏུ་འཛིན་པར་འགྱུར་རོ་༎ རབ་འབྱོར་། བདག་ཏུ་འཛིན་ཅེས་བྱ་བ་ནི་།
 ātmagrāha iti subhūte agrāha eṣa tathāgatena bhāṣitaḥ |	དེ་འཛིན་པ་མེད་པར་དེ་བཞིན་གཤེགས་པས་གསུངས་ན་།
 sa ca bālapṛthagjanairudgṛhītaḥ |	དེ་ཡང་བྱིས་པ་སོ་སོའི་སྐྱེ་བོ་རྣམས་ཀྱིས་བཟུང་ངོ་༎
 bālapṛthagjanā iti subhūte ajanā eva te tathāgatena bhāṣitāḥ |	རབ་འབྱོར་། བྱིས་པ་སོ་སོའི་སྐྱེ་བོ་རྣམས་ཞེས་བྱ་བ་ནི་། དེ་དག་སྐྱེ་བོ་མེད་པ་ཉིད་དུ་དེ་བཞིན་གཤེགས་པས་གསུངས་༄༢༣༣ཨ་༌༎
 tenocyante bālapṛthagjanā iti || 25 ||	ཏེ༏་དེས་ན་། བྱིས་པ་སོ་སོའི་སྐྱེ་བོ་རྣམས་ཞེས་བྱའོ་༎ རབ་འབྱོར་།
 tatkiṃ manyase subhūte - lakṣaṇasaṃpadā tathāgato draṣṭavyaḥ?	འདི་ཇི་སྙམ་དུ་སེམས་། མཚན་ཕུན་སུམ་ཚོགས་པས་དེ་བཞིན་གཤེགས་པར་བལྟའམ་།
 subhūtirāha - no hīdaṃ bhagavan | yathāhaṃ bhagavato bhāṣitasyārthamājānāmi,	རབ་འབྱོར་གྱིས་གསོལ་པ་། བཅོམ་ལྡན་འདས་། དེ་ནི་།
 na lakṣaṇasaṃpadā tathāgato draṣṭavyaḥ |	མ་ལགས་ཏེ་། མཚན་ཕུན་སུམ་ཚོགས་པས་དེ་བཞིན་གཤེགས་པར་མི་བལྟའོ་༎
 bhagavānāha - sādhu sādhu subhūte,	བཅོམ་ལྡན་འདས་ཀྱིས་བཀའ་སྩལ་པ་།
 evametatsubhūte, evametadyathā vadasi |	རབ་འབྱོར་། དེ་དེ་བཞིན་ཏེ་།
 na lakṣaṇasaṃpadā tathāgato draṣṭavyaḥ | tatkasya hetoḥ?	མཚན་ཕུན་སུམ་ཚོགས་པས་དེ་བཞིན་གཤེགས་པར་མི་བལྟའོ་༎
 sacetpunaḥ subhūte lakṣaṇasaṃpadā tathāgato draṣṭavyo 'bhaviṣyat,	རབ་འབྱོར་། གལ་ཏེ་མཚན་ཕུན་སུམ་ཚོགས་པས་དེ་བཞིན་གཤེགས་པར་བལྟ་བར་གྱུར་ན་།
 rājāpi cakravartī tathāgato 'bhaviṣyat |	འཁོར་ལོས་བསྒྱུར་བའི་རྒྱལ་པོ་ཡང་དེ་བཞིན་གཤེགས་པར་འགྱུར་ཏེ་།
 tasmānna lakṣaṇasaṃpadā tathāgato draṣṭavyaḥ |	དེ་བས་ན་། མཚན་ཕུན་སུམ་ཚོགས་པས་དེ་བཞིན་གཤེགས་པར་མི་བལྟའོ་༎
 āyuṣmān subhutirbhagavantametadavocat - yathāhaṃ bhagavato bhāṣitasyārthamājānāmi,	དེ་ནས་བཅོམ་ལྡན་འདས་ལ་ཚེ་དང་ལྡན་པ་རབ་འབྱོར་གྱིས་འདི་སྐད་ཅེས་གསོལ་ཏོ་༎ བཅོམ་ལྡན་འདས་ཀྱིས་གསུངས་པའི་དོན་བདག་གིས་འཚལ་བ་ལྟར་ན་།
 na lakṣaṇasaṃpadā tathāgato draṣṭavyaḥ ||	མཚན་ཕུན་སུམ་ཚོགས་པས་དེ་བཞིན་གཤེགས་པར་མི་བལྟའོ་༎
 atha khalu bhagavāṃstasyāṃ velāyāmime gāthe abhāṣata -	དེ་ནས་བཅོམ་ལྡན་འདས་ཀྱིས་དེའི་ཚེ་ཚིགས་སུ་བཅད་པ་འདི་དག་བཀའ་སྩལ་ཏོ་༎ གང་དག་ང་ལ་གཟུགས་སུ་མཐོང་༎
 ye māṃ rūpeṇa cādrākṣurye māṃ ghoṣeṇa cānvaguḥ |	གང་དག་ང་ལ་སྒྲར་ཤེས་པ་༎
 mithyāprahāṇaprasṛtā na māṃ drakṣyanti te janāḥ || 1 ||	ལོག་པར་སྤོང་བས་ཞུགས་པ་སྟེ་༎ སྐྱེ་བོ་དེ་དག་ང་མི་མཐོང་༎
 dharmato buddho draṣṭavyo dharmakāyā hi nāyakāḥ |	༄༢༣༣བ་སངས་རྒྱས་རྣམས་ནི་ཆོས་ཉིད་བལྟ་༎ འདྲེན་པ་རྣམས་ནི་ཆོས་ཀྱི་སྐུ་༎
 dharmatā ca na vijñeyā na sā śakyā vijānitum || 2 || 26 ||	ཆོས་ཉིད་ཤེས་པར་བྱ་མིན་པས་༎ དེ་ནི་རྣམ་པར་ཤེས་མི་ནུས་༎ རབ་འབྱོར་།
 (vajr, vaidya 88) tatkiṃ manyase subhūte lakṣaṇasaṃpadā tathāgatena anuttarā samyaksaṃbodhirabhisaṃbuddhā?	འདི་ཇི་སྙམ་དུ་སེམས་། མཚན་ཕུན་སུམ་ཚོགས་པས་དེ་བཞིན་གཤེགས་པ་དགྲ་བཅོམ་པ་ཡང་དག་པར་རྫོགས་པའི་སངས་རྒྱས་སོ་༎ སྙམ་དུ་འཛིན་ན་།
 na khalu punaste subhūte evaṃ draṣṭavyam | tatkasya hetoḥ?	རབ་འབྱོར་། ཁྱོད་ཀྱིས་དེ་ལྟར་མི་བལྟ་སྟེ་།
 na hi subhūte lakṣaṇasaṃpadā tathāgatena anuttarā samyaksaṃbodhirabhisaṃbuddhā syāt |	རབ་འབྱོར༏་མཚན་ཕུན་སུམ་ཚོགས་པས་དེ་བཞིན་གཤེགས་པ་དགྲ་བཅོམ་པ་ཡང་དག་པར་རྫོགས་པའི་སངས་རྒྱས་ཀྱིས་བླ་ན་མེད་པ་ཡང་དག་པར་རྫོགས་པའི་བྱང་ཆུབ་མངོན་པར་རྫོགས་པར་སངས་རྒྱས་པ་མེད་དོ་༎ རབ་འབྱོར་།
 na khalu punaste subhūte kaścidevaṃ vadet - bodhisattvayānasaṃprasthitaiḥ kasyaciddharmasya vināśaḥ prajñaptaḥ ucchedo veti |	འདི་སྙམ་དུ་། བྱང་ཆུབ་སེམས་དཔའི་ཐེག་པ་ལ་ཡང་དག་པར་ཞུགས་པ་རྣམས་ཀྱིས་ཆོས་ལ་ལ་ཞིག་རྣམ་པར་བཤིག་གམ་། ཆད་པར་བཏགས་པ་སྙམ་དུ་འཛིན་ན་།
 na khalu punaste subhūte evaṃ draṣṭavyam | tatkasya hetoḥ?	རབ་འབྱོར་། དེ་ལྟར་མི་བལྟ་སྟེ་།
 na bodhisattvayānasaṃprasthitaiḥ kasyaciddharmasya vināśaḥ prajñapto nocchedaḥ || 27 ||	བྱང་ཆུབ་སེམས་དཔའི་ཐེག་པ་ལ་ཡང་དག་པར་ཞུགས་པ་རྣམས་ཀྱིས་ཆོས་གང་ཡང་རྣམ་པར་བཤིག་པའམ་། ཆད་པར་བཏགས་པ་མེད་དོ་༎
 yaśca khalu punaḥ subhūte kulaputro vā kuladuhitā vā gaṅgānadīvālukāsamāṃllokadhātūn saptaratnaparipūrṇaṃ kṛtvā tathāgatebhyo 'rhadbhayaḥ samyaksaṃbuddhebhyo dānaṃ dadyāt,	ཡང་རབ་འབྱོར་། རིགས་ཀྱི་བུའམ་། རིགས་ཀྱི་བུ་མོ་གང་གིས་འཇིག་རྟེན་གྱི་ཁམས་གངགའའི་བྱེ་མ་སྙེད་དག་རིན་པོ་ཆེ་སྣ་བདུན་གྱིས་རབ་ཏུ་གང་བར་བྱས་ཏེ་སྦྱིན་པར་བྱིན་པ་བས་། 
 yaśca bodhisattvo nirātmakeṣvanutpattikeṣu dharmeṣu kṣāntiṃ pratilabhate,	བྱང་ཆུབ་སེམས་དཔའ་གང་ཞིག་ཆོས་རྣམས་བདག་མེད་ཅིང་སྐྱེ་བ་མེད་པ་ལ་བཟོད་པ་བས་། པ་ཐོབ་ན་། 
 ayameva tatonidānaṃ bahutaraṃ puṇyaskandhaṃ prasavedaprameyamasaṃkhyeyam |	དེ་ཉིད་༄༢༣༤ཨ་༌༎ གཞི་དེ་ལས་བསོད་ནམས་ཀྱི་ཕུང་པོ་ཆེས་མང་དུ་བསྐྱེད་དོ་༎
 na khalu punaḥ subhūte bodhisattvena mahāsattvena puṇyaskandhaḥ parigrahītavyaḥ |	ཡང་རབ་འབྱོར་། བྱང་ཆུབ་སེམས་དཔས་བསོད་ནམས་ཀྱི་ཕུང་པོ་ཡོངས་སུ་གཟུང་བར་མི་བྱའོ་༎
 āyuṣmān subhūtirāha - nanu bhagavan bodhisattvena puṇyaskandhaḥ parigrahītavyaḥ?	ཚེ་དང་ལྡན་པ་རབ་འབྱོར་གྱིས་གསོལ་པ་། བཅོམ་ལྡན་འདས་། བྱང་ཆུབ་སེམས་དཔས་བསོད་ནམས་ཀྱི་ཕུང་པོ་ཡོངས་སུ་གཟུང་བར་མི་བགྱི་ལགས་སམ་། བཅོམ་ལྡན་འདས་ཀྱིས་བཀའ་སྩལ་པ་།
 bhagavānāha - parigrahītavyaḥ subhūte no grahītavyaḥ |	རབ་འབྱོར་། ཡོངས་སུ་གཟུང་མོད་ཀྱི་། ལོག་པར་མི་གཟུང་སྟེ་།
 tenocyate parigrahītavya iti || 28 ||	དེས་ན་། ཡོངས་སུ་གཟུང་བ་ཞེས་བྱའོ་༎ རབ་འབྱོར་།
 api tu khalu punaḥ subhūte yaḥ kaścidevaṃ vadet - tathāgato gacchati vā āgacchati vā tiṣṭhati vā niṣīdati vā,	གང་ལ་ལ་ཞིག་འདི་སྐད་དུ་། དེ་བཞིན་གཤེགས་པ་བཞུད་དམ་། བྱོན་ཏམ་། བཞེངས་སམ་། བཞུགས་སམ་།
 śayyāṃ vā kalpayati,	མནལ་བར་མཛད་དོ་༎
 na me subhūte (sa)	ཞེས་དེ་སྐད་ཟེར་ན་།
 bhāṣitasyārthamājānāti | tatkasya hetoḥ?	དེས་ན་ངས་བཤད་པའི་དོན་མི་ཤེས་སོ༏་༏དེ་ཅིའི་ཕྱིར་ཞེ་ན་། རབ་འབྱོར་།
 tathāgata iti subhūte ucyate na kvacidgato na kutaścidāgataḥ |	དེ་བཞིན་གཤེགས་པ་ཞེས་བྱ་བ་ནི་། གར་ཡང་མ་བཞུད་། གང་ནས་ཀྱང་མ་བྱོན་པའི་ཕྱིར་ཏེ་།
 tenocyate tathāgato 'rhan samyaksaṃbuddha iti || 29 ||	དེས་ན་། དེ་བཞིན་གཤེགས་པ་དགྲ་བཅོམ་པ་ཡང་དག་པར་རྫོགས་པའི་སངས་རྒྱས་ཞེས་བྱའོ་༎
 yaśca khalu punaḥ subhūte kulaputro vā kuladuhitā vā yāvanti trisāhasramahāsāhasre lokadhātau pṛthivīrajāṃsi,	ཡང་རབ་འབྱོར་། རིགས་ཀྱི་བུའམ་། རིགས་ཀྱི་བུ་མོ་གང་གིས་སྟོང་གསུམ་གྱི་སྟོང་ཆེན་པོའི་འཇིག་རྟེན་གྱི་ཁམས་ན་སའི་རྡུལ་རྣམས་ཇི་སྙེད་ཡོད་པ་དེ་དག་འདི་ལྟ་སྟེ་།
 tāvatāṃ lokadhātūnāmevaṃrūpaṃ maṣiṃ kuryāt yāvadevamasaṃkhyeyena vīryeṇa tadyathāpi nāma paramāṇusaṃcayaḥ,	དཔེར་ན་། རྡུལ་ཕྲ་རབ་ཀྱི་ཚོགས་བཞིན་དུ་ཕྱེ་མར་བྱས་ན་།
 tatkiṃ manyase subhūte - api nu bahuḥ sa paramāṇusaṃcayo bhavet?	རབ་འབྱོར་། འདི་ཅི་སྙམ་དུ་སེམས་། རྡུལ་༄༢༣༤བ་ཕྲ་རབ་ཀྱི་ཚོགས་དེ་མང་བ་ཡིན་ནམ་།
 subhūtirāha - evametadbhagavan,	རབ་འབྱོར་གྱིས་གསོལ་པ་། བཅོམ་ལྡན་འདས་།
 evametatsugata |	དེ་དེ་ལྟར་ལགས་ཏེ་།
 bahuḥ sa paramāṇusaṃcayo bhavet |	རྡུལ་ཕྲ་རབ་ཀྱི་ཚོགས་དེ་མང་བ་ལགས་སོ་༎
 tatkasya hetoḥ?	དེ་ཅིའི་སླད་དུ་ཞེ་ན༏་བཅོམ་ལྡན་འདས་།
 sacedbhagavan bahuḥ paramāṇusaṃcayo 'bhaviṣyat,	གལ་ཏེ་ཚོགས་ཤིག་མཆིས་པར་གྱུར་ན་།
 na bhagavānavakṣyat - paramāṇusaṃcaya iti |	བཅོམ་ལྡན་འདས་ཀྱིས་རྡུལ་ཕྲ་རབ་ཀྱི་ཚོགས་ཞེས་བཀའ་མི་སྩོལ་བའི་སླད་དུའོ་༎
 tatkasya hetoḥ?	དེ་ཅིའི་སླད་དུ་ཞེ་ན་།
 yo 'sau bhagavan paramāṇusaṃcayastathāgatena bhāṣitaḥ, asaṃcayaḥ sa tathāgatena bhāṣitaḥ |	བཅོམ་ལྡན་འདས་ཀྱིས་རྡུལ་ཕྲ་རབ་ཀྱི་ཚོགས་ཞེས་གང་གསུངས་པ་དེ་ཚོགས་མ་མཆིས་པར་དེ་བཞིན་གཤེགས་པས་གསུངས་པའི་སླད་དུ་སྟེ་། དེས་ན་།
 tenocyate paramāṇusaṃcaya iti | yaśca tathāgatena bhāṣitastrisāhasramahāsāhasro lokadhāturiti,	རྡུལ་ཕྲ་རབ་ཀྱི་ཚོགས་ཞེས་བགྱིའོ༏་༏དེ་བཞིན་གཤེགས་པས་སྟོང་གསུམ་གྱི་སྟོང་ཆེན་པོའི་འཇིག་རྟེན་གྱི་ཁམས་ཞེས་གང་གསུངས་པ་དེ་།
 adhātuḥ sa tathāgatena bhāṣitaḥ |	ཁམས་མ་མཆིས་པར་དེ་བཞིན་གཤེགས་པས་གསུངས་ཏེ༏་དེས་ན་།
 tenocyate trisāhasramahāsāhasro lokadhāturiti |	སྟོང་གསུམ་གྱི་སྟོང་ཆེན་པོའི་འཇིག་རྟེན་གྱི་ཁམས་ཞེས་བགྱིའོ་༎
 tatkasya hetoḥ?	དེ་ཅིའི་སླད་དུ་ཞེ་ན་། བཅོམ་ལྡན་འདས་།
 sacedbhagavan lokadhāturabhaviṣyat,	གལ་ཏེ་ཁམས་ཤིག་མཆིས་པར་གྱུར་ན་།
 sa eva piṇḍagrāho (vajr, vaidya 89) 'bhaviṣyat |	དེ་ཉིད་རིལ་པོར་འཛིན་པར་འགྱུར་བའི་སླད་དུའོ་༎
 yaścaiva piṇḍagrāhastathāgatena bhāṣitaḥ,	དེ་བཞིན་གཤེགས་པས་རིལ་པོར་འཛིན་པར་གང་གསུངས་པ་དེ་།
 agrāhaḥ sa tathāgatena bhāṣitaḥ |	འཛིན་པ་མ་མཆིས་པར་དེ་བཞིན་གཤེགས་པས་གསུངས་ཏེ་།
 tenocyate piṇḍagrāha iti | bhagavānāha - piṇḍagrāhaścaiva subhūte avyavahāro 'nabhilāpyaḥ |	དེས་ན༏་རིལ་པོར་འཛིན་པ་ཞེས་བགྱིའོ་༎ བཅོམ་ལྡན་འདས་ཀྱིས་བཀའ་སྩལ་པ་། རབ་འབྱོར་། རིལ་པོར་འཛིན་པ་ཉིད་ནི་། ཐ་སྙད་དེ་།
 na sa dharmo nādharmaḥ |	ཆོས་དེ་ནི་། བརྗོད་དུ་མེད་པ་ཡིན་ན་།
 sa ca bālapṛthagjanairudgṛhītaḥ || 30 || tatkasya hetoḥ?	༄༢༣༥ཨ་༌༎ དེ་ཡང་བྱིས་པ་སོ་སོའི་སྐྱེ་བོ་རྣམས་ཀྱིས་བཟུང་ངོ་༎
 yo hi kaścitsubhūte evaṃ vadet - ātmadṛṣṭistathāgatena bhāṣitā,	རབ་འབྱོར་། གང་ལ་ལ་ཞིག་འདི་སྐད་དུ་། དེ་བཞིན་གཤེགས་པས་བདག་ཏུ་ལྟ་བར་གསུངས་ཤིང་།
 sattvadṛṣṭirjīvadṛṣṭiḥ pudgaladṛṣṭistathāgatena bhāṣitā,	དེ་བཞིན་གཤེགས་པས་སེམས་ཅན་དུ་ལྟ་བ་དང་། སྲོག་ཏུ་ལྟ་བ་དང་། གང་ཟག་ཏུ་ལྟ་བར་གསུངས་སོ་༎ ཞེས་ཟེར་ན་། རབ་འབྱོར་།
 api nu sa subhūte samyagvadamāno vadet?	དེ་ཡང་ཡང་དག་པར་སྨྲ་བས་སྨྲ་བ་ཡིན་ནམ་།
 subhūtirāha - no hīdaṃ bhagavan,	རབ་འབྱོར་གྱིས་གསོལ་པ་། བཅོམ་ལྡན་འདས་།
 no hīdaṃ sugata, na samyagvadamāno vadet |	དེ་ནི་། མ་ལགས་སོ་༎ བདེ་བར་གཤེགས་པ་།
 tatkasya hetoḥ?	དེ་ནི་། མ་ལགས་སོ་༎ དེ་ཅིའི་སླད་དུ་ཞེ་ན་།
 yā sā bhagavan ātmadṛṣṭistathāgatena bhāṣitā,	བཅོམ་ལྡན་འདས་། དེ་བཞིན་གཤེགས་པས་བདག་ཏུ་ལྟ་བར་གང་གསུངས་པ་དེ་།
 adṛṣṭiḥ sā tathāgatena bhāṣitā |	ལྟ་བ་མ་མཆིས་པར་དེ་བཞིན་གཤེགས་པས་གསུངས་པའི་སླད་དུ་སྟ་།
 tenocyate ātmadṛṣṭiriti ||	དེས་ན་། བདག་ཏུ་ལྟ་བ་ཞེས་བགྱིའོ༏་༏བཅོམ་ལྡན་འདས་ཀྱིས་བཀའ་སྩལ་པ་།
 bhagavānāha - evaṃ hi subhūte bodhisattvayānasaṃprasthitena sarvadharmā jñātavyā draṣṭavyā adhimoktavyāḥ |	རབ་འབྱོར་། བྱང་ཆུབ་སེམས་དཔའི་ཐེག་པ་ལ་ཡང་དག་པར་ཞུགས་པ་རྣམས་ཀྱིས་འདི་ལྟར་ཆོས་ཐམས་ཅད་ཤེས་པར་བྱ༏་བལྟ་བར་བྱ་། མོས་པར་བྱ་སྟེ་།
 tathāca jñātavyā draṣṭavyā adhimoktavyāḥ, yathā na dharmasaṃjñāyāmapi pratyupatiṣṭhennādharmasaṃjñāyām |	ཅི་ནས་ཆོས་སུ་འདུ་ཤེས་པ་ལ་ཡང་མི་གནས་པ་དེ་ལྟར་མོས་པར་བྱའོ་༎
 tatkasya hetoḥ?	དེ་ཅིའི་ཕྱིར་ཞེ་ན་། རབ་འབྱོར་།
 dharmasaṃjñā dharmasaṃjñeti subhūte asaṃjñaiṣā tathāgatena bhāṣitā |	ཆོས་སུ་འདུ་ཤེས་ཆོས་སུ་འདུ་ཤེས་ཞེས་བྱ་བ་ནི་། འདུ་ཤེས་མེད་པར་དེ་བཞིན་གཤེགས་པས་གསུངས་པའི་ཕྱིར་ཏེ་།
 tenocyate dharmasaṃjñeti || 31 ||	དེས་ན་། ཆོས་སུ་འདུ་ཤེས་ཞེས་བྱའོ་༎ ཡང་རབ་འབྱོར་།
 yaśca khalu punaḥ subhūte bodhisattvo mahāsattvo 'prameyānasaṃkhyeyāṃllokadhātūn saptaratnaparipūrṇaṃ kṛtvā tathāgatebhyo 'rhadbhayaḥ samyaksaṃbuddhebhyo dānaṃ dadyāt,	བྱང་ཆུབ་༄༢༣༥བ་སེམས་དཔའ་སེམས་དཔའ་ཆེན་པོ་གང་གིས་འཇིག་རྟེན་གྱི་ཁམས་དཔག་ཏུ་མེད་ཅིང་གྲངས་མེད་པ་དག་རིན་པོ་ཆེ་སྣ་བདུན་གྱིས་རབ་ཏུ་གང་བར་བྱས་ཏེ་སྦྱིན་པ་བྱིན་པ་བས་། རིགས་ཀྱི་བུའམ་།
 yaśca kulaputro vā kuladuhitā vā itaḥ prajñāpāramitāyā dharmaparyāyādantaśaścatuṣpādikāmapi gāthāmudgṛhya dhārayeddeśayedvācayet paryavāpnuyāt,	རིགས་ཀྱི་བུ་མོ་གང་གིས་ཤེས་རབ་ཀྱི་ཕ་རོལ་ཏུ་ཕྱིན་པ་འདི་ལས་ཐ་ན་ཚིག་བཞི་པའི་ཚིགས་སུ་བཅད་པ་ཙམ་བླངས་ནས་འཛིན་ཏམ་། ཀློག་གམ་། ཀུན་ཆུབ་པར་བྱེད་དམ་།
 parebhyaśca vistareṇa saṃprakāśayet,	གཞན་དག་ལ་ཡང་རྒྱ་ཆེར་ཡང་དག་པར་རབ་ཏུ་སྟོན་ན་།
 ayameva tatonidānaṃ bahutaraṃ puṇyaskandhaṃ prasunuyādaprameyamasaṃkhyeyam |	དེ་ཉིད་གཞི་དེ་ལས་བསོད་ནམས་མང་དུ་གྲངས་མེད་དཔག་ཏུ་མེད་པ་བསྐྱེད་དོ་༎
 kathaṃ ca saṃprakāśayet?	ཇི་ལྟར་ཡང་དག་པར་རབ་ཏུ་སྟོན་ཅེ་ན་། ཇི་ལྟར་ཡང་དག་པར་རབ་ཏུ་མི་སྟོན་པ་དེ་བཞིན་དུ་སྟེ་། དེས་ན་། ཡང་དག་པར་རབ་ཏུ་སྟོན་པ་ཞེས་བྱའོ་༎
 tadyathākāśe - tārakā timiraṃ dīpo māyāvaśyāya budbudam |	སྐར་མ་རབ་རིབ་མར་མེ་དང་༎ སྒྱུ་མ་ཟིལ་བ་ཆུ་བུར་དང་༎ རྨི་ལམ་གློག་དང་སྤྲིན་ལྟ་བུ་༎
 svapnaṃ ca vidyudabhraṃ ca evaṃ draṣṭavya saṃskṛtam || tathā prakāśayet, tenocyate saṃprakāśayediti ||	འདུས་བྱས་དེ་ལྟར་བལྟ་བར་བྱ་༎
