skt	tib
 transcription of the gilgit teXt folio 5a (g 1380; chak 182|1-183|11; du 151|3-152|15;	༄༢༡༥ཨ་། །རྒྱ་གར་སྐད་དུ་། ཨའརྱ་བཛྲ་ཙཚེ་ད་ཀ་ནའ་མ་པྲ་ཛཉའ་པ་ར་མི་ཏ་མ་ཧའ་ཡ་ན་སའུ་ཏྲ་། བོད་སྐད་དུ་། འཕགས་པ་ཤེས་རབ་ཀྱི་ཕ་རོལ་ཏུ་ཕྱིན་པ་རྡོ་རྗེ་གཅོད་པ་ཞེས་བྱ་བ་ཐེག་པ་ཆེན་པོའི་མདོ་། སངས་རྒྱས་དང་བྱང་ཆུབ་སེམས་དཔའ་ཐམས་ཅད་ལ་ཕྱག་འཚལ་ལོ་༎ འདི་སྐད་བདག་གིས་ཐོས་པ་དུས་གཅིག་ན་། བཅོམ་ལྡན་འདས་མཉན་དུ་ཡོད་པ་ན་རྒྱལ་བུ་རྒྱལ་བྱེད་ཀྱི་ཚལ་མགོན་མེད་ཟས་སྦྱིན་གྱི་ཀུན་དགའ་ར་བ་ན་དགེ་སློང་སྟོང་ཉིས་བརྒྱ་ལྔ་བཅུའི་དགེ་སློང་གི་དགེ་འདུན་ཆེན་པོ་དང་། བྱང་ཆུབ་སེམས་དཔའ་སེམས་དཔའ་ཆེན་པོ་རབ་ཏུ་མང་པོ་དང་ཐབས་གཅིག་ཏུ་བཞུགས་ཏེ་། དེ་ནས་བཅོམ་ལྡན་འདས་སྔ་དྲོའི་དུས་ཀྱི་ཚེ་ཤམ་ཐབས་དང་ཆོས་གོས་སྐུ་ལ་གསོལ་ཏེ་ལྷུང་བཟེད་༄༢༡༥བ་བསྣམས་ནས་མཉན་ཡོད་ཀྱི་གྲོང་ཁྱེར་ཆེན་པོར་བསོད་སྙོམས་ཀྱི་ཕྱིར་ཞུགས་སོ་༎ དེ་ནས་བཅོམ་ལྡན་འདས་མཉན་ཡོད་ཀྱི་གྲོང་ཁྱེར་ཆེན་པོར་བསོད་སྙོམས་ཀྱི་ཕྱིར་གཤེགས་ནས་བསོད་སྙོམས་ཀྱི་ཞལ་ཟས་མཇུག་ཏུ་གསོལ་ཏེ་ཟས་ཀྱི་བྱ་བ་མཛད་ནས་ཟས་ཕྱི་མའི་བསོད་སྙོམས་སྤངས་པས་། ལྷུང་བཟེད་དང་ཆོས་གོས་བཞག་ནས་ཞབས་བསིལ་ཏེ་གདན་བཤམས་པ་ལ་སྐྱིལ་མོ་ཀྲུང་བཅས་ནས་སྐུ་དྲང་པོར་བསྲང་སྟེ་དྲན་པ་མངོན་དུ་བཞག་། ནས་བཞུགས་སོ་༎ དེ་ནས་དགེ་སློང་མང་པོ་བཅོམ་ལྡན་འདས་ག་ལ་བ་དེར་དོང་སྟེ་ལྷགས་ནས་བཅོམ་ལྡན་འདས་ཀྱི་ཞབས་ལ་མགོ་བོས་ཕྱག་འཚལ་ཏེ་བཅོམ་ལྡན་འདས་ལ་ལན་གསུམ་བསྐོར་བ་བྱས་ནས་ཕྱོགས་གཅིག་ཏུ་འཁོད་དོ་༎ ཡང་དེའི་ཚེ་ཚེ་དང་ལྡན་པ་རབ་འབྱོར་འཁོར་དེ་ཉིད་དུ་འདུས་པར་གྱུར་ཏེ་འདུག་གོ་། དེ་ནས་ཚེ་དང་ལྡན་པ་རབ་འབྱོར་སྟན་ལས་ལངས་ཏེ་བླ་གོས་ཕྲག་པ་གཅིག་ཏུ་གཟར་ནས་པུས་མོ་ག-ཡས་པའི་ལྷ་ང་ས་ལ་བཙུགས་ཏེ་བཅོམ་ལྡན་འདས་ག་ལ་བ་དེ་ལོགས་སུ་ཐལ་མོ་སྦྱར་བ་བཏུད་དེ་བཅོམ་ལྡན་འདས་ལ་འདི་སྐད་ཅེས་གསོལ་ཏོ་༎ བཅོམ་ལྡན་འདས་། དེ་བཞིན་གཤེགས་པ་དགྲ་བཅོམ་པ་ཡང་དག་པར་རྫོགས་པའི་སངས་རྒྱས་ཀྱིས་བྱང་ཆུབ་སེམས་དཔའ་སེམས་དཔའ་ཆེན་པོ་རྣམས་ལ་ཕན་གདགས་པའི་དམ་པ་ཇི་སྙེད་པས་ཕན་བཏགས་པ་དང་། དེ་བཞིན་གཤེགས་པ་དགྲ་བཅོམ་པ་ཡང་དག་པར་རྫོགས་པའི་༄༢༡༦ཨ་༌༎ སངས་རྒྱས་ཀྱིས་བྱང་ཆུབ་སེམས་དཔའ་སེམས་དཔའ་ཆེན་པོ་རྣམས་ཡོངས་སུ་གཏད་པའི་དམ་པ་ཇི་སྙེད་པས་ཡོངས་སུ་གཏད་པ་ནི་། བཅོམ་ལྡན་འདས་། ངོ་མཚར་ལགས་སོ་༎ བདེ་བར་གཤེགས་པ་། ངོ་མཚར་ལགས་སོ་༎ བཅོམ་ལྡན་འདས་། བྱང་ཆུབ་སེམས་དཔའི་ཐེག་པ་ལ་ཡང་དག་པར་ཞུགས་པས་ཇི་ལྟར་གནས་པར་བགྱི་། ཇི་ལྟར་བསྒྲུབ་པར་བགྱི་། ཇི་ལྟར་སེམས་རབ་ཏུ་གཟུང་བར་བགྱི་། དེ་སྐད་ཅེས་གསོལ་པ་དང་། བཅོམ་ལྡན་འདས་ཀྱིས་ཚེ་དང་ལྡན་པ་རབ་འབྱོར་ལ་འདི་སྐད་ཅེས་བཀའ་སྩལ་ཏོ༏་༏རབ་འབྱོར་། ལེགས་སོ་༎ ལེགས་སོ་༎ རབ་འབྱོར་། དེ་དེ་བཞིན་ནོ་༎ དེ་དེ་བཞིན་ཏེ་། དེ་བཞིན་གཤེགས་པས་བྱང་ཆུབ་སེམས་དཔའ་སེམས་དཔའ་ཆེན་པོ་རྣམས་ལ་ཕན་གདགས་པའི་དམ་པས་ཕན་བཏགས་སོ་༎ དེ་བཞིན་གཤེགས་པས་བྱང་ཆུབ་སེམས་དཔའ་སེམས་དཔའ་ཆེན་པོ་རྣམས་ལ་ཡོངས་སུ་གཏད་པའི་དམ་པས་ཡོངས་སུ་གཏད་དོ་༎ རབ་འབྱོར་། དེའི་ཕྱིར་ཉོན་ལ་ལེགས་པར་རབ་ཏུ་ཡིད་ལ་ཟུངས་ཤིག་དང་། བྱང་ཆུབ་སེམས་དཔའི་ཐེག་པ་ལ་ཡང་དག་པར་ཞུགས་པས་ཇི་ལྟར་གནས་པར་བྱ་བ་དང་། ཇི་ལྟར་བསྒྲུབ་པར་བྱ་བ་དང་། ཇི་ལྟར་སེམས་རབ་ཏུ་གཟུང་བར་བྱ་བ་ངས་ཁྱོད་ལ་བཤད་དོ་༎ བཅོམ་ལྡན་འདས་། དེ་བཞིན་ནོ་༎ ཞེས་གསོལ་ནས་ཚེ་དང་ལྡན་པ་རབ་འབྱོར་བཅོམ་ལྡན་འདས་༄༢༡༦བ་ཀྱི་ལྟར་ཉན་པ་དང་། བཅོམ་ལྡན་འདས་ཀྱིས་འདི་སྐད་ཅེས་བཀའ་སྩལ་ཏོ་༎ རབ་འབྱོར་། འདི་ལ་བྱང་ཆུབ་སེམས་དཔའི་ཐེག་པ་ལ་ཡང་དག་པར་ཞུགས་པས་འདི་སྙམ་དུ་། བདག་གིས་ཇི་ཙམ་སེམས་ཅན་དུ་བསྡུ་བས་བསྡུས་པ་སྒོ་ང་ལས་སྐྱེས་པའམ་། མངལ་ནས་སྐྱེས་པའམ་། དྲོད་གཤེར་ལས་སྐྱེས་པའམ་། བརྫུས་ཏེ་སྐྱེས་པའམ་། གཟུགས་ཅན་ནམ་། གཟུགས་མེད་པའམ་། འདུ་ཤེས་ཅན་ནམ་། འདུ་ཤེས་མེད་པའམ་། འདུ་ཤེས་མེད་འདུ་ཤེས་མེད་མིན་ནམ་། སེམས་ཅན་གྱི་ཁམས་ཇི་ཙམ་སེམས་ཅན་དུ་གདགས་པས་བཏགས་པ་དེ་དག་ཐམས་ཅད་ཕུང་པོ་ལྷག་མ་མེད་པའི་མྱ་ངན་ལས་འདས་པའི་དབྱིངས་སུ་ཡོངས་སུ་མྱ་ངན་ལས་བཟླའོ་༎ དེ་ལྟར་སེམས་ཅན་ཚད་མེད་པ་ཡོངས་སུ་མྱ་ངན་ལས་བཟླས་ཀྱང་སེམས་ཅན་གང་ཡང་ཡོངས་སུ་མྱ་ངན་ལས་བཟླས་པར་གྱུར་པ་མེད་དོ་༎ སྙམ་དུ་སེམས་བསྐྱེད་པར་བྱའོ་༎ དེ་ཅིའི་ཕྱིར་ཞེ་ན་། རབ་འབྱོར་། གལ་ཏེ་བྱང་ཆུབ་སེམས་དཔའ་སེམས་ཅན་དུ་འདུ་ཤེས་འཇུག་ན་། དེ་བྱང་ཆུབ་སེམས་དཔའ་ཞེས་མི་བྱ་བའི་ཕྱིར་རོ་༎ དེ་ཅིའི་ཕྱིར་ཞེ་ན་། རབ་འབྱོར་། གང་སེམས་ཅན་དུ་འདུ་ཤེས་འཇུག་གམ་། སྲོག་ཏུ་འདུ་ཤེས་འཇུག་གམ་། གང་ཟག་ཏུ་འདུ་ཤེས་འཇུག་ན་། དེ་བྱང་ཆུབ་སེམས་དཔའ་ཞེས་མི་བྱ་བའི་ཕྱིར་རོ་༎ ཡང་རབ་འབྱོར་། བྱང་ཆུབ་སེམས་དཔས་དངོས་པོ་ལ་མི་གནས་པར་སྦྱིན་པ་སྦྱིན་ནོ་༎ ཆོས་གང་ལ་ཡང་མི་གནས་པར་༄༢༡༧ཨ་༌༎ སྦྱིན་པ་སྦྱིན་ནོ་༎ གཟུགས་ལའང་མི་གནས་པར་སྦྱིན་པ་སྦྱིན་པར་བྱའོ་༎ སྒྲ་དང་། དྲི་དང་། རོ་དང་། རེག་བྱ་དང་། ཆོས་ལའང་མི་གནས་པར་སྦྱིན་པ་སྦྱིན་ནོ༏་༏རབ་འབྱོར་། ཅི་ནས་མཚན་མར་འདུ་ཤེས་པ་ལའང་མི་གནས་པ་དེ་ལྟར་བྱང་ཆུབ་སེམས་དཔས་སྦྱིན་པ་སྦྱིན་ནོ་༎ དེ་ཅིའི་ཕྱིར་ཞེ་ན་། རབ་འབྱོར་། བྱང་ཆུབ་སེམས་དཔའ་གང་མི་གནས་པར་སྦྱིན་པ་སྦྱིན་པ་དེའི་བསོད་ནམས་ཀྱི་ཕུང་པོ་ནི་། རབ་འབྱོར་། ཚད་གཟུང་བར་སླ་བ་མ་ཡིན་པའི་ཕྱིར་རོ་༎ རབ་འབྱོར་། འདི་ཇི་སྙམ་དུ་སེམས་། ཤར་ཕྱོགས་ཀྱི་ནམ་མཁའི་ཚད་གཟུང་བར་སླའམ་། རབ་འབྱོར་གྱིས་གསོལ་པ་། བཅོམ་ལྡན་འདས་། དེ་ནི་། མ་ལགས་སོ་༎ བཅོམ་ལྡན་འདས་ཀྱིས་བཀའ་སྩལ་པ་། དེ་བཞིན་དུ་ལྷོ་དང་། ནུབ་དང་། བྱང་དང་། སྟེང་དང་། འོག་གི་ཕྱོགས་དང་། ཕྱོགས་མཚམས་དང་། ཕྱོགས་བཅུའི་ནམ་མཁའི་ཚད་གཟུང་བར་སླའམ་། རབ་འབྱོར་གྱིས་གསོལ་པ་། བཅོམ་ལྡན་འདས་། དེ་ནི་། མ་ལགས་སོ་༎ བཅོམ་ལྡན་འདས་ཀྱིས་བཀའ་སྩལ་པ་། རབ་འབྱོར་། དེ་བཞིན་དུ་བྱང་ཆུབ་སེམས་དཔའ་གང་མི་གནས་པའི་སྦྱིན་པ་སྦྱིན་པ་དེའི་བསོད་ནམས་ཀྱི་ཕུང་པོ་ཡང་ཚད་གཟུང་བར་སླ་བ་མ་ཡིན་ནོ་༎ རབ་འབྱོར་། འདི་ཇི་སྙམ་དུ་སེམས་། མཚན་ཕུན་སུམ་ཚོགས་པས་དེ་བཞིན་གཤེགས་པར་བལྟའམ་། རབ་འབྱོར་གྱིས་གསོལ་པ་། བཅོམ་ལྡན་འདས་། ༄༢༡༧བ་དེ་ནི༏་མ་ལགས་ཏེ་། མཚན་ཕུན་སུམ་ཚོགས་པས་དེ་བཞིན་གཤེགས་པར་མི་བལྟའོ་༎ དེ་ཅིའི་སླད་དུ་ཞེ་ན་། དེ་བཞིན་གཤེགས་པས་མཚན་ཕུན་སུམ་ཚོགས་པར་གང་གསུངས་པ་དེ་ཉིད་མཚན་ཕུན་སུམ་ཚོགས་པ་མ་མཆིས་པའི་སླད་དུའོ་༎ དེ་སྐད་ཅེས་གསོལ་པ་དང་། བཅོམ་ལྡན་འདས་ཀྱིས་ཚེ་དང་ལྡན་པ་རབ་འབྱོར་ལ་འདི་སྐད་ཅེས་བཀའ་སྩལ་ཏོ་༎ རབ་འབྱོར་འདི་ཇི་སྙམ་དུ་སེམས་། མཚན་ཕུན་སུམ་ཚོགས་པ་དེ་ཙམ་དུ་རྫུན་ནོ་༎ ཇི་ཙམ་དུ་མཚན་ཕུན་སུམ་ཚོགས་པ་མེད་པ་དེ་ཙམ་དུ་མི་རྫུན་ཏེ་། དེ་ལྟར་དེ་བཞིན་གཤེགས་པ་ལ་མཚན་དང་མཚན་མེད་པར་བལྟའོ་༎ དེ་སྐད་ཅེས་བཀའ་སྩལ་པ་དང་། བཅོམ་ལྡན་འདས་ལ་ཚེ་དང་ལྡན་པ་རབ་འབྱོར་གྱིས་འདི་སྐད་ཅེས་གསོལ་ཏོ་༎ བཅོམ་ལྡན་འདས་། མ་འོངས་པའི་དུས་ལྔ་བརྒྱ་ཐ་མ་ལ་དམ་པའི་ཆོས་རབ་ཏུ་རྣམ་པར་འཇིག་པར་འགྱུར་བ་ན་སེམས་ཅན་གང་ལ་ལ་དག་འདི་ལྟ་བུའི་མདོ་སྡེའི་ཆིག་བཤད་པ་འདི་ལ་ཡང་དག་པར་འདུ་ཤེས་བསྐྱེད་པར་འགྱུར་བ་ལྟ་མཆིས་སམ་། བཅོམ་ལྡན་འདས་ཀྱིས་བཀའ་སྩལ་པ་། རབ་འབྱོར་། ཁྱོད་འདི་སྐད་དུ་། མ་འོངས་པའི་དུས་ལྔ་བརྒྱ་ཐ་མ་ལ་དམ་པའི་ཆོས་རབ་ཏུ་རྣམ་པར་འཇིག་པར་འགྱུར་བ་ན་སེམས་ཅན་གང་ལ་ལ་དག་འདི་ལྟ་བུའི་མདོ་སྡེའི་ཚིག་བཤད་པ་འདི་ལ་ཡང་དག་པར་འདུ་ཤེས་བསྐྱེད་པར་འགྱུར་བ་ལྟ་མཆིས་སམ་ཞེས་མ་ཟེར་ཅིག་། ཡང་རབ་འབྱོར་། མ་འོངས་པའི་དུས་ལྔ་༄༢༡༨ཨ་༌༎ བརྒྱ་ཐ་མ་ལ་དམ་པའི་ཆོས་རབ་ཏུ་རྣམ་པར་འཇིག་པར་འགྱུར་བ་ན་བྱང་ཆུབ་སེམས་དཔའ་སེམས་དཔའ་ཆེན་པོ་ཚུལ་ཁྲིམས་དང་ལྡན་པ་། ཡོན་ཏན་དང་ལྡན་པ་། ཤེས་རབ་དང་ལྡན་པ་དག་འབྱུང་སྟེ་། རབ་འབྱོར་། བྱང་ཆུབ་སེམས་དཔའ་སེམས་དཔའ་ཆེན་པོ་དེ་དག་ཀྱང་སངས་རྒྱས་གཅིག་ལ་བསྙེན་བཀུར་བྱས་པ་མ་ཡིན་། སངས་རྒྱས་གཅིག་ལ་དགེ་བའི་རྩ་བ་བསྐྱེད་པ་མ་ཡིན་གྱི་། རབ་འབྱོར་། སངས་རྒྱས་བརྒྱ་སྟོང་མང་པོ་ལ་བསྙེན་བཀུར་བྱས་ཤིང་། སངས་རྒྱས་བརྒྱ་སྟོང་དུ་མ་ལ་དགེ་བའི་རྩ་བ་དག་བསྐྱེད་པའི་བྱང་ཆུབ་སེམས་དཔའ་སེམས་དཔའ་ཆེན་པོ་དག་འབྱུང་ངོ་༎ རབ་འབྱོར་། གང་དག་འདི་ལྟ་བུའི་མདོ་སྡེའི་ཚིག་བཤད་པ་འདི་ལ་སེམས་དད་པ་གཅིག་ཙམ་རྙེད་པར་འགྱུར་བ་དེ་དག་ནི༏་རབ་འབྱོར་། དེ་བཞིན་གཤེགས་པས་མཁྱེན་ཏོ་༎ རབ་འབྱོར་། དེ་དག་ནི་། དེ་བཞིན་གཤེགས་པས་གཟིགས་ཏེ་། རབ་འབྱོར་། སེམས་ཅན་དེ་དག་ཐམས་ཅད་ནི་། བསོད་ནམས་ཀྱི་ཕུང་པོ་དཔག་ཏུ་མེད་པ་བསྐྱེད་ཅིང་རབ་ཏུ་སྡུད་པར་འགྱུར་རོ་༎ དེ་ཅིའི་ཕྱིར་ཞེ་ན་། རབ་འབྱོར་། བྱང་ཆུབ་སེམས་དཔའ་སེམས་དཔའ་ཆེན་པོ་དེ་དག་ནི་། བདག་ཏུ་འདུ་ཤེས་འཇུག་པར་མི་འགྱུར་ཞིང་། སེམས་ཅན་དུ་འདུ་ཤེས་པ་མ་ཡིན་། སྲོག་ཏུ་འདུ་ཤེས་པ་མ་ཡིན་ཏེ་། གང་ཟག་ཏུའང་འདུ་ཤེས་འཇུག་པར་མི་འགྱུར་བའི་ཕྱིར་རོ་༎ རབ་འབྱོར་། བྱང་ཆུབ་༄༢༡༨བ་སེམས་དཔའ་སེམས་དཔའ་ཆེན་པོ་དེ་དག་ཆོས་སུ་འདུ་ཤེས་པ་དང་། ཆོས་མེད་པར་ཡང་འདུ་ཤེས་མི་འཇུག་སྟེ་། དེ་དག་ནི་། འདུ་ཤེས་དང་། འདུ་ཤེས་མེད་པར་ཡང་འདུ་ཤེས་འཇུག་པར་མི་འགྱུར་རོ་༎ དེ་ཅིའི་ཕྱིར་ཞེ་ན་། རབ་འབྱོར་། གལ་ཏེ་བྱང་ཆུབ་སེམས་དཔའ་སེམས་དཔའ་ཆེན་པོ་དེ་དག་ཆོས་སུ་འདུ་ཤེས་འཇུག་ན་། དེ་ཉིད་དེ་དག་གི་བདག་ཏུ་འཛིན་པར་འགྱུར་ཞིང་། སེམས་ཅན་དུ་འཛིན་པ་དང་། སྲོག་ཏུ་འཛིན་པ་དང་། གང་ཟག་ཏུ་འཛིན་པར་འགྱུར་བའི་ཕྱིར་རོ་༎ གལ་ཏེ་ཆོས་མེད་པར་འཇུག་ནའང་དེ་ཉིད་དེ་དག་གི་བདག་ཏུ་འཛིན་པར་འགྱུར་ཞིང་། སེམས་ཅན་དུ་འཛིན་པ་དང་། སྲོག་ཏུ་འཛིན་པ་དང་། གང་ཟག་ཏུ་འཛིན་པར་འགྱུར་བའི་ཕྱིར་རོ་༎ དེ་ཅིའི་ཕྱིར་ཞེ་ན་། ཡང་རབ་འབྱོར་། བྱང་ཆུབ་སེམས་དཔས་ཆོས་ཀྱང་ལོག་པར་གཟུང་བར་མི་བྱ་སྟེ་། ཆོས་མ་ཡིན་པ་ཡང་མི་གཟུང་བའི་ཕྱིར་རོ་༎ དེ་བས་ན་། དེ་ལས་དགོངས་ཏེ་དེ་བཞིན་གཤེགས་པས་ཆོས་ཀྱི་རྣམ་གྲངས་འདི་གཟིངས་ལྟ་བུར་ཤེས་པ་རྣམས་ཀྱིས་ཆོས་རྣམས་ཀྱང་སྤང་བར་བྱ་ན་། ཆོས་མ་ཡིན་པ་རྣམས་ལྟ་ཅི་སྨོས་ཞེས་གསུངས་སོ་༎ གཞན་ཡང་བཅོམ་ལྡན་འདས་ཀྱིས་ཚེ་དང་ལྡན་པ་རབ་འབྱོར་ལ་འདི་སྐད་ཅེས་བཀའ་སྩལ་ཏོ༏་༏རབ་འབྱོར་། འདི་ཇི་སྙམ་དུ་སེམས་། དེ་བཞིན་གཤེགས་པས་གང་བླ་ན་མེད་པ་ཡང་དག་པར་རྫོགས་པའི་བྱང་ཆུབ་མངོན་པར་རྫོགས་པར་སངས་རྒྱས་པའི་ཆོས་དེ་གང་ཡང་ཡོད་༄༢༡༩ཨ་༌༎ དམ༏་དེ་བཞིན་གཤེགས་པས་ཆོས་གང་ཡང་བསྟན་ཏམ་། དེ་སྐད་ཅེས་བཀའ་སྩལ་པ་དང་། བཅོམ་ལྡན་འདས་ལ་ཚེ་དང་ལྡན་པ་རབ་འབྱོར་གྱིས་འདི་སྐད་ཅེས་གསོལ་ཏོ་༎ བཅོམ་ལྡན་འདས་། བཅོམ་ལྡན་འདས་ཀྱིས་གསུངས་པའི་དོན་འདི་བདག་གིས་འཚལ་བ་ལྟར་ན་། དེ་བཞིན་གཤེགས་པས་གང་བླ་ན་མེད་པ་ཡང་དག་པར་རྫོགས་པའི་བྱང་ཆུབ་མངོན་པར་རྫོགས་པར་སངས་རྒྱས་པའི་ཆོས་དེ་གང་ཡང་མ་མཆིས་སོ་༎ དེ་བཞིན་གཤེགས་པས་གང་བསྟན་པའི་ཆོས་དེ་གང་ཡང་མ་མཆིས་སོ་༎ དེ་ཅིའི་སླད་དུ་ཞེ་ན་། དེ་བཞིན་གཤེགས་པས་ཆོས་གང་ཡང་མངོན་པར་རྫོགས་པར་སངས་རྒྱས་པའམ་བསྟན་པ་དེ་ནི་། གཟུང་དུ་མ་མཆིས་། བརྗོད་དུ་མ་མཆིས་ཏེ་། དེ་ནི་། ཆོས་ཀྱང་མ་ལགས་། ཆོས་མ་མཆིས་པ་ཡང་མ་ལགས་པའི་སླད་དུའོ་༎ དེ་ཅིའི་སླད་དུ་ཞེ་ན་། འཕགས་པའི་གང་ཟག་རྣམས་ནི་། འདུས་མ་བགྱིས་ཀྱིས་རབ་ཏུ་ཕྱེ་བའི་སླད་དུའོ་༎ བཅོམ་ལྡན་འདས་ཀྱིས་བཀའ་སྩལ་པ་། རབ་འབྱོར་། འདི་ཇི་སྙམ་དུ་སེམས་། རིགས་ཀྱི་བུའམ་། རིགས་ཀྱི་བུ་མོ་གང་ལ་ལ་ཞིག་གིས་སྟོང་གསུམ་གྱི་སྟོང་ཆེན་པོའི་འཇིག་རྟེན་གྱི་ཁམས་འདི་རིན་པོ་ཆེ་སྣ་བདུན་གྱིས་རབ་ཏུ་གང་བར་བྱས་ཏེ་སྦྱིན་པ་བྱིན་ན་། རིགས་ཀྱི་བུའམ་། རིགས་ཀྱི་བུ་མོ་དེ་གཞི་དེ་ལས་བསོད་ནམས་ཀྱི་ཕུང་པོ་མང་དུ་བསྐྱེད་དམ་། ༄༢༡༩བ་རབ་འབྱོར་གྱིས་གསོལ་པ་། བཅོམ་ལྡན་འདས་། མང་ལགས་སོ་༎ བདེ་བར་གཤེགས་པ་།
 mm 29|6-30|11; cz 38|6-39|20; par 182|10-183|10; tib 253|1|3-2|5)	མང་ལགས་ཏེ་། རིགས་ཀྱི་བུའམ་། རིགས་ཀྱི་བུ་མོ་དེ་གཞི་དེ་ལས་བསོད་ནམས་ཀྱི་ཕུང་པོ་མང་དུ་བསྐྱེད་དོ༏་༏དེ་ཅིའི་སླད་དུ་ཞེ་ན་། བཅོམ་ལྡན་འདས་། བསོད་ནམས་ཀྱི་ཕུང་པོ་དེ་ཉིད་ཕུང་པོ་མ་མཆིས་པའི་སླད་དུ་སྟེ་། དེས་ན་། དེ་བཞིན་གཤེགས་པས་བསོད་ནམས་ཀྱི་ཕུང་པོ་བསོད་ནམས་ཀྱི་ཕུང་པོ་༎
 1| ḥtaḥ bhagavān āha |	ཞེས་གསུངས་སོ་༎ བཅོམ་ལྡན་འདས་ཀྱིས་བཀའ་སྩལ་པ་། རབ་འབྱོར་། རིགས་ཀྱི་བུའམ་། རིགས་ཀྱི་བུ་མོ་གང་གིས་སྟོང་གསུམ་གྱི་སྟོང་ཆེན་པོའི་འཇིག་རྟེན་གྱི་ཁམས་འདི་རིན་པོ་ཆེ་སྣ་བདུན་གྱིས་རབ་ཏུ་གང་བར་བྱས་ཏེ་སྦྱིན་པ་བྱིན་པ་བས་། གང་གིས་ཆོས་ཀྱི་རྣམ་གྲངས་འདི་ལས་ཐ་ན་ཚིག་བཞི་པའི་ཚིགས་སུ་བཅད་པ་གཅིག་ཙམ་བཟུང་ནས་གཞན་དག་ལ་ཡང་འཆད་ཅིང་ཡང་དག་པར་རབ་ཏུ་སྟོན་ན་། དེ་གཞི་དེ་ལས་བསོད་ནམས་ཀྱི་ཕུང་པོ་ཆེས་མང་དུ་གྲངས་མེད་དཔག་ཏུ་མེད་པ་བསྐྱེད་དོ་༎ དེ་ཅིའི་ཕྱིར་ཞེ་ན་། རབ་འབྱོར་། དེ་བཞིན་གཤེགས་པ་དགྲ་བཅོམ་པ་ཡང་དག་པར་རྫོགས་པའི་སངས་རྒྱས་རྣམས་ཀྱི་བླ་ན་མེད་པ་ཡང་དག་པར་རྫོགས་པའི་བྱང་ཆུབ་ནི་། འདི་ལས་བྱུང་སྟེ་། སངས་རྒྱས་བཅོམ་ལྡན་འདས་རྣམས་ཀྱང་འདི་ལས་སྐྱེས་པའི་ཕྱིར་རོ་༎ དེ་ཅིའི་ཕྱིར་ཞེ་ན་། རབ་འབྱོར་། སངས་རྒྱས་ཀྱི་ཆོས་རྣམས་སངས་རྒྱས་ཀྱི་ཆོས་རྣམས་ཞེས་བྱ་བ་ནི་། སངས་རྒྱས་ཀྱི་ཆོས་དེ་དག་མེད་པར་དེ་བཞིན་གཤེགས་༄༢༢༠ཨ་༌༎ པས་གསུངས་པའི་ཕྱིར་ཏེ་། དེས་ན་། སངས་རྒྱས་ཀྱི་ཆོས་རྣམས་ཞེས་བྱའོ་༎ རབ་འབྱོར་། འདི་ཇི་སྙམ་དུ་སེམས་། རྒྱུན་དུ་ཞུགས་པ་འདི་སྙམ་དུ་། བདག་གིས་རྒྱུན་དུ་ཞུགས་པའི་འབྲས་བུ་ཐོབ་བོ་སྙམ་དུ་སེམས་སམ་། རབ་འབྱོར་གྱིས་གསོལ་པ་། བཅོམ་ལྡན་འདས་། དེ་ནི་། མ་ལགས་སོ་༎ དེ་ཅིའི་སླད་དུ་ཞེ་ན་། བཅོམ་ལྡན་འདས་། དེ་ནི་། ཅི་ལའང་ཞུགས་པ་མ་མཆིས་པའི་སླད་དུ་སྟེ་། དེས་ན་། རྒྱུན་དུ་ཞུགས་པ་ཞེས་བགྱིའོ་༎ གཟུགས་ལའང་མ་ཞུགས་། སྒྲ་ལ་མ་ལགས་། དྲི་ལ་མ་ལགས་། རོ་ལ་མ་ལགས་། རེག་བྱ་ལ་མ་ལགས་། ཆོས་ལའང་མ་ཞུགས་ཏེ་། དེས་ན་། རྒྱུན་དུ་ཞུགས་པ་ཞེས་བགྱིའོ་༎ བཅོམ་ལྡན་འདས་། གལ་ཏེ་རྒྱུན་དུ་ཞུགས་པ་དེ་འདི་སྙམ་དུ་། བདག་གིས་རྒྱུན་དུ་ཞུགས་པའི་འབྲས་བུ་ཐོ་བ་བོ༏་༏སྙམ་དུ་སེམས་པར་གྱུར་ན་། དེ་ཉིད་དེའི་བདག་ཏུ་འཛིན་པར་འགྱུར་ལགས་སོ་༎ སེམས་ཅན་དུ་འཛིན་པ་དང་། སྲོག་ཏུ་འཛིན་པ་དང་། གང་ཟག་ཏུ་འཛིན་པར་འགྱུར་ལགས་སོ་༎ བཅོམ་ལྡན་འདས་ཀྱིས་བཀའ་སྩལ་པ་། རབ་འབྱོར་། འདི་ཇི་སྙམ་དུ་སེམས་། ལན་གཅིག་ཕྱིར་འོང་བ་འདི་སྙམ་དུ་། བདག་གིས་ལན་གཅིག་ཕྱིར་འོང་བའི་འབྲས་བུ་ཐོབ་བོ་༎ སྙམ་དུ་སེམས་སམ་། རབ་འབྱོར་གྱིས་གསོལ་པ་། བཅོམ་ལྡན་འདས་། དེ་ནི་། མ་ལགས་སོ་༎ དེ་ཅིའི་སླད་དུ་ཞེ་ན་། གང་ལན་གཅིག་ཕྱིར་འོང་བ་ཉིད་དུ་ཞུགས་པའི་ཆོས་དེ་གང་ཡང་མ་༄༢༢༠བ་མཆིས་པའི་སླད་དུ་སྟེ་། དེས་ན་། ལན་གཅིག་ཕྱིར་འོང་བ་ཞེས་བགྱིའོ་༎ བཅོམ་ལྡན་འདས་ཀྱིས་བཀའ་སྩལ་པ་། རབ་འབྱོར་། འདི་ཇི་སྙམ་དུ་སེམས་། ཕྱིར་མི་འོང་བ་འདི་སྙམ་དུ་། བདག་གིས་ཕྱིར་མི་འོང་བའི་འབྲས་བུ་ཐོབ་བོ་༎ སྙམ་དུ་སེམས་སམ་། རབ་འབྱོར་གྱིས་གསོལ་པ་། བཅོམ་ལྡན་འདས་དེ་ནི་། མ་ལགས་སོ་༎ དེ་ཅིའི་སླད་དུ་ཞེ་ན་། གང་ཕྱིར་མི་འོང་བ་ཉིད་དུ་ཞུགས་པའི་ཆོས་དེ་གང་ཡང་མ་མཆིས་པའི་སླད་དུ་སྟེ་། དེས་ན་། ཕྱིར་མི་འོང་བ་ཞེས་བགྱིའོ་༎ བཅོམ་ལྡན་འདས་ཀྱིས་བཀའ་སྩལ་པ་། རབ་འབྱོར་། འདི་ཇི་སྙམ་དུ་སེམས་། དགྲ་བཅོམ་པ་འདི་སྙམ་དུ་། བདག་གིས་དགྲ་བཅོམ་པ་ཉིད་ཐོབ་བོ་༎ སྙམ་དུ་སེམས་སམ་། རབ་འབྱོར་གྱིས་གསོལ་པ་། བཅོམ་ལྡན་འདས་། དེ་ནི་། མ་ལགས་སོ་༎ དེ་ཅིའི་སླད་དུ་ཞེ་ན་། གང་དགྲ་བཅོམ་པ་ཞེས་བགྱི་བའི་ཆོས་དེ་གང་ཡང་མ་མཆིས་པའི་སླད་དུའོ་༎ བཅོམ་ལྡན་འདས་། གལ་ཏེ་དགྲ་བཅོམ་པ་འདི་སྙམ་དུ་། བདག་གིས་དགྲ་བཅོམ་པ་ཉིད་ཐོབ་བོ་༎ སྙམ་དུ་སེམས་པར་གྱུར་ན་། དེ་ཉིད་དེའི་བདག་ཏུ་འཛིན་པར་འགྱུར་ལགས་སོ་༎ སེམས་ཅན་དུ་འཛིན་པ་དང་། སྲོག་ཏུ་འཛིན་པ་དང་། གང་ཟག་ཏུ་འཛིན་པར་འགྱུར་ལགས་སོ་༎ བཅོམ་ལྡན་འདས༏་བདག་ནི་། དེ་བཞིན་གཤེགས་པ་དགྲ་བཅོམ་པ་ཡང་དག་པར་རྫོགས་པའི་སངས་རྒྱས་ཀྱིས་ཉོན་མོངས་པ་མེད་པར་གནས་པ་རྣམས་ཀྱི་མཆོག་ཏུ་བསྟན་ཏེ་། བཅོམ་ལྡན་འདས་། ༄༢༢༡ཨ་༌༎ བདག་འདོད་ཆགས་དང་བྲལ་བ་དགྲ་བཅོམ་པ་ལགས་ཀྱང་། བཅོམ་ལྡན་འདས་། བདག་འདི་སྙམ་དུ་། བདག་ནི་། དགྲ་བཅོམ་པའོ་༎ སྙམ་དུ་མི་སེམས་ལགས་སོ་༎ བཅོམ་ལྡན་འདས་། གལ་ཏེ་བདག་འདི་སྙམ་དུ་། བདག་གིས་དགྲ་བཅོམ་པ་ཉིད་ཐོབ་བོ་༎ སྙམ་དུ་སེམས་པར་གྱུར་ན་། དེ་བཞིན་གཤེགས་པས་བདག་ལ་རིགས་ཀྱི་བུ་རབ་འབྱོར་ནི་། ཉོན་མོངས་པ་མེད་པར་གནས་པ་རྣམས་ཀྱི་མཆོག་ཡིན་ཏེ་། ཅི་ལའང་མི་གནས་པས་ན་། ཉོན་མོངས་པ་མེད་པར་གནས་པ་། ཉོན་མོངས་པ་མེད་པར་གནས་པ་ཞེས་ལུང་མི་སྟོན་ལགས་སོ་༎ བཅོམ་ལྡན་འདས་ཀྱིས་བཀའ་སྩལ་པ་། རབ་འབྱོར་། འདི་ཇི་སྙམ་དུ་སེམས་། དེ་བཞིན་གཤེགས་པས་དེ་བཞིན་གཤེགས་པ་དགྲ་བཅོམ་པ་ཡང་དག་པར་རྫོགས་པའི་སངས་རྒྱས་མར་མེ་མཛད་ལས་གང་བླངས་པའི་ཆོས་དེ་གང་ཡང་ཡོད་དམ་། རབ་འབྱོར་གྱིས་གསོལ་པ་། བཅོམ་ལྡན་འདས་། དེ་ནི་། མ་ལགས་ཏེ་། དེ་བཞིན་གཤེགས་པས་དེ་བཞིན་གཤེགས་པ་དགྲ་བཅོམ་པ་ཡང་དག་པར་རྫོགས་པའི་སངས་རྒྱས་མར་མེ་མཛད་ལས་གང་བླངས་པའི་ཆོས་དེ་གང་ཡང་མ་མཆིས་སོ་༎ བཅོམ་ལྡན་འདས་ཀྱིས་བཀའ་སྩལ་པ་། རབ་འབྱོར་། བྱང་ཆུབ་སེམས་དཔའ་གང་ལ་ལ་ཞིག་འདི་སྐད་དུ་། བདག་གིས་ཞིང་བཀོད་པ་རྣམས་བསྒྲུབ་པར་བྱའོ་༎ ཞེས་ཟེར་ན་། དེ་ནི་། མི་བདེན་པར་སྨྲ་བའོ་༎ དེ་ཅིའི་ཕྱིར་ཞེ་ན་། ༄༢༢༡བ་རབ་འབྱོར་། ཞིང་བཀོད་པ་རྣམས་ཞིང་བཀོད་པ་རྣམས་ཞེས་བྱ་བ་ནི་། བཀོད་པ་དེ་དག་མེད་པར་དེ་བཞིན་གཤེགས་པས་གསུངས་པའི་ཕྱིར་ཏེ་། དེས་ན་། ཞིང་བཀོད་པ་རྣམས་ཞེས་བྱའོ་༎ རབ་འབྱོར༏་དེ་ལྟ་བས་ན་། བྱང་ཆུབ་སེམས་དཔའ་སེམས་དཔའ་ཆེན་པོས་འདི་ལྟར་མི་གནས་པར་སེམས་བསྐྱེད་པར་བྱའོ་༎ ཅི་ལའང་མི་གནས་པར་སེམས་བསྐྱེད་པར་བྱའོ་༎ གཟུགས་ལའང་མི་གནས་པར་སེམས་བསྐྱེད་པར་བྱའོ་༎ སྒྲ་དང་། དྲི་དང་། རོ་དང་། རེག་བྱ་དང་། ཆོས་ལའང་མི་གནས་པར་སེམས་བསྐྱེད་པར་བྱའོ་༎ རབ་འབྱོར་། འདི་ལྟ་སྟེ་། དཔེར་ན་། སྐྱེས་བུ་ཞིག་ལུས་འདི་ལྟ་བུར་གྱུར་ཏེ་། འདི་ལྟ་སྟེ་། རིའི་རྒྱལ་པོ་རི་རབ་ཙམ་དུ་གྱུར་ན་། རབ་འབྱོར་། འདི་ཇི་སྙམ་དུ་སེམས་། ལུས་དེ་ཆེ་བ་ཡིན་ནམ་། རབ་འབྱོར་གྱིས་གསོལ་པ་། བཅོམ་ལྡན་འདས༏་ལུས་དེ་ཆེ་བ་ལགས་སོ་༎ བདེ་བར་གཤེགས་པ་། ལུས་དེ་ཆེ་ལགས་སོ་༎ དེ་ཅིའི་སླད་དུ་ཞེ་ན་། དེ་བཞིན་གཤེགས་པས་དེ་དངོས་པོ་མ་མཆིས་པར་གསུངས་པའི་སླད་དུ་སྟེ༏་དེས་ན་། ལུས་ཞེས་བགྱིའོ་༎ དེ་དངོས་པོ་མ་མཆིས་པར་དེ་བཞིན་གཤེགས་པས་གསུངས་ཏེ་། དེས་ན་། ལུས་ཆེ་ཞེས་བགྱིའོ་༎ བཅོམ་ལྡན་འདས་ཀྱིས་བཀའ་སྩལ་པ་། རབ་འབྱོར༏་འདི་ཇི་སྙམ་དུ་སེམས་། གངགའའི་ཀླུང་གི་བྱེ་མ་ཇི་སྙེད་པ་གངགའའི་ཀླུང་ཡང་དེ་སྙེད་ཁོ་ནར་གྱུར་ན་། དེ་དག་གི་བྱེ་མ་གང་ཡིན་པ་དེ་དག་མང་བ་ཡིན་ནམ་། རབ་འབྱོར་གྱིས་༄༢༢༢ཨ་༌༎ གསོལ་པ་། བཅོམ་ལྡན་འདས་། གངགའའི་ཀླུང་དེ་དག་ཉིད་ཀྱང་མང་ལགས་ན་། དེ་དག་གི་བྱེ་མ་ལྟ་སྨོས་ཀྱང་མི་འཚལ་། བཅོམ་ལྡན་འདས་ཀྱིས་བཀའ་སྩལ་པ་། རབ་འབྱོར་། ཁྱོད་མོས་པར་བྱ་། ཁྱོད་ཀྱིས་ཁོང་དུ་ཆུད་པར་བྱའོ་༎ གངགའའི་ཀླུང་དེ་དག་གི་བྱེ་མ་ཇི་སྙེད་པ་དེ་སྙེད་ཀྱི་འཇིག་རྟེན་གྱི་ཁམས་ཀྱི་སྐྱེས་པའམ་། བུད་མེད་གང་ལ་ལ་ཞིག་གིས་རིན་པོ་ཆེ་སྣ་བདུན་གྱིས་རབ་ཏུ་གང་བར་བྱས་ཏེ་དེ་བཞིན་གཤེགས་པ་དགྲ་བཅོམ་པ་ཡང་དག་པར་རྫོགས་པའི་སངས་རྒྱས་རྣམས་ལ་སྦྱིན་པ་བྱིན་ན་། ། རབ་འབྱོར་། འདི་ཇི་སྙམ་དུ་སེམས་། སྐྱེས་པའམ་བུད་མེད་དེ་། གཞི་དེ་ལས་བསོད་ནམས་མང་དུ་བསྐྱེད་དམ་། རབ་འབྱོར་གྱིས་གསོལ་པ་། བཅོམ་ལྡན་འདས་། མང་ལགས་སོ་༎ བདེ་བར་གཤེགས་པ་། མང་ལགས་ཏེ༏་སྐྱེས་པའམ་བུད་མེད་དེ་། གཞི་དེ་ལས་བསོད་ནམས་མང་དུ་བསྐྱེད་དོ་༎ བཅོམ་ལྡན་འདས་ཀྱིས་བཀའ་སྩལ་པ་། རབ་འབྱོར་། གང་གིས་འཇིག་རྟེན་གྱི་ཁམས་དེ་སྙེད་རིན་པོ་ཆེ་སྣ་བདུན་གྱིས་རབ་ཏུ་གང་བར་བྱས་ཏེ་དེ་བཞིན་གཤེགས་པ་དགྲ་བཅོམ་པ་ཡང་དག་པར་རྫོགས་པའི་སངས་རྒྱས་རྣམས་ལ་སྦྱིན་པ་བྱིན་པ་བས་། གང་གིས་ཆོས་ཀྱི་རྣམ་གྲངས་འདི་ལས་ཐ་ན་ཚིག་བཞི་པའི་ཚིགས་སུ་བཅད་པ་ཙམ་བཟུང་ནས་གཞན་དག་ལ་ཡང་བཤད་དེ་ཡང་དག་པར་རབ་ཏུ་བསྟན་ན་། དེ་ཉིད་དེའི་གཞི་དེ་ལས་བསོད་ནམས་ཆེས་༄༢༢༢བ་མང་དུ་གྲངས་མེད་དཔག་ཏུ་མེད་པ་བསྐྱེད་དོ་༎ ཡང་རབ་འབྱོར་། ས་ཕྱོགས་གང་ན་ཆོས་ཀྱི་རྣམ་གྲངས་འདི་ལས་ཐ་ན་ཚིག་བཞི་པའི་ཚིགས་སུ་བཅད་པ་ཙམ་འདོན་ཏམ་། བཏོན་པའི་ས་ཕྱོགས་དེ་། ལྷ་དང་། མི་དང་། ལྷ་མ་ཡིན་དུ་བཅས་པའི་འཇིག་རྟེན་གྱི་མཆོད་རྟེན་དུ་གྱུར་པ་ཡིན་ན་། སུ་ཞིག་ཆོས་ཀྱི་རྣམ་གྲངས་འདི་ལེན་པ་དང་། འཛིན་པ་དང་། ཀློག་པ་དང་། ཀུན་ཆུབ་པར་བྱེད་པ་དང་། ཚུལ་བཞིན་དུ་ཡིད་ལ་བྱེད་པ་དེ་། ངོ་མཚར་རབ་དང་ལྡན་པར་གྱུར་པ་ལྟ་ཅི་སྨོས་། ས་ཕྱོགས་དེ་ན་སྟོན་པ་ཡང་བཞུགས་ཏེ་། བླ་མའི་གནས་གཞན་དག་ཀྱང་གནས་སོ་༎ དེ་སྐད་ཅེས་བཀའ་སྩལ་པ་དང་། བཅོམ་ལྡན་འདས་ལ་ཚེ་དང་ལྡན་པ་རབ་འབྱོར་གྱིས་འདི་སྐད་ཅེས་གསོལ་ཏོ་༎ བཅོམ་ལྡན་འདས་། ཆོས་ཀྱི་རྣམ་གྲངས་འདིའི་མིང་ཅི་ལགས་། ཇི་ལྟར་གཟུང་བར་བགྱི་། དེ་སྐད་ཅེས་གསོལ་པ་དང་། བཅོམ་ལྡན་འདས་ཀྱིས་ཚེ་དང་ལྡན་པ་རབ་འབྱོར་ལ་འདི་སྐད་ཅེས་བཀའ་སྩལ་ཏོ་༎ རབ་འབྱོར་། ཆོས་ཀྱི་རྣམ་གྲངས་འདི་ཤེས་རབ་ཀྱི་ཕ་རོལ་ཏུ་ཕྱིན་པ་ཞེས་བྱ་སྟེ་། འདི་དེ་ལྟར་ཟུངས་ཤིག་། དེ་ཅིའི་ཕྱིར་ཞེ་ན་། རབ་འབྱོར་། དེ་བཞིན་གཤེགས་པས་ཤེས་རབ་ཀྱི་ཕ་རོལ་ཏུ་ཕྱིན་པ་གང་གསུངས་པ་དེ་ཉིད་ཕ་རོལ་ཏུ་ཕྱིན་པ་མེད་པའི་ཕྱིར་ཏེ་། དེས་ན་། ཤེས་རབ་ཀྱི་ཕ་རོལ་ཏུ་ཕྱིན་པ་ཞེས་བྱའོ་༎ རབ་འབྱོར་། འདི་ཇི་སྙམ་དུ་སེམས་། དེ་བཞིན་གཤེགས་པས་གང་གསུངས་པའི་ཆོས་དེ་གང་༄༢༢༣ཨ་༌༎ ཡང་ཡོད་དམ་། རབ་འབྱོར་གྱིས་གསོལ་པ་། བཅོམ་ལྡན་འདས་། དེ་བཞིན་གཤེགས་པས་གང་གསུངས་པའི་ཆོས་དེ་དག་གང་ཡང་མ་མཆིས་སོ་༎ བཅོམ་ལྡན་འདས་ཀྱིས་བཀའ་སྩལ་པ་། རབ་འབྱོར་། འདི་ཇི་སྙམ་དུ་སེམས་།
 yāvat subhūte trisāhasramahāsāhasre lokadhātau pṛthivīrajaḥ kaccit tad bahu |	སྟོང་གསུམ་གྱི་སྟོང་ཆེན་པོའི་འཇིག་རྟེན་གྱི་ཁམས་ན་སའི་རྡུལ་ཕྲ་རབ་ཇི་སྙེད་ཡོད་པ་དེ་མང་བ་ཡིན་ནམ་། རབ་འབྱོར་གྱིས་གསོལ་པ་། བཅོམ་ལྡན་འདས་། སའི་རྡུལ་དེ་མང་ལགས་སོ་༎ བདེ་བར་གཤེགས་པ་།
 āha |	མང་ལགས་སོ་༎ དེ་ཅིའི་སླད་དུ་ཞེ་ན་། བཅོམ་ལྡན་འདས་། སའི་རྡུལ་གང་ལགས་པ་དེ་།
 bahu bhagavan tat pṛthivīrajaḥ arajas tathāgatena bhāṣitas tenocyate pṛthivīraja	རྡུལ་མ་མཆིས་པར་དེ་བཞིན་གཤེགས་པས་གསུངས་པའི་སླད་དུ་སྟེ་། དེས་ན་། སའི་རྡུལ་ཞེས་བགྱིའོ་༎
 2| iti | yo 'py asau lokadhātur adhātuḥ sa tathāgatena bhāṣitas tenocyate lokadhātur iti ||	འཇིག་རྟེན་གྱི་ཁམས་གང་ལགས་པ་དེ་ཁམས་མ་མཆིས་པར་དེ་བཞིན་གཤེགས་པས་གསུངས་ཏེ་། དེས་ན་། འཇིག་རྟེན་གྱི་ཁམས་ཞེས་བགྱིའོ་༎
 bhagavān āha |	བཅོམ་ལྡན་འདས་ཀྱིས་བཀའ་སྩལ་པ་། རབ་འབྱོར་།
 tat kiṃ manyase subhūte dvātṛṃśatā mahāpuruṣalakṣaṇais tathāgato draṣṭavyaḥ	འདི་ཇི་སྙམ་དུ་སེམས་། སྐྱེས་བུ་ཆེན་པོའི་མཚན་སུམ་ཅུ་རྩ་གཉིས་པོ་དེ་དག་གིས་དེ་བཞིན་གཤེགས་པ་དགྲ་བཅོམ་པ་ཡང་དག་པར་རྫོགས་པའི་སངས་རྒྱས་སུ་བལྟའམ་། རབ་འབྱོར་གྱིས་གསོལ་པ་། བཅོམ་ལྡན་འདས་། དེ་ནི་། མ་ལགས་སོ་༎
 3| āha | no bhagavaṃs tat kasya heto tāni tāni dvātriṃśan mahāpuruṣalakṣaṇāni tathāgatena bhāṣitāny alakṣaṇāni tenocyante dvātriṃśan mahāpuruṣalakṣaṇānīti	དེ་ཅིའི་སླད་དུ་ཞེ་ན་། སྐྱེས་བུ་ཆེན་པོའི་མཚན་སུམ་ཅུ་རྩ་གཉིས་པོ་གང་དག་དེ་བཞིན་གཤེགས་པས་གསུངས་པ་དེ་དག་མཚན་མ་མཆིས་པར་དེ་བཞིན་༄༢༢༣བ་གཤེགས་པས་གསུངས་པའི་སླད་དུ་སྟེ་། དེས་ན་། དེ་བཞིན་གཤེགས་པའི་མཚན་སུམ་ཅུ་རྩ་གཉིས་ཞེས་བགྱིའོ་༎
 bhagavān āha | yaś ca khalu	བཅོམ་ལྡན་འདས་ཀྱིས་བཀའ་སྩལ་པ་། ཡང་རབ་འབྱོར་།
 4| punaḥ subhūte strī vā puruṣo vā gaṃgānadīvālukopamān ātmabhāvān parityajed yaś ceto dharmaparyāyād antaśaś catuṣpadikām api gāthām udgṛhya parebhyo deśayed ayam eva	སྐྱེས་པའམ་བུད་མེད་གང་གིས་ལུས་གངགའའི་ཀླུང་གི་བྱེ་མ་སྙེད་ཡོངས་སུ་བཏང་བ་བས་། གང་གིས་ཆོས་ཀྱི་རྣམ་གྲངས་འདི་ལས་ཐ་ན་ཚིག་བཞི་པའི་ཚིགས་སུ་བཅད་པ་ཙམ་བཟུང་སྟེ་གཞན་དག་ལ་ཡང་བསྟན་ན་།
 5| tatonidānaṃ bahu puṇyaṃ prasavetāprameyam asaṃkhyeyaṃ ||	དེ་གཞི་དེ་ལས་བསོད་ནམས་ཆེས་མང་དུ་གྲངས་མེད་དཔག་ཏུ་མེད་པ་བསྐྱེད་དོ་༎
 atha khalv āyuṣmāṃ subhūtir dharmapravegenāsrūṇi prāmuṃcat so 'srūṇi prāmṛjya bhagavantam etad avocat* āścaryaṃ	དེ་ནས་ཚེ་དང་ལྡན་པ་རབ་འབྱོར་ཆོས་ཀྱི་ཤུགས་ཀྱིས་མཆི་མ་ཕྱུང་སྟེ༏་དེས་མཆིམ་ཕྱིས་ནས་བཅོམ་ལྡན་འདས་ལ་འདི་སྐད་ཅེས་གསོལ་ཏོ་༎ འདི་ལྟར་ཆོས་ཀྱི་རྣམ་གྲངས་འདི་དེ་བཞིན་གཤེགས་པས་གསུངས་པ་ནི་། བཅོམ་ལྡན་འདས་།
 6| bhagavan paramāścaryaṃ sugata |	ངོ་མཚར་ལགས་སོ་༎ བདེ་བར་གཤེགས་པ་། ངོ་མཚར་ལགས་སོ་༎
 yāvad ayaṃ dharmaparyāyas tathāgatena bhāṣito yato me bhagavaṃ jñānam utpannaṃ na me jātv ayaṃ dharmaparyāyaḥ śrūtapūrvaḥ parameṇa	བཅོམ་ལྡན་འདས་། བདག་གི་ཡེ་ཤེས་སྐྱེས་ཚུན་ཆད་བདག་གིས་ཆོས་ཀྱི་རྣམ་གྲངས་འདི་སྔོན་ནམ་ཡང་མ་ཐོས་སོ་༎ བཅོམ་ལྡན་འདས་།
 7| te bhagavann āścaryena samanvāgatā bhaviṣyanti ya iha sūtre bhāṣyamāṇe bhūtasaṃjñām utpādayiṣyanti |	མདོ་བཤད་པ་འདི་ལ་གང་དག་ཡང་དག་པར་འདུ་ཤེས་བསྐྱེད་པར་འགྱུར་བའི་སེམས་ཅན་དེ་དག་ནི་། ངོ་མཚར་རབ་དང་ལྡན་པར་འགྱུར་ལགས་སོ་༎ དེ་ཅིའི་སླད་དུ་ཞེ་ན༏་བཅོམ་ལྡན་འདས་།
 yā caiṣā bhagavan bhūtasaṃjñā saivā x-ṃj-x-ā x smāt tathāgato bhāṣate folio 5b (g 1381; chak 183|12-184|9; du 152|15-154|11; mm 30|12-32|1; cz 39|20-41|19; par 183|10-184|20; tib 253|2|5-3|8)	ཡང་དག་པར་འདུ་ཤེས་པ་གང་ལགས་པ་དེ་ཉིད་འདུ་ཤེས་མ་མཆིས་པའི་སླད་དུ་སྟེ་། དེ་བས་ན་།
 1| bhū xxx bhūtasaṃjñeti |	ཡང་དག་པར་འདུ་ཤེས་ཡང་དག་པར་འདུ་ཤེས་ཞེས་དེ་༄༢༢༤ཨ་༌༎ བཞིན་གཤེགས་པས་གསུངས་སོ་༎
 na me bhagavann āścaryaṃ yad aham imaṃ dharmaparyāyaṃ bhāṣyamāṇam avakalpayāmy adhimucya |	བཅོམ་ལྡན་འདས་། བདག་ཆོས་ཀྱི་རྣམ་གྲངས་འདི་བཤད་པ་ལ་རྟོག་ཅིང་མོས་པ་ནི་། བདག་ལ་མོས་པ་མ་ལགས་ཀྱི༏་བཅོམ་ལྡན་འདས་།
 ye te bhagavan satvā imaṃ dharmaparyāyam udgrahīṣyanti | yāvat paryavāpsyanti	སླད་མའི་ཚེ་སླད་མའི་དུས་ལྔ་བརྒྱ་ཐ་མ་ལ་སེམས་ཅན་གང་དག་ཆོས་ཀྱི་རྣམ་གྲངས་འདི་ལེན་པ་དང་། འཛིན་པ་དང་། ཀློག་པ་དང་། ཀུན་ཆུབ་པར་བགྱིད་པ་དེ་དག་ནི་།
 2| | te paramāścaryasamanvāgatā bhaviṣyanti |	ངོ་མཚར་རབ་དང་ལྡན་པར་འགྱུར་ལགས་སོ་༎ ཡང་བཅོམ་ལྡན་འདས་། དེ་དག་ནི་།
 api tu khalu punar bhagavan na teṣām ātmasaṃjñā pravartsyate | na satvasaṃjñā na jīvasaṃjñā na pudgalasaṃjñā |	བདག་ཏུ་འདུ་ཤེས་འཇུག་པར་མི་འགྱུར་། སེམས་ཅན་དུ་འདུ་ཤེས་པ་དང་། སྲོག་ཏུ་འདུ་ཤེས་པ་དང་། གང་ཟག་ཏུ་འདུ་ཤེས་འཇུག་པར་མི་འགྱུར་ལགས་སོ་༎ དེ་ཅིའི་སླད་དུ་ཞེ་ན་། བཅོམ་ལྡན་འདས་། བདག་ཏུ་འདུ་ཤེས་པ་དང་། སེམས་ཅན་དུ་འདུ་ཤེས་པ་དང་། སྲོག་ཏུ་འདུ་ཤེས་པ་དང་། གང་ཟག་ཏུ་འདུ་ཤེས་པ་གང་ལགས་པ་དེ་དག་ཉིད་འདུ་ཤེས་མ་མཆིས་པའི་སླད་དུའོ་༎
 tat kasya hetoḥ sarvasaṃjñāpagatāhi	དེ་ཅིའི་སླད་དུ་ཞེ་ན་།
 3| buddhā bhagavantaḥ bhagavān āha |	སངས་རྒྱས་བཅོམ་ལྡན་འདས་རྣམས་ནི་། འདུ་ཤེས་ཐམས་ཅད་དང་བྲལ་བའི་སླད་དུའོ་༎ དེ་སྐད་ཅེས་གསོལ་པ་དང་། བཅོམ་ལྡན་འདས་ཀྱིས་ཚེ་དང་ལྡན་པ་རབ་འབྱོར་ལ་འདི་སྐད་ཅེས་བཀའ་སྩལ་ཏོ་༎ རབ་འབྱོར༏་དེ་དེ་བཞིན་ནོ་༎ དེ་དེ་བཞིན་ཏེ་།
 evam etat subhūte paramāścaryasamanvāgatās te bhaviṣyanti ya imaṃ dharmaparyāyaṃ śrutvā nottrasiṣyanti | na saṃtrasiṣyanti | na saṃtrāsam āpatsyante	མདོ་འདི་བཤད་པ་འདི་ལ་གང་དག་མི་སྐྲག་མི་དང་བཞིང་དངང་བར་མི་འགྱུར་བའི་སེམས་ཅན་དེ་དག་ནི་། ངོ་མཚར་རབ་དང་ལྡན་པར་༄༢༢༤བ་འགྱུར་རོ་༎ དེ་ཅིའི་ཕྱིར་ཞེ་ན་།
 4| | tat kasya hetoḥ paramapāramiteyaṃ subhūte tathāgatena bhāṣitā| yāṃ ca tathāgataḥ paramapāramitāṃ bhāṣate |	རབ་འབྱོར་། ཕ་རོལ་ཏུ་ཕྱིན་པ་དམ་པ་འདི་ནི་། དེ་བཞིན་གཤེགས་པས་གསུངས་ཏེ་།
 tām aparimāṇā buddhā bhagavanto bhāṣante |	ཕ་རོལ་ཏུ་ཕྱིན་པ་དམ་པ་གང་དག་དེ་བཞིན་གཤེགས་པས་གསུངས་པ་དེ༏་སངས་རྒྱས་བཅོམ་ལྡན་འདས་དཔག་ཏུ་མེད་པ་རྣམས་ཀྱིས་ཀྱང་གསུངས་པའི་ཕྱིར་ཏེ་། 
 tenocyate paramapāramiteti	དེས་ན་། ཕ་རོལ་ཏུ་ཕྱིན་པ་དམ་པ་ཞེས་བྱའོ་༎ ཡང་རབ་འབྱོར་།
 5| || api tu khalu punaḥ subhūte ya tathāgatasya kṣāntipāramitā saivāpāramitā |	དེ་བཞིན་གཤེགས་པའི་བཟོད་པའི་ཕ་རོལ་ཏུ་ཕྱིན་པ་གང་ཡིན་པ་དེ་ཉིད་ཕ་རོལ་ཏུ་ཕྱིན་པ་མེད་དོ་༎ དེ་ཅིའི་ཕྱིར་ཞེ་ན་། རབ་འབྱོར་།
 tat kasya hetoḥ yadā subhūte kalirājāṅgapratyaṃgamāṃsāny acchaitsīt nāsīn	གང་གི་ཚེ་ཀ་ལིངཀའི་རྒྱལ་པོས་ངའི་ཡན་ལག་དང་། ཉིང་ལག་རྣམ་པར་བཅད་པར་གྱུར་པ་དེའི་ཚེ་ང་ལ་བདག་ཏུ་འདུ་ཤེས་སམ་།
 6| me tasmin samaye ātmasaṃjñā vā satvasaṃjñā vā jīvasaṃjñā vā pudgalasaṃjñā vā |	སེམས་ཅན་དུ་འདུ་ཤེས་སམ་། སྲོག་ཏུ་འདུ་ཤེས་སམ་། གང་ཟག་ཏུ་འདུ་ཤེས་ཀྱང་མ་བྱུང་ཞིང་། ང་ལ་འདུ་ཤེས་ཅི་ཡང་མེད་ལ་། འདུ་ཤེས་མེད་པར་གྱུར་པ་ཡང་མ་ཡིན་པའི་ཕྱིར་རོ་༎ དེ་ཅིའི་ཕྱིར་ཞེ་ན་། རབ་འབྱོར་། གལ་ཏེ་དེའི་ཚེ་བདག་ཏུ་འདུ་ཤེས་བྱུང་ན་། དེའི་ཚེ་གནོད་སེམས་ཀྱི་འདུ་ཤེས་ཀྱང་འབྱུང་ལ་། སེམས་ཅན་དུ་འདུ་ཤེས་པ་དང་། སྲོག་ཏུ་འདུ་ཤེས་པ་དང་། གང་ཟག་ཏུ་འདུ་ཤེས་པ་བྱུང་ན་།
 vyāpādasaṃjñā vāpi me tasmin samaye 'bhaviṣyad abhijānāmy ahaṃ subhūte atīte 'dhvani paṃca jātiśatāni	དེའི་ཚེ་གནོད་སེམས་ཀྱི་འདུ་ཤེས་ཀྱང་འབྱུང་བའི་ཕྱིར་རོ་༎ རབ་འབྱོར་། ངས་མངོན་པར་ཤེས་ཏེ༏་འདས་པའི་དུས་ན་ང་ཚེ་རབས་ལྔ་བརྒྱར་བཟོད་པར་སྨྲ་བ་ཞེས་བྱ་བའི་དྲང་སྲོང་དུ་གྱུར་པ་དེ་ན་ཡང་ང་ལ་བདག་ཏུ་འདུ་ཤེས་མ་བྱུང་།
 7| yo 'haṃ kṣāntivādī ṛṣir abhūvaṃs tatrāpi me nātmasaṃjñābhūn na satvasaṃjñā na jīvasaṃjñā na pudgalasaṃjñā |	སེམས་ཅན་དུ་འདུ་ཤེས་པ་དང་། སྲོག་ཏུ་འདུ་ཤེས་༄༢༢༥ཨ་༌༎ པ་དང་། གང་ཟག་ཏུ་འདུ་ཤེས་པ་མ་བྱུང་ངོ་༎ རབ་འབྱོར་།
 tasmāt tarhi subhūte bodhisatvena mahāsatvena sarvasaṃjñā varjayitvā folio 7a (g 1382; chak 184|9-185|4; du 156|14-157|13;	དེ་ལྟ་བས་ན་། བྱང་ཆུབ་སེམས་དཔའ་སེམས་དཔའ་ཆེན་པོས་འདུ་ཤེས་ཐམས་ཅད་རྣམ་པར་སྤངས་ཏེ་བླ་ན་མེད་པ་ཡང་དག་པར་རྫོགས་པའི་བྱང་ཆུབ་ཏུ་སེམས་བསྐྱེད་པར་བྱའོ་༎ གཟུགས་ལ་མི་གནས་པར་སེམས་བསྐྱེད་པར་བྱའོ་༎ སྒྲ་དང་། དྲི་དང་། རོ་དང་། རེག་བྱ་དང་། ཆོས་ལའང་མི་གནས་པར་སེམས་བསྐྱེད་པར་བྱའོ་༎ ཆོས་མེད་པ་ལའང་མི་གནས་པར་སེམས་བསྐྱེད་པར་བྱའོ་༎ ཅི་ལའང་མི་གནས་པར་སེམས་བསྐྱེད་པར་བྱའོ་༎ དེ་ཅིའི་ཕྱིར་ཞེ་ན་། གནས་པ་གང་ཡིན་པ་དེ་ཉིད་མི་གནས་པའི་ཕྱིར་ཏེ་། དེ་བས་ན་། དེ་བཞིན་གཤེགས་པས་འདི་སྐད་དུ་། བྱང་ཆུབ་སེམས་དཔས་མི་གནས་པར་སྦྱིན་པ་སྦྱིན་པར་བྱའོ་༎
 mm 34|2-35|2; cz 44|6-45|11; par 186|11-187|7; tib 253|5|7-254|1|7)	ཞེས་གསུངས་སོ་༎ ཡང་རབ་འབྱོར་། བྱང་ཆུབ་སེམས་དཔས་འདི་ལྟར་སེམས་ཅན་ཐམས་ཅད་ཀྱི་དོན་གྱི་ཕྱིར་སྦྱིན་པ་ཡོངས་སུ་གཏང་བར་བྱའོ་༎ སེམས་ཅན་དུ་འདུ་ཤེས་པ་གང་ཡིན་པ་དེ་ཉིད་ཀྱང་འདུ་ཤེས་མེད་པ་སྟེ་། དེ་བཞིན་གཤེགས་པས་སེམས་ཅན་ཐམས་ཅད་ཅེས་གང་གསུངས་པ་དེ་བདག་ཉིད་ཀྱང་མེད་པའོ་༎ དེ་ཅིའི་ཕྱིར་ཞེ་ན་། རབ་འབྱོར་། དེ་བཞིན་གཤེགས་པ་ནི་། ཡང་དག་པར་གསུང་པ་། བདེན་པར་གསུང་བ་། དེ་བཞིན་ཉིད་དུ་གསུང་བ་སྟེ་། དེ་བཞིན་གཤེགས་པ་ནི་། མ་ནོར་བ་དེ་བཞིན་ཉིད་གསུང་བའི་ཕྱིར་རོ་༎ ༄༢༢༥བ་ཡང་རབ་འབྱོར་། དེ་བཞིན་གཤེགས་པས་ཆོས་གང་མངོན་པར་རྫོགས་པར་སངས་རྒྱས་པའམ་། བསྟན་པ་དེ་ལ་ནི་། བདེན་པ་ཡང་མེད་། རྫུན་པ་ཡང་མེད་དོ་༎ རབ་འབྱོར་། འདི་ལྟ་སྟེ༏་དཔེར་ན་། མིག་དང་ལྡན་པའི་མི་ཞིག་མུན་པར་ཞུགས་ན་ཅི་ཡང་མི་མཐོང་བ་དེ་བཞིན་དུ་གང་དངོས་པོར་ལྷུང་བས་སྦྱིན་པ་ཡོངས་སུ་གཏོང་བའི་བྱང་ཆུབ་སེམས་དཔར་བལྟའོ༏་༏རབ་འབྱོར་། འདི་ལྟ་སྟེ་། དཔེར་ན་། ནམ་ལངས་ཏེ་ཉི་མ་ཤར་ནས་མིག་དང་ལྡན་པའི་མིས་གཟུགས་རྣམ་པ་སྣ་ཚོགས་དག་མཐོང་བ་དེ་བཞིན་དུ་གང་དངོས་པོར་མ་ལྷུང་བས་སྦྱིན་པ་ཡོངས་སུ་གཏོང་བའི་བྱང་ཆུབ་སེམས་དཔར་བལྟའོ་༎ ཡང་རབ་འབྱོར་། རིགས་ཀྱི་བུའམ་། རིགས་ཀྱི་བུ་མོ་གང་དག་ཆོས་ཀྱི་རྣམ་གྲངས་འདི་ལེན་པ་དང་། འཛིན་པ་དང་། ཀློག་པ་དང་། ཀུན་ཆུབ་པར་བྱེད་པ་དང་། གཞན་དག་ལ་ཡང་རྒྱ་ཆེར་ཡང་དག་པར་རབ་ཏུ་སྟོན་པ་དེ་དག་ནི་། དེ་བཞིན་གཤེགས་པས་མཁྱེན་། དེ་དག་ནི་། དེ་བཞིན་གཤེགས་པས་གཟིགས་ཏེ་། སེམས་ཅན་དེ་དག་ཐམས་ཅད་ནི་། བསོད་ནམས་ཀྱི་ཕུང་པོ་དཔག་ཏུ་མེད་པ་བསྐྱེད་པར་འགྱུར་རོ་༎ ཡང་རབ་འབྱོར་། སྐྱེས་པའམ་། བུད་མེད་གང་ཞིག་སྔ་དྲོའི་དུས་ཀྱི་ཚེ་ལུས་གངགའའི་ཀླུང་གི་བྱེ་མ་སྙེད་ཡོངས་སུ་གཏོང་ལ་། ཕྱེད་ཀྱི་དུས་དང་། ཕྱི་དྲོའི་དུས་ཀྱི་ཚེ་ཡང་ལུས་གངགའའི་ཀླུང་གི་བྱེ་མ་སྙེད་ཡོངས་སུ་གཏོང་སྟེ་། རྣམ་གྲངས་འདི་ལྟ་༄༢༢༦ཨ་༌༎ བུར་བསྐལ་པ་བྱེ་བ་ཁྲག་ཁྲིག་འབུམ་ཕྲག་དུ་མར་ལུས་ཡོངས་སུ་གཏོང་བ་བས་། གང་གིས་ཆོས་ཀྱི་རྣམ་གྲངས་འདི་ཐོས་ནས་མི་སྤོང་ན་། དེ་ཉིད་གཞི་དེ་ལས་བསོད་ནམས་ཆེས་མང་དུ་གྲངས་མེད་དཔག་ཏུ་མེད་པ་བསྐྱེད་ན་། གང་གིས་ཡི་གེར་བྲིས་ནས་ལེན་པ་དང་། འཛིན་པ་དང་། ཀློག་པ་དང་། ཀུན་ཆུབ་པར་བྱེད་པ་དང་། གཞན་དག་ལ་ཡང་རྒྱ་ཆེར་ཡང་དག་པར་རབ་ཏུ་སྟོན་པ་ལྟ་ཅི་སྨོས་། ཡང་རབ་འབྱོར་། ཆོས་ཀྱི་རྣམ་གྲངས་འདི་ནི་། བསམ་གྱིས་མི་ཁྱབ་ཅིང་མཚུངས་པ་མེད་དེ་། ཆོས་ཀྱི་རྣམ་གྲངས་འདི་ནི༏་ཐེག་པ་མཆོག་ལ་ཡང་དག་པར་ཞུགས་པའི་སེམས་ཅན་རྣམས་ཀྱི་དོན་དང་། ཐེག་པ་ཕུལ་དུ་ཕྱིན་པ་ལ་ཡང་དག་པར་ཞུགས་པའི་སེམས་ཅན་རྣམས་ཀྱི་དོན་གྱི་ཕྱིར་དེ་བཞིན་གཤེགས་པས་གསུངས་སོ་༎ གང་དག་ཆོས་ཀྱི་རྣམ་གྲངས་འདི་ལེན་པ་དང་། འཛིན་པ་དང་། ཀློག་པ་དང་། ཀུན་ཆུབ་པར་བྱེད་པ་དང་། གཞན་དག་ལ་ཡང་རྒྱ་ཆེར་ཡང་དག་པར་རབ་ཏུ་སྟོན་པ་དེ་དག་ནི་། དེ་བཞིན་གཤེགས་པས་མཁྱེན་། དེ་དག་ནི་། དེ་བཞིན་གཤེགས་པས་གཟིགས་ཏེ་། སེམས་ཅན་དེ་དག་ཐམས་ཅད་ནི་། བསོད་ནམས་ཀྱི་ཕུང་པོ་དཔག་ཏུ་མེད་པ་དང་ལྡན་པར་འགྱུར་རོ་༎ བསོད་ནམས་ཀྱི་ཕུང་པོ་བསམ་གྱིས་མི་ཁྱབ་པ་དང་། མཚུངས་པ་མེད་པ་དང་། གཞལ་དུ་མེད་པ་དང་། ཚད་མེད་པ་དང་ལྡན་༄༢༢༦བ་པར་འགྱུར་ཏེ་།
 1| ḥrimāṇena | sarve te satvā mamāṃsena bodhiṃ dhārayiṣyanti |	སེམས་ཅན་དེ་དག་ཐམས་ཅད་ངའི་བྱང་ཆུབ་ཕྲག་པ་ལ་ཐོགས་པར་འགྱུར་རོ་༎
 tat kasya hetoḥ na hi śakyaṃ subhūte ayaṃ dharmaparyāyo hīnādhimuktikaiḥ satvaiḥ śrotuṃ|	དེ་ཅིའི་ཕྱིར་ཞེ་ན་། རབ་འབྱོར་། དམན་པ་ལ་མོས་པ་རྣམས་ཀྱིས་ཆོས་ཀྱི་རྣམ་གྲངས་འདི་མཉན་པར་མི་ནུས་ཏེ་།
 nātmadṛṣṭikair na satvajīvapudgaladṛṣṭikaiḥ	བདག་ཏུ་ལྟ་བ་རྣམས་ཀྱིས་མ་ཡིན་། སེམས་ཅན་དུ་ལྟ་བ་རྣམས་ཀྱིས་མ་ཡིན་། སྲོག་ཏུ་ལྟ་བ་རྣམས་ཀྱིས་མ་ཡིན་ཞིང་།
 2| śakyaṃ śrotuṃ udgrahītuṃ vā | yāvat paryavāptuṃ vā nedaṃ sthānaṃ vidyate |	གང་ཟག་ཏུ་ལྟ་བ་རྣམས་ཀྱིས་མཉན་པ་དང་། བླང་བ་དང་། གཟུང་བ་དང་། ཀློག་པ་དང་། ཀུན་ཆུབ་པར་བྱེད་མི་ནུས་ཏེ་། དེ་ནི་། གནས་མེད་པའི་ཕྱིར་རོ་༎
 api tu khalu punaḥ subhūte yatra pṛthivīpradeśe idaṃ sūtraṃ prakāśayiṣyati | pūjanīyaḥ sa 3| pṛthivīpradeśo bhaviṣyati |	ཡང་རབ་འབྱོར་། ས་ཕྱོགས་གང་ན་མདོ་སྡེ་འདི་སྟོན་པའི་ས་ཕྱོགས་དེ་།
 sadevamānuṣāsurasya lokasya vandanīyaḥ pradakṣiṇīkaraṇīyaś caityabhūta sa pṛthivīpradeśo bhaviṣyati |	ལྷ་དང་། མི་དང་། ལྷ་མ་ཡིན་དུ་བཅས་པའི་འཇིག་རྟེན་གྱིས་མཆོད་པར་འོས་པར་འགྱུར་རོ་༎ ས་ཕྱོགས་དེ་ཕྱག་བྱ་བར་འོས་པ་དང་། བསྐོར་བ་བྱ་བར་འོས་པར་ཡང་འགྱུར་རོ་༎ ས་ཕྱོགས་དེ་ནི་། མཆོད་རྟེན་ལྟ་བུར་འགྱུར་རོ་༎ རབ་འབྱོར་།
 ye te subhūte kulaputrā 4| vā kuladuhitaro vā | imān evaṃrūpān sūtrāntān udgrahīṣyanti yāvat paryavāpsyanti |	རིགས་ཀྱི་བུའམ་རིགས་ཀྱི་བུ་མོ་གང་དག་འདི་ལྟ་བུའི་མདོ་སྡེའི་ཚིག་འདི་དག་ལེན་པ་དང་། འཛིན་པ་དང་། ཀློག་པ་དང་། ཀུན་ཆུབ་པར་བྱེད་པ་དེ་དག་ནི་། མནར་བར་འགྱུར་། ཤིན་ཏུ་མནར་བར་འགྱུར་རོ་༎ དེ་ཅིའི་ཕྱིར་ཞེ་ན་།
 te paribhūtā bhaviṣyanti suparibhūtāḥ yāni ca teṣāṃ satvānāṃ pūrvajanmikāny aśubhāni karmāṇy	རབ་འབྱོར་། སེམས་ཅན་དེ་དག་གིས་ཚེ་རབས་སྔ་མའི་མི་དགེ་བའི་ལས་ངན་སོང་དུ་སྐྱེ་བར་འགྱུར་བ་གང་དག་བྱས་པ་དག་ཚེ་འདི་ཉིད་ལ་མནར་བས་། ཚེ་རབས་སྔ་མའི་མི་དགེ་བའི་ལས་དེ་དག་འབྱང་བར་འགྱུར་ཏེ་།
 5| apāyasaṃvartanīyāni tāni dṛṣṭa eva dharme paribhūtatayā kṣapayiṣyanti buddabodhiṃ cānuprāpsyanti |	སངས་རྒྱས་ཀྱི་བྱང་༄༢༢༧ཨ་༌༎ ཆུབ་ཀྱང་འཐོབ་པར་འགྱུར་བའི་ཕྱིར་རོ་༎
 abhijānāmy ahaṃ subhūte atīte 'dhvany asaṃkhyeyaiḥ kalpair asaṃkhyeyatarair	རབ་འབྱོར་། ངས་མངོན་པར་ཤེས་ཏེ་། འདས་པའི་དུས་བསྐལ་པ་གྲངས་མེད་པའི་ཡང་ཆེས་གྲངས་མེད་པ་ན་།
 6| dīpaṃkarasya tathāgatasyārhataḥ samyaksaṃbuddhasya pareṇa caturaśītir buddhakoṭīniyutaśatasahasrāṇy abhūvan yāni mayā ārāgitāni ārāgya ca na virāgitāni | folio 7b (g 1383; chak 185|4-27; du 157|13-159|2; mm 35|2-36|3; cz 45|11-47|5; par 187|7-deest; tib 254|1|7-2|6)	དེ་བཞིན་གཤེགས་པ་དགྲ་བཅོམ་པ་ཡང་དག་པར་རྫོགས་པའི་སངས་རྒྱས་མར་མེ་མཛད་ཀྱི་ཕ་རོལ་གྱི་ཡང་ཆེས་ཕ་རོལ་ན་། སངས་རྒྱས་བྱེ་བ་ཁྲག་ཁྲིག་འབུམ་ཕྲག་བརྒྱད་ཅུ་རྩ་བཞི་དག་བྱུང་བ་ངས་མཉེས་པར་བྱས་ཏེ་། མཉེས་པར་བྱས་ནས་ཐུགས་མ་ཕྱུང་བར་བྱས་ཏེ་། རབ་འབྱོར་།
 1| yac ca mayā subhūte te buddhā bhagavanta ārāgya na virāgitā yac ca carime kāle paścimāyāṃ paṃcāśatyāṃ vartamānāyām imāṃ sūtrāntān udgrahīṣyanti	སངས་རྒྱས་བཅོམ་ལྡན་འདས་དེ་དག་ངས་མཉེས་པར་བྱས་ནས་ཐུགས་བྱུང་བར་མ་བྱས་པ་གང་ཡིན་པ་དང་། ཕྱི་མའི་དུས་ལྔ་བརྒྱ་ཐ་མར་གྱུར་པ་ན་། མདོ་སྡེ་འདི་ལེན་པ་དང་། འཛིན་པ་དང་། ཀློག་པ་དང་། ཀུན་ཆུབ་པར་བྱེད་པ་གང་ཡིན་པ་ལས་། རབ་འབྱོར་།
 yāvat paryavāpsyanti | asya subhūte 2| puṇyaskandhasyāsau pūrvakaḥ puṇyaskandhaḥ śatatamīm api kalān nopaiti | sahasratamīm api |	བསོད་ནམས་ཀྱི་ཕུང་པོ་འདི་ལ་བསོད་ནམས་ཀྱི་ཕུང་པོ་སྔ་མས་བརྒྱའི་ཆར་ཡང་མི་ཕོད་།
 śatasahasratamīm api | saṃkhyām api kalām api gaṇanām apy upamām apy upaniśām 3| api na kṣamate |	སྟོང་གི་ཆ་དང་། འབུམ་གྱི་ཆ་དང་། གྲངས་དང་། ཆ་དང་། བགྲང་བ་དང་། དཔེ་དང་། ཟླ་དང་། རྒྱུར་ཡང་མི་བཟོད་དོ་༎ རབ་འབྱོར་།
 sacet subhūte teṣāṃ kulaputrāṇāṃ kuladuhitrīṇāṃ ca puṇyaskandhaṃ bhāṣeyaṃ yāvantas te satvā kulaputrāḥ kuladuhitaraś ca tasmin samaye puṇyaskandhaṃ 4| parigrahīṣyanti |	གལ་ཏེ་དེའི་ཚེ་རིགས་ཀྱི་བུའམ་རིགས་ཀྱི་བུ་མོ་དག་བསོད་ནམས་ཀྱི་ཕུང་པོ་ཇི་སྙེད་རབ་ཏུ་འཛིན་པར་འགྱུར་བའི་རིགས་ཀྱི་བུའམ་རིགས་ཀྱི་བུ་མོ་དེ་དག་གི་བསོད་ནམས་ཀྱི་ཕུང་པོ་ངས་བརྗོད་ན་། སེམས་ཅན་རྣམས་མྱོ་མྱོ་པོར་འགྱུར་ཏེ་། སེམས་འཁྲུགས་པར་འགྱུར་རོ་༎ ཡང་རབ་འབྱོར་།
 unmādaṃ satvā anuprāpnuyuś cittavikṣepaṃ vā gaccheyuḥ api tu khalu punaḥ subhūte acintyo 'yaṃ dharmaparyāyaḥ asyācintya eva vipākaḥ ||	ཆོས་ཀྱི་རྣམ་༄༢༢༧བ་གྲངས་འདི་བསམ་གྱིས་མི་ཁྱབ་སྟེ་། འདིའི་རྣམ་པར་སྨིན་པ་ཡང་བསམ་གྱིས་མི་ཁྱབ་པ་ཉིད་དུ་རིག་པར་བྱའོ་༎ དེ་ནས་བཅོམ་ལྡན་འདས་ལ་ཚེ་དང་ལྡན་པ་རབ་འབྱོར་གྱིས་འདི་སྐད་ཅེས་གསོལ་ཏོ་༎ བཅོམ་ལྡན་འདས་།
 5| āha | kathaṃ bhagavan bodhisatvayānasaṃprasthitena sthātavyaṃ kathaṃ pratipattavyaṃ kathaṃ cittaṃ pragṛhītavyaṃ |	བྱང་ཆུབ་སེམས་དཔའི་ཐེག་པ་ལ་ཡང་དག་པར་ཞུགས་པས་ཇི་ལྟར་གནས་པར་བགྱི་། ཇི་ལྟར་བསྒྲུབ་པར་བགྱི་། ཇི་ལྟར་སེམས་རབ་ཏུ་གཟུངས་བར་བགྱི་།
 bhagavān āha |	བཅོམ་ལྡན་འདས་ཀྱིས་བཀའ་སྩལ་པ་། རབ་འབྱོར་།
 iha subhūte bodhisatvayānasaṃprasthitenaivaṃ cittam utpādayitavyaṃ	འདི་ལ་བྱང་ཆུབ་སེམས་དཔའི་ཐེག་པ་ལ་ཡང་དག་པར་ཞུགས་པས་འདི་སྙམ་དུ་།
 6| sarvasatvā mayā anupadhiśeṣe nirvāṇadhātau parinirvāpayitavyāḥ evaṃ ca satvān parinirvāpya na kaścit satvaḥ parinirvāpito bhavati |	བདག་གིས་སེམས་ཅན་ཐམས་ཅད་ཕུང་པོ་ལྷག་མ་མེད་པའི་མྱ་ངན་ལས་འདས་པའི་དབྱིངས་སུ་ཡོངས་སུ་མྱ་ངན་ལས་བཟླའོ་༎ དེ་ལྟར་སེམས་ཅན་རྣམས་ཡོངས་སུ་མྱ་ངན་ལས་བཟླས་ཀྱང་སེམས་ཅན་གང་ཡང་ཡོངས་སུ་མྱ་ངན་ལས་བཟླས་པར་གྱུར་པ་མེད་དོ་༎ སྙམ་དུ་སེམས་བསྐྱེད་པར་བྱའོ་༎
 tat kasya hetoḥ sacet folio 8a (g 1384; chak 185|27-186|22; du 159|2-160|10; mm 36|3-37|16; cz 47|5-49|5; par deest-188|10; tib 254|2|6-4|4)	དེ་ཅིའི་ཕྱིར་ཞེ་ན་། རབ་འབྱོར་།
 1| subhūte bodhisatvasya satvasaṃjñā pravarteta |	གལ་ཏེ་བྱང་ཆུབ་སེམས་དཔའ་སེམས་ཅན་དུ་འདུ་ཤེས་འཇུག་ན་། བྱང་ཆུབ་སེམས་དཔའ་ཞེས་མི་བྱ་ལ་། གང་ཟག་གི་བར་དུ་འདུ་ཤེས་འཇུག་ན་ཡང་དེ་བྱང་ཆུབ་སེམས་དཔའ་ཞེས་མི་བྱ་བའི་ཕྱིར་རོ་༎ དེ་ཅིའི་ཕྱིར་ཞེ་ན་།
 jīvasaṃjñā pudgalasaṃjñā vā na sa bodhisatva iti vaktavyaḥ tat kasya hetoḥ nāsti subhūte sa dharmo yo bodhisatvayānasaṃprasthito nāma |	རབ་འབྱོར་། གང་བྱང་ཆུབ་སེམས་དཔའི་ཐེག་པ་ལ་ཡང་དག་པར་ཞུགས་པ་ཞེས་བྱ་བའི་ཆོས་དེ་གང་ཡང་མེད་པའི་ཕྱིར་རོ་༎ རབ་འབྱོར་།
 tat kiṃ manyase	འདི་ཇི་སྙམ་དུ་སེམས་། དེ་བཞིན་༄༢༢༨ཨ་༌༎
 2| subhūte asti sa kaścid dharmo yas tathāgatena dīpaṃkarasya tathāgatasyāntikād anuttarāṃ samyaksaṃbodhim abhisaṃbuddhaḥ āha |	གཤེགས་པས་དེ་བཞིན་གཤེགས་པ་མར་མེ་མཛད་ལས་གང་བླ་ན་མེད་པ་ཡང་དག་པར་རྫོགས་པའི་བྱང་ཆུབ་མངོན་པར་རྫོགས་པར་སངས་རྒྱས་པའི་ཆོས་དེ་གང་ཡང་ཡོད་དམ་། དེ་སྐད་ཅེས་བཀའ་སྩལ་པ་དང་། བཅོམ་ལྡན་འདས་ལ་ཚེ་དང་ལྡན་པ་རབ་འབྱོར་གྱིས་འདི་སྐད་ཅེས་གསོལ་ཏོ་༎ བཅོམ་ལྡན་འདས༏་དེ་བཞིན་གཤེགས་པས་དེ་བཞིན་གཤེགས་པ་མར་མེ་མཛད་ལས་གང་བླ་ན་མེད་པ་ཡང་དག་པར་རྫོགས་པའི་བྱང་ཆུབ་མངོན་པར་རྫོགས་པར་སངས་རྒྱས་པའི་ཆོས་དེ་ཡང་མ་མཆིས་སོ་༎ དེ་སྐད་ཅེས་གསོལ་པ་དང་། བཅོམ་ལྡན་འདས་ཀྱིས་ཚེ་དང་ལྡན་པ་རབ་འབྱོར་ལ་འདི་སྐད་ཅེས་བཀའ་སྩལ་ཏོ་༎ རབ་འབྱོར་། དེ་དེ་བཞིན་ནོ་༎ དེ་དེ་བཞིན་ཏེ་།
 nāsti sa bhagavan kaścid dharmo yas tathāgatena dīpaṃkarasya 3| tathāgatasyāntikād anuttarā samyaksaṃbodhim abhisaṃbuddhaḥ āha |	དེ་བཞིན་གཤེགས་པས་དེ་བཞིན་གཤེགས་པ་མར་མེ་མཛད་ལས་གང་བླ་ན་མེད་པ་ཡང་དག་པར་རྫོགས་པའི་བྱང་ཆུབ་མངོན་པར་རྫོགས་པར་སངས་རྒྱས་པའི་ཆོས་དེ་གང་ཡང་མེད་དོ་༎ རབ་འབྱོར་། གལ་ཏེ་དེ་བཞིན་གཤེགས་པས་གང་མངོན་པར་རྫོགས་པར་སངས་རྒྱས་པའི་ཆོས་དེ་འགའ་ཞིག་ཡོད་པར་གྱུར་ན་། དེ་བཞིན་གཤེགས་པ་མར་མེ་མཛད་ཀྱིས་ང་ལ་བྲམ་ཟེའི་ཁྱེའུ་། ཁྱོད་མ་འོངས་པའི་དུས་ན་དེ་བཞིན་གཤེགས་པ་དགྲ་བཅོམ་པ་ཡང་དག་པར་རྫོགས་པའི་སངས་རྒྱས་ཤའཀྱ་ཐུབ་པ་༄༢༢༨བ་ཞེས་བྱ་བར་འགྱུར་རོ་༎ ཞེས་ལུང་མི་སྟོན་པ་ཞིག་ན་། རབ་འབྱོར་། འདི་ལྟར་དེ་བཞིན་གཤེགས་པས་གང་བླ་ན་མེད་པ་ཡང་དག་པར་རྫོགས་པའི་བྱང་ཆུབ་མངོན་པར་རྫོགས་པར་སངས་རྒྱས་པའི་ཆོས་དེ་གང་ཡང་མེད་པས་། 
 tasmād ahaṃ dīpaṃkareṇa tathāgatena vyākṛto bhaviṣyasi tvaṃ māṇavānāgate 'dhvani śākyamunir nāma tathāgato	དེའི་ཕྱིར་དེ་བཞིན་གཤེགས་པ་མར་མེ་མཛད་ཀྱིས་ངལ་བྲམ་ཟེའི་ཁྱེའུ་། ཁྱོད་མ་འོངས་པའི་དུས་ན་དེ་བཞིན་གཤེགས་པ་དགྲ་བཅོམ་པ་ཡང་དག་པར་རྫོགས་པའི་སངས་རྒྱས་ཤའཀྱ་ཐུབ་པ་ཞེས་བྱ་བར་འགྱུར་རོ་༎ ཞེས་ལུང་བསྟན་ཏོ་༎ དེ་ཅིའི་ཕྱིར་ཞེ་ན་། རབ་འབྱོར་། དེ་བཞིན་གཤེགས་པ་ཞེས་བྱ་བ་ནི་། ཡང་དག་པ་དེ་བཞིན་ཉིད་ཀྱི་ཚིག་བླ་དབ༹གས་ཡིན་པའི་ཕྱིར་རོ་༎
 4| 'rhan samyaksaṃbuddhas tat kasya hetos tathāgata iti subhūte tathatāyā etad adhivacanaṃ yaḥ kaścit subhūte evaṃ vadet tathāgatenānuttarā samyaksaṃbodhir abhisaṃbuddheti |	རབ་འབྱོར་། གང་ལ་ལ་ཞིག་འདི་སྐད་དུ་། དེ་བཞིན་གཤེགས་པ་དགྲ་བཅོམ་པ་ཡང་དག་པར་རྫོགས་པའི་སངས་རྒྱས་ཀྱིས་བླ་ན་མེད་པ་ཡང་དག་པར་རྫོགས་པའི་བྱང་ཆུབ་མངོན་པར་རྫོགས་པར་སངས་རྒྱས་སོ་༎ ཞེས་ཟེར་ན་། དེ་ལོག་པར་སྨྲ་བ་ཡིན་ནོ་༎ དེ་ཅིའི་ཕྱིར་ཞེ་ན་།
 5| nāsti subhūte sa kaścid dharmo yas tathāgatenānuttarā samyaksaṃbodhir abhisaṃbuddhaḥ	རབ་འབྱོར་། དེ་བཞིན་གཤེགས་པས་གང་བླ་ན་མེད་པ་ཡང་དག་པར་རྫོགས་པའི་བྱང་ཆུབ་མངོན་པར་རྫོགས་པར་སངས་རྒྱས་པའི་ཆོས་དེ་གང་ཡང་མེད་པའི་ཕྱིར་རོ་༎ རབ་འབྱོར་།
 yaḥ subhūte tathāgatena dharmo 'bhisaṃbuddhas tatra na satyaṃ na mṛṣāḥ tasmāt tathāgato bhāṣate |	དེ་བཞིན་གཤེགས་པས་ཆོས་གང་མངོན་པར་རྫོགས་པར་སངས་རྒྱས་པ་དེ་ལ་བདེན་པ་ཡང་མེད་། རྫུན་པ་ཡང་མེད་དེ་། དེ་བས་ན་། དེ་བཞིན་གཤེགས་པས་ཆོས་ཐམས་ཅད་སངས་རྒྱས་༄༢༢༩ཨ་༌༎ ཀྱི་ཆོས་སོ་༎ ཞེས་གསུངས་ངོ་༎ རབ་འབྱོར་།
 sarvadharmā 6| buddhadharmā iti |	ཆོས་ཐམས་ཅད་ཅེས་བྱ་བ་ནི་།
 sarvadharmā iti subhūte sarve te adharmās tenocyante sarvadharmā iti ||	དེ་དག་ཐམས་ཅད་ཆོས་མེད་པ་ཡིན་ཏེ་། དེ་བས་ན་། ཆོས་ཐམས་ཅད་སངས་རྒྱས་ཀྱི་ཆོས་ཞེས་བྱའོ་༎ རབ་འབྱོར་། འདི་ལྟ་སྟེ་།
 tadyathāpi nāma subhūte puruṣo bhaved upetakāyo mahākāyaḥ subhūtir āha | yo folio 8b (g 1385; chak 186|22-187|15; du 160|10-162|1; mm 37|16-39|2; cz 49|5-50|14; par 188|10-189|9; tib 254|4|4-255|1|1)	དཔེར་ན་། མི་ཞིག་ལུས་དང་ལྡན་ཞིང་ལུས་ཆེན་པོར་གྱུར་པ་བཞིན་ནོ་༎ ཚེ་དང་ལྡན་པ་རབ་འབྱོར་གྱིས་གསོལ་པ༏་བཅོམ་ལྡན་འདས་།
 1| 'sau tathāgatena puruṣo bhāṣita upetakāyo mahākāyaḥ akāyaḥ sa bhagavaṃs tathāgatena bhāṣitas tenocyate upetakāyo mahākāyaḥ bhagavān āha |	དེ་བཞིན་གཤེགས་པས་མི་ཞིག་ལུས་དང་ལྡན་ཞིང་ལུས་ཆེན་པོ་ཞེས་གང་གསུངས་པ་དེ་། དེ་བཞིན་གཤེགས་པས་ལུས་མ་མཆིས་པར་གསུངས་ཏེ་། དེས་ན་། ལུས་དང་ལྡན་ཞིང་ལུས་ཆེན་པོ་ཞེས་བགྱིའོ་༎ བཅོམ་ལྡན་འདས་ཀྱིས་བཀའ་སྩལ་པ་།
 evam etat subhūte	རབ་འབྱོར་། དེ་དེ་བཞིན་ཏེ་།
 2| yo bodhisatva evaṃ vaded ahaṃ satvān parinirvāpayiṣyāmīti |	བྱང་ཆུབ་སེམས་དཔའ་གང་འདི་སྐད་དུ་། བདག་གིས་སེམས་ཅན་རྣམས་ཡོངས་སུ་མྱ་ངན་ལས་བཟླའོ་༎ ཞེས་ཟེར་ན་། དེ་བྱང་ཆུབ་སེམས་དཔའ་ཞེས་མི་བྱའོ་༎ དེ་ཅིའི་ཕྱིར་ཞེ་ན་།
 na sa bodhisatva iti vaktavyaḥ tat kasya hetoḥ asti subhūte sa kaścid dharmo yo bodhisatvo nāma | āha |	རབ་འབྱོར་། གང་བྱང་ཆུབ་སེམས་དཔའ་ཞེས་བྱ་བའི་ཆོས་དེ་གང་ཡང་ཡོད་དམ་། རབ་འབྱོར་གྱིས་གསོལ་པ་།
 no hīdaṃ bhagavan	བཅོམ་ལྡན་འདས་། དེ་ནི་། མ་མཆིས་ལགས་སོ་༎
 3| bhagavān āha |	བཅོམ་ལྡན་འདས་ཀྱིས་བཀའ་སྩལ་པ་། རབ་འབྱོར་། དེ་བས་ན་། དེ་བཞིན་གཤེགས་པས་ཆོས་ཐམས་ཅད་ནི་། སེམས་ཅན་མེད་པ་། སྲོག་མེད་པ་། གང་ཟག་མེད་པའོ་༎ ཞེས་གསུང་ངོ་༎
 tasmāt tathāgato bhāṣate niḥsatvāḥ sarvadharmāḥ nirjīvā niṣpudgalāḥ yaḥ subhūte bodhisatva evaṃ vaded ahaṃ kṣetravyūhān niṣpādayiṣyāmīti |	རབ་༄༢༢༩བ་འབྱོར༏་བྱང་ཆུབ་སེམས་དཔའ་གང་ཞིག་འདི་སྐད་དུ་། བདག་གིས་ཞིང་བཀོད་པ་རྣམས་བསྒྲུབ་བོ་༎ ཞེས་ཟེར་ན་།
 so 'pi tathaiva	དེ་ཡང་དེ་བཞིན་དུ་བརྗོད་པར་བྱའོ་༎ དེ་ཅིའི་ཕྱིར་ཞེ་ན་།
 4| vaktavyaḥ tat kasya hetoḥ kṣetravyūhāḥ kṣetravyūhā iti subhūte avyūhās te tathāgatena bhāṣitās tenocyante kṣetravyūhā iti |	རབ་འབྱོར་ཞིང་བཀོད་པ་རྣམས་ཞིང་བཀོད་པ་རྣམས་ཞེས་བྱ་བ་དེ་ནི་། དེ་དག་བཀོད་པ་མེད་པར་དེ་བཞིན་གཤེགས་པས་གསུངས་པའི་ཕྱིར་ཏེ་། དེས་ན་ཞིང་བཀོད་པ་རྣམས་ཞེས་བྱའོ་༎
 yaḥ subhūte bodhisatvo nirātmāno dharmā nirātmāno	རབ་འབྱོར༏་བྱང་ཆུབ་སེམས་དཔའ་གང་ཞིག་ཆོས་རྣམས་ནི་། བདག་མེད་པའོ་༎ ཆོས་རྣམས་ནི་། བདག་མེད་པའོ་༎
 5| dharmā ity adhimucyate sa tathāgatenārhatā samyaksaṃbuddhena bodhisatvo bodhisatva ity ākhyātas tat kiṃ manyase subhūte saṃvidyate tathāgatasya māṃsacakṣuḥ āha |	ཞེས་མོས་པ་དེ་ནི་། དེ་བཞིན་གཤེགས་པ་དགྲ་བཅོམ་པ་ཡང་དག་པར་རྫོགས་པའི་སངས་རྒྱས་ཀྱིས་བྱང་ཆུབ་སེམས་དཔའ་བྱང་ཆུབ་སེམས་དཔའོ་༎ ཞེས་བརྗོད་དོ་༎ རབ་འབྱོར་། འདི་ཇི་སྙམ་དུ་སེམས་། དེ་བཞིན་གཤེགས་པ་ལ་ཤའི་སྤྱན་མངའམ་། རབ་འབྱོར་གྱིས་གསོལ་པ་།
 evam etad bhagavan	བཅོམ་ལྡན་འདས་། དེ་དེ་ལྟ་ལགས་ཏེ་།
 6| saṃvidyate tathāgatasya māṃsacakṣuḥ ||	དེ་བཞིན་གཤེགས་པ་ལ་ཤའི་སྤྱན་མངའོ་༎ བཅོམ་ལྡན་འདས་ཀྱིས་བཀའ་སྩལ་པ་། རབ་འབྱོར་། འདི་ཇི་སྙམ་དུ་སེམས་། དེ་བཞིན་གཤེགས་པ་ལ་ལྷའི་སྤྱན་མངའམ་། རབ་འབྱོར་གྱིས་གསོལ་པ་། བཅོམ་ལྡན་འདས་། དེ་དེ་ལྟ་ལགས་ཏེ་། དེ་བཞིན་གཤེགས་པ་ལ་ལྷའི་སྤྱན་མངའོ་༎
 bhagavān āha |	བཅོམ་ལྡན་འདས་ཀྱིས་བཀའ་སྩལ་པ་། རབ་འབྱོར་།
 tat kiṃ manyase subhūte saṃvidyate tathāgatasya divyaṃ cakṣuḥ prajñācakṣur dharmacakṣur buddhacakṣuḥ āhaivam etad bhagavan saṃvidyate tathāgatasya folio 9a (g 1386; chak 187|14-188|7; du 162|1-163|5; mm 39|2-40|8; cz 50|14-52|14; par 189|10-190|7; tib 255|1|1-2|1)	འདི་ཇི་སྙམ་དུ་སེམས་། དེ་བཞིན་གཤེགས་པ་ལ་ཤེས་རབ་ཀྱི་སྤྱན་མངའམ་། རབ་འབྱོར་། ༄༢༣༠ཨ་༌༎ གྱིས་གསོལ་པ་། བཅོམ་ལྡན་འདས་། དེ་དེ་ལྟ་ལགས་ཏེ་། དེ་བཞིན་གཤེགས་པ་ལ་ཤེས་རབ་ཀྱི་སྤྱན་མངའོ་༎ བཅོམ་ལྡན་འདས་ཀྱིས་བཀའ་སྩལ་པ་། རབ་འབྱོར་། འདི་ཇི་སྙམ་དུ་སེམས་། དེ་བཞིན་གཤེགས་པ་ལ་ཆོས་ཀྱི་སྤྱན་མ་ངའམ་། རབ་འབྱོར་གྱིས་གསོལ་པ་། བཅོམ་ལྡན་འདས་། དེ་དེ་ལྟ་ལགས་ཏེ་།
 1| divyaṃ cakṣuḥ prajñācakṣur dharmacakṣur buddhacakṣuḥ ||	དེ་བཞིན་གཤེགས་པ་ལ་ཆོས་ཀྱི་སྤྱན་མངའོ་༎ བཅོམ་ལྡན་འདས་ཀྱིས་བཀའ་སྩལ་པ་། རབ་འབྱོར་། འདི་ཇི་སྙམ་དུ་སེམས་། དེ་བཞིན་གཤེགས་པ་ལ་སངས་རྒྱས་ཀྱི་སྤྱན་མངའམ་། རབ་འབྱོར་གྱིས་གསོལ་པ་། བཅོམ་ལྡན་འདས་། དེ་དེ་ལྟ་ལགས་ཏེ་། དེ་བཞིན་གཤེགས་པ་ལ་སངས་རྒྱས་ཀྱི་སྤྱན་མངའོ་༎
 bhagavān āha |	བཅོམ་ལྡན་འདས་ཀྱིས་བཀའ་སྩལ་པ་། རབ་འབྱོར་།
 tat kiṃ manyase subhūte yāvantyo gaṃgānadyāṃ vālukās tāvantya gaṃgānadyo bhaveyus tāsu yā vālukās tāvanta eva lokadhātavo	འདི་ཇི་སྙམ་དུ་སེམས་། གངགའའི་ཀླུང་གི་བྱེ་མ་ཇི་སྙེད་པ་གངགའའི་ཀླུང་ཡང་དེ་སྙེད་དུ་གྱུར་ལ་། དེ་དག་གི་བྱེ་མ་ཇི་སྙེད་པ་དེ་སྙེད་ཀྱི་འཇིག་རྟེན་གྱི་ཁམས་སུ་གྱུར་ན་།
 2| bhaveyuḥ kaccid bahavas te lokadhātavo bhaveyuḥ bhagavān āha |	འཇིག་རྟེན་གྱི་ཁམས་དེ་དག་ཅི་མང་བ་ཡིན་ནམ་། རབ་འབྱོར་གྱིས་གསོལ་པ་། བཅོམ་ལྡན་འདས་། དེ་དེ་ལྟ་ལགས་ཏེ་། འཇིག་རྟེན་གྱི་ཁམས་དེ་དག་མང་བ་ལགས་སོ་༎ བཅོམ་ལྡན་འདས་ཀྱིས་བཀའ་སྩལ་པ་།
 yāvantaḥ subhūte teṣu lokadhātuṣu satvās teṣām ahaṃ nānābhāvāṃ cittadhārāṃ jānīyās tat kasya hetoś	རབ་འབྱོར་། འཇིག་རྟེན་གྱི་ཁམས་དེ་དག་ན་སེམས་ཅན་ཇི་སྙེད་ཡོད་པ་དེ་དག་གི་བསམ་པ་ཐ་༄༢༣༠བ་དད་པའི་སེམས་ཀྱི་རྒྱུན་ངས་རབ་ཏུ་ཤེས་སོ་༎ དེ་ཅིའི་ཕྱིར་ཞེ་ན་། རབ་འབྱོར་། སེམས་ཀྱི་རྒྱུན་ཞེས་བྱ་བ་ནི་། དེ་རྒྱུན་མེད་པར་དེ་བཞིན་གཤེགས་པས་གསུངས་པའི་ཕྱིར་ཏེ་།
 3| cittadhārā cittadhārā iti subhūte adhārās tās tathāgatena bhāṣitās tenocyante cittadhārā iti |	དེས་ན༏་སེམས་ཀྱི་རྒྱུན་ཞེས་བྱའོ་༎
 tat kasya hetor atītaṃ subhūte cittaṃ nopalabhyate |	དེ་ཅིའི་ཕྱིར་ཞེ་ན་། རབ་འབྱོར་། འདས་པའི་སེམས་ཀྱང་དམིགས་སུ་མེད་།
 anāgataṃ cittaṃ nopalabhyate	མ་འོངས་པའི་སེམས་ཀྱང་དམིགས་སུ་མེད་།
 4| | pratyutpannaṃ nopalabhyate |	ད་ལྟར་བྱུང་བའི་སེམས་ཀྱང་དམིགས་སུ་མེད་པའི་ཕྱིར་རོ་༎ རབ་འབྱོར་།
 tat kiṃ manyase subhūte ya imaṃ trisāhasramahāsāhasraṃ lokadhātuṃ saptaratnaparipūrṇaṃ kṛtvā dānaṃ dadyād api nu sa kulaputro vā kuladuhitā	འདི་ཇི་སྙམ་དུ་སེམས་། གང་གིས་སྟོང་གསུམ་གྱི་སྟོང་ཆེན་པོའི་འཇིག་རྟེན་གྱི་ཁམས་འདི་རིན་པོ་ཆེ་སྣ་བདུན་གྱིས་ཡོངས་སུ་གང་བར་བྱས་ཏེ་སྦྱིན་པ་བྱིན་ན་། རིགས་ཀྱི་བུའམ་། རིགས་ཀྱི་བུ་མོ་དེ་།
 5| vā tatonidānaṃ bahu puṇyaṃ prasaveta | āha |	གཞི་དེ་ལས་བསོད་ནམས་མང་དུ་བསྐྱེད་དམ་། རབ་འབྱོར་གྱིས་གསོལ་པ་། བཅོམ་ལྡན་འདས་།
 bahu bhagavan bahu sugata |	མང་ལགས་སོ་༎ བདེ་བར་གཤེགས་པ་། མང་ལགས་སོ་༎
 bhagavān āha |	བཅོམ་ལྡན་འདས་ཀྱིས་བཀའ་སྩལ་པ་། རབ་འབྱོར་།
 evam etat subhūte evam etad bahu sa kulaputro vā kuladuhitā vā tatonidānaṃ	དེ་དེ་བཞིན་ནོ་༎ དེ་དེ་བཞིན་ཏེ་། རིགས་ཀྱི་བུའམ༏་རིགས་ཀྱི་བུ་མོ་དེ་།
 6| bahu puṇyaṃ prasaveta |	གཞི་དེ་ལས་བསོད་ནམས་ཀྱི་ཕུང་པོ་མང་དུ་བསྐྱེད་དོ་༎ རབ་འབྱོར་།
 sacet subhūte puṇyaskandho 'bhaviṣyan na tathāgato 'bhāṣiṣyat puṇyaskandhaḥ puṇyaskandha iti |	གལ་ཏེ་བསོད་ནམས་ཀྱི་ཕུང་པོ་བསོད་ནམས་ཀྱི་ཕུང་པོར་གྱུར་ན་། བསོད་ནམས་ཀྱི་ཕུང་པོ་བསོད་ནམས་ཀྱི་ཕུང་པོ་ཞེས་དེ་བཞིན་གཤེགས་པས་མི་གསུང་ངོ་༎ རབ་འབྱོར་།
 tat kiṃ manyase subhūte rūpakāyapariniṣpattyā tathāgato draṣṭavyaḥ folio 9b (g 1387; chak 188|8-189|21; du 163|5-164|9;	འདི་ཇི་སྙམ་དུ་སེམས་། གཟུགས་ཀྱི་སྐུ་ཡོངས་སུ་གྲུབ་པས་དེ་བཞིན་གཤེགས་༄༢༣༡ཨ་༌༎ པར་བལྟའམ་། རབ་འབྱོར་གྱིས་གསོལ་པ་། བཅོམ་ལྡན་འདས་།
 mm 40|8-41|9; cz 52|14-54|1; par 190|7-191|7; tib 255|2|1-3|3)	དེ་ནི་། མ་ལགས་ཏེ་།
 1| āha | no bhagavan na rūpakāyapariniṣpattyā tathāgato draṣṭavyaḥ tat kasya hetoḥ rūpakāyapariniṣpattī rūpakāyapariniṣpattir ity apariniṣpattir eṣā tathāgatena	གཟུགས་ཀྱི་སྐུ་ཡོངས་སུ་གྲུབ་པས་དེ་བཞིན་གཤེགས་པར་མི་བལྟའོ་༎ དེ་ཅིའི་སླད་དུ་ཞེ་ན་། བཅོམ་ལྡན་འདས་། གཟུགས་ཀྱི་སྐུ་ཡོངས་སུ་གྲུབ་པ་། གཟུགས་ཀྱི་སྐུ་ཡོངས་སུ་རྫོགས་པ་ཞེས་བགྱི་བ་ནི་། དེ་ཡོངས་སུ་གྲུབ་པ་མ་མཆིས་པར་དེ་བཞིན་གཤེགས་པས་གསུངས་པའི་སླད་དུ་སྟེ་།
 2| bhāṣitā tenocyate rūpakāyapariniṣpattir iti |	དེས་ན་། གཟུགས་ཀྱི་སྐུ་ཡོངས་སུ་གྲུབ་པ་ཞེས་བགྱིའོ་༎
 bhagavan āha |	བཅོམ་ལྡན་འདས་ཀྱིས་བཀའ་སྩལ་པ༏་རབ་འབྱོར་།
 tat kiṃ manyase subhūte lakṣaṇasaṃpadā tathāgato draṣṭavyaḥ āha |	འདི་ཇི་སྙམ་དུ་སེམས་། མཚན་ཕུན་སུམ་ཚོགས་པས་། དེ་བཞིན་གཤེགས་པར་བལྟའམ་། རབ་འབྱོར་གྱིས་གསོལ་པ་། བཅོམ་ལྡན་འདས་།
 no bhagavan na lakṣaṇasaṃpadā tathāgato	དེ་ནི༏་མ་ལགས་ཏེ་། མཚན་ཕུན་སུམ་ཚོགས་པས་དེ་བཞིན་གཤེགས་པར་མི་བལྟའོ་༎ དེ་ཅིའི་སླད་དུ་ཞེ་ན་།
 3| draṣṭavyaḥ tat kasya hetoḥ yaiṣā lakṣaṇasaṃpat tathāgatena bhāṣitā alakṣaṇasaṃpad eṣā tathāgatena bhāṣitā tenocyate lakṣaṇasaṃpad iti |	དེ་བཞིན་གཤེགས་པས་མཚན་ཕུན་སུམ་ཚོགས་པར་གང་གསུངས་པ་དེ་། མཚན་ཕུན་སུམ་ཚོགས་པ་མ་མཆིས་པར་དེ་བཞིན་གཤེགས་པས་གསུངས་པའི་སླད་དུ་སྟེ་། དེས་ན་། མཚན་ཕུན་སུམ་ཚོགས་པ་ཞེས་བགྱིའོ་༎
 bhagavān āha |	བཅོམ་ལྡན་འདས་ཀྱིས་བཀའ་སྩལ་པ་། རབ་འབྱོར་།
 tat kiṃ manyase	འདི་ཇི་སྙམ་དུ་སེམས་།
 4| subhūte api nu tathāgatasyaivaṃ bhavati na mayā dharmo deśita iti |	དེ་བཞིན་གཤེགས་པ་འདི་སྙམ་དུ་། ངས་ཆོས་བསྟན་ཏོ་ཞེས་དགོངས་སོ་༎ སྙམ་ན་། ༄༢༣༡བ་རབ་འབྱོར་། དེ་ལྟར་མི་བལྟ་སྟེ་། དེ་བཞིན་གཤེགས་པས་གང་བསྟན་པའི་ཆོས་དེ་གང་ཡང་མེད་དོ་༎
 yaḥ subhūte evaṃ vadet tathāgatena dharmo deśita iti |	རབ་འབྱོར་། སུ་ཞིག་འདི་སྐད་དུ་། དེ་བཞིན་གཤེགས་པས་ཆོས་བསྟན་ཏོ༏་༏ཞེས་ཟེར་ན་། རབ་འབྱོར་། དེ་ནི་།
 abhyācakṣīta māṃsa subhūte asatād udgṛhītena	མེད་པ་དང་། ལོག་པར་ཟིན་པས་ང་ལ་སྐུར་བར་འགྱུར་རོ་༎ དེ་ཅིའི་ཕྱིར་ཞེ་ན་།
 5| | tat kasya hetor dharmadeśanā dharmadeśaneti subhūte nāsti sa kaścid dharmo yo dharmadeśanā nāmopalabhyate |	རབ་འབྱོར་། ཆོས་བསྟན་པ་ཞེས་བྱ་བ་དམིགས་པར་འགྱུར་བའི་ཆོས་བསྟན་པ་ཆོས་བསྟན་པ་ཞེས་བྱ་བ་དེ་། གང་ཡང་མེད་པའི་ཕྱིར་རོ་༎ དེ་ནས་བཅོམ་ལྡན་འདས་ལ་ཚེ་དང་ལྡན་པ་རབ་འབྱོར་གྱིས་འདི་སྐད་གསོལ་ཏོ་༎ བཅོམ་ལྡན་འདས་།
 āhāsti bhagavan kecit satvā bhaviṣyanty anāgate 'dhvani ya imān 6| evaṃrūpān dharmān bhāṣyamāṇāṃ cchrutvābhiśraddadhāsyanti |	མ་འོངས་པའི་དུས་ན་སེམས་ཅན་གང་དག་འདི་ལྟ་བུའི་ཆོས་བསྟན་པ་འདི་ཐོས་ནས་མངོན་པར་ཡིད་ཆེས་པར་འགྱུར་བ་མཆིས་སམ་།
 bhagavān āha |	བཅོམ་ལྡན་འདས་ཀྱིས་བཀའ་སྩལ་པ༏་རབ་འབྱོར་། དེ་དག་ནི་། སེམས་ཅན་ཡང་མ་ཡིན་། སེམས་ཅན་མེད་པ་ཡང་མ་ཡིན་ནོ་༎ དེ་ཅིའི་ཕྱིར་ཞེ་ན་།
 na te subhūte satvā nāsatvās tat kasya hetoḥ sarvasatvā iti subhūte asatvās te tathāgatena bhāṣitās tenocyante folio 10a (g 1388; chak 188|30-189|21; du 164|9-165|12;	རབ་འབྱོར་། སེམས་ཅན་རྣམས་ཞེས་བྱ་བ་ནི་། དེ་བཞིན་གཤེགས་པས་དེ་དག་སེམས་ཅན་མེད་པར་གསུངས་པའི་ཕྱིར་ཏེ་།
 mm 41|9-42|7; cz 54|1-55|8; par 191|7-192|3; tib 255|3|3-4|3)	དེས་ན་།
 1| sarvasatvā iti |	སེམས་ཅན་རྣམས་ཞེས་བྱའོ་༎
 tat kiṃ manyase subhūte api tv asti sa kaścid dharmo yas tathāgatenānuttarā samyaksaṃbodhir abhisaṃbuddhaḥ āha |	རབ་འབྱོར་། འདི་ཇི་སྙམ་དུ་སེམས་། དེ་བཞིན་གཤེགས་པས་གང་བླ་ན་མེད་པ་ཡང་དག་པར་རྫོགས་པའི་བྱང་ཆུབ་མངོན་པར་རྫོགས་པར་སངས་རྒྱས་པའི་ཆོས་དེ་གང་ཡང་ཡོད་དམ་། ཚེ་དང་ལྡན་པ་རབ་འབྱོར་གྱིས་གསོལ་པ་།
 nāsti sa bhagavan kaścid dharmo yas tathāgatenānuttarā 2| samyaksaṃbodhir abhisaṃbuddhaḥ bhagavān āha |	༄༢༣༢ཨ་༌༎ བཅོམ་ལྡན་འདས་། དེ་བཞིན་གཤེགས་པས་གང་བླ་ན་མེད་པ་ཡང་དག་པར་རྫོགས་པའི་བྱང་ཆུབ་མངོན་པར་རྫོགས་པར་སངས་རྒྱས་པའི་ཆོས་དེ་གང་ཡང་མ་མཆིས་ལགས་སོ་༎ བཅོམ་ལྡན་འདས་ཀྱིས་བཀའ་སྩལ་པ་།
 evam etat subhūte evam etat aṇur api tatra dharmo na saṃvidyate nopalabhyate tenocyate 'nuttarā samyaksaṃbodhir iti | api	རབ་འབྱོར་། དེ་དེ་བཞིན་ནོ་༎ དེ་དེ་བཞིན་ཏེ་།
 3| tu khalu punaḥ subhūte samaḥ sa dharmo na tatra kiṃcid viṣamas tenocyate 'nuttarā samyaksaṃbodhir iti |	དེ་ཆོས་ཅུང་ཟད་ཀྱང་མེད་ཅིང་མི་དམིགས་ཏེ་། དེས་ན་། བླ་ན་མེད་པ་ཡང་དག་པར་རྫོགས་པའི་བྱང་ཆུབ་ཅེས་བྱའོ་༎ ཡང་རབ་འབྱོར་། ཆོས་དེ་ནི་། མཉམ་པ་སྟེ་། དེ་ལ་མི་མཉམ་པ་གང་ཡང་མེད་པས་དེས་ན་།
 nirjīvatvena niḥsatvatvena niṣpudgalatvena samā sānuttarā samyaksaṃbodhiḥ	བླ་ན་མེད་པ་ཡང་དག་པར་རྫོགས་པའི་བྱང་ཆུབ་ཅེས་བྱའོ་༎ བླ་ན་མེད་པ་ཡང་དག་པར་རྫོགས་པའི་བྱང་ཆུབ་དེ་ནི་། བདག་མེད་པ་དང་། སེམས་ཅན་མེད་པ་དང་། སྲོག་མེད་པ་དང་། གང་ཟག་མེད་པར་མཉམ་པ་སྟེ་།
 4| sarvaiḥ kuśalair dharmair abhisaṃbudhyate |	དགེ་བའི་ཆོས་ཐམས་ཅད་ཀྱིས་མངོན་པར་རྫོགས་པར་འཚང་རྒྱའོ་༎ རབ་འབྱོར་།
 kuśalā dharmāḥ kuśalā dharmā iti subhūte adharmāś caiva te tathāgatena bhāṣitās tenocyante kuśalā dharmā iti |	དགེ་བའི་ཆོས་རྣམས་དགེ་བའི་ཆོས་རྣམས་ཞེས་བྱ་བ་ནི་། དེ་དག་དེ་བཞིན་གཤེགས་པས་ཆོས་མེད་པ་ཉིད་དུ་གསུངས་ཏེ་། དེས་ན་དགེ་བའི་ཆོས་རྣམས་ཞེས་བྱའོ་༎
 yaś ca khalu	ཡང་རབ་འབྱོར་། རིགས་ཀྱི་བུའམ་།
 5| punaḥ subhūte yāvantas trisāhasramahāsāhasre lokadhātau sumeravaḥ parvatarājās tāvato rāśīn saptānāṃ ratnānām abhisaṃhṛtya dānaṃ dadyād yaś cetaḥ prajñāpāramitāyā	རིགས་ཀྱི་བུ་མོ་གང་ལ་ལ་ཞིག་གིས་སྟོང་གསུམ་གྱི་སྟོང་ཆེན་པོའི་འཇིག་རྟེན་གྱི་ཁམས་ན་རིའི་རྒྱལ་པོ་རི་རབ་གང་དག་ཇི་སྙེད་༄༢༣༢བ་ཡོད་པ་དེ་ཙམ་གྱི་རིན་པོ་ཆེ་སྣ་བདུན་གྱི་ཕུང་པོ་མངོན་པར་བསྡུས་ཏེ་སྦྱིན་པ་བྱིན་པ་བས་། གང་གིས་ཤེས་རབ་ཀྱི་ཕ་རོལ་ཏུ་ཕྱིན་པ་འདི་ལས་ཐ་ན་ཚིག་བཞི་པའི་ཚིགས་སུ་བཅད་པ་ཙམ་བཟུང་ནས་གཞན་དག་ལ་པ་བས་། ཡང་བསྟན་ན་། 
 6| antaśaś catuṣpadikām api gāthām udgṛhya parebhyo deśayed asya subhūte puṇyaskandhasyāsau pūrvakaḥ puṇyaskandhaḥ śatatamīm api kalān nopaiti yāvad upaniśām folio 10b (g 1389; chak 189|21-190|11; du 165|12-166|14; mm 42|7-43|7; cz 55|8-56|20; par 192|3-192|21; tib 255|4|3-5|4) 1| api na kṣamate |	རབ་འབྱོར་། བསོད་ནམས་ཀྱི་ཕུང་པོ་འདི་ལ་བསོད་ནམས་ཀྱི་ཕུང་པོ་སྔ་མ་དེས་བརྒྱའི་ཆར་ཡང་མི་ཕོད་པ་ནས་རྒྱུའི་བར་དུ་ཡང་ཉེ་བར་མི་བཟོད་དོ་༎ 
 tat kiṃ manyase subhūte api nu tathāgatasyaivaṃ bhavati |	རབ་འབྱོར་། འདི་ཇི་སྙམ་དུ་སེམས་། དེ་བཞིན་གཤེགས་པ་འདི་སྙམ་དུ་།
 mayā satvā mocitā iti |	ངས་སེམས་ཅན་རྣམས་དཀྲོལ་ལོ་ཞེས་དགོངས་སོ་༎ སྙམ་ན་།
 na khalu punaḥ subhūte-r-evaṃ draṣṭavyaṃ |	རབ་འབྱོར་། དེ་དེ་ལྟར་མི་བལྟའོ་༎
 tat kasya hetoḥ na sa kaścit satvo	དེ་ཅིའི་ཕྱིར་ཞེ་ན་། རབ་འབྱོར་། དེ་བཞིན་གཤེགས་པས་གང་བཀྲོལ་བའི་སེམས་ཅན་དེ་དག་གང་ཡང་མེད་པའི་ཕྱིར་རོ་༎ རབ་འབྱོར་།
 2| yas tathāgatena mocitaḥ yadi punaḥ subhūte kaścit satvo 'bhaviṣyad yas tathāgatena mocitaḥ sa eva tasyātmagrāho 'bhaviṣyat satvagrāho jīvagrāhaḥ	གལ་ཏེ་དེ་བཞིན་གཤེགས་པས་སེམས་ཅན་གང་ལ་ལ་ཞིག་བཀྲོལ་བར་གྱུར་ན་། དེ་ཉིད་དེ་བཞིན་གཤེགས་པའི་བདག་ཏུ་འཛིན་པར་འགྱུར་། སེམས་ཅན་དུ་འཛིན་པ་དང་། སྲོག་ཏུ་འཛིན་པ་དང་། གང་ཟག་ཏུ་འཛིན་པར་འགྱུར་རོ་༎ རབ་འབྱོར་།
 3| ātmagrāha iti subhūte agrāha eṣa tathāgatena bhāṣitaḥ sa ca bālapṛthagjanair udgṛhītaḥ bālapṛthagjanā iti subhūte ajanā ete tathāgatena	བདག་ཏུ་འཛིན་ཅེས་བྱ་བ་ནི་། དེ་འཛིན་པ་མེད་པར་དེ་བཞིན་གཤེགས་པས་གསུངས་ན་། དེ་ཡང་བྱིས་པ་སོ་སོའི་སྐྱེ་བོ་རྣམས་ཀྱིས་བཟུང་ངོ་༎ རབ་འབྱོར་། བྱིས་པ་སོ་སོའི་སྐྱེ་བོ་རྣམས་ཞེས་བྱ་བ་ནི་། དེ་དག་སྐྱེ་བོ་མེད་པ་ཉིད་དུ་དེ་བཞིན་གཤེགས་པས་གསུངས་༄༢༣༣ཨ་༌༎
 4| bhāṣitās tenocyaṃte bālapṛthagjanā iti |	ཏེ༏་དེས་ན་། བྱིས་པ་སོ་སོའི་སྐྱེ་བོ་རྣམས་ཞེས་བྱའོ་༎ རབ་འབྱོར་།
 tat kiṃ manyase subhūte lakṣaṇasaṃpadā tathāgato draṣṭavyaḥ āhaivam etad bhagaval lakṣaṇasaṃpadā tathāgato draṣṭavyaḥ	འདི་ཇི་སྙམ་དུ་སེམས་། མཚན་ཕུན་སུམ་ཚོགས་པས་དེ་བཞིན་གཤེགས་པར་བལྟའམ་། རབ་འབྱོར་གྱིས་གསོལ་པ་། བཅོམ་ལྡན་འདས་། དེ་ནི་། མ་ལགས་ཏེ་། མཚན་ཕུན་སུམ་ཚོགས་པས་དེ་བཞིན་གཤེགས་པར་མི་བལྟའོ་༎
 5| bhagavān āha |	བཅོམ་ལྡན་འདས་ཀྱིས་བཀའ་སྩལ་པ་། རབ་འབྱོར་། དེ་དེ་བཞིན་ཏེ་། མཚན་ཕུན་སུམ་ཚོགས་པས་དེ་བཞིན་གཤེགས་པར་མི་བལྟའོ་༎
 sacet punaḥ subhūte lakṣaṇasaṃpadā tathāgato draṣṭavyo 'bhaviṣyad rājāpi cakravartī tathāgato 'bhaviṣyat* āha |	རབ་འབྱོར་། གལ་ཏེ་མཚན་ཕུན་སུམ་ཚོགས་པས་དེ་བཞིན་གཤེགས་པར་བལྟ་བར་གྱུར་ན་། འཁོར་ལོས་བསྒྱུར་བའི་རྒྱལ་པོ་ཡང་དེ་བཞིན་གཤེགས་པར་འགྱུར་ཏེ་། དེ་བས་ན་། མཚན་ཕུན་སུམ་ཚོགས་པས་དེ་བཞིན་གཤེགས་པར་མི་བལྟའོ་༎ དེ་ནས་བཅོམ་ལྡན་འདས་ལ་ཚེ་དང་ལྡན་པ་རབ་འབྱོར་གྱིས་འདི་སྐད་ཅེས་གསོལ་ཏོ་༎
 yathāhaṃ bhagavato bhāṣitasyārtham ājānāmi	བཅོམ་ལྡན་འདས་ཀྱིས་གསུངས་པའི་དོན་བདག་གིས་འཚལ་བ་ལྟར་ན་།
 6| | na lakṣaṇasaṃpadā tathāgato draṣṭavyaḥ ||	མཚན་ཕུན་སུམ་ཚོགས་པས་དེ་བཞིན་གཤེགས་པར་མི་བལྟའོ་༎
 atha khalu bhagavāṃs tasyāṃ velāyām imā gāthā abhāṣataḥ ||	དེ་ནས་བཅོམ་ལྡན་འདས་ཀྱིས་དེའི་ཚེ་ཚིགས་སུ་བཅད་པ་འདི་དག་བཀའ་སྩལ་ཏོ་༎ གང་དག་ང་ལ་གཟུགས་སུ་མཐོང་༎
 ye māṃ rūpeṇa adrākṣur ye māṃ ghoṣeṇa anvayuḥ mithyāprahāṇaprasṛtā folio 11a (g 1390; chak 190|12-191|4; du 166|14-168|3; mm 43|7-44|6; cz 56|20-59|1; par 192|21-193|13; tib 255|5|4-256|1|4)	གང་དག་ང་ལ་སྒྲར་ཤེས་པ་༎ ལོག་པར་སྤོང་བས་ཞུགས་པ་སྟེ་༎ སྐྱེ་བོ་དེ་དག་ང་མི་མཐོང་༎ ༄༢༣༣བ་སངས་རྒྱས་རྣམས་ནི་ཆོས་ཉིད་བལྟ་༎
 1| na māṃ drakṣyanti te janāḥ draṣṭavyo dharmato buddho dharmakāyas tathāgataḥ dharmatā cāpy avijñeyā na sā śakyaṃ vijānituṃ ||	འདྲེན་པ་རྣམས་ནི་ཆོས་ཀྱི་སྐུ་༎ ཆོས་ཉིད་ཤེས་པར་བྱ་མིན་པས་༎ དེ་ནི་རྣམ་པར་ཤེས་མི་ནུས་༎
 tat kiṃ manyase subhūte lakṣaṇasaṃpadā tathāgatenānuttarā	རབ་འབྱོར་། འདི་ཇི་སྙམ་དུ་སེམས་། མཚན་ཕུན་སུམ་ཚོགས་པས་དེ་བཞིན་གཤེགས་པ་དགྲ་བཅོམ་པ་ཡང་དག་པར་རྫོགས་པའི་སངས་རྒྱས་སོ་༎ སྙམ་དུ་འཛིན་ན་། རབ་འབྱོར་། ཁྱོད་ཀྱིས་དེ་ལྟར་མི་བལྟ་སྟེ་།
 2| samyaksaṃbodhir abhisaṃbuddhāḥ na khalu punaḥ subhūte evaṃ draṣṭavyaṃ na subhūte lakṣaṇasaṃpadā tathāgatenānuttarā samyaksaṃbodhir abhisaṃbuddhā| yat khalu punaḥ	རབ་འབྱོར༏་མཚན་ཕུན་སུམ་ཚོགས་པས་དེ་བཞིན་གཤེགས་པ་དགྲ་བཅོམ་པ་ཡང་དག་པར་རྫོགས་པའི་སངས་རྒྱས་ཀྱིས་བླ་ན་མེད་པ་ཡང་དག་པར་རྫོགས་པའི་བྱང་ཆུབ་མངོན་པར་རྫོགས་པར་སངས་རྒྱས་པ་མེད་དོ་༎ རབ་འབྱོར་། འདི་སྙམ་དུ་།
 3| subhūte syād evaṃ bodhisatvayānasaṃprasthitaiḥ kasyacid dharmasya vināśaḥ prajñapta ucchedo vā na khalu punaḥ subhūte evaṃ draṣṭavyaṃ |	བྱང་ཆུབ་སེམས་དཔའི་ཐེག་པ་ལ་ཡང་དག་པར་ཞུགས་པ་རྣམས་ཀྱིས་ཆོས་ལ་ལ་ཞིག་རྣམ་པར་བཤིག་གམ་། ཆད་པར་བཏགས་པ་སྙམ་དུ་འཛིན་ན་། རབ་འབྱོར་། དེ་ལྟར་མི་བལྟ་སྟེ་།
 na bodhisatvayānasaṃprasthitaiḥ kasyacid	བྱང་ཆུབ་སེམས་དཔའི་ཐེག་པ་ལ་ཡང་དག་པར་ཞུགས་པ་རྣམས་ཀྱིས་ཆོས་གང་ཡང་རྣམ་པར་བཤིག་པའམ་། ཆད་པར་བཏགས་པ་མེད་དོ་༎
 4| dharmasya vināśaḥ prajñapto nocchedaḥ yaś ca khalu punaḥ subhūte kulaputro vā kuladuhitā vā gaṃgānadīvālukopamāl lokadhātūn saptaratnapratipūrṇān kṛtvā tathāgatebhyo	ཡང་རབ་འབྱོར་། རིགས་ཀྱི་བུའམ་། རིགས་ཀྱི་བུ་མོ་གང་གིས་འཇིག་རྟེན་གྱི་ཁམས་གངགའའི་བྱེ་མ་སྙེད་དག་རིན་པོ་ཆེ་སྣ་བདུན་གྱིས་རབ་ཏུ་གང་བར་བྱས་ཏེ་སྦྱིན་པར་བྱིན་པ་བས་། 
 5| 'rhadbhyaḥ samyaksaṃbuddhebhyo dānaṃ dadyād yaś ca bodhisatvo nirātmakeṣu dharmeṣu kṣāntiṃ pratilabheta |	བྱང་ཆུབ་སེམས་དཔའ་གང་ཞིག་ཆོས་རྣམས་བདག་མེད་ཅིང་སྐྱེ་བ་མེད་པ་ལ་བཟོད་པ་བས་། 
 ayam eva tato bahutaraṃ puṇyaṃ prasaveta |	པ་ཐོབ་ན་། དེ་ཉིད་༄༢༣༤ཨ་༌༎ གཞི་དེ་ལས་བསོད་ནམས་ཀྱི་ཕུང་པོ་ཆེས་མང་དུ་བསྐྱེད་དོ་༎
 na khalu punaḥ subhūte bodhisatvena 6| puṇyaskandhaḥ parigrahītavyaḥ āha |	ཡང་རབ་འབྱོར་། བྱང་ཆུབ་སེམས་དཔས་བསོད་ནམས་ཀྱི་ཕུང་པོ་ཡོངས་སུ་གཟུང་བར་མི་བྱའོ་༎ ཚེ་དང་ལྡན་པ་རབ་འབྱོར་གྱིས་གསོལ་པ་། བཅོམ་ལྡན་འདས་།
 puṇyaskandho bhagavan parigrahītavyaḥ bhagavān āha |	བྱང་ཆུབ་སེམས་དཔས་བསོད་ནམས་ཀྱི་ཕུང་པོ་ཡོངས་སུ་གཟུང་བར་མི་བགྱི་ལགས་སམ་། བཅོམ་ལྡན་འདས་ཀྱིས་བཀའ་སྩལ་པ་། རབ་འབྱོར་།
 parigrahītavyaḥ subhūte nodgrahītavyaḥ tenocyate parigrahītavyaḥ folio 11b (g 1391; chak 191|5-26; du 168|3-169|4;	ཡོངས་སུ་གཟུང་མོད་ཀྱི་། ལོག་པར་མི་གཟུང་སྟེ་།
 mm 44|7-45,4; cz 54|1-60|7; par 193|13-194|5; tib 256|1|4-2|4)	དེས་ན་། ཡོངས་སུ་གཟུང་བ་ཞེས་བྱའོ་༎
 1| api tu khalu punaḥ subhūte yaḥ kaścid evaṃ vadet tathāgato gacchati vāgacchati vā |	རབ་འབྱོར་། གང་ལ་ལ་ཞིག་འདི་སྐད་དུ་། དེ་བཞིན་གཤེགས་པ་བཞུད་དམ་། བྱོན་ཏམ་།
 tiṣṭhati vā niṣīdati vā śayyāṃ vā kalpayati |	བཞེངས་སམ་། བཞུགས་སམ་། མནལ་བར་མཛད་དོ་༎ ཞེས་དེ་སྐད་ཟེར་ན་།
 na me sa bhāṣitasyārtham ājānāti | tat kasya hetoḥ	དེས་ན་ངས་བཤད་པའི་དོན་མི་ཤེས་སོ༏་༏དེ་ཅིའི་ཕྱིར་ཞེ་ན་། རབ་འབྱོར་། དེ་བཞིན་གཤེགས་པ་ཞེས་བྱ་བ་ནི་། གར་ཡང་མ་བཞུད་།
 2| tathāgata iti subhūte na kutaścid āgato na kvacid gataḥ tenocyate tathāgato 'rhan samyaksaṃbuddha iti |	གང་ནས་ཀྱང་མ་བྱོན་པའི་ཕྱིར་ཏེ་། དེས་ན་། དེ་བཞིན་གཤེགས་པ་དགྲ་བཅོམ་པ་ཡང་དག་པར་རྫོགས་པའི་སངས་རྒྱས་ཞེས་བྱའོ་༎
 yaś ca khalu punaḥ subhūte kulaputro vā kuladuhitā vā yāvantas trisāhasramahāsāhasre	ཡང་རབ་འབྱོར་། རིགས་ཀྱི་བུའམ་། རིགས་ཀྱི་བུ་མོ་གང་གིས་སྟོང་གསུམ་གྱི་སྟོང་ཆེན་པོའི་འཇིག་རྟེན་གྱི་ཁམས་ན་སའི་རྡུལ་རྣམས་ཇི་སྙེད་ཡོད་པ་དེ་དག་འདི་ལྟ་སྟེ་།
 3| lokadhātau pṛthivīrajāṃsi tāvato lokadhātūn maṣiṃ kuryāt tadyathāpi nāma paramāṇusaṃcayas tat kiṃ manyase subhūte bahu sa paramāṇusaṃcayo bhavet āhaivam	དཔེར་ན་། རྡུལ་ཕྲ་རབ་ཀྱི་ཚོགས་བཞིན་དུ་ཕྱེ་མར་བྱས་ན་། རབ་འབྱོར་། འདི་ཅི་སྙམ་དུ་སེམས་། རྡུལ་༄༢༣༤བ་ཕྲ་རབ་ཀྱི་ཚོགས་དེ་མང་བ་ཡིན་ནམ་། རབ་འབྱོར་གྱིས་གསོལ་པ་།
 4| etad bhagavan bahu sa paramāṇusaṃcayo bhavet tat kasya hetoḥ saced bhagavan saṃcayo 'bhaviṣyan na bhagavān avakṣyat paramāṇusaṃcaya iti |	བཅོམ་ལྡན་འདས་། དེ་དེ་ལྟར་ལགས་ཏེ་།
 tat kasya hetoḥ yo 'sau paramāṇusaṃcayo	རྡུལ་ཕྲ་རབ་ཀྱི་ཚོགས་དེ་མང་བ་ལགས་སོ་༎ དེ་ཅིའི་སླད་དུ་ཞེ་ན༏་བཅོམ་ལྡན་འདས་། གལ་ཏེ་ཚོགས་ཤིག་མཆིས་པར་གྱུར་ན་། བཅོམ་ལྡན་འདས་ཀྱིས་རྡུལ་ཕྲ་རབ་ཀྱི་ཚོགས་ཞེས་བཀའ་མི་སྩོལ་བའི་སླད་དུའོ་༎ དེ་ཅིའི་སླད་དུ་ཞེ་ན་།
 5| bhāṣitaḥ asaṃcayaḥ sa bhagavatā bhāṣitas tenocyate paramāṇusaṃcaya iti |	བཅོམ་ལྡན་འདས་ཀྱིས་རྡུལ་ཕྲ་རབ་ཀྱི་ཚོགས་ཞེས་གང་གསུངས་པ་དེ་ཚོགས་མ་མཆིས་པར་དེ་བཞིན་གཤེགས་པས་གསུངས་པའི་སླད་དུ་སྟེ་། དེས་ན་།
 yac ca tathāgato bhāṣati tṛsāhasramahāsāhasro lokadhātur iti | adhātuḥ sa tathāgatena	རྡུལ་ཕྲ་རབ་ཀྱི་ཚོགས་ཞེས་བགྱིའོ༏་༏དེ་བཞིན་གཤེགས་པས་སྟོང་གསུམ་གྱི་སྟོང་ཆེན་པོའི་འཇིག་རྟེན་གྱི་ཁམས་ཞེས་གང་གསུངས་པ་དེ་།
 6| bhāṣitas tenocyate trisāhasramahāsāhasro lokadhātur iti |	ཁམས་མ་མཆིས་པར་དེ་བཞིན་གཤེགས་པས་གསུངས་ཏེ༏་དེས་ན་། སྟོང་གསུམ་གྱི་སྟོང་ཆེན་པོའི་འཇིག་རྟེན་གྱི་ཁམས་ཞེས་བགྱིའོ་༎ དེ་ཅིའི་སླད་དུ་ཞེ་ན་།
 tat kasya hetoḥ saced bhagavan dhātur abhaviṣyat sa eva bhagavan piṇḍagrāho 'bhaviṣyad yaś caiva tathāgatena piṇḍagrāho folio 12a (g 1392; chak 191|27-192|15; du 169|4-170|7; mm 45|4-46|2; cz 6o|7-61|12; par 194|5-194|22; tib 256|2|4-3|4)	བཅོམ་ལྡན་འདས་། གལ་ཏེ་ཁམས་ཤིག་མཆིས་པར་གྱུར་ན་། དེ་ཉིད་རིལ་པོར་འཛིན་པར་འགྱུར་བའི་སླད་དུའོ་༎
 1| bhāṣitaḥ agrāhaḥ sa tathāgatena bhāṣitas tenocyate piṇḍagrāha iti |	དེ་བཞིན་གཤེགས་པས་རིལ་པོར་འཛིན་པར་གང་གསུངས་པ་དེ་། འཛིན་པ་མ་མཆིས་པར་དེ་བཞིན་གཤེགས་པས་གསུངས་ཏེ་། དེས་ན༏་རིལ་པོར་འཛིན་པ་ཞེས་བགྱིའོ་༎
 bhagavān āha |	བཅོམ་ལྡན་འདས་ཀྱིས་བཀའ་སྩལ་པ་། རབ་འབྱོར་། རིལ་པོར་འཛིན་པ་ཉིད་ནི་། ཐ་སྙད་དེ་།
 piṇḍagrāhaś caivāvyavahāro 'nabhilāpyaḥ subhūte sa dharmaḥsa bālapṛthagjanair	ཆོས་དེ་ནི་། བརྗོད་དུ་མེད་པ་ཡིན་ན་། ༄༢༣༥ཨ་༌༎ དེ་ཡང་བྱིས་པ་སོ་སོའི་སྐྱེ་བོ་རྣམས་ཀྱིས་བཟུང་ངོ་༎ རབ་འབྱོར་།
 2| udgṛhītaḥ tat kasya hetoḥ yaḥ kaścit subhūte evaṃ vaded ātmadṛṣṭis tathāgatena bhāṣitā satvadṛṣṭir jīvadṛṣṭiḥ pudgaladṛṣṭiḥ api nu subhūte sa samyag vadan vadet	གང་ལ་ལ་ཞིག་འདི་སྐད་དུ་། དེ་བཞིན་གཤེགས་པས་བདག་ཏུ་ལྟ་བར་གསུངས་ཤིང་། དེ་བཞིན་གཤེགས་པས་སེམས་ཅན་དུ་ལྟ་བ་དང་། སྲོག་ཏུ་ལྟ་བ་དང་། གང་ཟག་ཏུ་ལྟ་བར་གསུངས་སོ་༎ ཞེས་ཟེར་ན་། རབ་འབྱོར་། དེ་ཡང་ཡང་དག་པར་སྨྲ་བས་སྨྲ་བ་ཡིན་ནམ་། རབ་འབྱོར་གྱིས་གསོལ་པ་། བཅོམ་ལྡན་འདས་། དེ་ནི་། མ་ལགས་སོ་༎ བདེ་བར་གཤེགས་པ་། དེ་ནི་། མ་ལགས་སོ་༎ དེ་ཅིའི་སླད་དུ་ཞེ་ན་།
 3| āha | no bhagavaṃs tat kasya hetoḥ yā sā bhagavann ātmadṛṣṭis tathāgatena bhāṣitā adṛṣṭiḥ sā tathāgatena bhāṣitā tenocyate ātmadṛṣṭir iti	བཅོམ་ལྡན་འདས་། དེ་བཞིན་གཤེགས་པས་བདག་ཏུ་ལྟ་བར་གང་གསུངས་པ་དེ་། ལྟ་བ་མ་མཆིས་པར་དེ་བཞིན་གཤེགས་པས་གསུངས་པའི་སླད་དུ་སྟ་། དེས་ན་།
 bhagavān āha |	བདག་ཏུ་ལྟ་བ་ཞེས་བགྱིའོ༏་༏བཅོམ་ལྡན་འདས་ཀྱིས་བཀའ་སྩལ་པ་། རབ་འབྱོར་།
 4| evaṃ subhūte bodhisatvayānasaṃprasthitena sarvadharmā jñātavyā adhimoktavyās tathā cādhimoktavyā yathā na dharmasaṃjñāpi pratyupatiṣṭhet tat kasya hetoḥ dharmasaṃjñā	བྱང་ཆུབ་སེམས་དཔའི་ཐེག་པ་ལ་ཡང་དག་པར་ཞུགས་པ་རྣམས་ཀྱིས་འདི་ལྟར་ཆོས་ཐམས་ཅད་ཤེས་པར་བྱ༏་བལྟ་བར་བྱ་། མོས་པར་བྱ་སྟེ་། ཅི་ནས་ཆོས་སུ་འདུ་ཤེས་པ་ལ་ཡང་མི་གནས་པ་དེ་ལྟར་མོས་པར་བྱའོ་༎ དེ་ཅིའི་ཕྱིར་ཞེ་ན་།
 5| dharmasaṃjñeti subhūte asaṃjñaiṣā tathāgatena bhāṣitā tenocyate dharmasaṃjñeti |	རབ་འབྱོར་། ཆོས་སུ་འདུ་ཤེས་ཆོས་སུ་འདུ་ཤེས་ཞེས་བྱ་བ་ནི་། འདུ་ཤེས་མེད་པར་དེ་བཞིན་གཤེགས་པས་གསུངས་པའི་ཕྱིར་ཏེ་། དེས་ན་། ཆོས་སུ་འདུ་ཤེས་ཞེས་བྱའོ་༎
 yaś ca khalu punaḥ subhūte bodhisatvo mahāsatvaḥ aprameyāsaṃkhyeyāl lokadhātūn saptaratnaparipūrṇān	ཡང་རབ་འབྱོར་། བྱང་ཆུབ་༄༢༣༥བ་སེམས་དཔའ་སེམས་དཔའ་ཆེན་པོ་གང་གིས་འཇིག་རྟེན་གྱི་ཁམས་དཔག་ཏུ་མེད་ཅིང་གྲངས་མེད་པ་དག་རིན་པོ་ཆེ་སྣ་བདུན་གྱིས་རབ་ཏུ་གང་བར་བྱས་ཏེ་སྦྱིན་པ་བྱིན་པ་བས་། རིགས་ཀྱི་བུའམ་།
 6| kṛtvā dānaṃ dadyād yaś ca kulaputro vā kuladuhitā vā itaḥ prajñāpāramitāyā antaśaś catuṣpadikām api gāthām udgṛhya dhārayed deśayet paryavāpnuyād folio 12b (g 1393; chak 192|16-25; du 170|7-15; mm 46|2-11; cz 61|12-62|8; par 194|22-195|7; tib 256|3|4-3|8)	རིགས་ཀྱི་བུ་མོ་གང་གིས་ཤེས་རབ་ཀྱི་ཕ་རོལ་ཏུ་ཕྱིན་པ་འདི་ལས་ཐ་ན་ཚིག་བཞི་པའི་ཚིགས་སུ་བཅད་པ་ཙམ་བླངས་ནས་འཛིན་ཏམ་། ཀློག་གམ་། ཀུན་ཆུབ་པར་བྱེད་དམ་། གཞན་དག་ལ་ཡང་རྒྱ་ཆེར་ཡང་དག་པར་རབ་ཏུ་སྟོན་ན་།
 1| eva tato bahutaraṃ puṇyaṃ prasavetāprameyam asaṃkhyeyaṃ |	དེ་ཉིད་གཞི་དེ་ལས་བསོད་ནམས་མང་དུ་གྲངས་མེད་དཔག་ཏུ་མེད་པ་བསྐྱེད་དོ་༎ ཇི་ལྟར་ཡང་དག་པར་རབ་ཏུ་སྟོན་ཅེ་ན་།
 kaṭhaṃ ca saṃprakāśayed yathā na prakāśayet tenocyate saṃprakāśaye iti ||	ཇི་ལྟར་ཡང་དག་པར་རབ་ཏུ་མི་སྟོན་པ་དེ་བཞིན་དུ་སྟེ་། དེས་ན་། ཡང་དག་པར་རབ་ཏུ་སྟོན་པ་ཞེས་བྱའོ་༎
 tārakā timiraṃ dīpo māyāvaśyāya 2| budbudaḥ supinaṃ vidyud abhraṃ ca evaṃ draṣṭavya saṃskṛtaṃ ||	སྐར་མ་རབ་རིབ་མར་མེ་དང་༎ སྒྱུ་མ་ཟིལ་བ་ཆུ་བུར་དང་༎ རྨི་ལམ་གློག་དང་སྤྲིན་ལྟ་བུ་༎ འདུས་བྱས་དེ་ལྟར་བལྟ་བར་བྱ་༎
