skt	tib
 vaj 1; folio 26r1-v4 (cz 27|1-1)	༄༢༡༥ཨ་། །རྒྱ་གར་སྐད་དུ་། ཨའརྱ་བཛྲ་ཙཚེ་ད་ཀ་ནའ་མ་པྲ་ཛཉའ་པ་ར་མི་ཏ་མ་ཧའ་ཡ་ན་སའུ་ཏྲ་། བོད་སྐད་དུ་། འཕགས་པ་ཤེས་རབ་ཀྱི་ཕ་རོལ་ཏུ་ཕྱིན་པ་རྡོ་རྗེ་གཅོད་པ་ཞེས་བྱ་བ་ཐེག་པ་ཆེན་པོའི་མདོ་། 
 namo śākyamunaye tathāgatāyārhate samyaksaṃbuddhāya | ||	སངས་རྒྱས་དང་བྱང་ཆུབ་སེམས་དཔའ་ཐམས་ཅད་ལ་ཕྱག་འཚལ་ལོ་༎
 evaṃ mayā śrutam ekasmin samaye bhagavān |	འདི་སྐད་བདག་གིས་ཐོས་པ་དུས་གཅིག་ན་།
 śrāvastyāṃ viharati sma | jetavane | anāthapiṇḍadasyārāme mahatā bhikṣusaṃghena sārdham ardhatrayodaśabhir bhikṣuśataiḥ |	བཅོམ་ལྡན་འདས་མཉན་དུ་ཡོད་པ་ན་རྒྱལ་བུ་རྒྱལ་བྱེད་ཀྱི་ཚལ་མགོན་མེད་ཟས་སྦྱིན་གྱི་ཀུན་དགའ་ར་བ་ན་དགེ་སློང་སྟོང་ཉིས་བརྒྱ་ལྔ་བཅུའི་དགེ་སློང་གི་དགེ་འདུན་ཆེན་པོ་དང་། བྱང་ཆུབ་སེམས་དཔའ་སེམས་དཔའ་ཆེན་པོ་རབ་ཏུ་མང་པོ་དང་ཐབས་གཅིག་ཏུ་བཞུགས་ཏེ་།
 atha khalu bhagavān pūrvāhṇakālasamaye nivāsya pātracīvaram ādāya | śrāvastīṃ mahānagarīṃ piṇḍāya prāviśat |	དེ་ནས་བཅོམ་ལྡན་འདས་སྔ་དྲོའི་དུས་ཀྱི་ཚེ་ཤམ་ཐབས་དང་ཆོས་གོས་སྐུ་ལ་གསོལ་ཏེ་ལྷུང་བཟེད་༄༢༡༥བ་བསྣམས་ནས་མཉན་ཡོད་ཀྱི་གྲོང་ཁྱེར་ཆེན་པོར་བསོད་སྙོམས་ཀྱི་ཕྱིར་ཞུགས་སོ་༎
 atha khalu bhagavān | śrāvastīṃ mahānagarīṃ piṇḍāya caritvā paścādbhaktapiṇḍapātapratikrāntaḥ pādau prakṣālya nyaṣīdad bhagavān | prajñapta evāsane paryaṃkam ābhujya ṛjuṃ kāyaṃ praṇidhāya pratimukhaṃ smṛtim upasthāpya |	དེ་ནས་བཅོམ་ལྡན་འདས་མཉན་ཡོད་ཀྱི་གྲོང་ཁྱེར་ཆེན་པོར་བསོད་སྙོམས་ཀྱི་ཕྱིར་གཤེགས་ནས་བསོད་སྙོམས་ཀྱི་ཞལ་ཟས་མཇུག་ཏུ་གསོལ་ཏེ་ཟས་ཀྱི་བྱ་བ་མཛད་ནས་ཟས་ཕྱི་མའི་བསོད་སྙོམས་སྤངས་པས་། ལྷུང་བཟེད་དང་ཆོས་གོས་བཞག་ནས་ཞབས་བསིལ་ཏེ་གདན་བཤམས་པ་ལ་སྐྱིལ་མོ་ཀྲུང་བཅས་ནས་སྐུ་དྲང་པོར་བསྲང་སྟེ་དྲན་པ་མངོན་དུ་བཞག་། ནས་བཞུགས་སོ་༎ 
 atha saṃbahulā bhikṣavaḥ yena bhagavāṃs tenopasaṃkkraman upasaṃkkramya bhagavataḥ pādau śirasābhivandya bhagavaṃtaṃ tṛḥpradakṣiṇīkṛtvā ekāṃte nyaṣīdan | vaj 2; folio 26v4-27v6 (cz 27|16-28|17; p 179|14-24)	དེ་ནས་དགེ་སློང་མང་པོ་བཅོམ་ལྡན་འདས་ག་ལ་བ་དེར་དོང་སྟེ་ལྷགས་ནས་བཅོམ་ལྡན་འདས་ཀྱི་ཞབས་ལ་མགོ་བོས་ཕྱག་འཚལ་ཏེ་བཅོམ་ལྡན་འདས་ལ་ལན་གསུམ་བསྐོར་བ་བྱས་ནས་ཕྱོགས་གཅིག་ཏུ་འཁོད་དོ་༎
 tena khalu punaḥ samayenāyuṣmān subhūtiḥ tasyām eva pariṣadi sannipatito 'bhūt sanniṣaṇṇaḥ |	ཡང་དེའི་ཚེ་ཚེ་དང་ལྡན་པ་རབ་འབྱོར་འཁོར་དེ་ཉིད་དུ་འདུས་པར་གྱུར་ཏེ་འདུག་གོ་།
 atha khalv āyuṣmān subhūtir utthāyāsanād ekāṃsam uttarāsaṃgaṃ kṛtvā dakṣiṇaṃ jānumaṇḍalaṃ pṛthivyāṃ pratiṣṭhāpya yena bhagavāṃs tenāṃjaliṃ praṇāmya bhagavaṃtam etad avocat |	དེ་ནས་ཚེ་དང་ལྡན་པ་རབ་འབྱོར་སྟན་ལས་ལངས་ཏེ་བླ་གོས་ཕྲག་པ་གཅིག་ཏུ་གཟར་ནས་པུས་མོ་ག-ཡས་པའི་ལྷ་ང་ས་ལ་བཙུགས་ཏེ་བཅོམ་ལྡན་འདས་ག་ལ་བ་དེ་ལོགས་སུ་ཐལ་མོ་སྦྱར་བ་བཏུད་དེ་བཅོམ་ལྡན་འདས་ལ་འདི་སྐད་ཅེས་གསོལ་ཏོ་༎ བཅོམ་ལྡན་འདས་།
 āścaryaṃ bhagavan yāvad eva tathāgatenārhatā samyaksaṃbuddhena bodhisatvā mahāsatvā anuparigṛhītāḥ parameṇānugraheṇa |	དེ་བཞིན་གཤེགས་པ་དགྲ་བཅོམ་པ་ཡང་དག་པར་རྫོགས་པའི་སངས་རྒྱས་ཀྱིས་བྱང་ཆུབ་སེམས་དཔའ་སེམས་དཔའ་ཆེན་པོ་རྣམས་ལ་ཕན་གདགས་པའི་དམ་པ་ཇི་སྙེད་པས་ཕན་བཏགས་པ་དང་། དེ་བཞིན་གཤེགས་པ་དགྲ་བཅོམ་པ་ཡང་དག་པར་རྫོགས་པའི་༄༢༡༦ཨ་༌༎
 yāvad eva tathāgatena bodhisatvāḥ parittāḥ paramayā parindanayā |	སངས་རྒྱས་ཀྱིས་བྱང་ཆུབ་སེམས་དཔའ་སེམས་དཔའ་ཆེན་པོ་རྣམས་ཡོངས་སུ་གཏད་པའི་དམ་པ་ཇི་སྙེད་པས་ཡོངས་སུ་གཏད་པ་ནི་། བཅོམ་ལྡན་འདས་། ངོ་མཚར་ལགས་སོ་༎ བདེ་བར་གཤེགས་པ་། ངོ་མཚར་ལགས་སོ་༎
 kathaṃ bhagavan bodhisatvayānasaṃprasthitena sthātavyam |	བཅོམ་ལྡན་འདས་། བྱང་ཆུབ་སེམས་དཔའི་ཐེག་པ་ལ་ཡང་དག་པར་ཞུགས་པས་ཇི་ལྟར་གནས་པར་བགྱི་།
 kathaṃ pratipattavyam |	ཇི་ལྟར་བསྒྲུབ་པར་བགྱི་།
 kathaṃ cittaṃ pratigṛhītavyam |	ཇི་ལྟར་སེམས་རབ་ཏུ་གཟུང་བར་བགྱི་།
 evam ukte bhagavān āyuṣmaṃtaṃ subhūtim etad avocat |	དེ་སྐད་ཅེས་གསོལ་པ་དང་། བཅོམ་ལྡན་འདས་ཀྱིས་ཚེ་དང་ལྡན་པ་རབ་འབྱོར་ལ་འདི་སྐད་ཅེས་བཀའ་སྩལ་ཏོ༏་༏རབ་འབྱོར་། ལེགས་སོ་༎ ལེགས་སོ་༎ རབ་འབྱོར་། དེ་དེ་བཞིན་ནོ་༎ དེ་དེ་བཞིན་ཏེ་།
 sādhu sādhu subhūte evam etat subhūte anuparigṛhītās tathāgatena bodhisatvāḥ parameṇānugraheṇa |	དེ་བཞིན་གཤེགས་པས་བྱང་ཆུབ་སེམས་དཔའ་སེམས་དཔའ་ཆེན་པོ་རྣམས་ལ་ཕན་གདགས་པའི་དམ་པས་ཕན་བཏགས་སོ་༎ 
 parittās tathāgatena bodhisatvāḥ paramayānuparindanayā |	དེ་བཞིན་གཤེགས་པས་བྱང་ཆུབ་སེམས་དཔའ་སེམས་དཔའ་ཆེན་པོ་རྣམས་ལ་ཡོངས་སུ་གཏད་པའི་དམ་པས་ཡོངས་སུ་གཏད་དོ་༎ རབ་འབྱོར་།
 tena hi subhūte śṛṇu sādhu ca suṣṭhu ca manasikuru bhāṣiṣye | yathā bodhisatvayānasaṃprasthitena sthātavyaṃ | yathā pratipattavyam |	དེའི་ཕྱིར་ཉོན་ལ་ལེགས་པར་རབ་ཏུ་ཡིད་ལ་ཟུངས་ཤིག་དང་། བྱང་ཆུབ་སེམས་དཔའི་ཐེག་པ་ལ་ཡང་དག་པར་ཞུགས་པས་ཇི་ལྟར་གནས་པར་བྱ་བ་དང་། ཇི་ལྟར་བསྒྲུབ་པར་བྱ་བ་དང་། ཇི་ལྟར་སེམས་རབ་ཏུ་གཟུང་བར་བྱ་བ་ངས་ཁྱོད་ལ་བཤད་དོ་༎ བཅོམ་ལྡན་འདས་།
 yathā cittaṃ pratigṛhītavyam |	དེ་བཞིན་ནོ་༎
 evaṃ bhagavann ity āyuṣmān subhūtir bhagavataḥ pratyaśrauṣīt | vaj 3m folio 27v6-28v1 (cz 28|17-29|7; p 179|24-180|10) bhagavāṃs tān etad avocat |	ཞེས་གསོལ་ནས་ཚེ་དང་ལྡན་པ་རབ་འབྱོར་བཅོམ་ལྡན་འདས་༄༢༡༦བ་ཀྱི་ལྟར་ཉན་པ་དང་། བཅོམ་ལྡན་འདས་ཀྱིས་འདི་སྐད་ཅེས་བཀའ་སྩལ་ཏོ་༎ རབ་འབྱོར་།
 iha subhūte bodhisatvayānasaṃprasthitair evaṃ cittam utpādayitavyam |	འདི་ལ་བྱང་ཆུབ་སེམས་དཔའི་ཐེག་པ་ལ་ཡང་དག་པར་ཞུགས་པས་འདི་སྙམ་དུ་། བདག་གིས་ཇི་ཙམ་སེམས་ཅན་དུ་བསྡུ་བས་བསྡུས་པ་སྒོ་ང་ལས་སྐྱེས་པའམ་།
 yāvaṃtaḥ satvāḥ satvasaṃgraheṇa saṃgṛhītaḥ aṇḍajā vā jarāyujā vā saṃsvedajā vā upapādukā	མངལ་ནས་སྐྱེས་པའམ་། དྲོད་གཤེར་ལས་སྐྱེས་པའམ་། བརྫུས་ཏེ་སྐྱེས་པའམ་། གཟུགས་ཅན་ནམ་།
 vā rūpiṇo vā arūpiṇo vā saṃjñino vā asaṃjñino vā naiva saṃjñino nāsaṃjñinaḥ yāvat	གཟུགས་མེད་པའམ་། འདུ་ཤེས་ཅན་ནམ་། འདུ་ཤེས་མེད་པའམ་། འདུ་ཤེས་མེད་འདུ་ཤེས་མེད་མིན་ནམ་།
 satvadhātuḥ prajñapyamānaḥ prajñapyate te mayā sarve anupadhiśeṣe nirvāṇadhātau parinirvāpayitavyāḥ |	སེམས་ཅན་གྱི་ཁམས་ཇི་ཙམ་སེམས་ཅན་དུ་གདགས་པས་བཏགས་པ་དེ་དག་ཐམས་ཅད་ཕུང་པོ་ལྷག་མ་མེད་པའི་མྱ་ངན་ལས་འདས་པའི་དབྱིངས་སུ་ཡོངས་སུ་མྱ་ངན་ལས་བཟླའོ་༎
 evam aparimāṇāṃś ca satvān parinirvāpayitavyāḥ na ca kaścit satvaḥ parinirvāpito bhavati |	དེ་ལྟར་སེམས་ཅན་ཚད་མེད་པ་ཡོངས་སུ་མྱ་ངན་ལས་བཟླས་ཀྱང་སེམས་ཅན་གང་ཡང་ཡོངས་སུ་མྱ་ངན་ལས་བཟླས་པར་གྱུར་པ་མེད་དོ་༎ སྙམ་དུ་སེམས་བསྐྱེད་པར་བྱའོ་༎
 tat kasmād dhetoḥ |	དེ་ཅིའི་ཕྱིར་ཞེ་ན་། རབ་འབྱོར་།
 sacet subhūte bodhisatvasya satvasaṃjñā pravartate na sa bodhisatva iti vaktavyaḥ |	གལ་ཏེ་བྱང་ཆུབ་སེམས་དཔའ་སེམས་ཅན་དུ་འདུ་ཤེས་འཇུག་ན་། དེ་བྱང་ཆུབ་སེམས་དཔའ་ཞེས་མི་བྱ་བའི་ཕྱིར་རོ་༎
 tat kasya hetoḥ |	དེ་ཅིའི་ཕྱིར་ཞེ་ན་། རབ་འབྱོར་།
 na sa subhūte bodhisatvo vaktavyo yasya satvasaṃjñā pravarteta jīvasaṃjñā vā pudgalasaṃjñā vā pravarteta | vaj 4; folio 28v1-29r5 (cz 29|8-30|5; p 180|10-15)	གང་སེམས་ཅན་དུ་འདུ་ཤེས་འཇུག་གམ་། སྲོག་ཏུ་འདུ་ཤེས་འཇུག་གམ་། གང་ཟག་ཏུ་འདུ་ཤེས་འཇུག་ན་། དེ་བྱང་ཆུབ་སེམས་དཔའ་ཞེས་མི་བྱ་བའི་ཕྱིར་རོ་༎
 api tu khalu punaḥ subhūte bodhisatvena na vastupratiṣṭhitena dānaṃ dātavyam |	ཡང་རབ་འབྱོར་། བྱང་ཆུབ་སེམས་དཔས་དངོས་པོ་ལ་མི་གནས་པར་སྦྱིན་པ་སྦྱིན་ནོ་༎
 na kvacitpratiṣṭhitena dānaṃ dātavyam |	ཆོས་གང་ལ་ཡང་མི་གནས་པར་༄༢༡༧ཨ་༌༎ སྦྱིན་པ་སྦྱིན་ནོ་༎
 na rūpapratiṣṭhitena dānaṃ dātavyam na śabdagandharasaspraṣṭavyeṣu na dharmapratiṣṭhitena dānaṃ dātavyam |	གཟུགས་ལའང་མི་གནས་པར་སྦྱིན་པ་སྦྱིན་པར་བྱའོ་༎ སྒྲ་དང་། དྲི་དང་། རོ་དང་། རེག་བྱ་དང་། ཆོས་ལའང་མི་གནས་པར་སྦྱིན་པ་སྦྱིན་ནོ༏་༏རབ་འབྱོར་།
 evaṃ hi subhūte bodhisatvena dānaṃ dātavyam | yathā na nimittasaṃjñāyāṃ pratitiṣṭhet |	ཅི་ནས་མཚན་མར་འདུ་ཤེས་པ་ལའང་མི་གནས་པ་དེ་ལྟར་བྱང་ཆུབ་སེམས་དཔས་སྦྱིན་པ་སྦྱིན་ནོ་༎ 
 tat kasya hetoḥ |	དེ་ཅིའི་ཕྱིར་ཞེ་ན་། རབ་འབྱོར་།
 yaḥ subhūte bodhisatvaḥ apratiṣṭhito dānaṃ dadāti tasya subhūte puṇyaskandhasya na sukaraṃ pramāṇam udgrahītum |	བྱང་ཆུབ་སེམས་དཔའ་གང་མི་གནས་པར་སྦྱིན་པ་སྦྱིན་པ་དེའི་བསོད་ནམས་ཀྱི་ཕུང་པོ་ནི་། རབ་འབྱོར་། ཚད་གཟུང་བར་སླ་བ་མ་ཡིན་པའི་ཕྱིར་རོ་༎
 tat kiṃ manyase subhūte sukaraṃ pūrvasyāṃ diśi ākāśasya pramāṇam udgrahītum |	རབ་འབྱོར་། འདི་ཇི་སྙམ་དུ་སེམས་། ཤར་ཕྱོགས་ཀྱི་ནམ་མཁའི་ཚད་གཟུང་བར་སླའམ་།
 subhūtir āha |	རབ་འབྱོར་གྱིས་གསོལ་པ་།
 no hīdaṃ bhagavan |	བཅོམ་ལྡན་འདས་། དེ་ནི་། མ་ལགས་སོ་༎ བཅོམ་ལྡན་འདས་ཀྱིས་བཀའ་སྩལ་པ་།
 evaṃ dakṣiṇapaścimottarāsv adha ūrdhvaṃ vidikṣu-r-avidikṣu | daśasu dikṣu | sukaram ākāśasya pramāṇam udgrahītum |	དེ་བཞིན་དུ་ལྷོ་དང་། ནུབ་དང་། བྱང་དང་། སྟེང་དང་། འོག་གི་ཕྱོགས་དང་། ཕྱོགས་མཚམས་དང་། ཕྱོགས་བཅུའི་ནམ་མཁའི་ཚད་གཟུང་བར་སླའམ་།
 subhūtir āha |	རབ་འབྱོར་གྱིས་གསོལ་པ་། བཅོམ་ལྡན་འདས་།
 na hīdaṃ bhagavan |	དེ་ནི་། མ་ལགས་སོ་༎
 bhagavān āha |	བཅོམ་ལྡན་འདས་ཀྱིས་བཀའ་སྩལ་པ་། རབ་འབྱོར་།
 evam etat subhūte | evam etat subhūte yo bodhisatvo 'pratiṣṭhito dānaṃ dadāti tasya puṇyaskandhasya na sukaraṃ pramāṇam udgrahītum | api tu khalu punaḥ subhūte evaṃ bodhisatvena dānamayaṃ puṇyakṛyāvastuṃ dānaṃ dātavyam | vaj 5; folio 29r5-v4 (cz 30|6-14)	དེ་བཞིན་དུ་བྱང་ཆུབ་སེམས་དཔའ་གང་མི་གནས་པའི་སྦྱིན་པ་སྦྱིན་པ་དེའི་བསོད་ནམས་ཀྱི་ཕུང་པོ་ཡང་ཚད་གཟུང་བར་སླ་བ་མ་ཡིན་ནོ་༎ རབ་འབྱོར་།
 tat kiṃ manyase subhūte tathāgato lakṣaṇasaṃpadā draṣṭavyaḥ |	འདི་ཇི་སྙམ་དུ་སེམས་། མཚན་ཕུན་སུམ་ཚོགས་པས་དེ་བཞིན་གཤེགས་པར་བལྟའམ་། རབ་འབྱོར་གྱིས་གསོལ་པ་། བཅོམ་ལྡན་འདས་།
 bhagavān āha na lakṣaṇasaṃpadā tathāgato draṣṭavyaḥ |	༄༢༡༧བ་དེ་ནི༏་མ་ལགས་ཏེ་། མཚན་ཕུན་སུམ་ཚོགས་པས་དེ་བཞིན་གཤེགས་པར་མི་བལྟའོ་༎
 tat kasya hetoḥ |	དེ་ཅིའི་སླད་དུ་ཞེ་ན་།
 yā sā tathāgatena lakṣaṇasaṃpad bhāsitā saivālakṣaṇasaṃpat |	དེ་བཞིན་གཤེགས་པས་མཚན་ཕུན་སུམ་ཚོགས་པར་གང་གསུངས་པ་དེ་ཉིད་མཚན་ཕུན་སུམ་ཚོགས་པ་མ་མཆིས་པའི་སླད་དུའོ་༎
 evam ukte bhagavān āyuṣmaṃtaṃ subhūtim etad avocat |	དེ་སྐད་ཅེས་གསོལ་པ་དང་། བཅོམ་ལྡན་འདས་ཀྱིས་ཚེ་དང་ལྡན་པ་རབ་འབྱོར་ལ་འདི་སྐད་ཅེས་བཀའ་སྩལ་ཏོ་༎ རབ་འབྱོར་འདི་ཇི་སྙམ་དུ་སེམས་།
 yāvat subhūte lakṣaṇaṃ tāvan mṛṣā |	མཚན་ཕུན་སུམ་ཚོགས་པ་དེ་ཙམ་དུ་རྫུན་ནོ་༎
 yāvad alakṣaṇaṃ tāvad amṛṣā |	ཇི་ཙམ་དུ་མཚན་ཕུན་སུམ་ཚོགས་པ་མེད་པ་དེ་ཙམ་དུ་མི་རྫུན་ཏེ་།
 iti hi lakṣaṇālakṣaṇataḥ tathāgato draṣṭavyaḥ || vaj 6; folio 29v4-31v6 (cz 30|15-32|5)	དེ་ལྟར་དེ་བཞིན་གཤེགས་པ་ལ་མཚན་དང་མཚན་མེད་པར་བལྟའོ་༎
 evam ukte āyuṣmān subhūtir bhagavaṃtam etad avocat |	དེ་སྐད་ཅེས་བཀའ་སྩལ་པ་དང་། བཅོམ་ལྡན་འདས་ལ་ཚེ་དང་ལྡན་པ་རབ་འབྱོར་གྱིས་འདི་སྐད་ཅེས་གསོལ་ཏོ་༎
 asti bhagavan kecit satvāḥ bhaviṣyaṃty anāgate 'dhvani paścimāyāṃ paṃcāśatyāṃ vartamānāyāṃ ye imeṣv evaṃrūpeṣu sūtrāṃtapadeṣu bhāṣyamāṇeṣu bhūtasaṃjñām utpādayiṣyaṃti |	བཅོམ་ལྡན་འདས་། མ་འོངས་པའི་དུས་ལྔ་བརྒྱ་ཐ་མ་ལ་དམ་པའི་ཆོས་རབ་ཏུ་རྣམ་པར་འཇིག་པར་འགྱུར་བ་ན་སེམས་ཅན་གང་ལ་ལ་དག་འདི་ལྟ་བུའི་མདོ་སྡེའི་ཆིག་བཤད་པ་འདི་ལ་ཡང་དག་པར་འདུ་ཤེས་བསྐྱེད་པར་འགྱུར་བ་ལྟ་མཆིས་སམ་།
 bhagavān āha |	བཅོམ་ལྡན་འདས་ཀྱིས་བཀའ་སྩལ་པ་། རབ་འབྱོར་།
 mā tvaṃ subhūte evaṃ vocat |	ཁྱོད་འདི་སྐད་དུ་།
 asti kecit satvāḥ bhaviṣyaṃty anāgate 'dhvani ye imeṣv evaṃrūpeṣu sūtrāṃtapadeṣu bhāṣyamāṇeṣu bhūtasaṃjñām utpādayiṣyaṃti |	མ་འོངས་པའི་དུས་ལྔ་བརྒྱ་ཐ་མ་ལ་དམ་པའི་ཆོས་རབ་ཏུ་རྣམ་པར་འཇིག་པར་འགྱུར་བ་ན་སེམས་ཅན་གང་ལ་ལ་དག་འདི་ལྟ་བུའི་མདོ་སྡེའི་ཚིག་བཤད་པ་འདི་ལ་ཡང་དག་པར་འདུ་ཤེས་བསྐྱེད་པར་འགྱུར་བ་ལྟ་མཆིས་སམ་ཞེས་མ་ཟེར་ཅིག་། 
 api tu khalu punaḥ subhūte bhaviṣyaṃty anāgate 'dhvani bodhisatvā mahāsatvā paścimāyāṃ paṃcāśatyāṃ saddharmavipralope vartamāne śīlavaṃto guṇavaṃtaḥ prajñāvaṃto bhaviṣyaṃti |	ཡང་རབ་འབྱོར་། མ་འོངས་པའི་དུས་ལྔ་༄༢༡༨ཨ་༌༎ བརྒྱ་ཐ་མ་ལ་དམ་པའི་ཆོས་རབ་ཏུ་རྣམ་པར་འཇིག་པར་འགྱུར་བ་ན་བྱང་ཆུབ་སེམས་དཔའ་སེམས་དཔའ་ཆེན་པོ་ཚུལ་ཁྲིམས་དང་ལྡན་པ་། ཡོན་ཏན་དང་ལྡན་པ་།
 na khalu punaḥ subhūte bodhisatvā ekabuddhaparyupāsitā bhaviṣyaṃti |	ཤེས་རབ་དང་ལྡན་པ་དག་འབྱུང་སྟེ་། རབ་འབྱོར་། བྱང་ཆུབ་སེམས་དཔའ་སེམས་དཔའ་ཆེན་པོ་དེ་དག་ཀྱང་སངས་རྒྱས་གཅིག་ལ་བསྙེན་བཀུར་བྱས་པ་མ་ཡིན་། 
 naikabuddhāvaropitakuśalamūlā bhaviṣyaṃti |	སངས་རྒྱས་གཅིག་ལ་དགེ་བའི་རྩ་བ་བསྐྱེད་པ་མ་ཡིན་གྱི་། རབ་འབྱོར་། སངས་རྒྱས་བརྒྱ་སྟོང་མང་པོ་ལ་བསྙེན་བཀུར་བྱས་ཤིང་།
 api tu khalu punaḥ subhūte anekabuddhaparyupāsitā bhaviṣyaṃti anekabuddhāvaropitakuśalamūlā bhaviṣyaṃti |	སངས་རྒྱས་བརྒྱ་སྟོང་དུ་མ་ལ་དགེ་བའི་རྩ་བ་དག་བསྐྱེད་པའི་བྱང་ཆུབ་སེམས་དཔའ་སེམས་དཔའ་ཆེན་པོ་དག་འབྱུང་ངོ་༎ རབ་འབྱོར་།
 ye imeṣv evaṃrūpeṣu sūtrāṃtapadeṣu bhāṣyamāṇeṣv ekacittaprasādamātram api pratilapsyaṃte |	གང་དག་འདི་ལྟ་བུའི་མདོ་སྡེའི་ཚིག་བཤད་པ་འདི་ལ་སེམས་དད་པ་གཅིག་ཙམ་རྙེད་པར་འགྱུར་བ་དེ་དག་ནི༏་རབ་འབྱོར་། དེ་བཞིན་གཤེགས་པས་མཁྱེན་ཏོ་༎ རབ་འབྱོར་། དེ་དག་ནི་།
 jñātās te subhūte tathāgatena dṛṣṭās te subhūte tathāgatena sarve te aprameyaṃ puṇyaskaṃdhaṃ prasaviṣyaṃti pratigṛhīṣyaṃti |	དེ་བཞིན་གཤེགས་པས་གཟིགས་ཏེ་། རབ་འབྱོར་། སེམས་ཅན་དེ་དག་ཐམས་ཅད་ནི་། བསོད་ནམས་ཀྱི་ཕུང་པོ་དཔག་ཏུ་མེད་པ་བསྐྱེད་ཅིང་རབ་ཏུ་སྡུད་པར་འགྱུར་རོ་༎
 tat kasya hetoḥ |	དེ་ཅིའི་ཕྱིར་ཞེ་ན་། རབ་འབྱོར་། བྱང་ཆུབ་སེམས་དཔའ་སེམས་དཔའ་ཆེན་པོ་དེ་དག་ནི་། བདག་ཏུ་འདུ་ཤེས་འཇུག་པར་མི་འགྱུར་ཞིང་།
 na hi teṣāṃ subhūte bodhisatvānām ātmasaṃjñā pravartsyate na satvasaṃjñā na jīvasaṃjñā na pudgalasaṃjñā pravartsyate |	སེམས་ཅན་དུ་འདུ་ཤེས་པ་མ་ཡིན་། སྲོག་ཏུ་འདུ་ཤེས་པ་མ་ཡིན་ཏེ་། གང་ཟག་ཏུའང་འདུ་ཤེས་འཇུག་པར་མི་འགྱུར་བའི་ཕྱིར་རོ་༎ རབ་འབྱོར་།
 nāpi teṣāṃ subhūte bodhisatvānāṃ dharmasaṃjñā pravartsyate nādharmasaṃjñā nāpi teṣāṃ saṃjñā nāsaṃjñā pravartsyate |	བྱང་ཆུབ་༄༢༡༨བ་སེམས་དཔའ་སེམས་དཔའ་ཆེན་པོ་དེ་དག་ཆོས་སུ་འདུ་ཤེས་པ་དང་། ཆོས་མེད་པར་ཡང་འདུ་ཤེས་མི་འཇུག་སྟེ་། དེ་དག་ནི་། འདུ་ཤེས་དང་། འདུ་ཤེས་མེད་པར་ཡང་འདུ་ཤེས་འཇུག་པར་མི་འགྱུར་རོ་༎
 tat kasya hetoḥ |	དེ་ཅིའི་ཕྱིར་ཞེ་ན་། རབ་འབྱོར་།
 sacet subhūte teṣāṃ bodhisatvānāṃ dharmasaṃjñā pravartsyate sa eva teṣām ātmagrāho bhavet |	གལ་ཏེ་བྱང་ཆུབ་སེམས་དཔའ་སེམས་དཔའ་ཆེན་པོ་དེ་དག་ཆོས་སུ་འདུ་ཤེས་འཇུག་ན་། དེ་ཉིད་དེ་དག་གི་བདག་ཏུ་འཛིན་པར་འགྱུར་ཞིང་།
 satvagrāho jīvagrāhaḥ pudgalagrāho bhavet |	སེམས་ཅན་དུ་འཛིན་པ་དང་། སྲོག་ཏུ་འཛིན་པ་དང་། གང་ཟག་ཏུ་འཛིན་པར་འགྱུར་བའི་ཕྱིར་རོ་༎
 saced adharmasaṃjñā pravarteta sa eva teṣām ātmagrāho bhavet |	གལ་ཏེ་ཆོས་མེད་པར་འཇུག་ནའང་དེ་ཉིད་དེ་དག་གི་བདག་ཏུ་འཛིན་པར་འགྱུར་ཞིང་།
 satvagrāho jīvagrāhaḥ pudgalagrāha iti |	སེམས་ཅན་དུ་འཛིན་པ་དང་། སྲོག་ཏུ་འཛིན་པ་དང་། གང་ཟག་ཏུ་འཛིན་པར་འགྱུར་བའི་ཕྱིར་རོ་༎
 tat kasya hetoḥ |	དེ་ཅིའི་ཕྱིར་ཞེ་ན་། ཡང་རབ་འབྱོར་།
 na khalu punaḥ subhūte dharmodgrahītavyo nādharmaḥ |	བྱང་ཆུབ་སེམས་དཔས་ཆོས་ཀྱང་ལོག་པར་གཟུང་བར་མི་བྱ་སྟེ་། ཆོས་མ་ཡིན་པ་ཡང་མི་གཟུང་བའི་ཕྱིར་རོ་༎
 tasmād idaṃ sandhāya tathāgatena bhāṣitaṃ kolopamaṃ dharmaparyāyam ājānadbhiḥ dharmāḥ eva prahātavyāḥ prāg evādharmāḥ | vaj 7; folio 31v6-32vl (cz 32|6-33|2)	དེ་བས་ན་། དེ་ལས་དགོངས་ཏེ་དེ་བཞིན་གཤེགས་པས་ཆོས་ཀྱི་རྣམ་གྲངས་འདི་གཟིངས་ལྟ་བུར་ཤེས་པ་རྣམས་ཀྱིས་ཆོས་རྣམས་ཀྱང་སྤང་བར་བྱ་ན་། ཆོས་མ་ཡིན་པ་རྣམས་ལྟ་ཅི་སྨོས་ཞེས་གསུངས་སོ་༎
 punar aparaṃ bhagavān āyuṣmaṃtaṃ subhūtim etad avocat |	གཞན་ཡང་བཅོམ་ལྡན་འདས་ཀྱིས་ཚེ་དང་ལྡན་པ་རབ་འབྱོར་ལ་འདི་སྐད་ཅེས་བཀའ་སྩལ་ཏོ༏་༏རབ་འབྱོར་། 
 tat kiṃ manyase subhūte kācit tathāgatenānuttarā samyaksaṃbodhir abhisaṃbuddhā |	འདི་ཇི་སྙམ་དུ་སེམས་། དེ་བཞིན་གཤེགས་པས་གང་བླ་ན་མེད་པ་ཡང་དག་པར་རྫོགས་པའི་བྱང་ཆུབ་མངོན་པར་རྫོགས་པར་སངས་རྒྱས་པའི་ཆོས་དེ་གང་ཡང་ཡོད་༄༢༡༩ཨ་༌༎
 kaścid vā dharmas tathāgatena deśitaḥ || subhūtir āha |	དམ༏་དེ་བཞིན་གཤེགས་པས་ཆོས་གང་ཡང་བསྟན་ཏམ་། དེ་སྐད་ཅེས་བཀའ་སྩལ་པ་དང་། བཅོམ་ལྡན་འདས་ལ་ཚེ་དང་ལྡན་པ་རབ་འབྱོར་གྱིས་འདི་སྐད་ཅེས་གསོལ་ཏོ་༎ བཅོམ་ལྡན་འདས་།
 yathāhaṃ bhagavan bhagavato bhāṣitasyārtham ājānāmi nāsti sa kaścid dharmo yas tathāgatenānuttarā samyaksaṃbodhir abhisaṃbuddhā | nāsti sa kaścid dharmo yas tathāgatena deśitaḥ |	བཅོམ་ལྡན་འདས་ཀྱིས་གསུངས་པའི་དོན་འདི་བདག་གིས་འཚལ་བ་ལྟར་ན་། དེ་བཞིན་གཤེགས་པས་གང་བླ་ན་མེད་པ་ཡང་དག་པར་རྫོགས་པའི་བྱང་ཆུབ་མངོན་པར་རྫོགས་པར་སངས་རྒྱས་པའི་ཆོས་དེ་གང་ཡང་མ་མཆིས་སོ་༎ དེ་བཞིན་གཤེགས་པས་གང་བསྟན་པའི་ཆོས་དེ་གང་ཡང་མ་མཆིས་སོ་༎
 tat kasya hetoḥ |	དེ་ཅིའི་སླད་དུ་ཞེ་ན་།
 yo 'sau tathāgatena dharmo deśitaḥ |	དེ་བཞིན་གཤེགས་པས་ཆོས་གང་ཡང་མངོན་པར་རྫོགས་པར་སངས་རྒྱས་པའམ་བསྟན་པ་དེ་ནི་།
 agrāhyaḥ so 'nabhilapyaḥ |	གཟུང་དུ་མ་མཆིས་། བརྗོད་དུ་མ་མཆིས་ཏེ་།
 na sa dharmo nādharmaḥ |	དེ་ནི་། ཆོས་ཀྱང་མ་ལགས་། ཆོས་མ་མཆིས་པ་ཡང་མ་ལགས་པའི་སླད་དུའོ་༎
 tat kasya hetoḥ |	དེ་ཅིའི་སླད་དུ་ཞེ་ན་།
 asaṃskṛtaprabhāvitā hy āryapudgalāḥ | vaj 8; folio 32vl-34rl (cz 33|3-26)	འཕགས་པའི་གང་ཟག་རྣམས་ནི་། འདུས་མ་བགྱིས་ཀྱིས་རབ་ཏུ་ཕྱེ་བའི་སླད་དུའོ་༎ བཅོམ་ལྡན་འདས་ཀྱིས་བཀའ་སྩལ་པ་། རབ་འབྱོར་།
 tat kiṃ manyase subhūte ya imāṃ tṛsāhasramahāsāhasrāṃ lokadhātuṃ saptaratnapratipūrṇaṃ kṛtvā dānaṃ dadyāt |	འདི་ཇི་སྙམ་དུ་སེམས་། རིགས་ཀྱི་བུའམ་། རིགས་ཀྱི་བུ་མོ་གང་ལ་ལ་ཞིག་གིས་སྟོང་གསུམ་གྱི་སྟོང་ཆེན་པོའི་འཇིག་རྟེན་གྱི་ཁམས་འདི་རིན་པོ་ཆེ་སྣ་བདུན་གྱིས་རབ་ཏུ་གང་བར་བྱས་ཏེ་སྦྱིན་པ་བྱིན་ན་།
 tat kiṃ manyase subhūte api nu sa kulaputro vā kuladuhitā vā tatonidānaṃ bahu puṇyaṃ prasunuyāt |	རིགས་ཀྱི་བུའམ་། རིགས་ཀྱི་བུ་མོ་དེ་གཞི་དེ་ལས་བསོད་ནམས་ཀྱི་ཕུང་པོ་མང་དུ་བསྐྱེད་དམ་།
 subhūtir āha |	༄༢༡༩བ་རབ་འབྱོར་གྱིས་གསོལ་པ་། བཅོམ་ལྡན་འདས་།
 bahu bhagavan bahu sugata |	མང་ལགས་སོ་༎ བདེ་བར་གཤེགས་པ་། མང་ལགས་ཏེ་།
 sa kulaputro vā kuladuhitā vā tatonidānaṃ bahu puṇyaṃ prasunuyāt | tat kasya hetoḥ |	རིགས་ཀྱི་བུའམ་། རིགས་ཀྱི་བུ་མོ་དེ་གཞི་དེ་ལས་བསོད་ནམས་ཀྱི་ཕུང་པོ་མང་དུ་བསྐྱེད་དོ༏་༏དེ་ཅིའི་སླད་དུ་ཞེ་ན་། བཅོམ་ལྡན་འདས་།
 sa eva bhagavann askandhaḥ |	བསོད་ནམས་ཀྱི་ཕུང་པོ་དེ་ཉིད་ཕུང་པོ་མ་མཆིས་པའི་སླད་དུ་སྟེ་། དེས་ན་།
 tasmāt tathāgato bhāṣate puṇyaskandhaḥ askandha iti bhagavān āha |	དེ་བཞིན་གཤེགས་པས་བསོད་ནམས་ཀྱི་ཕུང་པོ་བསོད་ནམས་ཀྱི་ཕུང་པོ་༎ ཞེས་གསུངས་སོ་༎ བཅོམ་ལྡན་འདས་ཀྱིས་བཀའ་སྩལ་པ་།
 yaś ca khalu punaḥ subhūte kulaputro vā kuladuhitā vā imāṃ tṛsāhasrāmahāsāhasrāṃ lokadhātuṃ saptaratnapratipūrṇaṃ kṛtvā dānaṃ dadyāt |	རབ་འབྱོར་། རིགས་ཀྱི་བུའམ་། རིགས་ཀྱི་བུ་མོ་གང་གིས་སྟོང་གསུམ་གྱི་སྟོང་ཆེན་པོའི་འཇིག་རྟེན་གྱི་ཁམས་འདི་རིན་པོ་ཆེ་སྣ་བདུན་གྱིས་རབ་ཏུ་གང་བར་བྱས་ཏེ་སྦྱིན་པ་བྱིན་པ་བས་།
 yaś ceto dharmaparyāyad aṃtaśaś catuṣpadikām api gāthām udgṛhya parebhyo deśayet saṃprakāśayed ayam eva tatonidānaṃ bahutaraṃ puṇyaṃ prasunuyāt aprameyam asaṃkhyeyaṃ | tat kasya hetoḥ |	གང་གིས་ཆོས་ཀྱི་རྣམ་གྲངས་འདི་ལས་ཐ་ན་ཚིག་བཞི་པའི་ཚིགས་སུ་བཅད་པ་གཅིག་ཙམ་བཟུང་ནས་གཞན་དག་ལ་ཡང་འཆད་ཅིང་ཡང་དག་པར་རབ་ཏུ་སྟོན་ན་། དེ་གཞི་དེ་ལས་བསོད་ནམས་ཀྱི་ཕུང་པོ་ཆེས་མང་དུ་གྲངས་མེད་དཔག་ཏུ་མེད་པ་བསྐྱེད་དོ་༎ དེ་ཅིའི་ཕྱིར་ཞེ་ན་།
 ato nirjātā hi subhūte tathāgatānām anuttarā samyaksaṃbodhiḥ |	རབ་འབྱོར་། དེ་བཞིན་གཤེགས་པ་དགྲ་བཅོམ་པ་ཡང་དག་པར་རྫོགས་པའི་སངས་རྒྱས་རྣམས་ཀྱི་བླ་ན་མེད་པ་ཡང་དག་པར་རྫོགས་པའི་བྱང་ཆུབ་ནི་། འདི་ལས་བྱུང་སྟེ་།
 ato nirjātāś ca buddhā bhagavaṃtaḥ |	སངས་རྒྱས་བཅོམ་ལྡན་འདས་རྣམས་ཀྱང་འདི་ལས་སྐྱེས་པའི་ཕྱིར་རོ་༎
 tat kasmād dhetoḥ |	དེ་ཅིའི་ཕྱིར་ཞེ་ན་། རབ་འབྱོར་།
 buddhadharmāḥ buddhadhannā iti subhūte abuddhadharmāś caiva te | vaj 9a; folio 34rl-5 (cz 33|26-34|11)	སངས་རྒྱས་ཀྱི་ཆོས་རྣམས་སངས་རྒྱས་ཀྱི་ཆོས་རྣམས་ཞེས་བྱ་བ་ནི་། སངས་རྒྱས་ཀྱི་ཆོས་དེ་དག་མེད་པར་དེ་བཞིན་གཤེགས་༄༢༢༠ཨ་༌༎ པས་གསུངས་པའི་ཕྱིར་ཏེ་། དེས་ན་། སངས་རྒྱས་ཀྱི་ཆོས་རྣམས་ཞེས་བྱའོ་༎
 tat kiṃ manyase subhūte |	རབ་འབྱོར་། འདི་ཇི་སྙམ་དུ་སེམས་།
 api nu srotāpannasya evaṃ bhavati mayā srotāpattiphalaṃ prāptam iti |	རྒྱུན་དུ་ཞུགས་པ་འདི་སྙམ་དུ་། བདག་གིས་རྒྱུན་དུ་ཞུགས་པའི་འབྲས་བུ་ཐོབ་བོ་སྙམ་དུ་སེམས་སམ་།
 subhūtir āha |	རབ་འབྱོར་གྱིས་གསོལ་པ་།
 no hīdaṃ bhagavan | bhagavān āha |	བཅོམ་ལྡན་འདས་། དེ་ནི་། མ་ལགས་སོ་༎
 tat kasya hetoḥ |	དེ་ཅིའི་སླད་དུ་ཞེ་ན་། བཅོམ་ལྡན་འདས་། དེ་ནི་།
 na hi sa bhagavan kiṃcid āpannaḥ |	ཅི་ལའང་ཞུགས་པ་མ་མཆིས་པའི་སླད་དུ་སྟེ་།
 tenocyate srotāpanna iti |	དེས་ན་། རྒྱུན་དུ་ཞུགས་པ་ཞེས་བགྱིའོ་༎ གཟུགས་ལའང་མ་ཞུགས་། སྒྲ་ལ་མ་ལགས་། དྲི་ལ་མ་ལགས་།
 na rūpam āpanno na śabdān na gandhān na rasān na spraṣṭavyān na dharmān āpannaḥ |	རོ་ལ་མ་ལགས་། རེག་བྱ་ལ་མ་ལགས་། ཆོས་ལའང་མ་ཞུགས་ཏེ་།
 tenocyate srotāpanna iti | vaj 9b; folio 34vl-35rl (cz 34|12-18)	དེས་ན་། རྒྱུན་དུ་ཞུགས་པ་ཞེས་བགྱིའོ་༎ བཅོམ་ལྡན་འདས་། གལ་ཏེ་རྒྱུན་དུ་ཞུགས་པ་དེ་འདི་སྙམ་དུ་། བདག་གིས་རྒྱུན་དུ་ཞུགས་པའི་འབྲས་བུ་ཐོ་བ་བོ༏་༏སྙམ་དུ་སེམས་པར་གྱུར་ན་། དེ་ཉིད་དེའི་བདག་ཏུ་འཛིན་པར་འགྱུར་ལགས་སོ་༎ སེམས་ཅན་དུ་འཛིན་པ་དང་། སྲོག་ཏུ་འཛིན་པ་དང་། གང་ཟག་ཏུ་འཛིན་པར་འགྱུར་ལགས་སོ་༎
 bhagavān āha |	བཅོམ་ལྡན་འདས་ཀྱིས་བཀའ་སྩལ་པ་། རབ་འབྱོར་།
 tat kiṃ manyase subhūte api nu sakṛdāgāminaḥ evaṃ bhaven mayā sakṛdāgāmiphalaṃ prāptam iti |	འདི་ཇི་སྙམ་དུ་སེམས་། ལན་གཅིག་ཕྱིར་འོང་བ་འདི་སྙམ་དུ་། བདག་གིས་ལན་གཅིག་ཕྱིར་འོང་བའི་འབྲས་བུ་ཐོབ་བོ་༎ སྙམ་དུ་སེམས་སམ་།
 subhūtir āha |	རབ་འབྱོར་གྱིས་གསོལ་པ་།
 no hīdaṃ bhagavan | bhagavān āha |	བཅོམ་ལྡན་འདས་། དེ་ནི་། མ་ལགས་སོ་༎
 tat kasya hetoḥ | na sakṛdāgāmino evaṃ bhavati mayā sakṛdāgāmiphalaṃ prāptam iti | tat kasmād dhetoḥ |	དེ་ཅིའི་སླད་དུ་ཞེ་ན་།
 na hi sa kaścid dharmaḥ yaḥ sakṛdāgāmitvam āpannaḥ |	གང་ལན་གཅིག་ཕྱིར་འོང་བ་ཉིད་དུ་ཞུགས་པའི་ཆོས་དེ་གང་ཡང་མ་༄༢༢༠བ་མཆིས་པའི་སླད་དུ་སྟེ་། 
 tenocyate sakṛdāgāmīti | vaj 9c; folio 35rl-4 (cz 34|19-25)	དེས་ན་། ལན་གཅིག་ཕྱིར་འོང་བ་ཞེས་བགྱིའོ་༎
 bhagavān āha |	བཅོམ་ལྡན་འདས་ཀྱིས་བཀའ་སྩལ་པ་། རབ་འབྱོར་།
 tat kiṃ manyase subhūte api nv anāgāmina evaṃ bhavati mayā anāgāmiphalaṃ prāptam iti |	འདི་ཇི་སྙམ་དུ་སེམས་། ཕྱིར་མི་འོང་བ་འདི་སྙམ་དུ་། བདག་གིས་ཕྱིར་མི་འོང་བའི་འབྲས་བུ་ཐོབ་བོ་༎ སྙམ་དུ་སེམས་སམ་། རབ་འབྱོར་གྱིས་གསོལ་པ་། བཅོམ་ལྡན་འདས་དེ་ནི་།
 tat kasya hetoḥ |	མ་ལགས་སོ་༎ དེ་ཅིའི་སླད་དུ་ཞེ་ན་།
 na sa kaścid dharmaḥ yo 'nāgāmīti | samanupaśyati |	གང་ཕྱིར་མི་འོང་བ་ཉིད་དུ་ཞུགས་པའི་ཆོས་དེ་གང་ཡང་མ་མཆིས་པའི་སླད་དུ་སྟེ་།
 tenocyate anāgāmīti | vaj 9d; folio 35r4-v2 (cz 34|26-35|6)	དེས་ན་། ཕྱིར་མི་འོང་བ་ཞེས་བགྱིའོ་༎
 bhagavān āha |	བཅོམ་ལྡན་འདས་ཀྱིས་བཀའ་སྩལ་པ་། རབ་འབྱོར་།
 tat kiṃ manyase subhūte |	འདི་ཇི་སྙམ་དུ་སེམས་།
 api nv arhato evaṃ bhavati mayārhatvaṃ prāptam iti |	དགྲ་བཅོམ་པ་འདི་སྙམ་དུ་། བདག་གིས་དགྲ་བཅོམ་པ་ཉིད་ཐོབ་བོ་༎ སྙམ་དུ་སེམས་སམ་།
 subhūtir āha |	རབ་འབྱོར་གྱིས་གསོལ་པ་།
 no hīdaṃ bhagavan |	བཅོམ་ལྡན་འདས་། དེ་ནི་། མ་ལགས་སོ་༎
 tat kasya hetoḥ |	དེ་ཅིའི་སླད་དུ་ཞེ་ན་།
 na hi bhagavan sa kaścid dharmo yo 'rhan nāmaḥ |	གང་དགྲ་བཅོམ་པ་ཞེས་བགྱི་བའི་ཆོས་དེ་གང་ཡང་མ་མཆིས་པའི་སླད་དུའོ་༎
 saced bhagavann arhata evaṃ bhaven mayārhatvaṃ prāptam iti |	བཅོམ་ལྡན་འདས་། གལ་ཏེ་དགྲ་བཅོམ་པ་འདི་སྙམ་དུ་། བདག་གིས་དགྲ་བཅོམ་པ་ཉིད་ཐོབ་བོ་༎
 sa eva tasyātmagrāho bhavet |	སྙམ་དུ་སེམས་པར་གྱུར་ན་། དེ་ཉིད་དེའི་བདག་ཏུ་འཛིན་པར་འགྱུར་ལགས་སོ་༎
 satvagrāho jīvagrāhaḥ pudgalagrāho bhavet | vaj 9e; folio 35v2-36rl (cz 35|6-14)	སེམས་ཅན་དུ་འཛིན་པ་དང་། སྲོག་ཏུ་འཛིན་པ་དང་། གང་ཟག་ཏུ་འཛིན་པར་འགྱུར་ལགས་སོ་༎
 aham asmi bhagavan | ||	བཅོམ་ལྡན་འདས༏་བདག་ནི་།
 tathāgatenārhatā samyaksaṃbuddhenāraṇavihāriṇām agryo nirdiṣṭaḥ |	དེ་བཞིན་གཤེགས་པ་དགྲ་བཅོམ་པ་ཡང་དག་པར་རྫོགས་པའི་སངས་རྒྱས་ཀྱིས་ཉོན་མོངས་པ་མེད་པར་གནས་པ་རྣམས་ཀྱི་མཆོག་ཏུ་བསྟན་ཏེ་། བཅོམ་ལྡན་འདས་།
 aham asmi bhagavann arhan vigatarāgaḥ |	༄༢༢༡ཨ་༌༎ བདག་འདོད་ཆགས་དང་བྲལ་བ་དགྲ་བཅོམ་པ་ལགས་ཀྱང་། བཅོམ་ལྡན་འདས་།
 na ca me bhagavann evaṃ bhavati aham asmi arhann iti |	བདག་འདི་སྙམ་དུ་། བདག་ནི་། དགྲ་བཅོམ་པའོ་༎ སྙམ་དུ་མི་སེམས་ལགས་སོ་༎
 sacen mama bhagavann evaṃ bhaven mayārhatvaṃ prāptam iti |	བཅོམ་ལྡན་འདས་། གལ་ཏེ་བདག་འདི་སྙམ་དུ་། བདག་གིས་དགྲ་བཅོམ་པ་ཉིད་ཐོབ་བོ་༎
 na me tathāgato vyākariṣyati |	སྙམ་དུ་སེམས་པར་གྱུར་ན་། དེ་བཞིན་གཤེགས་པས་བདག་ལ་རིགས་ཀྱི་བུ་རབ་འབྱོར་ནི་།
 araṇāvihārinām agrya iti subhūtiḥ |	ཉོན་མོངས་པ་མེད་པར་གནས་པ་རྣམས་ཀྱི་མཆོག་ཡིན་ཏེ་།
 kulaputro na kvacid viharati | tenocyate |	ཅི་ལའང་མི་གནས་པས་ན་། ཉོན་མོངས་པ་མེད་པར་གནས་པ་།
 araṇāvihārīti araṇāvihārīti | vaj 10a; folio 36rl-4 (cz 35|15-20)	ཉོན་མོངས་པ་མེད་པར་གནས་པ་ཞེས་ལུང་མི་སྟོན་ལགས་སོ་༎
 bhagavān āha |	བཅོམ་ལྡན་འདས་ཀྱིས་བཀའ་སྩལ་པ་། རབ་འབྱོར་།
 tat kiṃ manyase subhūte |	འདི་ཇི་སྙམ་དུ་སེམས་།
 kaścid dharmas tathāgatena dīpaṃkarāt tathāgatād arhataḥ samyaksaṃbuddhād udgṛhītaḥ |	དེ་བཞིན་གཤེགས་པས་དེ་བཞིན་གཤེགས་པ་དགྲ་བཅོམ་པ་ཡང་དག་པར་རྫོགས་པའི་སངས་རྒྱས་མར་མེ་མཛད་ལས་གང་བླངས་པའི་ཆོས་དེ་གང་ཡང་ཡོད་དམ་། 
 subhūtir āha |	རབ་འབྱོར་གྱིས་གསོལ་པ་།
 no hīdaṃ bhagavan |	བཅོམ་ལྡན་འདས་། དེ་ནི་། མ་ལགས་ཏེ་།
 bhagavān āha | na sa kaścid dharmaḥ tathāgatena dīpaṃkarāt tathāgatād arhataḥ samyaksaṃbuddhād udgṛhītaḥ | vaj 10b; folio 36r4-v2 (cz 35|21-25; p 180|17)	དེ་བཞིན་གཤེགས་པས་དེ་བཞིན་གཤེགས་པ་དགྲ་བཅོམ་པ་ཡང་དག་པར་རྫོགས་པའི་སངས་རྒྱས་མར་མེ་མཛད་ལས་གང་བླངས་པའི་ཆོས་དེ་གང་ཡང་མ་མཆིས་སོ་༎ 
 bhagavān āha |	བཅོམ་ལྡན་འདས་ཀྱིས་བཀའ་སྩལ་པ་། རབ་འབྱོར་།
 yaḥ kaścit subhūte bodhisatvo evaṃ vaded ahaṃ kṣetravyūhān niṣpādayiṣyāmīti sa vitathaṃ vadet |	བྱང་ཆུབ་སེམས་དཔའ་གང་ལ་ལ་ཞིག་འདི་སྐད་དུ་། བདག་གིས་ཞིང་བཀོད་པ་རྣམས་བསྒྲུབ་པར་བྱའོ་༎ ཞེས་ཟེར་ན་། དེ་ནི་། མི་བདེན་པར་སྨྲ་བའོ་༎
 tat kasya hetoḥ |	དེ་ཅིའི་ཕྱིར་ཞེ་ན་། ༄༢༢༡བ་རབ་འབྱོར་།
 kṣetravyūhāḥ kṣetravyūhā iti subhūte avyūhā hy ete tathāgatena bhāṣitāḥ |	ཞིང་བཀོད་པ་རྣམས་ཞིང་བཀོད་པ་རྣམས་ཞེས་བྱ་བ་ནི་། བཀོད་པ་དེ་དག་མེད་པར་དེ་བཞིན་གཤེགས་པས་གསུངས་པའི་ཕྱིར་ཏེ་།
 tenocyaṃte kṣetravyūhā iti | vaj 10c; folio 36v2-37r3 (cz 35|25-36|12; p 180|17-181|1)	དེས་ན་། ཞིང་བཀོད་པ་རྣམས་ཞེས་བྱའོ་༎
 tasmāt tarhi subhūte bodhisatvena evaṃ cittam utpādayitavyaṃ apratiṣṭhitaṃ |	རབ་འབྱོར༏་དེ་ལྟ་བས་ན་། བྱང་ཆུབ་སེམས་དཔའ་སེམས་དཔའ་ཆེན་པོས་འདི་ལྟར་མི་གནས་པར་སེམས་བསྐྱེད་པར་བྱའོ་༎ ཅི་ལའང་མི་གནས་པར་སེམས་བསྐྱེད་པར་བྱའོ་༎
 na rūpapratiṣṭhitaṃ cittam utpādayitavyaṃ |	གཟུགས་ལའང་མི་གནས་པར་སེམས་བསྐྱེད་པར་བྱའོ་༎
 na śabdagandharasaspraṣṭavyadharmapratiṣṭhitaṃ cittam utpādayitavyam | na kvacitpratiṣṭhitaṃ cittam utpādayitavyam |	སྒྲ་དང་། དྲི་དང་། རོ་དང་། རེག་བྱ་དང་། ཆོས་ལའང་མི་གནས་པར་སེམས་བསྐྱེད་པར་བྱའོ་༎ རབ་འབྱོར་།
 tad yathāpi nāma subhūte puruṣo bhavet |	འདི་ལྟ་སྟེ་། དཔེར་ན་། སྐྱེས་བུ་ཞིག་ལུས་འདི་ལྟ་བུར་གྱུར་ཏེ་།
 yasyaivaṃrūpa ātmabhāvaḥ syāt tad yathāpi nāma sumeruḥ parvatarājā |	འདི་ལྟ་སྟེ་། རིའི་རྒྱལ་པོ་རི་རབ་ཙམ་དུ་གྱུར་ན་།
 tat kiṃ manyase subhūte mahān sa ātmabhāvo bhavet |	རབ་འབྱོར་། འདི་ཇི་སྙམ་དུ་སེམས་། ལུས་དེ་ཆེ་བ་ཡིན་ནམ་།
 subhūtir āha |	རབ་འབྱོར་གྱིས་གསོལ་པ་། བཅོམ་ལྡན་འདས༏་ལུས་དེ་ཆེ་བ་ལགས་སོ་༎
 mahān bhagavaṅ mahān sugata |	བདེ་བར་གཤེགས་པ་།
 sa ātmabhāvo bhavet | bhagavan |	ལུས་དེ་ཆེ་ལགས་སོ་༎
 tat kasya hetoḥ |	དེ་ཅིའི་སླད་དུ་ཞེ་ན་།
 abhāvaḥ sa tathāgatena bhāṣitaḥ |	དེ་བཞིན་གཤེགས་པས་དེ་དངོས་པོ་མ་མཆིས་པར་གསུངས་པའི་སླད་དུ་སྟེ༏་དེས་ན་།
 tenocyate ātmabhāva iti |	ལུས་ཞེས་བགྱིའོ་༎
 na hi sa bhāvaḥ |	དེ་དངོས་པོ་མ་མཆིས་པར་དེ་བཞིན་གཤེགས་པས་གསུངས་ཏེ་།
 tenocyate ātmabhāva iti | || vaj 11; folio 37r3-38r2 (cz 36|13-37|10; p 181|1-13)	དེས་ན་། ལུས་ཆེ་ཞེས་བགྱིའོ་༎
 bhagavān āha |	བཅོམ་ལྡན་འདས་ཀྱིས་བཀའ་སྩལ་པ་།
 tat kiṃ manyase subhūte yāvaṃtyo gaṃgānadyāṃ vālukās tāvaṃtya eva gaṃgānadyo bhaveyuḥ |	རབ་འབྱོར༏་འདི་ཇི་སྙམ་དུ་སེམས་། གངགའའི་ཀླུང་གི་བྱེ་མ་ཇི་སྙེད་པ་གངགའའི་ཀླུང་ཡང་དེ་སྙེད་ཁོ་ནར་གྱུར་ན་།
 api nu tāsu bahvyo vālukā bhaveyuḥ |	དེ་དག་གི་བྱེ་མ་གང་ཡིན་པ་དེ་དག་མང་བ་ཡིན་ནམ་།
 subhūtir āha |	རབ་འབྱོར་གྱིས་༄༢༢༢ཨ་༌༎ གསོལ་པ་། བཅོམ་ལྡན་འདས་།
 tā eva tāvad bhagavan bahvyo gaṃgānadyo bhaveyuḥ prāg eva yās tāsu vālukāḥ |	གངགའའི་ཀླུང་དེ་དག་ཉིད་ཀྱང་མང་ལགས་ན་། དེ་དག་གི་བྱེ་མ་ལྟ་སྨོས་ཀྱང་མི་འཚལ་།
 bhagavān āha |	བཅོམ་ལྡན་འདས་ཀྱིས་བཀའ་སྩལ་པ་། རབ་འབྱོར་། ཁྱོད་མོས་པར་བྱ་། ཁྱོད་ཀྱིས་ཁོང་དུ་ཆུད་པར་བྱའོ་༎
 ārocayāmi te subhūte prativedayāmi te yāvaṃtyas tāsu gaṃgānadīṣu vālukā bhaveyuḥ | tāvaṃtyo lokadhātavaḥ kaścid eva strī vā puruṣo vā saptaratnapratipūrṇaṃ kṛtvā tathāgatebhyo 'rhadbhyaḥ samyaksaṃbuddhebhyo dānaṃ dadyāt |	གངགའའི་ཀླུང་དེ་དག་གི་བྱེ་མ་ཇི་སྙེད་པ་དེ་སྙེད་ཀྱི་འཇིག་རྟེན་གྱི་ཁམས་ཀྱི་སྐྱེས་པའམ་། བུད་མེད་གང་ལ་ལ་ཞིག་གིས་རིན་པོ་ཆེ་སྣ་བདུན་གྱིས་རབ་ཏུ་གང་བར་བྱས་ཏེ་དེ་བཞིན་གཤེགས་པ་དགྲ་བཅོམ་པ་ཡང་དག་པར་རྫོགས་པའི་སངས་རྒྱས་རྣམས་ལ་སྦྱིན་པ་བྱིན་ན་། ། རབ་འབྱོར་།
 tat kiṃ manyase subhūte |	འདི་ཇི་སྙམ་དུ་སེམས་།
 api nu sā strī vā puruṣo vā tatonidānaṃ bahu puṇyaṃ prasunuyāt |	སྐྱེས་པའམ་བུད་མེད་དེ་། གཞི་དེ་ལས་བསོད་ནམས་མང་དུ་བསྐྱེད་དམ་།
 subhūtir āha |	རབ་འབྱོར་གྱིས་གསོལ་པ་།
 bahu bhagavan bahu sugata |	བཅོམ་ལྡན་འདས་། མང་ལགས་སོ་༎ བདེ་བར་གཤེགས་པ་།
 sā strī vā puruso vā tatonidānaṃ bahu puṇyaṃ prasunuyāt |	མང་ལགས་ཏེ༏་སྐྱེས་པའམ་བུད་མེད་དེ་། གཞི་དེ་ལས་བསོད་ནམས་མང་དུ་བསྐྱེད་དོ་༎
 bhagavān āha |	བཅོམ་ལྡན་འདས་ཀྱིས་བཀའ་སྩལ་པ་། རབ་འབྱོར་།
 yaś ca khalu punaḥ subhūte tāvaṃtyo lokadhātavaḥ saptaratnapratipūrṇaṃ kṛtvā dānaṃ dadyāt |	གང་གིས་འཇིག་རྟེན་གྱི་ཁམས་དེ་སྙེད་རིན་པོ་ཆེ་སྣ་བདུན་གྱིས་རབ་ཏུ་གང་བར་བྱས་ཏེ་དེ་བཞིན་གཤེགས་པ་དགྲ་བཅོམ་པ་ཡང་དག་པར་རྫོགས་པའི་སངས་རྒྱས་རྣམས་ལ་སྦྱིན་པ་བྱིན་པ་བས་། 
 yaś ceto dharmaparyāyād aṃtaśaś catuṣpadikām api gāthām udgṛhya parebhyo deśayet |	གང་གིས་ཆོས་ཀྱི་རྣམ་གྲངས་འདི་ལས་ཐ་ན་ཚིག་བཞི་པའི་ཚིགས་སུ་བཅད་པ་ཙམ་བཟུང་ནས་གཞན་དག་ལ་ཡང་བཤད་དེ་ཡང་དག་པར་རབ་ཏུ་བསྟན་ན་།
 ayaṃ tato bahutaraṃ puṇyaṃ prasunuyād aprameyam asaṃkhyeyam | vaj 12; folio 38r2-vl (cz 37|10-19; p 181|13-182|3)	དེ་ཉིད་དེའི་གཞི་དེ་ལས་བསོད་ནམས་ཆེས་༄༢༢༢བ་མང་དུ་གྲངས་མེད་དཔག་ཏུ་མེད་པ་བསྐྱེད་དོ་༎ ཡང་རབ་འབྱོར་།
 api tu khalu subhūte yasmin pṛthivīpradeśe ito dharmaparyāyād aṃtaśaś catuṣpadikām api gāthāṃ bhāṣyeta vā deśyeta vā sa pṛthivīpradeśaś caityabhūto bhavet |	ས་ཕྱོགས་གང་ན་ཆོས་ཀྱི་རྣམ་གྲངས་འདི་ལས་ཐ་ན་ཚིག་བཞི་པའི་ཚིགས་སུ་བཅད་པ་ཙམ་འདོན་ཏམ་། བཏོན་པའི་ས་ཕྱོགས་དེ་།
 sadevamānuṣāsurasya lokasya kaḥ punar vādaḥ subhūte ya imaṃ dharmaparyāyaṃ dhārayiṣyaṃti parameṇa te āścaryeṇa samanvāgatā bhaviṣyaṃti |	ལྷ་དང་། མི་དང་། ལྷ་མ་ཡིན་དུ་བཅས་པའི་འཇིག་རྟེན་གྱི་མཆོད་རྟེན་དུ་གྱུར་པ་ཡིན་ན་། སུ་ཞིག་ཆོས་ཀྱི་རྣམ་གྲངས་འདི་ལེན་པ་དང་། འཛིན་པ་དང་། ཀློག་པ་དང་། ཀུན་ཆུབ་པར་བྱེད་པ་དང་། ཚུལ་བཞིན་དུ་ཡིད་ལ་བྱེད་པ་དེ་། ངོ་མཚར་རབ་དང་ལྡན་པར་གྱུར་པ་ལྟ་ཅི་སྨོས་།
 tasmiṃś ca pṛthivīpradeśe śāstā viharaty anyatarānyataro vā gurusthānīyaḥ | vaj 13a; folio 38vl-5 (cz 37|20-38|2; p 182|3-8)	ས་ཕྱོགས་དེ་ན་སྟོན་པ་ཡང་བཞུགས་ཏེ་། བླ་མའི་གནས་གཞན་དག་ཀྱང་གནས་སོ་༎
 evam ukte āyuṣmān subhūtir bhagavaṃtam etad avocat |	དེ་སྐད་ཅེས་བཀའ་སྩལ་པ་དང་། བཅོམ་ལྡན་འདས་ལ་ཚེ་དང་ལྡན་པ་རབ་འབྱོར་གྱིས་འདི་སྐད་ཅེས་གསོལ་ཏོ་༎
 ko nāmāyaṃ bhagavan dharmaparyāyaḥ kathaṃ cainaṃ dhārayāmi |	བཅོམ་ལྡན་འདས་། ཆོས་ཀྱི་རྣམ་གྲངས་འདིའི་མིང་ཅི་ལགས་། ཇི་ལྟར་གཟུང་བར་བགྱི་།
 evam ukte bhagavān āyuṣmaṃtaṃ subhūtim etad avocat |	དེ་སྐད་ཅེས་གསོལ་པ་དང་། བཅོམ་ལྡན་འདས་ཀྱིས་ཚེ་དང་ལྡན་པ་རབ་འབྱོར་ལ་འདི་སྐད་ཅེས་བཀའ་སྩལ་ཏོ་༎ རབ་འབྱོར་།
 prajñāpāramitā nāmāyaṃ subhūte dharmaparyāyaḥ |	ཆོས་ཀྱི་རྣམ་གྲངས་འདི་ཤེས་རབ་ཀྱི་ཕ་རོལ་ཏུ་ཕྱིན་པ་ཞེས་བྱ་སྟེ་།
 evam cainaṃ dhāraya |	འདི་དེ་ལྟར་ཟུངས་ཤིག་།
 tat kasya hetoḥ |	དེ་ཅིའི་ཕྱིར་ཞེ་ན་། རབ་འབྱོར་།
 yaiva subhūte prajñāpāramitā tathāgatena bhāṣitā |	དེ་བཞིན་གཤེགས་པས་ཤེས་རབ་ཀྱི་ཕ་རོལ་ཏུ་ཕྱིན་པ་གང་གསུངས་པ་དེ་ཉིད་ཕ་རོལ་ཏུ་ཕྱིན་པ་མེད་པའི་ཕྱིར་ཏེ་། དེས་ན་།
 saivāpāramitā | vaj 13b; folio 38v5-39rl (cz 38|3-6; pl82|8-10)	ཤེས་རབ་ཀྱི་ཕ་རོལ་ཏུ་ཕྱིན་པ་ཞེས་བྱའོ་༎
 tat kiṃ manyase subhūte api nu sa kaścid dharmo tathāgatena bhāṣitaḥ |	རབ་འབྱོར་། འདི་ཇི་སྙམ་དུ་སེམས་། དེ་བཞིན་གཤེགས་པས་གང་གསུངས་པའི་ཆོས་དེ་གང་༄༢༢༣ཨ་༌༎ ཡང་ཡོད་དམ་།
 subhūtir āha | no hīdaṃ bhagavan |	རབ་འབྱོར་གྱིས་གསོལ་པ་། བཅོམ་ལྡན་འདས་།
 na sa kaścid bhagavaṃ dharmo yaḥ tathāgatena bhāṣitaḥ | vaj 13c; folio 39rl-6 (cz 38|7-15; g 5al-2; p182|10-15)	དེ་བཞིན་གཤེགས་པས་གང་གསུངས་པའི་ཆོས་དེ་དག་གང་ཡང་མ་མཆིས་སོ་༎ བཅོམ་ལྡན་འདས་ཀྱིས་བཀའ་སྩལ་པ་།
 yāvataḥ subhūte tṛsāhasramahāsāhasryāṃ lokadhātau pṛthivīrajaḥ kaccit tad bahu bhavet |	རབ་འབྱོར་། འདི་ཇི་སྙམ་དུ་སེམས་། སྟོང་གསུམ་གྱི་སྟོང་ཆེན་པོའི་འཇིག་རྟེན་གྱི་ཁམས་ན་སའི་རྡུལ་ཕྲ་རབ་ཇི་སྙེད་ཡོད་པ་དེ་མང་བ་ཡིན་ནམ་།
 subhūtir āha |	རབ་འབྱོར་གྱིས་གསོལ་པ་། བཅོམ་ལྡན་འདས་།
 bahu bhagavans tat pṛthivīrajo bhavet | yat tad bhagavan |	སའི་རྡུལ་དེ་མང་ལགས་སོ་༎ བདེ་བར་གཤེགས་པ་། མང་ལགས་སོ་༎ དེ་ཅིའི་སླད་དུ་ཞེ་ན་། བཅོམ་ལྡན་འདས་། སའི་རྡུལ་གང་ལགས་པ་དེ་།
 pṛthivīrajaḥ tathāgatena bhāṣitaḥ arajaḥ sa tathāgatena bhāṣitaḥ |	རྡུལ་མ་མཆིས་པར་དེ་བཞིན་གཤེགས་པས་གསུངས་པའི་སླད་དུ་སྟེ་།
 tad ucyate pṛthivīraja iti |	དེས་ན་། སའི་རྡུལ་ཞེས་བགྱིའོ་༎
 yā sā lokadhātur adhātuḥ sā tathāgatena bhāṣitaḥ |	འཇིག་རྟེན་གྱི་ཁམས་གང་ལགས་པ་དེ་ཁམས་མ་མཆིས་པར་དེ་བཞིན་གཤེགས་པས་གསུངས་ཏེ་།
 tad ucyate lokadhātur iti | || vaj 13d; folio 39r6-v4 (cz 38|16-24; g 5a2-3; p 182|15-20)	དེས་ན་། འཇིག་རྟེན་གྱི་ཁམས་ཞེས་བགྱིའོ་༎
 bhagavān āha |	བཅོམ་ལྡན་འདས་ཀྱིས་བཀའ་སྩལ་པ་། རབ་འབྱོར་།
 tat kiṃ manyase subhūte dvātṛṃśadbhir mahāpuruṣalakṣaṇaiḥ tathāgato 'rhan samyaksaṃbuddho draṣṭavyaḥ |	འདི་ཇི་སྙམ་དུ་སེམས་། སྐྱེས་བུ་ཆེན་པོའི་མཚན་སུམ་ཅུ་རྩ་གཉིས་པོ་དེ་དག་གིས་དེ་བཞིན་གཤེགས་པ་དགྲ་བཅོམ་པ་ཡང་དག་པར་རྫོགས་པའི་སངས་རྒྱས་སུ་བལྟའམ་།
 subhūtir āha |	རབ་འབྱོར་གྱིས་གསོལ་པ་།
 no hīdaṃ bhagavan |	བཅོམ་ལྡན་འདས་། དེ་ནི་། མ་ལགས་སོ་༎
 tat kasya hetoḥ |	དེ་ཅིའི་སླད་དུ་ཞེ་ན་།
 yāni tāni bhagavan dvātṛṃśanmahāpuraṣalakṣaṇāni tathāgatena bhāṣitāny alakṣaṇāni tathāgatena bhāṣitāni tasmād ucyaṃte dvātṛṃśanmahāpuruṣalakṣaṇānīti vaj 13e; folio 39v4-40rl (cz 39|1-8; g 5a3-5; p 182|20-183|3)	སྐྱེས་བུ་ཆེན་པོའི་མཚན་སུམ་ཅུ་རྩ་གཉིས་པོ་གང་དག་དེ་བཞིན་གཤེགས་པས་གསུངས་པ་དེ་དག་མཚན་མ་མཆིས་པར་དེ་བཞིན་༄༢༢༣བ་གཤེགས་པས་གསུངས་པའི་སླད་དུ་སྟེ་། དེས་ན་། དེ་བཞིན་གཤེགས་པའི་མཚན་སུམ་ཅུ་རྩ་གཉིས་ཞེས་བགྱིའོ་༎
 bhagavān āha |	བཅོམ་ལྡན་འདས་ཀྱིས་བཀའ་སྩལ་པ་། ཡང་རབ་འབྱོར་།
 yaś ca khalu punaḥ subhūte strī vā puruṣo vā gaṃgānadīvālukopamān ātmabhāvān parityajet |	སྐྱེས་པའམ་བུད་མེད་གང་གིས་ལུས་གངགའའི་ཀླུང་གི་བྱེ་མ་སྙེད་ཡོངས་སུ་བཏང་བ་བས་།
 yaś ceto dharmaparyāyāc catuṣpadikām api gāthām udgṛhya parebhyo deśayet |	གང་གིས་ཆོས་ཀྱི་རྣམ་གྲངས་འདི་ལས་ཐ་ན་ཚིག་བཞི་པའི་ཚིགས་སུ་བཅད་པ་ཙམ་བཟུང་སྟེ་གཞན་དག་ལ་ཡང་བསྟན་ན་།
 ayaṃ tatonidānaṃ bahutaraṃ puṇyaṃ prasunuyād aprameyam asaṃkhyeyam | vaj 14a; folio 40rl-vl (cz 39|9-21; g 5a5-5bl; p 183|3-10 )	དེ་གཞི་དེ་ལས་བསོད་ནམས་ཆེས་མང་དུ་གྲངས་མེད་དཔག་ཏུ་མེད་པ་བསྐྱེད་དོ་༎
 atha khalv āyuṣmān subhūtiḥ dharmapravegenāśrūṇi prāmuṃcat | pravartayaṃ so 'śrūṇi parimārjya bhagavaṃtam etad avocat |	དེ་ནས་ཚེ་དང་ལྡན་པ་རབ་འབྱོར་ཆོས་ཀྱི་ཤུགས་ཀྱིས་མཆི་མ་ཕྱུང་སྟེ༏་དེས་མཆིམ་ཕྱིས་ནས་བཅོམ་ལྡན་འདས་ལ་འདི་སྐད་ཅེས་གསོལ་ཏོ་༎ འདི་ལྟར་ཆོས་ཀྱི་རྣམ་གྲངས་འདི་དེ་བཞིན་གཤེགས་པས་གསུངས་པ་ནི་།
 āścaryaṃ bhagavan |	བཅོམ་ལྡན་འདས་། ངོ་མཚར་ལགས་སོ་༎ བདེ་བར་གཤེགས་པ་།
 paramāścaryaṃ sugata |	ངོ་མཚར་ལགས་སོ་༎ བཅོམ་ལྡན་འདས་།
 yāvad ayaṃ dharmaparyāyaḥ tathāgatena bhāṣitaḥ | yato me bhagavan | jñānam utpannaṃ na mayā jātv eva dharmaparyāyaḥ śrutapūrvaḥ |	བདག་གི་ཡེ་ཤེས་སྐྱེས་ཚུན་ཆད་བདག་གིས་ཆོས་ཀྱི་རྣམ་གྲངས་འདི་སྔོན་ནམ་ཡང་མ་ཐོས་སོ་༎ བཅོམ་ལྡན་འདས་།
 parameṇa te bhagavan | āścaryeṇa samanvāgatā bhaviṣyaṃti ya iha sūtre bhāṣyamāṇe bhūtasaṃjñām utpādayiṣyaṃti | yā caiṣā bhagavan |	མདོ་བཤད་པ་འདི་ལ་གང་དག་ཡང་དག་པར་འདུ་ཤེས་བསྐྱེད་པར་འགྱུར་བའི་སེམས་ཅན་དེ་དག་ནི་། ངོ་མཚར་རབ་དང་ལྡན་པར་འགྱུར་ལགས་སོ་༎ དེ་ཅིའི་སླད་དུ་ཞེ་ན༏་བཅོམ་ལྡན་འདས་།
 bhūtasaṃjñā saivāsaṃjñā tasmāt tathāgato bhāṣate bhūtasaṃjñā bhūtasaṃjñeti | vaj 14b; folio 40vl-4 (cz 40|1-8; g 5bl-2; p 183|10-16)	ཡང་དག་པར་འདུ་ཤེས་པ་གང་ལགས་པ་དེ་ཉིད་འདུ་ཤེས་མ་མཆིས་པའི་སླད་དུ་སྟེ་། དེ་བས་ན་། ཡང་དག་པར་འདུ་ཤེས་ཡང་དག་པར་འདུ་ཤེས་ཞེས་དེ་༄༢༢༤ཨ་༌༎ བཞིན་གཤེགས་པས་གསུངས་སོ་༎
 na mama bhagavann āścaryaṃ yad ahaṃ dharmaparyāyaṃ bhāṣyamāṇam avakalpayāmy adhimucyāmi |	བཅོམ་ལྡན་འདས་། བདག་ཆོས་ཀྱི་རྣམ་གྲངས་འདི་བཤད་པ་ལ་རྟོག་ཅིང་མོས་པ་ནི་། བདག་ལ་མོས་པ་མ་ལགས་ཀྱི༏་བཅོམ་ལྡན་འདས་། སླད་མའི་ཚེ་སླད་མའི་དུས་ལྔ་བརྒྱ་ཐ་མ་ལ་སེམས་ཅན་གང་དག་ཆོས་ཀྱི་རྣམ་གྲངས་འདི་ལེན་པ་དང་། 
 ye te bhagavann imaṃ dharmaparyāyam udgṛhīṣyaṃti paryavāpsyaṃti dhārayiṣyaṃti |	འཛིན་པ་དང་། ཀློག་པ་དང་། ཀུན་ཆུབ་པར་བགྱིད་པ་དེ་དག་ནི་། ངོ་མཚར་རབ་དང་ལྡན་པར་འགྱུར་ལགས་སོ་༎ ཡང་བཅོམ་ལྡན་འདས་།
 te paramāścaryasamanvāgatā bhaviṣyaṃti | || vaj 14c; folio 40v4-41rl (cz 40|9-15; g 5b2-3; p 183|16-184|3)	དེ་དག་ནི་།
 api tu khalu punaḥ bhagavan na teṣām ātmasaṃjñā pravartsyate |	བདག་ཏུ་འདུ་ཤེས་འཇུག་པར་མི་འགྱུར་།
 na satvasaṃjñā na jīvasaṃjñā | na pudgalasaṃjñā pravartsyate |	སེམས་ཅན་དུ་འདུ་ཤེས་པ་དང་། སྲོག་ཏུ་འདུ་ཤེས་པ་དང་། གང་ཟག་ཏུ་འདུ་ཤེས་འཇུག་པར་མི་འགྱུར་ལགས་སོ་༎
 tat kasya hetoḥ yāsāv ātmasaṃjñā saivāsaṃjñā |	དེ་ཅིའི་སླད་དུ་ཞེ་ན་།
 yā satvasaṃjñā jīvasaṃjñā pudgalasaṃjñā saivāsaṃjñā |	བཅོམ་ལྡན་འདས་། བདག་ཏུ་འདུ་ཤེས་པ་དང་། སེམས་ཅན་དུ་འདུ་ཤེས་པ་དང་། སྲོག་ཏུ་འདུ་ཤེས་པ་དང་། གང་ཟག་ཏུ་འདུ་ཤེས་པ་གང་ལགས་པ་དེ་དག་ཉིད་འདུ་ཤེས་མ་མཆིས་པའི་སླད་དུའོ་༎
 tat kasya hetoḥ |	དེ་ཅིའི་སླད་དུ་ཞེ་ན་།
 sarvasaṃjñāpagatā hi buddhā bhagavaṃtaḥ || vaj 14d; folio 41rl-vl (cz 40|16-41|4; g 5b3-5; p 184|4-9)	སངས་རྒྱས་བཅོམ་ལྡན་འདས་རྣམས་ནི་། འདུ་ཤེས་ཐམས་ཅད་དང་བྲལ་བའི་སླད་དུའོ་༎
 evam ukte bhagavān āyuṣmaṃtaṃ subhūtim etad avocat |	དེ་སྐད་ཅེས་གསོལ་པ་དང་། བཅོམ་ལྡན་འདས་ཀྱིས་ཚེ་དང་ལྡན་པ་རབ་འབྱོར་ལ་འདི་སྐད་ཅེས་བཀའ་སྩལ་ཏོ་༎
 evam etat subhūte evam etat subhūte paramāścaryasamanvāgatās te satvā bhaviṣyaṃti |	རབ་འབྱོར༏་དེ་དེ་བཞིན་ནོ་༎ དེ་དེ་བཞིན་ཏེ་།
 ya iha sūtre bhāṣyamāṇe śrutvā nottrasiṣyaṃti | na saṃtrasiṣyaṃti | na saṃtrāsam āpatsyaṃte |	མདོ་འདི་བཤད་པ་འདི་ལ་གང་དག་མི་སྐྲག་མི་དང་བཞིང་དངང་བར་མི་འགྱུར་བའི་སེམས་ཅན་དེ་དག་ནི་། ངོ་མཚར་རབ་དང་ལྡན་པར་༄༢༢༤བ་འགྱུར་རོ་༎
 tat kasya hetoḥ |	དེ་ཅིའི་ཕྱིར་ཞེ་ན་། རབ་འབྱོར་།
 paramapāramiteyaṃ subhūte tathāgatena bhāṣitā |	ཕ་རོལ་ཏུ་ཕྱིན་པ་དམ་པ་འདི་ནི་། དེ་བཞིན་གཤེགས་པས་གསུངས་ཏེ་།
 yāṃ ca tathāgataḥ paramapāramitāṃ bhāṣate tām aparimāṇā buddhā bhagavaṃto bhāṣaṃte |	ཕ་རོལ་ཏུ་ཕྱིན་པ་དམ་པ་གང་དག་དེ་བཞིན་གཤེགས་པས་གསུངས་པ་དེ༏་སངས་རྒྱས་བཅོམ་ལྡན་འདས་དཔག་ཏུ་མེད་པ་རྣམས་ཀྱིས་ཀྱང་གསུངས་པའི་ཕྱིར་ཏེ་། 
 tenocyate paramapāramiteti | vaj 14e; folio 41vl-42v3 (cz 41|5-42|5; g 5b5-7; p 184|10-185|4)	དེས་ན་། ཕ་རོལ་ཏུ་ཕྱིན་པ་དམ་པ་ཞེས་བྱའོ་༎ ཡང་རབ་འབྱོར་།
 api tu khalu punaḥ subhūte yā tathāgatasya kṣāṃtipāramitā saivāpāramitā |	དེ་བཞིན་གཤེགས་པའི་བཟོད་པའི་ཕ་རོལ་ཏུ་ཕྱིན་པ་གང་ཡིན་པ་དེ་ཉིད་ཕ་རོལ་ཏུ་ཕྱིན་པ་མེད་དོ་༎ 
 tat kasya hetoḥ |	དེ་ཅིའི་ཕྱིར་ཞེ་ན་། རབ་འབྱོར་། གང་གི་ཚེ་ཀ་ལིངཀའི་རྒྱལ་པོས་ངའི་ཡན་ལག་དང་། ཉིང་ལག་རྣམ་པར་བཅད་པར་གྱུར་པ་དེའི་ཚེ་ང་ལ་བདག་ཏུ་འདུ་ཤེས་སམ་། སེམས་ཅན་དུ་འདུ་ཤེས་སམ་།
 yadā me subhūte kaliṃgarājā aṃgapratyaṃgāny acchetsīn nāsīn me tasmin samaye ātmasaṃjñā vā satvasaṃjñā vā jīvasaṃjñā vā pudgalasaṃjñā vā na me kācit saṃjñā nāsaṃjñā babhūva |	སྲོག་ཏུ་འདུ་ཤེས་སམ་། གང་ཟག་ཏུ་འདུ་ཤེས་ཀྱང་མ་བྱུང་ཞིང་། ང་ལ་འདུ་ཤེས་ཅི་ཡང་མེད་ལ་། འདུ་ཤེས་མེད་པར་གྱུར་པ་ཡང་མ་ཡིན་པའི་ཕྱིར་རོ་༎
 tat kasya hetoḥ |	དེ་ཅིའི་ཕྱིར་ཞེ་ན་། རབ་འབྱོར་།
 sacet subhūte mama tasmin samaye ātmasamjñābhaviṣyat |	གལ་ཏེ་དེའི་ཚེ་བདག་ཏུ་འདུ་ཤེས་བྱུང་ན་།
 vyāpādasaṃjñāpi me 'bhaviṣyat tasmin samaye |	དེའི་ཚེ་གནོད་སེམས་ཀྱི་འདུ་ཤེས་ཀྱང་འབྱུང་ལ་། སེམས་ཅན་དུ་འདུ་ཤེས་པ་དང་། སྲོག་ཏུ་འདུ་ཤེས་པ་དང་། གང་ཟག་ཏུ་འདུ་ཤེས་པ་བྱུང་ན་།
 abhijānāmy ahaṃ subhūte atīte 'dhvani paṃca jātiśatāni yad ahaṃ kṣāṃtivādī riṣir abhū tadāpi me nātmasaṃjñā babhūva |	དེའི་ཚེ་གནོད་སེམས་ཀྱི་འདུ་ཤེས་ཀྱང་འབྱུང་བའི་ཕྱིར་རོ་༎ རབ་འབྱོར་། ངས་མངོན་པར་ཤེས་ཏེ༏་འདས་པའི་དུས་ན་ང་ཚེ་རབས་ལྔ་བརྒྱར་བཟོད་པར་སྨྲ་བ་ཞེས་བྱ་བའི་དྲང་སྲོང་དུ་གྱུར་པ་དེ་ན་ཡང་ང་ལ་བདག་ཏུ་འདུ་ཤེས་མ་བྱུང་།
 na satvasaṃjñā na jīvasaṃjñā na pudgalasaṃjñā |	སེམས་ཅན་དུ་འདུ་ཤེས་པ་དང་། སྲོག་ཏུ་འདུ་ཤེས་༄༢༢༥ཨ་༌༎ པ་དང་། གང་ཟག་ཏུ་འདུ་ཤེས་པ་མ་བྱུང་ངོ་༎
 tasmāt tarhi subhūte bodhisatvena mahāsatvena sarvasaṃjñā vivarjayitvānuttarāyāṃ samyaksaṃbodhau cittam utpādayitavyam |	རབ་འབྱོར་། དེ་ལྟ་བས་ན་། བྱང་ཆུབ་སེམས་དཔའ་སེམས་དཔའ་ཆེན་པོས་འདུ་ཤེས་ཐམས་ཅད་རྣམ་པར་སྤངས་ཏེ་བླ་ན་མེད་པ་ཡང་དག་པར་རྫོགས་པའི་བྱང་ཆུབ་ཏུ་སེམས་བསྐྱེད་པར་བྱའོ་༎ 
 na rūpapratiṣṭhitaṃ cittam utpādayitavyam |	གཟུགས་ལ་མི་གནས་པར་སེམས་བསྐྱེད་པར་བྱའོ་༎
 na śabdagandharasaspraṣṭavyapratiṣṭhitaṃ cittam utpādayitavyam | na dharmapratiṣṭhitaṃ cittam utpādayitavyam |	སྒྲ་དང་། དྲི་དང་། རོ་དང་། རེག་བྱ་དང་། ཆོས་ལའང་མི་གནས་པར་སེམས་བསྐྱེད་པར་བྱའོ་༎
 nādharmapratiṣṭhitaṃ cittam utpādayitavyam |	ཆོས་མེད་པ་ལའང་མི་གནས་པར་སེམས་བསྐྱེད་པར་བྱའོ་༎
 na kvacitpratiṣṭhitaṃ cittam utpādayitavyam |	ཅི་ལའང་མི་གནས་པར་སེམས་བསྐྱེད་པར་བྱའོ་༎
 tat kasmād dhetoḥ |	དེ་ཅིའི་ཕྱིར་ཞེ་ན་།
 yat pratiṣṭhitaṃ tad evāpratiṣṭhitaṃ |	གནས་པ་གང་ཡིན་པ་དེ་ཉིད་མི་གནས་པའི་ཕྱིར་ཏེ་། དེ་བས་ན་། དེ་བཞིན་གཤེགས་པས་འདི་སྐད་དུ་།
 tasmād eva tathāgato bhāṣate rūpāpratiṣṭhitena dānaṃ dātavyam | vaj 14f; folio 42v3-43rl (cz 42|5-12; p 185|4-8)	བྱང་ཆུབ་སེམས་དཔས་མི་གནས་པར་སྦྱིན་པ་སྦྱིན་པར་བྱའོ་༎
 api tu khalu punaḥ subhūte bodhisatvenaivaṃ dānaparityāgaḥ parityajyaḥ sarvasatvānām arthāya |	ཞེས་གསུངས་སོ་༎ ཡང་རབ་འབྱོར་། བྱང་ཆུབ་སེམས་དཔས་འདི་ལྟར་སེམས་ཅན་ཐམས་ཅད་ཀྱི་དོན་གྱི་ཕྱིར་སྦྱིན་པ་ཡོངས་སུ་གཏང་བར་བྱའོ་༎ 
 yaiva ca satvasaṃjñā sa evāsaṃjñā |	སེམས་ཅན་དུ་འདུ་ཤེས་པ་གང་ཡིན་པ་དེ་ཉིད་ཀྱང་འདུ་ཤེས་མེད་པ་སྟེ་།
 ya eva te sarvasatvāḥ tathāgatena bhāṣitāḥ ta evāsatvāḥ |	དེ་བཞིན་གཤེགས་པས་སེམས་ཅན་ཐམས་ཅད་ཅེས་གང་གསུངས་པ་དེ་བདག་ཉིད་ཀྱང་མེད་པའོ་༎ དེ་ཅིའི་ཕྱིར་ཞེ་ན་། རབ་འབྱོར་།
 bhūtavādī subhūte tathāgataḥ satyavādī tathāvādī tathāgato na vitathāvādī tathāgato | vaj 14g; folio 43rl-6 (cz 42|12-20; p 185|8-14)	དེ་བཞིན་གཤེགས་པ་ནི་། ཡང་དག་པར་གསུང་པ་། བདེན་པར་གསུང་བ་། དེ་བཞིན་ཉིད་དུ་གསུང་བ་སྟེ་། དེ་བཞིན་གཤེགས་པ་ནི་། མ་ནོར་བ་དེ་བཞིན་ཉིད་གསུང་བའི་ཕྱིར་རོ་༎ ༄༢༢༥བ་ཡང་རབ་འབྱོར་།
 api tu khalu punaḥ subhūte yaḥ tathāgatena dharmo 'bhisaṃbuddho deśito vā na tatra satyaṃ na mṛṣā |	དེ་བཞིན་གཤེགས་པས་ཆོས་གང་མངོན་པར་རྫོགས་པར་སངས་རྒྱས་པའམ་། བསྟན་པ་དེ་ལ་ནི་། བདེན་པ་ཡང་མེད་། རྫུན་པ་ཡང་མེད་དོ་༎
 tad yathāpi nāma subhūte puruṣo 'ndhakārapraviṣṭaḥ |	རབ་འབྱོར་། འདི་ལྟ་སྟེ༏་དཔེར་ན་།
 evaṃ vastupatito bodhisatvo draṣṭavyo yo vastupatitaṃ dānaṃ parityajati |	མིག་དང་ལྡན་པའི་མི་ཞིག་མུན་པར་ཞུགས་ན་ཅི་ཡང་མི་མཐོང་བ་དེ་བཞིན་དུ་གང་དངོས་པོར་ལྷུང་བས་སྦྱིན་པ་ཡོངས་སུ་གཏོང་བའི་བྱང་ཆུབ་སེམས་དཔར་བལྟའོ༏་༏རབ་འབྱོར་། འདི་ལྟ་སྟེ་།
 tad yathāpi nāma subhūte cakṣuṣmān puruṣo vibhātāyāṃ rātryāṃ sūrye 'bhyudgate nānāvidhāni rūpāṇi paśyet | evaṃ bodhisatvo draṣṭavyo yo vastvapatitaṃ dānaṃ parityajati | vaj 14h; folio 43r6-v3 (cz 42|20-43|7; p 185|14-18)	དཔེར་ན་། ནམ་ལངས་ཏེ་ཉི་མ་ཤར་ནས་མིག་དང་ལྡན་པའི་མིས་གཟུགས་རྣམ་པ་སྣ་ཚོགས་དག་མཐོང་བ་དེ་བཞིན་དུ་གང་དངོས་པོར་མ་ལྷུང་བས་སྦྱིན་པ་ཡོངས་སུ་གཏོང་བའི་བྱང་ཆུབ་སེམས་དཔར་བལྟའོ་༎ ཡང་རབ་འབྱོར་། རིགས་ཀྱི་བུའམ་།
 api tu khalu punaḥ subhūte ye kulaputrā vā kuladuhitaro vā imaṃ dharmaparyāyam udgrahīṣyaṃti | dhārayiṣyaṃti | vācayiṣyaṃti | paryavāpsyaṃti |	རིགས་ཀྱི་བུ་མོ་གང་དག་ཆོས་ཀྱི་རྣམ་གྲངས་འདི་ལེན་པ་དང་། འཛིན་པ་དང་། ཀློག་པ་དང་། ཀུན་ཆུབ་པར་བྱེད་པ་དང་། གཞན་དག་ལ་ཡང་རྒྱ་ཆེར་ཡང་དག་པར་རབ་ཏུ་སྟོན་པ་དེ་དག་ནི་།
 jñātās te subhūte tathāgatena dṛṣṭās te subhūte tathāgatena buddhās te tathāgatena |	དེ་བཞིན་གཤེགས་པས་མཁྱེན་། དེ་དག་ནི་། དེ་བཞིན་གཤེགས་པས་གཟིགས་ཏེ་།
 sarve te satvāḥ aprameyaṃ puṇyaskandhaṃ prasaviṣyaṃti | vaj 15a; folio 43v3-44r5 (cz 43|8-19; p 185|18-186|4)	སེམས་ཅན་དེ་དག་ཐམས་ཅད་ནི་། བསོད་ནམས་ཀྱི་ཕུང་པོ་དཔག་ཏུ་མེད་པ་བསྐྱེད་པར་འགྱུར་རོ་༎ ཡང་རབ་འབྱོར་།
 yaś ca khalu punaḥ subhūte strī vā puruṣo vā pūrvāhṇakālasamaye gaṃgānadīvālukopamān ātmabhāvān parityajet | madhyāhṇakālasamaye sāyāhṇakālasamaye gaṃgānadīvālukopamān ātmabhāvān parityajet |	སྐྱེས་པའམ་། བུད་མེད་གང་ཞིག་སྔ་དྲོའི་དུས་ཀྱི་ཚེ་ལུས་གངགའའི་ཀླུང་གི་བྱེ་མ་སྙེད་ཡོངས་སུ་གཏོང་ལ་། ཕྱེད་ཀྱི་དུས་དང་། ཕྱི་དྲོའི་དུས་ཀྱི་ཚེ་ཡང་ལུས་གངགའའི་ཀླུང་གི་བྱེ་མ་སྙེད་ཡོངས་སུ་གཏོང་སྟེ་། རྣམ་གྲངས་འདི་ལྟ་༄༢༢༦ཨ་༌༎
 anena paryāyeṇa kalpakoṭīnayutaśatasahasrāṇy ātmabhāvān parityajet |	བུར་བསྐལ་པ་བྱེ་བ་ཁྲག་ཁྲིག་འབུམ་ཕྲག་དུ་མར་ལུས་ཡོངས་སུ་གཏོང་བ་བས་།
 yaś cemaṃ dharmaparyāyaṃ śrutvā |	གང་གིས་ཆོས་ཀྱི་རྣམ་གྲངས་འདི་ཐོས་ནས་མི་སྤོང་ན་།
 na pratikṣiped ayam eva tatonidānaṃ bahutaraṃ puṇyaskandhaṃ prasunuyāt | aprameyam asaṃkhyeyam | kaḥ punar vādaḥ yo iikhitvodgṛhṇīyāt | dhārayet |	དེ་ཉིད་གཞི་དེ་ལས་བསོད་ནམས་ཆེས་མང་དུ་གྲངས་མེད་དཔག་ཏུ་མེད་པ་བསྐྱེད་ན་།
 vācayet | paryavāpnuyāt | parebhyaś ca vistareṇa saṃprakāśayet | vaj 15b; folio 44r5-45r4 (cz 43|19-44|13; g 7al-2; p 186|5-17)	གང་གིས་ཡི་གེར་བྲིས་ནས་ལེན་པ་དང་། འཛིན་པ་དང་། ཀློག་པ་དང་། ཀུན་ཆུབ་པར་བྱེད་པ་དང་། གཞན་དག་ལ་ཡང་རྒྱ་ཆེར་ཡང་དག་པར་རབ་ཏུ་སྟོན་པ་ལྟ་ཅི་སྨོས་།
 api tu subhūte aciṃtyo 'tulyo 'yaṃ dharmaparyāyaḥ |	ཡང་རབ་འབྱོར་། ཆོས་ཀྱི་རྣམ་གྲངས་འདི་ནི་། བསམ་གྱིས་མི་ཁྱབ་ཅིང་མཚུངས་པ་མེད་དེ་།
 ayaṃ ca dharmaparyāyaḥ tathāgatena bhāṣitaḥ agrayānasaṃprasthitānāṃ satvānām arthāya |	ཆོས་ཀྱི་རྣམ་གྲངས་འདི་ནི༏་ཐེག་པ་མཆོག་ལ་ཡང་དག་པར་ཞུགས་པའི་སེམས་ཅན་རྣམས་ཀྱི་དོན་དང་། 
 śreṣṭhayānasaṃprasthitānāṃ satvānām arthāya |	ཐེག་པ་ཕུལ་དུ་ཕྱིན་པ་ལ་ཡང་དག་པར་ཞུགས་པའི་སེམས་ཅན་རྣམས་ཀྱི་དོན་གྱི་ཕྱིར་དེ་བཞིན་གཤེགས་པས་གསུངས་སོ་༎
 ye imaṃ dharmaparyāyam udgrahīṣyaṃti | dhārayiṣyaṃti | vācayiṣyaṃti | paryavāpsyaṃti |	གང་དག་ཆོས་ཀྱི་རྣམ་གྲངས་འདི་ལེན་པ་དང་། འཛིན་པ་དང་། ཀློག་པ་དང་། ཀུན་ཆུབ་པར་བྱེད་པ་དང་། གཞན་དག་ལ་ཡང་རྒྱ་ཆེར་ཡང་དག་པར་རབ་ཏུ་སྟོན་པ་དེ་དག་ནི་།
 jñātās te subhūte tathāgatena dṛṣṭās te subhūte tathāgatena |	དེ་བཞིན་གཤེགས་པས་མཁྱེན་། དེ་དག་ནི་། དེ་བཞིན་གཤེགས་པས་གཟིགས་ཏེ་།
 sarve te satvāḥ aprameyeṇa puṇyaskandhena samanvāgatā bhaviṣyaṃti |	སེམས་ཅན་དེ་དག་ཐམས་ཅད་ནི་། བསོད་ནམས་ཀྱི་ཕུང་པོ་དཔག་ཏུ་མེད་པ་དང་ལྡན་པར་འགྱུར་རོ་༎
 aciṃtyenātulyenāmāpyenāparimāṇena puṇyaskandhena samanvāgatā bhaviṣyaṃti |	བསོད་ནམས་ཀྱི་ཕུང་པོ་བསམ་གྱིས་མི་ཁྱབ་པ་དང་། མཚུངས་པ་མེད་པ་དང་། གཞལ་དུ་མེད་པ་དང་། ཚད་མེད་པ་དང་ལྡན་༄༢༢༦བ་པར་འགྱུར་ཏེ་། སེམས་ཅན་དེ་དག་ཐམས་ཅད་ངའི་བྱང་ཆུབ་ཕྲག་པ་ལ་ཐོགས་པར་འགྱུར་རོ་༎
 tat kasya hetoḥ |	དེ་ཅིའི་ཕྱིར་ཞེ་ན་། རབ་འབྱོར་།
 na hi śakyaṃ subhūte ayaṃ dharmo hīnādhimuktikaiḥ śrotum |	དམན་པ་ལ་མོས་པ་རྣམས་ཀྱིས་ཆོས་ཀྱི་རྣམ་གྲངས་འདི་མཉན་པར་མི་ནུས་ཏེ་། བདག་ཏུ་ལྟ་བ་རྣམས་ཀྱིས་མ་ཡིན་།
 nātmadṛṣṭikaiḥ na satvadṛṣṭikaiḥ na jīvadṛṣṭikaiḥ na pudgaladṛṣṭikaiḥ śakyaṃ śrotum udgrahītuṃ vā dhārayituṃ vā vācayituṃ vā paryavāptuṃ vā nedaṃ sthānaṃ vidyate | vaj 15c; folio 45r4-v2 (cz 44|13-18; g 7a2-3; p 186|17-20)	སེམས་ཅན་དུ་ལྟ་བ་རྣམས་ཀྱིས་མ་ཡིན་། སྲོག་ཏུ་ལྟ་བ་རྣམས་ཀྱིས་མ་ཡིན་ཞིང་། གང་ཟག་ཏུ་ལྟ་བ་རྣམས་ཀྱིས་མཉན་པ་དང་། བླང་བ་དང་། གཟུང་བ་དང་། ཀློག་པ་དང་། ཀུན་ཆུབ་པར་བྱེད་མི་ནུས་ཏེ་། དེ་ནི་། གནས་མེད་པའི་ཕྱིར་རོ་༎
 api tu subhūte yatra pṛthivīpradeśe idaṃ sūtraṃ prakāśayiṣyati | pūjanīyaḥ sa pṛthivīpradeśo bhaviṣyati |	ཡང་རབ་འབྱོར་། ས་ཕྱོགས་གང་ན་མདོ་སྡེ་འདི་སྟོན་པའི་ས་ཕྱོགས་དེ་།
 sadevamānuṣāsurasya lokasya vandanīyaḥ pradakṣiṇīkaraṇīyaś ca sa pṛthivīpradeśo bhaviṣyati |	ལྷ་དང་། མི་དང་། ལྷ་མ་ཡིན་དུ་བཅས་པའི་འཇིག་རྟེན་གྱིས་མཆོད་པར་འོས་པར་འགྱུར་རོ་༎ ས་ཕྱོགས་དེ་ཕྱག་བྱ་བར་འོས་པ་དང་། བསྐོར་བ་བྱ་བར་འོས་པར་ཡང་འགྱུར་རོ་༎
 caitya sa pṛthivīpradeśo bhaviṣyati | vaj 16a; folio 45v2-46rl (cz 44|18-45|6; g 7a3-5; p 186|20-187|3)	ས་ཕྱོགས་དེ་ནི་།
 ye te subhūte kulaputrā vā kuladuhitaro vā imān evaṃrūpāṃ sūtrāṃtān udgrahīsyaṃti dhārayiṣyaṃti paryavāpsyaṃti |	མཆོད་རྟེན་ལྟ་བུར་འགྱུར་རོ་༎ རབ་འབྱོར་། རིགས་ཀྱི་བུའམ་རིགས་ཀྱི་བུ་མོ་གང་དག་འདི་ལྟ་བུའི་མདོ་སྡེའི་ཚིག་འདི་དག་ལེན་པ་དང་། འཛིན་པ་དང་། ཀློག་པ་དང་། ཀུན་ཆུབ་པར་བྱེད་པ་དེ་དག་ནི་།
 te paribhūtā bhaviṣyaṃti suparibhūtāś ca bhaviṣyaṃti | ||	མནར་བར་འགྱུར་། ཤིན་ཏུ་མནར་བར་འགྱུར་རོ་༎ དེ་ཅིའི་ཕྱིར་ཞེ་ན་།
 yāni teṣāṃ satvānāṃ paurvajanmikāni karmāṇi kṛtāny apāyasaṃvartanīyāni dṛṣṭa eva dharme paribhūtatayā pūrvajanmikāny aśubhāni karmāṇi kṣapayiṣyaṃti	རབ་འབྱོར་། སེམས་ཅན་དེ་དག་གིས་ཚེ་རབས་སྔ་མའི་མི་དགེ་བའི་ལས་ངན་སོང་དུ་སྐྱེ་བར་འགྱུར་བ་གང་དག་བྱས་པ་དག་ཚེ་འདི་ཉིད་ལ་མནར་བས་། ཚེ་རབས་སྔ་མའི་མི་དགེ་བའི་ལས་དེ་དག་འབྱང་བར་འགྱུར་ཏེ་།
 buddhabodhiṃ ca prāpsyaṃti | vaj 16b; folio 46rl-v4 (cz 45|6-46|6; g 7a5-7b3; p 187|3-187|13)	སངས་རྒྱས་ཀྱི་བྱང་༄༢༢༧ཨ་༌༎ ཆུབ་ཀྱང་འཐོབ་པར་འགྱུར་བའི་ཕྱིར་རོ་༎ རབ་འབྱོར་།
 abhijānāmy ahaṃ subhūte atīte 'dhvani asaṃkhyeye kalpe asaṃkhyeyatare dīpaṃkarasya	ངས་མངོན་པར་ཤེས་ཏེ་། འདས་པའི་དུས་བསྐལ་པ་གྲངས་མེད་པའི་ཡང་ཆེས་གྲངས་མེད་པ་ན་། དེ་བཞིན་གཤེགས་པ་དགྲ་བཅོམ་པ་ཡང་དག་པར་རྫོགས་པའི་སངས་རྒྱས་མར་མེ་མཛད་ཀྱི་ཕ་རོལ་གྱི་ཡང་ཆེས་ཕ་རོལ་ན་།
 tathāgatasyārhataḥ samyaksaṃbuddhasya pareṇa parataraṃ caturaśītibuddhakoṭīnayutaśatasahasrāṇy abhūvan ye mayā ārādhitā ārādhayetvā na virādhitā |	སངས་རྒྱས་བྱེ་བ་ཁྲག་ཁྲིག་འབུམ་ཕྲག་བརྒྱད་ཅུ་རྩ་བཞི་དག་བྱུང་བ་ངས་མཉེས་པར་བྱས་ཏེ་། མཉེས་པར་བྱས་ནས་ཐུགས་མ་ཕྱུང་བར་བྱས་ཏེ་། རབ་འབྱོར་།
 yac ca mayā subhūte buddhā bhagavaṃtaḥ ārāgitā ārāgayetvā na virāgitā yac ca carime	སངས་རྒྱས་བཅོམ་ལྡན་འདས་དེ་དག་ངས་མཉེས་པར་བྱས་ནས་ཐུགས་བྱུང་བར་མ་བྱས་པ་གང་ཡིན་པ་དང་། 
 kāle paścimikāyaṃ paṃcāśatyāṃ vartamānāyām imaṃ sūtrāṃtam udgrahīṣyaṃti dhārayiṣyaṃti	ཕྱི་མའི་དུས་ལྔ་བརྒྱ་ཐ་མར་གྱུར་པ་ན་།
 vācayiṣyaṃti paryavāpsyaṃti |	མདོ་སྡེ་འདི་ལེན་པ་དང་། འཛིན་པ་དང་། ཀློག་པ་དང་། ཀུན་ཆུབ་པར་བྱེད་པ་གང་ཡིན་པ་ལས་།
 asya subhūte puṇyaskandhasyāṃtikād eṣa pūrvakaḥ puṇyaskandhaḥ śatatamīm api kalāṃ nopaiti sāhasṛtamām api |	རབ་འབྱོར་། བསོད་ནམས་ཀྱི་ཕུང་པོ་འདི་ལ་བསོད་ནམས་ཀྱི་ཕུང་པོ་སྔ་མས་བརྒྱའི་ཆར་ཡང་མི་ཕོད་།
 śatasāhasṛtamām api | koṭīśatasāhasṛtamām api | saṃkhyām api kalām api gaṇanām api upamām api upaniśām api na kṣamate | vaj 16c; folio 46v4-6 (cz 46|6-11; g 7b3-4; p 187|13-14)	སྟོང་གི་ཆ་དང་། འབུམ་གྱི་ཆ་དང་། གྲངས་དང་། ཆ་དང་། བགྲང་བ་དང་། དཔེ་དང་། ཟླ་དང་། རྒྱུར་ཡང་མི་བཟོད་དོ་༎
 sacet subhūte teṣāṃ kulaputrāṇāṃ kuladuhitṝṇāṃ vā puṇyaskandhaṃ bhāṣet |	རབ་འབྱོར་། གལ་ཏེ་དེའི་ཚེ་རིགས་ཀྱི་བུའམ་རིགས་ཀྱི་བུ་མོ་དག་བསོད་ནམས་ཀྱི་ཕུང་པོ་ཇི་སྙེད་རབ་ཏུ་འཛིན་པར་འགྱུར་བའི་རིགས་ཀྱི་བུའམ་རིགས་ཀྱི་བུ་མོ་དེ་དག་གི་བསོད་ནམས་ཀྱི་ཕུང་པོ་ངས་བརྗོད་ན་། སེམས་ཅན་རྣམས་མྱོ་མྱོ་པོར་འགྱུར་ཏེ་། སེམས་འཁྲུགས་པར་འགྱུར་རོ་༎ ཡང་རབ་འབྱོར་། ཆོས་ཀྱི་རྣམ་༄༢༢༧བ་གྲངས་འདི་བསམ་གྱིས་མི་ཁྱབ་སྟེ་། འདིའི་རྣམ་པར་སྨིན་པ་ཡང་བསམ་གྱིས་མི་ཁྱབ་པ་ཉིད་དུ་རིག་པར་བྱའོ་༎ དེ་ནས་བཅོམ་ལྡན་འདས་ལ་ཚེ་དང་ལྡན་པ་རབ་འབྱོར་གྱིས་འདི་སྐད་ཅེས་གསོལ་ཏོ་༎ བཅོམ་ལྡན་འདས་། བྱང་ཆུབ་སེམས་དཔའི་ཐེག་པ་ལ་ཡང་དག་པར་ཞུགས་པས་ཇི་ལྟར་གནས་པར་བགྱི་། ཇི་ལྟར་བསྒྲུབ་པར་བགྱི་། ཇི་ལྟར་སེམས་རབ་ཏུ་གཟུངས་བར་བགྱི་། བཅོམ་ལྡན་འདས་ཀྱིས་བཀའ་སྩལ་པ་། རབ་འབྱོར་། འདི་ལ་བྱང་ཆུབ་སེམས་དཔའི་ཐེག་པ་ལ་ཡང་དག་པར་ཞུགས་པས་འདི་སྙམ་དུ་། བདག་གིས་སེམས་ཅན་ཐམས་ཅད་ཕུང་པོ་ལྷག་མ་མེད་པའི་མྱ་ངན་ལས་འདས་པའི་དབྱིངས་སུ་ཡོངས་སུ་མྱ་ངན་ལས་བཟླའོ་༎ དེ་ལྟར་སེམས་ཅན་རྣམས་ཡོངས་སུ་མྱ་ངན་ལས་བཟླས་ཀྱང་སེམས་ཅན་གང་ཡང་ཡོངས་སུ་མྱ་ངན་ལས་བཟླས་པར་གྱུར་པ་མེད་དོ་༎ སྙམ་དུ་སེམས་བསྐྱེད་པར་བྱའོ་༎ དེ་ཅིའི་ཕྱིར་ཞེ་ན་། རབ་འབྱོར་། གལ་ཏེ་བྱང་ཆུབ་སེམས་དཔའ་སེམས་ཅན་དུ་འདུ་ཤེས་འཇུག་ན་། བྱང་ཆུབ་སེམས་དཔའ་ཞེས་མི་བྱ་ལ་། གང་ཟག་གི་བར་དུ་འདུ་ཤེས་འཇུག་ན་ཡང་དེ་བྱང་ཆུབ་སེམས་དཔའ་ཞེས་མི་བྱ་བའི་ཕྱིར་རོ་༎ དེ་ཅིའི་ཕྱིར་ཞེ་ན་། རབ་འབྱོར་། གང་བྱང་ཆུབ་སེམས་དཔའི་ཐེག་པ་ལ་ཡང་དག་པར་ཞུགས་པ་ཞེས་བྱ་བའི་ཆོས་དེ་གང་ཡང་མེད་པའི་ཕྱིར་རོ་༎ རབ་འབྱོར་། འདི་ཇི་སྙམ་དུ་སེམས་། དེ་བཞིན་༄༢༢༨ཨ་༌༎ གཤེགས་པས་དེ་བཞིན་གཤེགས་པ་མར་མེ་མཛད་ལས་གང་བླ་ན་མེད་པ་ཡང་དག་པར་རྫོགས་པའི་བྱང་ཆུབ་མངོན་པར་རྫོགས་པར་སངས་རྒྱས་པའི་ཆོས་དེ་གང་ཡང་ཡོད་དམ་། དེ་སྐད་ཅེས་བཀའ་སྩལ་པ་དང་། བཅོམ་ལྡན་འདས་ལ་ཚེ་དང་ལྡན་པ་རབ་འབྱོར་གྱིས་འདི་སྐད་ཅེས་གསོལ་ཏོ་༎ བཅོམ་ལྡན་འདས༏་དེ་བཞིན་གཤེགས་པས་དེ་བཞིན་གཤེགས་པ་མར་མེ་མཛད་ལས་གང་བླ་ན་མེད་པ་ཡང་དག་པར་རྫོགས་པའི་བྱང་ཆུབ་མངོན་པར་རྫོགས་པར་སངས་རྒྱས་པའི་ཆོས་དེ་ཡང་མ་མཆིས་སོ་༎ དེ་སྐད་ཅེས་གསོལ་པ་དང་། བཅོམ་ལྡན་འདས་ཀྱིས་ཚེ་དང་ལྡན་པ་རབ་འབྱོར་ལ་འདི་སྐད་ཅེས་བཀའ་སྩལ་ཏོ་༎ རབ་འབྱོར་། དེ་དེ་བཞིན་ནོ་༎ དེ་དེ་བཞིན་ཏེ་། དེ་བཞིན་གཤེགས་པས་དེ་བཞིན་གཤེགས་པ་མར་མེ་མཛད་ལས་གང་བླ་ན་མེད་པ་ཡང་དག་པར་རྫོགས་པའི་བྱང་ཆུབ་མངོན་པར་རྫོགས་པར་སངས་རྒྱས་པའི་ཆོས་དེ་གང་ཡང་མེད་དོ་༎ རབ་འབྱོར་། གལ་ཏེ་དེ་བཞིན་གཤེགས་པས་གང་མངོན་པར་རྫོགས་པར་སངས་རྒྱས་པའི་ཆོས་དེ་འགའ་ཞིག་ཡོད་པར་གྱུར་ན་། དེ་བཞིན་གཤེགས་པ་མར་མེ་མཛད་ཀྱིས་ང་ལ་བྲམ་ཟེའི་ཁྱེའུ་། ཁྱོད་མ་འོངས་པའི་དུས་ན་དེ་བཞིན་གཤེགས་པ་དགྲ་བཅོམ་པ་ཡང་དག་པར་རྫོགས་པའི་སངས་རྒྱས་ཤའཀྱ་ཐུབ་པ་༄༢༢༨བ་ཞེས་བྱ་བར་འགྱུར་རོ་༎ ཞེས་ལུང་མི་སྟོན་པ་ཞིག་ན་། རབ་འབྱོར་། འདི་ལྟར་དེ་བཞིན་གཤེགས་པས་གང་བླ་ན་མེད་པ་ཡང་དག་པར་རྫོགས་པའི་བྱང་ཆུབ་མངོན་པར་རྫོགས་པར་སངས་རྒྱས་པའི་ཆོས་དེ་གང་ཡང་མེད་པས་། དེའི་ཕྱིར་དེ་བཞིན་གཤེགས་པ་མར་མེ་མཛད་ཀྱིས་ངལ་བྲམ་ཟེའི་ཁྱེའུ་། ཁྱོད་མ་འོངས་པའི་དུས་ན་དེ་བཞིན་གཤེགས་པ་དགྲ་བཅོམ་པ་ཡང་དག་པར་རྫོགས་པའི་སངས་རྒྱས་ཤའཀྱ་ཐུབ་པ་ཞེས་བྱ་བར་འགྱུར་རོ་༎ ཞེས་ལུང་བསྟན་ཏོ་༎ དེ་ཅིའི་ཕྱིར་ཞེ་ན་། རབ་འབྱོར་། དེ་བཞིན་གཤེགས་པ་ཞེས་བྱ་བ་ནི་། ཡང་དག་པ་དེ་བཞིན་ཉིད་ཀྱི་ཚིག་བླ་དབ༹གས་ཡིན་པའི་ཕྱིར་རོ་༎ རབ་འབྱོར་། གང་ལ་ལ་ཞིག་འདི་སྐད་དུ་། དེ་བཞིན་གཤེགས་པ་དགྲ་བཅོམ་པ་ཡང་དག་པར་རྫོགས་པའི་སངས་རྒྱས་ཀྱིས་བླ་ན་མེད་པ་ཡང་དག་པར་རྫོགས་པའི་བྱང་ཆུབ་མངོན་པར་རྫོགས་པར་སངས་རྒྱས་སོ་༎ ཞེས་ཟེར་ན་། དེ་ལོག་པར་སྨྲ་བ་ཡིན་ནོ་༎ དེ་ཅིའི་ཕྱིར་ཞེ་ན་། རབ་འབྱོར་། དེ་བཞིན་གཤེགས་པས་གང་བླ་ན་མེད་པ་ཡང་དག་པར་རྫོགས་པའི་བྱང་ཆུབ་མངོན་པར་རྫོགས་པར་སངས་རྒྱས་པའི་ཆོས་དེ་གང་ཡང་མེད་པའི་ཕྱིར་རོ་༎ རབ་འབྱོར་། དེ་བཞིན་གཤེགས་པས་ཆོས་གང་མངོན་པར་རྫོགས་པར་སངས་རྒྱས་པ་དེ་ལ་བདེན་པ་ཡང་མེད་། རྫུན་པ་ཡང་མེད་དེ་། དེ་བས་ན་། དེ་བཞིན་གཤེགས་པས་ཆོས་ཐམས་ཅད་སངས་རྒྱས་༄༢༢༩ཨ་༌༎ ཀྱི་ཆོས་སོ་༎ ཞེས་གསུངས་ངོ་༎ རབ་འབྱོར་། ཆོས་ཐམས་ཅད་ཅེས་བྱ་བ་ནི་། དེ་དག་ཐམས་ཅད་ཆོས་མེད་པ་ཡིན་ཏེ་། དེ་བས་ན་། ཆོས་ཐམས་ཅད་སངས་རྒྱས་ཀྱི་ཆོས་ཞེས་བྱའོ་༎ རབ་འབྱོར་། འདི་ལྟ་སྟེ་། དཔེར་ན་། མི་ཞིག་ལུས་དང་ལྡན་ཞིང་ལུས་ཆེན་པོར་གྱུར་པ་བཞིན་ནོ་༎ ཚེ་དང་ལྡན་པ་རབ་འབྱོར་གྱིས་གསོལ་པ༏་བཅོམ་ལྡན་འདས་། དེ་བཞིན་གཤེགས་པས་མི་ཞིག་ལུས་དང་ལྡན་ཞིང་ལུས་ཆེན་པོ་ཞེས་གང་གསུངས་པ་དེ་། དེ་བཞིན་གཤེགས་པས་ལུས་མ་མཆིས་པར་གསུངས་ཏེ་། དེས་ན་། ལུས་དང་ལྡན་ཞིང་ལུས་ཆེན་པོ་ཞེས་བགྱིའོ་༎ བཅོམ་ལྡན་འདས་ཀྱིས་བཀའ་སྩལ་པ་། རབ་འབྱོར་། དེ་དེ་བཞིན་ཏེ་། བྱང་ཆུབ་སེམས་དཔའ་གང་འདི་སྐད་དུ་། བདག་གིས་སེམས་ཅན་རྣམས་ཡོངས་སུ་མྱ་ངན་ལས་བཟླའོ་༎ ཞེས་ཟེར་ན་། དེ་བྱང་ཆུབ་སེམས་དཔའ་ཞེས་མི་བྱའོ་༎ དེ་ཅིའི་ཕྱིར་ཞེ་ན་། རབ་འབྱོར་། གང་བྱང་ཆུབ་སེམས་དཔའ་ཞེས་བྱ་བའི་ཆོས་དེ་གང་ཡང་ཡོད་དམ་། རབ་འབྱོར་གྱིས་གསོལ་པ་། བཅོམ་ལྡན་འདས་། དེ་ནི་། མ་མཆིས་ལགས་སོ་༎ བཅོམ་ལྡན་འདས་ཀྱིས་བཀའ་སྩལ་པ་། རབ་འབྱོར་། དེ་བས་ན་། དེ་བཞིན་གཤེགས་པས་ཆོས་ཐམས་ཅད་ནི་། སེམས་ཅན་མེད་པ་། སྲོག་མེད་པ་། གང་ཟག་མེད་པའོ་༎ ཞེས་གསུང་ངོ་༎ རབ་༄༢༢༩བ་འབྱོར༏་བྱང་ཆུབ་སེམས་དཔའ་གང་ཞིག་འདི་སྐད་དུ་། བདག་གིས་ཞིང་བཀོད་པ་རྣམས་བསྒྲུབ་བོ་༎ ཞེས་ཟེར་ན་། དེ་ཡང་དེ་བཞིན་དུ་བརྗོད་པར་བྱའོ་༎ དེ་ཅིའི་ཕྱིར་ཞེ་ན་། རབ་འབྱོར་ཞིང་བཀོད་པ་རྣམས་ཞིང་བཀོད་པ་རྣམས་ཞེས་བྱ་བ་དེ་ནི་། དེ་དག་བཀོད་པ་མེད་པར་དེ་བཞིན་གཤེགས་པས་གསུངས་པའི་ཕྱིར་ཏེ་། དེས་ན་ཞིང་བཀོད་པ་རྣམས་ཞེས་བྱའོ་༎ རབ་འབྱོར༏་བྱང་ཆུབ་སེམས་དཔའ་གང་ཞིག་ཆོས་རྣམས་ནི་། བདག་མེད་པའོ་༎ ཆོས་རྣམས་ནི་། བདག་མེད་པའོ་༎ ཞེས་མོས་པ་དེ་ནི་། དེ་བཞིན་གཤེགས་པ་དགྲ་བཅོམ་པ་ཡང་དག་པར་རྫོགས་པའི་སངས་རྒྱས་ཀྱིས་བྱང་ཆུབ་སེམས་དཔའ་བྱང་ཆུབ་སེམས་དཔའོ་༎ ཞེས་བརྗོད་དོ་༎ རབ་འབྱོར་། འདི་ཇི་སྙམ་དུ་སེམས་། དེ་བཞིན་གཤེགས་པ་ལ་ཤའི་སྤྱན་མངའམ་། རབ་འབྱོར་གྱིས་གསོལ་པ་། བཅོམ་ལྡན་འདས་། དེ་དེ་ལྟ་ལགས་ཏེ་། དེ་བཞིན་གཤེགས་པ་ལ་ཤའི་སྤྱན་མངའོ་༎ བཅོམ་ལྡན་འདས་ཀྱིས་བཀའ་སྩལ་པ་། རབ་འབྱོར་། འདི་ཇི་སྙམ་དུ་སེམས་། དེ་བཞིན་གཤེགས་པ་ལ་ལྷའི་སྤྱན་མངའམ་། རབ་འབྱོར་གྱིས་གསོལ་པ་། བཅོམ་ལྡན་འདས་། དེ་དེ་ལྟ་ལགས་ཏེ་། དེ་བཞིན་གཤེགས་པ་ལ་ལྷའི་སྤྱན་མངའོ་༎ བཅོམ་ལྡན་འདས་ཀྱིས་བཀའ་སྩལ་པ་། རབ་འབྱོར་། འདི་ཇི་སྙམ་དུ་སེམས་། དེ་བཞིན་གཤེགས་པ་ལ་ཤེས་རབ་ཀྱི་སྤྱན་མངའམ་། རབ་འབྱོར་། ༄༢༣༠ཨ་༌༎ གྱིས་གསོལ་པ་། བཅོམ་ལྡན་འདས་། དེ་དེ་ལྟ་ལགས་ཏེ་། དེ་བཞིན་གཤེགས་པ་ལ་ཤེས་རབ་ཀྱི་སྤྱན་མངའོ་༎ བཅོམ་ལྡན་འདས་ཀྱིས་བཀའ་སྩལ་པ་། རབ་འབྱོར་། འདི་ཇི་སྙམ་དུ་སེམས་། དེ་བཞིན་གཤེགས་པ་ལ་ཆོས་ཀྱི་སྤྱན་མ་ངའམ་། རབ་འབྱོར་གྱིས་གསོལ་པ་། བཅོམ་ལྡན་འདས་། དེ་དེ་ལྟ་ལགས་ཏེ་། དེ་བཞིན་གཤེགས་པ་ལ་ཆོས་ཀྱི་སྤྱན་མངའོ་༎ བཅོམ་ལྡན་འདས་ཀྱིས་བཀའ་སྩལ་པ་། རབ་འབྱོར་། འདི་ཇི་སྙམ་དུ་སེམས་། དེ་བཞིན་གཤེགས་པ་ལ་སངས་རྒྱས་ཀྱི་སྤྱན་མངའམ་། རབ་འབྱོར་གྱིས་གསོལ་པ་། བཅོམ་ལྡན་འདས་། དེ་དེ་ལྟ་ལགས་ཏེ་། དེ་བཞིན་གཤེགས་པ་ལ་སངས་རྒྱས་ཀྱི་སྤྱན་མངའོ་༎ བཅོམ་ལྡན་འདས་ཀྱིས་བཀའ་སྩལ་པ་། རབ་འབྱོར་། འདི་ཇི་སྙམ་དུ་སེམས་། གངགའའི་ཀླུང་གི་བྱེ་མ་ཇི་སྙེད་པ་གངགའའི་ཀླུང་ཡང་དེ་སྙེད་དུ་གྱུར་ལ་། དེ་དག་གི་བྱེ་མ་ཇི་སྙེད་པ་དེ་སྙེད་ཀྱི་འཇིག་རྟེན་གྱི་ཁམས་སུ་གྱུར་ན་། འཇིག་རྟེན་གྱི་ཁམས་དེ་དག་ཅི་མང་བ་ཡིན་ནམ་། རབ་འབྱོར་གྱིས་གསོལ་པ་། བཅོམ་ལྡན་འདས་། དེ་དེ་ལྟ་ལགས་ཏེ་། འཇིག་རྟེན་གྱི་ཁམས་དེ་དག་མང་བ་ལགས་སོ་༎ བཅོམ་ལྡན་འདས་ཀྱིས་བཀའ་སྩལ་པ་། རབ་འབྱོར་། འཇིག་རྟེན་གྱི་ཁམས་དེ་དག་ན་སེམས་ཅན་ཇི་སྙེད་ཡོད་པ་དེ་དག་གི་བསམ་པ་ཐ་༄༢༣༠བ་དད་པའི་སེམས་ཀྱི་རྒྱུན་ངས་རབ་ཏུ་ཤེས་སོ་༎ དེ་ཅིའི་ཕྱིར་ཞེ་ན་། རབ་འབྱོར་། སེམས་ཀྱི་རྒྱུན་ཞེས་བྱ་བ་ནི་། དེ་རྒྱུན་མེད་པར་དེ་བཞིན་གཤེགས་པས་གསུངས་པའི་ཕྱིར་ཏེ་། དེས་ན༏་སེམས་ཀྱི་རྒྱུན་ཞེས་བྱའོ་༎ དེ་ཅིའི་ཕྱིར་ཞེ་ན་། རབ་འབྱོར་། འདས་པའི་སེམས་ཀྱང་དམིགས་སུ་མེད་། མ་འོངས་པའི་སེམས་ཀྱང་དམིགས་སུ་མེད་། ད་ལྟར་བྱུང་བའི་སེམས་ཀྱང་དམིགས་སུ་མེད་པའི་ཕྱིར་རོ་༎ རབ་འབྱོར་། འདི་ཇི་སྙམ་དུ་སེམས་། གང་གིས་སྟོང་གསུམ་གྱི་སྟོང་ཆེན་པོའི་འཇིག་རྟེན་གྱི་ཁམས་འདི་རིན་པོ་ཆེ་སྣ་བདུན་གྱིས་ཡོངས་སུ་གང་བར་བྱས་ཏེ་སྦྱིན་པ་བྱིན་ན་། རིགས་ཀྱི་བུའམ་། རིགས་ཀྱི་བུ་མོ་དེ་། གཞི་དེ་ལས་བསོད་ནམས་མང་དུ་བསྐྱེད་དམ་། རབ་འབྱོར་གྱིས་གསོལ་པ་། བཅོམ་ལྡན་འདས་། མང་ལགས་སོ་༎ བདེ་བར་གཤེགས་པ་། མང་ལགས་སོ་༎ བཅོམ་ལྡན་འདས་ཀྱིས་བཀའ་སྩལ་པ་། རབ་འབྱོར་། དེ་དེ་བཞིན་ནོ་༎ དེ་དེ་བཞིན་ཏེ་།
 yāvaṃtaḥ te kulaputrā vā kuladuhitaro vā tasmin samaye puṇyaskandhaṃ pratigṛhṇaṃti |	རིགས་ཀྱི་བུའམ༏་རིགས་ཀྱི་བུ་མོ་དེ་། གཞི་དེ་ལས་བསོད་ནམས་ཀྱི་ཕུང་པོ་མང་དུ་བསྐྱེད་དོ་༎ རབ་འབྱོར་། གལ་ཏེ་བསོད་ནམས་ཀྱི་ཕུང་པོ་བསོད་ནམས་ཀྱི་ཕུང་པོར་གྱུར་ན་། བསོད་ནམས་ཀྱི་ཕུང་པོ་བསོད་ནམས་ཀྱི་ཕུང་པོ་ཞེས་དེ་བཞིན་གཤེགས་པས་མི་གསུང་ངོ་༎ རབ་འབྱོར་། འདི་ཇི་སྙམ་དུ་སེམས་། གཟུགས་ཀྱི་སྐུ་ཡོངས་སུ་གྲུབ་པས་དེ་བཞིན་གཤེགས་༄༢༣༡ཨ་༌༎ པར་བལྟའམ་། རབ་འབྱོར་གྱིས་གསོལ་པ་། བཅོམ་ལྡན་འདས་། དེ་ནི་། མ་ལགས་ཏེ་། གཟུགས་ཀྱི་སྐུ་ཡོངས་སུ་གྲུབ་པས་དེ་བཞིན་གཤེགས་པར་མི་བལྟའོ་༎ དེ་ཅིའི་སླད་དུ་ཞེ་ན་། བཅོམ་ལྡན་འདས་། གཟུགས་ཀྱི་སྐུ་ཡོངས་སུ་གྲུབ་པ་། གཟུགས་ཀྱི་སྐུ་ཡོངས་སུ་རྫོགས་པ་ཞེས་བགྱི་བ་ནི་། དེ་ཡོངས་སུ་གྲུབ་པ་མ་མཆིས་པར་དེ་བཞིན་གཤེགས་པས་གསུངས་པའི་སླད་དུ་སྟེ་། དེས་ན་། གཟུགས་ཀྱི་སྐུ་ཡོངས་སུ་གྲུབ་པ་ཞེས་བགྱིའོ་༎ བཅོམ་ལྡན་འདས་ཀྱིས་བཀའ་སྩལ་པ༏་རབ་འབྱོར་། འདི་ཇི་སྙམ་དུ་སེམས་། མཚན་ཕུན་སུམ་ཚོགས་པས་། དེ་བཞིན་གཤེགས་པར་བལྟའམ་། རབ་འབྱོར་གྱིས་གསོལ་པ་། བཅོམ་ལྡན་འདས་། དེ་ནི༏་མ་ལགས་ཏེ་། མཚན་ཕུན་སུམ་ཚོགས་པས་དེ་བཞིན་གཤེགས་པར་མི་བལྟའོ་༎ དེ་ཅིའི་སླད་དུ་ཞེ་ན་། དེ་བཞིན་གཤེགས་པས་མཚན་ཕུན་སུམ་ཚོགས་པར་གང་གསུངས་པ་དེ་། མཚན་ཕུན་སུམ་ཚོགས་པ་མ་མཆིས་པར་དེ་བཞིན་གཤེགས་པས་གསུངས་པའི་སླད་དུ་སྟེ་། དེས་ན་། མཚན་ཕུན་སུམ་ཚོགས་པ་ཞེས་བགྱིའོ་༎ བཅོམ་ལྡན་འདས་ཀྱིས་བཀའ་སྩལ་པ་། རབ་འབྱོར་། འདི་ཇི་སྙམ་དུ་སེམས་། དེ་བཞིན་གཤེགས་པ་འདི་སྙམ་དུ་། ངས་ཆོས་བསྟན་ཏོ་ཞེས་དགོངས་སོ་༎ སྙམ་ན་། ༄༢༣༡བ་རབ་འབྱོར་། དེ་ལྟར་མི་བལྟ་སྟེ་། དེ་བཞིན་གཤེགས་པས་གང་བསྟན་པའི་ཆོས་དེ་གང་ཡང་མེད་དོ་༎ རབ་འབྱོར་། སུ་ཞིག་འདི་སྐད་དུ་། དེ་བཞིན་གཤེགས་པས་ཆོས་བསྟན་ཏོ༏་༏ཞེས་ཟེར་ན་། རབ་འབྱོར་། དེ་ནི་། མེད་པ་དང་། ལོག་པར་ཟིན་པས་ང་ལ་སྐུར་བར་འགྱུར་རོ་༎ དེ་ཅིའི་ཕྱིར་ཞེ་ན་། རབ་འབྱོར་། ཆོས་བསྟན་པ་ཞེས་བྱ་བ་དམིགས་པར་འགྱུར་བའི་ཆོས་བསྟན་པ་ཆོས་བསྟན་པ་ཞེས་བྱ་བ་དེ་། གང་ཡང་མེད་པའི་ཕྱིར་རོ་༎ དེ་ནས་བཅོམ་ལྡན་འདས་ལ་ཚེ་དང་ལྡན་པ་རབ་འབྱོར་གྱིས་འདི་སྐད་གསོལ་ཏོ་༎ བཅོམ་ལྡན་འདས་། མ་འོངས་པའི་དུས་ན་སེམས་ཅན་གང་དག་འདི་ལྟ་བུའི་ཆོས་བསྟན་པ་འདི་ཐོས་ནས་མངོན་པར་ཡིད་ཆེས་པར་འགྱུར་བ་མཆིས་སམ་། བཅོམ་ལྡན་འདས་ཀྱིས་བཀའ་སྩལ་པ༏་རབ་འབྱོར་། དེ་དག་ནི་། སེམས་ཅན་ཡང་མ་ཡིན་། སེམས་ཅན་མེད་པ་ཡང་མ་ཡིན་ནོ་༎ དེ་ཅིའི་ཕྱིར་ཞེ་ན་། རབ་འབྱོར་། སེམས་ཅན་རྣམས་ཞེས་བྱ་བ་ནི་། དེ་བཞིན་གཤེགས་པས་དེ་དག་སེམས་ཅན་མེད་པར་གསུངས་པའི་ཕྱིར་ཏེ་། དེས་ན་། སེམས་ཅན་རྣམས་ཞེས་བྱའོ་༎ རབ་འབྱོར་། འདི་ཇི་སྙམ་དུ་སེམས་། དེ་བཞིན་གཤེགས་པས་གང་བླ་ན་མེད་པ་ཡང་དག་པར་རྫོགས་པའི་བྱང་ཆུབ་མངོན་པར་རྫོགས་པར་སངས་རྒྱས་པའི་ཆོས་དེ་གང་ཡང་ཡོད་དམ་། ཚེ་དང་ལྡན་པ་རབ་འབྱོར་གྱིས་གསོལ་པ་། ༄༢༣༢ཨ་༌༎ བཅོམ་ལྡན་འདས་། དེ་བཞིན་གཤེགས་པས་གང་བླ་ན་མེད་པ་ཡང་དག་པར་རྫོགས་པའི་བྱང་ཆུབ་མངོན་པར་རྫོགས་པར་སངས་རྒྱས་པའི་ཆོས་དེ་གང་ཡང་མ་མཆིས་ལགས་སོ་༎ བཅོམ་ལྡན་འདས་ཀྱིས་བཀའ་སྩལ་པ་། རབ་འབྱོར་། དེ་དེ་བཞིན་ནོ་༎ དེ་དེ་བཞིན་ཏེ་། དེ་ཆོས་ཅུང་ཟད་ཀྱང་མེད་ཅིང་མི་དམིགས་ཏེ་། དེས་ན་། བླ་ན་མེད་པ་ཡང་དག་པར་རྫོགས་པའི་བྱང་ཆུབ་ཅེས་བྱའོ་༎ ཡང་རབ་འབྱོར་། ཆོས་དེ་ནི་། མཉམ་པ་སྟེ་། དེ་ལ་མི་མཉམ་པ་གང་ཡང་མེད་པས་དེས་ན་། བླ་ན་མེད་པ་ཡང་དག་པར་རྫོགས་པའི་བྱང་ཆུབ་ཅེས་བྱའོ་༎ བླ་ན་མེད་པ་ཡང་དག་པར་རྫོགས་པའི་བྱང་ཆུབ་དེ་ནི་། བདག་མེད་པ་དང་། སེམས་ཅན་མེད་པ་དང་། སྲོག་མེད་པ་དང་། གང་ཟག་མེད་པར་མཉམ་པ་སྟེ་། དགེ་བའི་ཆོས་ཐམས་ཅད་ཀྱིས་མངོན་པར་རྫོགས་པར་འཚང་རྒྱའོ་༎ རབ་འབྱོར་། དགེ་བའི་ཆོས་རྣམས་དགེ་བའི་ཆོས་རྣམས་ཞེས་བྱ་བ་ནི་། དེ་དག་དེ་བཞིན་གཤེགས་པས་ཆོས་མེད་པ་ཉིད་དུ་གསུངས་ཏེ་། དེས་ན་དགེ་བའི་ཆོས་རྣམས་ཞེས་བྱའོ་༎ ཡང་རབ་འབྱོར་། རིགས་ཀྱི་བུའམ་། རིགས་ཀྱི་བུ་མོ་གང་ལ་ལ་ཞིག་གིས་སྟོང་གསུམ་གྱི་སྟོང་ཆེན་པོའི་འཇིག་རྟེན་གྱི་ཁམས་ན་རིའི་རྒྱལ་པོ་རི་རབ་གང་དག་ཇི་སྙེད་༄༢༣༢བ་ཡོད་པ་དེ་ཙམ་གྱི་རིན་པོ་ཆེ་སྣ་བདུན་གྱི་ཕུང་པོ་མངོན་པར་བསྡུས་ཏེ་སྦྱིན་པ་བྱིན་པ་བས་། གང་གིས་ཤེས་རབ་ཀྱི་ཕ་རོལ་ཏུ་ཕྱིན་པ་འདི་ལས་ཐ་ན་ཚིག་བཞི་པའི་ཚིགས་སུ་བཅད་པ་ཙམ་བཟུང་ནས་གཞན་དག་ལ་པ་བས་། ཡང་བསྟན་ན་། རབ་འབྱོར་། བསོད་ནམས་ཀྱི་ཕུང་པོ་འདི་ལ་བསོད་ནམས་ཀྱི་ཕུང་པོ་སྔ་མ་དེས་བརྒྱའི་ཆར་ཡང་མི་ཕོད་པ་ནས་རྒྱུའི་བར་དུ་ཡང་ཉེ་བར་མི་བཟོད་དོ་༎ རབ་འབྱོར་། འདི་ཇི་སྙམ་དུ་སེམས་། དེ་བཞིན་གཤེགས་པ་འདི་སྙམ་དུ་། ངས་སེམས་ཅན་རྣམས་དཀྲོལ་ལོ་ཞེས་དགོངས་སོ་༎ སྙམ་ན་། རབ་འབྱོར་། དེ་དེ་ལྟར་མི་བལྟའོ་༎ དེ་ཅིའི་ཕྱིར་ཞེ་ན་། རབ་འབྱོར་། དེ་བཞིན་གཤེགས་པས་གང་བཀྲོལ་བའི་སེམས་ཅན་དེ་དག་གང་ཡང་མེད་པའི་ཕྱིར་རོ་༎ རབ་འབྱོར་། གལ་ཏེ་དེ་བཞིན་གཤེགས་པས་སེམས་ཅན་གང་ལ་ལ་ཞིག་བཀྲོལ་བར་གྱུར་ན་། དེ་ཉིད་དེ་བཞིན་གཤེགས་པའི་བདག་ཏུ་འཛིན་པར་འགྱུར་། སེམས་ཅན་དུ་འཛིན་པ་དང་། སྲོག་ཏུ་འཛིན་པ་དང་། གང་ཟག་ཏུ་འཛིན་པར་འགྱུར་རོ་༎ རབ་འབྱོར་། བདག་ཏུ་འཛིན་ཅེས་བྱ་བ་ནི་། དེ་འཛིན་པ་མེད་པར་དེ་བཞིན་གཤེགས་པས་གསུངས་ན་། དེ་ཡང་བྱིས་པ་སོ་སོའི་སྐྱེ་བོ་རྣམས་ཀྱིས་བཟུང་ངོ་༎ རབ་འབྱོར་། བྱིས་པ་སོ་སོའི་སྐྱེ་བོ་རྣམས་ཞེས་བྱ་བ་ནི་། དེ་དག་སྐྱེ་བོ་མེད་པ་ཉིད་དུ་དེ་བཞིན་གཤེགས་པས་གསུངས་༄༢༣༣ཨ་༌༎ ཏེ༏་དེས་ན་། བྱིས་པ་སོ་སོའི་སྐྱེ་བོ་རྣམས་ཞེས་བྱའོ་༎ རབ་འབྱོར་། འདི་ཇི་སྙམ་དུ་སེམས་། མཚན་ཕུན་སུམ་ཚོགས་པས་དེ་བཞིན་གཤེགས་པར་བལྟའམ་། རབ་འབྱོར་གྱིས་གསོལ་པ་། བཅོམ་ལྡན་འདས་། དེ་ནི་། མ་ལགས་ཏེ་། མཚན་ཕུན་སུམ་ཚོགས་པས་དེ་བཞིན་གཤེགས་པར་མི་བལྟའོ་༎ བཅོམ་ལྡན་འདས་ཀྱིས་བཀའ་སྩལ་པ་། རབ་འབྱོར་། དེ་དེ་བཞིན་ཏེ་། མཚན་ཕུན་སུམ་ཚོགས་པས་དེ་བཞིན་གཤེགས་པར་མི་བལྟའོ་༎ རབ་འབྱོར་། གལ་ཏེ་མཚན་ཕུན་སུམ་ཚོགས་པས་དེ་བཞིན་གཤེགས་པར་བལྟ་བར་གྱུར་ན་། འཁོར་ལོས་བསྒྱུར་བའི་རྒྱལ་པོ་ཡང་དེ་བཞིན་གཤེགས་པར་འགྱུར་ཏེ་། དེ་བས་ན་། མཚན་ཕུན་སུམ་ཚོགས་པས་དེ་བཞིན་གཤེགས་པར་མི་བལྟའོ་༎ དེ་ནས་བཅོམ་ལྡན་འདས་ལ་ཚེ་དང་ལྡན་པ་རབ་འབྱོར་གྱིས་འདི་སྐད་ཅེས་གསོལ་ཏོ་༎ བཅོམ་ལྡན་འདས་ཀྱིས་གསུངས་པའི་དོན་བདག་གིས་འཚལ་བ་ལྟར་ན་། མཚན་ཕུན་སུམ་ཚོགས་པས་དེ་བཞིན་གཤེགས་པར་མི་བལྟའོ་༎ དེ་ནས་བཅོམ་ལྡན་འདས་ཀྱིས་དེའི་ཚེ་ཚིགས་སུ་བཅད་པ་འདི་དག་བཀའ་སྩལ་ཏོ་༎ གང་དག་ང་ལ་གཟུགས་སུ་མཐོང་༎ གང་དག་ང་ལ་སྒྲར་ཤེས་པ་༎ ལོག་པར་སྤོང་བས་ཞུགས་པ་སྟེ་༎ སྐྱེ་བོ་དེ་དག་ང་མི་མཐོང་༎ ༄༢༣༣བ་སངས་རྒྱས་རྣམས་ནི་ཆོས་ཉིད་བལྟ་༎ འདྲེན་པ་རྣམས་ནི་ཆོས་ཀྱི་སྐུ་༎ ཆོས་ཉིད་ཤེས་པར་བྱ་མིན་པས་༎ དེ་ནི་རྣམ་པར་ཤེས་མི་ནུས་༎ རབ་འབྱོར་། འདི་ཇི་སྙམ་དུ་སེམས་། མཚན་ཕུན་སུམ་ཚོགས་པས་དེ་བཞིན་གཤེགས་པ་དགྲ་བཅོམ་པ་ཡང་དག་པར་རྫོགས་པའི་སངས་རྒྱས་སོ་༎ སྙམ་དུ་འཛིན་ན་། རབ་འབྱོར་། ཁྱོད་ཀྱིས་དེ་ལྟར་མི་བལྟ་སྟེ་། རབ་འབྱོར༏་མཚན་ཕུན་སུམ་ཚོགས་པས་དེ་བཞིན་གཤེགས་པ་དགྲ་བཅོམ་པ་ཡང་དག་པར་རྫོགས་པའི་སངས་རྒྱས་ཀྱིས་བླ་ན་མེད་པ་ཡང་དག་པར་རྫོགས་པའི་བྱང་ཆུབ་མངོན་པར་རྫོགས་པར་སངས་རྒྱས་པ་མེད་དོ་༎ རབ་འབྱོར་། འདི་སྙམ་དུ་། བྱང་ཆུབ་སེམས་དཔའི་ཐེག་པ་ལ་ཡང་དག་པར་ཞུགས་པ་རྣམས་ཀྱིས་ཆོས་ལ་ལ་ཞིག་རྣམ་པར་བཤིག་གམ་། ཆད་པར་བཏགས་པ་སྙམ་དུ་འཛིན་ན་། རབ་འབྱོར་། དེ་ལྟར་མི་བལྟ་སྟེ་། བྱང་ཆུབ་སེམས་དཔའི་ཐེག་པ་ལ་ཡང་དག་པར་ཞུགས་པ་རྣམས་ཀྱིས་ཆོས་གང་ཡང་རྣམ་པར་བཤིག་པའམ་། ཆད་པར་བཏགས་པ་མེད་དོ་༎ ཡང་རབ་འབྱོར་། རིགས་ཀྱི་བུའམ་། རིགས་ཀྱི་བུ་མོ་གང་གིས་འཇིག་རྟེན་གྱི་ཁམས་གངགའའི་བྱེ་མ་སྙེད་དག་རིན་པོ་ཆེ་སྣ་བདུན་གྱིས་རབ་ཏུ་གང་བར་བྱས་ཏེ་སྦྱིན་པར་བྱིན་པ་བས་། བྱང་ཆུབ་སེམས་དཔའ་གང་ཞིག་ཆོས་རྣམས་བདག་མེད་ཅིང་སྐྱེ་བ་མེད་པ་ལ་བཟོད་པ་བས་། པ་ཐོབ་ན་། དེ་ཉིད་༄༢༣༤ཨ་༌༎ གཞི་དེ་ལས་བསོད་ནམས་ཀྱི་ཕུང་པོ་ཆེས་མང་དུ་བསྐྱེད་དོ་༎ ཡང་རབ་འབྱོར་། བྱང་ཆུབ་སེམས་དཔས་བསོད་ནམས་ཀྱི་ཕུང་པོ་ཡོངས་སུ་གཟུང་བར་མི་བྱའོ་༎ ཚེ་དང་ལྡན་པ་རབ་འབྱོར་གྱིས་གསོལ་པ་། བཅོམ་ལྡན་འདས་། བྱང་ཆུབ་སེམས་དཔས་བསོད་ནམས་ཀྱི་ཕུང་པོ་ཡོངས་སུ་གཟུང་བར་མི་བགྱི་ལགས་སམ་། བཅོམ་ལྡན་འདས་ཀྱིས་བཀའ་སྩལ་པ་། རབ་འབྱོར་། ཡོངས་སུ་གཟུང་མོད་ཀྱི་། ལོག་པར་མི་གཟུང་སྟེ་། དེས་ན་། ཡོངས་སུ་གཟུང་བ་ཞེས་བྱའོ་༎ རབ་འབྱོར་། གང་ལ་ལ་ཞིག་འདི་སྐད་དུ་། དེ་བཞིན་གཤེགས་པ་བཞུད་དམ་། བྱོན་ཏམ་། བཞེངས་སམ་།
 unmādaṃ te satvāḥ prāpnuyuḥ cittavikṣepaṃ vā gaccheyuḥ |	བཞུགས་སམ་། མནལ་བར་མཛད་དོ་༎ ཞེས་དེ་སྐད་ཟེར་ན་། དེས་ན་ངས་བཤད་པའི་དོན་མི་ཤེས་སོ༏་༏དེ་ཅིའི་ཕྱིར་ཞེ་ན་། རབ་འབྱོར་། དེ་བཞིན་གཤེགས་པ་ཞེས་བྱ་བ་ནི་། གར་ཡང་མ་བཞུད་། གང་ནས་ཀྱང་མ་བྱོན་པའི་ཕྱིར་ཏེ་། དེས་ན་། དེ་བཞིན་གཤེགས་པ་དགྲ་བཅོམ་པ་ཡང་དག་པར་རྫོགས་པའི་སངས་རྒྱས་ཞེས་བྱའོ་༎ ཡང་རབ་འབྱོར་། རིགས་ཀྱི་བུའམ་། རིགས་ཀྱི་བུ་མོ་གང་གིས་སྟོང་གསུམ་གྱི་སྟོང་ཆེན་པོའི་འཇིག་རྟེན་གྱི་ཁམས་ན་སའི་རྡུལ་རྣམས་ཇི་སྙེད་ཡོད་པ་དེ་དག་འདི་ལྟ་སྟེ་། དཔེར་ན་། རྡུལ་ཕྲ་རབ་ཀྱི་ཚོགས་བཞིན་དུ་ཕྱེ་མར་བྱས་ན་། རབ་འབྱོར་། འདི་ཅི་སྙམ་དུ་སེམས་། རྡུལ་༄༢༣༤བ་ཕྲ་རབ་ཀྱི་ཚོགས་དེ་མང་བ་ཡིན་ནམ་། རབ་འབྱོར་གྱིས་གསོལ་པ་། བཅོམ་ལྡན་འདས་། དེ་དེ་ལྟར་ལགས་ཏེ་། རྡུལ་ཕྲ་རབ་ཀྱི་ཚོགས་དེ་མང་བ་ལགས་སོ་༎ དེ་ཅིའི་སླད་དུ་ཞེ་ན༏་བཅོམ་ལྡན་འདས་། གལ་ཏེ་ཚོགས་ཤིག་མཆིས་པར་གྱུར་ན་། བཅོམ་ལྡན་འདས་ཀྱིས་རྡུལ་ཕྲ་རབ་ཀྱི་ཚོགས་ཞེས་བཀའ་མི་སྩོལ་བའི་སླད་དུའོ་༎ དེ་ཅིའི་སླད་དུ་ཞེ་ན་། བཅོམ་ལྡན་འདས་ཀྱིས་རྡུལ་ཕྲ་རབ་ཀྱི་ཚོགས་ཞེས་གང་གསུངས་པ་དེ་ཚོགས་མ་མཆིས་པར་དེ་བཞིན་གཤེགས་པས་གསུངས་པའི་སླད་དུ་སྟེ་། དེས་ན་། རྡུལ་ཕྲ་རབ་ཀྱི་ཚོགས་ཞེས་བགྱིའོ༏་༏དེ་བཞིན་གཤེགས་པས་སྟོང་གསུམ་གྱི་སྟོང་ཆེན་པོའི་འཇིག་རྟེན་གྱི་ཁམས་ཞེས་གང་གསུངས་པ་དེ་། ཁམས་མ་མཆིས་པར་དེ་བཞིན་གཤེགས་པས་གསུངས་ཏེ༏་དེས་ན་། སྟོང་གསུམ་གྱི་སྟོང་ཆེན་པོའི་འཇིག་རྟེན་གྱི་ཁམས་ཞེས་བགྱིའོ་༎ དེ་ཅིའི་སླད་དུ་ཞེ་ན་། བཅོམ་ལྡན་འདས་། གལ་ཏེ་ཁམས་ཤིག་མཆིས་པར་གྱུར་ན་། དེ་ཉིད་རིལ་པོར་འཛིན་པར་འགྱུར་བའི་སླད་དུའོ་༎ དེ་བཞིན་གཤེགས་པས་རིལ་པོར་འཛིན་པར་གང་གསུངས་པ་དེ་། འཛིན་པ་མ་མཆིས་པར་དེ་བཞིན་གཤེགས་པས་གསུངས་ཏེ་། དེས་ན༏་རིལ་པོར་འཛིན་པ་ཞེས་བགྱིའོ་༎ བཅོམ་ལྡན་འདས་ཀྱིས་བཀའ་སྩལ་པ་། རབ་འབྱོར་། རིལ་པོར་འཛིན་པ་ཉིད་ནི་། ཐ་སྙད་དེ་། ཆོས་དེ་ནི་། བརྗོད་དུ་མེད་པ་ཡིན་ན་། ༄༢༣༥ཨ་༌༎ དེ་ཡང་བྱིས་པ་སོ་སོའི་སྐྱེ་བོ་རྣམས་ཀྱིས་བཟུང་ངོ་༎ རབ་འབྱོར་། གང་ལ་ལ་ཞིག་འདི་སྐད་དུ་། དེ་བཞིན་གཤེགས་པས་བདག་ཏུ་ལྟ་བར་གསུངས་ཤིང་། དེ་བཞིན་གཤེགས་པས་སེམས་ཅན་དུ་ལྟ་བ་དང་། སྲོག་ཏུ་ལྟ་བ་དང་། གང་ཟག་ཏུ་ལྟ་བར་གསུངས་སོ་༎ ཞེས་ཟེར་ན་། རབ་འབྱོར་། དེ་ཡང་ཡང་དག་པར་སྨྲ་བས་སྨྲ་བ་ཡིན་ནམ་། རབ་འབྱོར་གྱིས་གསོལ་པ་། བཅོམ་ལྡན་འདས་། དེ་ནི་། མ་ལགས་སོ་༎ བདེ་བར་གཤེགས་པ་། དེ་ནི་། མ་ལགས་སོ་༎ དེ་ཅིའི་སླད་དུ་ཞེ་ན་། བཅོམ་ལྡན་འདས་། དེ་བཞིན་གཤེགས་པས་བདག་ཏུ་ལྟ་བར་གང་གསུངས་པ་དེ་། ལྟ་བ་མ་མཆིས་པར་དེ་བཞིན་གཤེགས་པས་གསུངས་པའི་སླད་དུ་སྟ་། དེས་ན་། བདག་ཏུ་ལྟ་བ་ཞེས་བགྱིའོ༏་༏བཅོམ་ལྡན་འདས་ཀྱིས་བཀའ་སྩལ་པ་། རབ་འབྱོར་། བྱང་ཆུབ་སེམས་དཔའི་ཐེག་པ་ལ་ཡང་དག་པར་ཞུགས་པ་རྣམས་ཀྱིས་འདི་ལྟར་ཆོས་ཐམས་ཅད་ཤེས་པར་བྱ༏་བལྟ་བར་བྱ་། མོས་པར་བྱ་སྟེ་། ཅི་ནས་ཆོས་སུ་འདུ་ཤེས་པ་ལ་ཡང་མི་གནས་པ་དེ་ལྟར་མོས་པར་བྱའོ་༎ དེ་ཅིའི་ཕྱིར་ཞེ་ན་། རབ་འབྱོར་། ཆོས་སུ་འདུ་ཤེས་ཆོས་སུ་འདུ་ཤེས་ཞེས་བྱ་བ་ནི་། འདུ་ཤེས་མེད་པར་དེ་བཞིན་གཤེགས་པས་གསུངས་པའི་ཕྱིར་ཏེ་། དེས་ན་། ཆོས་སུ་འདུ་ཤེས་ཞེས་བྱའོ་༎ ཡང་རབ་འབྱོར་། བྱང་ཆུབ་༄༢༣༥བ་སེམས་དཔའ་སེམས་དཔའ་ཆེན་པོ་གང་གིས་འཇིག་རྟེན་གྱི་ཁམས་དཔག་ཏུ་མེད་ཅིང་གྲངས་མེད་པ་དག་རིན་པོ་ཆེ་སྣ་བདུན་གྱིས་རབ་ཏུ་གང་བར་བྱས་ཏེ་སྦྱིན་པ་བྱིན་པ་བས་། རིགས་ཀྱི་བུའམ་། རིགས་ཀྱི་བུ་མོ་གང་གིས་ཤེས་རབ་ཀྱི་ཕ་རོལ་ཏུ་ཕྱིན་པ་འདི་ལས་ཐ་ན་ཚིག་བཞི་པའི་ཚིགས་སུ་བཅད་པ་ཙམ་བླངས་ནས་འཛིན་ཏམ་། ཀློག་གམ་། ཀུན་ཆུབ་པར་བྱེད་དམ་། གཞན་དག་ལ་ཡང་རྒྱ་ཆེར་ཡང་དག་པར་རབ་ཏུ་སྟོན་ན་། དེ་ཉིད་གཞི་དེ་ལས་བསོད་ནམས་མང་དུ་གྲངས་མེད་དཔག་ཏུ་མེད་པ་བསྐྱེད་དོ་༎ ཇི་ལྟར་ཡང་དག་པར་རབ་ཏུ་སྟོན་ཅེ་ན་། ཇི་ལྟར་ཡང་དག་པར་རབ་ཏུ་མི་སྟོན་པ་དེ་བཞིན་དུ་སྟེ་། དེས་ན་། ཡང་དག་པར་རབ་ཏུ་སྟོན་པ་ཞེས་བྱའོ་༎ སྐར་མ་རབ་རིབ་མར་མེ་དང་༎ སྒྱུ་མ་ཟིལ་བ་ཆུ་བུར་དང་༎ རྨི་ལམ་གློག་དང་སྤྲིན་ལྟ་བུ་༎ འདུས་བྱས་དེ་ལྟར་བལྟ་བར་བྱ་༎
