skt	tib
 sukhāvatīvyūhaḥ | [vistaramātṛkā] oṃ namo ratnatrayāya | oṃ namaḥ śrīsarvabuddhabodhisattvebhyaḥ | namo daśadiganantāparyantalokadhātupratiṣṭhitebhyaḥ sarvabuddhabodhisattvāryaśrāvakapratyekabuddhebhyo 'tītānāgatapratyutpannebhyaḥ | namo 'mitābhāya | namo 'cintyaguṇāntarātmane || start sukhv 1:	༄༣༦༧ཨ་། །རྒྱ་གར་སྐད་དུ་། ཨའརྱ་ཨཨ་མི་ཏའ་བྷ་བ་བྱུ་ཧ་། ནའ་མ་མ་ཧའ་ཡའ་ན་སའུ་ཏྲ་། བོད་སྐད་དུ་། འཕགས་པ་འོད་དཔག་མེད་ཀྱི་བཀོད་པ་ཞེས་བྱ་བ་ཐེག་པ་ཆེན་པོའི་མདོ་། བམ་པོ་དང་པོ་། སངས་རྒྱས་དང་བྱང་ཆུབ་སེམས་དཔའ་ཐམས་ཅད་ལ་ཕྱག་འཚལ་ལོ་༎
 evaṃ mayā śrutam |	འདི་སྐད་བདག་གིས་ཐོས་པ་དུས་གཅིག་ན་།
 ekasmin samaye bhagavān rājagṛhe viharati sma gṛdhrakūṭaparvate mahatā bhikṣusaṃghena sārdhaṃ dvātriṃśatā bhikṣusahasraiḥ,	བཅོམ་ལྡན་འདས་རྒྱལ་པོའི་ཁབ་ན་བྱ་རྒོད་ཀྱི་ཕུང་པོའི་རི་ལ་དགེ་སློང་སུམ་ཁྲི་ཉིས་སྟོང་གི་དགེ་སློང་གི་དགེ་འདུན་ཆེན་པོ་དང་ཐབས་གཅིག་ཏུ་བཞུགས་ཏེ་། ཐམས་ཅད་ཀྱང་དགྲ་བཅོམ་པ་། ཟག་པ་ཟད་པ་། ཉོན་མོངས་པ་མེད་པ་། གནས་པ་དང་ལྡན་པ་།
 sarvairarhadbhiḥ kṣīṇāsravairniḥkleśairuṣitavadbhiḥ samyagājñāsuvimuktacittaiḥ parīkṣacittaiḥ	ཡང་དག་པའི་ཤེས་པས་སེམས་ཤིན་ཏུ་རྣམ་པར་གྲོལ་བ་། སྲིད་པར་ཀུན་ཏུ་སྦྱོར་བ་ཡོངས་སུ་ཟད་པ་།
 parikṣīṇabhavasaṃyojanairanuprāptasvakārthairvijitavadbhiruttamadamathaprāptaiḥ suvimuktacittaiḥ	༄༣༦༧བ་བདག་གི་དོན་རྗེས་སུ་ཐོབ་པ་། རྣམ་པར་རྒྱལ་བ་དང་ལྡན་པ་། དུལ་བ་དང་ཞི་བའི་མཆོག་ཐོབ་པ་། སེམས་ཤིན་ཏུ་རྣམ་པར་གྲོལ་བ་། ཤེས་རབ་ཤིན་ཏུ་རྣམ་པར་གྲོལ་བ་། ཅང་ཤེས་པ་། གླང་པོ་ཆེན་པོ་།
 suvimuktaprajñairmahānāgaiḥ ṣaḍabhijñairvaśībhūtairaṣṭavimokṣadhyāyibhirbalaprāptairabhijñātābhijñaiḥ	མངོན་པར་ཤེས་པ་དྲུག་དང་ལྡན་པ་། དབང་དང་ལྡན་པར་གྱུར་པ་། རྣམ་པར་ཐར་པ་བརྒྱད་ལ་བསམ་གཏན་པ་། སྟོབས་ཐོབ་པ་། མངོན་པར་ཤེས་པས་མངོན་པར་ཤེས་པ་།
 sthavirairmahāśrāvakaiḥ |	གནས་བརྟན་ཉན་ཐོས་ཆེན་པོ་ཤ་སྟག་ལ་འདི་ལྟ་སྟེ་། ཚེ་དང་ལྡན་པ་ཀུན་ཤེས་ཀོའུ་དི་ནྱ་དང་། ཚེ་དང་ལྡན་པ་རྟ་ཐུལ་དང་། ཚེ་དང་ལྡན་པ་རླངས་པ་དང་། ཚེ་དང་ལྡན་པ་མིང་ཆེན་དང་། ཚེ་དང་ལྡན་པ་རྒྱལ་བཟང་དང་། ཚེ་དང་ལྡན་པ་གྲགས་ལྷ་དང་། ཚེ་དང་ལྡན་པ་དྲི་མ་མེད་པ་དང་། ཚེ་དང་ལྡན་པ་ལག་བཟང་དང་། ཚེ་དང་ལྡན་པ་བྱམས་མའི་བུ་གང་པོ་དང་། ཚེ་དང་ལྡན་པ་བ་གླང་བདག་དང༏་ཚེ་དང་ལྡན་པ་ལྟེང་རྒྱས་འོད་སྲུང་དང་། ཚེ་དང་ལྡན་པ་ཆུ་ཀླུང་འོད་སྲུང་དང་། ཚེ་དང་ལྡན་པ་ག་ཡ་འོད་སྲུང་དང་། ཚེ་དང་ལྡན་པ་གཞོན་ནུ་འོད་སྲུང་དང་། ཚེ་དང་ལྡན་པ་འོད་སྲུང་ཆེན་པོ་དང༏་ཚེ་དང་ལྡན་པ་ཤའ་རིའི་བུ་དང་། ཚེ་དང་ལྡན་པ་མོའུ་དགལ་གྱི་བུ་ཆེན་པོ་དང་། ཚེ་དང་ལྡན་པ་གསུས་པོ་ཆེ་དང་། ཚེ་དང་ལྡན་པ་ཀ་པི་ན་ཆེན་པོ་དང་། ཚེ་དང་ལྡན་པ་སྐུལ་བྱེད་ཆེན་པོ་དང་། ཚེ་དང་ལྡན་པ་མ་འགགས་པ་དང་། ཚེ་དང་ལྡན་པ་གྲུམ་པོ་དང་། ཚེ་དང་ལྡན་པ་དགའ་ཡོད་དང་། ཚེ་དང་ལྡན་པ་ཀིམ་པི་ལ་དང་། ཚེ་དང་ལྡན་པ་རབ་འབྱོར་དང་། ཚེ་དང་ལྡན་པ་ནམ་གྲུ་དང་། ༄༣༦༨ཨ་༌༎ ཚེ་དང་ལྡན་པ་སེང་ལྡེང་ནགས་པ་དང་། ཚེ་དང་ལྡན་པ་བ་ཀུ་ལ་དང་། ཚེ་དང་ལྡན་པ་ལེགས་འོངས་དང་། ཚེ་དང་ལྡན་པ་དོན་ཡོད་རྒྱལ་པོ་དང་། ཚེ་དང་ལྡན་པ་ཕ་རོལ་སོན་དང་། ཚེ་དང་ལྡན་པ་ལམ་བསྟན་པ་དང་། ཚེ་དང་ལྡན་པ་ལམ་ཕྲན་བསྟན་པ་དང་། ཚེ་དང་ལྡན་པ་སྒྲ་གཅན་ཟིན་དང་། ཚེ་དང་ལྡན་པ་དགའ་བོ་དང་། དེ་དག་དང་གཞན་ཡང་མངོན་པར་ཤེས་པས་མངོན་པར་ཤེས་པ་གནས་བརྟན་ཉན་ཐོས་ཆེན་པོ་ཤ་སྟག་སྟེ་། གང་ཟག་གཅིག་མ་གཏོགས་པ་ནི་།
 tadyathā - ājñātakauṇḍinyena ca, aśvajitā ca, bāṣpeṇa ca, mahānāmnā ca, bhadrajitā ca, yaśodevena ca, vimalena ca, subāhunā ca, pūrṇamaitrāyaṇīputreṇa ca, urubilvākāśyapena ca, nadīkāśyapena ca, gayākāśyapena ca, kumārakāśyapena ca, mahākāśyapena ca, śāriputreṇa ca, mahāmaudgalyāyanena ca, mahākauṣṭhilyena ca, mahākaphilena ca, mahācundena ca, aniruddhena ca, nandikena ca, kampilena ca, subhūtinā ca, revatena ca, khadiravanikena ca, vakulena ca, svāgatena ca, amogharājena ca, pārāyaṇikena ca, patkena ca, cullapatkena ca, nandena ca, rāhulena ca, āyuṣmatānandena ca,	འདི་ལྟ་སྟེ་།
 etaiścānyaiśca abhijñātābhijñaiḥ sthavirairmahāśrāvakairekaṃ pudgalaṃ sthāpayitvā śaikṣapratidyuttarikaraṇīyaṃ yadidamāyuṣmantamānandam |	སློབ་པའི་ལམ་ལ་གོང་དུ་བྱ་བ་ཡོད་པ་ཚེ་དང་ལྡན་པ་ཀུན་དགའ་བོའོ་༎
 maitreyapūrvaṃgamaiśca saṃbahulairbodhisattvairmahāsattvaiḥ || sukhv_1 || start sukhv 2: atha khalvāyuṣmānānda utthāyāsamādekāṃsamuttarāsaṅgaṃ kṛtvā dakṣiṇaṃ jānumaṇḍalaṃ	བྱམས་པ་ལ་སོགས་པ་བྱང་ཆུབ་སེམས་དཔའ་སེམས་དཔའ་ཆེན་པོ་མང་པོ་དང་ཡང་ཐབས་གཅིག་གོ་། དེ་ནས་ཚེ་དང་ལྡན་པ་ཀུན་དགའ་བོ་སྟན་ལས་ལངས་ཏེ་བླ་གོས་ཕྲག་པ་གཅིག་ཏུ་གཟར་ནས་པུས་མོ་ག-ཡས་པའི་ལྷ་ང་ས་ལ་། བཙུགས་ཏེ་། 
 pṛthivyāṃ pratiṣṭhāpya yena bhagavāṃstenāñjaliṃ praṇamya bhagavantametadavocat -	བཅོམ་ལྡན་འདས་ག་ལ་བ་དེ་ལོངས་སུ་ཐལ་མོ་སྦྱར་བ་བཏུད་ནས་། བཅོམ་ལྡན་འདས་ལ་འདི་སྐད་ཅེས་གསོལ་ཏོ་༎
 viprasannāni tava bhagavata indriyāṇi, pariśuddhaśchavivarṇaḥ,	བཅོམ་ལྡན་འདས་ཁྱོད་ཀྱི་དབང་པོ་རྣམས་ནི་ཤིན་ཏུ་དང་། ཞལ་གྱི་མདོག་ནི་ཡོངས་སུ་དག་།
 paryavadāto mukhavarṇaḥ pītanirbhāsaḥ |	པགས་པའི་མདོག་ནི་ཡོངས་སུ་བྱང་ཞིང་སེར་པོར་གདའ་སྟེ༏་འདི་ལྟ་སྟེ་།
 tadyathāpi nāma śāradaṃ vanadaṃ pāṇḍupariśuddhaṃ paryavadātaṃ pītanirbhāsam,	དཔེར་ན་། སྟོན་གྱི་གོས་སེར་སྐྱ་ཡོངས་སུ་དག་པ་། ཡོངས་སུ་སྦྱངས་པ་། སེར་པོ་གདའ་བ་དེ་བཞིན་དུ་།
 evameva bhagavato viprasannānīndriyāṇi, pariśuddho mukhavarṇaḥ,	བཅོམ་ལྡན་འདས་ཀྱི་དབང་པོ་རྣམས་ནི་ཤིན་ཏུ་དང་། ཞལ་གྱི་༄༣༦༨བ་མདོག་ནི་ཡོངས་སུ་དག་།
 paryavadātaśchavivarṇaḥ pītanirbhāsaḥ |	པགས་པའི་མདོག་ནི་ཡོངས་སུ་བྱང་ཞིང་སེར་པོར་གདའ་སྟེ་། བཙུན་པ་བཅོམ་ལྡན་འདས་། འདི་ལྟ་སྟེ་།
 tadyathāpi nāma bhagavan jāmbūnadasuvarṇaniṣko dakṣeṇa karmāreṇa karmārāntevāsinā vā ulkāmukhena saṃpraveśya supariniṣṭhitaḥ (sukhv, vaidya	དཔེར་བགྱི་ན་། འཛམ་བུའི་ཆུ་བོའི་གསེར་བརྒྱ་ཆད་པ་མགར་བའམ་། མགར་བའི་སློབ་མ་མཁས་པ་ཞིག་གི་ནང་དུ་སྩལ་ཏེ་།
 pāṇḍukambala uparinikṣipto 'tīva pariśuddho bhavati paryavadātaḥ pītanirbhāsaḥ, evameva bhagavato ciprasannānīndriyāṇi,	ཤིན་ཏུ་སྦྱངས་ནས་ལ་བ་སེར་པོའི་ནང་དུ་སྩལ་ན་ཤིན་ཏུ་ཡོངས་སུ་དག་ཅིང་ཡོངས་སུ་བྱང་ལ་སེར་པོར་གདའ་བར་འགྱུར་རོ༏་༏དེ་བཞིན་དུ་བཅོམ་ལྡན་འདས་ཀྱི་དབང་པོ་རྣམས་ནི་ཤིན་ཏུ་དང་། 
 pariśuddho mukhavarṇaḥ,	ཞལ་གྱི་མདོག་ནི་ཡོངས་སུ་དག་།
 paryavadātaśchavivarṇaḥ pītanirbhāsaḥ |	པགས་པའི་མདོག་ནི་ཡོངས་སུ་བྱང་ཞིང་སེར་པོར་གདའོ་༎
 na khalu punarahaṃ bhagavan abhijānāmi itaḥ pūrvataramevaṃ viprasannāni tathāgatasyendriyāṇi evaṃ poariśuddhaṃ mukhavarṇaṃ paryavadātaṃ chavivarṇaṃ pītanirbhāsam |	བཅོམ་ལྡན་འདས་། བདག་གིས་སྔ་བས་ཀྱང་ཆེས་སྔ་བ་ན་དེ་བཞིན་གཤེགས་པའི་དབང་པོ་འདི་ལྟར་དང་བ་དང་། ཞལ་གྱི་མདོག་འདི་ལྟར་ཡོངས་སུ་དག་པ་དང་། པགས་པའི་མདོག་ཡོངས་སུ་བྱང་ཞིང་སེར་པོར་གདའ་བ་མ་འཚལ་ཏོ་༎ བཅོམ་ལྡན་འདས་།
 tasya me bhagavan evaṃ bhavati - buddhavihāreṇa batādya tathāgato vihārati, jinavihāreṇa sarvajñatāvihāeṇa |	དེ་ལ་བདག་འདི་སྙམ་དུ་བགྱིད་དེ་།
 mahānāgavihāreṇa batādya tathāgato viharati | atītānāgatapratyutpannān vā tathāgatānarhataḥ samyaksaṃbuddhān samanusmaratīti |	དེ་བཞིན་གཤེགས་པ་དེ་རིང་འདས་པ་དང་། མ་བྱོན་པ་དང་། ད་ལྟར་བྱུང་བའི་དེ་བཞིན་གཤེགས་པ་དགྲ་བཅོམ་པ་ཡང་དག་པར་རྫོགས་པའི་སངས་རྒྱས་རྣམས་རྗེས་སུ་དགོངས་ཤིང་། དེ་བཞིན་གཤེགས་པ་དེ་རིང་སངས་རྒྱས་ཀྱི་གནས་པས་བཞུགས་ཏེ་། རྒྱལ་བར་གནས་པ་དང་། ཐམས་ཅད་མཁྱེན་པ་ཉིད་ཀྱི་གནས་པ་དང་། གླང་པོ་ཆེན་པོའི་གནས་པས་བཞུགས་པ་སྙམ་བགྱིད་དོ་༎
 evamukte bhagavānāyuṣmantamānandametadavocat - sādhu sādhvānanda |	དེ་སྐད་ཅེས་གསོལ་པ་དང་། བཅོམ་ལྡན་འདས་ཀྱིས་ཚེ་དང་ལྡན་པ་ཀུན་དགའ་བོ་ལ་འདི་༄༣༦༩ཨ་༌༎ སྐད་ཅེས་བཀའ་སྩལ་ཏོ་༎ ཀུན་དགའ་བོ་། ལེགས་སོ་༎ ལེགས་སོ་༎
 kiṃ punaste devatā etamarthamārocayanti,	ཅི་དོན་འདི་ཁྱོད་ལ་ལྷ་རྣམས་ཀྱིས་བསྙད་དམ་།
 utāho buddhā bhagavntaḥ?	འོན་ཏེ་སངས་རྒྱས་བཅོམ་ལྡན་འདས་རྣམས་ཀྱིས་སམ་།
 atha tena pratyutpannamīmāṃsājñānenaivaṃ prajānāsīti?	འོན་ཏེ་བདག་རང་གི་དཔྱོད་པའི་ཤེས་པས་དེ་ལྟར་ཤེས་།
 evamukte āyuṣmānānando bhagavantametadavocat - na me bhagavan devatā etamarthamārocayanti,	དེ་སྐད་ཅེས་བཀའ་སྩལ་པ་དང་། བཅོམ་ལྡན་འདས་ལ་ཚེ་དང་ལྡན་པ་ཀུན་དགའ་བོས་འདི་སྐད་ཅེས་གསོལ་ཏོ་༎ བཅོམ་ལྡན་འདས་། དོན་འདི་ནི་ལྷ་རྣམས་ཀྱིས་བདག་ལ་བསྙད་པ་ཡང་མ་མཆིས་།
 nāpi buddhā bhagavantaḥ |	སངས་རྒྱས་བཅོམ་ལྡན་འདས་ཀྱིས་ཀྱང་མ་ལགས་ཀྱི་། བཅོམ་ལྡན་འདས་། བདག་རང་གི་དཔྱོད་པའི་འཚལ་བས་འདི་སྙམ་དུ་དེ་བཞིན་གཤེགས་པ་ནི་དེ་རིང་འདས་པ་དང་། མ་བྱོན་པ་དང་། ད་ལྟར་བྱུང་བའི་དེ་བཞིན་གཤེགས་པ་དགྲ་བཅོམ་པ་ཡང་དག་པར་རྫོགས་པའི་སངས་རྒྱས་རྣམས་རྗེས་སུ་དགོངས་ཤིང་། 
 atha tarhi me bhagavaṃstenaiva pratyātmamīmāṃsājñānenaivaṃ bhavati - buddhavihāreṇādya tathāgato viharati |	དེ་བཞིན་གཤེགས་པ་དེ་རིང་སངས་རྒྱས་ཀྱི་གནས་པས་བཞུགས་ཏེ་།
 jinavihāreṇa sarvajñatāvihāreṇa batādya tathāgato viharati | atītānāgatapratyutpannān vā buddhān bhagavataḥ samanusmaratīti |	རྒྱལ་བའི་གནས་པ་དང་། ཐམས་ཅད་མཁྱེན་པ་ཉིད་ཀྱི་གནས་པ་དང་། གླང་པོ་ཆེན་པོའི་གནས་པས་བཞུགས་སོ་སྙམ་བགྱིད་དོ་༎
 evamukte bhagavānāyuṣmantamānandametadavocat - sādhu sādhvānanda |	དེ་སྐད་ཅེས་གསོལ་པ་དང་། བཅོམ་ལྡན་འདས་ཀྱིས་ཚེ་དང་ལྡན་པ་ཀུན་དགའ་བོ་ལ་འདི་སྐད་ཅེས་བཀའ་སྩལ་ཏོ་༎ ཀུན་དགའ་བོ་། ཁྱོད་ཀྱི་རྟོག་པ་རྒྱ་ཆེ་སྟེ་། དཔྱོད་པ་བཟང་ཞིང་སྤོབས་པས་དགེ་སྟེ་།
 udāraḥ khalu te unmiñjaḥ,	ཀུན་དགའ་བོ་།
 bhadrikā mīmāṃsā, kalyāṇaṃ pratibhānam | bahujanahitāya tvamānanda pratipanno bahujanasukhāya lokānukampāyai mahato janakāyayārthāya hitāya sukhāya devānāṃ ca manuṣyāṇāṃ ca,	ཁྱོད་སྐྱེ་བོ་མང་པོ་ལ་ཕན་པ་དང་། སྐྱེ་བོ་མང་པོ་ལ་བདེ་བའི་ཕྱིར་ཞུགས་པ་དང་། འཇིག་རྟེན་ལ་སྙིང་༄༣༦༩བ་བརྩེ་བ་དང་། སྐྱེ་བོའི་ཚོགས་ཕལ་པོ་ཆེ་དང་། ལྷ་དང་མི་རྣམས་ཀྱི་དོན་དང་། ཕན་པ་དང་། བདེ་བའི་ཕྱིར་ཁྱོད་དེ་བཞིན་གཤེགས་པ་ལ་དོན་འདི་འདྲི་བར་སེམས་པ་ལེགས་སོ་༎
 yastvaṃ tathāgatamarthaṃ paripraṣṭavyaṃ manyase |	ལེགས་སོ་༎ ཀུན་དགའ་བོ༏་དེ་དེ་བཞིན་ཏེ་།
 evameva bhagavatsu ānandastathāgateṣvarhatsu samyaksaṃbuddheṣu aprameyeṣu asaṃkhyeyeṣu jñānadarśanamupasaṃharet,	དེ་བཞིན་གཤེགས་པ་དགྲ་བཅོམ་པ་ཡང་དག་པར་རྫོགས་པའི་སངས་རྒྱས་དཔག་ཏུ་མེད་།
 na tathāgatasya jñānamupahanyeta |	གྲངས་མེད་པ་དག་གིས་ཡེ་ཤེས་མཐོང་བ་སྡུད་ཀྱང་དེ་བཞིན་གཤེགས་པའི་ཡེ་ཤེས་མཐོང་བ་ལ་གནོད་པ་མེད་དོ་༎
 tatkasya hetoḥ?	དེ་ཅིའི་ཕྱིར་ཞེ་ན་། ཀུན་དགའ་བོ་།
 apratihatahetujñānadarśano hyānanda tathāgataḥ |	དེ་བཞིན་གཤེགས་པའི་ཡེ་ཤེས་མཐོང་བ་ཐོགས་པ་མེད་པའི་ཕྱིར་ཏེ་། ཀུན་དགའ་བོ་། དེ་བཞིན་གཤེགས་པ་བཞེད་ན་། བསོད་སྙོམས་གཅིག་གིས་བསྐལ་པའམ་།
 jñānamākāṅkṣannānanda tathāgataḥ ekapiṇḍapātena kalpaṃ vā tiṣṭhet kalpaśataṃ vā kalpaśatasahasraṃ vā yāvatkalpakoṭīniyutaśatasahasraṃ vā, tato vottari tiṣṭhet,	བསྐལ་པ་བརྒྱའམ་། བསྐལ་པ་སྟོང་ངམ་། བསྐལ་པ་བརྒྱ་སྟོང་ངམ་།
 na ca tathāgatasyendriyāṇyupanaśyeyuḥ,	དེ་བས་ཀྱང་ལྷག་པར་བཞུགས་ཀྱང་དེ་བཞིན་གཤེགས་པའི་དབང་པོ་རྣམས་ལ་ཉམས་པ་མེད་དོ་༎
 na mukhavarṇasyānyathātvaṃ bhavet,	ཞལ་གྱི་མདོག་གཞན་དུ་འགྱུར་བ་མེད་དོ་༎
 nāpi cchavivarṇa upahanyeta |	པགས་པའི་མདོག་ལ་གནོད་པ་མེད་དོ་༎
 tatkasya hetoḥ?	དེ་ཅིའི་ཕྱིར་ཞེ་ན་། ཀུན་དགའ་བོ་།
 tathā hi ānanda tathāgataḥ samādhimukhapāramitāprāptaḥ |	འདི་ལྟར་དེ་བཞིན་གཤེགས་པ་ནི་ཏིང་ངེ་འཛིན་གྱི་བདེ་བའི་ཕ་རོལ་ཏུ་བྱོན་པའོ་༎ ཀུན་དགའ་བོ་།
 samyaksaṃbuddhānāmānanda loke sudurlabhaḥ prādurbhāvaḥ |	ཡང་དག་པར་རྫོགས་པའི་སངས་རྒྱས་རྣམས་འཇིག་རྟེན་དུ་འབྱུང་བ་ཤིན་ཏུ་དཀའ་སྟེ་། འདི་ལྟ་སྟེ་།
 tadyathā audumbarapuṣpāṇāṃ loke prādurbhāvaḥ sudurlabho bhavati,	དཔེར་ན་། ཨཽ་དུ་མ་བ་རའི་མེ་ཏོག་འཇིག་རྟེན་དུ་འབྱུང་བ་དཀའ་བ་དེ་བཞིན་དུ་། ཀུན་དགའ་བོ་། དེ་བཞིན་གཤེགས་པ་དགྲ་བཅོམ་པ་ཡང་དག་པར་རྫོགས་པའི་སངས་རྒྱས་སེམས་ཅན་ཐམས་ཅད་ཀྱི་དོན་བཞེད་པ་། 
 evameva ānanda tathāgatānāmarthakāmānāṃ hitaiṣīṇāmanukampakānāṃ mahākaruṇāpratipannānāṃ sudurlabhaḥ prādurbhāvaḥ |	ཕན་པ་བཞེད་པ་། ༄༣༧༠ཨ་༌༎ ཐུགས་བརྩེ་བ་ཅན་། ཐུགས་རྗེ་ཆེན་པོ་ལ་ཞུགས་པ་རྣམས་འཇིག་རྟེན་དུ་འབྱུང་བ་ནི་ཤིན་ཏུ་དཀའོ་༎ ཀུན་དགའ་བོ་།
 api tu khalvānanda tathāgatasyaiva so 'nubhāvo yastvaṃ sarvalokācāryāṇāṃ sattvānāṃ	གང་ཁྱོད་འཇིག་རྟེན་ཐམས་ཅད་ཀྱི་སློབ་དཔོན་ཁོང་དཔའ་བ་དག་འཇིག་རྟེན་དུ་འབྱུང་བར་བྱ་བ་དང་། 
 loke prādurbhāvāya bodhisattvānāṃ mahāsattvānāmarthāya tathāgatametamarthaṃ paripraṣṭavyaṃ manyase |	བྱང་ཆུབ་སེམས་དཔའ་སེམས་དཔའ་ཆེན་པོ་རྣམས་ཀྱི་དོན་གྱི་ཕྱིར་དེ་བཞིན་གཤེགས་པ་ལ་དོན་འདྲི་བར་སེམས་པ་དེ་ནི་དེ་བཞིན་གཤེགས་པའི་མཐུ་ཡིན་ནོ་༎ ཀུན་དགའ་བོ་།
 tena hyānanda śṛṇu, sādhu ca suṣṭhu ca manasikuru | bhāṣiṣye 'haṃ te |	དེའི་ཕྱིར་ལེགས་པར་རབ་ཏུ་ཉོན་ལ་ཡིད་ལ་གཟུང་ཞིག་དང་། ངས་ཁྱོད་ལ་བཤད་དོ་༎
 evaṃ bhagavan ityāyuṣmānānando bhagavataḥ pratyaśrauṣīt || sukhv_2 || start sukhv 3:	ཀུན་དགའ་བོས་བཅོམ་ལྡན་འདས་དེ་བཞིན་ནོ་ཞེས་གསོལ་ཏེ་། བཅོམ་ལྡན་འདས་ཀྱི་ལྟར་ཉན་པ་དང་། བཅོམ་ལྡན་འདས་ཀྱིས་འདི་སྐད་ཅེས་བཀའ་སྩལ་ཏོ་༎
 bhagavānānandametadavocat - bhūtapūrvamānanda atīte 'dhvani ito 'saṃkhyeye kalpe 'saṃkhyeyatare vipule 'prameye 'cintye yadāsīt |	ཀུན་དགའ་བོ་། སྔོན་བྱུང་བ་འདས་པའི་དུས་ན་འདི་ནས་བསྐལ་པ་གྲངས་མེད་པའི་ཡང་ཆེས་གྲངས་མེད་པ་།
 tena kālena tena samayena dīpaṃkaro nāma tathāgato 'rhan samyaksaṃbuddho loka udapādi |	ཤིན་ཏུ་རྒྱས་པ་ཚང་མེད་པ་དང་། བསམ་གྱིས་མི་ཁྱབ་པར་གྱུར་པ་དེའི་ཚེ་དེའི་དུས་ན་དེ་བཞིན་གཤེགས་པ་དགྲ་བཅོམ་པ་ཡང་དག་པར་རྫོགས་པའི་སངས་རྒྱས་མར་མེ་མཛད་ཅེས་བྱ་བ་འཇིག་རྟེན་དུ་བྱུང་ངོ་༎ ཀུན་དགའ་བོ་།
 dīpaṃkarasyānanda pareṇa parataraṃ pratāpavānnāma tathāgato 'bhūt |	དེ་བཞིན་གཤེགས་པ་མར་མེ་མཛད་ཀྱི་སྔ་རོལ་གྱི་ཡང་ཆེས་སྔ་རོལ་དུ་དེ་བཞིན་གཤེགས་པ་འོད་ལྡན་ཞེས་བྱ་བ་བྱུང་ངོ་༎
 tasya pareṇa parataraṃ prabhākaro nāma tathāgato 'bhūt |	དེའི་སྔ་རོལ་གྱི་ཡང་ཆེས་སྔ་རོལ་དུ་དེ་བཞིན་གཤེགས་པ་འོད་མཛད་ཅེས་བྱ་བ་བྱུང་ངོ་༎ དེའི་སྔ་རོལ་གྱི་ཡང་ཆེས་སྔ་རོལ་དུ་དེ་བཞིན་གཤེགས་པ་ཙན་དན་༄༣༧༠བ་གྱི་དྲི་ཞེས་བྱ་བ་བྱུང་ངོ་༎ ཀུན་དགའ་བོ་།
 tasya pareṇa parataraṃ candanagandho nāma tathāgato 'bhūt | tasya pareṇa parataraṃ sumerukalpo nāma tathāgato 'bhūt | (sukhv, vaidya 223) evaṃ candano nāma, vimalānano nāma, anupalipto nāma,	དེ་བཞིན་གཤེགས་པ་ཙན་དན་གྱི་དྲི་དེའི་སྔ་རོལ་གྱི་ཡང་ཆེས་སྔ་རོལ་དུ་དེ་བཞིན་གཤེགས་པ་རི་རབ་ལྟ་བུ་ཞེས་བྱ་བ་བྱུང་ངོ་༎ དེ་བཞིན་དུ་དེ་བཞིན་གཤེགས་པ་ཟླ་བའི་ཞལ་ཞེས་བྱ་བ་བྱུང་ངོ་༎
 vimalaprabho nāma, nāgābhibhūrnāma, sūryodano nāma, girirājaghoṣo nāma, merukūṭo nāma, suvarṇaprabho nāma, jyotiṣprabho nāma, vaiḍūryanirbhāso nāma, brahmaghoṣo nāma,	དེ་བཞིན་གཤེགས་པ་དྲི་མ་མེད་པའི་ཞལ་ཞེས་བྱ་བ་དང་། དེ་བཞིན་གཤེགས་པ་མི་གོས་པ་ཞེས་བྱ་བ་དང་། དེ་བཞིན་གཤེགས་པ་འོད་དྲི་མ་མེད་པ་ཞེས་བྱ་བ་དང་། དེ་བཞིན་གཤེགས་པ་ཀླུ་ཟིལ་གྱིས་གནོན་པ་ཞེས་བྱ་བ་དང་། དེ་བཞིན་གཤེགས་པ་ཉི་མའི་ཞལ་ཞེས་བྱ་བ་དང་། དེ་བཞིན་གཤེགས་པ་རིའི་རྒྱལ་པོ་དབྱངས་ཞེས་བྱ་བ་དང་། དེ་བཞིན་གཤེགས་པ་རི་རབ་དབྱངས་ཞེས་བྱ་བ་དང་། དེ་བཞིན་གཤེགས་པ་རི་རབ་བརྩེགས་པ་ཞེས་བྱ་བ་དང་། དེ་བཞིན་གཤེགས་པ་གསེར་འོད་ཅེས་བྱ་བ་དང་། དེ་བཞིན་གཤེགས་པ་སྐར་མའི་འོད་ཅེས་བྱ་བ་དང་། དེ་བཞིན་གཤེགས་པ་བེཨེདའུརྱ་སྣང་བ་ཞེས་བྱ་བ་དང་། དེ་བཞིན་གཤེགས་པ་ཚངས་པའི་དབྱངས་ཞེས་བྱ་བ་དང་། དེ་བཞིན་གཤེགས་པ་ཟླ་བ་ཟིལ་གྱིས་གནོན་པ་ཞེས་བྱ་བ་དང་། དེ་བཞིན་གཤེགས་པ་ཉི་མའི་དབྱངས་ཞེས་བྱ་བ་དང་། དེ་བཞིན་གཤེགས་པ་མེ་ཏོག་སིལ་མའི་འོད་ཀྱི་རྒྱན་ཞེས་བྱ་བ་དང་། དེ་བཞིན་གཤེགས་པ་དཔལ་བརྩེགས་ཞེས་བྱ་བ་དང་། དེ་བཞིན་གཤེགས་པ་རྒྱ་མཚོ་མཆོག་གི་བློས་རྣམ་པར་རོལ་པ་མངོན་པར་མཁྱེན་པ་ཞེས་བྱ་བ་དང་། 
 candrābhibhūrnāma, tūryaghoṣo nāma, muktakusumapratimaṇḍitaprabho nāma,	དེ་བཞིན་གཤེགས་པ་འོད་མཆོག་ཅེས་བྱ་བ་དང་། དེ་བཞིན་གཤེགས་པ་སྤོས་ཀྱི་རྒྱལ་པོ་༄༣༧༡ཨ་༌༎
 śrīkūṭo nāma, sāgaravarabuddhivikrīḍitābhijño nāma, varaprabho nāma, mahāgandharājanirbhāso nāma, vyapagatakhilamalapratighoṣo nāma, śūrakūṭo nāma, raṇaṃjaho nāma, mahāguṇadharabuddhiprāptābhijño nāma,	ཆེན་པོར་སྣང་བ་ཞེས་བྱ་བ་དང་། དེ་བཞིན་གཤེགས་པ་ཐ་བ་དང་། དྲི་མ་དང་། ཁོང་ཁྲོ་བ་དང་བྲལ་བ་ཞེས་བྱ་བ་དང་། དེ་བཞིན་གཤེགས་པ་དཔལ་བརྩེགས་ཞེས་བྱ་བ་དང་། དེ་བཞིན་གཤེགས་པ་རིན་པོ་ཆེ་གཏོང་བ་ཞེས་བྱ་བ་དང་། དེ་བཞིན་གཤེགས་པ་ཡོན་ཏན་ཆེན་པོ་མངའ་བའི་བློ་བརྙེས་པའི་མངོན་པར་མཁྱེན་པ་ཞེས་བྱ་བ་དང་། 
 candrasūryajihmīkaraṇo nāma, uttaptavaiḍūryanirbhāso nāma, cittadhārābuddhisaṃkusumitābhyudgato nāma, puṣpāvatīvanarājasaṃkusumitābhijño nāma, puṣpākaro nāma, udakacandro nāma,	དེ་བཞིན་གཤེགས་པ་འོད་ཀྱིས་ཉི་ཟླའི་ཟིལ་དུ་བརླག་པར་མཛད་ཅེས་བྱ་བ་དང་། དེ་བཞིན་གཤེགས་པ་བེཨེ་དའུརྱ་སྦྱངས་པར་སྣང་བ་ཞེས་བྱ་བ་དང་། དེ་བཞིན་གཤེགས་པ་སེམས་ཀྱི་རྒྱུད་ཀྱི་བློ་ཤིན་ཏུ་རྒྱས་པ་མངོན་པར་འཕགས་པ་ཞེས་བྱ་བ་དང་། 
 avidyāndhakāravidhvaṃśanakaro nāma, lokendro nāma, muktacchtrapravātasadṛśo nāma, tiṣyo nāma, dharmamativinanditarājo nāma, siṃhasāgarajūūṭavinanditarājo nāma, sāgaramerucandro nāma, bramhasvaranādābhinandito nāma, kusumasaṃbhavo nāma prāptaseno nāma, candrabhānurnāma, candraprabho nāma, vimalanetro nāma, girirājaghoṣośvaro nāma, kusumaprabho nāma,	དེ་བཞིན་གཤེགས་པ་མེ་ཏོག་གི་ཕྲེང་བའི་ནགས་ཀྱི་རྒྱལ་པོ་མེ་ཏོག་ཀུན་དུ་རྒྱས་པ་མངོན་པར་མཁྱེན་པ་ཞེས་བྱ་བ་དང་། དེ་བཞིན་གཤེགས་པ་མེ་ཏོག་གི་འབྱུང་གནས་ཞེས་བྱ་བ་དང་། དེ་བཞིན་གཤེགས་པ་ཆུ་ཟླ་ལྟ་བུ་ཞེས་བྱ་བ་དང་། དེ་བཞིན་གཤེགས་པ་མ་རིག་པའི་མུན་པ་རྣམ་པར་འཇོམས་པ་ཞེས་བྱ་བ་དང་། དེ་བཞིན་གཤེགས་པ་འཇིག་རྟེན་དབང་པོ་ཞེས་བྱ་བ་དང་། དེ་བཞིན་གཤེགས་པ་མུ་ཏིག་བྱི་རུ་འདྲ་བའི་གདུགས་ཞེས་བྱ་བ་དང་། དེ་བཞིན་གཤེགས་པ་བཞེད་པ་ཞེས་བྱ་བ་དང་། དེ་བཞིན་གཤེགས་པ་ཆོས་ཀྱི་བློ་གྲོས་ཀྱིས་བསྒྲགས་པའི་རྒྱལ་པོ་ཞེས་བྱ་བ་དང་། དེ་བཞིན་གཤེགས་པ་སེང་གེ་དང་རྒྱ་མཚོ་བརྩེགས་པ་ལྟར་བསྒྲགས་པའི་རྒྱལ་པོ་ཞེས་བྱ་བ་དང་། དེ་༄༣༧༡བ་བཞིན་གཤེགས་པ་རྒྱ་མཚོ་རི་རབ་ཟླ་བ་ཞེས་བྱ་བ་དང་། དེ་བཞིན་གཤེགས་པ་ཚངས་པའི་དབྱངས་ཀྱི་ང་རོ་ལ་མངོན་པར་དགོས་པ་ཞེས་བྱ་བ་དང་། དེ་བཞིན་གཤེགས་པ་མེ་ཏོག་འབྱུང་ཞེས་བྱ་བ་དང་། དེ་བཞིན་གཤེགས་པ་སྡེ་བརྙེས་ཞེས་བྱ་བ་དང་། དེ་བཞིན་གཤེགས་པ་ཉི་ཟླ་ཞེས་བྱ་བ་དང་། དེ་བཞིན་གཤེགས་པ་ལྷུན་པོ་བརྩེགས་ཞེས་བྱ་བ་དང་། དེ་བཞིན་གཤེགས་པ་ཟླ་འོད་ཅེས་བྱ་བ་དང་། དེ་བཞིན་གཤེགས་པ་དྲི་མ་མེད་པའི་སྤྱན་ཞེས་བྱ་བ་དང་། དེ་བཞིན་གཤེགས་པ་རི་བོའི་རྒྱལ་པོ་སྒྲ་དབྱངས་ཞེས་བྱ་བ་དང་། དེ་བཞིན་གཤེགས་པ་མེ་ཏོག་འོད་ཅེས་བྱ་བ་དང་། དེ་བཞིན་གཤེགས་པ་མེ་ཏོག་གི་ཆར་རབ་ཏུ་འཐོར་བ་ཞེས་བྱ་བ་དང་། དེ་བཞིན་གཤེགས་པ་རིན་པོ་ཆེའི་གདུགས་ཞེས་བྱ་བ་དང་། དེ་བཞིན་གཤེགས་པ་པདམས་སྲང་མཛེས་པར་མཛད་ཅེས་བྱ་བ་དང་། དེ་བཞིན་གཤེགས་པ་ཙན་དན་གྱི་དྲི་ཞེས་བྱ་བ་དང་། དེ་བཞིན་གཤེགས་པ་རྒྱ་སྤོས་དྲི་ཞེས་བྱ་བ་དང་། དེ་བཞིན་གཤེགས་པ་རིན་པོ་ཆེར་སྣང་བ་ཞེས་བྱ་བ་དང་། དེ་བཞིན་གཤེགས་པ་མུ་ཁྱུད་ཅེས་བྱ་བ་དང་། དེ་བཞིན་གཤེགས་པ་བཀོད་པ་ཆེན་པོ་ཞེས་བྱ་བ་དང་། དེ་བཞིན་གཤེགས་པ་ཐ་བ་དང་། ཞེ་སྡང་དང་བྲལ་བ་ཞེས་བྱ་བ་དང་། དེ་བཞིན་གཤེགས་པ་ཚངས་པའི་དབྱངས་ཞེས་བྱ་བ་དང་། དེ་བཞིན་གཤེགས་པ་རིན་པོ་ཆེ་སྣ་བདུན་གྱི་ཆར་འབེབས་པ་ཞེས་བྱ་བ་དང་། དེ་བཞིན་གཤེགས་པ་ཡོན་ཏན་ཆེན་པོ་མངའ་བ་ཞེས་བྱ་བ་དང་། དེ་༄༣༧༢ཨ་༌༎
 kusumavṛṣṭyabhiprakīrṇo nāma, ratnacandro nāma, padmabimbyupaśobhito nāma, candanagandho nāma, ratnābhibhāso nāma nimirnāma, mahāvyūho nāma,	བཞིན་གཤེགས་པ་ཏ་མ་ལའི་ལོ་མ་དང་། ཙན་དན་གྱི་རྫབ་ཅན་ཞེས་བྱ་བ་དང་། དེ་བཞིན་གཤེགས་པ་མེ་ཏོག་མངོན་པར་མཁྱེན་ཞེས་བྱ་བ་དང་། དེ་བཞིན་གཤེགས་པ་མི་ཤེས་པ་རྣམ་པར་འཇོམས་ཞེས་བྱ་བ་དང་། དེ་བཞིན་གཤེགས་པ་རལ་པ་ཅན་ཞེས་བྱ་བ་དང་། དེ་བཞིན་གཤེགས་པ་མུ་ཏིག་གི་གདུགས་ཞེས་བྱ་བ་དང་། དེ་བཞིན་གཤེགས་པ་གསེར་གྱི་སྙིང་པོ་ཞེས་བྱ་བ་དང་། དེ་བཞིན་གཤེགས་པ་བེཨེ་དའུརྱའི་སྙིང་པོ་ཞེས་བྱ་བ་དང་། དེ་བཞིན་གཤེགས་པ་མེ་ཏོག་ཆེན་པོ་ཞེས་བྱ་བ་དང་། དེ་བཞིན་གཤེགས་པ་ཆོས་ཀྱི་ཏོག་ཅེས་བྱ་བ་དང་། དེ་བཞིན་གཤེགས་པ་རིན་ཆེན་དཔལ་ཞེས་བྱ་བ་དང་། དེ་བཞིན་གཤེགས་པ་མིའི་དབང་པོ་ཞེས་བྱ་བ་དང་། དེ་བཞིན་གཤེགས་པ་འཇིག་རྟེན་དབང་པོ་ཞེས་བྱ་བ་དང་། དེ་བཞིན་གཤེགས་པ་ཐུགས་རྗེ་ཅན་ཞེས་བྱ་བ་དང་། དེ་བཞིན་གཤེགས་པ་འཇིག་རྟེན་མཛེས་ཞེས་བྱ་བ་དང་། དེ་བཞིན་གཤེགས་པ་ཚངས་པའི་ཏོག་ཅེས་བྱ་བ་དང་། དེ་བཞིན་གཤེགས་པ་ཆོས་ཀྱི་བློ་གྲོས་ཞེས་བྱ་བ་དང་། དེ་བཞིན་གཤེགས་པ་སེང་གེ་ཞེས་བྱ་བ་དང་། དེ་བཞིན་གཤེགས་པ་སེང་གེའི་བློ་གྲོས་ཞེས་བྱ་བ་བྱུང་སྟེ་།
 vyapagatakhiladoṣo nāma, bramhaghoṣo nāma, saptaratnābhivṛṣṭo nāma, mahāguṇadharo nāma, mahātamālapatracandanakardamo nāma, kusukābhijño nāma, ajñānavidhvaṃsano nāma, kesarī nāma, muktacchatro nāma, suvarṇagarbho nāma, vaiḍūryagarbho nāma, mahāketurnāma, dharmaketurnāma, ratnaketurnāma, ratnaśrīrnāma, kolendro nāma, narendro nāma, kāruṇiko nāma, lokasundaro nāma, bramhaketurnāma, dharmaketurnāma, siṃho nāmasiṃhamatirnāma |	ཀུན་དགའ་བོ་།
 siṃhamaterānanda pareṇa parataraṃ lokeśvararājo nāma tathāgato 'rhan samyaksaṃbuddho	དེ་བཞིན་གཤེགས་པ་སེང་གེའི་བློ་གྲོས་ཀྱི་སྔ་རོལ་གྱི་ཡང་ཆེས་སྔ་རོལ་དུ་དེ་བཞིན་གཤེགས་པ་དགྲ་བཅོམ་པ་ཡང་དག་པར་རྫོགས་པའི་སངས་རྒྱས་མཁྱེན་པ་དང་ཞབས་སུ་ལྡན་པ་།
 loka udapādi vidyācaraṇasaṃpannaḥ sugato lokavidanuttaraḥ puruṣadamyasārathiḥ śāstā	བདེ་བར་གཤེགས་༄༣༧༢བ་པ་འཇིག་རྟེན་མཁྱེན་པ་། སྐྱེས་བུ་འདུལ་བའི་ཁ་ལོ་སྒྱུར་བ་བླ་ན་མེད་པ་།
 devānāṃ ca manuṣyāṇāṃ ca buddho bhagavān |	ལྷ་དང་མི་རྣམས་ཀྱི་སྟོན་པ་། སངས་རྒྱས་བཅོམ་ལྡན་འདས་འཇིག་རྟེན་དབང་ཕྱུག་རྒྱལ་པོ་ཞེས་བྱ་བ་འཇིག་རྟེན་དུ་བྱུང་ངོ་༎ ཀུན་དགའ་བོ་།
 tasya khalu punarānanda lokeśvararājasya tathāgata, syārhataḥ samyaksaṃbuddhasya pravacane dharmākaro nāma bhikṣubhūdadhimātraṃ smṛtimān matimān gatimān prajñāvan,	དེ་བཞིན་གཤེགས་པ་དགྲ་བཅོམ་པ་ཡང་དག་པར་རྫོགས་པའི་སངས་རྒྱས་འཇིག་རྟེན་དབང་ཕྱུག་རྒྱལ་པོ་དེའི་བསྟན་པ་ལ་དགེ་སློང་ཆོས་ཀྱི་འབྱུང་གནས་ཞེས་བྱ་བ་ཤས་ཆེར་དྲན་པ་དང་ལྡན་པ་། བློ་གྲོས་དང་ལྡན་པ་། རྟོགས་པ་དང་ལྡན་པ་། ཤེས་རབ་དང་ལྡན་པ་།
 adhimātraṃ vīryavān udārādhimuktikaḥ || sukhv_3 ||	བརྩོན་འགྲུས་དང་ལྡན་པ་། རྒྱ་ཆེན་པོ་ལ་མོས་པ་ཞིག་བྱུང་ངོ་༎
 start sukhv 4: atha khalvānanda sa dharmākaro bhikṣurutthāyāsanādekāṃsamuttarāsaṅgaṃ kṛtvā dakṣiṇajānumaṇḍalaṃ	ཀུན་དགའ་བོ་། དེ་ནས་དགེ་སློང་ཆོས་ཀྱི་འབྱུང་གནས་དེ་སྟན་ལས་ལངས་ཏེ་བླ་གོས་ཕྲག་པ་གཅིག་ཏུ་གཟར་ནས་པུས་མོ་ག-ཡས་པའི་ལྷ་ང་ས་ལ་བཙུགས་ཏེ་། 
 pṛthivyāṃ pratiṣṭhāpya yenāsau bhagavāṃllokeśvararājastathāgatastenāñjaliṃ praṇamya	བཅོམ་ལྡན་འདས་དེ་བཞིན་གཤེགས་པ་འཇིག་རྟེན་དབང་ཕྱུག་རྒྱལ་པོ་ག་ལ་བ་དེ་ལོགས་སུ་ཐལ་མོ་སྦྱར་བ་བཏུད་ནས་། བཅོམ་ལྡན་འདས་ལ་ཕྱག་འཚལ་ཏེ་།
 bhagavantaṃ namaskṛtya tasminneva samaye saṃmukhamābhirgāthābhirabhyaṣṭāvīt -	དེའི་ཚེ་ཚིགས་སུ་བཅད་པ་འདི་དག་གིས་མངོན་སུམ་དུ་བསྟོད་དོ་༎
 amitaprabha anantatulyabuddhe na ca iha anya prabhā vibhāti kācit |	འོད་ནི་དཔག་མེད་བློ་ནི་མཐའ་ཡས་མཚུངས་༎ གཞན་གྱི་འོད་ནི་གང་ཡང་མི་གསལ་ཏེ་༎
 sūryamaṇigirīśacandraābhā na tapita bhosiṣu ebhi sarvaloke || sukhv_vs_1 ||	ཉི་ཟླ་ནོར་བུ་སྣ་ཚོགས་འོད་རྣམས་ནི་༎ འཇིག་རྟེན་ཀུན་ན་ལྷམ་མེ་ལྷན་མེ་ལགས་༎ སེམས་ཅན་སྙིང་པོའི་གཟུགས་ནི་མཐའ་ཡས་ཏེ་༎
 rūpamapi anantu attvasāre tatha api buddhasvaro anantaghoṣaḥ | (sukhv, vaidya 224)	དེ་བཞིན་སངས་རྒྱས་གསུང་ནི་མཐའ་ཡས་དབྱངས་༎
 śīlamapi samādhiprajñavīryaiḥ sadṛśu na te 'stiha loki kaścidanyaḥ || sukhv_vs_2 ||	ཚུལ་ཁྲིམས་ཏིང་འཛིན་ཤེས་རབ་བརྩོན་འགྲུས་ཀྱང་༎ ཁྱོད་འདྲ་འཇིག་རྟེན་འདི་ན་གཞན་༄༣༧༣ཨ་༌༎ མ་མཆིས་༎
 gabhiru vipulu sūkṣmaprāptu dharmo 'cintitu buddhavaro yathā samudraḥ |	ཟབ་ཅིང་ཤིན་ཏུ་རྒྱས་པའི་ཆོས་བརྙེས་པ་༎ སངས་རྒྱས་མཆོག་གི་ཐུགས་ནི་རྒྱ་མཚོ་བཞིན་༎ དེས་ཀྱང་སྟོན་ལ་ཁེངས་པ་མི་མངའ་སྟེ་༎
 tenonnamanā na cāsti śāstuḥ khiladoṣān jahyā ato 'dhikālam || sukhv_vs_3 ||	ཐ་བ་ཞེ་སྡང་སྤངས་ནས་ཕ་མཐར་སྒྲོལ་༎
 atha buddhabalā anantatejā pratapati sarvadiśā narendrarājā |	ཇི་ལྟར་སངས་རྒྱས་མཆོག་གི་གཟི་མཐའ་ཡས་༎ མི་དབང་གཟི་བརྗིད་ཕྱོགས་ཀུན་ལྷམ་མེར་གདའ༎
 tatha ahu buddha bhavi dharmasvāmī jaramaraṇātprajāṃ pramocayeyam || sukhv_vs_4 ||	དེ་ལྟར་བདག་ཀྱང་སངས་རྒྱས་ཆོས་རྒྱལ་གྱུར་༎ སྐྱེ་རྒུ་རྒ་དང་འཆི་ལས་རབ་ཐར་བགྱི་༎
 dānaśamathaśīlakṣāntivīrya dhyānasamādhitaścaiva agraśreṣṭhāṃ |	སྦྱིན་དང་དུལ་དང་ཚུལ་ཁྲིམས་བཟོད་བརྩོན་འགྲུས་༎ བསམ་གཏན་ཏིང་འཛིན་དེ་བཞིན་ཤེས་རབ་མཆོག་།
 ebhi ahu vratāṃ samādadāmi buddha bhaviṣyami sarvasattvatrātā || sukhv_vs_5 ||	བརྟུལ་ཞུགས་འདི་དག་བདག་གིས་ཡང་དག་བླང་༎ སེམས་ཅན་ཀུན་སྐྱོབ་སངས་རྒྱས་འགྱུར་བར་བགྱི་༎ བྱང་ཆུབ་ཞི་མཆོག་མཚུངས་མེད་ཚོལ་བགྱིད་ཅིང་༎
 buddhaśatasahasra koṭyanekā yathariva vālika gaṅgayā anantā |	སངས་རྒྱས་བྱེ་བ་བརྒྱ་སྟོང་དུ་མའི་ཕྲག་། གངགའའི་བྱེ་མ་ལྟ་བུར་མཐའ་ཡས་པ་༎
 sarvata ahu pūjayiṣya nāthāṃ śivavarabodhigaveṣako atulyāṃ || sukhv_vs_6 ||	མགོན་པོ་དེ་ཀུན་བདག་གིས་མཆོད་པར་བགྱི་༎
 gaṅgārajasamānalokadhātūṃ tatra bhūyo 'ntari ye anantakṣetrāḥ |	གང་གིས་རྡུལ་དང་མཉམ་པའི་འཇིག་རྟེན་ཁམས་༎ དེ་བས་གོང་དུ་མཐའ་ཡས་ཞིང་གི་ཁམས་༎ དེ་དག་ཀུན་དུ་འོད་ནི་རབ་འབྱིན་པ་༎
 sarvatra prabha muñcayiṣya tatrā iti etādṛśa vīryamārabhidhya || sukhv_vs_7 ||	འདི་འདྲའི་བརྩོན་འགྲུས་སྟོབས་ནི་བརྩམ་པར་བགྱི་༎
 kṣetra mama udāru agra śreṣṭho varamiha malī(?) saṃskṛte 'smiṃ |	བདག་གིས་ཞིང་ཡངས་གཙོ་བོ་དམ་པ་མཆོག་། འདུས་བྱས་འདིར་ནི་བརྒྱན་པར་བགྱིས་ནས་སུ་༎
 asadṛśa nirvāṇadhātusaukhyaṃ taśca(cca?) asattvatayā viśodhayiṣye || sukhv_vs_8 ||	མཚུངས་པ་མ་མཆིས་མྱ་ངན་འདས་དབྱིངས་བདེ་༎ དེ་ཡང་མ་མཆིས་པས་ནི་རྣམ་པར་སྦྱང་༎
 daśadiśata samāgatāni sattvāḥ tatra gatā sukha me diśanti kṣipram |	ཕྱོགས་བཅུ་དག་ནས་ལྷགས་པའི་སེམས་ཅན་རྣམས་༎ དེར་ལྷགས་མྱུར་དུ་བདེ་ལ་དགའ་བར་གྱུར་༎ ༄༣༧༣བ་སངས་རྒྱས་ཚད་མ་འདི་ནི་བདག་གི་དབང་༎
 buddha mama pramāṇu atra śikṣī avitathavīryabalaṃ janemi chandam || sukhv_vs_9 ||	མ་ལོག་བརྩོན་འགྲུས་སྟོབས་ནི་བསྐྱེད་པར་འཚལ་༎
 daśadiśalokavidasaṅgajñānī sada mama citta prajānayanti te 'pi |	ཕྱོགས་བཅུའི་འཇིག་རྟེན་མི་ཆགས་མཁྱེན་པ་ཅན་༎ མཁས་པ་དེ་དག་རྟག་ཏུ་བདག་སེམས་མཁྱེན་༎
 avicigatu ahaṃ sadā vaseyaṃ praṇidhibalaṃ na punarvivartayiṣye || sukhv_vs_10 || start sukhv 5: (sukhv, vaidya 225)	བདག་ནི་མཚམས་མེད་མཆིས་ཏེ་རྟག་གནས་བགྱི་༎ སྨོན་ལམ་སྟོབས་ལས་ལོག་པར་ཡོང་མི་བགྱི་༎
 atha khalvānanda sa dharmākaro bhikṣustaṃ bhagavantaṃ lokeśvararājaṃ tathāgataṃ saṃmukhamābhirgāthābhirabhiṣṭutya	ཀུན་དགའ་བོ་། དེ་ནས་དགེ་སློང་ཆོས་ཀྱི་འབྱུང་གནས་དེས་། བཅོམ་ལྡན་འདས་དེ་བཞིན་གཤེགས་པ་འཇིག་རྟེན་དབང་ཕྱུག་རྒྱལ་པོ་ལ་ཚིགས་སུ་བཅད་པ་འདི་དག་གིས་མངོན་པར་བསྟོད་ནས་འདི་སྐད་ཅེས་གསོལ་ཏོ་༎ བཅོམ་ལྡན་འདས་།
 etadavocat - ahamasmi bhagavan uttarāṃ samyaksaṃbodhimabhisaṃboddhukāmaḥ |	བདག་ནི་བླ་ན་མེད་པ་ཡང་དག་པར་རྫོགས་པའི་བྱང་ཆུབ་མངོན་པར་རྫོགས་པར་འཚང་རྒྱ་བར་འཚལ་ཏེ་། 
 punaḥ punaranuttarāyāṃ samyaksaṃbodhau cittamutpādayāmi pariṇāmayāmi | tasya me bhagavān śāstā tathā dharmaṃ deśayatu,	ཡང་དང་ཡང་བླ་ན་མེད་པ་ཡང་དག་པར་རྫོགས་པའི་བྱང་ཆུབ་ཏུ་སེམས་བསྐྱེད་ཅིང་ཡོངས་སུ་བསྔོ་བ་བགྱིད་ན་།
 yathāhaṃ kṣipramanuttarāṃ samyaksaṃbodhimabhisaṃbudhyeyam | asamasamastathāgato loke bhaveyam | tāṃśca bhagavānākārān parikīrtayatu yairahaṃ buddhakṣetrasya guṇavyūhasaṃpadaṃ parigṛhṇīyām |	ཅི་ནས་ཀྱང་བདག་མྱུར་དུ་བླ་ན་མེད་པ་ཡང་དག་པར་རྫོགས་པའི་བྱང་ཆུབ་མངོན་པར་རྫོགས་པར་འཚང་རྒྱ་བ་དང་། འཇིག་རྟེན་དུ་དེ་བཞིན་གཤེགས་པ་མི་མཉམ་པ་དང་མཉམ་པར་འགྱུར་བ་དེ་ལྟ་བུའི་ཆོས་བཅོམ་ལྡན་འདས་ཀྱིས་བདག་ལ་ལེགས་པར་བསྟན་དུ་གསོལ་། རྣམ་པ་གང་དག་གིས་བདག་གི་སངས་རྒྱས་ཀྱི་ཞིང་གི་ཡོན་ཏན་གྱི་རྒྱན་བཀོད་པ་ཕུན་སུམ་ཚོགས་པ་ཡོངས་སུ་འཛིན་པར་འགྱུར་བའི་རྣམ་པ་དེ་ཡང་བཅོམ་ལྡན་འདས་ཀྱིས་བདག་ལ་ཡོངས་སུ་བརྗོད་དུ་གསོལ་།
 evamukte ānanda bhagavāṃllokeśvararājastathāgatastaṃ bhikṣumetadavocat - tena hi tvaṃ bhikṣo svayameva buddhakṣetraguṇālaṃkāravyūhasaṃpadaṃ parigṛhṇīṣva |	ཀུན་དགའ་བོ་། དེ་སྐད་ཅེས་གསོལ་པ་དང་། བཅོམ་ལྡན་འདས་དེ་བཞིན་གཤེགས་པ་༄༣༧༤ཨ་༌༎ འཇིག་རྟེན་དབང་ཕྱུག་རྒྱལ་པོས་དགེ་སློང་ཆོས་ཀྱི་འབྱུང་གནས་དེ་ལ་འདི་སྐད་ཅེས་བཀའ་སྩལ་ཏོ་༎ དེའི་ཕྱིར་དགེ་སློང་ཁྱོད་བདག་ཉིད་ཀྱི་སངས་རྒྱས་ཀྱི་ཞིང་གི་ཡོན་ཏན་གྱི་རྒྱན་བཀོད་པ་ཕུན་སུམ་ཚོགས་པ་ཡོངས་སུ་གཟུང་ཞིག་།
 so 'vocat - nāhaṃ bhagavaṃstatsaheyam,	དེས་གསོལ་པ་། བཅོམ་ལྡན་འདས་། བདག་སྤྲོ་བ་མ་མཆིས་སོ་༎
 api tu bhagavāneva | bhāṣasva anyeṣāṃ tathāgatānāṃ buddhakṣetraguṇavyūhālaṃkārasaṃpadam, yāṃ śrutvā vayaṃ sarvākāraṃ paripūrayiṣyāma iti |	དེ་བཞིན་གཤེགས་པ་གཞན་དག་གིས་སངས་རྒྱས་ཀྱི་ཞིང་གི་ཡོན་ཏན་བཀོད་པའི་རྒྱན་ཕུན་སུམ་ཚོགས་པ་གང་ཐོས་ནས་བདག་གིས་རྒྱན་བཀོད་པ་ཐམས་ཅད་ཡོངས་སུ་རྫོགས་པར་འགྱུར་བ་བཅོམ་ལྡན་འདས་ཀྱིས་བཤད་དུ་གསོལ་།
 athānanda sa lokeśvararājastathāgato 'rhan samyaksaṃbuddhastasya bhikṣurāśayaṃ jñātvā	ཀུན་དགའ་བོ་། དེ་ནས་དེ་བཞིན་གཤེགས་པ་དགྲ་བཅོམ་པ་ཡང་དག་པར་རྫོགས་པའི་སངས་རྒྱས་འཇིག་རྟེན་དབང་ཕྱུག་རྒྱལ་པོ་དེས་དགེ་སློང་དེའི་བསམ་པ་མཁྱེན་ནས་དོན་བཞེད་པ་ཕན་པ་བཞེད་པ་ཐུགས་བརྩེ་བ་ཅན་གྱི་ཐུགས་བརྩེ་བ་ཉེ་བར་གཟུང་སྟེ་།
 paripūrṇāṃ varṣakoṭīmekāśītibuddhakoṭīniyutaśatasahasrāṇāṃ buddhakṣetraguṇālaṃkāravyūhasaṃpadaṃ	སངས་རྒྱས་ཀྱི་ཚུལ་མི་གཅད་པའི་ཕྱིར་སེམས་ཅན་རྣམས་ལ་ཐུགས་རྗེ་ཆེན་པོ་བསྐྱེད་ནས་ལོ་བྱེ་བ་ཐམ་པར་སངས་རྒྱས་བྱེ་བ་ཁྲག་ཁྲིག་བརྒྱ་སྟོང་ཕྲག་བརྒྱད་ཅུ་རྩ་གཅིག་གི་སངས་རྒྱས་ཀྱི་ཞིང་གི་ཡོན་ཏན་གྱི་རྒྱན་བཀོད་པ་ཕུན་སུམ་ཚོགས་པ་རྣམ་པ་དང་བཅས་། ཡུལ་ཕྱོགས་དང་བཅས་།
 sākārāṃ soddeśāṃ sanirdeśāṃ saṃprakāśitavānarthakāmo hitaiṣī anukampako 'nukampāmupādāya buddhakṣetrānupacchedāya sattveṣu mahākaruṇāṃ saṃjanayitvā |	གཞི་ཅི་ལས་གྱུར་པ་དང་བཅས་པར་ཡང་དག་པར་རབ་ཏུ་བཤད་དོ་༎ དེ་ནས་བཅོམ་ལྡན་འདས་ལ་ཚེ་དང་ལྡན་པ་ཀུན་དགའ་བོས་འདི་སྐད་ཅེས་གསོལ་ཏོ་༎ བཅོམ་ལྡན་འདས་། བཅོམ་ལྡན་འདས་འཇིག་རྟེན་༄༣༧༤བ་དབང་ཕྱུག་རྒྱལ་པོ་དེའི་སྐུ་ཚེའི་ཚད་ཇི་ཙམ་ཞིག་ཐུབ་པར་འགྱུར་། དེ་སྐད་ཅེས་གསོལ་པ་དང་། བཅོམ་ལྡན་འདས་ཀྱིས་ཚེ་དང་ལྡན་པ་ཀུན་དགའ་བོ་ལ་འདི་སྐད་ཅེས་བཀའ་སྩལ་ཏོ་༎
 paripūrṇāścatvāriṃśatkalpāstasya bhagavatastathāgatasyāyuḥpramāṇam || sukhv_5 || start sukhv 6: (sukhv, vaidya 226)	དེ་བཞིན་གཤེགས་པ་འཇིག་རྟེན་དབང་ཕྱུག་རྒྱལ་པོ་དེའི་ཚེའི་ཚད་ནི་བསྐལ་པ་བྱེ་བ་ཁྲག་ཁྲིག་བརྒྱ་སྟོང་ཕྲག་བཞི་བཅུ་ཐམ་པ་ཐུབ་པར་གྱུར་ཏོ་༎ 
 atha khalvānanda sa dharmākaro bhikṣuryāsteṣāmekāśītibuddhakoṭīniyutaśatasahasrāṇāṃ buddhakṣetraguṇālaṃkāravyūhasaṃpadaḥ,	ཀུན་དགའ་བོ་། དེ་ནས་དགེ་སློང་ཆོས་ཀྱི་འབྱུང་གནས་དེས་སངས་རྒྱས་བྱེ་བ་ཁྲག་ཁྲིག་བརྒྱ་སྟོང་ཕྲག་བརྒྱད་ཅུ་རྩ་གཅིག་པོ་དེ་དག་གི་སངས་རྒྱས་ཀྱི་ཞིང་གི་ཡོན་ཏན་གྱི་རྒྱན་བཀོད་པ་ཕུན་སུམ་ཚོགས་པ་གང་ཡིན་པ་དེ་དག་ཐམས་ཅད་སངས་རྒྱས་ཀྱི་ཞིང་གཅིག་ཏུ་ཡོངས་སུ་བཟུང་ནས་།
 tāḥ sarvā eke buddhakṣetre parigṛhya bhagavato lokeśvararājasya tathāgatasya pādau śirasā vanditvā pradakṣiṇīkṛtya tasya bhagavato 'ntikātprākrāmat	བཅོམ་ལྡན་འདས་དེ་བཞིན་གཤེགས་པ་འཇིག་རྟེན་དབང་ཕྱུག་རྒྱལ་པོ་དེའི་ཞབས་ལ་མགོ་བོས་ཕྱག་འཚལ་ཏེ་། བསྐོར་བ་བྱས་ནས་བཅོམ་ལྡན་འདས་དེའི་གན་ནས་སོང་ངོ་༎
 uttari ca pañca kalpān buddhakṣetraguṇālaṃkāravyūhasaṃpadamudāratarāṃ praṇītatarāṃ ca sarvaloke daśasu dikṣu apracaritapūrvāṃ parigṛhītavān,	གང་དུ་ཡང་བསྐལ་པ་ལྔར་སངས་རྒྱས་ཀྱི་ཞིང་གི་ཡོན་ཏན་གྱི་རྒྱན་བཀོད་པ་ཕུན་སུམ་ཚོགས་པ་ཤིན་ཏུ་ཐ་གྲུ་ཆེ་བ་། ཤིན་ཏུ་གྱ་ནོམ་པ་། སྔོན་ཕྱོགས་བཅུའི་འཇིག་རྟེན་གྱི་ཁམས་ཐམས་ཅད་དུ་མ་བྱུང་བ་དག་ཀྱང་ཡོངས་སུ་བཟུང་བར་གྱུར་ཏོ་༎ 
 udārataraṃ ca praṇidhānamakārṣīt || sukhv_6 ||	སྨོན་ལམ་ཤིན་ཏུ་རྒྱ་ཆེན་པོ་ཡང་བཏབ་བོ་༎ ཀུན་དགའ་བོ་།
 start sukhv 7: iti hyānanda yā tena bhagavatā lokeśvararājena tathāgatena teṣāmekāśītibuddhakṣetrakoṭīniyutaśatasahasrāṇāṃ saṃpattiḥ kathitā, tato bhikṣurekāśītyudārapraṇītāprameyatarāṃ buddhakṣetrasaṃpattiṃ parigṛhya yena	དེ་ལྟར་དགེ་སློང་ཆོས་ཀྱི་འབྱུང་གནས་དེས་སངས་རྒྱས་བྱེ་བ་ཁྲག་ཁྲིག་བརྒྱ་སྟོང་ཕྲག་བརྒྱད་ཅུ་རྩ་གཅིག་པོ་དེ་དག་གི་ཞིང་ཕུན་སུམ་ཚོགས་པ་གང་བརྗོད་པ་དེ་བས་ཀྱང་སངས་རྒྱས་ཀྱི་ཞིང་ཕུན་སུམ་ཚོགས་པ་ཆེས་ལྷག་པར་ཐ་གྲུ་ཆེ་བ་། ཆེས་གྱ་༄༣༧༥ཨ་༌༎ ནོམ་པ་། ཆེས་དཔག་ཏུ་མེད་པ་ཡོངས་སུ་བཟུང་སྟེ་།
 sa tathāgatastenopasaṃkramya bhagavataḥ pādau śirasā vanditvā etadavocat - parigṛhītā	བཅོམ་ལྡན་འདས་འཇིག་རྟེན་དབང་ཕྱུག་རྒྱལ་པོ་ག་ལ་བ་དེར་སོང་སྟེ་། ཕྱིན་ནས་བཅོམ་ལྡན་འདས་དེའི་ཞབས་ལ་མགོ་བོས་ཕྱག་འཚལ་ཏེ་། འདི་སྐད་ཅེས་གསོལ་ཏོ་༎
 me bhagavan buddhakṣetraguṇālaṃkāravyūhasaṃpaditi |	བཅོམ་ལྡན་འདས་། བདག་གིས་སངས་རྒྱས་ཀྱི་ཞིང་གི་ཡོན་ཏན་གྱི་རྒྱན་བཀོད་པ་ཕུན་སུམ་ཚོགས་པ་ཡོངས་སུ་བཟུང་ལགས་སོ་༎ 
 evamukte ānanda sa lokeśvararājastathāgatastaṃ bhikṣumetadavocat - tena hi bhikṣo bhāṣasva, anumodate tathāgataḥ |	ཀུན་དགའ་བོ་། དེ་སྐད་ཅེས་གསོལ་པ་དང་། དེ་བཞིན་གཤེགས་པ་འཇིག་རྟེན་དབང་ཕྱུག་རྒྱལ་པོ་དེས་དགེ་སློང་ཆོས་ཀྱི་འབྱུང་གནས་དེ་ལ་འདི་སྐད་ཅེས་བཀའ་སྩལ་ཏོ་༎ དེའི་ཕྱིར་དེ་བཞིན་གཤེགས་པ་ཡང་རྗེས་སུ་ཡི་རང་བ་མཛད་ཀྱི་དགེ་སློང་གིས་སྨྲོས་ཤིག་།
 ayaṃ kālo bhikṣo,	འདི་ནི་དེའི་དུས་ཡིན་གྱི་།
 pramodaya parṣadam,	འཁོར་དགའ་བར་གྱིས་ཤིག་།
 harṣaṃ janaya,	མགུ་བ་སྐྱེད་ཅིག་།
 siṃhanādaṃ nada,	སེང་གེའི་སྒྲ་སྒྲོགས་ཤིག་།
 yaṃ śrutvā bodhisattvā mahāsattvā etarhyanāgate 'dhvani evaṃrūpāṇi buddhakṣetraguṇasaṃpattipraṇidhisthānāni parigrahīṣyanti |	དེ་ཐོས་ནས་བྱང་ཆུབ་སེམས་དཔའ་སེམས་དཔའ་ཆེན་པོ་དག་ད་ལྟར་དང་། མ་འོངས་པའི་དུས་ན་སངས་རྒྱས་ཀྱི་ཞིང་ཕུན་སུམ་ཚོགས་པ་སྨོན་ལམ་གྱི་གནས་འདི་ལྟ་བུ་ཡོངས་སུ་འཛིན་པར་འགྱུར་། ཡོངས་སུ་རྫོགས་པར་བྱེད་པར་འགྱུར་རོ་༎ ཀུན་དགའ་བོ་།
 athānanda sa dharmākaro bhikṣustasyāṃ velāyāṃ bhagavantametadavocat - tena hi śṛṇotu me bhagavān ye mama praṇidhānaviśeṣāḥ,	དེ་ནས་དགེ་སློང་ཆོས་ཀྱི་འབྱུང་གནས་དེས་དེའི་ཚེ་བཅོམ་ལྡན་འདས་དེ་ལ་འདི་སྐད་ཅེས་གསོལ་ཏོ་༎ 
 yathā me 'nuttarāṃ samyaksaṃbodhimabhisaṃbuddhasya acintyaguṇālaṃkāravyūhasamanvāgataṃ tad buddhakṣetraṃ bhaviṣyati || sukhv_7 ||	དེའི་སླད་དུ་ཇི་ལྟར་བདག་བླ་ན་མེད་པ་ཡང་དག་པར་རྫོགས་པའི་བྱང་ཆུབ་ཏུ་མངོན་པར་རྫོགས་པར་སངས་རྒྱས་པའི་ཚེ་སངས་རྒྱས་ཀྱི་ཞིང་དེའི་ཡོན་ཏན་གྱི་རྒྱན་བཀོད་པ་བསམ་གྱིས་མི་ཁྱབ་པ་༄༣༧༥བ་དང་ལྡན་པར་འགྱུར་བའི་བདག་གི་སྨོན་ལམ་གྱི་ཁྱད་པར་བཅོམ་ལྡན་འདས་ཀྱིས་བདག་ལ་གསན་དུ་གསོལ་། བཅོམ་ལྡན་འདས་།
 start sukhv 8: 1| sacenme bhagavaṃstasmin buddhakṣetre nirayo vā tiryagyonirvā pretaviṣayo vā āsuro vā kāyo bhavet, mā tāvadahamanuttarāṃ samyaksaṃbodhimabhisaṃbudhyeyam ||	གལ་ཏེ་བདག་གི་སངས་རྒྱས་ཀྱི་ཞིང་དེ་ན་སེམས་ཅན་དམྱལ་བ་དང་། དུད་འགྲོའི་སྐྱེ་གནས་དང་། ཡི་དབ༹གས་ཀྱི་ཡུལ་དང་། ལྷ་མ་ཡིན་གྱི་རིས་མཆིས་པར་གྱུར་པ་དེ་སྲིད་དུ་བདག་བླ་ན་མེད་པ་ཡང་དག་པར་རྫོགས་པའི་བྱང་ཆུབ་ཏུ་མངོན་པར་རྫོགས་པར་འཚང་རྒྱ་བར་མི་བགྱིའོ་༎
 2| sacenme bhagavaṃstasya tatra buddhakṣetre ye sattvāḥ pratyājātā bhaveyuḥ,	བཅོམ་ལྡན་འདས་། གལ་ཏེ་བདག་གིས་སངས་རྒྱས་ཀྱི་ཞིང་དེར་སེམས་ཅན་གང་དག་སྐྱེས་པར་གྱུར་པ་དེ་དག་དེ་ནས་ཤི་འཕོས་ནས་སེམས་ཅན་དམྱལ་བའམ་།
 te punastataścyutvā nirayaṃ vā tiryagyoniṃ vā pretaviṣayaṃ vā āsuraṃ vā kāyaṃ prapateyuḥ,	དུད་འགྲོའི་སྐྱེ་གནས་སམ་། ཡི་དབ༹གས་ཀྱི་ཡུལ་ལམ་།
 mā tāvadahamanuttarāṃ samyaksaṃbodhimabhisaṃbudhyeyam ||	ལྷ་མ་ཡིན་གྱི་རིས་སུ་མི་ལྟུང་བར་གྱུར་པ་དེ་སྲིད་དུ་བདག་བླ་ན་མེད་པ་ཡང་དག་པར་རྫོགས་པའི་བྱང་ཆུབ་མངོན་པར་རྫོགས་པར་འཚང་རྒྱ་བར་མི་བགྱིའོ་༎ བཅོམ་ལྡན་འདས་།
 3| sacenme bhagavaṃstatra buddhakṣetre ye sattvāḥ pratyājātāste ca sarve naikavarṇāḥ syuryadidaṃ suvarṇavarṇāḥ,	གལ་ཏེ་བདག་གི་སངས་རྒྱས་ཀྱི་ཞིང་དེར་སེམས་ཅན་གང་དག་སྐྱེས་པ་དེ་དག་ཐམས་ཅད་འདི་ལྟ་སྟེ་། 
 mā tāvadahamanuttarāṃ samyaksaṃbodhimabhisaṃbudhyeyam ||	གསེར་གྱི་ཁ་དོག་ཏུ་ཁ་དོག་གཅིག་པར་མ་གྱུར་པ་དེ་སྲིད་དུ་བདག་བླ་ན་མེད་པ་ཡང་དག་པར་རྫོགས་པའི་བྱང་ཆུབ་མངོན་པར་རྫོགས་པར་འཚང་རྒྱ་བར་མི་བགྱིའོ་༎ བཅོམ་ལྡན་འདས་།
 4| sacenme bhagavaṃstasmin buddhakṣetre devānāṃ ca manuṣyāṇāṃ ca nānātvaṃ prajñāyeta anyatra nāma saṃvṛtivyavahāramātrā devamanuṣyā iti saṃkhyāgaṇanātaḥ,	གལ་ཏེ་བདག་གི་སངས་རྒྱས་ཀྱི་ཞིང་དེ་ན་ལྷ་དང་། མི་ཐ་དད་པ་དག་གདའ་བར་གྱུར་པར་གཞན་དུ་ན་ཀུན་རྫོབ་ཀྱི་ཐ་སྙད་ཙམ་དུ་མིང་དང་བརྡས་ལྷ་དང་མི་ཞེས་བགྱི་བའི་གྲངས་སུ་མཆི་བར་མ་གྱུར་པ་དེ་སྲིད་དུ་བདག་བླ་ན་མེད་པ་ཡང་དག་པར་རྫོགས་༄༣༧༦ཨ་༌༎
 mā tāvadahamanuttarāṃ samyaksaṃbodhimabhisaṃbudhyeyam || 5| sacenme bhagavaṃtasmin buddhakṣetre ye sattvāḥ pratyājātāḥ, te ca sarve na ṛddhivaśitāparamapāramitāprāptā bhaveyuḥ,	པའི་བྱང་ཆུབ་མངོན་པར་རྫོགས་པར་འཚང་རྒྱ་བར་མི་བགྱིའོ་༎ བཅོམ་ལྡན་འདས་།
 antaśa ekacittakṣaṇalavena buddhakṣetrakoṭīniyutaśatasahasrātikramaṇatayāpi, mā tāvadahamanuttarāṃ samyaksaṃbodhimabhisaṃbudhyeyam || 6| sacenme bhagavaṃstasmin buddhakṣetre ye sattvāḥ pratyājātā bhaveyuḥ, te ca sarve jātismarā na syuḥ,	གལ་ཏེ་བདག་གི་སངས་རྒྱས་ཀྱི་ཞིང་དེར་སེམས་ཅན་གང་དག་སྐྱེས་པར་གྱུར་པ་དེ་དག་ཐམས་ཅད་གལ་ཏེ་ཐ་ན་སེམས་ཀྱི་སྐད་ཅིག་ཐང་ཅིག་ལ་སངས་རྒྱས་ཀྱི་ཞིང་བྱེ་བ་ཁྲག་ཁྲིག་བརྒྱ་སྟོང་འདའ་བའི་རྫུ་འཕྲུལ་ལ་དབང་དམ་པའི་ཕ་རོལ་དུ་སོན་པར་མ་གྱུར་པ་དེ་སྲིད་དུ་བདག་བླ་ན་མེད་པ་ཡང་དག་པར་རྫོགས་པའི་བྱང་ཆུབ་ཏུ་མངོན་པར་རྫོགས་པར་འཚང་རྒྱ་བར་མི་བགྱིའོ་༎ བཅོམ་ལྡན་འདས་།
 antaśaḥ kalpakoṭīniyutaśatasahasrānusmaraṇatayāpi, mā tāvadahamanuttarāṃ samyaksaṃbodhimabhisaṃbudhyeyam || 7| sacenme bhagavaṃstasmin buddhakṣetre ye sattvāḥ pratyājāyeran, te sarve na divyasya cakṣuṣo lābhino bhaveyuḥ,	གལ་ཏེ་བདག་གི་སངས་རྒྱས་ཀྱི་ཞིང་དེར་སེམས་ཅན་གང་དག་སྐྱེས་པར་གྱུར་པ་དེ་དག་ཐམས་ཅད་ཐ་ན་བསྐལ་པ་བྱེ་བ་ཁྲག་ཁྲིག་བརྒྱ་སྟོང་རྗེས་སུ་དྲན་པའི་ཚེ་རབས་དྲན་པར་མ་གྱུར་པ་དེ་སྲིད་དུ་བདག་བླ་ན་མེད་པ་ཡང་དག་པར་རྫོགས་པའི་བྱང་ཆུབ་མངོན་པར་རྫོགས་པར་འཚང་རྒྱ་བར་མི་བགྱིའོ་༎ བཅོམ་ལྡན་འདས་།
 antaśo lokadhātukoṭīniyutaśatasahasradarśanatayāpi, mā tāvadahamanuttarāṃ samyaksaṃbodhimabhisaṃbudhyeyam || 8| sacenme bhagavaṃstasmin buddhakṣetre ye sattvāḥ pratyājāyeran,	གལ་ཏེ་བདག་གི་སངས་རྒྱས་ཀྱི་ཞིང་དེར་སེམས་ཅན་གང་དག་སྐྱེས་པར་གྱུར་པ་དེ་དག་ཐམས་ཅད་ཐ་ན་འཇིག་རྟེན་གྱི་ཁམས་བྱེ་བ་ཁྲག་ཁྲིག་བརྒྱ་སྟོང་མཐོང་བའི་ལྷའི་མིག་ཐོབ་པར་མ་གྱུར་པ་དེ་སྲིད་དུ་བདག་བླ་ན་མེད་པ་ཡང་དག་པར་རྫོགས་པའི་བྱང་ཆུབ་མངོན་པར་རྫོགས་པར་འཚང་རྒྱ་བར་མི་བགྱིའོ་༎ བཅོམ་ལྡན་འདས་།
 te sarve na divyasya śrotrasya lābhino bhaveyuḥ, antaśo buddhakṣetrakoṭīniyutaśatasahasrādapi yugapatsaddharmaśravaṇatayā, mā tāvadahamanuttarāṃ samyaksaṃbodhimabhisaṃbudhyeyam ||	གལ་ཏེ་བདག་གི་སངས་རྒྱས་ཀྱི་ཞིང་དེར་སེམས་ཅན་གང་དག་སྐྱེས་པར་གྱུར་པ་དེ་དག་ཐམས་ཅད་ཐ་ན་སངས་རྒྱས་ཀྱི་ཞིང་བྱེ་བ་ཁྲག་ཁྲིག་བརྒྱ་༄༣༧༦བ་སྟོང་དུ་ཅིག་ཅར་ཆོས་ཉན་པའི་ལྷའི་རྣ་བ་ཐོབ་པར་མ་གྱུར་པ་དེ་སྲིད་དུ་བདག་བླ་ན་མེད་པར་ཡང་དག་པར་རྫོགས་པའི་བྱང་ཆུབ་མངོན་པར་རྫོགས་པར་འཚང་རྒྱ་བར་མི་བགྱིའོ་༎ བཅོམ་ལྡན་འདས་།
 9| sacenme bhagavaṃstasmin buddhakṣetre ye sattvāḥ pratyājāyeran, te sarve na paracittajñānakovidā bhaveyuḥ, antaśo buddhakṣetrakoṭīniyutaśatasahasraparyāpannānāmapi sattvānāṃ cittacaritaparijñānatayā,	གལ་ཏེ་བདག་གི་སངས་རྒྱས་ཀྱི་ཞིང་དེར་སེམས་ཅན་གང་དག་སྐྱེས་པར་གྱུར་པ་དེ་དག་ཐམས་ཅད་ཐ་ན་སངས་རྒྱས་ཀྱི་ཞིང་བྱེ་བ་ཁྲག་ཁྲིག་བརྒྱ་སྟོང་དུ་གཏོགས་པའི་སེམས་ཅན་རྣམས་ཀྱི་སེམས་ཀྱི་སྤྱོད་པ་ཡོངས་སུ་འཚལ་བར་ཕ་རོལ་གྱི་སེམས་འཚལ་བ་ལ་མཁས་པར་མ་གྱུར་པ་དེ་སྲིད་དུ་བདག་བླ་ན་མེད་པ་ཡང་དག་པར་རྫོགས་པའི་བྱང་ཆུབ་མངོན་པར་རྫོགས་པར་འཚང་རྒྱ་བར་མི་བགྱིའོ་༎ བཅོམ་ལྡན་འདས་།
 mā tāvadahamanuttarāṃ samyaksaṃbodhimabhisaṃbudhyeyam || 10| sacenme bhagavaṃstasmin buddhakṣetre ye sattvāḥ pratyājāyeran, teṣāṃ kācitparigrahasaṃjñotpadyeta, antaśaḥ svaśarīre 'pi, mā tāvadahamanuttarāṃ samyaksaṃbodhimabhisaṃbudhyeyam ||	གལ་ཏེ་བདག་གི་སངས་རྒྱས་ཀྱི་ཞིང་དེར་སེམས་ཅན་གང་དག་སྐྱེས་པར་གྱུར་པ་དེ་དག་ཐ་ན་རང་གི་ལུས་ལ་ཡོངས་སུ་འཛིན་པའི་འདུ་ཤེས་འགའ་ཞིག་བསྐྱེད་ན་ཡང་དེ་སྲིད་དུ་བདག་བླ་ན་མེད་པ་ཡང་དག་པར་རྫོགས་པའི་བྱང་ཆུབ་མངོན་པར་རྫོགས་པར་འཚང་རྒྱ་བར་མི་བགྱིའོ་༎ བཅོམ་ལྡན་འདས་།
 11| sacenme bhagavaṃstasmin buddhakṣetre ye sattvāḥ pratyājāyeran, te sarve na niyatāḥ syuryādidaṃ samyaktve yāvanmahāparinirvāṇe,	གལ་ཏེ་བདག་གི་སངས་རྒྱས་ཀྱི་ཞིང་དེར་སེམས་ཅན་གང་དག་སྐྱེས་པར་གྱུར་པ་དེ་དག་ཐམས་ཅད་ཡོངས་སུ་མྱ་ངན་ལས་འདས་པ་ཆེན་པོའི་བར་དུ་འདི་ལྟ་སྟེ་།
 mā tāvadahamanuttarāṃ samyaksaṃbodhimabhisaṃbudhyeyam ||	ཡང་དག་པ་ཉིད་ལ་ངེས་པར་མ་གྱུར་པ་དེ་སྲིད་དུ་བདག་བླ་ན་མེད་པ་ཡང་དག་པར་རྫོགས་པའི་བྱང་ཆུབ་ཏུ་མངོན་པར་རྫོགས་པར་འཚང་རྒྱ་བར་མི་བགྱིའོ་༎ བཅོམ་ལྡན་འདས་།
 12| sacenme bhagavaṃstasmin buddhakṣetre anuttarāṃ samyaksaṃbodhimabhisaṃbuddhasya kaścitsattvaḥ śrāvakāṇāṃ gaṇanāmadhigacchet,	གལ་ཏེ་བདག་བླ་ན་མེད་པ་ཡང་དག་པར་རྫོགས་པའི་བྱང་༄༣༧༧ཨ་༌༎ ཆུབ་ཏུ་མངོན་པར་རྫོགས་པར་སངས་རྒྱས་པའི་ཚེ་། སངས་རྒྱས་ཀྱི་ཞིང་དེ་ན་སེམས་ཅན་འགའ་ཞིག་གིས་ཉན་ཐོས་རྣམས་ཀྱི་ཚད་ཀྱི་གྲངས་རྙེད་པར་འགྱུར་པ་ལྟ་ན་།
 antaśastrisāhasramahāsāhasraparyāpannā api sarvasattvāḥ pratyekabuddhabhūtāḥ kalpakoṭīniyutaśatasahasramabhigaṇayantaḥ,	ཐ་ན་སྟོང་གསུམ་གྱི་སྟོང་ཆེན་པོའི་འཇིག་རྟེན་གྱི་ཁམས་སུ་གཏོགས་པའི་སེམས་ཅན་ཐམས་ཅད་རང་སངས་རྒྱས་སུ་གྱུར་པ་ལ་། བསྐལ་པ་བྱེ་བ་ཁྲག་ཁྲིག་བརྒྱ་སྟོང་དུ་བགྲངས་ཏེ་གྲངས་རྙེད་པར་གྱུར་ན་ཡང་དེ་སྲིད་དུ་བདག་བླ་ན་མེད་པ་ཡང་དག་པར་རྫོགས་པའི་བྱང་ཆུབ་མངོན་པར་རྫོགས་པར་འཚང་རྒྱ་བར་མི་བགྱིའོ་༎ བཅོམ་ལྡན་འདས་།
 mā tāvadahamanuttarāṃ samyaksaṃbodhimabhisaṃbudhyeyam ||	གལ་ཏེ་བདག་བླ་ན་མེད་པ་ཡང་དག་པར་རྫོགས་པའི་བྱང་ཆུབ་མངོན་པར་རྫོགས་པར་སངས་རྒྱས་པའི་ཚེ་། 
 13| sacenme bhagavaṃstasmin buddhakṣetre anuttarāṃ samyaksaṃbodhimabhisaṃbuddhasya pramāṇikī me prabhā bhavet, antaśo buddhakṣetrakoṭīniyutaśatasahasrapramāṇenāpi,	སངས་རྒྱས་ཀྱི་ཞིང་དེར་བདག་གི་འོད་ཐ་ན་སངས་རྒྱས་ཀྱི་ཞིང་བྱེ་བ་ཁྲག་ཁྲིག་བརྒྱ་སྟོང་གི་ཚད་ཀྱི་ཚད་དང་ལྡན་པར་གྱུར་ན་ཡང་དེ་སྲིད་དུ་བདག་བླ་ན་མེད་པ་ཡང་དག་པར་རྫོགས་པའི་བྱང་ཆུབ་མངོན་པར་རྫོགས་པར་འཚང་རྒྱ་བར་མི་བགྱིའོ་༎
 mā tāvadahamanuttarāṃ samyaksaṃbodhimabhisaṃbudhyeyam || (sukhv, vaidya 227)	བཅོམ་ལྡན་འདས་། གལ་ཏེ་བདག་བླ་ན་མེད་པ་ཡང་དག་པར་རྫོགས་པའི་བྱང་ཆུབ་མངོན་པར་རྫོགས་པར་སངས་རྒྱས་པའི་ཚེ་། 
 14| sacenme bhagavannanuttarāṃ samyaksaṃbodhimabhisaṃbuddhasya tasmin buddhakṣetre sattvānāṃ pramāṇīkṛtamāyuṣpramāṇaṃ bhavet, anyatra praṇidhānavaśena, mā tāvadahamanuttarāṃ samyaksaṃbodhimabhisaṃbudhyeyam ||	སངས་རྒྱས་ཀྱི་ཞིང་དེ་ན་སྨོན་ལམ་གྱི་དབང་མ་གཏོགས་པར་སེམས་ཅན་རྣམས་ཀྱི་ཚེའི་ཆེད་ལ་ཆད་མཆིས་པར་གྱུར་པ་དེ་སྲིད་དུ་བདག་བླ་ན་མེད་པ་ཡང་དག་པར་རྫོགས་པའི་བྱང་ཆུབ་ཏུ་མངོན་པར་རྫོགས་པར་འཚང་རྒྱ་པའི་ཚེ་། བར་མི་བགྱིའོ་༎ བཅོམ་ལྡན་འདས་།
 15| sacenme bhagavan bodhiprāptasyāyuṣpramāṇaṃ paryantīkṛtaṃ bhavet, antaśaḥ kalpakoṭīniyutaśatasahasragaṇayāpi, mā tāvadahamanuttarāṃ samyaksaṃbodhimabhisaṃbudhyeyam ||	གལ་ཏེ་༄༣༧༧བ་བདག་བྱང་ཆུབ་ཐོབ་པའི་ཚེ་ཚེའི་ཚད་ཐ་ན་བསྐལ་པ་བྱེ་བ་ཁྲག་ཁྲིག་བརྒྱ་སྟོང་དུ་བགྲངས་བས་མཐར་ཕྱིན་པར་གྱུར་ན་ཡང་དེ་སྲིད་དུ་བདག་བླ་ན་མེད་པ་ཡང་དག་པར་རྫོགས་པའི་བྱང་ཆུབ་མངོན་པར་རྫོགས་པར་འཚང་རྒྱ་བར་མི་བགྱིའོ་༎
 16| sacenme bhagavan bodhiprāptasya tasmin buddhakṣetre sattvānāmakuśalasya nāmadheyamapi bhavet, mā tāvadahamanuttarāṃ samyaksaṃbodhimabhisaṃbudhyeyam ||	བཅོམ་ལྡན་འདས་། གལ་ཏེ་བདག་བྱང་ཆུབ་ཐོབ་པའི་ཚེ་སངས་རྒྱས་ཀྱི་ཞིང་དེ་ན་སེམས་ཅན་རྣམས་ལ་མི་དགེ་བའི་མིང་མཆིས་པར་གྱུར་ན་ཡང་དེ་སྲིད་དུ་བདག་བླ་ན་མེད་པ་ཡང་དག་པར་རྫོགས་པའི་བྱང་ཆུབ་མངོན་པར་རྫོགས་པར་འཚང་རྒྱ་བར་མི་བགྱིའོ་༎ 
 17| sacenme bhagavan bodhiprāptasya nāpramayeṣu buddhakṣetreṣu aprameyāsaṃkhyeyā buddhā bhagavanto nāmadheyaṃ parikīrtayeyuḥ,	བཅོམ་ལྡན་འདས་། གལ་ཏེ་བདག་བྱང་ཆུབ་ཐོབ་པའི་ཚེ་སངས་རྒྱས་ཀྱི་ཞིང་དཔག་ཏུ་མ་མཆིས་པ་དག་ན་སངས་རྒྱས་བཅོམ་ལྡན་འདས་གྲངས་མ་མཆིས་པ་དཔག་ཏུ་མ་མཆིས་པ་དག་མིང་ཡོངས་སུ་བརྗོད་པར་མ་གྱུར་ཏམ་། 
 na varṇaṃ bhāṣeran,	བསྔགས་པ་མི་བརྗོད་དམ་།
 na praśaṃsāmabhyudīrayeran,	བསྟོད་པ་མི་བརྗོད་དམ་།
 na samudīrayeyuḥ, mā tāvadahamanuttarāṃ samyaksaṃbodhimabhisaṃbudhyeyam ||	གྲགས་པ་མི་བརྗོད་པ་དེ་སྲིད་དུ་བདག་བླ་ན་མེད་པ་ཡང་དག་པར་རྫོགས་པའི་བྱང་ཆུབ་མངོན་པར་རྫོགས་པར་འཚང་རྒྱ་བར་མི་བགྱིའོ་༎
 18| sacenme bhagavan bodhiprāptasya ye sattvā anyeṣu lokadhātuṣvanuttarāyāṃ samyaksaṃbodhau cittamutpādya mama nāmadheyaṃ śrutvā prasannacittā	བཅོམ་ལྡན་འདས་། གལ་ཏེ་བདག་བྱང་ཆུབ་ཐོབ་པའི་ཚེ་སེམས་ཅན་གང་དག་འཇིག་རྟེན་གྱི་ཁམས་གཞན་དག་ཏུ་བླ་ན་མེད་པ་ཡང་དག་པར་རྫོགས་པའི་བྱང་ཆུབ་ཏུ་སེམས་བསྐྱེད་ནས་བདག་གི་མིང་ཐོས་ཏེ༏་སེམས་རབ་ཏུ་དང་བར་གྱུར་ལ་།
 teṣāṃ cedahaṃ maraṇakālasamaye pratyupasthite bhikṣusaṃghaparivṛtaḥ puraskṛto na puratastiṣṭheyaṃ yadidaṃ cittāvikṣepatāyai,	བདག་རྗེས་སུ་དྲན་པ་དེ་དག་ལ་གལ་ཏེ་འགུམ་པའི་དུས་ཉེ་བར་གནས་པའི་ཚེ་བདག་དགེ་སློང་གི་དགེ་འདུན་གྱིས་ཡོངས་སུ་བསྐོར་ཅིང་མདུན་དུ་བདར་༄༣༧༨ཨ་༌༎ བའི་མདུན་དུ་འདི་ལྟ་སྟེ་།
 mā tāvadahamanuttarāṃ samyaksaṃbodhimabhisaṃbudhyeyam ||	ག-ཡེང་བ་མ་མཆིས་པའི་སེམས་ཀྱིས་གནས་པར་མ་གྱུར་པ་དེ་སྲིད་དུ་བདག་བླ་ན་མེད་པ་ཡང་དག་པར་རྫོགས་པའི་བྱང་ཆུབ་མངོན་པར་རྫོགས་པར་འཚང་རྒྱ་བར་མི་བགྱིའོ་༎ བཅོམ་ལྡན་འདས་།
 19| sacenme bhagavan bodhiprāptasya aprameyāsaṃkhyeyeṣu buddhakṣetreṣu ye sattvā mama nāmadheyaṃ śrutvā tatra buddhakṣetre cittaṃ prerayeyuḥ,	གལ་ཏེ་བདག་བྱང་ཆུབ་ཐོབ་པའི་ཚེ་སངས་རྒྱས་ཀྱི་ཞིང་གྲངས་མ་མཆིས་པ་།
 upapattaye kuśalamūlāni ca pariṇāmayeyuḥ, te tatra buddhakṣetre nopapadyeran, antaśo daśabhiścittotpādaparivartaiḥ sthāpayitvā ānantaryakāriṇaḥ saddharmapratikṣepāvaraṇakṛtāṃśca sattvān,	དཔག་ཏུ་མ་མཆིས་པ་དག་ན་སེམས་ཅན་གང་དག་གིས་བདག་གི་མིང་ཐོས་ནས་སངས་རྒྱས་ཀྱི་ཞིང་དེར་སྐྱེ་བར་བགྱི་བའི་སླད་དུ་སེམས་གཏོང་ཞིང་དགེ་བའི་རྩ་བ་རྣམས་ཀྱང་ཡོངས་སུ་བསྔོ་བར་བགྱིད་ན་མཚམས་མ་མཆིས་པ་བགྱིད་པ་དང་། དམ་པའི་ཆོས་སྤོང་བའི་སྒྲིབ་པས་བསྒྲིབས་པའི་སེམས་ཅན་རྣམས་མ་གཏོགས་པར་དེ་དག་ཐ་ན་སེམས་བསྐྱེད་པའི་འགྱུར་བ་བཅུས་སངས་རྒྱས་ཀྱི་ཞིང་དེར་སྐྱེ་བར་མ་གྱུར་པ་དེ་སྲིད་དུ་བདག་བླ་ན་མེད་པ་ཡང་དག་པར་རྫོགས་པའི་བྱང་ཆུབ་མངོན་པར་རྫོགས་པར་འཚང་རྒྱ་བར་མི་བགྱིའོ་། ༎ བཅོམ་ལྡན་འདས་།
 mā tāvadahamanuttarāṃ samyaksaṃbodhimabhisaṃbudhyeyam ||	གལ་ཏེ་བདག་བྱང་ཆུབ་ཐོབ་པའི་ཚེ་སངས་རྒྱས་ཀྱི་ཞིང་དེར་སེམས་ཅན་གང་དག་སྐྱེས་པར་གྱུར་པ་དེ་དག་ཐམས་ཅད་སྐྱེས་བུ་ཆེན་པོའི་མཚན་སུམ་ཅུ་རྩ་གཉིས་དང་ལྡན་པར་མ་གྱུར་པ་དེ་སྲིད་དུ་བདག་བླ་ན་མེད་པ་ཡང་དག་པར་རྫོགས་པའི་བྱང་ཆུབ་མངོན་པར་རྫོགས་པར་འཚང་རྒྱ་བར་མི་བགྱིའོ་༎
 20| sacenme bhagavan bodhiprāptasya tatra buddhakṣetre ye sattvāḥ pratyājātā bhaveyuḥ, te sarve naikajātipratibaddhāḥ syuranuttarāyāṃ samyaksaṃbodhau sthāpayitvā praṇidhānaviśeṣān,	བཅོམ་ལྡན་འདས་། གལ་ཏེ་བདག་བྱང་ཆུབ་ཐོབ་པའི་ཚེ་སངས་རྒྱས་ཀྱི་ཞིང་དེར་༄༣༧༨བ་སེམས་ཅན་གང་དག་སྐྱེས་པར་གྱུར་པ་། 
 teṣāmeva bodhisattvānāṃ mahāsattvānāṃ mahāsaṃnāhasaṃnaddhānāṃ sarvalokārthasaṃbuddhānāṃ	བྱང་ཆུབ་སེམས་དཔའ་སེམས་དཔའ་ཆེན་པོ་གོ་ཆ་ཆེན་པོ་བགོས་པ་། འཇིག་རྟེན་ཐམས་ཅད་ཀྱི་དོན་དུ་གོ་ཆ་བགོས་པ་།
 sarvalokābhiyuktānāṃ sarvalokaparinirvāṇābhiyuktānāṃ sarvalokadhātuṣu bodhisattvacaryāṃ	འཇིག་རྟེན་ཐམས་ཅད་ཀྱི་དོན་ལ་བརྩོན་པ་། འཇིག་རྟེན་ཐམས་ཅད་ཡོངས་སུ་མྱ་ངན་ལས་བཟླ་བ་ལ་མངོན་པར་བརྩོན་པ་། འཇིག་རྟེན་གྱི་ཁམས་ཐམས་ཅད་དུ་བྱང་ཆུབ་སེམས་དཔའི་སྤྱད་པ་སྤྱོད་པར་འཚལ་བ་།
 caritukāmānāṃ sarvabuddhānāṃ saṃvartukāmānāṃ gaṅgānadīvālukāsamān sattvān anuttarāyāṃ	སངས་རྒྱས་ཐམས་ཅད་ལ་ཕུ་དུད་བགྱི་བར་འཚལ་བ་། སེམས་ཅན་གངགའའི་ཀླུང་གི་བྱེ་མ་སྙེད་བླ་ན་མེད་པ་ཡང་དག་པར་རྫོགས་པའི་བྱང་ཆུབ་ལ་དགོད་པར་འཚལ་བ་ཡང་གོང་མའི་སྤྱོད་པ་ལ་མངོན་དུ་ཕྱོགས་པ་།
 samyaksaṃbodhau pratiṣṭhāpakānāṃ bhūyaśca uttaracaryābhimukhānāṃ samantabhadracaryāniryātānām, mā tāvadahamanuttarāṃ samyaksaṃbodhimabhisaṃbudhyeyam ||	ཀུན་ཏུ་བཟང་པོའི་སྤྱོད་པས་ངེས་པར་བྱུང་བ་རྣམས་ཀྱི་སྨོན་ལམ་གྱི་ཁྱད་པར་མ་གཏོགས་པར་དེ་དག་ཐམས་ཅད་བླ་ན་མེད་པ་ཡང་དག་པར་རྫོགས་པའི་བྱང་ཆུབ་ཏུ་སྐྱེ་བ་གཅིག་གིས་ཐོག་པར་མ་གྱུར་པ་དེ་སྲིད་དུ་བདག་བླ་ན་མེད་པ་ཡང་དག་པར་རྫོགས་པའི་བྱང་ཆུབ་མངོན་པར་རྫོགས་པར་འཚང་རྒྱ་བར་མི་བགྱིའོ་༎ བཅོམ་ལྡན་འདས་། གལ་ཏེ་བདག་བྱང་ཆུབ་ཐོབ་པའི་ཚེ་།
 21| sacenme bhagavan bodhiprāptasya tatra buddhakṣetre ye bodhisattvāḥ pratyājātā bhaveyuḥ, te sarve ekapurobhaktena anyāni buddhakṣetrāṇi gatvā bahūni buddhaśatāni bahūni buddhasahasrāṇi bahūni buddhaśatasahasrāṇi bahvīrbuddhakoṭīryāvadbahūni buddhakoṭīniyutaśatasahasrāṇi	སངས་རྒྱས་ཀྱི་ཞིང་དེར་སེམས་ཅན་གང་དག་སྐྱེས་པར་གྱུར་པ་དེ་དག་ཐམས་ཅད་སྔ་དྲོ་གཅིག་བཞིན་སངས་རྒྱས་ཀྱི་ཞིང་གཞན་དག་ཏུ་མཆིས་ལ་། སངས་རྒྱས་བརྒྱ་ཕྲག་མང་པོ་དང་། སངས་རྒྱས་སྟོང་ཕྲག་མང་པོ་དང་། སངས་རྒྱས་བརྒྱ་སྟོང་ཕྲག་མང་པོ་དང་། སངས་རྒྱས་བྱེ་བ་ཕྲག་མང་པོ་ནས་སངས་རྒྱས་བྱེ་བ་ཁྲག་ཁྲིག་བརྒྱ་སྟོང་ཕྲག་མང་པོ་དག་ལ་༄༣༧༩ཨ་༌༎ འདི་ལྟ་སྟེ་།
 nopatiṣṭheran sarvasukhopadhānaiḥ tadidaṃ buddhānubhāvena, mā tāvadahamanuttarāṃ samyaksaṃbodhimabhisaṃbudhyeyam ||	སངས་རྒྱས་ཀྱི་མཐུས་བདེ་བར་སྦྱར་བ་ཐམས་ཅད་ཀྱིས་བསྙེན་བཀུར་བགྱིད་པར་མ་གྱུར་པ་དེ་སྲིད་དུ་བདག་བླ་ན་མེད་པ་ཡང་དག་པར་རྫོགས་པའི་བྱང་ཆུབ་མངོན་པར་རྫོགས་པར་འཚང་རྒྱ་བར་མི་བགྱིའོ་༎ བཅོམ་ལྡན་འདས་།
 22| sacenme bhagavan bodhiprāptasta tatra buddhakṣetre bodhisattvā yathārūpairākārairākāṅkṣeyuḥ	གལ་ཏེ་བདག་བྱང་ཆུབ་ཐོབ་པའི་ཚེ་སངས་རྒྱས་ཀྱི་ཞིང་དེ་ན་བྱང་ཆུབ་སེམས་དཔའ་དེ་དག་འདི་ལྟ་སྟེ་། གསེར་རམ་། དངུལ་ལམ་། ནོར་བུའམ་། མུ་ཏིག་གམ་། བེཨེ་དའུརྱའམ་། དུང་ངམ་། མན་ཤེལ་ལམ་། བྱི་རུའམ་། ཤེལ་ལམ་། སྤུག་གམ་།
 kuśalamūlānyavaropayituṃ yadidaṃ suvarṇena vā rajatena vā maṇimuktāvaiḍūryaśaṅkhaśilāpravālasphaṭikamusāragalvalohitamuktāśmagarbhādibhirvā	རྡོའི་སྙིང་པོའམ་། མུ་ཏིག་དམར་པོ་ལ་སོགས་པ་གང་ཡང་རུང་བའམ་།
 anyatamānyatamaiḥ sarvai ratnairvā sarvagandhapuṣpamālyavilepanadhūpacūrṇacīvaracchatradhvajapatākāpradīpairvā (sukhv, vaidya 228) sarvanṛtyagītavādhairvā,	རིན་པོ་ཆེ་ཐམས་ཅད་དམ་། མེ་ཏོག་དང་། སྤོས་དང་། ཕྲེང་བ་དང་། བྱུག་པ་དང་། བདུག་པ་དང་། ཕྱེ་མ་དང་། གོས་དང་། གདུགས་དང་། རྒྱལ་མཚན་དང་། བ་དན་དང་། མར་མེ་ཐམས་ཅད་དང་། གླུ་དང་། གར་དང་། རོལ་མོའི་དབྱངས་སྒྲའམ་།
 teṣāṃ ca tathārūpā āhārāḥ sahacittotpādānna prādurbhaveyuḥ, mā tāvadahamanuttarāṃ samyaksaṃbodhimabhisaṃbudhyeyam ||	རྣམ་པ་ཇི་ལྟ་བུ་དག་འཚལ་བར་གྱུར་ནས་དགེ་བའི་རྩ་བ་རྣམས་བསྐྲུན་པ་རྣམ་པ་དེ་ལྟ་བུ་དེ་དག་སེམས་བསྐྱེད་མ་ཐག་ཏུ་གལ་ཏེ་དེ་དག་ལ་བྱུང་བར་མ་གྱུར་པ་དེ་སྲིད་དུ་བདག་བླ་ན་མེད་པ་ཡང་དག་པར་རྫོགས་པའི་བྱང་ཆུབ་མངོན་པར་རྫོགས་པར་འཚང་རྒྱ་བར་མི་བགྱིའོ་༎ བཅོམ་ལྡན་འདས་།
 23| sacenme bhagavan bodhiprāptasya tatra buddhakṣetre ye sattvāḥ pratyājātā bhaveyuḥ, te sarva na sarvajñatāsahagatāṃ dharmakathāṃ kathayeyuḥ, mā tāvadahamanuttarāṃ samyaksaṃbodhimabhisaṃbudhyeyam ||	གལ་ཏེ་བདག་བྱང་ཆུབ་ཐོབ་པའི་ཚེ་སངས་རྒྱས་ཀྱི་ཞིང་དེར་སེམས་ཅན་གང་དག་སྐྱེས་པར་གྱུར་པ་དེ་དག་ཐམས་ཅད་ཐམས་ཅད་མཁྱེན་པ་ཉིད་༄༣༧༩བ་དང་ལྡན་པའི་ཆོས་ཀྱི་བཀའ་མཆིད་མཆི་བར་མ་གྱུར་པ་དེ་སྲིད་དུ་བདག་བླ་ན་མེད་པ་ཡང་དག་པར་རྫོགས་པའི་བྱང་ཆུབ་མངོན་པར་རྫོགས་པར་འཚང་བརྒྱ་བར་མི་བགྱིའོ་༎
 24| sacenme bhagavan bodhiprāptasya tatra buddhakṣetre ye bodhisattvā evaṃ cittamutpādayeyuḥ - yadihaiva vayaṃ lokadhātau sthitvā aprameyāsaṃkhyeyeṣu buddhakṣetreṣu buddhān bhagavataḥ	བཅོམ་ལྡན་འདས་། གལ་ཏེ་བདག་བྱང་ཆུབ་ཐོབ་པའི་ཚེ་སངས་རྒྱས་ཀྱི་ཞིང་དེ་ན་བྱང་ཆུབ་སེམས་དཔའ་གང་དག་འདི་སྙམ་དུ་བདག་ཅག་འཇིག་རྟེན་གྱི་ཁམས་འདི་ན་གནས་བཞིན་དུ་སངས་རྒྱས་ཀྱི་ཞིང་གྲངས་མེད་དཔག་ཏུ་མེད་པ་དག་ཏུ་སངས་རྒྱས་བཅོམ་ལྡན་འདས་རྣམས་ལ་འདི་ལྟ་སྟེ་།
 satkuryām gurukuryām mānayema pūjayema yadidaṃ cīvarapiṇḍapātraśayanāsanaglānapratyayabhaiṣajyapariṣkāraiḥ puṣpadhūpadīpagandhamālyavilepanacūrṇacīvaracchatradhvajapatākābhirnānāvidhanṛtyagītavādyai ratnavarṣairiti,	ན་བཟའ་དང་། ཞལ་ཟས་དང་། གཟིམས་ཆ་དང་། སྙུན་གསོས་ཀྱི་སྨན་དང་། ཡོ་བྱད་རྣམས་དང་། མེ་ཏོག་དང་། བདུག་པ་དང་། སྤོས་དང་། ཕྲེང་བ་དང་། བྱུག་པ་དང་། ཕྱེ་མ་དང་། ན་བཟའ་དང་། གདུགས་དང་། རྒྱལ་མཚན་དང་། བ་དན་རྣམས་དང་། གླུ་དང་། གར་དང་། སིལ་སྙན་དང་། རིན་པོ་ཆེ་རྣམ་པ་ཐ་དད་པའི་ཆར་རྣམས་ཀྱིས་བསྟི་སྟང་དུ་བགྱི་བ་དང་། བླ་མར་བགྱི་བ་དང་། རིམ་གྲོར་བགྱི་བ་དང་། མཆོད་པར་བགྱི་བར་སེམས་བསྐྱེད་ལ་།
 teṣāṃ ca buddhā bhagavantaḥ sahacittotpādānna pratigṛhṇīyuryadidamanukampāmupādāya,	དེ་དག་གིས་སེམས་བསྐྱེད་མ་ཐག་ཏུ་གལ་ཏེ་འདི་ལྟར་སངས་རྒྱས་བཅོམ་ལྡན་འདས་དེ་དག་གིས་ཐུགས་བརྩེ་བ་ཉེ་བར་བཟུང་སྟེ་།
 mā tāvadahamanuttarāṃ samyaksaṃbodhimabhisaṃbudhyeyam ||	མཆོད་པ་དེ་དག་བཞེས་པར་མ་གྱུར་པ་དེ་སྲིད་དུ་བདག་བླ་ན་མེད་པ་ཡང་དག་པར་རྫོགས་པའི་བྱང་ཆུབ་མངོན་པར་རྫོགས་པར་འཚང་རྒྱ་བར་མི་བགྱིའོ་༎ བཅོམ་ལྡན་འདས་།
 25| sacenme bhagavan bodhiprāptasya tatra buddhakṣetre ye bodhisattvāḥ pratyājātā bhaveyuḥ, te sarve na nārāyaṇavajrasaṃhatātmabhāvasthāmapratilabdhā bhaveyuḥ, mā tāvadahamanuttarāṃ samyaksaṃbodhimabhisaṃbudhyeyam ||	གལ་ཏེ་བདག་བྱང་ཆུབ་ཐོབ་པའི་ཚེ་སངས་རྒྱས་ཀྱི་ཞིང་དེར་སེམས་ཅན་གང་དག་སྐྱེས་པར་༄༣༨༠ཨ་༌༎ གྱུར་པ་དེ་དག་ཐམས་ཅད་སྲེད་མེད་ཀྱི་བུ་དང་། རྡོ་རྗེ་ལྟར་མཁྲེགས་པའི་ལུས་དང་། མཐུ་ཐོབ་པར་མ་གྱུར་པ་དེ་སྲིད་དུ་བདག་བླ་ན་མེད་པ་ཡང་དག་པར་རྫོགས་པའི་བྱང་ཆུབ་མངོན་པར་རྫོགས་པར་འཚང་རྒྱ་བར་མི་བགྱིའོ་༎ བཅོམ་ལྡན་འདས་།
 26| sacenme bhagavan bodhiprāptasya tatra buddhakṣetre yaḥ kaścitsattvo 'laṃkārasya varṇaparyantamudgṛhṇīyāt - antaśo divyenāpi cakṣuṣā evaṃvarṇamevaṃvibhūti idaṃ buddhakṣetramiti	གལ་ཏེ་བདག་བྱང་ཆུབ་ཐོབ་པའི་ཚེ་སངས་རྒྱས་ཀྱི་ཞིང་དེ་ན་རྒྱན་གྱི་ཁ་དོག་སེམས་ཅན་འགའ་ཞིག་གིས་ལྷའི་མིག་གིས་མཐའ་བལྟ་ན་ཡང་སངས་རྒྱས་ཀྱི་ཞིང་འདིའི་གཟི་བརྗིད་ནི་འདི་ལྟ་བུའོ་༎ 
 nānāvarṇatāṃ jānīyāt,	ཁ་དོག་ནི་འདི་ལྟ་བུའོ་༎
 mā tāvadahamanuttarāṃ samyaksaṃbodhimabhisaṃbudhyeyam ||	འབྱོར་པ་ནི་འདི་ལྟ་བུའོ་ཞེས་ཁ་དོག་ཐ་དད་པ་དག་འཚལ་བར་མ་གྱུར་པ་དེ་སྲིད་དུ་བདག་བླ་ན་མེད་པ་ཡང་དག་པར་རྫོགས་པའི་བྱང་ཆུབ་མངོན་པར་རྫོགས་པར་འཚང་རྒྱ་བར་མི་བགྱིའོ་༎ བཅོམ་ལྡན་འདས་།
 27| sacenme bhagavan bodhiprāptasya tatra buddhakṣetre yaḥ sarvaparīttakuśalamūlo bodhisattvaḥ so 'ntaśo yojanaśatotthitamudāravarṇaṃ bodhivṛkṣaṃ na saṃjānīyāt, mā tāvadahamanuttarāṃ samyaksaṃbodhimabhisaṃbudhyeyam ||	གལ་ཏེ་བདག་བྱང་ཆུབ་ཐོབ་པའི་ཚེ་སངས་རྒྱས་ཀྱི་ཞིང་དེ་ན་ཐམས་ཅད་ཀྱི་ནང་ནས་བྱང་ཆུབ་སེམས་དཔའ་གང་དགེ་བའི་རྩ་བ་ཆུང་བ་དེས་ཀྱང་བྱང་ཆུབ་ཀྱི་ཤིང་དཔག་ཚད་སྟོང་དྲུག་བརྒྱ་ཙམ་དུ་མཐོང་བར་འཚལ་བར་མ་གྱུར་པ་དེ་སྲིད་དུ་བདག་བླ་ན་མེད་པ་ཡང་དག་པར་རྫོགས་པའི་བྱང་ཆུབ་མངོན་པར་རྫོགས་པར་འཚང་རྒྱ་བར་མི་བགྱིའོ་༎ བཅོམ་ལྡན་འདས་།
 28| sacenme bhagavan bodhiprāptasya tatra buddhakṣetre kasyacitsattvasyoddeśo vā svādhyāyo vā kartavyaḥ syāt,	གལ་ཏེ་བདག་བྱང་ཆུབ་ཐོབ་པའི་ཚེ་སངས་རྒྱས་ཀྱི་ཞིང་དེ་ན་བྱང་ཆུབ་སེམས་དཔའ་གང་ལུང་ནོད་པ་དང་། 
 na te sarve pratisaṃvitprāptā bhaveyuḥ, mā tāvadahamanuttarāṃ samyaksaṃbodhimabhisaṃbudhyeyam ||	ཁ་ཏོན་བགྱིད་པར་གྱུར་པ་དེ་དག་ཐམས་ཅད་སོ་སོ་ཡང་དག་པར་རིག་པ་ཐོབ་པར་མ་གྱུར་པ་དེ་སྲིད་དུ་བདག་བླ་ན་མེད་༄༣༨༠བ་པ་ཡང་དག་པར་རྫོགས་པའི་བྱང་ཆུབ་མངོན་པར་རྫོགས་པར་འཚང་རྒྱ་བར་མི་ནོད་པ་དང་། བགྱིའོ་༎ བཅོམ་ལྡན་འདས་། གལ་ཏེ་བདག་བྱང་ཆུབ་ཐོབ་པའི་ཚེ་སངས་རྒྱས་ཀྱི་ཞིང་དེར་སེམས་ཅན་གང་དག་སྐྱེས་པར་གྱུར་པ་དེ་དག་ཐམས་ཅད་ཤེས་རབ་དང་སྤོབས་པ་མཐའ་ཡས་པ་ཐོབ་པར་མ་གྱུར་པ་དེ་སྲིད་དུ་བདག་བླ་ན་མེད་པ་ཡང་དག་པར་རྫོགས་པའི་བྱང་ཆུབ་མངོན་པར་རྫོགས་པར་འཚང་རྒྱ་བར་མི་བགྱིའོ་༎ 
 29| sacenme bhagavan bodhiprāptasya naivaṃ prabhāsvaraṃ tadbuddhakṣetraṃ bhavedyatra	བཅོམ་ལྡན་འདས་། གལ་ཏེ་བདག་བྱང་ཆུབ་ཐོབ་པའི་ཚེ་སངས་རྒྱས་ཀྱི་ཞིང་དེར་གང་ན་ཀུན་དུ་སངས་རྒྱས་ཀྱི་ཞིང་དཔག་ཏུ་མ་མཆིས་། གྲངས་མ་མཆིས་།
 samantādaprameyāsaṃkhyeyācintyātulyāparimāṇāni buddhakṣetrāṇi saṃdṛśyeran tadyathāpi	བསམ་གྱིས་མི་ཁྱབ་། མཚུངས་པ་མ་མཆིས་། ཚད་མ་མཆིས་པ་དག་ཀུན་དུ་གདའ་བ་འདི་ལྟ་སྟེ་། དཔེར་བགྱི་ན་།
 nāma parimṛṣṭe ādarśamaṇḍale mukhamaṇḍalam, mā tāvadahamanuttarāṃ samyaksaṃbodhimabhisaṃbudhyeyam ||	ཤིན་ཏུ་ཕྱིས་པའི་མེ་ལོང་གི་དཀྱིལ་འཁོར་ལ་བཞིན་གྱི་དཀྱིལ་འཁོར་གདའ་བ་དེ་ལྟ་བུའི་འོད་གསལ་བར་མ་གྱུར་པ་དེ་སྲིད་དུ་བདག་བླ་ན་མེད་པ་ཡང་དག་པར་རྫོགས་པའི་བྱང་ཆུབ་མངོན་པར་རྫོགས་པར་འཚང་རྒྱ་བར་མི་བགྱིའོ་༎
 30| sacenme bhagavan bodhiprāptasya tatra buddhakṣetre dharaṇītalamupādāya yāvadantarīkṣāddevamanuṣyaviṣayātikrāntasyābhijātasya	བཅོམ་ལྡན་འདས་། གལ་ཏེ་བདག་བྱང་ཆུབ་ཐོབ་པའི་ཚེ་སངས་རྒྱས་ཀྱི་ཞིང་དེ་ན་སའི་སྟེང་ནས་བཟུང་སྟེ་བར་སྣང་གི་བར་ལས་ལྷ་དང་མིའི་ཡུལ་ལས་ཤིན་ཏུ་འདས་པའི་གདུག་པ་རིགས་བཟང་པོ་དེ་བཞིན་གཤེགས་པ་དང་། 
 dhūpasya tathāgatabodhisattvapūjāpratyarhasya sarvaratnamayāni nānāsurabhigandhaghaṭikāśatasahasrāṇi sadā nidhūpitānyava na syuḥ,	བྱང་ཆུབ་སེམས་དཔའ་ལ་འོས་པ་དག་དྲི་རབ་ཏུ་བདའ་བའི་པོག་སྣོད་རིན་པོ་ཆེ་སྣ་ཚོགས་ལས་བགྱིས་པ་བརྒྱ་སྟོང་དག་ནས་རྟག་ཏུ་གདུགས་པར་མ་གྱུར་པ་དེ་སྲིད་དུ་བདག་བླ་ན་མེད་པ་ཡང་དག་པར་༄༣༨༡ཨ་གཤེགས་པ་དང་། 
 mā tāvadahamanuttarāṃ samyaksaṃbodhimabhisaṃbudhyeyam ||	༌༎ རྫོགས་པའི་བྱང་ཆུབ་མངོན་པར་རྫོགས་པར་འཚང་རྒྱ་བར་མི་བགྱིའོ་༎ བཅོམ་ལྡན་འདས་།
 31| sacenme bhagavan bodhiprāptasya tatra buddhakṣetre na sadābhipravṛṣṭānyeva sugandhinānāratnapuṣpavarṣāṇi sadā pravāditāśca manojñasvarā vādyameghā na syuḥ,	གལ་ཏེ་བདག་བྱང་ཆུབ་ཐོབ་པའི་ཚེ་སངས་རྒྱས་ཀྱི་ཞིང་དེ་ན་མེ་ཏོག་དྲི་རབ་ཏུ་བདའ་བ་ཐ་དད་པའི་ཆར་རྟག་ཏུ་འབབ་པར་གྱུར་པ་དང་། 
 mā tāvadahamanuttarāṃ samyaksaṃbodhimabhisaṃbudhyeyam || (sukhv, vaidya 229)	རོལ་མོའི་དབྱངས་སྒྲའི་ང་རོ་ཡིད་དུ་མཆི་བའི་སྤྲིན་རྟག་ཏུ་སྒྲ་འབྱུང་བར་མ་གྱུར་པ་དེ་སྲིད་དུ་བདག་བླ་ན་མེད་པ་ཡང་དག་པར་རྫོགས་པའི་བྱང་ཆུབ་མངོན་པར་རྫོགས་པར་འཚང་རྒྱ་བར་མི་བགྱིའོ་༎ བཅོམ་ལྡན་འདས་།
 32| sacenme bhagavan bodhiprāptasya ye sattvā aprameyāsaṃkhyeyācinyātulyeṣu lokadhātuṣvābhayā sphuṭā bhaveyuḥ,	གལ་ཏེ་བདག་བྱང་ཆུབ་ཐོབ་པའི་ཚེ་བདག་གི་འོད་ཀྱིས་འཇིག་རྟེན་གྱི་ཁམས་གྲངས་མ་མཆིས་། བསམ་གྱིས་མི་ཁྱབ་།
 te sarve na devamanuṣyasamatikrāntena sukhena samanvāgatā bhaveyuḥ, mā tāvadahamanuttarāṃ samyaksaṃbodhimabhisaṃbudhyeyam ||	མཚུངས་པ་མ་མཆིས་པ་དག་ཏུ་སེམས་ཅན་གང་དག་ལ་གསལ་བར་གྱུར་པ་དེ་དག་ཐམས་ཅད་ལྷ་དང་མི་ལས་ཤིན་ཏུ་འདས་པའི་བདེ་བ་དང་ལྡན་པར་མ་གྱུར་པ་དེ་སྲིད་དུ་བདག་བླ་ན་མེད་པ་ཡང་དག་པར་རྫོགས་པའི་བྱང་ཆུབ་མངོན་པར་རྫོགས་པར་འཚང་རྒྱ་བར་མི་བགྱིའོ་༎ བཅོམ་ལྡན་འདས་།
 33| sacenme bhagavan bodhiprāptasya samantādaprameyācintyātulyāparimāṇeṣu buddhakṣetreṣu	གལ་ཏེ་བདག་བྱང་ཆུབ་ཐོབ་པའི་ཚེ་ཀུན་དུ་སངས་རྒྱས་ཀྱི་ཞིང་དཔག་ཏུ་མ་མཆིས་། གྲངས་མ་མཆིས་། བསམ་གྱིས་མི་ཁྱབ་། མཚུངས་པ་མ་མཆིས་།
 bodhisattvā mahāsattvā mama nāmadheyaṃ śrutvā tacchravaṇasahagatena kuśalena jātivyativṛttāḥ	ཚད་མ་མཆིས་པ་དག་ཏུ་བྱང་ཆུབ་སེམས་དཔའ་དག་གིས་བདག་གི་མིང་ཐོས་ཏེ་།
 santo na dhāraṇīpratilabdhā bhaveyuryāvadbodhimaṇḍaparyantamiti, mā tāvadahamanuttarāṃ samyaksaṃbodhimabhisaṃbudhyeyam ||	ཐོས་མ་ཐག་པ་ལས་བྱུང་བའི་དགེ་བའི་རྩ་བས་ཚེ་བརྗེས་ནས་བྱང་ཆུབ་ཀྱི་སྙིང་པོའི་མཐའི་བར་དུ་གཟུངས་ཐོབ་པར་མ་གྱུར་པ་དེ་སྲིད་དུ་བདག་བླ་ན་མེད་པ་༄༣༨༡བ་ཡང་དག་པར་རྫོགས་པའི་བྱང་ཆུབ་མངོན་པར་རྫོགས་པར་འཚང་རྒྱ་བར་མི་བགྱིའོ་༎ བཅོམ་ལྡན་འདས་།
 34| sacenme bhagavan bodhiprāptasya samantādaprameyāsaṃkhyeyācintyātulyāparimāṇeṣu buddhakṣetreṣu yāḥ striyo mama nāmadheyaṃ śrutvā pramādaṃ	གལ་ཏེ་བདག་བྱང་ཆུབ་ཐོབ་པའི་ཚེ་ཀུན་དུ་སངས་རྒྱས་ཀྱི་ཞིང་གྲངས་མ་མཆིས་། བསམ་གྱིས་མི་ཁྱབ་། མཚུངས་པ་མ་མཆིས་། ཚད་མ་མཆིས་པ་དག་ན་བུད་མེད་གང་དག་གིས་བདག་གི་མིང་ཐོས་ནས་རབ་ཏུ་དང་བ་སྐྱེས་ཏེ་། 
 bodhicittaṃ notpādayeyuḥ,	བྱང་ཆུབ་ཏུ་སེམས་བསྐྱེད་པར་གྱུར་ལ་།
 strībhāvaṃ ca na vijugupseran,	བུད་མེད་ཀྱི་ལུས་ལ་སྨོད་པར་གྱུར་ཏེ་།
 jātivyativṛttāḥ samānāḥ saceddvitīyaṃ strībhāvaṃ pratilabheran, mā tāvadahamanuttarāṃ samyaksaṃbodhimabhisaṃbudhyeyam ||	དེ་དག་ཚེ་བརྗེས་ནས་གལ་ཏེ་བུད་མེད་ཀྱི་ལུས་ལན་གཉིས་ཐོབ་པར་གྱུར་པ་དེ་སྲིད་དུ་བདག་བླ་ན་མེད་པ་ཡང་དག་པར་རྫོགས་པའི་བྱང་ཆུབ་མངོན་པར་རྫོགས་པར་འཚང་རྒྱ་བར་མི་བགྱིའོ་༎ བཅོམ་ལྡན་འདས་། གལ་ཏེ་བདག་བྱང་ཆུབ་ཐོབ་པའི་ཚེ་སངས་རྒྱས་ཀྱི་ཞིང་དཔག་ཏུ་མ་མཆིས་། གྲངས་མ་མཆིས་། བསམ་གྱིས་མི་ཁྱབ་། མཚུངས་པ་མ་མཆིས་། ཚད་མ་མཆིས་པ་དག་ན་སེམས་ཅན་གང་དག་གིས་བདག་གི་མིང་ཐོས་པར་གྱུར་ལ་། མིང་ཐོས་པ་ཙམ་གྱིས་བྱང་ཆུབ་ཀྱི་སྙིང་པོའི་མཐའི་བར་དུ་ཚངས་པར་སྤྱོད་པར་མ་གྱུར་པ་དེ་སྲིད་དུ་བདག་བླ་ན་མེད་པ་ཡང་དག་པར་རྫོགས་པའི་བྱང་ཆུབ་མངོན་པར་རྫོགས་པར་འཚང་རྒྱ་བར་མི་བགྱིའོ་༎ བཅོམ་ལྡན་འདས་།
 35| sacenme bhagavan bodhiprāptasya samantāddaśasu dikṣu aprameyāsaṃkhyeyācintyātulyāparimāṇeṣu	གལ་ཏེ་བདག་བྱང་ཆུབ་ཐོབ་པའི་ཚེ་ཕྱོགས་བཅུ་ཀུན་དུ་སངས་རྒྱས་ཀྱི་ཞིང་དཔག་ཏུ་མ་མཆིས་། གྲངས་མ་མཆིས་། བསམ་གྱིས་མི་ཁྱབ་། མཚུངས་པ་མ་མཆིས་། ཚད་མ་མཆིས་པ་དག་ན་སེམས་ཅན་གང་དག་གིས་བདག་གི་མིང་ཐོས་པ་༄༣༨༢ཨ་༌༎
 buddhakṣetreṣu ye bodhisattvā mama nāmadheyaṃ śrutvā praṇipatya pañcamaṇḍalanamaskāreṇa vandiṣyante te bodhisattvacaryāṃ caranto na sadevakena lokena satkriyeran, mā tāvadahamanuttarāṃ samyaksaṃbodhimabhisaṃbudhyeyam ||	ལ་ཡན་ལག་ལྔའི་ཕྱག་བགྱི་བས་ཕྱག་འཚལ་བ་དང་། དེ་དག་བྱང་ཆུབ་སེམས་དཔའི་སྤྱད་པ་སྤྱོད་པ་ན་ལྷ་དང་བཅས་པའི་འཇིག་རྟེན་གྱིས་བསྟི་སྟང་དུ་བགྱི་བར་མ་གྱུར་པ་དེ་སྲིད་དུ་བདག་བླ་ན་མེད་པ་ཡང་དག་པར་རྫོགས་པའི་བྱང་ཆུབ་མངོན་པར་རྫོགས་པར་འཚང་རྒྱ་བར་མི་བགྱིའོ་༎ བཅོམ་ལྡན་འདས་།
 36| sacenme bhagavan bodhiprāptasya kasyacidbodhisattvasya cīvaradhāvanaśoṣaṇasīvanarañjanakarma kartavyaṃ bhavet,	གལ་ཏེ་བདག་བྱང་ཆུབ་ཐོབ་པའི་ཚེ་སངས་རྒྱས་ཀྱི་ཞིང་དེ་ན་བྱང་ཆུབ་སེམས་དཔའ་གང་ཆོས་གོས་འཁྲུའམ་། སྐེམས་སམ་། འདྲུབ་བམ་། འཚེད་པའི་ལས་བགྱིད་པར་གྱུར་ལ་།
 na tveva navābhijātacīvararatnaiḥ prāvṛtamevātmānaṃ saṃjānīyuḥ sahacittotpādāttathāgatānujñātaiḥ, mā tāvadahamanuttarāṃ samyaksaṃbodhimabhisaṃbudhyeyam ||	ཆོས་གོས་རིན་པོ་ཆེ་སར་པ་ཁྲེའུ་ཚང་རིགས་བཟང་བ་དེ་བཞིན་གཤེགས་པས་གནང་བ་དག་སེམས་བསྐྱེད་མ་ཐག་ཏུ་བགོས་པར་བདག་གིས་འཚལ་བར་མ་གྱུར་པ་དེ་སྲིད་དུ་བདག་བླ་ན་མེད་པ་ཡང་དག་པར་རྫོགས་པའི་བྱང་ཆུབ་མངོན་པར་རྫོགས་པར་འཚང་རྒྱ་བར་མི་བགྱིའོ་༎ བཅོམ་ལྡན་འདས་།
 37| sacenme bhagavan bodhiprāptasya tatra buddhakṣetre sahotpannāḥ sattvā naivaṃvidhaṃ sukhaṃ pratilabheraṃstadyathāpi nāma niṣparidāhasyārhato	གལ་ཏེ་བདག་བྱང་ཆུབ་ཐོབ་པའི་ཚེ་སངས་རྒྱས་ཀྱི་ཞིང་དེར་སེམས་ཅན་གང་དག་སྐྱེས་མ་ཐག་ཏུ་འདི་ལྟ་སྟེ་། དཔེར་ན་། དགེ་སློང་དགྲ་བཅོམ་པ་ཡོངས་སུ་གདུང་བ་མ་མཆིས་པ་།
 mā tāvadahamanuttarāṃ samyaksaṃbodhimabhisaṃbudhyeyam ||	བསམ་གཏན་གསུམ་པ་ལ་སྙོམས་པར་ཞུགས་པ་ལྟ་བུར་བདེ་བ་རྣམ་པ་དེ་ལྟ་བུ་ཐོབ་པར་མ་གྱུར་པ་དེ་སྲིད་དུ་བདག་བླ་ན་མེད་པ་ཡང་དག་པར་རྫོགས་པའི་བྱང་ཆུབ་མངོན་པར་རྫོགས་པར་འཚང་རྒྱ་བར་མི་བགྱིའོ་༎ བཅོམ་ལྡན་འདས་།
 38| sacenme bhagavan bodhiprāptasya tatra buddhakṣetre ye bodhisattvāḥ pratyājātāḥ, te yathārūpaṃ buddhakṣetre guṇālaṃkāravyūhamākāṅkṣeyuḥ, tathārūpaṃ nānāratnavṛkṣebhyo na saṃjanayeyuḥ, mā tāvadahamanuttarāṃ samyaksaṃbodhimabhisaṃbudhyeyam ||	གལ་ཏེ་བདག་བྱང་ཆུབ་ཐོབ་པའི་ཚེ་༄༣༨༢བ་སངས་རྒྱས་ཀྱི་ཞིང་དེར་བྱང་ཆུབ་སེམས་དཔའ་གང་དག་སྐྱེས་པར་གྱུར་པ་དེ་དག་སངས་རྒྱས་ཀྱི་ཞིང་གི་ཡོན་ཏན་གྱི་རྒྱན་བཀོད་པ་རྣམ་པ་ཇི་ལྟ་བུ་དག་འདོད་པར་གྱུར་པ་རྣམ་པ་དེ་ལྟ་བུ་དག་རིན་པོ་ཆེའི་ཤིང་སྣ་ཚོགས་ལས་འཚལ་བར་མ་གྱུར་པ་དེ་སྲིད་དུ་བདག་བླ་ན་མེད་པ་ཡང་དག་པར་རྫོགས་པའི་བྱང་ཆུབ་མངོན་པར་རྫོགས་པར་འཚང་རྒྱ་བར་མི་བགྱིའོ་༎
 39| sacenme bhagavan bodhiprāptasya mama nāmadheyaṃ śrutvā anyabuddhakṣetropapannā bodhisattvā indriyabalavaikalyaṃ gaccheyuḥ,	བཅོམ་ལྡན་འདས་། གལ་ཏེ་བདག་བྱང་ཆུབ་ཐོབ་པའི་ཚེ་བྱང་ཆུབ་སེམས་དཔའ་སངས་རྒྱས་ཀྱི་ཞིང་གཞན་དུ་སྐྱེས་པ་དག་གིས་བདག་གི་མིང་ཐོས་ལ་།
 mā tāvadahamanuttarāṃ samyaksaṃbodhimabhisaṃbudhyeyam ||	དབང་པོ་མ་ཚང་པ་མེད་པ་ཐོབ་པར་མ་གྱུར་པ་དེ་སྲིད་དུ་བདག་བླ་ན་མེད་པ་ཡང་དག་པར་རྫོགས་པའི་བྱང་ཆུབ་མངོན་པར་རྫོགས་པར་འཚང་རྒྱ་བར་མི་བགྱིའོ་༎ བཅོམ་ལྡན་འདས་། གལ་ཏེ་བདག་བྱང་ཆུབ་ཐོབ་པའི་ཚེ་།
 40| sacenme bhagavan bodhiprāptasya tadanyabuddhakṣetrasthāne bodhisattvā mama nāmadheyasahaśravaṇānna suvibhaktavatīṃ nāma samādhiṃ pratilabheran, yatra samādhau sthitvā bodhisattvā ekakṣaṇavyatihāreṇa aprameyāsaṃkhyeyācintyātulyāparimāṇān buddhān bhagavataḥ paśyanti, sa caiṣāṃ samādhirantarā vipraṇaśyet,	སངས་རྒྱས་ཀྱི་ཞིང་གཞན་ན་གནས་པའི་བྱང་ཆུབ་སེམས་དཔའ་དག་གིས་བདག་གི་མིང་ཐོས་མ་ཐག་ཏུ་ཤིན་ཏུ་རྣམ་པར་ཕྱེ་བ་ཞེས་བགྱི་བའི་ཏིང་ངེ་འཛིན་ཐོབ་པར་མ་གྱུར་པ་དང་། བྱང་ཆུབ་སེམས་དཔའ་ཏིང་ངེ་འཛིན་དེ་ལ་གནས་ནས་སྐད་ཅིག་གཅིག་འདས་པ་ཙམ་གྱིས་སངས་རྒྱས་བཅོམ་ལྡན་འདས་དཔག་ཏུ་མ་མཆིས་། གྲངས་མ་མཆིས་། བསམ་གྱིས་མི་ཁྱབ་། མཚུངས་པ་མ་མཆིས་། ཚད་མ་མཆིས་པ་དག་མཐོང་ལ་།
 mā tāvadahamanuttarāṃ samyaksaṃbodhimabhisaṃbudhyeyam ||	ཏིང་ངེ་འཛིན་དེ་བར་མ་དོར་ཆབ་འཚལ་བར་མ་གྱུར་པ་དེ་སྲིད་དུ་བདག་བླ་ན་མེད་པ་ཡང་དག་པར་རྫོགས་པའི་བྱང་ཆུབ་མངོན་པར་རྫོགས་པར་༄༣༨༣ཨ་༌༎ འཚང་རྒྱ་བར་མི་བགྱིའོ་༎ བཅོམ་ལྡན་འདས་།
 41| sacenme bhagavan bodhiprāptasya tadanyeṣu buddhakṣetreṣu mama nāmadheyaṃ śrutvā	གལ་ཏེ་བདག་བྱང་ཆུབ་ཐོབ་པའི་ཚེ་སེམས་ཅན་དག་གིས་བདག་གི་མིང་ཐོས་ལ་།
 tacchravaṇasahagatena kuśalamūlena sattvā nābhijātakulopapattiṃ pratilabheran yāvadbodhiparyantam, mā tāvadahamanuttarāṃ samyaksaṃbodhimabhisaṃbudhyeyam || (sukhv, vaidya 230)	ཐོས་མ་ཐག་པ་ལས་བྱུང་བའི་དགེ་བའི་རྩ་བས་སེམས་ཅན་རྣམས་བྱང་ཆུབ་ཀྱི་མཐའི་བར་དུ་རིགས་བཟང་པོའི་རིགས་སུ་སྐྱེ་བ་ཐོབ་པར་མ་གྱུར་པ་དེ་སྲིད་དུ་བདག་བླ་ན་མེད་པ་ཡང་དག་པར་རྫོགས་པའི་བྱང་ཆུབ་མངོན་པར་རྫོགས་པར་འཚང་རྒྱ་བར་མི་བགྱིའོ་༎
 42| sacenme bhagavan bodhiprāptasya tadanyeṣu buddhakṣetreṣu ye bodhisattvā mama	བཅོམ་ལྡན་འདས་། གལ་ཏེ་བདག་བྱང་ཆུབ་ཐོབ་པའི་ཚེ་འདི་ལས་གཞན་དུ་གྱུར་པའི་སངས་རྒྱས་ཀྱི་ཞིང་རྣམས་སུ་བྱང་ཆུབ་སེམས་དཔའ་གང་དག་གིས་བདག་གི་མིང་ཐོས་པར་གྱུར་ལ་།
 nāmadheyaṃ śrutvā tacchravaṇakuśalamūlena yāvadbodhiparyantaṃ te sarve bodhisattvacaryāprītiprāmodyakuśalamūlasamavadhānagatā na bhaveyuḥ, mā tāvadahamanuttarāṃ samyaksaṃbodhimabhisaṃbudhyeyam ||	དེ་ཐོས་མ་ཐག་པ་ལས་བྱུང་བའི་དགེ་བའི་རྩ་བས་བྱང་ཆུབ་ཀྱི་མཐའི་བར་དུ་ཐམས་ཅད་བྱང་ཆུབ་སེམས་དཔའི་སྤྱོད་པ་ལ་དགའ་བ་དང་། མཆོག་ཏུ་དགའ་བའི་དགེ་བའི་རྩ་བ་དང་ཕྲད་པར་མ་གྱུར་པ་དེ་སྲིད་དུ་བདག་བླ་ན་མེད་པ་ཡང་དག་པར་རྫོགས་པའི་བྱང་ཆུབ་མངོན་པར་རྫོགས་པར་འཚང་རྒྱ་བར་མི་བགྱིའོ་༎
 43| sacenme bhagavan bodhiprāptasya sahanāmadheyaśravaṇāttadanyeṣu lokadhātuṣu bodhisattvā na samantānugataṃ nāma samādhiṃ pratilabheran,	བཅོམ་ལྡན་འདས་། གལ་ཏེ་བདག་བྱང་ཆུབ་ཐོབ་པའི་ཚེ་འདི་ལས་གཞན་དུ་གྱུར་པའི་འཇིག་རྟེན་གྱི་ཁམས་རྣམས་སུ་བྱང་ཆུབ་སེམས་དཔའ་གང་དག་གིས་བདག་གི་མིང་ཐོས་མ་ཐག་ཏུ་ཀུན་གྱི་རྗེས་སུ་སོང་བ་ཞེས་བགྱི་བའི་ཏིང་ངེ་འཛིན་ཐོབ་པར་མ་གྱུར་པ་དང་། 
 yatra sthitvā bodhisattvā ekakṣaṇavyatihāreṇa aprameyāsaṃkhyeyācinyātulyāparimāṇān buddhān bhagavataḥ satkurvanti,	བྱང་ཆུབ་སེམས་དཔའ་དག་ཏིང་ངེ་འཛིན་དེ་ལ་གནས་ནས་སྐད་ཅིག་གཅིག་༄༣༨༣བ་འདས་པ་ཙམ་གྱིས་སངས་རྒྱས་བཅོམ་ལྡན་འདས་གྲངས་མ་པ་དང་། མཆིས་། དཔག་ཏུ་མ་མཆིས་། བསམ་གྱིས་མི་ཁྱབ་། མཚུངས་པ་མ་མཆིས་། ཚད་མ་མཆིས་པ་དག་ལ་བསྟི་སྟང་བགྱིད་ལ་།
 sa caiṣāṃ samādhirantarā vipraṇaśyedyāvadbodhimaṇḍaparyantam, mā tāvadahamanuttarāṃ samyaksaṃbodhimabhisaṃbudhyeyam ||	ཏིང་ངེ་འཛིན་དེ་བྱང་ཆུབ་ཀྱི་སྙིང་པོའི་མཐའི་བར་དུ་བར་མ་དོར་ཆ་བ་འཚལ་བར་མ་གྱུར་པ་དེ་སྲིད་དུ་བདག་བླ་ན་མེད་པ་ཡང་དག་པར་རྫོགས་པའི་བྱང་ཆུབ་མངོན་པར་རྫོགས་པར་འཚང་རྒྱ་བར་མི་བགྱིའོ་༎ བཅོམ་ལྡན་འདས་།
 44| sacenme bhagavan bodhiprāptasya tatra buddhakṣetre ye sattvāḥ pratyājātā bhaveyuḥ te yathārūpāṃ dharmadeśanāmākāṅkṣeyuḥ śrotum, tathārūpāṃ sahacittotpādānna śṛṇuyuḥ, mā tāvadahamanuttarāṃ samyaksaṃbodhimabhisaṃbudhyeyam ||	གལ་ཏེ་བདག་བྱང་ཆུབ་ཐོབ་པའི་ཚེ་སངས་རྒྱས་ཀྱི་ཞིང་དེར་སེམས་ཅན་གང་དག་སྐྱེས་པར་གྱུར་པ་དེ་དག་ཆོས་བསྟན་པ་རྣམ་པ་ཇི་ལྟ་བུ་ཉན་འཚལ་བར་གྱུར་པ་ཆོས་བསྟན་པ་རྣམ་པ་དེ་ལྟ་བུ་སེམས་བསྐྱེད་མ་ཐག་ཏུ་ཐོས་པར་མ་གྱུར་པ་དེ་སྲིད་དུ་བདག་བླ་ན་མེད་པ་ཡང་དག་པར་རྫོགས་པའི་བྱང་ཆུབ་མངོན་པར་རྫོགས་པར་འཚང་རྒྱ་བར་མི་བགྱིའོ་༎ བཅོམ་ལྡན་འདས་།
 45| sacenme bhagavan bodhiprāptasya tatra buddhakṣetre tadanyeṣu buddhakṣetreṣu ye ca bodhisattvā mama nāmadheyaṃ śṛṇuyuḥ, te sahanāmadheyaśravaṇānnāvaivartikā bhaveyuranuttarāyāḥ samyaksaṃbodheḥ, mā tāvadahamanuttarāṃ samyaksaṃbodhimabhisaṃbudhyeyam ||	གལ་ཏེ་བདག་བྱང་ཆུབ་ཐོབ་པའི་ཚེ་སངས་རྒྱས་ཀྱི་ཞིང་གཞན་དག་ཏུ་བྱང་ཆུབ་སེམས་དཔའ་གང་དག་གིས་བདག་གི་མིང་ཐོས་པ་དེ་དག་བདག་གི་མིང་ཐོས་མ་ཐག་ཏུ་བླ་ན་མེད་པ་ཡང་དག་པར་རྫོགས་པའི་བྱང་ཆུབ་ལས་ཕྱིར་མི་ལྡོག་པར་མ་གྱུར་པ་དེ་སྲིད་དུ་བདག་བླ་ན་མེད་པ་ཡང་དག་པར་རྫོགས་པའི་བྱང་ཆུབ་མངོན་པར་རྫོགས་པར་འཚང་རྒྱ་བར་མི་བགྱིའོ་༎
 46| sacenme bhagavan bodhiprāptasya buddhaśāsturbuddhakṣetreṣu te bodhisattvā mama nāmadheyaṃ śṛṇuyuḥ, te sahanāmadheyaśravanātprathamadvitīyatṛtīyāḥ kṣāntīḥ pratilabheran nāvaivartikā bhaveyurbuddhadharmasaṃghebhyaḥ,	བཅོམ་ལྡན་འདས་། གལ་ཏེ་བདག་བྱང་ཆུབ་ཐོབ་པའི་ཚེ་སངས་རྒྱས་ཀྱི་ཞིང་གཞན་དག་ཏུ་བྱང་ཆུབ་སེམས་དཔའ་གང་དག་གིས་བདག་གི་མིང་ཐོས་པར་གྱུར་པ་དེ་དག་གི་མིང་ཐོས་མ་ཐག་ཏུ་བཟོད་པ་དང་པོ་དང་། 
 mā tāvadahamanuttarāṃ samyaksaṃbodhimabhibudhyeyam || sukhv_8 || start sukhv 9:	༄༣༨༤ཨ་༌༎ གཉིས་པ་དང་། གསུམ་པ་ཐོབ་པར་མ་གྱུར་པ་དང་། སངས་རྒྱས་ཀྱི་ཆོས་རྣམས་ལས་ཕྱིར་མི་ལྡོག་པར་མ་གྱུར་པ་དེ་སྲིད་དུ་བདག་བླ་ན་མེད་པ་ཡང་དག་པར་རྫོགས་པའི་བྱང་ཆུབ་མངོན་པར་རྫོགས་པར་འཚང་རྒྱ་བར་མི་བགྱིའོ་༎
 atha khalvānanda sa dharmākaro bhikṣurimānevaṃrūpān praṇidhānaviśeṣānnirdiśya tasyāṃ velāyām buddhānubhāven imā gāthā abhāṣata -	ཀུན་དགའ་བོ་། དེ་ནས་དགེ་སློང་ཆོས་ཀྱི་འབྱུང་གནས་དེས་སྨོན་ལམ་གྱི་ཁྱད་པར་རྣམ་པ་འདི་ལྟ་བུ་འདི་དག་བསྟན་ནས་སངས་རྒྱས་ཀྱི་མཐུས་དེའི་ཚེ་ཚིགས་སུ་བཅད་པ་འདི་དག་གསོལ་ཏོ་༎ གལ་ཏེ་དག་གིས་བྱང་ཆུབ་ཐོབ་ཚེ་སྨོན་ལམ་མཆོག་། ཁྱད་པར་འཕགས་པ་རྣམ་པ་འདི་འདྲར་མ་གྱུར་ན་༎
 saci mi[siya] viśiṣṭa naivarūpā varapraṇidhāna siyā khu bodhiprāpto | māha siya gavendrasattvasāro daśabaladhāri atulyadakṣiṇīyaḥ || sukhv_vs_11 ||	སྟོབས་བཅུ་མངའ་བ་མཚུངས་པ་མ་མཆིས་སྦྱིན་པའི་གནས་༎ མི་ཡི་སེང་གེ་སེམས་ཅན་སྙིང་པོར་བདག་མ་གྱུར་༎ གལ་ཏེ་བདག་ཞིང་རྣམ་པ་དེ་འདྲར་མ་གྱུར་ལ་༎
 saci mi siya na kṣetra evarūpaṃ bahu adha nānaprabhūtadivyavittam |	སེམས་ཅན་དབུལ་མང་ནོར་མང་སྩལ་པར་མ་གྱུར་ཅིང་༎
 sukhita naraka yeya duḥkhaprāpto māha siyā ratanāna[loka]rājā || sukhv_vs_12 ||	སྡུག་བསྔལ་གྱུར་པའི་མི་དག་བདེ་བར་མ་བགྱིས་པར་༎ མི་ཡི་རྒྱལ་པོ་དཀོན་མཆོག་ཏུ་ནི་བདག་མ་གྱུར་༎
 saci mi upagatasya bodhimaṇḍaṃ daśadiśi pravraji nāmadheyu kṣipram |	བདག་ནི་བྱང་ཆུབ་སྙིང་པོར་ཉེ་བར་མཆིས་པའི་ཚེ་༎ ཕྱོགས་བཅུ་དག་གི་ཞིང་རྣམས་མང་པོ་ཐ་གྲུ་ཆེ་༎ མཐའ་ཡས་དག་ཏུ་མྱུར་དུ་མིང་གྲགས་མ་གྱུར་པར་༎
 pṛthu bahava ananta buddhakṣetrā māha siyā balaprāptu lokanāthaḥ || sukhv_vs_13 || (sukhv, vaidya 231) saci khu ahu rameya kāmabhogāṃ smṛtimatiyā gatiyā vihīnu santaḥ |	འཇིག་རྟེན་མགོན་པོ་སྟོབས་བརྙེས་པར་ནི་བདག་མ་གྱུར་༎
 atula śiva sameyamāna bodhiṃ māha siyā balaprāptu śāstra loke || sukhv_vs_14 ||	བྱང་ཆུབ་མཚུངས་མེད་ཞི་བ་ཡང་དག་ཚོལ་བ་ན་༎ དྲན་དང་བློ་གྲོས་རྟོགས་པ་རྣམ་པར་ཉམས་གྱུར་ཅིང་༎ གལ་ཏེ་བདག་ནི་འདོད་པའི་ལོངས་སྤྱོད་སྤྱོད་གྱུར་༄༣༨༤བ་ན༏་༏འཇིག་རྟེན་སྟོན་པ་སྟོབས་བརྙེས་པར་ནི་བདག་མ་གྱུར་༎ 
 vipulaprabha atulyananta nātha diśi vidiśi sphuri sarvabuddhakṣetrā |	ཤིན་ཏུ་རྒྱས་འོད་མཚུངས་པ་མ་མཆིས་མཐའ་ཡས་པ་༎ ཕྱོགས་དང་ཕྱོགས་མཚམས་མགོན་པོའི་སངས་རྒྱས་ཞིང་ཀུན་ཁྱབ༏་༏འདོད་ཆགས་ཞེ་སྡང་གཏི་མུག་ཐམས་ཅད་རབ་ཞི་ཞིང་༎ 
 rāga praśami sarvadoṣamohāṃ narakagatismi praśāmi dhūmaketum || sukhv_vs_15 ||	སེམས་ཅན་དམྱལ་བར་དོང་བའི་མེ་རྣམས་ཞི་བར་བགྱི་༎
 janiya suruciraṃ viśālanetraṃ vidhuniya sarvanarāṇa andhakāram |	ཤིན་ཏུ་མཛེས་ཤིང་ཡངས་པའི་མིག་ནི་ཕྱི་ནས་སུ་༎ མི་རྣམས་ཀུན་གྱི་མུན་ནག་རྣམ་པར་བསལ་བར་བགྱི་༎
 apaniya su na akṣaṇānaśeṣāṃ upanayi svargagatānanantatejāṃ || sukhv_vs_16 ||	དལ་བ་མེད་པ་དག་ནི་མ་ལུས་བསལ་ནས་སུ་༎ གཟི་བརྗིད་མཐའ་ཡས་མཐོ་རིས་ལམ་དུ་གཟུང་བར་བགྱི་༎ སྔོན་གྱི་སྤྱོད་པ་ཡོངས་སུ་དག་པར་སྤྱད་ནས་ནི་༎
 na tapati nabha candrasūryaābhā maṇigaṇa agniprabhā na devatānām |	མཁའ་ལ་ཉི་ཟླའི་འོད་ནི་ལམ་མེ་མ་ལགས་ཤིང་༎ ནོར་བུའི་ཚོགས་དང་མེ་དང་ལྷ་ཡི་འོད་རྣམས་ཀྱང་༎ མི་ཡི་སེང་གེའི་འོད་ཀྱིས་ཐམས་ཅད་ཟིལ་གྱིས་མནན་༎
 abhibhavati narendra ābha sarvāṃ purimacariṃ pariśuddha ācaritvā || sukhv_vs_17 || puruṣavaru nidhāna duḥkhitānāṃ diśi vidiśāsu na asti evarūpaḥ |	སྐྱེས་བུ་མཆོག་གྱུར་སྡུག་བསྔལ་རྣམས་ཀྱི་གཏེར་གྱུར་ཏེ་༎ ཕྱོགས་མཚམས་ཕྱོགས་ན་དེ་འདྲའི་གཟུགས་ནི་མ་མཆིས་ཤིང་༎
 kuśalaśatasahasrasarvapūrṇa parṣagaro nadi buddhasiṃhanādam || sukhv_vs_18 ||	དགེ་བ་བརྒྱ་སྟོང་དག་ནི་རབ་ཏུ་རྫོགས་གྱུར་ནས་༎ འཁོར་ནའང་མཆིས་ཏེ་སངས་རྒྱས་སེང་གེའི་སྒྲ་བསྒྲག་གོ་།
 purimajina svayaṃbhu satkaritvā vratatapakoṭi caritva aprameyām |	སྔོན་གྱི་རྒྱལ་བ་རང་བྱུང་དག་ལ་གུས་བགྱིས་ཏེ་༎ བརྟུལ་ཞུགས་དཀའ་ཐུབ་བྱེ་བ་དཔག་མེད་སྤྱད་ནས་ནི་༎ ཡེ་ཤེས་ཕུང་པོ་དམ་པ་མཆོག་རབ་བཙལ་ནས་སུ་༎
 pravaravarasame 'smi jñānaskandha praṇidhibalapratipūrṇa sattvasāro || sukhv_vs_19 ||	སྨོན་ལམ་སྟོབས་ནི་རྫོགས་བགྱིས་སེམས་ཅན་སྙིང་པོར་འགྱུར་༎
 yatha bhagava asaṅgajñānadarśī trividha prajānati saṃskṛte narendraḥ |	ཇི་ལྟར་བཅོམ་ལྡན་འདས་ཡེ་ཤེས་གཟིགས་པ་ཆགས་མི་མངའ༎ མི་ཡི་དབང་པོ་འདུས་བྱས་རྣམ་གསུམ་རབ་༄༣༨༥ཨ་༌༎ མཁྱེན་པ་༎
 ahamapi siya tulyadakṣiṇīyo vidupravaro naranāyako narāṇām || sukhv_vs_20 ||	བདག་ཀྱང་མཚུངས་པ་མ་མཆིས་སྦྱིན་གནས་མཁས་པ་དང་༎ མི་རྣམས་ནང་ན་མི་ཡི་འདྲེན་པ་མཆོག་གྱུར་ཅིག་།
 saci mi ayu narendra evarūpā praṇidhi samṛdhyati bodhi prāpuṇitvā |	མི་དབང་བདག་གིས་བྱང་ཆུབ་རབ་ཏུ་ཐོབ་ནས་ནི་༎ གལ་ཏེ་སྨོན་ལམ་འདི་འདྲ་འདི་དག་འགྲུབ་ཅེ་ན་༎
 calatu aya sahasralokadhātu kusumapravarṣaṇa bhātu devasaṃghāṃ || sukhv_vs_21 ||	སྟོང་གི་འཇིག་རྟེན་ཁམས་འདི་རབ་ཏུ་ག-ཡོས་གྱུར་ཅིང་༎ ལྷ་ཡི་ཚོགས་ཀྱིས་མཁའ་ལས་མེ་ཏོག་ཆར་ཕོབ་ཅིག་།
 (sukhv, vaidya 232) pracalita vasudhā pravarṣi puṣpāḥ tūryaśatā gagane 'tha saṃpraṇeduḥ |	ས་ཡང་རབ་ཏུ་ག-ཡོས་ཏེ་མེ་ཏོག་ཆར་ཡང་བབ་༎
 divyaruciracandanasya cūrṇā avakiri caiva bhaviṣya loki buddhaḥ || sukhv_vs_22 || iti || sukhv_9 ||	ནམ་མཁའ་ལས་ཀྱང་སིལ་སྙན་རྣམས་ཀྱི་སྒྲ་ཡང་བྱུང་༎ ལྷ་ཡི་ཙན་དན་མཛེས་པ་དག་གི་ཕྱེ་མ་ཡང་༎ མངོན་པར་འཐོབ་བར་གྱུར་ཏེ་འཇིག་རྟེན་སངས་རྒྱས་འགྱུར་༎༎
 start sukhv 10:	བམ་པོ་གཉིས་པ་།
 evaṃrūpayā ānanda praṇidhānasaṃpadā sa dharmākaro bhikṣurbodhisattvo mahāsattvaḥ samanvāgato 'bhūt |	ཀུན་དགའ་བོ་། དགེ་སློང་ཆོས་ཀྱི་འབྱུང་གནས་བྱང་ཆུབ་སེམས་དཔའ་སེམས་དཔའ་ཆེན་པོ་དེ་སྨོན་ལམ་ཕུན་སུམ་ཚོགས་པ་རྣམ་པ་དེ་ལྟ་བུ་དང་ལྡན་ཏེ་། ཀུན་དགའ་བོ་།
 evaṃrūpayā cānanda praṇidhānasaṃpadā alpakā bodhisattvāḥ samanvāgatāḥ |	སྨོན་ལམ་ཕུན་སུམ་ཚོགས་པ་རྣམ་པ་འདི་ལྟ་བུ་དང་ལྡན་པའི་བྱང་ཆུབ་སེམས་དཔའ་ནི་ཉུང་ངོ་༎ 
 alpakānāṃ caivaṃrūpāṇāṃ praṇidhīnāṃ loke prādurbhāvo bhavati parīttānām |	སྨོན་ལམ་རྣམ་པ་འདི་ལྟ་བུ་དག་འཇིག་རྟེན་དུ་བྱུང་བ་ཉུང་སྟེ་། ཉུང་དུ་ཟད་ཀྱི་།
 na punaḥ sarvaśo nāsti |	ཡེ་མེད་པ་ནི་མ་ཡིན་ནོ་༎ ཀུན་དགའ་བོ་།
 sa khalu punarānanda dharmākaro bhikṣustasya bhagavato lokeśvararājasya tathāgatasya purataḥ sadevakasya lokasya samārakasya sabrahmakasya saśramaṇabrāhmaṇikāyāḥ prajāyāḥ	དགེ་སློང་ཆོས་ཀྱི་འབྱུང་གནས་དེས་བཅོམ་ལྡན་འདས་དེ་བཞིན་གཤེགས་པ་འཇིག་རྟེན་དབང་ཕྱུག་རྒྱལ་པོ་དེའི་སྤྱན་སྔར་ལྷ་དང་བཅས་པའི་འཇིག་རྟེན་བདུད་དང་བཅས་པ་དང་། ཚངས་པ་དང་བཅགས་པ་།
 sadevamānuṣāsurāyāḥ purata imānevaṃrūpān praṇidhānaviśeṣānnirdiśya yathābhūtapratijñāpratipattipratiṣṭhito 'bhūt |	དགེ་སྦྱོང་དང་བྲམ་ཟེའི་སྐྱེ་དགུ་དང་བཅས་པ་། ལྷ་དང་མི་དང་ལྷ་མ་༄༣༨༥བ་ཡིན་དུ་བཅས་པའི་མདུན་དུ་སྨོན་ལམ་གྱི་ཁྱད་པར་རྣམ་པ་དེ་ལྟ་བུ་དེ་དག་བསྟན་ནས་ཡང་དག་པ་ཇི་ལྟ་བ་བཞིན་དུ་སྒྲུབ་པ་ལ་གནས་པར་གྱུར་ཏེ་། 
 sa imāmevaṃrūpāṃ buddhakṣetrapariśuddhiṃ buddhakṣetramāhātmyaṃ buddhakṣetrodāratāṃ	དེ་སངས་རྒྱས་ཀྱི་ཞིང་ཡོངས་སུ་དག་པ་དང༏་སངས་རྒྱས་ཀྱི་ཞིང་གི་ཆེ་བ་གྱུར་ཏེ་། ཉིད་དང་། སངས་རྒྱས་ཀྱི་ཞིང་ཐ་གྲུ་ཆེན་པོ་རྣམ་པ་དེ་ལྟ་བུ་དེ་གྱུར་ཏེ་། ཉིད་དང་། དག་ནི་སྒྲུབ་། 
 samudānayan bodhisattvacaryāṃ caran aprameyāsaṃkhyeyācintyātulyāmāpyāparimāṇānabhilāpyāni	བྱང་ཆུབ་སེམས་དཔའི་སྤྱད་པ་ནི་སྤྱོད་ཅིང་།
 varṣakoṭīniyutaśatasahasrāṇi na jātu kāmavyāpādavihiṃsāvitarkān vitarkitavān,	ལོ་བྱེ་བ་ཁྲག་ཁྲིག་བརྒྱ་སྟོང་དཔག་ཏུ་མེད་། གྲངས་མེད་། བསམ་གྱིས་མི་ཁྱབ་། མཚུངས་པ་མེད་། གཞལ་དུ་མེད་། ཚད་མེད་། བརྗོད་དུ་མེད་པར་ལན་འགའ་ཡང་འདོད་པ་དང་། གནོད་སེམས་དང་། རྣམ་པར་འཚེ་བའི་རྣམ་པར་རྟོག་པས་རྣམ་པར་རྟོག་པར་མ་གྱུར་།
 na jātu kāmavyāpādavihiṃsāsaṃjñāmutpāditavān,	ལན་འགའ་ཡང་འདོད་པ་དང་། གནོད་སེམས་དང་། རྣམ་པར་འཚེ་བའི་འདུ་ཤེས་བསྐྱེད་པར་མ་གྱུར་།
 na jātu rūpaśabdagandharasaspraṣṭavyasaṃjñāmutpāditavān |	ལན་འགའ་ཡང་གཟུགས་དང་། སྒྲ་དང་། དྲི་དང་། རོ་དང་། རེག་བྱའི་འདུ་ཤེས་བསྐྱེད་པར་མ་གྱུར་ཏེ་།
 sa daharamanohara eva surato 'bhūtsukhasaṃvāso 'dhivāsanajātīyaḥ subhagaḥ supoṣo 'lpecchaḥ saṃtuṣṭaḥ pravivikto 'duṣṭo 'mūḍho 'śaṅko 'jihmo 'śaṭho 'māyāvī sukhilomaḥ priyālāpo nityābhiyuktaḥ śukladharmaparyeṣṭau sunikṣiptadhuraḥ sarvasattvānāmarthāya	གཞོན་ནུ་དེས་ཤིང་འགྲོགས་ན་བདེ་བ་དང་། དང་དུ་ལེན་པའི་རང་བཞིན་ཅན་དང་། དགང་སླ་བ་དང་། གསོལ་བ་དང་། འདོད་པ་ཆུང་བ་དང་། ཆོག་ཤེས་པ་དང་། རབ་ཏུ་དབེན་པ་དང་། ཞེ་སྡང་མེད་པ་དང་། རྨོངས་པ་མེད་པ་དང་། དྲང་བ་དང་། མི་དམན་པ་དང་། ག-ཡོ་མེད་པ་དང་། སྒྱུ་མེད་པ་དང་། ངང་ཚུལ་བཟང་བ་དང་། མཉེན་པ་དང་། སྙན་པར་སྨྲ་བ་དང་། རྟག་ཏུ་བརྩོན་པ་དང་། དཀར་པོའི་ཆོས་ཡོངས་སུ་ཚོལ་བ་ལ་བརྩོན་པ་མི་འདོར་བར་གྱུར་ཏེ་། སེམས་ཅན་ཐམས་ཅད་ཀྱི་དོན་དུ་༄༣༨༦ཨ་༌༎
 mahāpraṇidhānaṃ samudānitavān buddhadharmasaṃghācāryopādhyāyakalyāṇamitrasagauravo	སྨོན་ལམ་ཆེན་པོ་ཡང་དག་པར་བསྒྲུབས་པར་གྱུར་ཏོ་༎ སངས་རྒྱས་དང་། ཆོས་དང་། དགེ་འདུན་དང་། སློབ་དཔོན་དང་། མཁན་པོ་དང་། དགེ་བའི་བཤེས་གཉེན་ལ་གུས་པ་དང་བཅས་ཤིང་བྱང་ཆུབ་སེམས་དཔའི་སྤྱོད་པ་ལ་རྟག་ཏུ་གོ་ཆ་བགོས་ཏེ་། 
 nityasaṃnaddho bodhisattvacaryāyāmārjavo mārdavo 'kuhako 'nilapako guṇavān pūrvaṃgamaḥ	དྲང་བ་དང་། མཉེན་པ་དང་། ཚུལ་འཆོས་པ་མེད་པ་དང་། ཁ་གསག་མེད་པ་དང་། ཡོན་ཏན་དང་ལྡན་ཞིང་སེམས་ཅན་ཐམས་ཅད་དགེ་བའི་ཆོས་ཐམས་ཅད་ཡང་དག་པར་འཛིན་དུ་འཇུག་པའི་སྔོན་དུ་ནི་འགྲོ་།
 sarvakuśaladharmasamādāpanatāyai śūnyatānimittāpraṇihitānabhisaṃskārānutpādavihārairnirmānaḥ	སྟོང་པ་ཉིད་དང་། མཚན་མ་མེད་པ་དང་། སྨོན་པ་མེད་པ་དང་། མངོན་པར་འདུ་བྱ་བ་མེད་པ་དང་། སྐྱེ་བ་མེད་པ་དང་། འགག་པ་མེད་པའི་གནས་པས་ནི་གནས་ཏེ་།
 svārakṣitavākyaścābhūt |	ང་རྒྱལ་མེད་ཅིང་ངག་ལེགས་པར་བསྲུངས་པར་གྱུར་ཏོ་༎
 bodhisattvacaryāṃ caran sa yadvākkarmotsṛṣṭamātmaparobhayavyāpādāya saṃvartate,	བྱང་ཆུབ་སེམས་དཔའི་སྤྱད་པ་སྤྱོད་པ་ན་དེས་ངག་གི་ལས་འབྱུང་བ་གང་བདག་དང་གཞན་དང་གཉིས་ཀ་ལ་གནོད་པར་འགྱུར་བ་རྣམ་པ་དེ་ལྟ་བུ་སྤངས་ནས་།
 tathāvidhaṃ tyaktvā yadvākkarma svaparobhayahitasukhasaṃvartakaṃ tadevābhiprayuktavān |	ངག་གི་ལས་གང་བདག་དང་གཞན་དང་གཉིས་ཀ་ལ་ཕན་པར་འགྱུར་བ་དེ་ལ་བརྩོན་པར་གྱུར་ཏེ་། 
 evaṃ ca samprajāno 'bhūt yadgrāmanagaranigamajanapadarāṣṭrarājadhānīṣvavataranna jātu rūpaśabdagandharasaspraṣṭavyadharmeṣvanunīto 'bhūdapratihataḥ	དེ་ལྟར་ཤེས་བཞིན་ཅན་དུ་གྱུར་ཅིང་གྲོང་དང་། གྲོང་ཁྱེར་དང་། གྲོང་བརྡལ་དང་། ཡུལ་འཁོར་དང་། རྒྱལ་པོའི་ཕོ་བྲང་འཁོར་རྣམས་སུ་འཇུག་པ་ན་ནམ་ཡང་གཟུགས་དང་། སྒྲ་དང་། དྲི་དང་། རོ་དང་། རེག་བྱ་དང་། ཆོས་ལ་རྗེས་སུ་ཆགས་པ་དང་། ཁོང་ཁྲོ་བ་མེད་པར་གྱུར་ཏོ་༎
 sa bodhisattvacaryāyāṃ caran svayaṃ ca dānapāramitāyāmacarat parāṃśca tatraiva samādāpitavān,	དེ་བྱང་ཆུབ་སེམས་དཔའི་༄༣༨༦བ་སྤྱད་པ་སྤྱོད་པ་ན་བདག་ཉིད་ཀྱང་སྦྱིན་པའི་ཕ་རོལ་ཏུ་ཕྱིན་པ་ལ་སྤྱོད་ཅིང་། གཞན་ཡང་དེ་ཉིད་ཡང་དག་པར་འཛིན་དུ་བཅུག་གོ་།
 svayaṃ ca śīlakṣāntivīryadhyānaprajñāpāramitāsvacarat,	བདག་ཉིད་ཀྱང་ཚུལ་ཁྲིམས་དང་། བཟོད་པ་དང་། བརྩོན་འགྲུས་དང༏་བསམ་གཏན་དང་། ཤེས་རབ་ཀྱི་ཕ་རོལ་ཏུ་ཕྱིན་པ་ལ་སྤྱོད་ཅིང་།
 parāṃśca tatraiva samādāpitavān |	གཞན་ཡང་དེ་ཉིད་ཡང་དག་པར་འཛིན་དུ་བཅུག་གོ་།
 tathārūpāṇi ca kuśalamūlāni samudānītavān, yaiḥ samanvāgato yatrayatropapadyate, tatra tatra asyānekāni nidhānakoṭīniyutaśatasahasrāṇi dharaṇyāḥ prādurbhavanti |	གང་དག་དང་ལྡན་ན་གང་དང་གང་དུ་སྐྱེས་པ་དེ་དང་དེར་གཏེར་བྱེ་བ་ཁྲག་ཁྲིག་བརྒྱ་སྟོང་དུ་མས་ལས་འབྱུང་བར་འགྱུར་བ་རྣམ་པ་དེ་ལྟ་བུའི་དགེ་བའི་རྩ་བ་རྣམས་ཡང་དག་པར་བསྒྲུབས་པར་གྱུར་ཏོ་༎
 tena bodhisattvacaryāṃ caratā tāvadaprameyāsaṃkhyeyāni sattvakoṭīniyutaśatasahasrāṇyanuttarāyāṃ samyaksaṃbodhau pratiṣṭhāpitāni, yeṣāṃ na sukaraṃ vākkarmaṇā paryantamadhigantum |	དེ་བྱང་ཆུབ་སེམས་དཔའི་སྤྱད་པ་སྤྱོད་པ་ན་སེམས་ཅན་བྱེ་བ་ཁྲག་ཁྲིག་བརྒྱ་སྟོང་གྲངས་མེད་དཔག་ཏུ་མེད་པ་གང་དག་ངག་གི་ལས་ཀྱིས་མཐར་ཕྱིན་པར་སླ་བ་མ་ཡིན་པ་དེ་སྙེད་བླ་ན་མེད་པ་ཡང་དག་པར་རྫོགས་པའི་བྱང་ཆུབ་ལ་བཀོད་དོ་༎
 tāvadaprameyāsaṃkhyeyā buddhā bhagavantaḥ satkṛtā gurukṛtā mānitāḥ pūjitāścīvarapiṇḍapātraśayanāsanaglānapratyayabhaiṣajyapariṣkāraiḥ sarvasukhopadhānasparśavihāraiḥ pratipāditāḥ | yāvantaḥ sattvāḥ śreṣṭhigṛhapatyamātyakṣatriyabrāhmaṇamahāśālakuleṣu pratiṣṭhāpitāḥ, teṣāṃ na sukaro vākkarmanirdeśena paryanto 'dhigantum | evaṃ jāmbūdvīpeśvarāśca pratiṣṭhāpitāścakravartitve lokapālatve śakratve suyāmatve (sukhv, vaidya 233) sutuṣitatve sunirmitatve suvaśavartitve devarājatve mahābrahmatve ca pratiṣṭhāpitāḥ |	སངས་རྒྱས་བཅོམ་ལྡན་འདས་གྲངས་མེད་དཔག་ཏུ་མེད་པ་དེ་སྙེད་ལ་། ན་བཟའ་དང་། ཞལ་ཟས་དང་། གཟིམས་ཆ་དང་། སྙུན་གྱི་གསོས་སྨན་དང་། ཡོ་བྱད་རྣམས་དང་། བདེ་བར་སྦྱར་བ་ལ་རེག་པར་གནས་པ་ཐམས་ཅད་ཀྱིས་བསྟི་སྟང་དུ་བྱས་།
 tāvadaprameyāsaṃkhyeyā buddhā bhagavantaḥ satkṛtā gurukṛtā mānitāḥ pūjitāścīvarapiṇḍapātraśayanāsanaglānapratyayabhaiṣajyapariṣkāraiḥ sarvasukhopadhānasparśavihāraiḥ pratipāditāḥ |	བླ་མར་བྱས་། རིམ་གྲོར་བྱས་། མཆོད་པར་བྱས་སོ་༎
 yāvantaḥ sattvāḥ śreṣṭhigṛhapatyamātyakṣatriyabrāhmaṇamahāśālakuleṣu pratiṣṭhāpitāḥ, teṣāṃ na sukaro vākkarmanirdeśena paryanto 'dhigantum |	སེམས་ཅན་ཇི་སྙེད་རབ་ཏུ་སྨིན་པར་བྱས་པ་དང་། ཚོང་དཔོན་དང་། ཁྱིམ་བདག་དང་། བློན་པོ་དང་། རྒྱལ་རིགས་དང་། བྲམ་ཟེའི་རིགས་ཤིང་སའ་ལ་ཆེན་པོ་ལྟ་བུ་དག་ལ་རབ་ཏུ་བཀོད་པ་དེ་དག་ཀྱང་ཚིག་གིས་བསྟན་པས་མཐར་ཕྱིན་པར་སླ་བ་མ་ཡིན་ནོ་༎ 
 evaṃ jāmbūdvīpeśvarāśca pratiṣṭhāpitāścakravartitve lokapālatve śakratve suyāmatve sutuṣitatve sunirmitatve vaśavartitve devarājatve mahābrahmatve ca pratiṣṭhāpitāḥ |	དེ་བཞིན་དུ་འཛམ་བུའི་གླིང་གི་དབང་༄༣༨༧ཨ་༌༎ ཕྱུག་ཉིད་དང་། འཁོར་ལོས་བསྒྱུར་བ་ཉིད་དང་། འཇིག་རྟེན་སྐྱོང་བ་ཉིད་དང་། བརྒྱ་བྱིན་ཉིད་དང་། རབ་འཐབ་བྲལ་ཉིད་དང་། ཡོངས་སུ་དགའ་ལྡན་ཉིད་དང་། རབ་འཕྲུལ་དགའ་ཉིད་དང་། དབང་སྒྱུར་ཉིད་དང་། ལྷའི་རྒྱལ་པོ་ཉིད་དང་། ཚངས་པ་ཆེན་པོ་ཉིད་ལ་རབ་ཏུ་བཀོད་དོ་༎
 tāvadaprameyāsaṃkhyeyā buddhā bhagavantaḥ satkṛtā gurukṛtā mānitāḥ pūjitā dharmacakrapravartanārthaṃ cādhīṣṭāḥ,	སངས་རྒྱས་བཅོམ་ལྡན་འདས་གྲངས་མེད་དཔག་ཏུ་མེད་པ་དེ་སྙེད་ལ་བསྟི་སྟང་དུ་བྱས་། བླ་མར་བྱས་། རིམ་གྲོར་བྱས་ཏེ་།
 yeṣāṃ na sukaro vākkarmanirdeśena paryanto 'dhigantum | sa evaṃrūpaṃ kuśalaṃ samudānayat,	མཆོད་ནས་ཆོས་ཀྱི་འཁོར་ལོ་རབ་ཏུ་བསྐོར་བར་བྱ་བའི་ཕྱིར་གསོལ་བ་བཏབ་པ་དེ་དག་ཀྱང་ངག་གི་ལས་ཀྱིས་བསྟན་པ་མཐར་ཕྱིན་པར་སླ་བ་མ་ཡིན་ནོ་༎
 yadasya bodhisattvacaryāṃ carato 'prameyāsaṃkhyeyācintyātulyāmāpyāparimāṇānabhilāpyāni kalpakoṭīniyutaśatasahasrāṇi surabhirdivyātikrāntacandanagandho mukhātpravāti sma |	དེ་བྱང་ཆུབ་སེམས་དཔའི་སྤྱད་པ་སྤྱོད་པ་ན་། བསྐལ་པ་བྱེ་བ་ཁྲག་ཁྲིག་བརྒྱ་སྟོང་དཔག་ཏུ་མེད་། གྲངས་མེད་། བསམ་གྱིས་མི་ཁྱབ་། མཚུངས་པ་མེད་། གཞལ་དུ་མེད༏་ཚད་མེད་། བརྗོད་དུ་མེད་པར་ཁ་ནས་ལྷའི་ལས་ཤིན་ཏུ་འདས་པའི་ཙན་དན་དྲི་རབ་ཏུ་ཞིམ་པའི་བསུང་འབྱུང་བ་དང་། 
 sarvaromakūpebhya utpalagandho vāti sma |	སྤུའི་ཁུང་བུ་ཐམས་ཅད་ནས་མེ་ཏོག་ཨཽཏཔ་ལའི་བསུང་འབྱུང་བ་དང༏་འཇིག་རྟེན་ཐམས་ཅད་ན་གཟུགས་བཟང་ཞིང་མཛེས་ལ་བལྟ་ན་འབྱུང་བ་དང་། སྡུག་པ་དང་། 
 sarvalokābhirūpaścābhūtprāsādiko darśanīyaḥ paramaśubhavarṇapuṣkalatayā samanvāgataḥ lakṣaṇavyañjanasamalaṃkṛtenātmabhāvena | tasya sarvaratnālakārāḥ sarvavastracīvarābhinirhārāḥ sarvapuṣpadhūpagandhamālyavilepanacchatradhvajapatākābhinirhārāḥ sarvavādyasaṃgītyabhinirhārāśca sarvaromakūpebhyaḥ pāṇitalābhyāṃ ca niścaranti sma | sarvānnapānakhādyabhojyalehyarasābhinirhārāḥ sarvopabhogaparibhogābhinirhārāśca pāṇitalābhyāṃ prasyandantaḥ prādurbhavanti sma |	ཁ་དོག་བཟང་པོ་རྒྱས་པ་མཆོག་དང་ལྡན་པ་དང་། མཚན་དང་དཔེ་བྱད་བཟང་པོས་ལུས་ལེགས་པར་བརྒྱན་པ་དང་། དེའི་རིན་པོ་ཆེའི་རྒྱན་ཐམས་ཅད་དང་། གོས་དང་ཆོས་གོས་མངོན་པར་བསྒྲུབ་པ་ཐམས་ཅད་དང་། མེ་ཏོག་དང་། སྤོས་དང་། བདུག་པ་དང་། ཕྲེང་བ་དང་། བྱུག་པ་དང་། ༄༣༨༧བ་གདུགས་དང་། རྒྱལ་མཚན་དང་། བ་དན་མངོན་པར་བསྒྲུབ་པ་ཐམས་ཅད་དང་། རོལ་མོའི་དབྱངས་སྒྲ་དང་གླུ་དབྱངས་མངོན་པར་བསྒྲུབ་པ་ཐམས་ཅད་ཀྱང་སྤུའི་ཁུང་བུ་ཐམས་ཅད་དང་། ལག་པ་གཉིས་ནས་འབྱུང་བ་དང་། ཟས་དང་། སྐོམ་དང་། བཟའ་བ་དང་། བཅའ་བ་དང་། བལྡག་པ་དང་། རོ་བྲོ་བ་མངོན་པར་བསྒྲུབ་པ་ཐམས་ཅད་དང་ལོངས་སྤྱོད་དང་ཡོངས་སུ་སྤྱད་པ་མངོན་པར་བསྒྲུབ་པ་ཐམས་ཅད་ཀྱང་ལག་པ་གཉིས་ནས་ཟག་ཅིང་འབྱུང་བར་འགྱུར་བ་རྣམ་པ་དེ་ལྟ་བུའི་དགེ་བ་ཡང་དག་པར་བསྒྲུབས་སོ་༎
 iti hi sarvapariṣkāravaśitāprāptaḥ sa ānanda dharmākaro bhikṣurabhūt pūrvaṃ bodhisattvacaryāṃ caran || sukhv_10 || start sukhv 11:	ཀུན་དགའ་བོ་། དེ་ལྟར་དགེ་སློང་ཆོས་ཀྱི་འབྱུང་གནས་དེ་སྔོན་བྱང་ཆུབ་སེམས་དཔའི་སྤྱད་པ་སྤྱོད་པ་ན་། ཡོ་བྱད་ཐམས་ཅད་ལ་དབང་བའི་ཕ་རོལ་ཏུ་ཕྱིན་པར་གྱུར་ཏོ་༎
 evamukte āyuṣmānānando bhagavantametadavocat - kiṃ punarbhagavan sa dharmākaro bhikṣurbodhisattvo mahāsattvo 'nuttarāṃ samyaksaṃbodhimabhisaṃbudhyātītaḥ	དེ་སྐད་ཅེས་བཀའ་སྩལ་པ་དང་། བཅོམ་ལྡན་འདས་ལ་ཚེ་དང་ལྡན་པ་ཀུན་དགའ་བོས་འདི་སྐད་ཅེས་གསོལ་ཏོ་༎ བཅོམ་ལྡན་འདས་། ཅི་ལགས་། བྱང་ཆུབ་སེམས་དཔའ་སེམས་དཔའ་ཆེན་པོ་ཆོས་ཀྱི་འབྱུང་གནས་དེ་བླ་ན་མེད་པ་ཡང་དག་པར་རྫོགས་པའི་བྱང་ཆུབ་མངོན་པར་རྫོགས་པར་སངས་རྒྱས་ཏེ་། ཡོངས་སུ་མྱ་ངན་ལས་འདས་ལགས་སམ་།
 utāho 'nabhisaṃbuddhaḥ atha pratyutpanno 'bhisaṃbuddha etarhi tiṣṭhati dhriyate yāpayati dharmaṃ ca deśayati?	འོན་ཏེ་མངོན་པར་རྫོགས་པར་སངས་རྒྱས་མ་རྒྱས་སམ་། འོན་ཏེ་དེ་ལྟར་བྱུང་བ་ན་མངོན་པར་རྫོགས་པར་སངས་རྒྱས་ཏེ་། ད་ལྟ་ན་བཞུགས་ལ་འཚོ་ཞིང་གཞེས་ཏེ་ཆོས་ཀྱང་སྟོན་།
 bhagavānāha - na,	བཅོམ་ལྡན་འདས་ཀྱིས་བཀའ་སྩལ་པ་། ཀུན་དགའ་བོ་།
 khalu punarānanda sa tathāgato 'tīto na anāgataḥ |	དེ་བཞིན་གཤེགས་པ་དེ་ནི་འདས་པ་ཡང་མ་ཡིན་། མ་འོངས་པ་༄༣༨༨ཨ་༌༎ ཡང་མ་ཡིན་གྱི་།
 api tveva sa tathāgato 'rhan samyaksaṃbodhimabhisaṃbuddha etarhiṃ tiṣṭhati dhriyate	དེ་བཞིན་གཤེགས་པ་དེ་བླ་ན་མེད་པ་ཡང་དག་པར་རྫོགས་པའི་བྱང་ཆུབ་མངོན་པར་རྫོགས་པར་སངས་རྒྱས་ནས་ད་ལྟར་ན་བཞུགས་ཏེ་འཚོ་ཞིང་གཞེས་ལ་ཆོས་ཀྱང་སྟོན་ཏེ་།
 yāpayati dharmaṃ ca deśayati paścimāyāṃ diśi ito koṭīniyutaśatasahasratame ca buddhakṣetre sukhāvatyāṃ lokadhātāvamitābho nāma tathāgato 'rhan samyaksaṃbuddho 'parimāṇairbodhisattvaiḥ	འདི་ནས་ནུབ་ཕྱོགས་སུ་སངས་རྒྱས་ཀྱི་ཞིང་བྱེ་བ་ཁྲག་ཁྲིག་བརྒྱ་སྟོང་ན་འཇིག་རྟེན་གྱི་ཁམས་བདེ་བ་ཅན་ན་དེ་བཞིན་གཤེགས་པ་དགྲ་བཅོམ་པ་ཡང་དག་པར་རྫོགས་པའི་སངས་རྒྱས་འོད་དཔག་མེད་ཅེས་བྱ་སྟེ་།
 parivṛtaḥ puraskṛto 'nantaiḥ śrāvakairanantayā buddhakṣetrasaṃpadā samanvāgataḥ || sukhv_11 || start sukhv 12:	བྱང་ཆུབ་སེམས་དཔའ་སེམས་དཔའ་ཆེན་པོ་ཚད་མེད་པ་དག་དང་། ཉན་ཐོས་མཐའ་ཡས་པ་དག་གིས་ཡོངས་སུ་བསྐོར་ཞིང་མདུན་དུ་བདར་ཏེ་། སངས་རྒྱས་ཀྱི་ཞིང་ཕུན་སུམ་ཚོགས་པ་མཐའ་ཡས་པ་དང་ལྡན་ནོ་༎
 amitā cāsya prabhā yasya na sukaraṃ pramāṇaparyantamadhigantum - iyanti buddhakṣetraśatāni, iyanti buddhakṣetrasahasrāṇi, iyanti buddhakṣetraśatasahasrāṇi, iyanti buddhakṣetrakoṭīni,	དེའི་འོད་ནི་དཔག་ཏུ་མེད་དེ་།
 iyanti buddhakṣetrakoṭīśatāni, iyanti buddhakṣetrakoṭīsahasrāṇi, iyanti buddhakṣetrakoṭīśatasahasrāṇi,	དེ་ནི་སངས་རྒྱས་ཀྱི་ཞིང་འདི་སྙེད་ཅིག་དང་། སངས་རྒྱས་ཀྱི་ཞིང་བརྒྱ་ཕྲག་འདི་སྙེད་ཅིག་དང་། སངས་རྒྱས་ཀྱི་ཞིང་སྟོང་ཕྲག་འདི་སྙེད་ཅིག་དང་། སངས་རྒྱས་ཀྱི་ཞིང་བརྒྱ་སྟོང་ཕྲག་འདི་སྙེད་ཅིག་དང་། སངས་རྒྱས་ཀྱི་ཞིང་བྱེ་བ་ཕྲག་འདི་སྙེད་ཅིག་དང་། སངས་རྒྱས་ཀྱི་ཞིང་བྱེ་བ་བརྒྱ་ཕྲག་འདི་སྙེད་ཅིག་དང་། སངས་རྒྱས་ཀྱི་ཞིང་བྱེ་བ་སྟོང་ཕྲག་འདི་སྙེད་ཅིག་དང་། སངས་རྒྱས་ཀྱི་ཞིང་བྱེ་བ་བརྒྱ་སྟོང་ཕྲག་འདི་སྙེད་ཅིག་དང་། སངས་རྒྱས་ཀྱི་ཞིང་བྱེ་བ་ཁྲག་ཁྲིག་བརྒྱ་སྟོང་ཕྲག་འདི་སྙེད་ཅིག་ཁྱབ་པར་བྱས་ཏེ་འདུག་གོ་ཞེས་མཐའི་ཚད་རྟོགས་པར་སླ་བ་མ་ཡིན་ནོ་༎ ཀུན་དགའ་བོ་།
 iyanti buddhakṣetrakoṭīniyutaśatasahasrāṇi spharitvā tiṣṭhatīti | api tu khalu punarānanda saṃkṣiptena pūrvasyāṃ diśi gaṅgānadīvālukopamāni buddhakṣetrakoṭīniyutaśatasahasrāṇi tayā tasya bhagavato 'mitābhasya prabhayā sadā sphuṭāni | evaṃ dakṣiṇapaścimottarāsvadha ūrdhvaṃ digvidikṣu ca ekaikasyāṃ diśi samantādgaṅgānadīvālukopamāni yāvadbuddhakṣetrakoṭīniyutaśatasahasrāṇi (sukhv, vaidya 234)	འོན་ཀྱང་མདོར་བསྟན་ན་ཤར་ཕྱོགས་སུ་སངས་༄༣༨༨བ་རྒྱས་ཀྱི་ཞིང་བྱེ་བ་ཁྲག་ཁྲིག་བརྒྱ་སྟོང་ཕྲག་གངགའའི་ཀླུང་གི་བྱེ་མ་སྙེད་དག་བཅོམ་ལྡན་འདས་འོད་དཔག་མེད་དེའི་འོད་ཀྱིས་རྟག་ཏུ་ཁྱབ་བོ་༎ དེ་བཞིན་དུ་ལྷོ་དང་། ནུབ་དང་། བྱང་དང་། འོག་དང་། སྟེང་དང་། ཕྱོགས་མཚམས་ཀྱི་ཕྱོགས་རེ་རེ་ཡང་སངས་རྒྱས་ཀྱི་ཞིང་བྱེ་བ་ཁྲག་ཁྲིག་བརྒྱ་སྟོང་ཕྲག་གངགའའི་ཀླུང་གི་བྱེ་མ་སྙེད་དག་བཅོམ་ལྡན་འདས་དེ་བཞིན་གཤེགས་པ་འོད་དཔག་མེད་དེའི་འོད་ཀྱིས་རྟག་ཏུ་ཁྱབ་སྟེ་། 
 tasya bhagavato 'mitābhasya prabhayā sadā parisphuṭāni sthāpayitvā buddhān bhagavataḥ pūrvapraṇidhānādhiṣṭhānena ye vyāmaprabhayā ekadvitricatuḥpañcadaśaviṃśatitriṃśaccatvāriṃśatpañcāśadyojanaprabhayā yojanaśataprabhayā yojanasahasraprabhayā yojanaśatasahasraprabhayā yāvadanekayojanakoṭīniyutaśatasahasraprabhayā	སངས་རྒྱས་བཅོམ་ལྡན་འདས་རྣམས་ཀྱི་སྔོན་གྱི་སྨོན་ལམ་གྱི་བྱིན་གྱི་རླབས་ཀྱིས་འོད་འདོམ་གང་བ་དང་། འདོམ་དོ་པ་དང་། གསུམ་པ་དང་། བཞི་པ་དང་། ལྔ་པ་དང་། བཅུ་པ་དང་། ཉི་ཤུ་པ་དང་། སུམ་ཅུ་པ་དང་། བཞི་བཅུ་པ་དང་། ལྔ་བཅུ་པ་དང་། འོད་དཔག་ཚད་བཅུ་པ་དང་། འོད་དཔག་ཚད་བརྒྱ་པ་དང་། འོད་དཔག་ཚད་སྟོང་པ་དང་། འོད་དཔག་ཚད་བརྒྱ་སྟོང་པ་ནས་འོད་དཔག་ཚད་བྱེ་བ་ཁྲག་ཁྲིག་བརྒྱ་སྟོང་ཕྲག་དུ་མའི་འོད་ཀྱིས་འཇིག་རྟེན་གྱི་ཁམས་ཀྱི་བར་དུ་ཁྱབ་པར་གྱུར་ཏེ་། 
 vā lokaṃ spharitvā tiṣṭhanti |	གནས་པ་ནི་མ་གཏོགས་སོ་༎
 nāstyānanda upamopanyāso yena śakyaṃ tasyāmitābhasya tathāgatasya prabhāyāḥ pramāṇamudgrahītum |	ཀུན་དགའ་བོ་། དཔེ་གང་གིས་བཅོམ་ལྡན་འདས་དེ་བཞིན་གཤེགས་པ་འོད་དཔག་མེད་དེའི་འོད་ཀྱི་ཚད་གཟུང་བའི་དཔེ་གཞག་པ་མེད་དེ་།
 tadanenānanda paryāyeṇa sa tathāgato 'mitābha ityucyate,	ཀུན་དགའ་བོ་། རྣམ་གྲངས་དེས་ན་དེ་བཞིན་གཤེགས་པ་དེ་འོད་དཔག་མེད་ཅེས་བྱ་སྟེ་།
 amitaprabho 'mitaprabhāso 'samāptaprabho 'saṃgataprabhaḥ prabhāśikhotsṛṣṭaprabhaḥ	འོད་དཔག་ཏུ་མེད་པ་དང་། སྣང་བ་དཔག་ཏུ་མེད་པ་དང་། འོད་ཐུག་པ་མེད་པ་དང་། འོད་ཆགས་པ་མེད་པ་དང་། འོད་ཐོགས་པ་མེད་པ་དང་། འོད་རྟག་ཏུ་གཏོང་བ་དང་། ལྷའི་༄༣༨༩ཨ་༌༎
 sadivyamaṇiprabho 'pratihataraśmirāgaprabho rājanīyaprabhaḥ premaṇīyaprabhaḥ pramodanīyaprabhaḥ saṃgamanīyaprabha upoṣaṇīyaprabho nibandhanīyaprabho 'tivīryaprabho 'tulyaprabho 'bhibhūyanarendrāmūnnayendraprabhaḥ(?)	ནོར་བུའི་འོད་དང་། ཐོགས་པ་མེད་པའི་འོད་ཟེར་གྱི་རྒྱལ་པོའི་འོད་དང་། ཆགས་པར་འགྱུར་བའི་འོད་དང་། དགའ་བར་འགྱུར་བའི་འོད་དང་། མཆོག་ཏུ་དགའ་བར་འགྱུར་བའི་འོད་དང་། ཚིམ་པར་འགྱུར་བའི་འོད་དང་། ལྟ་བར་འགྱུར་བའི་འོད་དང་། འབྲེལ་བར་འགྱུར་བའི་འོད་དང་། བསམ་གྱིས་མི་ཁྱབ་པའི་འོད་དང་། མཚུངས་པ་མེད་པའི་འོད་དང་། མིའི་དབང་པོ་དང་། ལྷའི་དབང་པོ་ཟིལ་གྱིས་གནོན་པའི་འོད་དང་། ཉི་མ་དང་ཟླ་བ་ཟིལ་གྱིས་གནོན་ཞིང་མོག་མོག་པོར་བྱེད་པའི་འོད་དང་། འཇིག་རྟེན་སྐྱོང་བ་དང་། བརྒྱ་བྱིན་དང༏་ཚངས་པ་དང་། གནས་གཙང་མ་དང་། དབང་ཕྱུག་ཆེན་པོ་དང་། ལྷ་ཐམས་ཅད་ཟིལ་གྱིས་གནོན་ཅིང་མོག་མོག་པོར་བྱེད་པའི་འོད་དང་། མདོར་བསྡུ་ན་འོད་ཐམས་ཅད་ཀྱི་ཕ་རོལ་ཏུ་ཕྱིན་པ་ཞེས་བྱའོ་༎
 śrāntasaṃcayendusūryajihmīkaraṇaprabho 'bhibhūya lokapālaśakrabrahmaśuddhāvāsamaheśvarasarvadevajihmīkaraṇaprabha ityucyate |	དེའི་འོད་དེ་ནི་དྲི་མ་མེད་པ་ཤིན་ཏུ་རྒྱས་པ་ལུས་ལ་བདེ་བ་སྐྱེད་པ་།
 sā ca āryaprabhā vimalā vipulā kāyasukhasaṃjananī cittaudvilyakaraṇī devāsuranāgayakṣagandharvagaruḍamahoragakinnaramanuṣyāmanuṣyāṇāṃ	སེམས་དགའ་བར་བྱེད་པ་། ལྷ་དང་། ལྷ་མ་ཡིན་དང་། ཀླུ་དང་། གནོད་སྦྱིན་དང་། དྲི་ཟ་དང་། ནམ་མཁའ་ལྡིང་དང་། ལྟོ་འཕྱེ་ཆེན་པོ་དང་། མི་འམ་ཅི་དང་། མི་དང་། མི་མ་ཡིན་པ་རྣམས་ལ་དགའ་བ་དང་། མཆོག་ཏུ་དགའ་བ་དང་། བདེ་བ་བསྐྱེད་པ་།
 prītiprāmodyasukhakaraṇī kuśalāśayānāṃ sattvānāṃ kalyakuśalamimiṇevadviprāmodyakaraṇī(?)	སེམས་ཅན་དགེ་བའི་བསམ་པ་ཅན་རྣམས་ལ་དགེ་བ་དང་། ཡང་བ་དང་། རྟོགས་པ་དང་། མཁས་པ་དང་། བློ་དང་། མཆོག་ཏུ་དགའ་བ་བྱེད་པའོ་༎ ཀུན་དགའ་བོ་།
 ye 'nyeṣvapyanantāparyanteṣu buddhakṣetreṣu |	རྣམ་གྲངས་འདིས་སངས་རྒྱས་ཀྱི་ཞིང་གཞན་མཐའ་ཡས་མུ་༄༣༨༩བ་མེད་པ་དག་དེ་བཞིན་གཤེགས་པས་ཡོངས་སུ་གང་སྟེ་། 
 anena cānanda paryāyeṇa tathāgataḥ paripūrṇaṃ kalpaṃ bhāṣyet tasyāmitābhasya tathāgatasya nāma karmopādāya prabhāmārabhya,	བསྐལ་པར་དེ་བཞིན་གཤེགས་པ་འོད་དཔག་མེད་དེའི་མཚན་གྱི་ལས་རྒྱུར་བྱས་པ་སུ་གང་སྟེ་། དང་། འོད་ཕུན་སུམ་ཚོགས་པ་ལས་བརྩམས་ཏེ་བརྗོད་ཀྱང་མཚན་བསྟན་པ་དང་སུ་གང་སྟེ་། དང་། 
 na ca śaknoti guṇaparyantamadhigantuṃ tasyāḥ prabhāyāḥ,	། འོད་ཕུན་སུམ་ཚོགས་པའི་ཡོན་ཏན་གྱི་མཐའ་ཡང་རྟོགས་པར་མི་སུ་གང་སྟེ་། དང་། ། ནུས་ལ་།
 tathāgatasya vaiśāradyopacchedo bhavet |	དེ་བཞིན་གཤེགས་པའི་མི་འཇིགས་པ་ཡང་རྒྱུན་ཆད་པར་མི་འགྱུར་རོ་༎
 tatkasya hetoḥ?	དེ་ཅིའི་ཕྱིར་ཞེ་ན་། ཀུན་དགའ་བོ་། འདི་ལྟ་སྟེ་།
 ubhayamapyetadānanda aprameyamasaṃkhyeyamacintyāparyantaṃ yadidaṃ tasya bhagavato 'mitābhasya tathāgatasya prabhāguṇavibhūtiḥ, tathāgatasya cānuttaraṃ prajñāpratibhānam || sukhv_12 || start sukhv 13:	བཅོམ་ལྡན་འདས་འོད་དཔག་མེད་དེའི་འོད་ཀྱི་ཡོན་ཏན་འབྱོར་པ་དང་། དེ་བཞིན་གཤེགས་པའི་ཤེས་རབ་དང་། སྤོབས་པ་བླ་ན་མེད་པ་དང་། དེ་གཉིས་ཀ་ཡང་གྲངས་མེད་དཔག་ཏུ་མེད་ཅིང་བསམ་གྱིས་མི་ཁྱབ་ལ་མུ་མེད་པའི་ཕྱིར་རོ་༎ ཀུན་དགའ་བོ་།
 tasya khalu punarānanda amitābhasya tathāgatasyāprameyaḥ śrāvakasaṃgho yasya na sukaraṃ pramāṇamudgrahītum - iyatyaḥ śrāvakakoṭyaḥ,	དེ་བཞིན་གཤེགས་པ་འོད་དཔག་མེད་དེའི་ཉན་ཐོས་ཀྱི་དགེ་འདུན་དཔག་ཏུ་མེད་དེ༏་ཉན་ཐོས་བྱེ་བ་ཕྲག་འདི་སྙེད་ཅིག་ཅེའམ་།
 iyanti śrāvakakoṭīśatāni,	ཉན་ཐོས་བྱེ་བ་བརྒྱ་ཕྲག་འདི་སྙེད་ཅིག་ཅེའམ་།
 iyanti śrāvakakoṭīsahasrāṇi,	ཉན་ཐོས་བྱེ་བ་སྟོང་ཕྲག་འདི་སྙེད་ཅིག་ཅེའམ་།
 iyanti śrāvakakoṭīśatasahasrāṇi,	ཉན་ཐོས་བྱེ་བ་བརྒྱ་སྟོང་ཕྲག་འདི་སྙེད་ཅིག་ཅེའམ་།
 iyanti kaṃkarāṇi,	གཏམས་ཕྲག་འདི་སྙེད་ཅིག་ཅེའམ་།
 iyanti bimbarāṇi,	དཀྲིགས་ཕྲག་འདི་སྙེད་ཅིག་ཅེའམ་།
 iyanti nayutāni,	ཁྲག་ཁྲིག་ཕྲག་འདི་སྙེད་ཅིག་ཅེའམ་།
 iyantyayutāni,	ཐེར་འབུམ་ཕྲག་འདི་སྙེད་ཅིག་ཅེའམ་།
 iyantyakṣobhyāṇi,	མི་འཁྲུགས་པ་ཕྲག་འདི་སྙེད་ཅིག་ཅེའམ་།
 iyanto vivāhāḥ,	རྣམ་འདེག་ཕྲག་འདི་སྙེད་ཅིག་ཅེའམ་།
 iyanti srotāṃsi,	རྒྱུན་འབབ་ཕྲག་འདི་སྙེད་ཅིག་ཅེའམ་།
 iyanti ojāṃsi,	རྒྱལ་བ་ཕྲག་འདི་སྙེད་ཅིག་ཅེའམ་།
 iyantyaprameyāṇi,	དཔག་ཏུ་མེད་པ་ཕྲག་འདི་སྙེད་ཅིག་ཅེའམ་།
 iyantyasaṃkhyeyāni,	༄༣༩༠ཨ་༌༎ གྲངས་མེད་པ་ཕྲག་འདི་སྙེད་ཅིག་ཅེའམ་།
 iyantyagaṇyāni,	བགྲང་དུ་མེད་པ་ཕྲག་འདི་སྙེད་ཅིག་ཅེའམ་།
 iyantyatulyāni,	མཚུངས་པ་མེད་པ་ཕྲག་འདི་སྙེད་ཅིག་ཅེའམ་།
 iyantyacintyānīti |	བསམ་གྱིས་མི་ཁྱབ་པ་ཕྲག་འདི་སྙེད་ཅིག་ཅེས་དེའི་ཚད་གཟུང་བར་སླ་བ་མ་ཡིན་ནོ་༎ ཀུན་དགའ་བོ་། འདི་ལྟ་སྟེ་། དཔེར་ན་།
 tadyathā ānanda bhikṣurmaudgalyāyana ṛddhivaśitāprāptaḥ | sa ākāṅkṣan trisāhasramahāsāhasralokadhātau yāvanti tārārūpāṇi tāni sarvāṇyekarātridine nagareṇa gaṇayet, evaṃrūpāṇāṃ ca ṛddhimatāṃ koṭīniyutaśatasahasraṃ bhavet,	དགེ་སློང་མོའུ་དགལ་གྱི་བུ་ཆེན་པོའི་རྫུ་འཕྲུལ་ལ་དབང་ཐོབ་པ་དེ་འདོད་ན་སྟོང་གསུམ་གྱི་སྟོང་ཆེན་པོའི་འཇིག་རྟེན་གྱི་ཁམས་ན་སྐར་མའི་གཟུགས་ཇི་སྙེད་ཡོད་པ་དེ་དག་ཐམས་ཅད་ཉིན་ཞག་གཅིག་གིས་བགྲང་པ་དེ་ལྟ་བུའི་རྣམ་པའི་རྫུ་འཕྲུལ་དང་ལྡན་པ་བྱེ་བ་ཁྲག་ཁྲིག་བརྒྱ་སྟོང་ཡོད་པར་གྱུར་ལ་།
 te ca varṣakoṭīniyutaśatasahasramananyakarmaṇā amitābhasya tathāgatasya prathamaśrāvakasaṃnipātaṃ gaṇayeyuḥ | ebhirgaṇayadbhiḥ śatatamo 'pi bhāgo na gaṇito bhavet,	དེ་དག་ལས་གཞན་མི་བྱེད་པར་ལོ་བྱེ་བ་ཁྲག་ཁྲིག་བརྒྱ་སྟོང་དུ་དེ་བཞིན་གཤེགས་པ་འོད་དཔག་མེད་ཀྱི་ཉན་ཐོས་དང་པོ་འདུས་པ་བགྲངས་ཀྱང་དེ་དག་གིས་བརྒྱའི་ཆར་ཡང་བགྲངས་པར་མི་འགྱུར་ཏེ་། 
 sahasratamo 'pi śatasahasratamo 'pi, yāvatkalāmapi upamāmapi upanisāmapi na gaṇito bhavet |	སྟོང་དང་། བརྒྱ་སྟོང་དང་། ཆ་དང་། དཔེ་དང་། རྒྱུའི་བར་དུ་ཡང་བགྲངས་པར་མི་འགྱུར་རོ་༎ ཀུན་དགའ་བོ་། འདི་ལྟ་སྟེ་།
 tadyathā ānanda mahāsamudrāccaturaśītiyojanasahasrāṇyāvedhena tiryagaprameyāt kaścideva puruṣaḥ śatadhā bhinnayā bālāgrakoṭyā ekamudakabindumabhyutkṣipet,	དཔེར་ན་། རྒྱ་མཚོ་ཆེན་པོ་ཟབས་སུ་དཔག་ཚད་བརྒྱད་ཁྲི་བཞི་སྟོང་ཡོད་པ་། ཁྱོན་དཔག་ཏུ་མེད་པ་ལ་མི་ལ་ལ་ཞིག་གིས་སྐྲ་ཚལ་པ་བརྒྱར་བཤགས་པའི་རྩེ་མོས་ཆུ་ཐིགས་པ་གཅིག་བླངས་ན་། ཀུན་དགའ་བོ་།
 tatkiṃ manyase ānanda katamo 'tra bahutaraḥ - yo vā śatadhā bhinnayā bālāgrakoṭyābhyutkṣipta eka udakabinduḥ, yo vā mahāsamudre 'psakandho 'vaśisṭa iti?	འདི་ཇི་སྙམ་དུ་སེམས་། གང་སྐྲ་ཚལ་པ་བརྒྱར་བཤགས་པའི་རྩེ་མོས་ཆུའི་ཐིགས་པ་གཅིག་བླངས་པ་དང་། གང་རྒྱ་མཚོ་ཆེན་པོའི་ཆུའི་ཕུང་པོ་ཕྱི་ན་ལས་པ་དེ་༄༣༩༠བ་གཉིས་གང་མང་།
 ānanda āha - yojanasahasramapi tāvadbhagavan mahāsamudrasya parīttaṃ bhavet kimaṅga punaḥ śatadhā bhinnayā bālāgrakoṭyā (sukhv, vaidya 235) utkṣipta eka udakabinduḥ |	གསོལ་པ་། བཅོམ་ལྡན་འདས་། དཔག་ཚད་སྟོང་ཡང་རྒྱ་མཚོ་ཆེན་པོ་བས་ཉུང་ལགས་ན་། སྐྲ་ཚལ་པ་བརྒྱར་བཤགས་པའི་རྩེ་མོས་ཆབ་ཐིགས་པ་གཅིག་བླངས་པ་ལྟ་སྨོས་ཀྱང་ཅི་འཚལ་།
 bhagavānāha - tadyathā sa ekabinduḥ,	བཅོམ་ལྡན་འདས་ཀྱིས་བཀའ་སྩལ་པ་། ཀུན་དགའ་བོ་། ཆུའི་ཐིགས་པ་གཅིག་ལྟ་བུར་ནི་།
 iyattamaḥ sa prathamasaṃnipāto 'bhūt | tairmaudgalyāyanasadṛśairbhikṣubhirgaṇayadbhistena varṣakoṭīniyutaśatasahasreṇa gaṇitaṃ bhavet,	བཅོམ་ལྡན་འདས་དེ་བཞིན་གཤེགས་པ་འོད་དཔག་མེད་ཀྱི་ཉན་ཐོས་དང་པོར་འདུས་པ་ལ་མོའུ་དགལ་གྱི་བུ་འདི་ལྟ་བུའི་དགེ་སློང་རྣམས་ཀྱིས་ལོ་བྱེ་བ་ཁྲག་ཁྲིག་བརྒྱ་སྟོང་དུ་བགྲངས་ཏེ་འདི་སྙེད་གཅིག་གོ་ཞེས་གྲངས་ཀྱིས་ཆོད་པ་ལྟ་བུ་ཡིན་ནོ་༎ 
 yathā mahāsamudre 'pskandho 'vaśiṣṭaḥ | evamagaṇitaṃ draṣṭavyam |	རྒྱ་མཚོ་ཆེན་པོའི་ཆུའི་ཕུང་པོ་ཕྱི་ན་ལས་པ་ལྟ་བུ་ནི་གྲངས་ཀྱིས་མ་ཆོད་པ་ལྟ་བུ་ཡིན་ན་།
 kaḥ punarvādo dvitīyatṛtīyādīnāṃ śrāvakasaṃnipātānām |	ཉན་ཐོས་འདུས་པ་གཉིས་པ་དང་། གསུམ་པ་རྣམས་ལྟ་སྨོས་ཀྱང་ཅི་དགོས་ཏེ་།
 evamanantāparyantastasya bhagavataḥ śrāvakasaṃgho yo 'prameyāsaṃkhyeya ityeva saṃkhyāṃ gacchati || sukhv_13 || start sukhv 14:	བཅོམ་ལྡན་འདས་དེའི་ཉན་ཐོས་ཀྱི་དགེ་འདུན་ནི་དེ་ལྟར་མཐའ་ཡས་མུ་མེད་དེ་། དེ་ནི་དཔག་ཏུ་མེད་དོ་༎ ཞེས་བྱ་བའི་གྲངས་སུ་འགྲོ་བ་ཡིན་ནོ་༎
 aparimitaṃ ca ānanda tasya bhagavato 'mitābhasya tathāgatasyāyuḥpramāṇaṃ yasya na sukaraṃ pramāṇamadhigantum,	ཀུན་དགའ་བོ་། བཅོམ་ལྡན་འདས་དེ་བཞིན་གཤེགས་པ་འོད་དཔག་མེད་དེའི་ཚེའི་ཚད་ཀྱང་དཔག་ཏུ་མེད་དེ་།
 iyanti vā kalpaśatāni,	བསྐལ་པ་འདི་སྙེད་ཅིག་ཅེའམ་།
 iyanti vā kalpasahasrāṇi,	བསྐལ་པ་བརྒྱ་ཕྲག་འདི་སྙེད་ཅིག་ཅེའམ་།
 iyanti vā kalpaśatasahasrāaṇi,	བསྐལ་པ་སྟོང་ཕྲག་འདི་སྙེད་ཅིག་ཅེའམ་།
 iyatyo vā kalpakoṭyaḥ,	བསྐལ་པ་བརྒྱ་སྟོང་ཕྲག་འདི་སྙེད་ཅིག་ཅེའམ་།
 iyanti vā kalpakoṭīśatāni,	བསྐལ་པ་བྱེ་བ་ཁྲག་འདི་སྙེད་ཅིག་ཅེའམ་།
 iyanti vā kalpakoṭīsahasrāṇi,	བསྐལ་དབྱེ་བ་བརྒྱ་ཕྲག་འདི་སྙེད་ཅིག་ཅེའམ་།
 iyanti vā kalpakoṭīśatasahasrāṇi,	བསྐལ་པ་བྱེ་བ་སྟོང་ཕྲག་འདི་སྙེད་ཅིག་ཅེའམ་།
 iyanti vā kalpakoṭīniyutaśatasahasrāṇīti |	བསྐལ་པ་བྱེ་བ་བརྒྱ་སྟོང་ཕྲག་འདི་སྙེད་ཅིག་ཅེས་བྱ་༄༣༩༡ཨ་༌༎ བ་ནས་བསྐལ་པ་བྱེ་བ་ཁྲག་ཁྲིག་བརྒྱ་སྟོང་ཕྲག་འདི་སྙེད་ཅིག་གོ་ཞེས་བྱ་བའི་བར་དུ་ཚེའི་ཚད་རྟོགས་པར་སླ་བ་མ་ཡིན་ནོ་༎ ཀུན་དགའ་བོ་།
 atha tarhi ānanda aparimitameva tasya bhagavat āyuḥpramāṇamaparyantam | tena sa tathāgato 'mitāyurityucyate |	བཅོམ་ལྡན་འདས་དེ་བཞིན་གཤེགས་པ་འོད་དཔག་མེད་དེའི་སྐུ་ཚེའི་ཚད་དེ་ལྟར་དཔག་ཏུ་མེད་དེ་། དེའི་ཕྱིར་དེ་བཞིན་གཤེགས་པ་དེ་ཚེ་དཔག་མེད་ཅེས་བྱའོ་༎
 yathā cānanda iha lokadhātau kalpagaṇanāprajñaptisaṃketaḥ,	ཀུན་དགའ་བོ་།
 tathā sāṃprataṃ daśa kalpāstasya bhagavato 'mitāyuṣastathāgatasyotpannasya anuttarāṃ samyaksaṃbodhimabhisaṃbuddhasya || sukhv_14 ||	བཅོམ་ལྡན་འདས་དེ་བཞིན་གཤེགས་པ་འོད་དཔག་མེད་དེ་བླ་ན་མེད་པ་ཡང་དག་པར་རྫོགས་པའི་བྱང་ཆུབ་མངོན་པར་རྫོགས་པར་སངས་རྒྱས་ནས་ཇི་ལྟར་ད་ལྟར་འཇིག་རྟེན་གྱི་ཁམས་འདི་ན་། བསྐལ་པའི་གྲངས་དང་། བསྐལ་པ་བགྲང་བའི་བརྡར་བཏགས་པ་དེ་ལྟ་བུའི་བསྐལ་པ་བཅུ་ལོན་ནོ་༎ ཀུན་དགའ་བོ་། བཅོམ་ལྡན་འདས་འོད་དཔག་མེད་ཀྱི་འཇིག་རྟེན་གྱི་ཁམས་བདེ་བ་ཅན་ཞེས་བྱ་བ་ནི་འབྱོར་བ་། མོད་པ་།
 start sukhv 15: tasya khalu punarānanda bhagavato 'mitābhasya sukhāvatī nāma lokadhāturṛddhā ca sphītā ca kṣemā ca subhikṣā ca ramaṇīyā ca bahudevamanuṣyākīrṇā ca |	བདེ་བ་། ལོ་ལེགས་པ་། ཉམས་དགའ་བ་། ལྷ་དང་མི་མང་པོས་གང་བའོ་༎ ཀུན་དགའ་བོ་།
 tatra khalvānanda lokadhātau na nirayāḥ santi na tiryagyonirna pretaviṣayo nāsurāḥ kāyā nākṣaṇopapattayaḥ |	འཇིག་རྟེན་གྱི་ཁམས་དེ་ན་སེམས་ཅན་དམྱལ་བ་མེད་དོ༏་༏དུད་འགྲོའི་སྐྱེ་གནས་མེད་དོ་༎ ཡི་དབ༹གས་ཀྱི་ཡུལ་མེད་དོ་༎ ལྷ་མ་ཡིན་གྱི་རིས་མེད་དོ་༎ མི་ཁོམ་པར་སྐྱེ་བ་མེད་དོ་༎
 na ca tāni ratnāni loke pracaranti yāni sukhāvatyāṃ lokadhātau vidyante || sukhv_15 || start sukhv 16:	འཇིག་རྟེན་གྱི་ཁམས་བདེ་བ་ཅན་ན་སྣང་བའི་རིན་པོ་ཆེ་གང་ཡིན་པ་དེ་དག་ནི་འཇིག་རྟེན་ན་མི་སྤྱོད་དོ་༎
 sā khalvānanda sukhāvatī lokadhātuḥ surabhinānāgandhasamīritā nānāpuṣpaphalasamṛddhā ratnavṛkṣasamalaṃkṛtā tathāgatābhinirmitamanojñasvaranānādvijasaṃghaniṣevitā	ཀུན་དགའ་བོ་། འཇིག་རྟེན་གྱི་ཁམས་བདེ་བ་ཅན་དེ་ནི་སྤོས་སྣ་ཚོགས་དྲི་རབ་ཏུ་ཞིམ་པ་ངད་ལྡང་བའི་མེ་ཏོག་དང་འབྲས་བུ་སྣ་ཚོགས་འབྱོར་༄༣༩༡བ་པའོ༏་༏རིན་པོ་ཆེའི་ཤིང་ལྗོན་པས་ལེགས་པར་བརྒྱན་པའོ་༎ དེ་བཞིན་གཤེགས་པའི་སྤྲུལ་པའི་བྱ་རྣམ་པ་སྣ་ཚོགས་སྒྲ་ཡིད་དུ་འོང་བ་ཅན་གྱི་ཚོགས་༎ ཀྱིས་བརྒྱན་པའོ་༎ ཀུན་དགའ་བོ་།
 te cānanda ratnavṛkṣā nānāvarṇā anekavarṇā anekaśatasahasravarṇāḥ |	རིན་པོ་ཆེའི་ཤིང་ལྗོན་པ་དེ་དག་ནི་ཁ་དོག་ཐ་དད་པ་། ཁ་དོག་དུ་མ་། ཁ་དོག་བརྒྱ་སྟོང་ཕྲག་དུ་མ་ཡོད་པའོ་༎
 santi tatra ratnavṛkṣāḥ suvarṇavarṇāḥ suvarṇamayāḥ |	ཀུན་དགའ་བོ་། དེ་ན་རིན་པོ་ཆེའི་ཤིང་ལྗོན་པ་གསེར་གྱི་ཁ་དོག་ལྟ་བུ་དང་། གསེར་གྱི་རང་བཞིན་དག་ཡོད་དོ་༎
 santi rūpyavarṇā rūpyamayāḥ |	དངུལ་གྱི་ཁ་དོག་ལྟ་བུ་དང་། དངུལ་གྱི་རང་བཞིན་དག་ཡོད་དོ་༎
 santi vaiḍūryavarṇā vaiḍūryamayāḥ |	བེཨེ་དའུརྱའི་ཁ་དོག་ལྟ་བུ་དང་། བེཨེ་དའུརྱའི་རང་བཞིན་དག་ཡོད་དོ་༎
 santi sphaṭikavarṇāḥ sphaṭikamayāḥ |	ཤེལ་གྱི་ཁ་དོག་ལྟ་བུ་དང་། ཤེལ་གྱི་རང་བཞིན་དག་ཡོད་དོ་༎
 santi musāragalvavarṇā musāragalvamayāḥ |	སྤུག་གི་ཁ་དོག་ལྟ་བུ་དང་། སྤུག་གི་རང་བཞིན་དག་ཡོད་དོ་༎
 santi lohitamuktāvarṇā lohitamuktāmayāḥ |	མུ་ཏིག་དམར་པོའི་ཁ་དོག་ལྟ་བུ་དང་། མུ་ཏིག་དམར་པོའི་རང་བཞིན་དག་ཡོད་དོ་༎
 santyaśmagarbhavarṇā aśmagarbhamayāḥ |	རྡོའི་སྙིང་པོའི་ཁ་དོག་ལྟ་བུ་དང་། རྡོའི་སྙིང་པོའི་རང་བཞིན་དག་ཡོད་དོ་༎
 santi kecid dvayo ratnayoḥ suvarṇasya rūpyasya ca |	ཁ་ཅིག་ནི་གསེར་དང་། དངུལ་དང་། རིན་པོ་ཆེ་སྣ་གཉིས་པ་དག་ཡོད་དོ་༎
 santi trayāṇāṃ ratnānāṃ suvarṇasya rūpyasya vaiḍūryasya ca |	གསེར་དང་། དངུལ་དང་། བེཨེ་དའུརྱ་དང་། རིན་པོ་ཆེ་སྣ་གསུམ་པ་དག་ཀྱང་ཡོད་དོ་༎
 santi caturṇāṃ ratnānāṃ suvarṇasya rūpyasya vaiḍūryasya sphaṭikasya ca |	གསེར་དང་། དངུལ་དང་། བེཨེ་དའུརྱ་དང་། ཤེལ་དང་། རིན་པོ་ཆེ་སྣ་བཞི་པ་དག་ཀྱང་ཡོད་དོ་༎
 santi pañcānāṃ ratnānāṃ suvarṇasya rūpyasya vaiḍūryasya sphaṭikasya musāragalvasya ca |	གསེར་དང་། དངུལ་དང་། བེཨེ་དའུརྱ་དང་། ཤེལ་དང་། སྤུག་དང་། རིན་པོ་ཆེ་སྣ་ལྔ་པ་དག་ཀྱང་ཡོད་དོ་༎
 santi ṣaṇṇāṃ ratnānāṃ suvarṇasya rūpyasya vaiḍūryasya sphaṭikasya musāragalvasya lohitamuktāyāśca |	གསེར་དང་། དངུལ་དང་། བེཨེ་དའུརྱ་དང་། ཤེལ་དང་། སྤུག་དང་། མུ་ཏིག་དམར་པོ་དང་། རིན་པོ་ཆེ་སྣ་དྲུག་པ་དག་ཀྱང་ཡོད་དོ་༎ གསེར་དང་། དངུལ་༄༣༩༢ཨ་༌༎
 santi saptānāṃ ratnānāṃ suvarṇasya rūpyasya vaiḍūryasya sphaṭikasya musāragalvasya lohitamuktāyā aśmagarbhasya ca saptamasya |	དང༏་བེཨེ་དའུརྱ་དང་། ཤེལ་དང་། སྤུག་དང་། མུ་ཏིག་དམར་པོ་དང་། རྡོའི་སྙིང་པོ་དང་། རིན་པོ་ཆེ་སྣ་བདུན་པ་དག་ཀྱང་ཡོད་དོ་༎
 tatrānanda suvarṇamayānāṃ vṛkṣāṇāṃ suvarṇamayāni mūlaskandhaviṭapaśākhāpatrapuṣpāṇi,	ཀུན་དགའ་བོ་། དེ་ན་གསེར་གྱི་ཤིང་ལྗོན་པ་རྣམས་ཀྱི་རྩ་བ་དང་། སྡོང་པོ་དང་། ཡལ་ག་དང་། ལོ་མ་དང་། འདབ་མ་དང་། མེ་ཏོག་རྣམས་གསེར་གྱི་རང་བཞིན་ལ་། རྩ་བ་རྣམས་དངུལ་གྱི་རང་བཞིན་ནོ་༎
 phalāni rūpyamayāṇi | rūpyamayāṇāṃ vṛkṣāṇāṃ rūpyamayānyeva mūlaskandhaviṭapaśākhāpatrapuṣpāṇi,	དངུལ་གྱི་ཤིང་ལྗོན་པ་རྣམས་ཀྱི་རྩ་བ་དང་། སྡོང་པོ་དང་། ཡལ་ག་དང་། ལོ་མ་དང་། འདབ་མ་དང་། མེ་ཏོག་རྣམས་དངུལ་གྱི་རང་བཞིན་ལ་།
 phalāni vaiḍūryamayāṇi |	འབྲས་བུ་རྣམས་བེཨེ་དའུརྱའི་རང་བཞིན་ནོ་༎
 vaiḍūryamayāṇāṃ vṛkṣāṇāṃ vaiḍūryamayāṇi mūlaskandhaviṭapaśākhāpatrapuṣpāṇi,	བེཨེ་དའུརྱའི་ཤིང་ལྗོན་པ་རྣམས་ཀྱི་རྩ་བ་དང་། སྡོང་པོ་དང་། ཡལ་ག་དང་། ལོ་མ་དང་། འདབ་མ་དང་། མེ་ཏོག་རྣམས་བེཨེ་དའུརྱའི་རང་བཞིན་ལ་།
 phalāni sphaṭikamayāni |	འབྲས་བུ་རྣམས་ཤེལ་གྱི་རང་བཞིན་ནོ་༎
 sphaṭikamayānāṃ vṛkṣāṇāṃ sphaṭikamayānyeva mūlaskandhaviṭapaśākhāpatrapuṣpāṇi, (sukhv, vaidya 236) phalāni ca musāragalvamayāni |	ཤེལ་གྱི་ཤིང་ལྗོན་པ་རྣམས་ཀྱི་རྩ་བ་དང་། སྡོང་པོ་དང་། ཡལ་ག་དང་། ལོ་མ་དང་། འདབ་མ་དང་། མེ་ཏོག་རྣམས་ཤེལ་གྱི་རང་བཞིན་ལ་།
 musāragalvamayānāṃ vṛkṣāṇāṃ musāragalvamayānyeva mūlaskandhaviṭapaśākhāpatrapuṣpāṇi,	འབྲས་བུ་རྣམས་སྤུག་གི་རང་བཞིན་ནོ༏་༏སྤུག་གི་ཤིང་ལྗོན་པ་རྣམས་ཀྱི་རྩ་བ་དང་། སྡོང་པོ་དང་། ཡལ་ག་དང་། ལོ་མ་དང་། འདབ་མ་དང་། མེ་ཏོག་རྣམས་སྤུག་གི་རང་བཞིན་ལ་།
 phalāni ca lohitamuktāmayāni |	འབྲས་བུ་རྣམས་མུ་ཏིག་དམར་པོའི་རང་བཞིན་ནོ་༎
 lohitamuktāmayānāṃ vṛkṣāṇāṃ lohitamuktāmayānyeva mūlaskandhaviṭapaśākhāpatrapuṣpāṇi, phalāni cāśmagarbhamayāṇi |	མུ་ཏིག་དམར་པོའི་ཤིང་ལྗོན་པ་རྣམས་ཀྱི་རྩ་བ་དང་། སྡོང་པོ་དང་། ཡལ་ག་དང་། ལོ་མ་དང་། འདབ་མ་དང་། མེ་ཏོག་རྣམས་མུ་ཏིག་དམར་པོའི་རང་བཞིན་ལ་། ༄༣༩༢བ་འབྲས་བུ་རྣམས་རྡོའི་སྙིང་པོའི་རང་བཞིན་ནོ་༎
 aśmagarbhamayāṇāṃ vṛkṣāṇāmaśmagarbhamayāṇyeva mūlaskandhaviṭapaśākhāpatrapuṣpāṇi, phalāni ca suvarṇamayāni |	རྡོའི་སྙིང་པོའི་ཤིང་ལྗོན་པ་རྣམས་ཀྱི་རྩ་བ་དང་། སྡོང་པོ་དང་། ཡལ་ག་དང་། ལོ་མ་དང་། འདབ་མ་དང་། མེ་ཏོག་རྣམས་རྡོའི་སྙིང་པོའི་རང་བཞིན་ལ༏་འབྲས་བུ་རྣམས་གསེར་གྱི་རང་བཞིན་ནོ་༎ ཀུན་དགའ་བོ་།
 keṣāṃcidānanda vṛkṣāṇāṃ suvarṇamayāni mūlāni,	ཤིང་ལྗོན་པ་ཁ་ཅིག་ནི་རྩ་བ་རྣམས་གསེར་གྱི་རང་བཞིན་ལ་།
 rūpyamayāḥ skandhāḥ,	སྡོང་པོ་རྣམས་དངུལ་གྱི་རང་བཞིན་།
 vaiḍūryamayā viṭapāḥ,	ཡལ་ག་རྣམས་བེཨེ་དའུརྱའི་རང་བཞིན་།
 sphaṭikamayāḥ śākhāḥ, musāragalvamayāni patrāṇi,	ལོ་མ་རྣམས་ཤེལ་གྱི་རང་བཞིན་། འདབ་མ་རྣམས་སྤུག་གི་རང་བཞིན་།
 lohitamuktāmayāni puṣpāṇi,	མེ་ཏོག་རྣམས་མུ་ཏིག་དམར་པོའི་རང་བཞིན་།
 aśmagarbhamayāṇi phalāni |	འབྲས་བུ་རྣམས་རྡོའི་སྙིང་པོའི་རང་བཞིན་ནོ་༎ ཀུན་དགའ་བོ་།
 keṣāṃcidānanda vṛkṣāṇāṃ rūpyamayāṇi mūlāni,	ཤིང་ལྗོན་པ་ཁ་ཅིག་ནི་རྩ་བ་རྣམས་དངུལ་གྱི་རང་བཞིན་ལ་།
 vaiḍūryamayāḥ skandhāḥ,	སྡོང་པོ་རྣམས་བེཨེ་དའུརྱའི་རང་བཞིན་།
 sphaṭikamayā viṭapāḥ,	ཡལ་ག་རྣམས་ཤེལ་གྱི་རང་བཞིན་།
 musāragalvamayāḥ śākhāḥ,	ལོ་མ་རྣམས་སྤུག་གི་རང་བཞིན་།
 lohitamuktāmayāni patrāṇi,	འདབ་མ་རྣམས་མུ་ཏིག་དམར་པོའི་རང་བཞིན་།
 aśmagarbhamayāṇi puṣpāṇi,	མེ་ཏོག་རྣམས་རྡོའི་སྙིང་པོའི་རང་བཞིན་།
 suvarṇamayāni phalāni |	འབྲས་བུ་རྣམས་གསེར་གྱི་རང་བཞིན་ནོ་༎ ཀུན་དགའ་བོ་།
 keṣāṃcidānanda vṛkṣāṇāṃ vaiḍūryamayāṇi mūlāni, sphaṭikamayāḥ skandhāḥ,	ཤིང་ལྗོན་པ་ཁ་ཅིག་ནི་རྩ་བ་རྣམས་བེཨེ་དའུརྱའི་རང་བཞིན་ལ་།
 musāragalvamayā viṭapāḥ,	སྡོང་པོ་རྣམས་ཤེལ་གྱི་རང་བཞིན་།
 lohitamuktāmayāḥ śākhāḥ,	ཡལ་ག་རྣམས་སྤུག་གི་རང་བཞིན་། ལོ་མ་རྣམས་མུ་ཏིག་དམར་པོའི་རང་བཞིན་།
 aśmagarbhamayāṇi patrāṇi,	འདབ་མ་རྣམས་རྡོའི་སྙིང་པོའི་རང་བཞིན་།
 suvarṇamayāni puṣpāṇi,	མེ་ཏོག་རྣམས་གསེར་གྱི་རང་བཞིན་།
 rūpyamayāṇi phalāni |	འབྲས་བུ་རྣམས་དངུལ་གྱི་རང་བཞིན་ནོ་༎
 keṣāṃcidānanda vṛkṣāṇāṃ sphaṭikamayāni mūlāni,	ཀུན་དགའ་བོ་། ཤིང་ལྗོན་པ་ཁ་ཅིག་ནི་རྩ་བ་རྣམས་ཤེལ་གྱི་རང་བཞིན་ལ་།
 musāragalvamayāḥ skandhāḥ,	སྡོང་པོ་རྣམས་སྤུག་གི་རང་བཞིན་།
 lohitamuktāmayā viṭapāḥ,	༄༣༩༣ཨ་༌༎ ཡལ་ག་རྣམས་མུ་ཏིག་དམར་པོའི་རང་བཞིན་༎
 aśmagarbhamayāḥ śākhāḥ,	ལོ་མ་རྣམས་རྡོའི་སྙིང་པོའི་རང་བཞིན་།
 suvarṇamayāni patrāṇi,	འདབ་མ་རྣམས་གསེར་གྱི་རང་བཞིན་།
 rūpyamayāṇi puṣpāṇi,	མེ་ཏོག་རྣམས་དངུལ་གྱི་རང་བཞིན་།
 vaiḍūryamayāṇi phalāni |	འབྲས་བུ་རྣམས་བེཨེ་དའུརྱའི་རང་བཞིན་ནོ་༎ ཀུན་དགའ་བོ་།
 keṣāṃcidānanda vṛkṣāṇāṃ musāragalvamayāni mūlāni,	ཤིང་ལྗོན་པ་ཁ་ཅིག་ནི་རྩ་བ་རྣམས་སྤུག་གི་རང་བཞིན་ལ་།
 lohitamuktāmayāḥ skandhāḥ,	སྡོང་པོ་རྣམས་མུ་ཏིག་དམར་པོའི་རང་བཞིན་།
 aśmagarbhamayā viṭapāḥ,	ཡལ་ག་རྣམས་རྡོའི་སྙིང་པོའི་རང་བཞིན་།
 suvarṇamayāḥ śākhāḥ,	ལོ་མ་རྣམས་གསེར་གྱི་རང་བཞིན་།
 rūpyamayāṇi patrāṇi,	འདབ་མ་རྣམས་དངུལ་གྱི་རང་བཞིན་།
 vaiḍūryamayāṇi puṣpāṇi,	མེ་ཏོག་རྣམས་བེཨེ་དའུརྱའི་རང་བཞིན་།
 sphaṭikamayāni phalāni |	འབྲས་བུ་རྣམས་ཤེལ་གྱི་རང་བཞིན་ནོ་༎
 keṣāṃcidānanda vṛkṣāṇāṃ lohitamuktāmayāni mūlāni,	ཀུན་དགའ་བོ༏་ཤིང་ལྗོན་པ་ཁ་ཅིག་ནི་རྩ་བ་རྣམས་མུ་ཏིག་དམར་པོའི་རང་བཞིན་ལ་།
 aśmagarbhamayāḥ skandhāḥ,	སྡོང་པོ་རྣམས་རྡོའི་སྙིང་པོའི་རང་བཞིན་།
 suvarṇamayā viṭapāḥ,	ཡལ་ག་རྣམས་གསེར་གྱི་རང་བཞིན་།
 rūpyamayāḥ śākhāḥ, vaiḍūryamayāṇi patrāṇi,	ལོ་མ་རྣམས་དངུལ་གྱི་རང་བཞིན་། འདབ་མ་རྣམས་བེཨེ་དའུརྱའི་རང་བཞིན་།
 sphaṭikamayāni puṣpāṇi,	མེ་ཏོག་རྣམས་ཤེལ་གྱི་རང་བཞིན་།
 musāragalvamayāṇi phalānikeṣāṃcidānanda vṛkṣāṇāmaśmagarbhamayāṇi mūlāni,	འབྲས་བུ་རྣམས་སྤུག་གི་རང་བཞིན་ནོ་༎ ཀུན་དགའ་བོ་། ཤིང་ལྗོན་པ་ཁ་ཅིག་ནི་རྩ་བ་རྣམས་རྡོའི་སྙིང་པོའི་རང་བཞིན་ལ་།
 suvarṇamayāḥ skandhāḥ,	སྡོང་པོ་རྣམས་གསེར་གྱི་རང་བཞིན་།
 rūpyamayā viṭapāḥ,	ཡལ་ག་རྣམས་དངུལ་གྱི་རང་བཞིན་།
 vaiḍūryamayāḥ śākhāḥ,	ལོ་མ་རྣམས་བེཨེ་དའུརྱའི་རང་བཞིན་།
 sphaṭikamayāni patrāṇi,	འདབ་མ་རྣམས་ཤེལ་གྱི་རང་བཞིན་།
 musāragalvamayāni puṣpāṇi,	མེ་ཏོག་རྣམས་སྤུག་གི་རང་བཞིན་།
 lohitamuktāmayāni phalāni |	འབྲས་བུ་རྣམས་མུ་ཏིག་དམར་པོའི་རང་བཞིན་ནོ་༎ ཀུན་དགའ་བོ་།
 keṣāṃcidānanda vṛkṣāṇāṃ saptaratnamayāni mūlāni,	ཤིང་ལྗོན་པ་ཁ་ཅིག་ནི་རྩ་བ་རྣམས་རིན་པོ་ཆེ་སྣ་བདུན་གྱི་རང་བཞིན་ལ་།
 saptaratnamayāḥ skandhāḥ,	སྡོང་པོ་༄༣༩༣བ་རྣམས་ཀྱང་རིན་པོ་ཆེ་སྣ་བདུན་གྱི་རང་བཞིན་།
 saptaratnamayā viṭapāḥ,	ཡལ་ག་རྣམས་ཀྱང་རིན་པོ་ཆེ་སྣ་བདུན་གྱི་རང་བཞིན་།
 saptaratnamayāḥ śākhāḥ,	ལོ་མ་རྣམས་ཀྱང་རིན་པོ་ཆེ་སྣ་བདུན་གྱི་རང་བཞིན་།
 saptaratnamayāni patrāṇi,	འདབ་མ་རྣམས་ཀྱང་རིན་པོ་ཆེ་སྣ་བདུན་གྱི་རང་བཞིན་།
 saptaratnamayāni puṣpāṇi,	མེ་ཏོག་རྣམས་ཀྱང་རིན་པོ་ཆེ་སྣ་བདུན་གྱི་རང་བཞིན་།
 saptaratnamayāni phalāni |	འབྲས་བུ་རྣམས་ཀྱང་རིན་པོ་ཆེ་སྣ་བདུན་གྱི་རང་བཞིན་ནོ་༎ ཀུན་དགའ་བོ་།
 sarveṣāṃ cānanda teṣāṃ vṛkṣāṇāṃ mūlaskandhaviṭapaśākhāpatrapuṣpaphalāni sukhasaṃsparśāni sugandhīni |	ཤིང་ལྗོན་པ་དེ་དག་ཐམས་ཅད་ཀྱི་རྩ་བ་དང༏་སྡོང་པོ་དང་། ཡལ་ག་དང་། ལོ་མ་དང་། འདབ་མ་དང་། མེ་ཏོག་དང་། འབྲས་བུ་རྣམས་ནི་འཇམ་པ་། རེག་ན་བདེ་བ་། དྲི་ཞིམ་པ་དག་གོ་།
 vātena preritena ca teṣāṃ valgumanojñaghoṣo niścaratyasecanako 'pratikūlaḥ śravaṇāya |	རླུང་གིས་བསྐྱོད་ན་དེ་དག་ལས་སྙན་ཅིང་ཡིད་དུ་འོང་བའི་སྒྲ་འབྱུང་སྟེ་། མཉན་པ་དང་མཐུན་ཞིང་མཉན་པས་ཆོག་མི་ཤེས་པའོ་༎
 evaṃrūpairānanda saptaratnamayairvṛkṣaiḥ saṃtataṃ tadbuddhakṣetraṃ samantācca kadalīskandhaiḥ	ཀུན་དགའ་བོ་། སངས་རྒྱས་ཀྱི་ཞིང་དེ་ནི་རིན་པོ་ཆེ་སྣ་བདུན་གྱི་ཤིང་ལྗོན་པ་རྣམ་པ་དེ་ལྟ་བུ་དག་གིས་གང་སྟེ་།
 saptaratnamayai ratnatālapaṅktibhiścānuparikṣiptaṃ sarvataśca hemajālapraticchannaṃ	མཐའ་ན་རིན་པོ་ཆེ་སྣ་བདུན་གྱི་ཆུ་ཤིང་གི་སྡོང་པོ་དང་། རིན་པོ་ཆེའི་ཤིང་ཏ་ལའི་ཕྲེང་གིས་ཡོངས་སུ་བསྐོར་ཏོ་༎ ཐམས་ཅད་ཀྱང་གསེར་གྱི་དྲ་བས་ཁེབས་པའོ་༎
 samantaśca sarvaratnamayaiḥ padmaiḥ saṃchannam |	ཀུན་དུ་རིན་པོ་ཆེ་སྣ་བདུན་གྱི་པདམ་རྣམས་ཀྱིས་ཁེབས་པའོ་༎
 santi tatra padmānyardhayojanapramāṇāni,	དེ་ན་པདམའི་ཚད་དཔག་ཚད་ཕྱེད་པ་ཙམ་ཡང་ཡོད་།
 santi yojanapramāṇāni,	དཔག་ཚད་ཀྱི་ཚད་ཙམ་ཡང་ཡོད་།
 santi dvitricatuḥpañcayojanapramāṇāni,	དཔག་ཚད་གཅིག་དང་། གཉིས་དང་། གསུམ་དང་། བཞི་དང་། ལྔའི་ཚད་ཙམ་ཡང་ཡོད་།
 santi yāvaddaśayojanapramāṇāni |	དཔག་ཚད་བཅུའི་བར་གྱི་ཚད་ཙམ་དག་ཀྱང་ཡོད་དོ་༎
 sarvataśca ratnapadmātṣaṭtriṃśadraśmikoṭīśatasahasrāṇi niścaranti |	རིན་པོ་ཆེའི་པདམ་ཐམས་ཅད་ལས་ཀྱང་འོད་ཟེར་བྱེ་བ་སྟོང་ཕྲག་སུམ་ཅུ་རྩ་དྲུག་དྲུག་འབྱུང་ངོ་༎ འོད་ཟེར་གྱི་རྩེ་མོ་༄༣༩༤ཨ་༌༎
 sarvataśca raśmimukhātṣaṭtriṃśadbuddhakoṭīśatasahasrāṇi niścaranti suvarṇamayavarṇaiḥ kāyairdvātriṃśanmahāpuruṣalakṣaṇadharaiḥ, yāni pūrvasyāṃ diśyaprameyāsaṃkhyeyāsu lokadhātuṣu gatvā sattvebhyo dharmaṃ deśayanti |	ཐམས་ཅད་ལས་ཀྱང་སངས་རྒྱས་ཀྱི་སྐུ་གསེར་གྱི་ཁ་དོག་ཅན་སྐྱེས་བུ་ཆེན་པོའི་མཚན་སུམ་ཅུ་རྩ་གཉིས་མངའ་བ་བྱེ་བ་སྟོང་ཕྲག་སུམ་ཅུ་རྩ་དྲུག་དྲུག་འབྱུང་སྟེ༏་དེ་དག་ཤར་ཕྱོགས་སུ་འཇིག་རྟེན་གྱི་ཁམས་གྲངས་མེད་དཔག་ཏུ་མེད་པ་དག་ཏུ་གཤེགས་ནས་སེམས་ཅན་རྣམས་ལ་ཆོས་སྟོན་ཏོ་༎ 
 evaṃ dakṣiṇapaścimottarāsu dikṣu adha ūrdhvamanuvidikṣu gatāvaraṇe loke 'prameyāsaṃkhyeyāṃllokadhātūn gatiṃ gattvā sattvebhyo dharmaṃ deśayanti start sukhv 17: (sukhv, vaidya 237)	དེ་བཞིན་དུ་ལྷོ་དང་། ནུབ་དང་། བྱང་ཕྱོགས་དང༏་འོག་དང་། སྟེང་དང་། ཕྱོགས་མཚམས་རྣམས་སུ་འཇིག་རྟེན་གྱི་ཁམས་ཐ་དད་པ་གྲངས་མེད་དཔག་ཏུ་མེད་པ་དག་ཏུ་གཤེགས་ནས་སེམས་ཅན་རྣམས་ལ་ཆོས་སྟོན་ཏོ་༎ ཀུན་དགའ་བོ་།
 tasmin khalu punarānanda buddhakṣetre sarvaśaḥ kālaparvatā na santi sarvato ratnaparvatāḥ sarvaśaḥ sumeravaḥ parvatarājāḥ sarvaśaścakravālā mahācakravālāḥ parvatarājāḥ |	སངས་རྒྱས་ཀྱི་ཞིང་དེ་ན་རི་ནག་པོ་རྣམས་ཡེ་མེད་དེ་། རི་ཐམས་ཅད་ཀྱང་རིན་པོ་ཆེའི་རི་ཤ་སྟག་གོ་། རིའི་རྒྱལ་པོ་རི་རབ་ཐམས་ཅད་དང་། ཁོར་ཡུག་དང་། རིའི་རྒྱལ་པོ་ཁོར་ཡུག་ཆེན་པོ་ཐམས་ཅད་དང་། མཚོ་ཆེན་པོ་རྣམས་མེད་དོ་༎
 samantācca tadbuddhakṣetraṃ samaṃ ramaṇīyaṃ pāṇitalajātaṃ nānāvidharatnamaṇicitabhūmibhāgam |	སངས་རྒྱས་ཀྱི་ཞིང་དེ་ནི་ཀུན་དུ་མཉམ་པ་། ཉམས་དགའ་བ་། ལག་མཐིལ་ལྟར་མཉམ་པ་། ས་ཕྱོགས་རིན་པོ་ཆེ་རྣམ་པ་སྣ་ཚོགས་ཀྱིས་སྤྲས་པའོ་༎
 evamukte āyuṣmānānando bhagavantametadavocat - ye ca punaste bhagavaṃścāturmahārājakāyikā devāḥ sumerupārśvanivāsinastrāyastriṃśā vā sumerumūrdhni	དེ་སྐད་ཅེས་བཀའ་སྩལ་པ་དང་། བཅོམ་ལྡན་འདས་ལ་ཚེ་དང་ལྡན་པ་ཀུན་དགའ་བོས་འདི་སྐད་ཅེས་གསོལ་ཏོ་༎ བཅོམ་ལྡན་འདས་། རྒྱལ་ཆེན་བཞིའི་རིས་ཀྱི་ལྷ་རི་རབ་ཀྱི་ངོས་ལ་གནས་པ་དང་། སུམ་ཅུ་རྩ་གསུམ་པའི་ལྷ་རི་རབ་ཀྱི་རྩེ་མོ་ལ་གནས་པ་དེ་དག་གང་ན་གནས་། བཅོམ་ལྡན་འདས་ཀྱིས་བཀའ་སྩལ་པ་། ཀུན་དགའ་བོ་། འདི་ཇི་༄༣༩༤བ་སྙམ་དུ་སེམས་།
 te kutra pratiṣṭhitāḥ? bhagavānāha - tatkiṃ manyase ānanda ye te iha sumeroḥ parvatarājasyopari yāmā devāstuṣitā vā nirmāṇaratayo vā paranirmitavaśavartino vā brahmakāyikā vā brahmapurohitā vā mahābrahmāṇo va yāvadakaniṣṭhā vā,	འདི་ན་རིའི་རྒྱལ་པོ་རི་རབ་ཀྱི་གོང་མ་འཐབ་བྲལ་གྱི་ལྷ་རྣམས་དང་། དགའ་ལྡན་དང་། འཕྲུལ་དགའ་དང་། གཞན་འཕྲུལ་དབང་བྱེད་དང་། ཚངས་རིས་དང་། ཚངས་པའི་མདུན་ན་འདོན་དང་། ཚངས་ཆེན་ནས་འོག་མིན་གྱི་བར་གྱི་ལྷ་རྣམས་གང་ན་གནས་།
 kutra te pratiṣṭhitā iti |	གསོལ་པ་།
 ānanda āha - acintyo bhagavan karmaṇāṃ vipākaḥ karmābhisaṃskāraḥ |	བཅོམ་ལྡན་འདས་། ལས་ཀྱི་རྣམ་པར་སྨིན་པ་དང་། ལས་མངོན་པར་འདུ་བགྱིད་པ་བསམ་གྱིས་མི་ཁྱབ་བོ་༎ བཅོམ་ལྡན་འདས་ཀྱིས་བཀའ་སྩལ་པ་།
 bhagavānāha - labdhastvayānanda ihācintyaḥ karmaṇāṃ vipākaḥ karmābhisaṃskāro na buddhānāṃ bhagavatāmacintyaṃ buddhādhiṣṭhānaṃ kṛtapuṇyānāṃ ca sattvānāmavaropitakuśalamūlānām | tavācintyā puṇyā vibhūtiḥ |	ཀུན་དགའ་བོ་། ལས་ཀྱི་རྣམ་པར་སྨིན་པ་དང་། ལས་མངོན་པར་འདུ་བྱེད་པ་བསམ་གྱིས་མི་ཁྱབ་པ་ནི་རྙེད་པར་རུང་གི་། སངས་རྒྱས་བཅོམ་ལྡན་འདས་རྣམས་ཀྱི་དགེ་བ་དང་། རྫུ་འཕྲུལ་དང་། བྱིན་གྱི་རླབས་བསམ་གྱིས་མི་ཁྱབ་པ་ནི་སུས་ཀྱང་མཐའ་མ་། ཚད་རྟོགས་པའམ་། བསམ་པར་མི་ནུས་ཏེ་། གཞན་དུ་ན་སངས་རྒྱས་ཀྱི་ཡུལ་བསམ་གྱིས་མི་ཁྱབ་པོ་ཞེས་རབ་ཏུ་འབྱེད་དོ་༎ དེ་ལྟར་སེམས་ཅན་བསོད་ནམས་བྱས་པ་དང་། དགེ་བའི་རྩ་བ་བསྐྱེད་པའི་བསོད་ནམས་དང་ཡེ་ཤེས་དང་། རྫུ་འཕྲུལ་དང་། འབྱོར་པ་བསམ་གྱིས་མི་ཁྱབ་པ་དག་སངས་རྒྱས་ཀྱི་ཞིང་དེར་འབྱུང་ངོ་༎ གསོལ་པ་། བཅོམ་ལྡན་འདས་།
 ānanda āha - na me 'tra bhagavan kācitkāṅkṣā vā vimatirvā vicikitsā vā |	བདག་ནི་དེ་ལ་དོགས་པའམ་། ཡིད་གཉིས་སམ་། ཐེ་ཚོམ་མ་མཆིས་ཏེ་།
 api tu khalvahamanāgatānāṃ sattvānāṃ kāṅkṣāvimativicikitsānirghātāya tathāgatametadarthaṃ paripṛcchāmi |	བདག་ནི་མ་འོངས་པའི་སེམས་ཅན་རྣམས་ཀྱི་དོགས་པ་དང་། ཡིད་གཉིས་དང་། ཐེ་ཚོམ་བསལ་བའི་སླད་དུ་དེ་བཞིན་གཤེགས་པ་ལ་དོན་འདི་ཡོངས་སུ་ཞུའོ་༎ བཅོམ་ལྡན་འདས་ཀྱིས་བཀའ་སྩལ་པ་།
 bhagavānāha - sādhu sādhvānanda,	ཀུན་དགའ་བོ་། ལེགས་༄༣༩༥ཨ་༌༎ སོ༏་༏ལེགས་སོ་༎
 evaṃ te karaṇīyam || sukhv_17 ||	དེ་ལྟ་བུ་ནི་ཁྱོད་ཀྱི་བྱ་བ་ཡིན་ནོ་༎ ཀུན་དགའ་བོ་།
 start sukhv 18: tasyāṃ khalvānanda sukhāvatyāṃ lokadhātau nānāprakārā nadyaḥ pracaranti |	འཇིག་རྟེན་གྱི་ཁམས་བདེ་བ་ཅན་དེ་ན་ཆུ་ཀླུང་རྣམ་པ་སྣ་ཚོགས་དག་འབབ་སྟེ་།
 santi tatra mahānadyo yojanavistārāḥ |	དེ་ན་ཆུ་ཀླུང་ཆེན་པོ་ཁ་ཚོན་དཔག་ཚད་ཙམ་དག་ཀྱང་ཡོད་དེ་།
 santi yāvadviṃśatitriṃśaccatvāṃriśatpañcāśadyojanavistārā yāvaddvādaśayojanāvedhāḥ |	དཔག་ཚད་བཅུ་དང་། ཉི་ཤུ་དང་། སུམ་ཅུ་དང་། བཞི་བཅུ་དང་། ལྔ་བཅུའི་བར་དང་། ཁ་ཚོན་དཔག་ཚད་བརྒྱ་སྟོང་གི་ཚད་ཙམ་དག་ཀྱང་ཡོད་དེ་། ཟབས་སུ་ནི་དཔག་ཚད་བཅུ་གཉིས་པ་དག་གོ་།
 sarvāśca tā nadyaḥ sukhavāhinyo nānāsurabhigandhavārivāhinyo nānāratnalulitapuṣpasaṃghātavāhinyo nānāmadhurasvaranirghoṣāḥ |	ཆུ་ཀླུང་དེ་དག་ཐམས་ཅད་ཀྱང་སྤོས་དྲི་རབ་ཏུ་ཞིམ་པ་སྣ་ཚོགས་ཀྱི་ཆུར་འབབ་ཅིང་རིན་པོ་ཆེའི་མེ་ཏོག་སིལ་མའི་ཚོགས་དག་འབབ་པ་དག་གོ་། སྒྲ་དབྱངས་སྙན་པ་ཐ་དད་པ་སྣ་ཚོགས་དང་ཡང་ལྡན་པ་དག་གོ་། ཀུན་དགའ་བོ་།
 tāsāṃ cānanda koṭiśatasahasrāṅgasaṃprayuktasya divyasaṃgītisamūrcchitasya tūryasya kuśalaiḥ saṃpravāditasya tāvanmanojñaghoṣo niścarati yathārūpastāsāṃ mahānadīnāṃ	ཆུ་ཀླུང་ཆེན་པོ་དེ་དག་ལས་ལྷའི་གླུ་དབྱངས་ཡན་ལག་བྱེ་བ་བརྒྱ་སྟོང་དང་ལྡན་པའི་སིལ་སྙན་དག་མཁས་པ་རྣམས་ཀྱིས་བྱས་པ་བས་ལྷག་པའི་སྒྲ་ཡིད་དུ་འོང་བ་འབྱུང་སྟེ་།
 nirghoṣo niścarati gambhīro 'jñeyo 'vijñeyo 'nelaḥ karṇasukho hṛdayaṃgamaḥ premaṇīyo valgurmanojño 'secanako 'pratikūlaḥ śravaṇāya, anityaṃ śāntamanātmeti sukhaśravanīyo yasteṣāṃ sattvānāṃ śrotrendriyābhāsamāgacchati |	ཆུ་ཀླུང་ཆེན་པོ་དེ་དག་ལས་རྣམ་པ་འདི་ལྟ་བུའི་སྒྲ་འབྱུང་བ་ནི་ཟབ་པ་དང་། ཀུན་དུ་ཤེས་པར་བྱ་བ་དང་། རྣམ་པར་ཤེས་པར་བྱ་བ་དང་། བརྫུན་པ་མ་ཡིན་པ་དང་། རྣ་བར་བདེ་བ་དང་། སྙིང་དུ་འོང་བ་དང་། དགའ་བར་བྱ་བ་དང་། སྙན་པ་དང་། ཡིད་དུ་འོང་བ་དང་། མཉན་པས་ཆོག་མི་ཤེས་པ་དང་། མཉན་པ་དང་མཐུན་པ་དང་། མི་རྟག་པ་དང་། ཞི་བ་དང་། བདག་མེད་ཅེས་བྱ་བ་དང་། མཉན་ན་བདེ་བ་སྟེ་། དེ་དག་སེམས་ཅན་དེ་དག་གི་རྣ་བའི་༄༣༩༥བ་དབང་པོ་ལ་གྲག་གོ་།
 tāsāṃ khalu punarānanda mahānadīnāmubhayatastīrāṇi nānāgandharatnavṛkṣaiḥ saṃtatāni,	ཀུན་དགའ་བོ་། ཆུ་ཀླུང་ཆེན་པོ་དེ་དག་གི་འགྲམ་གཉིས་ནི་རིན་པོ་ཆེའི་སྤོས་ཀྱི་ཤིང་ལྗོན་པ་དག་གིས་གང་སྟེ་། 
 yebhyo nānāśākhāpatrapuṣpamañjaryo 'valambante |	དེ་དག་ལ་ཡལ་ག་དང་། ལོ་མ་དང་། མེ་ཏོག་དང་། དོག་པ་སྣ་ཚོགས་འཕྱང་ངོ་༎
 tatra ye sattvāsteṣu nadītīreṣvākāṅkṣanti divyābhirāmaramaṇīyāṃ ratikrīḍāṃ cānubhavitum,	དེ་ན་སེམས་ཅན་གང་དག་ཆུ་ཀླུང་གི་འགྲམ་དེ་དག་ཏུ་ཟང་ཟིང་མེད་པའི་ལྷའི་དགའ་བ་དང་། རྩེ་བ་མྱོང་བར་འདོད་པ་དེ་དག་ཆུ་ཀླུང་དེ་དག་ཏུ་འཇུག་པའི་ཚེ་།
 teṣāṃ tatra nadīṣvavatīrṇānāmākāṅkṣatāṃ gulphamātraṃ vāri saṃtiṣṭhate |	འདོད་ན་ཆུ་ལོང་བུ་ནུབ་ཙམ་དུ་གནས་སོ་༎
 ākāṅkṣatāṃ jānumātraṃ kaṭimātraṃ kakṣamātram, ākāṅkṣatāṃ karṇamātraṃ vāri saṃtiṣṭhate,	འདོད་ན་ཆུ་པུས་མོ་ནུབ་ཙམ་དང་། འདོད་ན་རྐེད་པ་ནུབ་ཙམ་དང་། འདོད་ན་མཆན་ཁུང་ནུབ་ཙམ་དང་། འདོད་ན་མིད་པ་ནུབ་ཙམ་དུ་ཆུ་གནས་པར་འགྱུར་ཏེ་།
 divyāśca ratayaḥ prādurbhavanti |	ལྷའི་དགའ་བ་དག་ཀྱང་འབྱུང་ངོ་༎
 tatra ye sattvā ākāṅkṣanti śītaṃ vāri bhavatviti, teṣāṃ śītaṃ vāri bhavati |	དེར་སེམས་ཅན་གང་དག་ཆུ་གྲང་བར་གྱུར་ཅིག་སྙམ་དུ་འདོད་ན་ཡང་དེ་དག་ལ་བསིལ་བར་འགྱུར་རོ་༎ 
 ya ākāṅkṣanyuṣṇaṃ bhavatviti, teṣāmuṣṇaṃ bhavati |	གང་དག་དྲོ་བར་གྱུར་ཅིག་སྙམ་དུ་འདོད་ན་ཡང་དེ་དག་ལ་དྲོ་བར་འགྱུར་འགྱུར་རོ་༎ རོ་༎ 
 ya ākāṅkṣanti śītoṣṇaṃ bhavatviti, teṣāṃ śītoṣṇameva tadvāri bhavatyanusukham |	གང་དག་བསིལ་བ་དང་། དྲོ་བར་གྱུར་ཅིག་སྙམ་དུ་འདོད་ན་ཡང་དེ་དག་ལ་ཆུ་དེ་བསིལ་བ་དང་དྲོ་བར་འགྱུར་ཏེ་། 
 tāśca mahānadyo divyatamālapatrāgarukālānusāritagaroragasāracandanavaragandhavāsitavāriparipūrṇāḥ	བདེ་བར་འགྱུར་རོ་༎ ཆུ་ཀླུང་ཆེན་པོ་དེ་དག་ནི་ལྷའི་ཤིང་ཏ་མ་ལའི་ལོ་མ་དང་། ཨཨ་ཀ་རུ་དང་། དུས་ཀྱི་རྗེས་སུ་འབྲང་བ་དང་། རྒྱ་སྤོས་དང་། ཙན་དན་སྤྲུལ་གྱི་སྙིང་པོ་དང་། སྤོས་མཆོག་གིས་བསྒོས་པའི་ཆུས་ཡོངས་སུ་གང་སྟེ་འབབ་པ་།
 pravahanti divyotpalapadmakumudapuṇḍarīkasaugandhikādipuṣpasaṃchannā haṃsasārasakrauñcacakravākakāraṇḍavaśukaśārikakokilakuṇālakalaviṅkamayūrādimanojña	ལྷའི་མེ་ཏོག་ཨཽཏཔ་ལ་དང༏་པདམ་དང་། ཀུ་མུ་ཏ་དང་། པདམ་དཀར་པོ་དང་། དྲི་རབ་ཏུ་ཞིམ་པ་དག་གི་མེ་ཏོག་གིས་ཁེབས་པ་། ཁོལ་ཁོལ་དག་ན་བྱ་ངང་པ་དང་། གཞད་དང་། ཁྲུང་ཁྲུང་དང་། ངུར་པ་དང་། ཀ་༄༣༩༦ཨ་༌༎ རན་ད་བ་དང་། ནེ་ཙོ་དང་། རི་སྐེགས་དང་། ཁུ་བྱུག་དང་། ཀུ་ན་ལ་དང་། ཀ་ལ་པིང་ཀ་དང་། རྨ་བྱ་ལ་སོགས་པ་སྒྲ་ཡིད་དུ་འོང་བ་དང་ལྡན་པ་།
 - svarāstathāgatābhinirmitapakṣisaṃghaniṣevitapulinā dhārtarāṣṭropaśobhitāḥ sūpatīrthā	དེ་བཞིན་གཤེགས་པས་སྤྲུལ་པའི་བྱའི་ཚོགས་ཀྱིས་བསྟེན་པ་། ངང་པ་དང་། ངང་པའི་རྒྱལ་པོ་རྣམས་ཀྱིས་མཛེས་པར་བྱས་པ་དང་། འབབ་སྟེགས་བདེ་བ་། འདམ་རྫབ་མེད་པ་།
 vikardamāḥ suvarṇavālukāsaṃkirṇāḥ |	གསེར་གྱི་བྱེ་མ་བདལ་བ་དག་གོ་།
 tatra yadā te sattvā ākāṅkṣanti kīdṛśā (sukhv, vaidya 238) asmākamabhiprāyāḥ paripūryantāmiti, tadā teṣāṃ tādṛśā evābhiprāyā paripūryante | yaścāsāvānanda tasya vāriṇo nirghoṣaḥ sa manojño niścarati,	དེ་ན་གང་གི་ཚེ་སེམས་ཅན་དེ་དག་བདག་ཅག་གི་བསམ་པ་འདི་འདྲ་བ་ཡོངས་སུ་རྫོགས་པར་གྱུར་ཅིག་སྙམ་དུ་འདོད་པ་དེའི་ཚེ་དེ་དག་གི་བསམ་པ་དེ་ལྟ་བུ་དག་ཆོས་དང་ལྡན་པར་ཡོངས་སུ་རྫོགས་པར་འགྱུར་རོ་༎ ཀུན་དགའ་བོ་།
 yena sarvāvattadbuddhakṣetramabhijñāpyate | ye ca sattvā nadītīreṣu sthitā ākāṅkṣanti mā asmākamayaṃ śabdaḥ śrotrendriyāvabhāsamāgacchatviti, teṣāṃ na divyasyāpi śrotrendriyasyāvabhāsamāgacchati |	ཆུ་དེ་ལས་ཡིད་དུ་འོང་བའི་སྒྲ་འབྱུང་བ་གང་ཡིན་པ་དེས་སངས་རྒྱས་ཀྱི་ཞིང་དེར་ཐམས་ཅད་དང་ལྡན་པའི་འཁོར་ལ་གོ་བར་བྱེད་དོ་༎ དེ་ན་སེམས་ཅན་གང་དག་ཆུ་ངོགས་ན་འཁོད་པ་དག་སྒྲ་འདི་བདག་ཅག་གི་རྣ་བའི་དབང་པོ་ལ་གྲགས་པར་མ་གྱུར་ཅིག་ཅེས་འདོད་ན་དེ་དེ་དག་གི་ལྷའི་རྣ་བའི་དབང་པོ་ལ་གྲགས་པར་མི་འགྱུར་རོ་༎
 yaśca yathārūpaṃ śabdamākāṅkṣati śrotum, sa tathārūpameva manojñaṃ śabdaṃ śṛṇoti |	གང་སྒྲ་རྣམ་པ་ཇི་ལྟ་བུ་ཐོས་པར་འདོད་པ་དེ་རྣམ་པ་དེ་ལྟ་བུའི་སྒྲ་ཡིད་དུ་འོང་བ་ཐོས་སོ་༎ འདི་ལྟ་སྟེ་།
 tadyathā - buddhaśabdaṃ dharmaśabdaṃ saṃghaśabdaṃ pāramitāśabdaṃ bhūmiśabdaṃ balaśabdaṃ vaiśāradyaśabdamāveṇikabuddhadharmaśabdaṃ pratisaṃvicchabdaṃ śūnyatānimittāpraṇihitānabhisaṃskārājātānutpādābhāvanirodhaśabdaṃ śāntapraśāntopaśāntaṃ mahāmaitrīmahākarūṇāmahāmuditāmahopekṣāśabdamanutpattikadharmakṣāntyabhiṣekabhūmipratilambhaśabdam |	སངས་རྒྱས་ཀྱི་སྒྲ་དང་། ཆོས་ཀྱི་སྒྲ་དང་། དགེ་འདུན་གྱི་སྒྲ་དང་། ཕ་རོལ་ཏུ་ཕྱིན་པའི་སྒྲ་དང་། སའི་སྒྲ་དང་། སྟོབས་ཀྱི་སྒྲ་དང་། མི་འཇིགས་པའི་སྒྲ་དང་། སངས་རྒྱས་ཀྱི་ཆོས་མ་འདྲེས་པའི་སྒྲ་དང་། མངོན་པར་ཤེས་པའི་སྒྲ་དང་། ༄༣༩༦བ་སོ་སོ་ཡང་དག་པར་རིག་པའི་སྒྲ་དང་། སྟོང་པ་ཉིད་དང་། མཚན་མ་མེད་པ་དང་། སྨོན་པ་མེད་པ་དང་། མངོན་པར་འདུ་བྱ་བ་མེད་པ་དང་། མ་སྐྱེས་པ་དང་། མ་བྱུང་བ་དང་། དངོས་པོ་མེད་པ་དང་། འགག་པ་མེད་པའི་སྒྲ་དང་། ཞི་བ་དང་། རབ་ཏུ་ཞི་བ་དང་། ཉེ་བར་ཞི་བའི་སྒྲ་དང་། བྱམས་པ་ཆེན་པོ་དང་། སྙིང་རྗེ་ཆེན་པོ་དང་། དགའ་བ་ཆེན་པོ་དང་། བཏང་སྙོམས་ཆེན་པོའི་སྒྲ་དང་། མི་སྐྱེ་བའི་ཆོས་ལ་བཟོད་པ་དང་། དབང་བསྐུར་བའི་ས་རབ་ཏུ་ཐོབ་པའི་སྒྲ་དག་ཐོས་སོ་༎ དེས་སྒྲ་རྣམ་པ་དེ་ལྟ་བུ་ཐོས་ནས་དགའ་བ་དང་། མཆོག་ཏུ་དགའ་བ་རྒྱ་ཆེན་པོ་ཐོབ་བོ་༎
 śrutvā udāraprītiprāmodyaṃ pratilabhate vivekasahagataṃ virāgasahagataṃ śāntasahagataṃ nirodhasahagataṃ dharmasahagataṃ bodhipariniṣpattikuśalamūlasahagataṃ ca |	དབེན་པ་དང་ལྡན་པ་དང་། འདོད་ཆགས་དང་བྲལ་བ་དང་ལྡན་པ་དང་། ཞི་བ་དང་ལྡན་པ་དང་། འགོག་པ་དང་ལྡན་པ་དང་། ཆོས་དང་ལྡན་པ་དང་། བྱང་ཆུབ་ཡོངས་སུ་འགྲུབ་པའི་དགེ་བའི་རྩ་བ་དང་ལྡན་པའི་སྒྲ་འབྱུང་ངོ་༎ ཀུན་དགའ་བོ་།
 sarvaśaścānanda sukhāvatyāṃ lokadhātāvakuśalaśabdo nāsti,	འཇིག་རྟེན་གྱི་ཁམས་བདེ་བ་ཅན་ན་མི་དགེ་བའི་མིང་མེད་དོ་༎
 sarvaśo nīvaraṇaśabdo nāsti,	སྒྲིབ་པའི་སྒྲ་ཡང་ཡོང་མེད་དོ་༎
 sarvaśo 'pāyadurgativinipātaśabdo nāsti,	ངན་སོང་ངན་འགྲོ་རྣམ་པར་ལྟུང་བའི་སྒྲ་ཡང་ཡོང་མེད་དོ་༎
 sarvaśo duḥkhaśabdo nāsti |	སྡུག་བསྔལ་གྱི་སྒྲ་ཡང་ཡོང་མེད་དོ་༎ ཀུན་དགའ་བོ་།
 aduḥkhāsukhavedanāśabdo 'pi tāvadānanda tatra nāsti,	དེ་ན་སྡུག་བསྔལ་ཡང་མ་ཡིན་། བདེ་བ་ཡང་མ་ཡིན་པའི་ཚོར་བའི་སྒྲ་ཡང་མེད་ན་།
 kutaḥ punarduḥkhaśabdo bhaviṣyati?	སྡུག་བསྔལ་དང་། སྡུག་བསྔལ་གྱི་སྒྲ་ལྟ་ག་ལ་ཡོད་།
 tadanena ānanda paryāyeṇa sā lokadhātuḥ sukhāvatītyucyate saṃkṣiptena,	ཀུན་དགའ་བོ་། མདོར་བསྡུ་ན་རྣམ་གྲངས་འདིས་འཇིག་རྟེན་གྱི་ཁམས་དེ་བདེ་བ་ཅན་ཞེས་བྱ་སྟེ་། རྒྱས་པར་ནི་མ་ཡིན་ནོ་༎ ཀུན་དགའ་བོ་། རྒྱས་པར་བྱེད་༄༣༩༧ཨ་༌༎
 na punarvistareṇa kalpo 'pyānanda parikṣayaṃ gacchetsukhāvatyā lokadhātoḥ sukhakāraṇeṣu parikīrtyamāneṣu, na tveva śakyaṃ teṣāṃ sukhakāraṇānāṃ paryantamadhigantum || sukhv_18 || start sukhv 19:	ན༏་བསྐལ་པའམ་བསྐལ་པ་ལས་ལྷག་པར་ཟད་ཟད་དུ་འཇིག་རྟེན་གྱི་ཁམས་བདེ་བ་ཅན་གྱི་བདེ་བའི་རྒྱུ་ཡོངས་སུ་བརྗོད་ཀྱང་བདེ་བའི་རྒྱུ་དེ་དག་གི་མཐའ་རྟོགས་པར་མི་ནུས་སོ་༎ ཀུན་དགའ་བོ་།
 tasyāṃ khalu punarānanda sukhāvatyāṃ lokadhātau ye sattvāḥ pratyājātāḥ pratyājaniṣyante, sarve te evaṃrūpeṇa varṇena balena sthāmnā ārohapariṇāhena ādhipatyena puṇyasaṃcayena atiṣṇabhirvastrābharaṇodyānavimānakūṭāgāraparibhogairevaṃrūpaśabdagandharasasparśaparibhogaiḥ evaṃrūpaiśca sarvairapi bhogaparibhogaiḥ samanvāgatāḥ,	འཇིག་རྟེན་གྱི་ཁམས་བདེ་བ་ཅན་དེར་སེམས་ཅན་གང་དག་སྐྱེས་པ་དང་། སྐྱེ་བ་དང་། སྐྱེ་བར་འགྱུར་བ་དེ་དག་ཐམས་ཅད་ཀྱང་གཟུགས་དང་། ཁ་དོག་དང་། སྟོབས་དང་། མཐུ་དང་། ཆུ་ཞེང་དང་། དབང་དང་། བསོད་ནམས་བསགས་པ་དང་། མངོན་པར་ཤེས་པ་དག་དང་། གོས་དང་། རྒྱན་དང་། སྐྱེད་མོས་ཚལ་དང་། གཞལ་མེད་ཁང་དང་། ཁང་པ་བརྩེགས་པ་ཡོངས་སུ་སྤྱད་པ་རྣམ་པ་དེ་ལྟ་བུ་དག་དང་། གཟུགས་དང་། སྒྲ་དང་། དྲི་དང་། རོ་དང་། རེག་བྱ་ཡོངས་སུ་སྤྱད་པ་རྣམ་པ་དེ་ལྟ་བུ་དག་དང་། ལོངས་སྤྱོད་དང་། ཡོངས་སུ་སྤྱད་པ་རྣམ་པ་དེ་ལྟ་བུ་ཐམས་ཅད་དང་ལྡན་ཏེ་།
 tadyathāpi nāma devāḥ paranirmitavaśavartinaḥ |	དཔེར་ན་། གཞན་འཕྲུལ་དབང་བྱེད་ཀྱི་ལྷ་རྣམས་དང་འདྲའོ་༎ ཀུན་དགའ་བོ་།
 na khalu punarānanda sukhāvatyāṃ lokadhātau sattvā audārikayūṣaphāṇitākārāhāramāharanti | api tu khalu punaryathārūpamevāharamākāṅkṣanti,	འཇིག་རྟེན་གྱི་ཁམས་བདེ་བ་ཅན་གྱི་སེམས་ཅན་དག་ཁམ་གྱི་ཟས་ཟ་བ་རགས་པའི་ཁ་ཟས་མི་ཟའི་། 
 tathārūpamāhṛtameva saṃjānanti,	ཁ་ཟས་རྣམ་པ་ཇི་ལྟ་བུ་འདོད་པ་རྣམ་པ་དེ་ལྟ་བུ་འབྱོར་པ་ཉིད་མི་ཟའི་། དུ་ཤེས་ཏེ་། 
 prīṇitakāyāśca bhavanti prīṇitamānāḥ |	ལུས་ཚིམ་པར་འགྱུར་། གཟུགས་ཚིམ་པར་འགྱུར་རོ་༎
 na teṣāṃ bhūyaḥ kāye prakṣepaḥ karaṇīyaḥ |	ཞེས་དེ་དག་ཡང་ལུས་ལ་འཇུག་པར་མི་བྱེད་དོ་༎
 te prīṇitakāyāstathārūpāṇi gandhajātānyākāṅkṣanti - īddaśaireva gandhajātairdivyaistadbuddhakṣetraṃ sarvameva nirdhūpitaṃ bhavati |	དེ་དག་ལུས་ཚིམ་ནས་སྤོས་ཀྱི་རྣམ་པ་ཇི་ལྟ་བུ་འདོད་པ་དེ་ལྟ་བུའི་ལྷའི་སྤོས་ཀྱི་རྣམ་པ་དག་གིས་སངས་རྒྱས་ཀྱི་༄༣༩༧བ་ཞིང་ཐམས་ཅད་བདུགས་པར་འགྱུར་རོ་༎
 tatra yastaṃ gandhamāghrātukāmo bhavati,	དེ་ན་གང་དྲི་དེ་ལ་སྣོམ་པར་མི་འདོད་པ་དེ་ལ་སྤོས་དྲིའི་འདུ་ཤེས་དང་། བསྒོས་པ་ཙམ་ཡང་འབྱུང་བར་མི་འགྱུར་རོ་༎
 tasya sarvaśo gandharvarājño vāsanā na samudācarati | evaṃ ye yathārūpāṇi gandhamālyavilepanacūrṇacīvaracchatradhvajapatākātūryāṇyākāṅkṣanti, teṣāṃ tathārūpaiśca taiḥ sarvaṃ tadbuddhakṣetraṃ parisphuṭaṃ bhavati |	དེ་ལྟར་གང་དག་སྤོས་དང༏་ཕྲེང་བ་དང་། བྱུག་པ་དང་། ཕྱེ་མ་དང་། གདུགས་དང་། རྒྱལ་མཚན་དང་། བ་དན་དང་། སིལ་སྙན་རྣམ་པ་ཇི་ལྟ་བུ་དག་འདོད་པ་དེ་དག་གི་རྣམ་པ་དེ་ལྟ་བུ་དེ་དག་གིས་སངས་རྒྱས་ཀྱི་ཞིང་དེ་ཐམས་ཅད་ཡོངས་སུ་ཁྱབ་པར་འགྱུར་རོ་༎
 cīvarāṇyākāṅkṣanti nānāvarṇānyanekaśatasahasravarṇāni, teṣāṃ tādṛśaireva cīvararatnaiḥ sarvaṃ tadbuddhakṣetraṃ parisphuṭaṃ bhavati,	དེ་དག་གོས་ཁ་དོག་ཐ་དད་པ་། ཁ་དོག་བརྒྱ་སྟོང་དུ་མ་ཅི་འདྲ་བ་འདོད་པ་དེ་ལྟ་བུའི་གོས་རིན་པོ་ཆེ་དག་གིས་སངས་རྒྱས་ཀྱི་ཞིང་དེ་ཐམས་ཅད་ཡོངས་སུ་ཁྱབ་པར་འགྱུར་ཞིང་ལུས་ལ་བགོས་པར་བདག་ཉིད་ཀྱིས་ཤེས་སོ་༎ 
 prāvṛtameva cātmānaṃ saṃjānanti | te yathārūpāṇyābharaṇānyākāṅkṣanti,	དེ་དག་འདི་ལྟ་སྟེ་། མགོ་བོའི་རྒྱན་ནམ་།
 tadyathā - śīrṣābharaṇāni vā karṇābharaṇāni vā grīvābharaṇāni vā hastapādābharaṇāni	རྣ་བའི་རྒྱན་ནམ་། མགུལ་པ་དང་། ལག་པ་དང༏་རྐང་པའི་རྒྱན་འདི་ལྟ་སྟེ་།
 vā yadidaṃ mukuṭāni kuṇḍalāni kaṭakakeyūrāṇi vatsahārā rūcakahārā karṇikā mudrikāḥ svarṇasūtrāṇi mekhalāḥ svarṇasūtāṇi jālāni muktājālāni sarvaratnajālāni svarṇaratnakiṅkiṇījālāni, tathārūpairābharaṇairanekaratnaśatasahasrapratyuptaiḥ sphuṭaṃ (sukhv, vaidya 239)	ཅོད་པན་དང་། རྣ་ཆ་དང་། གདུ་བུ་དང་། དཔུང་རྒྱན་དང་། དོ་ཤལ་དང་། སེ་མོ་དོ་དང་། རྣ་རྒྱན་དང་། སོར་གདུབ་དང་། གསེར་གྱི་ཙོང་ཙོང་དང་། སྐ་རགས་དང་། གསེར་གྱི་དྲ་བ་དང་། མུ་ཏིག་གི་དྲ་བ་དང་། རིན་པོ་ཆེ་ཐམས་ཅད་ཀྱི་དྲིལ་བུ་ག-ཡེར་ཁའི་དྲ་བ་དང་། རྒྱན་ཇི་ལྟ་བུ་འདོད་པ་རྣམ་པ་དེ་ལྟ་བུའི་རྒྱན་རིན་པོ་ཆེ་བརྒྱ་སྟོང་དུ་མས་སྤྲས་པ་འདི་ལྟ་སྟེ་།
 tadbuddhakṣetraṃ paśyanti yadidamābharaṇavṛkṣāvasaktaiḥ |	རིན་པོ་ཆེའི་ཤིང་ལྗོན་པ་ལ་འཕྱང་བས་སངས་རྒྱས་ཀྱི་ཞིང་དེ་གང་བར་མཐོང་སྟེ་།
 taiścābharaṇairalaṃkṛtamātmānaṃ saṃjānanti |	རྒྱན་དེ་དག་གིས་བདག་བརྒྱན་པར་ཡང་ཤེས་སོ་༎
 te yādṛśaṃ vimānamākāṅkṣanti yadvarṇaliṅgasaṃsthānaṃ yāvadārohapariṇāhaṃ nānāratnamayaniryūhaśatasahasrasamalaṃkṛtaṃ nānādivyapuṣpasaṃstīrṇaṃ	དེ་དག་གང་ཁ་༄༣༩༨ཨ་༌༎ དོག་དང་། རྟགས་དང་། དབྱིབས་དང་། ཆུ་ཞེང་གི་བར་དང་། རིན་པོ་ཆེ་སྣ་ཚོགས་ཀྱི་བ་གམ་བརྒྱ་སྟོང་གིས་བརྒྱན་པ་རིན་པོ་ཆེའི་ཁྲི་ལྷའི་རས་བཅོས་བུ་སྣ་ཚོགས་བཏིང་བ་།
 tādṛśameva vimānaṃ teṣāṃ purataḥ prādurbhavati |	སྔས་ཁྲ་བོ་བཞག་པ་དང་ལྡན་པའི་གཞལ་མེད་ཁང་ཇི་ལྟ་བུ་འདོད་པ་དེ་ལྟ་བུའི་གཞལ་མེད་ཁང་དེ་དག་དེ་དག་གི་མདུན་དུ་འབྱུང་སྟེ་། 
 teṣu manonirvṛtteṣu vimāneṣu saptasaptāsparasahasraparivṛtāḥ puraskṛtā viharanti krīḍanti ramante paricārayanti || sukhv_19 || start sukhv 20:	དེ་དག་རིན་པོ་ཆེའི་གཞལ་མེད་ཁང་གྲུབ་པ་དེ་དག་གི་ནང་ན་ལྷའི་བུ་མོ་བདུན་སྟོང་བདུན་སྟོང་གིས་ཡོངས་སུ་བསྐོར་ཞིང་མདུན་གྱིས་བལྟས་ནས་འཁོད་དེ་། རྩེ་ཞིང་དགའ་ལ་དགའ་མགུར་སྤྱོད་དོ་༎
 na ca tatra lokadhātau devānāṃ vā manuṣyāṇāṃ vā nānātvamasti anyatra saṃvṛtivyavahāreṇa devamanuṣyāviti saṃkhyāṃ gacchanti |	འཇིག་རྟེན་གྱི་ཁམས་དེ་ན་ལྷ་དང་མི་རྣམས་ཐ་དད་པ་མེད་དེ་། གཞན་དུ་ན་ཀུན་རྫོབ་ཀྱི་ཐ་སྙད་ཀྱིས་ལྷ་དང་མི་ཞེས་བྱ་བའི་གྲངས་སུ་འགྲོ་བ་ནི་མ་གཏོགས་སོ་༎ ཀུན་དགའ་བོ་། འདི་ལྟ་སྟེ་།
 tadyathā ānanda rājñaścakravartinaḥ purato manuṣyahīno manuṣyapretako na bhāsate na tapate na virocate,	དཔེར་ན་། འཁོར་ལོའི་བསྒྱུར་བའི་རྒྱལ་པོའི་མདུན་ན་མི་མ་རབས་དང་། མི་ཟ་མ་ནི་ལམ་མེ་མ་ཡིན་། ལྷན་ནེ་མ་ཡིན་།
 na ca bhavati viśārado na prabhāśvaraḥ,	ལྷང་ངེ་མ་ཡིན་ཞིང་མི་འཇིགས་པ་མ་ཡིན་ལ་འོད་གསལ་བ་མ་ཡིན་ནོ་༎
 evameva devānāṃ paranirmitavaśavartināṃ purataḥ śakro devānāmindro na bhāsate na	དེ་བཞིན་དུ་གཞན་འཕྲུལ་དབང་བྱེད་ཀྱི་ལྷ་རྣམས་ཀྱི་མདུན་ན་ལྷའི་དབང་པོ་བརྒྱ་བྱིན་ཡང་འདི་ལྟ་སྟེ་། 
 tapate na virocate yadidamudyānavimānavastrābharaṇairādhipatyena ṛddhyā vā prātihāryeṇa	སྐྱེད་མོས་ཚལ་དང་། གཞལ་མེད་ཁང་དང་། གོས་དང་། རྒྱན་དང་། དབུང་དང་། རྫུ་འཕྲུལ་དང་། ཆོ་འཕྲུལ་དང་། དབང་ཕྱུག་གིས་ལམ་མེ་མ་ཡིན་།
 vā aiśvaryeṇa vā ānanda,	ལྷན་ནེ་མ་ཡིན་། ལྷང་ངེ་མ་ཡིན་ཏེ་།
 sa khalu dharmābhisamayena dharmaparibhogeṇa vā |	ཆོས་མངོན་པར་རྟོགས་པ་དང་། ཆོས་ལ་ཡོངས་སུ་སྤྱོད་པ་ནི་མ་གཏོགས་སོ་༎ ༄༣༩༨བ་ཀུན་དགའ་བོ་།
 tatra ānanda yathā devāḥ parinirmitavaśavartinaḥ, evaṃ sukhāvatyāṃ lokadhātau manuṣyā draṣṭavyāḥ || sukhv_20 || start sukhv 21:	དེ་ལ་གཞན་འཕྲུལ་དབང་བྱེད་ཀྱི་ལྷ་རྣམས་ཅི་འདྲ་བ་དེ་འདྲ་བར་བདེ་བ་ཅན་གྱི་འཇིག་རྟེན་གྱི་ཁམས་ཀྱི་མི་རྣམས་བལྟ་བར་བྱའོ་༎
 tasyāṃ khalu punarānanda sukhāvatyāṃ lokadhātau pūrvāhṇakālasamaye pratyupasthite samantāccaturdiśamākulāḥ samākulā vāyavo vānti |	ཀུན་དགའ་བོ་། འཇིག་རྟེན་གྱི་ཁམས་བདེ་བ་ཅན་དེ་ན་སྔ་དྲོའི་དུས་ཉེ་བར་གནས་པའི་ཚེ་ཕྱོགས་བཞི་ཀུན་ནས་འཁྲུགས་ཤིང་ཀུན་དུ་འཁྲུགས་པའི་རླུང་ལྡང་སྟེ་། དེ་དག་གིས་རིན་པོ་ཆེའི་ཤིང་ལྗོན་པ་བཀྲ་བ་། བལྟ་ན་སྡུག་པ་།
 teṣāṃ ratnavṛkṣāṇāṃ citrān darśanīyān nānāvarṇānanekavṛntān nānāsurabhidivyagandhaparivāsitān	ཁ་དོག་ཐ་དད་པ་། ཁ་དོག་དུ་མ་ཡོད་པ་། ལྷའི་སྤོས་དྲི་རབ་ཏུ་ཞིམ་པ་སྣ་ཚོགས་ཀྱིས་བསྒོ་ས་པ་དེ་དག་བསྐྱོད་། ཀུན་དུ་བསྐྱོད་། བསྒུལ་།
 kṣobhayanti saṃkṣobhayanti īrayanti samīrayanti yato bahūni puṣpaśatāni tasyāṃ ratnamayyāṃ mahāpṛthivyāṃ prapatanti manojñagandhāni darśanīyāni |	ཀུན་དུ་བསྒུལ་ནས་དེ་དག་ལ་ས་མེ་ཏོག་རྣམ་པ་མང་པོ་ཡིད་དུ་འོང་བའི་བསུང་ཅན་བལྟ་ན་སྡུག་པ་དག་རིན་པོ་ཆེའི་ས་ཆེན་པོ་དེ་ལ་འབྲུལ་ཏེ་།
 taiśca puṣpaistadbuddhakṣetraṃ samantātsaptapauruṣaṃ saṃskṛtarūpaṃ bhavati |	མེ་ཏོག་དེ་དག་གིས་སངས་རྒྱས་ཀྱི་ཞིང་དེ་ཀུན་དུ་མི་འགྲེང་བ་བདུན་སྲིད་དུ་བཀྲམ་པར་འགྱུར་རོ་༎ 
 tadyathāpi nāma puruṣaḥ kuśalaḥ pṛthivyāṃ puṣpasaṃstaraṃ saṃstṛṇuyāt,	འདི་ལྟ་སྟེ༏་དཔེར་ན་།
 ubhābhyāṃ pāṇibhyāṃ samaṃ racayetsucitraṃ darśanīyam,	སྐྱེས་བུ་ས་ལ་མེ་ཏོག་འགྲེམས་མཁས་པ་ཞིག་གིས་ལག་པ་གཉིས་ཀས་བཀྲམ་སྟེ་མཉམ་པར་བཀོད་ན་ཤིན་ཏུ་བཀྲ་ཞིང་བལྟ་ན་སྡུག་གོ་།
 evameva tadbuddhakṣetraṃ taiḥ puṣpairnānāgandhavarṇaiḥ samantātsaptapauruṣaṃ sphuṭaṃ bhavati |	དེ་བཞིན་དུ་མེ་ཏོག་བསུང་དང་། ཁ་དོག་ཐ་དད་པ་དང་ལྡན་པ་དེ་དག་གིས་སངས་རྒྱས་ཀྱི་ཞིང་དེ་ཀུན་དུ་མི་འགྲེང་བདུན་ཙམ་དུ་ཁྱབ་པར་འགྱུར་རོ་༎ མེ་ཏོག་གི་རྣམ་པ་དེ་དག་ནི་འཇམ་པ་སྟེ་།
 tāni ca puṣpajātāni mṛdūni kācilindikasukhasaṃsparśāni aupamyamātreṇa, yāni nikṣipte pāde caturaṅgulamavanamanti, utkṣipte pāde caturaṅgulamevonnamanti |	དཔེ་ཙམ་དུ་ན་གོས་ཀ་ཙ་ལིན་ད་ལྟར་རེག་ན་བདེ་བའོ༏་༏དེ་དག་ནི་རྐང་པ་འཇོག་པ་ན་སོར་བཞི་ཙམ་གྱིས་དམའ་བར་འགྱུར་ཞིང་། རྐང་པ་འདེགས་པ་ན་སོར་བཞི་ཙམ་གྱིས་མཐོ་བར་འགྱུར་རོ་༎
 nirgate punaḥ pūrvāhṇakālasamaye tāni puṣpāṇi niravaśeṣamantardhīyante |	སྔ་དྲོའི་དུས་འདས་ནས་མེ་ཏོག་དེ་དག་ཀྱང་མ་༄༣༩༩ཨ་༌༎ ལུས་པར་མེད་པར་འགྱུར་ཏེ་།
 athe tadbuddhakṣetraṃ viviktaṃ ramyaṃ śubhaṃ bhavatyaparikliṣṭaiḥ pūrvapuṣpaiḥ |	དེའི་འོག་ཏུ་སངས་རྒྱས་ཀྱི་ཞིང་བདེ་བ་དང་། ཉམས་དགའ་བ་དང་། དག་པར་འགྱུར་ཞིང་མེ་ཏོག་སྔ་མ་རྣམས་ཀྱིས་རྙོགས་པ་མེད་པར་འགྱུར་རོ་༎
 tataḥ punarapi samantāccaturdiśaṃ vāyavo vānti,	དེ་ནས་ཡང་ཕྱོགས་བཞི་ཀུན་ནས་རླུང་ལངས་ཏེ་།
 ye pūrvavadabhinavāni puṣpāṇyabhiprakiranti | yathā pūrvāhṇe,	གང་སྔོན་མ་བྱུང་བའི་མེ་ཏོག་སར་པ་དག་མངོན་པར་འཐོར་རོ་༎
 evaṃ madhyāhnakālasamaye saṃdhyāyāṃ rātryāḥ prathame yāme madhyame yāme paścime yāme |	སྔ་དྲོ་ཇི་ལྟ་བར་ཉི་མའི་གུང་དང་། ཕྱི་དྲོའི་དུས་ཀྱི་ཚེ་དང་། མཚན་མོ་ཡང་སྲོད་དང་། ནམ་གྱི་གུང་དང་། ཐོ་རངས་ཀྱང་དེ་བཞིན་ནོ་༎
 taiśca vātairvāyadbhirnānāgandhaparivāsitaiste sattvāḥ spṛṣṭāḥ santaḥ evaṃ sukhasamarpitā bhavanti tadyathāpi nāma nirodhasamāpanno bhikṣuḥ start sukhv 22:	སྤོས་དང་། དྲི་སྣ་ཚོགས་ཀྱིས་བསྒོས་པའི་རླུང་དེ་དག་ལངས་ནས་སེམས་ཅན་དེ་དག་ལ་རེག་ན་འདི་ལྟ་སྟེ་། དཔེར་ན་། དགེ་སློང་འགོག་པ་ལ་སྙོམས་པར་ཞུགས་ལྟ་བུའི་བདེ་བ་དང་ལྡན་པར་འགྱུར་རོ་༎
 tasmiścānanda buddhakṣetre sarvaśo 'gnisūryacandragrahanakṣatratārārūpāṇāṃ tamondhakārasya nāmadheyaprajñapraptirapi nāsti |	ཀུན་དགའ་བོ་། སངས་རྒྱས་ཀྱི་ཞིང་དེ་ན་དེ་བཞིན་གཤེགས་པས་བསྙད་པ་མ་གཏོགས་པར་མེ་དང་། ཉི་མ་དང་། ཟླ་བ་དང་། གཟའ་དང་། རྒྱུ་སྐར་དང་། སྐར་མའི་གཟུགས་དང་། མུན་པ་མུན་ནག་གི་མིང་དུ་གདགས་པ་ཡོང་མེད་དོ་༎
 sarvaśo rātriṃdivaṃ prajñaptirapi nāsti anyatra tathāgatavyavahārāt,	ཉིན་མོ་དང་མཚན་མོར་གདགས་པ་ཡང་ཡོང་མེད་དོ་༎
 sarvaśaścārāmaparigrahasaṃjñā nāsti || sukhv_22 ||	ཁྱིམ་ཡོངས་སུ་འཛིན་པའི་འདུ་ཤེས་ཀྱང་ཡོང་མེད་དོ་༎ ཀུན་དགའ་བོ་།
 start sukhv 23: tasyāṃ khalu punarānanda sukhāvatyāṃ lokadhātau kāle divyagandhodakameghā abhipravarṣayanti divyāni sarvavarṇikāni kusumāni,	འཇིག་རྟེན་གྱི་ཁམས་བདེ་བ་ཅན་དེ་ན་དུས་དུས་སུ་ལྷའི་སྤོས་ཆུའི་སྤྲིན་གྱི་ཆར་མངོན་པར་འབབ་བོ་༎ 
 divyāni saptaratnāni, divyaṃ candanacūrṇam, divyāśchatradhvajapatākā abhipravarṣayanti | divyāni sarvavarṇikāni kusumāni,	ལྷའི་མེ་ཏོག་ཁ་དོག་ཐམས་ཅད་དང་ལྡན་པ་དག་དང་། ལྷའི་རིན་པོ་ཆེ་སྣ་བདུན་དང་། ལྷའི་ཙན་དན་གྱི་ཕྱེ་མ་དང་། ལྷའི་གདུགས་དང་། རྒྱལ་མཚན་དང་། བ་༄༣༩༩བ་དན་གྱི་ཆར་མངོན་པར་འབབ་བོ་༎
 divyāni (sukhv, vaidya 240) vitānāni dhriyante,	ལྷའི་བླ་རེ་དག་ཀྱང་འཛིན་ཏོ་༎
 divyāni cchatraratnāni sarvābharaṇānyākāśe dhriyante,	ལྷའི་རིན་པོ་ཆེའི་གདུགས་རྔ་མའི་བསིལ་ཡབ་དང་བཅས་པ་དག་ཀྱང་ནམ་མཁའ་ལ་འཛིན་ཏོ་༎
 divyāni vādyāni pravādyante, divyāścāpsaraso nṛtyanti || sukhv_23 || start sukhv 24:	ལྷའི་རོལ་མོའི་དབྱངས་སྒྲ་དག་ཀྱང་སྒྲོགས་ཤིང་ལྷའི་བུ་མོ་དག་ཀྱང་གར་བྱེད་དོ་༎ ཀུན་དགའ་བོ་།
 tasmin khalu punarānanda buddhakṣetre ye sattvā upapannā utpadyante utpasyante, sarve te niyatāḥ samyaktve yāvannirvāṇam |	སངས་རྒྱས་ཀྱི་ཞིང་དེར་སེམས་ཅན་གང་དག་སྐྱེས་པ་དང་། སྐྱེ་བ་དང་། སྐྱེ་བར་འགྱུར་བ་དེ་དག་ཐམས་ཅད་མྱ་ངན་ལས་འདས་ཀྱི་བར་དུ་ཡང་དག་པ་ཉིད་དུ་ངེས་པར་འགྱུར་རོ་༎
 tatkasya hetoḥ?	དེ་ཅིའི་ཕྱིར་ཞེ་ན་། དེ་ནི་འདི་ལྟ་སྟེ་།
 nāsti tatra dvayo rāśyorvyavasthānaṃ prajñaptirvā yadidamaniyatasya vā mithyātvaniyatasya vā |	མ་ངེས་པ་དང་། ལོག་པ་ཉིད་དུ་ངེས་པའི་ཕུང་པོ་གཉིས་རྣམ་པར་བཞག་པའམ་། གདགས་པ་མེད་པའི་ཕྱིར་རོ་༎
 tadanenāpyānanda paryāyeṇa sā lokadhātuḥ sukhāvatītyucyate saṃkṣiptena,	ཀུན་དགའ་བོ་། མདོར་བསྡུ་ན་རྣམ་གྲངས་འདིས་འཇིག་རྟེན་གྱི་ཁམས་དེ་བདེ་བ་ཅན་ཞེས་བྱ་སྟེ་རྒྱས་པར་ནི་མ་ཡིན་ནོ་༎ ཀུན་དགའ་བོ་།
 na punarvistareṇa | kalpo 'pyānanda parikṣīyeta sukhāvatyāṃ lokadhātau sukhakāraṇeṣu parikīrtyamāneṣu, na ca teṣāṃ sukhakāraṇānāṃ śakyaṃ paryantamadhigantum || sukhv_24 ||	རྒྱས་པར་བསྟན་ན་ནི་བསྐལ་པ་ཟད་ཟད་དུ་འཇིག་རྟེན་གྱི་ཁམས་བདེ་བ་ཅན་གྱི་བདེ་བའི་རྒྱུ་རྣམས་ཡོངས་སུ་བརྗོད་ཀྱང་བདེ་བའི་རྒྱུ་དེ་དག་གི་མཐའ་རྟོགས་པར་མི་ནུས་སོ་༎
 start sukhv 25: atha khalu bhagavāṃstasyāṃ velāyāmimā gāthā abhāṣata -	དེ་ནས་དེའི་ཚེ་བཅོམ་ལྡན་འདས་ཀྱིས་ཚིགས་སུ་བཅད་པ་འདི་དག་བཀའ་སྩལ་ཏོ་༎ སེམས་ཅན་ཐམས་ཅད་བདེ་བར་གཤེགས་གྱུར་ལ་༎
 sarve 'pi sattvāḥ sukhitā bhaveyurviśuddhajñānāḥ paramārthakovidāḥ |	དམ་པའི་དོན་མཁས་ཡེ་ཤེས་རྣམ་དག་སྟེ་།
 te kalpakoṭīmatha vāpi cottariṃ sukhāvatīvarṇa prakāśayeyuḥ || sukhv_vs_23 ||	དེ་དག་བསྐལ་པའམ་འོན་ཏེ་ལྷག་པར་ནི་༎ བདེ་བ་ཅན་གྱི་བསྔགས་པ་རབ་བརྗོད་ཀྱང་༎ བསྔགས་པའི་ཕྲེང་བ་རབ་ཏུ་བརྗོད་པ་ན་༎
 kṣaye kalpakoṭī vajre surāśca sukhāvatīye na ca varṇasāruḥ | kṣayaṃ na gacchetpratibhā ca teṣāṃ prakāśayantāna tu varṇa nānāṃ || sukhv_vs_24 ||	བསྐལ་པ་བྱེ་བ་དེ་དག་ཟད་འགྱུར་གྱི་༎ བདེ་བ་ཅན་གྱི་བསྔགས་པ་མཐར་མི་ཕྱིན་༎ དེ་དག་སྤོབས་པ་༄༤༠༠ཨ་༌༎ པའང་ཟད་པར་འགྱུར་མ་ཡིན་༎
 ye lokadhātū paramāṇusādṛśāṃśchidyeya bhidyeya rajaśca kuryāt |	གང་གིས་ཕྲ་རབ་རྡུལ་སྙེད་འཇིག་རྟེན་ཁམས་༎ བཤིག་ཅིང་བཏགས་ཏེ་རྡུལ་དུ་བྱས་གྱུར་པ་༎
 ato bahū uttari lokadhātu pūreta dānaṃ ratanāhi dadyāt || sukhv_vs_25 ||	དེ་བས་མང་བའི་འཇིག་རྟེན་ཁམས་ཀྱི་རྣམས་༎ རིན་ཆེན་བཀང་སྟེ་སྦྱིན་པ་བྱིན་པ་ནི་༎ གང་གིས་དཔག་ཏུ་མེད་པའི་འོད་མཚན་དང་༎ བདེ་བ་ཅན་གྱི་ཡོན་ཏན་ཁྱད་འཕགས་རྣམས་༎ ཐོས་ནས་དགའ་སྟེ་ཐལ་མོ་སྦྱོར་བྱེད་པ་༎
 naitā kalāpi upamāpi tasya puṇyasya bhontī pṛthulokadhātavaḥ |	བསོད་ནམས་འདི་ཡི་ཆར་ཡང་འགྱུར་མ་ཡིན་༎ དེ་ལྟ་བས་ན་དེ་བཞིན་གཤེགས་པ་དེའི་༎ ཡོན་ཏན་ཐོས་ནས་མགུ་དང་དད་སྐྱེས་ལ་༎ བདེ་བ་ཅན་གྱི་འཇིག་རྟེན་ཁམས་མཆོག་ཏུ༏་༏འགྲོ་བར་བྱ་ཕྱིར་མོས་པ་དྲག་པོ་བསྐྱེད་༎
 ye lokadhātūya sukhāvatīye śrutvaiva nāmaṃ bhavatīha puṇyam || sukhv_vs_26 ||	གང་གིས་བདེ་བ་ཅན་གྱི་འཇིག་རྟེན་གྱི་༎ མིང་ཐོས་པ་ཡི་བསོད་ནམས་དེ་ལ་ནི་༎ ཞིང་མཆོག་ཐ་གྲུ་ཆེན་པོ་དེ་དག་ཀུན་༎ ཆ་དང་དཔེར་ཡང་འགྱུར་བ་མ་ཡིན་ནོ་༎
 tato bahū puṇya bhaveta teṣāṃ ye śraddhate jinavacanaṃ saprajñāḥ |	གང་དག་རྒྱལ་བའི་བཀའ་དང་ཤེས་རབ་ཅན་༎ དེ་དག་དེ་བས་བསོད་ནམས་མང་དུ་འགྱུར་༎
 śraddhā hi mūlaṃ jagatasya prāptaye tasmāddhi śrutvā vicitiṃ vinodayet || sukhv_vs_27 || iti ||	དོན་དམ་ཐོབ་ཕྱིར་དད་པ་རྩ་བ་སྟེ་༎ དེ་ལྟ་བས་ན་ཐོས་ནས་ཡིད་གཉིས་སོལ་༎
 evamaprameyaguṇavarṇā ānanda sukhāvatī lokadhātuḥ || sukhv_25 || start sukhv 26:	ཀུན་དགའ་བོ་། འཇིག་རྟེན་གྱི་ཁམས་བདེ་བ་ཅན་གྱི་ཡོན་ཏན་དང་བསྔགས་པ་དེ་ལྟར་དཔག་ཏུ་མེད་དོ་༎ ཀུན་དགའ་བོ་།
 tasya khalu punarānanda bhagavato 'mitābhasya tathāgatasya daśasu dikṣu ekaikasyāṃ diśi gaṅgānadīvālukāsameṣu buddhakṣetreṣu gaṅgānadīvālukāsamā buddhā bhagavanto nāmadheyaṃ (sukhv, vaidya 241) parikīrtayante,	ཕྱོགས་བཅུའི་ཕྱོགས་རེ་རེ་ཡང་སངས་རྒྱས་ཀྱི་ཞིང་གངགའའི་ཀླུང་གི་བྱེ་མ་སྙེད་དག་ན་སངས་རྒྱས་བཅོམ་ལྡན་འདས་གངགའའི་ཀླུང་གི་བྱེ་མ་སྙེད་དག་བཅོམ་ལྡན་འདས་དེ་བཞིན་གཤེགས་པ་འོད་དཔག་མེད་དེའི་མཚན་ཡོངས་སུ་བརྗོད་༄༤༠༠བ་དོ་༎
 varṇaṃ bhāṣante,	བསྔགས་པ་གསུང་ངོ་༎
 yaśaḥ prakāśayanti,	གྲགས་པ་རབ་ཏུ་སྒྲོགས་སོ་༎
 guṇamudīrayanti |	ཡོན་ཏན་བརྗོད་དོ་༎
 tatkasya hetoḥ?	དེ་ཅིའི་ཕྱིར་ཞེ་ན་།
 ye kecitsattvāstasya bhagavato 'mitābhasya nāmadheyaṃ śṛṇvanti,	སེམས་ཅན་གང་དག་ཁ་ཅིག་གིས་བཅོམ་ལྡན་འདས་འོད་དཔག་མེད་དེའི་མཚན་ཐོས་ལ་།
 śrutvā cāntaśa ekacittotpādamapyadhyāśayena prasādasahagatena cittamutpādayanti, te sarve 'vaivartikatāyāṃ santyanuttarāyāḥ samyaksaṃbodheḥ || sukhv_26 || start sukhv 27:	ཐོས་ནས་ཀྱང་ཐ་ན་སེམས་བསྐྱེད་པ་གཅིག་ཙམ་ཞིག་བསམ་པ་ཐག་པ་ནས་དད་པ་དང་དགའ་བ་བསྐྱེད་པ་དེ་དག་ཐམས་ཅད་བླ་ན་མེད་པ་ཡང་དག་པར་རྫོགས་པའི་བྱང་ཆུབ་ལས་ཕྱིར་མི་ལྡོག་པའི་ཕྱིར་རོ་༎
 ye cānanda kecitsattvāstaṃ tathāgataṃ punaḥ satkāramanasikariṣyanti,	ཀུན་དགའ་བོ་། སེམས་ཅན་གང་དག་ཁ་ཅིག་ནི་དེ་བཞིན་གཤེགས་པ་དེ་རྣམ་པས་ཡང་དང་ཡང་ཡིད་ལ་བྱེད་པ་དང་། 
 bahvaparimitaṃ kuśalamūlamavaropayiṣyanti bodhaye cittaṃ pariṇāmya,	དགེ་བའི་རྩ་བ་མང་པོ་དཔག་ཏུ་མེད་པ་བསྐྱེད་པ་དང་། བྱང་ཆུབ་ཏུ་སེམས་ཡོངས་སུ་བསྔོས་ཏེ་།
 tatra ca lokadhātāvupapattaye praṇidhāsyanti, teṣāṃ so 'mitābhastathāgato 'rhan samyaksaṃbuddho maraṇakālasamaye pratyupasthite 'nekabhikṣugaṇaparivṛtaḥ puraskṛtaḥ sthāsyati |	འཇིག་རྟེན་གྱི་ཁམས་དེར་སྐྱེ་བར་སྨོན་ལམ་འདེབས་པ་དེ་དག་འཆི་བའི་དུས་ཉེ་བར་གནས་པ་ན་དེ་བཞིན་གཤེགས་པ་དགྲ་བཅོམ་པ་ཡང་དག་པར་རྫོགས་པའི་སངས་རྒྱས་འོད་དཔག་མེད་དེ་དགེ་སློང་གི་ཚོགས་དུ་མས་ཡོངས་སུ་བསྐོར་ཞིང་མདུན་གྱིས་བལྟས་ནས་བཞུགས་པར་འགྱུར་ཏེ་།
 tataste taṃ bhagavantaṃ dṛṣṭvā prasannacittāścyutāḥ santastatraiva sukhāvatyāṃ lokadhātāvupapatsyante |	དེ་དག་གིས་བཅོམ་ལྡན་འདས་འོད་དཔག་མེད་དེ་མཐོང་ནས་རབ་ཏུ་དང་བའི་སེམས་ཀྱིས་ཤི་འཕོས་ཏེ་། འཇིག་རྟེན་གྱི་ཁམས་བདེ་བ་ཅན་དེ་ཉིད་དུ་སྐྱེ་བར་འགྱུར་རོ་༎ ཀུན་དགའ་བོ་།
 yaśca ānanda ākāṅkṣeta kulaputro vā kuladuhitā vā kimityahaṃ dṛṣṭa eva dharme tamamitābhaṃ tathāgataṃ paśyeyamiti,	རིགས་ཀྱི་བུའམ་རིགས་ཀྱི་བུ་མོ་གང་ལ་ལ་དག་གིས་ཚེ་འདི་ཉིད་ལ་དེ་བཞིན་གཤེགས་པ་འོད་དཔག་མེད་མཐོང་ཡང་ཅི་མ་རུང་སྙམ་དུ་སེམས་བ་དེས་བླ་ན་མེད་པ་ཡང་དག་པར་རྫོགས་པའི་བྱང་ཆུབ་ཏུ་སེམས་བསྐྱེད་ལ་།
 tenānuttarāyāṃ samyaksaṃbodhau cittamutpādya adhyāśayātiśayatayā saṃtatyā tasmin buddhakṣetre cittaṃ saṃpreṣya upapattaye kuśalamūlāni ca pariṇāmayitavyāni	ལྷག་པའི་བསམ་པའི་རྒྱུད་ཀྱིས་སངས་༄༤༠༡ཨ་༌༎ རྒྱས་ཀྱི་ཞིང་དེར་སྐྱེ་བར་བྱ་བའི་ཕྱིར་སེམས་ཡང་དག་པར་བཏང་སྟེ་། དགེ་བའི་རྩ་བ་རྣམས་བསྐྱེད་པར་བྱ་ཞིང་ཡོངས་སུ་བསྔོ་བར་བྱའོ་༎ ཀུན་དགའ་བོ་།
 start sukhv 28: ye punastaṃ tathāgataṃ na bhūyo manasikariṣyanti, na ca bahvaparimitaṃ kuśalamūlamabhīkṣṇamavaropayiṣyanti,	གང་དག་ཡང་དེ་བཞིན་གཤེགས་པ་དེ་ཡང་ཡིད་ལ་བྱེད་ཅིང་དགེ་བའི་རྩ་བ་མང་པོ་དཔག་ཏུ་མེད་པ་རྒྱུན་དུ་བསྐྱེད་ལ་། སངས་རྒྱས་ཀྱི་ཞིང་དེར་སེམས་ཡང་དག་པར་གཏོད་པ་དེ་དག་འཆི་བའི་དུས་ཉེ་བར་གནས་པ་ན་། 
 teṣāṃ tādṛśenaiva so 'mitābhastathāgato 'rhan samyaksaṃbuddho varṇasaṃsthānārohapariṇāhena bhikṣusaṃghaparivāreṇa ca tādṛśa eva buddhinirmito maraṇakālasamaye purataḥ sthāsyati |	དེ་བཞིན་གཤེགས་པ་དགྲ་བཅོམ་པ་ཡང་དག་པར་རྫོགས་པའི་སངས་རྒྱས་འོད་དཔག་མེད་དེའི་ན་། ཁ་དོག་དང་། དབྱིབས་དང་། ཆུ་ཞེང་དང་། ཞམ་འབྲིང་བ་དགེ་སློང་གི་དགེ་འདུན་ཅི་འདྲ་བ་དེ་འདྲ་བའི་སངས་རྒྱས་ཀྱི་སྤྲུལ་པ་དག་མདུན་དུ་གནས་པར་འགྱུར་ཏེ་།
 te tenaiva tathāgatadarśanaprasādālambanena samādhinā apramuṣitayā smṛtyā cyutāstatraiva buddhakṣetre pratyājaniṣyanti || sukhv_28 ||	དེ་དག་དེ་བཞིན་གཤེགས་པ་མཐོང་བས་རབ་ཏུ་དང་བ་ལ་དམིགས་པའི་ཏིང་ངེ་འཛིན་དེ་དང་། བརྗེད་པ་མེད་པའི་དྲན་པས་ཤི་འཕོས་ནས་སངས་རྒྱས་ཀྱི་ཞིང་དེ་ཉིད་དུ་སྐྱེ་བར་འགྱུར་། རོ་༎ ཀུན་དགའ་བོ་།
 start sukhv 29: ye punarānanda sattvāstaṃ tathāgataṃ daśacittotpādātsamanusmariṣyanti, spṛhāṃ ca tasmin buddhakṣetra utpādayiṣyanti,	སེམས་ཅན་གང་དག་དེ་བཞིན་གཤེགས་པ་དེ་ཐ་ན་སེམས་བསྐྱེད་པ་གཅིག་ཙམ་རྗེས་སུ་དྲན་པར་བྱེད་ཅིང་སངས་རྒྱས་ཀྱི་ཞིང་དེར་སྐྱེ་བར་འདོད་ལ་། 
 gambhīreṣu ca dharmeṣu bhāṣyamāṇeṣu tuṣṭiṃ pratilapsyante, na vipatsyante, na viṣādamāpatsyante, na saṃsadanamāpatsyante,	ཆོས་ཟབ་མོ་དག་འཆད་པ་ན་དགའ་བ་འཐོབ་ཅིང་སྒྱིད་ལུག་པ་མེད་ལ་།
 antaśa ekacittotpādenāpi taṃ tathāgataṃ manasikariṣyanti,	མི་འགོང་མི་ཞུམ་ཞིང་ཐ་ན་སེམས་བསྐྱེད་པ་གཅིག་ཙམ་དེ་བཞིན་གཤེགས་པ་འོད་དཔག་མེད་དེ་ཡི་ད་ལ་བྱེད་དེ་།
 spṛhāṃ cotpādayiṣyanti tasmin buddhakṣetre, te 'pi svapnāntaragatā amitābhaṃ tathāgataṃ drakṣyanti, sukhāvatyāṃ lokadhātāvupapatsyante,	འདོད་པ་ཡང་བསྐྱེད་ན་དེ་དག་རྨི་ལམ་ན་དེ་བཞིན་གཤེགས་པ་འོད་དཔག་མེད་དེ་༄༤༠༡བ་མཐོང་ཞིང་འཇིག་རྟེན་གྱི་ཁམས་བདེ་བ་ཅན་དུ་སྐྱེ་བར་འགྱུར་། 
 avaivartikāśca bhaviṣyantyanuttarāyāḥ samyaksaṃbodheḥ || sukhv_29 ||	བླ་ན་མེད་པ་ཡང་དག་པར་རྫོགས་པའི་བྱང་ཆུབ་ལས་ཕྱིར་མི་ལྡོག་པར་ཡང་བར་འགྱུར་། འགྱུར་རོ་༎ ཀུན་དགའ་བོ་།
 start sukhv 30: imaṃ khalvānanda arthavaśaṃ saṃpaśya tathāgatā daśasu dikṣu aprameyāsaṃkhyeyāsu lokadhātuṣu tasyāmitābhasya tathāgatasya nāmagheyaṃ parikīrtayanto varṇaṃ ghoṣayantaḥ saṃpraśaṃsāmabhyudīrayanti |	དེ་བཞིན་གཤེགས་པ་དེ་དག་དོན་གྱི་དབང་དེ་གཟིགས་ནས་ཕྱོགས་བཅུའི་འཇིག་རྟེན་གྱི་ཁམས་གྲངས་མེད་དཔག་ཏུ་མེད་པ་དག་ན་དེ་བཞིན་གཤེགས་པ་འོད་དཔག་མེད་དེའི་མཚན་ཀྱང་ཡོངས་སུ་བརྗོད་དོ་༎ བསྔགས་པ་ཡང་གསུང་། བསྟོད་པ་ཡང་སྒྲོགས་སོ་༎ ཀུན་དགའ་བོ་།
 tasmin khalu punarānanda buddhakṣetre daśabhyo digbhya ekaikasyāṃ diśi gaṅgānadīvālukāsamā bodhisattvāstamamitābhaṃ tathāgatamupasaṃkramanti darśanāya vandanāya paryupāsanāya paripraśnīkaraṇāya, taṃ ca bodhisattvagaṇaṃ tāṃśca buddhakṣetraguṇālaṃkāravyūhasaṃpadviśeṣān draṣṭum || sukhv_30 || start sukhv 31:	ཕྱོགས་བཅུའི་ཕྱོགས་རེ་རེ་ནས་ཀྱང་བྱང་ཆུབ་སེམས་དཔའ་གངགའའི་ཀླུང་གི་བྱེ་མ་སྙེད་དག་དེ་བཞིན་གཤེགས་པ་འོད་དཔག་མེད་དེ་ལ་བལྟ་བ་དང་། ཕྱག་བྱ་བ་དང་། བསྙེན་བཀུར་བྱ་བ་དང་། ཡོངས་སུ་དྲི་བ་བྱ་བ་དང་། བྱང་ཆུབ་སེམས་དཔའི་ཚོགས་དེ་དང་། སངས་རྒྱས་ཀྱི་ཞིང་གི་ཡོན་ཏན་གྱི་རྒྱན་བཀོད་པ་ཕུན་སུམ་ཚོགས་པའི་ཁྱད་པར་དེ་དག་བལྟ་བའི་ཕྱིར་སངས་རྒྱས་ཀྱི་ཞིང་དེར་འདོང་ངོ་༎
 atha khalu bhagavāṃstasyāṃ velāyāmimamevārthaṃ bhūyasyā mātrayā paridīpayannimā gāthā abhāṣata -	དེ་ནས་དེའི་ཚེ་བཅོམ་ལྡན་འདས་ཀྱིས་དོན་འདི་ཉིད་རྒྱས་པར་གསུང་ཞིང་། ཚིགས་སུ་བཅད་པ་འདི་དག་བཀའ་སྩལ་ཏོ་༎ འདྲེན་པ་འོད་དཔག་མེད་ཀྱི་སངས་རྒྱས་ལ་༎
 yathaiva gaṅgānadīvālukāsamā buddhāna kṣetrā amitāyunāyakam || sukhv_vs_28 || (sukhv, vaidya 242)	ཕྱག་བྱའི་ཕྱིར་ནི་ཤར་གྱི་སངས་རྒྱས་ཞིང་༎ མཐའ་ཡས་གངགའའི་ཀླུང་གི་བྱེ་སྙེད་ནས་༎ རྫོགས་པའི་བྱང་ཆུབ་སེམས་དཔའ་དེ་དག་ལྷགས་༎
 bahupuṣpapūṭī gṛhītva te nānāvarṇaṃ surabhī manoramāṃ |	དེ་དག་མེ་ཏོག་ཁ་དོག་ཐ་དད་པ་༎ དྲི་ཞིམ་ཡིད་འོང་མང་པོ་སྙིམ་ཐོགས་ཏེ་༎
 okiranti naranāyakottamaṃ amitāyuṃ naradevapūjitam || sukhv_vs_29 ||	ཚེ་དཔག་མེད་པ་ལྷ་དང་མིས་མཆོད་པ་༎ མི་ཡི་འདྲེན་པ་མཆོག་ལ་རབ་ཏུ་འཐོར་༎ ༄༤༠༢ཨ་༌༎ འདྲེན་པ་འོད་དཔག་མེད་ཀྱི་སངས་རྒྱས་ལ་༎
 tatha dakṣiṇapaścimottarāsu buddhāna kṣetrā daśatāsu yāttakāḥ | yato yato āgami buddha vandituṃ sabodhisattvā amitāyunāyakam || sukhv_vs_30 ||	ཕྱག་བྱའི་ཕྱིར་ནི་དེ་བཞིན་ལྷོ་ནུབ་དང་༎ བྱང་ཕྱོགས་སངས་རྒྱས་ཞིང་རྣམས་ཇི་སྙེད་ནས་༎ རྫོགས་པའི་བྱང་ཆུབ་སེམས་དཔའ་དེ་དག་ལྷགས་༎
 bahugandhāpūṭī gṛhitvā nānāvarṇa surabhī manoramāṃ |	དེ་དག་སྤོས་ཀྱི་ཁ་དོག་ཐ་དད་པ་༎ དྲི་ཞིམ་ཡིད་འོང་མང་པོ་སྙིམ་ཐོགས་ཏེ་༎
 okiranti naranāyakottamaṃ amitāyuṃ naradevapūjitam || sukhv_vs_31 ||	ཚེ་དཔག་མེད་པ་ལྷ་དང་མིས་མཆོད་པ་༎ མི་ཡི་འདྲེན་པ་མཆོག་ལ་རབ་ཏུ་འཐོར་༎
 pūjitva vā te bahubodhisattvā vanditva pādāmamitaprabhasya |	བྱང་ཆུབ་སེམས་དཔའ་མང་པོ་དེ་དག་གིས་༎ མཆོད་པ་བྱས་ཏེ་དཔག་མེད་འོད་ཞབས་ལ་༎ ཕྱག་འཚལ་བསྐོར་བ་བྱས་ནས་འདི་སྐད་དུ་༎
 pradakṣiṇīkṛtya vadanti caivaṃ aho 'dbhutaṃ śobhati buddhakṣetram || sukhv_vs_32 ||	སངས་རྒྱས་ཞིང་ནི་ངོ་མཚར་མཛེས་ཞེས་འཛེར་༎ དགའ་ཞིང་མགུ་བའི་སེམས་ནི་གཞལ་ཡས་ཀྱིས་༎
 te puṣpapūṭīhi punokiranti udagracittā atulāya prītiye |	དེ་དག་གིས་ནི་མེ་ཏོག་སྙིམ་གཏོར་ནས་༎
 kāmaṃ prabhāṣanti purasta nāyake asmāpi kṣetraṃ siya evarūpam || sukhv_vs_33 ||	འདྲེན་པ་དེ་ཡི་སྤྱན་སྔར་འདི་སྐད་དུ་༎ བདག་ཅག་ཞིང་ཡང་འདི་འདྲར་གྱུར་ཅེས་སྨྲས་༎
 ye puṣpapūṭā iti kṣipta tatra chatraṃtayā saṃsthihi yojanāśatam |	དེ་དག་མེ་ཏོག་སྙིམ་པ་གཏོར་མ་ཐག་།
 svalaṃkṛtaṃ śobhati citraravato chādante buddhasya samanta kāyam || sukhv_vs_34 ||	དེ་ཚེ་དཔག་ཚད་བརྒྱ་པའི་གདུགས་གྱུར་ཏེ་༎ ལེགས་པར་བརྒྱན་ཞིང་ཡུ་བ་བཀྲ་བས་མཛེས་༎ སངས་རྒྱས་སྐུ་ལ་ཀུན་ཏུ་ཁེབས་པས་གནས་༎
 te bodhisattvā tathā satkaritvā kathaṃ karontī iti tuṣṭa tatra |	བྱང་ཆུབ་སེམས་དཔའ་དེ་དག་དེ་བཞིན་དུ་༎ བསྙེན་བཀུར་བྱས་ནས་དགའ་སྟེ་འདི་སྐད་དུ་༎
 sulabdha lābhāḥ khalu tehi sattvaiḥ yehī śrutaṃ nāma narottamasya || sukhv_vs_35 ||	གང་དག་གིས་ནི་མི་མཆོག་མཚན་ཐོས་པ་༎
 asmehi pī lābha sulabdhapūrvā yadā gatāsya ima buddhakṣetram |	སེམས་ཅན་དེ་དག་རྙེད་པ་ལེགས་རྙེད་འཛེར་༎ སངས་རྒྱས་ཞིང་འདིར་བདག་ཅག་ལྷགས་པས་ན་༎ བདག་ཅག་གིས་ནི་སྔོན་རྙེད་ལེགས་པར་རྙེད་༎
 paśyātha svapnopama maitra kīdṛśaṃ yatkalpitaṃ kalpasahasra śāstuḥ || sukhv_vs_36 || (sukhv, vaidya 243) paśyātha buddhā vara puṇyarāśiḥ parivṛto śobhati bodhisattvaiḥ |	བསྐལ་པ་སྟོང་དུ་སྟོན་པས་གང་བསྒྲུབས་པ་༎ རྨི་ལམ་ལྟ་བུའི་ཞིང་ནི་༄༤༠༢བ་ཅི་འདྲ་ལྟོས་༎
 amitābhasya ābhā amitā ca tejā amitaṃ ca āyūramitaśca saṃghaḥ || sukhv_vs_37 ||	འོད་ནི་དཔག་མེད་གཟི་བརྗིད་དཔག་མེད་པ་༎ སྐུ་ཚེ་དཔག་མེད་དགེ་འདུན་དཔག་མེད་པ་༎ བྱང་ཆུབ་སེམས་དཔས་བསྐོར་ཞིང་མཛེས་གྱུར་པ་༎ སངས་རྒྱས་བསོད་ནམས་ཕུང་པོ་མཆོག་ལ་ལྟོས་༎
 smitaṃ karotī amitāyunāthaṃ ṣaṭtriṃśakoṭīnayutāna arciṣām |	དེ་ནས་ཚེ་དཔག་མེད་ཀྱིས་འཛུམ་མཛད་ནས་༎ འོད་འཕྲོ་བྱེ་བ་ཁྲག་ཁྲིག་སུམ་ཅུ་དྲུག་།
 ye niścaritvā mukhamaṇḍalātaḥ sphūranti kṣetrāṇi sahasrakoṭīḥ || sukhv_vs_38 ||	དེ་དག་ཞལ་གྱི་དཀྱིལ་འཁོར་ནས་བྱུང་སྟེ་༎ ཞིང་སྟོང་བྱེ་བ་དག་ནི་ཁྱབ་པར་མཛད་༎ འོད་འཕྲོ་དེ་དག་ཐམས་ཅད་སླར་ལོག་སྟེ་༎
 tāḥ sarvasūrīḥ punaretya tatra mūrdhe ca astaṃ gami nāyakasya |	འདྲེན་པའི་སྤྱི་གཙུག་དེར་ནི་ནུབ་པར་གྱུར་༎ དེ་ཚེ་འོད་འཕྲོ་ནུབ་པར་གྱུར་ནས་ནི་༎
 devā manuṣyā janayanti prītiṃ arcistadā asyamidāṃ viditvā || sukhv_vs_39 ||	ལྷ་དང་མི་རྣམས་དགའ་བ་རབ་ཏུ་སྐྱེད་༎ དེ་ནས་སངས་རྒྱས་སྲས་པོ་གྲགས་ཆེན་པོ་༎
 uttiṣṭhate buddhasuto mahāyaśā nātha so hi avalokiteśvaraḥ |	སྤྱན་རས་གཟིགས་ཀྱི་དབང་ཕྱུག་དེ་ལངས་ཏེ་༎ གང་སླད་འཇིག་རྟེན་མགོན་པོ་འཛུམ་མཛད་པ་༎
 ko heturatra bhagavaṃ kaḥ pratyayo yena smitaṃ kurvasi lokanātha || sukhv_vs_40 ||	བཅོམ་ལྡན་དེ་ཡི་རྒྱུ་དང་རྐྱེན་གང་ལགས་༎
 taṃ vyākarohī yatra so 'rthakovido hitānukampī bahusattvamocakaḥ |	སེམས་ཅན་མང་འགྲོལ་ཕན་པ་ཐུགས་བརྩེ་ཅན་༎ དོན་དམ་མཁས་པ་དེ་ནི་ལུང་བསྟན་གསོལ་༎ གསུང་མཆོག་ཡིད་དུ་མཆི་བ་དེ་ཐོས་ནས་༎
 śrutveti vācaṃ paramāṃ manoramāṃ udagracittā bhaviṣyanti sattvāḥ || sukhv_vs_41 ||	སེམས་ཅན་དག་ནི་དགའ་བའི་སེམས་སུ་འགྱུར་༎
 ye bodhisattvā bahulokadhātutaḥ sukhāvatīṃ prasthita buddha paśyatāṃ |	འཇིག་རྟེན་ཁམས་མང་བྱང་ཆུབ་སེམས་དཔའ་དག་། སངས་རྒྱས་བལྟ་སླད་བདེ་ཅན་འདིར་མཆི་བ་༎
 te śrutvā prītiṃ vipulāṃ janetvā kṣipramimaṃ kṣetra vilokayeyuḥ || sukhv_vs_42 ||	དེ་དག་ཐོས་ནས་དགའ་བ་ཆེར་བསྐྱེད་དེ་༎
 āgatya ca kṣetramidaṃ udāraṃ ṛddhībalaṃ prāpuṇi kṣiprameva |	མྱུར་དུ་ཞིང་འདི་རྣམ་པར་བལྟ་བར་འགྱུར་༎
 divyaṃ ca cakṣustatha śrotra divyaṃ jātismarāḥ pāramikovidāśca || sukhv_vs_43 ||	རྒྱ་ཆེན་ཞིང་འདིར་ལྷགས་པར་གྱུར་ནས་ཀྱང༏་༏ལྷ་ཡི་མིག་དང་ལྷ་ཡི་རྣ་བ་དང་༎ ཚེ་རབས་དྲན་དང་བློ་གྲོས་མཁས་མཆོག་དང་༎ རྫུ་འཕྲུལ་སྟོབས་ཀྱང་མྱུར་དུ་ཐོབ་པར་འགྱུར་༎
 amitāyu buddhastada vyākaroti mama hyayaṃ praṇidhi babhūva pūrvam |	སངས་རྒྱས་ཚེ་དཔག་མེད་ཀྱིས་ལུང་བསྟན་པ་༎ ངས་ནི་སྔོན་༄༤༠༣ཨ་༌༎ ཚེ་སྨོན་ལམ་འདི་སྐད་བཏབ་༎
 kathaṃ pi sattvā śruṇiyāni nāma vrajeyu kṣetraṃ mama nityameva || sukhv_vs_44 || (sukhv, vaidya 244)	སེམས་ཅན་གང་གིས་ང་ཡི་མིང་ཐོས་ན་༎ ང་ཡི་ཞིང་དུ་རྟག་ཏུ་འོང་བར་ཤོག་།
 sa me ayaṃ praṇidhi prapūrṇa śobhanā sattvāśca ebhi bahulokadhātutaḥ |	ང་ཡི་སྨོན་ལམ་བཟང་པོ་དེ་རྫོགས་པས་༎ འཇིག་རྟེན་ཁམས་མང་དག་ནས་སེམས་ཅན་འོང་༎
 āgatya kṣipraṃ mama antikasmiṃ avaivartikā bhontiha ekajātiyā || sukhv_vs_45 ||	དེ་དག་ང་ཡི་ཞིང་དུ་ལྷགས་ནས་ནི་༎ དེ་དག་སྐྱེ་བ་གཅིག་ལས་ཕྱིར་མི་ལྡོག་། དེ་ཕྱིར་བྱང་ཆུབ་སེམས་དཔའ་གང་ཞིག་འདིར་༎
 tasmādya icchatiha bodhisattvaḥ mamāpi kṣetraṃ siya evarūpam | ahaṃ pi sattvān bahu mocayeyaṃ nāmena ghoṣeṇa tha darśanena || sukhv_vs_46 ||	བདག་གི་ཞིང་ཡང་འདི་འདྲར་གྱུར་པ་དང་༎ བདག་གི་མིང་དང་སྒྲ་དང་ལྟ་བས་ཀྱང་༎ སེམས་ཅན་མང་པོ་གྲོལ་བར་བྱ་འདོད་པ་༎
 sa śīghraśīghraṃ tvaramāṇarūpaḥ sukhāvatīṃ gacchatu lokadhātum |	དེ་ནི་མྱུར་དུ་རིངས་པར་ལ་གོར་དུ་༎ བདེ་བ་ཅན་གྱི་འཇིག་རྟེན་ཁམས་སོང་ལ་༎
 gattvā ca pūrvamamitaprabhasya pūjetu buddhāna sahasrakoṭīḥ || sukhv_vs_47 ||	འོད་དཔག་མེད་ཀྱི་གན་དུ་སོང་ནས་ནི་༎ སངས་རྒྱས་བྱེ་བ་སྟོང་ལ་མཆོད་པ་གྱིས་༎
 buddhāna koṭī bahu pūjayitvā ṛddhībalena bahu kṣetra gattvā |	རྫུ་འཕྲུལ་སྟོབས་ཀྱི་ཞིང་མང་སོང་ནས་ནི་༎ སངས་རྒྱས་བྱེ་བ་མང་ལ་མཆོད་བྱ་སྟེ་༎
 kṛtvāna pūjāṃ sugatāna santike bhaktyā gamiṣyanti sukhāvatītaḥ || sukhv_vs_48 ||	བདེ་བར་གཤེགས་ལ་མཆོད་པ་བྱས་ནས་ཀྱང་༎ དྲོ་ཁར་བདེ་བ་ཅན་དུ་སླར་ཡང་འོང་༎༎
 iti || sukhv_31 ||	བམ་པོ་གསུམ་པ་སྟེ་ཐ་མའོ་༎ ཀུན་དགའ་བོ་།
 start sukhv 32: tasya khalu punarānanda amitāyuṣastathāgatasyārhataḥ samyaksaṃbuddhasya bodhivṛkṣaḥ | sa daśa yojanaśatānyuccaistvena,	དེ་བཞིན་གཤེགས་པ་དགྲ་བཅོམ་པ་ཡང་དག་པར་རྫོགས་པའི་སངས་རྒྱས་འོད་དཔག་མེད་དེའི་བྱང་ཆུབ་ཀྱི་ཤིང་ནི་འཕང་དུ་དཔག་ཚད་སྟོང་དྲུག་བརྒྱ་ཡོད་པ་། 
 aṣṭau yojanaśatānyabhipralambitaśākhāpatrapalāśaḥ pañcayojanaśatamūlārohapariṇāhaḥ	ཡལ་ག་དང་། ལོ་མ་དང་། འདབ་མ་དཔག་ཚད་བརྒྱད་བརྒྱ་ཚུན་ཆད་དུ་འཕྱང་བ་། རྩ་བའི་སྦོམས་དང་ཁྲུན་དཔག་ཚད་ལྔ་བརྒྱ་ཡོད་པ་། རྟག་ཏུ་ལོ་མ་ཆགས་པ་། རྟག་ཏུ་མེ་ཏོག་ཆགས་པ་། རྟག་ཏུ་འབྲས་བུ་ཆགས་པ་། ཁ་དོག་ཐ་དད་པ་།
 sadāpatraḥ sadāpuṣpaḥ sadāphalo nānāvarṇo 'nekaśatasahasravarṇo nānāpatro nānāpuṣpo	ཁ་དོག་བརྒྱ་༄༤༠༣བ་སྟོང་དུ་མ་ཡོད་པ་། ལོ་མ་ཐ་དད་པ་། མེ་ཏོག་ཐ་དད་པ་། འབྲས་བུ་ཐ་དད་པ་།
 nānāphalo nānāvicitrabhūṣaṇasamalaṃkṛtaścandrabhāsamaṇiratnaparisphuṭaḥ śakrābhilagnamaṇiratnavicitritaścintāmaṇiratnākīrṇaḥ	རྒྱན་སྣ་ཚོགས་ཀྱིས་བརྒྱན་པ་། ཟླ་བ་ལྟ་བུར་སྣང་བའི་ནོར་བུ་རིན་པོ་ཆེས་ཡོངས་སུ་གསལ་བ་། བརྒྱ་བྱིན་ཐོགས་པའི་ནོར་བུ་རིན་པོ་ཆེས་རྣམ་པར་སྤྲས་པ་།
 sāgaravaramaṇiratnasuvicitrito divyasamatikrāntaḥ svarṇasūtrābhipralambito	ཡིད་བཞིན་གྱི་ནོར་བུ་རིན་པོ་ཆེས་གང་བ་། རྒྱ་མཚོའི་ནོར་བུ་རིན་པོ་ཆེ་མཆོག་གིས་ཤིན་ཏུ་རྣམ་པར་སྤྲས་པ་། ཁ་དོག་ལྷའི་ལས་འདས་པ་།
 rucakahāraratnahāravatsahārakaṭakahāralohitamuktāhāranīlamuktāhārasiṃhalatāmekhalākalāparatnasūtrasarva-ratnavastuśatābhivicitritaḥ	གསེར་གྱི་སྐུད་པ་འཆང་བ་། སེ་མོ་དོ་མཛེས་པ་དང་། རིན་པོ་ཆེའི་ཆུན་པོ་དང་། རྒྱན་ཕྲེང་དང་། དོ་ཤལ་ཆིག་རྐྱང་དང་། མུ་ཏིག་དམར་པོའི་རྒྱན་ཕྲེང་དང་། མུ་ཏིག་སྔོན་པོའི་རྒྱན་ཕྲེང་དང་། སེང་གེའི་ཁ་ནས་འཕྱང་བའི་སྐ་རགས་ཀྱི་ཚོགས་ཡོད་པ་། རིན་པོ་ཆེའི་སྐུད་པ་དང་། རིན་པོ་ཆེ་ཐམས་ཅད་དང་། དུང་གིས་མངོན་པར་སྤྲས་པ་།
 svarṇajālamuktājālasarvaratnajālakiṅkiṇījālatato makarasvastikanandyāvartacandrasamalaṃkṛtaḥ	གསེར་གྱི་དྲ་བ་དང་། མུ་ཏིག་གི་དྲ་བ་དང་། རིན་པོ་ཆེ་ཐམས་ཅད་ཀྱི་དྲ་བ་དང་། དྲིལ་བུ་ག-ཡེར་ཁའི་དྲ་བས་བླ་རེར་བྲེས་པ་། ཆུ་སྲིན་དང་། བཀྲ་ཤིས་པ་དང་། ག-ཡུང་དྲུང་འཁྱིལ་བ་དང་། ཟླ་གམ་ལྟ་བུས་ལེགས་པར་བརྒྱན་པ་།
 kiṅkiṇīmaṇijālasauvarṇasarvaratnālaṃkāravibhūṣito yathāśayasattvavijñaptisamalaṃkṛtaśca |	ནོར་བུ་འཁྲོལ་བ་དང༏་གསེར་དང་རིན་པོ་ཆེའི་རྒྱན་ཐམས་ཅད་ཀྱིས་བརྒྱན་པ་། སེམས་ཅན་གྱི་བསམ་པའི་རྣམ་པར་རིག་པ་ཇི་ལྟ་བ་བཞིན་དུ་ལེགས་པར་བརྒྱན་པའོ་༎ ཀུན་དགའ་བོ་།
 tasya khalu punarānanda bodhivṛkṣasya vātasamīritasya yaḥ śabdo ghoṣo niścarati so 'parimāṇāṃllokadhātūn vijñāpayati |	བྱང་ཆུབ་ཀྱི་ཤིང་དེ་རླུང་གིས་བསྐྱོད་ན་སྒྲ་དབྱངས་འབྱུང་བ་གང་ཡིན་པ་དེས་འཇིག་རྟེན་གྱི་ཁམས་ཚད་མེད་པ་གོ་བར་བྱེད་དོ་༎
 tatrānanda yeṣāṃ sattvānāṃ sa bodhivṛkṣaḥ śrotrāvabhāsamāgacchati,	ཀུན་དགའ་བོ་། དེ་ལ་བྱང་ཆུབ་ཀྱི་ཤིང་གི་སྒྲ་དེ་སེམས་ཅན་གང་དག་གི་རྣ་ལམ་དུ་གྲག་༄༤༠༤ཨ་༌༎
 teṣāṃ śrotrarogo na pratikāṅkṣitavyo yāvadbodhiparyantam |	པ་དེ་དག་བྱང་ཆུབ་ཀྱི་མཐའི་བར་དུ་རྣ་ནད་ཀྱིས་མི་བཏབ་པར་ཤེས་པར་བྱའོ་༎ སེམས་ཅན་དཔག་ཏུ་མེད་། གྲངས་མེད་། བསམ་གྱིས་མི་ཁྱབ་།
 yeṣāmaprameyāsaṃkhyeyācintyātulyāmāpyāparimāṇānabhilāpyānāṃ sattvānāṃ sa bodhivṛkṣaścakṣuṣa ābhāsamāgacchati, teṣāṃ cakṣūrogo na pratikāṅkṣitavyo yāvadbodhiparyantam |	མཚུངས་པ་མེད༏་གཞལ་དུ་མེད་། ཚད་མེད་། བརྗོད་དུ་མེད་པ་གང་དག་གི་མིག་ལམ་དུ་བྱང་ཆུབ་ཀྱི་ཤིང་དེ་སྣང་བ་དེ་དག་བྱང་ཆུབ་ཀྱི་མཐའི་བར་དུ་ནམ་ཡང་མིག་ནད་ཀྱིས་མི་བཏབ་པར་ཤེས་པར་བྱའོ་༎ ཀུན་དགའ་བོ་།
 ye khalu punarānanda sattvāstato bodhivṛkṣādgandhaṃ jighranti, teṣāṃ yāvadbodhiparyantaṃ na jātu ghrāṇaroagaḥ pratikāṅkṣitavyaḥ |	སེམས་ཅན་གང་དག་བྱང་ཆུབ་ཀྱི་ཤིང་དེའི་དྲི་ཚོར་བ་དེ་དག་ཀྱང་བྱང་ཆུབ་ཀྱི་མཐའི་བར་དུ་ནམ་ཡང་སྣ་ནད་ཀྱིས་མི་བཏབ་པར་ཤེས་པར་བྱའོ་༎ 
 ye sattvāstato bodhivṛkṣatphalānyāsvādayanti, teṣāṃ yāvadbodhiparyantaṃ na jātu jihvārogaḥ pratikāṅkṣitavyaḥ |	སེམས་ཅན་གང་དག་བྱང་ཆུབ་ཀྱི་ཤིང་དེའི་འབྲས་བུའི་རོ་མྱོང་བ་དེ་དག་ཐམས་ཅད་ཀྱང་བྱང་ཆུབ་ཀྱི་མཐའི་བར་དུ་ནམ་ཡང་ལྕེ་ནད་ཀྱིས་མི་བཏབ་པར་ཤེས་པར་བྱའོ་༎
 ye sattvāstasya bodhivṛkṣasyābhayā sphuṭā (sukhv, vaidya 245) bhavanti, teṣāṃ yāvadbodhiparyantaṃ na jātu kāyarogaḥ pratikāṅkṣitavyaḥ |	བྱང་ཆུབ་ཀྱི་ཤིང་དེའི་འོད་ཀྱིས་སེམས་ཅན་གང་དག་ལ་ཁྱབ་པར་གྱུར་བ་དེ་དག་ཀྱང་བྱང་ཆུབ་ཀྱི་མཐའི་བར་དུ་ནམ་ཡང་ལུས་ལ་ནད་ཀྱིས་མི་བཏབ་པར་ཤེས་པར་བྱའོ་༎ ཀུན་དགའ་བོ་།
 ye ca khalu punarānanda sattvāstaṃ bodhivṛkṣaṃ dharmato nidhyāyanti, teṣāṃ tata upādāya yāvadbodhiparyantaṃ na jātu cittavikṣepaḥ pratikāṅkṣitavyaḥ |	སེམས་ཅན་གང་དག་བྱང་ཆུབ་ཀྱི་ཤིང་དེ་ཆོས་ཉིད་དུ་ངེས་པར་སེམས་པ་དེ་དག་ཀྱང་དེ་ནས་བཟུང་སྟེ་བྱང་ཆུབ་ཀྱི་མཐའི་བར་དུ་ནམ་ཡང་སེམས་མི་ག-ཡེང་པར་ཤེས་པར་བྱའོ་༎
 sarve ca te sattvāḥ sahadarśanāttasya bodhivṛkṣasyāvaivartikāḥ saṃtiṣṭhante yadutānuttarāyāḥ samyaksaṃbodheḥ | tisraśca kṣāntīḥ pratilabhante yadidaṃ ghoṣānugāmanulomikīmanutpattikadharmakṣāntiṃ	སེམས་ཅན་དེ་དག་ཐམས་ཅད་ནི་བྱང་ཆུབ་ཀྱི་ཤིང་དེ་མཐོང་མ་ཐག་ཏུ་བླ་ན་མེད་པ་ཡང་དག་པར་རྫོགས་པའི་བྱང་ཆུབ་ལས་ཕྱིར་མི་ལྡོག་པར་འགྱུར་རོ་༎
 ca tasyaivāmitāyuṣastathāgatasya pūrvapraṇidhānādhiṣṭhānena pūrvajinakṛtādhikāratayā pūrvapraṇidhānaparicaryayā ca susamāpyayā subhāvitayānūnāvikalatayā || sukhv_32 || start sukhv 33:	དེ་བཞིན་གཤེགས་པ་ཚེ་དཔག་མེད་དེ་ཉིད་ཀྱི་སྔོན་གྱི་སྨོན་ལམ་གྱི་བྱིན་གྱི་རླབས་༄༤༠༤བ་དང་། སྔོན་གྱི་རྒྱལ་བ་ལ་ལྷག་པར་བྱ་བ་བྱས་པ་དང་། སྔོན་གྱི་སྨོན་ལམ་དང་སྤྱོད་པ་ཤིན་ཏུ་རྫོགས་པ་དང་། ཤིན་ཏུ་བསྒོམས་པ་དང་། མི་ཉུང་བ་དང་། མ་ཚང་བ་མེད་པས་འདི་ལྟ་སྟེ་། སྒྲའི་རྗེས་སུ་འགྲོ་བ་དང་། རྗེས་སུ་མཐུན་པ་དང་། མི་སྐྱེ་བའི་ཆོས་ལ་བཟོད་པ་དང་། བཟོད་པ་རྣམ་པ་གསུམ་འཐོབ་བོ་༎ ཀུན་དགའ་བོ་།
 tatraiva khalu punarānanda ye bodhisattvāḥ pratyājātāḥ pratyājāyante pratyājaniṣyante vā, sarve te ekajātipratibaddhāstata evānuttarāṃ samyaksaṃbodhimabhisaṃbhotsyante sthāpayitvā	བྱང་ཆུབ་སེམས་དཔའ་གང་དག་སངས་རྒྱས་ཀྱི་ཞིང་དེར་སྐྱེས་པ་དང་། སྐྱེ་བ་དང་། སྐྱེ་བར་འགྱུར་བ་དེ་དག་ཐམས་ཅད་སྐྱེ་བ་གཅིག་གིས་ཐོགས་པ་གྱུར་ནས་བླ་ན་མེད་པ་ཡང་དག་པར་རྫོགས་པའི་བྱང་ཆུབ་མངོན་པར་རྫོགས་པར་འཚང་རྒྱ་བར་འགྱུར་ཏེ་། སྨོན་ལམ་གྱི་དབང་ནི་མ་གཏོགས་སོ་༎
 praṇidhānavaśaṃ ye te bodhisattvā mahāsiṃhanādanādina udārasaṃnāhasaṃnaddhāḥ sarvasattvaparinirvāṇābhiyuktāśca || sukhv_33 || start sukhv 34:	བྱང་ཆུབ་སེམས་དཔའ་དེ་དག་ནི་སེང་གེའི་སྒྲ་ཆེན་པོ་སྒྲོགས་པ་། གོ་ཆ་ཆེན་པོ་བགོས་པ་། སེམས་ཅན་ཐམས་ཅད་ཡོངས་སུ་མྱ་ངན་ལས་བཟླ་བ་ལ་མངོན་པར་བརྩོན་པ་ཤ་སྟག་གོ་།
 tasmina khalu punarānanda buddhakṣetre ye śrāvakānte vyāmaprabhāḥ,	ཀུན་དགའ་བོ་། སངས་རྒྱས་ཀྱི་ཞིང་དེ་ན་ཉན་ཐོས་གང་དག་འཁོད་པ་དེ་དག་ནི་འོད་འདོམ་གང་བ་ཤ་སྟག་གོ་། 
 te bodhisattvāste yojanakoṭīśatasahasraprabhāḥ,	བྱང་ཆུབ་སེམས་དཔའ་གང་དག་འཁོད་པ་དེ་དག་ནི་འོད་དཔག་ཚད་བྱེ་བ་བརྒྱ་སྟོང་པ་ཤ་སྟག་སྟེ་༎
 sthāpayitvā dvau bodhisattvau yayoḥ prabhayā sā lokadhātuḥ satatasamitaṃ nityāvabhāsasphuṭā |	བྱང་ཆུབ་སེམས་དཔའ་གང་འོད་ཀྱིས་འཇིག་རྟེན་གྱི་ཁམས་དེ་རྟག་ཏུ་རྒྱུན་མི་འཆད་པར་ཁོར་ཡུག་ཏུ་སྣང་བས་ཁྱབ་པར་བྱེད་པ་གཉིས་ནི་མ་གཏོགས་སོ༏་༏དེ་ནས་བཅོམ་ལྡན་འདས་ལ་ཚེ་དང་ལྡན་པ་ཀུན་དགའ་བོས་འདི་སྐད་ཅེས་གསོལ་ཏོ་༎ བཅོམ་ལྡན་འདས་།
 atha khalvāyuṣmānānando bhagavantametadavocat - kiṃnāmadheyau bhagavaṃstau bodhisattvau mahāsattvau?	བྱང་ཆུབ་སེམས་དཔའ་སེམས་དཔའ་ཆེན་པོ་དེ་གཉིས་ཀྱིས་མིང་ཅི་ཞེས་༄༤༠༥ཨ་༌༎ བགྱི༏་བཅོམ་ལྡན་འདས་ཀྱིས་བཀའ་སྩལ་པ་།
 bhagavānāha - ekastayorānanda avalokiteśvaro bodhisattvo mahāsattvaḥ dvitīyo mahāsthāmaprāpto nāma |	ཀུན་དགའ་བོ་། དེ་གཉིས་ལ་གཅིག་གི་མིང་ནི་བྱང་ཆུབ་སེམས་དཔའ་སེམས་དཔའ་ཆེན་པོ་སྤྱན་རས་གཟིགས་དབང་ཕྱུག་ཅེས་བྱའོ་༎ གཅིག་གི་མིང་ནི་མཐུ་ཆེན་ཐོབ་ཅེས་བྱ་སྟེ་།
 ita eva cānanda buddhakṣetrāccyutā tau tatropapannau || sukhv_34 ||	ཀུན་དགའ་བོ་། དེ་གཉིས་ནི་སངས་རྒྱས་ཀྱི་ཞིང་འདི་ནས་ཤི་འཕོས་ནས་སངས་རྒྱས་ཀྱི་ཞིང་དེར་སྐྱེས་སོ༏་༏ཀུན་དགའ་བོ་། 
 start sukhv 35: tatra cānanda buddhakṣetre ye bodhisattvāḥ pratyājātāḥ, sarve te dvātriṃśanmahāpuruṣalakṣaṇasamanvāgatāḥ paripūrṇagātrā dhyānābhijñākovidāḥ	བྱང་ཆུབ་སེམས་དཔའ་གང་དག་སངས་རྒྱས་ཀྱི་ཞིང་དེར་སྐྱེས་པ་དེ་དག་ཐམས་ཅད་ནི་སྐྱེས་བུ་ཆེན་པོའི་མཚན་སུམ་ཅུ་རྩ་གཉིས་དགའ་བོ་། དང་ལྡན་པ་། ལུས་ཡོངས་སུ་རྫོགས་པ༏་བསམ་གཏན་དང་མངོན་པར་ཤེས་པ་ལ་དགའ་བོ་། དང་ལྡན་པ་། མཁས་པ་། ཤེས་རབ་ཀྱིས་རབ་ཏུ་དབྱེ་བ་ལ་མཁས་པ་དགའ་བོ་། དང་ལྡན་པ་། མཁས་པ་། 
 prajñāprabhedakuśalāstīkṣṇendriyāḥ susaṃvṛtendriyā ājñātāvīndriyā adīnābalendriyāḥ	། དབང་པོ་རྣོ་བ་། དབང་པོ་བསྡམས་པ་། ཀུན་ཤེས་པའི་དབང་པོ་དང་ལྡན་པ་། མ་ཞུམ་པ་། དབང་པོ་མི་ག-ཡོ་བ་།
 pratilambhakṣāntikā anantāparyantaguṇāḥ || sukhv_35 || start sukhv 36:	བཟོད་པ་ཐོབ་པ་། ཡོན་ཏན་མཐའ་ཡས་པ་མུ་མེད་པ་ཤ་སྟག་གོ་།
 tasmin khalu punarānanda buddhakṣetre ye bodhisattvā pratyājātāḥ,	ཀུན་དགའ་བོ་། བྱང་ཆུབ་སེམས་དཔའ་གང་དག་སངས་རྒྱས་ཀྱི་ཞིང་དེར་སྐྱེས་པ་དེ་དག་ཐམས་ཅད་ནི་སངས་རྒྱས་མཐོང་བ་དང་མི་འདྲ་ལ་བ་།
 sarve te 'virahitā buddhadarśanenāvinipātadharmāṇo yāvadbodhiparyantam |	བྱང་ཆུབ་ཀྱི་མཐའི་བར་དུ་ལོག་པར་མི་ལྟུང་བའི་ཆོས་ཅན་ཤ་སྟག་སྟེ་།
 sarve te tata upādāya na jātu jātismarā bhaviṣyanti sthāpayitvā tathārūpeṣu kalpasaṃkṣobheṣu	དེ་དག་ཐམས་ཅད་འདི་ནས་ཉེ་བར་བཟུང་ནས་ནམ་ཡང་ཚེ་རབས་མི་དྲན་པར་མི་འགྱུར་གྱི་ཚེ་རབས་དྲན་པར་འགྱུར་ཏེ་། གང་དག་དཔེར་ན་།
 ye pūrvasthānapraṇihitāḥ pañcasu kaṣāyeṣu vartamāneṣu yadā buddhānāṃ bhagavatāṃ loke prādurbhāvo bhavati tadyathāpi nāma mamaitarhi || sukhv_36 || start sukhv 37:	ད་ལྟར་གྱི་ང་བཞིན་དུ་སྙིགས་མ་ལྔའི་དུས་ན་གང་གི་ཚེ་སངས་རྒྱས་བཅོམ་ལྡན་འདས་དག་༄༤༠༥བ་འཇིག་རྟེན་དུ་འབྱུང་བར་འགྱུར་བ་དེ་ལྟ་བུའི་བསྐལ་པས་བཀྲུགས་པ་དག་ཏུ་གནས་པར་སྔོན་སྨོན་ལམ་བཏབ་པ་རྣམས་ནི་མ་གཏོགས་སོ་༎
 tasmin khalu punarānanda buddhakṣetre ye bodhisattvāḥ pratyājātāḥ, sarve te ekapurobhaktenānyāṃllokadhātūn gatvā anekāni buddhakoṭīniyutaśatasahasrāṇyupatiṣṭhanti yāvadākāṅkṣanti buddhānubhāvena |	ཀུན་དགའ་བོ་། བྱང་ཆུབ་སེམས་དཔའ་གང་དག་སངས་རྒྱས་ཀྱི་ཞིང་དེར་སྐྱེས་པ་དེ་དག་ཐམས་ཅད་སྔ་དྲོ་གཅིག་བཞིན་འཇིག་རྟེན་གྱི་ཁམས་གཞན་དག་ཏུ་དོང་ནས་སངས་རྒྱས་བྱེ་བ་ཁྲག་ཁྲིག་ཕྲག་དུ་མ་ལ་བསྙེན་བཀུར་བྱེད་དེ་།
 te yathā yathā cittamutpādayanti evamevaṃrūpaiḥ puṣpadhūpadīpagandhamālyavilepanacūrṇacīvaracchatradhvajapatākāvaijayantītūryasaṃgītivādyaiḥ pūjāṃ kuryāma iti,	དེ་དག་རྣམ་པ་འདི་ལྟ་བུའི་མེ་ཏོག་དང་། བདུག་པ་དང་། མར་མེ་དང་། སྤོས་དང་། ཕྲེང་བ་དང་། བྱུག་པ་དང་། ཕྱེ་མ་དང་། གོས་དང་། གདུགས་དང་། རྒྱལ་མཚན་དང་། བ་དན་དང་། སིལ་སྙན་དང་། གླུ་དབྱངས་དང༏་རོལ་མོའི་དབྱངས་སྒྲ་དག་གིས་མཆོད་པར་བྱའོ་སྙམ་དུ་ཇི་ལྟ་ཇི་ལྟར་སེམས་བསྐྱེད་ཅིང་། 
 teṣāṃ sahacittotpādāttathārūpāṇi ca sarvapūjāvidhānāni pāṇau prādurbhavanti |	ཇི་ལྟར་འདོད་པ་རྣམས་དེ་དག་གིས་སེམས་བསྐྱེད་མ་ཐག་ཏུ་སངས་རྒྱས་ཀྱི་མཐུས་རྣམ་པ་དེ་ལྟ་བུའི་མཆོད་པའི་ཡོ་བྱད་ཐམས་ཅད་ལག་པ་ནས་འབྱུང་བར་འགྱུར་ཏེ་།
 te taiḥ puṣpairyāvadvādyaisteṣu buddheṣu bhagavatsu pūjāṃ kurvanto bahvaparimāṇāsaṃkhyeyaṃ kuśalamupacinvanti |	དེ་དག་གིས་མེ་ཏོག་ནས་རོལ་མོའི་དབྱངས་སྒྲའི་བར་དེ་དག་གིས་སངས་རྒྱས་བཅོམ་ལྡན་འདས་དེ་དག་ལ་མཆོད་པ་བྱེད་ལ་། དགེ་བའི་རྩ་བ་མང་པོ་ཚད་མེད་། གྲངས་མེད་པ་དག་ཀྱང་བསྐྱེད་ཅིང་གསོག་གོ་།
 sacetpunarākāṅkṣanti evaṃrūpāḥ puṣpapuṭāḥ pāṇau prādurbhavantviti,	གལ་ཏེ་མེ་ཏོག་གི་སྐོན་བུ་རྣམ་པ་འདི་ལྟ་བུ་ལག་པ་ནས་འབྱུང་བར་གྱུར་ཅིག་ཅེས་འདོད་ན་ཡང་དེ་དག་གིས་སེམས་བསྐྱེད་མ་ཐག་ཏུ་ལྷའི་མེ་ཏོག་ཁ་དོག་ཐ་དད་པ་།
 teṣāṃ sahacittotpādānnānāvarṇā anekavarṇā nānāgandhā divyāḥ puṣpapuṭāḥ pāṇau prādurbhavanti |	དྲི་ཐ་དད་པ་། དྲི་དུ་མ་ཡོད་པའི་སྐོན་བུ་དག་ལག་པ་ནས་འབྱུང་སྟེ་། དེ་དག་གིས་སྐོན་བུའི་མེ་ཏོག་རྣམ་པ་དེ་ལྟ་བུ་དེ་དག་༄༤༠༦ཨ་༌༎
 te taistathārūpaiḥ puṣpapuṭaistān buddhān bhagavato 'vakiranti abhyavakiranti abhiprakiranti |	སངས་རྒྱས་བཅོམ་ལྡན་འདས་དེ་དག་ལ་འཐོར་། མངོན་པར་འཐོར་། མངོན་པར་རབ་ཏུ་འཐོར་རོ་༎
 teṣāṃ ca yaḥ sarvaparītaḥ puṣpapuṭa (sukhv, vaidya 246) utsṛṣṭaḥ sa daśayojanavistaraṃ puṣpacchatraṃ prādurbhavati uparyantarīkṣe |	སྐོན་བུའི་མེ་ཏོག་གཏོར་བ་དེ་དག་ཐམས་ཅད་ལས་ནང་གི་ཆུང་དུ་གང་ཡིན་པ་དེ་ཡང་སྟེང་གི་བར་སྣང་ལ་དཔག་ཚད་བཅུའི་ཚད་ཙམ་གྱི་མེ་ཏོག་གི་གདུགས་སུ་འགྱུར་ཏེ་།
 dvitīye cānutsṛṣṭe na prathamo dharaṇyāṃ prapatati |	ཕྱི་མ་ཤོས་མ་གཏོར་གྱི་བར་སྔ་མས་ལ་མི་ལྟུང་ངོ་༎
 santi tatra puṣpapuṭā ya utsṛṣṭāḥ santo viṃśatiyojanavistārāṇi puṣpacchatrāṇyuparyantarīkṣe prādurbhavanti |	དེ་ན་སྐོན་བུའི་མེ་ཏོག་གཏོར་བ་གང་སྟེང་གི་བར་སྣང་ལ་དཔག་ཚད་ཉི་ཤུའི་ཚད་ཙམ་གྱི་གདུགས་སུ་འགྱུར་བ་ཡང་ཡོད་།
 santi triṃśaccatvāriṃśatpañcāśadyojanavistārāṇi,	དཔག་ཚད་སུམ་ཅུ་དང་། བཞི་བཅུའི་ཚད་ཙམ་ཡང་ཡོད་།
 santi yāvadyojanaśatasahasravistārāṇi puṣpacchatrāṇyuparyantarīkṣe prādurbhavanti |	སྟེང་གི་བར་སྣང་ལ་མེ་ཏོག་གི་གདུགས་དཔག་ཚད་བརྒྱ་སྟོང་གི་ཚད་ཀྱི་བར་ཙམ་དུ་འགྱུར་བ་དག་ཀྱང་ཡོད་དོ་༎
 tatra ye udāraṃ prītiprāmodyaṃ saṃjanayanti,	དེ་ན་གང་དག་དགའ་བ་དང་མཆོག་ཏུ་དགའ་བ་རྒྱ་ཆེན་པོ་བསྐྱེད་ཅིང་།
 udāraṃ ca cittaudvilyaṃ pratilabhante, te bahvaparimitamasaṃkhyeyaṃ kuśalamūlamavaropya bahūni ca buddhakoṭīniyutaśatasahasrāṇyupasthāya	སེམས་དགའ་བ་ཆེན་པོ་ཐོབ་པ་དེ་དག་དགེ་བའི་རྩ་བ་གྲངས་མེད་དཔག་ཏུ་མེད་པ་བསྐྱེད་ནས་སངས་རྒྱས་བྱེ་བ་ཁྲག་ཁྲིག་བརྒྱ་སྟོང་ཕྲག་མང་པོ་ལ་བསྙེན་བཀུར་བྱས་ཏེ་། སྔ་དྲོ་གཅིག་ལ་སླར་ལོག་ནས་འཇིག་རྟེན་གྱི་ཁམས་བདེ་བ་ཅན་དུ་གནས་སོ་༎
 ekapūrvāhṇena punarapi sukhāvatyāṃ lokadhātau pratiṣṭhante tasyaivāmitāyuṣastathāgatasya pūrvapraṇidhānādhiṣṭhānaparigraheṇa pūrvadattadharmaśravaṇena pūrvajināvaropitakuśalamūlatayā pūrvapraṇidhānasamṛddhiparipūryātmabhūtayā suvibhaktabhāvitayā || sukhv_37 ||	བཅོམ་ལྡན་འདས་དེ་བཞིན་གཤེགས་པ་ཚེ་དཔག་མེད་དེའི་སྔོན་གྱི་སྨོན་ལམ་གྱི་བྱིན་གྱི་རླབས་ཀྱིས་ཡོངས་སུ་ཟིན་པ་དང་། སྔོན་ཆོས་མཉན་པ་བྱིན་པ་དང་། སྔོན་གྱི་རྒྱལ་བ་ལ་དགེ་བའི་རྩ་བ་བསྐྱེད་པ་དང་། སྔོན་གྱི་སྨོན་ལམ་འབྱོར་ཞིང་ཡོངས་སུ་རྫོགས་པ་དང་། མི་ཉུང་བ་དང་། ཤིན་ཏུ་རྣམ་པར་ཕྱེ་བ་དང་། ༄༤༠༦བ་ཤིན་ཏུ་བསྒོམས་པས་སྨོན་ལམ་བཏབ་པ་འགྲུབ་པ་། ཀུན་དགའ་བོ་།
 start sukhv 38: tasmin khalu punarānanda buddhakṣetre ye sattvāḥ pratyājātāḥ, sarve te sarvajñatāsahagatāmeva dharmakathāṃ kathayanti |	བྱང་ཆུབ་སེམས་དཔའ་གང་དག་སངས་རྒྱས་ཀྱི་ཞིང་དེར་སྐྱེས་པར་གྱུར་པ་དེ་དག་ཐམས་ཅད་ནི་ཐམས་ཅད་མཁྱེན་པ་ཉིད་དང་ལྡན་པའི་ཆོས་ཀྱི་གཏམ་སྨྲ་བ་དག་གོ་།
 na ca tatra buddhakṣetre sattvānāṃ kācitparigrahasaṃjñāsti |	སངས་རྒྱས་ཀྱི་ཞིང་དེ་ན་སེམས་ཅན་གང་དག་ཡོངས་སུ་འཛིན་པའི་འདུ་ཤེས་འགའ་ཡང་མི་བསྐྱེད་དོ་༎ 
 te sarve ca tadbuddhakṣetramanucaṃkramamāṇā anuvicaranto na ratiṃ nāratimutpādayanti |	དེ་དག་ཐམས་ཅད་སངས་རྒྱས་ཀྱི་ཞིང་དེ་ཀུན་དུ་འཆག་ཅིང་རྣམ་པར་རྒྱུ་བ་ན་དོ་༎ དགའ་བ་དང་། མི་དགའ་བ་མི་བསྐྱེད་དོ་༎
 prakrāmantaścānapekṣāḥ,	འགྲོ་བ་ན་ཡང་ལྟོས་པ་མེད་པ་ཉིད་དུ་འགྲོའི་།
 na ca prakrāmanti sāpekṣāḥ |	ལྟོས་པ་དང་བཅས་པར་ནི་མ་ཡིན་ནོ་༎ འདི་ལྟ་སྟེ་།
 sarvasattveṣāmeva cittaṃ nāsti |	དངོས་པོ་ཡོངས་སུ་འཛིན་པ་དང་། གནས་ཀྱི་སེམས་དང་། སེམས་དེ་ལྟ་བུ་དག་དེ་དག་ལ་ཡོད་མེད་དོ་༎ ཀུན་དགའ་བོ་།
 tatra khalu punarānanda sukhāvatyāṃ lokadhātau ye sattvāḥ pratyājātāḥ, nāsti teṣāmanyatamakasaṃjñā,	བྱང་ཆུབ་སེམས་དཔའ་གང་དག་འཇིག་རྟེན་གྱི་ཁམས་བདེ་བ་ཅན་དེར་སྐྱེས་པ་དེ་དག་ལ་གཞན་གྱི་འདུ་ཤེས་མེད་།
 nāsti svakasaṃjñā,	རང་གི་འདུ་ཤེས་མེད་།
 nāstyasamasaṃjñā,	བདག་གི་འདུ་ཤེས་མེད་།
 nāsti vigrahaḥ,	འཐབ་པ་མེད་།
 nāsti vivādaḥ,	རྩོད་པ་མེད་།
 nāsti virodhaḥ |	མི་མཐུན་པ་མེད་། མི་མཉམ་པའི་སེམས་མེད་དེ་།
 samacittā maitracittā mṛducittāḥ snigdhacittāḥ karmaṇyacittāḥ prasannacittāḥ sthiracittā	དེ་དག་ནི་སེམས་ཅན་ཐམས་ཅད་ལ་སེམས་མཉམ་པ་དང་། ཕན་པའི་སེམས་དང་། བྱམས་པའི་སེམས་དང་། མཉེན་པའི་སེམས་དང་། འཇམ་པའི་སེམས་དང་། དགེ་བའི་སེམས་དང་། རབ་ཏུ་དང་བའི་སེམས་དང༏་བརྟན་པའི་སེམས་དང་། སྒྲིབ་པ་མེད་པའི་སེམས་དང་། འཁྲུག་པ་མེད་པའི་སེམས་དང་། རྙོག་པ་མེད་པའི་སེམས་དང་། ཤེས་རབ་ཀྱི་ཕ་རོལ་ཏུ་ཕྱིན་པ་ལ་སྤྱད་པ་སྤྱོད་པའི་སེམས་༄༤༠༧ཨ་༌༎
 vinīvaraṇacittā akṣubhitacittā alulitacittāḥ prajñāpāramitācaryācaraṇacittāścittādhārabuddhipraviṣṭāḥ |	དང༏་སེམས་ཀྱི་རྒྱུད་སྒྱུ་མའི་རང་བཞིན་ལ་བློ་རབ་ཏུ་ཞུགས་པ་།
 sāgarasamāḥ prajñayā,	ཤེས་རབ་རྒྱ་མཚོ་ཆེན་པོ་དང་མཉམ་པ་།
 merusamā buddhyā,	བློ་རི་རབ་དང་མཚུངས་པ་།
 anekaguṇasaṃnicayāḥ, bodhyaṅgasaṃgītyā vikrīḍitāḥ,	ཡོན་ཏན་དུ་མ་བསགས་པ༏་བྱང་ཆུབ་ཀྱི་ཡན་ལག་ཡང་དག་པར་འགྲོ་བས་རྣམ་པར་བརྩེན་པ་། སངས་རྒྱས་ཡང་དག་པར་འགྲོ་བ་ལ་མངོན་པར་བརྩོན་པ་།
 buddhasaṃgītyabhiyuktā māṃsacakṣuḥ pravicinvanti,	ཤའི་མིག་རབ་ཏུ་རྣམ་པར་འབྱེད་པ་།
 divyaṃ cakṣurabhinirharanti,	ལྷའི་མིག་མངོན་པར་བསྒྲུབ་པ་།
 prajñācakṣurgatiṃgatā dharmacakṣuḥpāragatā buddhacakṣurniṣpādayanto darśayanto dyotayanto vistareṇa prakāśayanto 'saṅgajñānamabhinirharanti	ཤེས་རབ་ཀྱི་མིག་རྟོགས་པར་ཁོང་དུ་ཆུད་པ་། ཆོས་ཀྱི་མིག་གི་ཕ་རོལ་ཏུ་སོན་པ་། སངས་རྒྱས་ཀྱི་སྤྱན་སྒྲུབ་ཅིང་འཆད་དེ་སྟོན་པ་། རྒྱ་ཆེར་ཡང་དག་པར་རབ་ཏུ་སྟོན་ཅིང་ཆགས་པ་མེད་པའི་ཡེ་ཤེས་མངོན་པར་སྒྲུབ་པ་།
 traidhātukasamatāyāmabhiyuktā dāntacittāḥ śāntacittāḥ sarvadharmadhātūpalabdhisamanvāgatāḥ	ཁམས་གསུམ་མཉམ་པ་ཉིད་དུ་མངོན་པར་བརྩོན་པ་། སེམས་དུལ་བ་། སེམས་ཞི་བ་། ཆོས་ཐམས་ཅད་མི་དམིགས་པ་དང་ལྡན་པ་། ཀུན་འབྱུང་བའི་ངེས་པའི་ཚིག་ལ་མཁས་པ་། ཆོས་ཀྱི་ངེས་པའི་ཚིག་དང་ལྡན་པ་། གསལ་བ་དང་མི་གསལ་བ་ལ་མཁས་པ་།
 samudayaniruktikuśalā dharmaniruktisamanvāgatā hārāhārakuśalā nayānayakuśalāḥ sthānakuśalā	ཚུལ་དང་ཚུལ་མ་ཡིན་པའི་གནས་ལ་མཁས་པ་།
 laukikīṣu kathāsvanapekṣā viharanti |	འཇིག་རྟེན་པའི་གཏམ་ལ་མི་ལྟ་བར་གནས་པ་།
 lokottarābhiḥ kathābhiḥ sāraṃ pratyayanti |	འཇིག་རྟེན་ལས་འདས་པའི་གཏམ་རྣམས་ཀྱི་སྙིང་པོ་རྟོགས་པ་།
 sarvadharmaparyeṣṭikuśalāḥ sarvadharmaprakṛtivyupaśamajñānavihāriṇo 'nupalambhagocarā	ཆོས་ཐམས་ཅད་ཡོངས་སུ་ཚོལ་བ་ལ་མཁས་པ་། ཆོས་ཐམས་ཅད་རང་བཞིན་གྱིས་ཉེ་བར་ཞི་བར་ཤེས་པས་གནས་པ་། དམིགས་པ་མེད་པའི་སྤྱོད་ཡུལ་བ་། ཅི་ཡང་མེད་པ་། ལེན་པ་མེད་པ་། སེམས་པ་མེད་པ་། ཕུང་པོ་མེད་པ་།
 niṣkiṃcanā nirupādānā niścintā nirupadhayo 'nupādāya suvimuktā anaṅgaṇā aparyasthāyino	ལེན་པ་མེད་པས་ཤིན་ཏུ་རྣམ་༄༤༠༧བ་པར་གྲོལ་བར་ཉོན་མོངས་པ་མེད་པ་། མངོན་པར་ཤེས་པ་རྣམས་ལ་ཐུག་པ་མེད་པར་གནས་པ་།
 'bhijñāsu amūlasthāyino 'saṅgācārikā anavalīnā gambhīreṣu dharmeṣvabhiyuktā na saṃsīdanti	རྩ་བ་མེད་པ་ལ་གནས་པ་། སེམས་ཆགས་པ་མེད་པ་། ཞུམ་པ་མེད་པ་། ཆོས་ཟབ་མོ་རྣམས་ལ་མངོན་པར་བརྩོན་པ་།
 dūranubodhabuddhajñānapraveśodgatā ekāyanamārgānuprāptā nirvicikitsāstīrṇakathaṃkathā	སྒྱིད་ལུག་པ་མེད་པ་། སངས་རྒྱས་ཀྱི་ཡེ་ཤེས་རྟོགས་པར་དཀའ་བ་ལ་འཇུག་པས་། འཕགས་པ་བགྲོད་པ་གཅིག་པུའི་ལམ་རྗེས་སུ་ཐོབ་པ་། ཐེ་ཚོམ་མེད་པ་། དོགས་པ་ལས་བརྒལ་པ༏་ཤེས་པ་གཞན་གྱི་དྲིང་ལ་མི་འཇོག་པ་།
 aparapratyayajñānā anadhimāninaḥ |	ལྷག་པའི་ང་རྒྱལ་མེད་པ་།
 sumerusamā jñānābhyudgatāḥ |	ཡེ་ཤེས་ཀྱིས་མངོན་པར་འཕགས་ཏེ་རི་རབ་དང་མཚུངས་པ་།
 sāgarasamā buddhyakṣobhyāḥ |	འཁྲུགས་པ་མེད་པའི་བློས་རྒྱ་མཚོ་དང་འདྲ་བ་།
 candrasūryaprabhātikrāntāḥ prajñābhayā pāṇḍarasuśuklaśuddhaśubhacittatayā ca | uttaptahemavarṇasadṛśā avabhāsanirbhāsatayā ca |	ཤེས་རབ་ཀྱི་འོད་དང་དཀར་ཞིང་ཤིན་ཏུ་དཀར་ལ་དག་ཅིང་དགེ་བའི་སེམས་དང་། གསེར་བཙོ་མའི་ཁ་དོག་འདྲ་བར་སྣང་ཞིང་འོད་འབྱུང་བའི་ཡོན་ཏན་གྱི་མཆོག་གིས་ཉི་ཟླའི་འོད་ལས་ཤིན་ཏུ་འདས་པ་།
 vasuṃdharāsadṛśāḥ sarvasattvaśubhāśubhakṣamaṇatayā |	སེམས་ཅན་ཐམས་ཅད་ཀྱི་དགེ་བ་དང་། མི་དགེ་བ་བཟོད་པས་ས་དང་མཚུངས་པ་།
 apsadṛśāḥ sarvakleśamūlanirdhāvanapravāhaṇatayā ca |	ཉོན་མོངས་པའི་དྲི་མ་འཁྲུ་བར་འབབ་པས་ཆུ་དང་འདྲ་བ་།
 agnirājasadṛśāḥ sarvadharmamanyanākleśanirdahanatayā |	ཆོས་ཐམས་ཅད་ལ་རློམ་སེམས་སུ་བྱེད་པ་དང་། ཉོན་མོངས་པ་སྲེག་པའི་ཕྱིར་མེའི་ཕུང་པོ་དང་མཚུངས་པ་།
 vāyusadṛśāḥ sarvalokāsañjanatayā |	འཇིག་རྟེན་ཐམས་ཅད་ལ་མི་ཆགས་པའི་ཕྱིར་རླུང་དང་འདྲ་བ་།
 ākāśasadṛśāḥ sarvadharmanairvedhikatayā sarvaśo niṣkiṃcanatayā ca |	ཆོས་ཐམས་ཅད་ངེས་པར་ཕིགས་པ་དང་ཐམས་ཅད་དུ་ཅི་ཡང་མེད་པའི་ཕྱིར་ནམ་མཁའ་དང་མཚུངས་པ་དང་། 
 (sukhv, vaidya 247) padmasadṛśāḥ sarvalokānupaliptatayā |	འཇིག་རྟེན་ཐམས་ཅད་ཀྱིས་མི་གོས་པའི་ཕྱིར་པདམ་དང་འདྲ་བ་།
 kālānusārimahāmeghasadṛśā dharmābhigarjanatayā |	ཆོས་དང་ཆོས་མ་ཡིན་པ་མངོན་པར་སྒྲོགས་པས་དུས་ཀྱི་རྗེས་སུ་འབྲང་བའི་༄༤༠༨ཨ་༌༎ འབྲུག་ཆེན་པོ་དང་མཚུངས་པ་།
 mahāvṛṣṭisadṛśā dharmasalilābhipravarṣaṇatayā |	ཆོས་ཀྱི་ཆུའི་ཆར་མངོན་པར་འབེབས་པས་ཆར་བ་ཆེན་པོ་དང་འདྲ་བ་།
 ṛṣabhasadṛśā mahāgaṇābhibhavanatayā |	ཚོགས་ཆེན་པོ་ཟིལ་གྱིས་གནོན་པས་ཁྱུ་མཆོག་དང་མཚུངས་པ་།
 mahānāgasadṛśāḥ paramasudāntacittatayā |	སེམས་ཤིན་ཏུ་མཆོག་ཏུ་དུལ་བས་གླང་པོ་ཆེ་ཆེན་པོ་དང་འདྲ་བ་།
 bhadrāśvājāneyasadṛśāḥ suvinītatayā |	ཤིན་ཏུ་དུལ་བས་རྟ་ཅང་ཤེས་བཟང་པོ་དང་མཚུངས་པ་།
 siṃhamṛgarājasadṛśā vikramavaiśāradyāsaṃtrastatayā | nyagrodhadrumarājasadṛśāḥ sarvasattvaparitrāṇatayā |	རྩལ་དང་མི་འཇིགས་པས་སྐྲག་པ་མེད་པའི་ཕྱིར་རི་དབ༹གས་ཀྱི་རྒྱལ་པོ་སེང་གེ་དང་འདྲ་བ་། སེམས་ཅན་ཐམས་ཅད་ཡོངས་སུ་སྐྱོད་པས་ཤིང་གི་རྒྱལ་པོ་ནྱ་གྲོ་ད་དང་མཚུངས་པ་།
 parvatarājasadṛśāḥ sarvaparapravādyakampanatayā |	ཕས་ཀྱི་རྒོལ་བ་ཐམས་ཅད་ཀྱིས་མི་ག-ཡོས་པས་རིའི་རྒྱལ་པོ་རི་རབ་དང་འདྲ་བ་།
 gaganasadṛśā aparimāṇamaitrīprabhāvanatayā |	བྱམས་པ་ཚད་མེད་པ་བསྒོམས་པས་ནམ་མཁའ་དང་མཚུངས་པ་།
 mahābrahmasamāḥ sarvakuśalamūladharmādhipatyapūrvaṃgamatayā | pakṣisadṛśā asaṃnicayasthānatayā |	དགེ་བའི་ཆོས་ཐམས་ཅད་ཀྱི་དབང་དུ་བྱ་བའི་སྔོན་དུ་འགྲོ་བས་ཚངས་པ་ཆེན་པོ་དང་འདྲ་བ༏་གནས་སུ་གསོག་པ་མེད་པས་བྱ་དང་མཚུངས་པ་། 
 garuḍadvijarājasadṛśāḥ sarvaparapravādividhvaṃsanatayā |	ཕས་ཀྱི་རྒོལ་བ་ཐམས་ཅད་རྣམ་པར་འཇོམས་པས་བྱའི་རྒྱལ་པོ་ནམ་མཁའི་ལྡིང་དང་འདྲ་པ་། བ་། 
 udumbarapuṣpasadṛśā durlabhāpratyarthitayā |	འབྱུང་བར་དཀའ་བའི་ཕྱིར་ཨཽ་དུམ་ཝ་རའི་མེ་ཏོག་དང་མཚུངས་པ་།
 nāgavatsusamāhitā avikṣiptājihmendriyatayā |	གླང་པོ་ཆེ་ལྟར་ཤིན་ཏུ་མཉམ་པར་བཞགས་པས་རྣམ་པར་ག-ཡེང་བ་མེད་པ་། དབང་པོ་རྨུགས་པ་མེད་པ་།
 viniścayakuśalāḥ kṣāntisaurabhyabahulāḥ |	རྣམ་པར་གཏན་ལ་འབེབས་པ་ལ་མཁས་པ་། བཟོད་པ་དང་དེས་པ་མང་བ་།
 anīrṣukāḥ parasaṃpattyaprārthanatayā |	ཕ་རོལ་ཕུན་སུམ་ཚོགས་པར་སྨོན་པས་ཕྲག་དོག་མེད་པ་། ཆོས་ཀྱི་གཏམ་རྣམས་ལ་འཇིགས་པ་མེད་པ་།
 viśāradā dharmakathā svatṛptā dharmaparyeṣṭayā |	ཆོས་ཡོངས་སུ་ཚོལ་བས་ངོམས་མི་༄༤༠༨བ་མྱོང་བ་།
 vaiḍūryasadṛśāḥ śīlena |	ཚུལ་ཁྲིམས་ཀྱིས་བེཨེ་དའུརྱ་དང་འདྲ་བ་།
 ratnākarāḥ śrutena |	ཐོས་པ་རིན་པོ་ཆེའི་འབྱུང་གནས་དང་མཚུངས་པ་།
 mañjusvarā mahādharmadundubhinirghoṣeṇa |	ཆོས་ཀྱི་རྔ་སྒྲ་ཆེན་པོས་སྒྲ་སྙན་པ་། ཆོས་ཀྱི་རྔ་ཆེན་པོ་བརྡུང་བ་། ཆོས་ཀྱི་དུང་ཆེན་པོ་འབུད་པ་།
 mahādharmabherīṃ parāghnanto mahādharmaśaṅkhamāpūrayanto mahādharmadhvajamucchrāpayanto	ཆོས་ཀྱི་རྒྱལ་མཚན་ཆེན་པོ་བསྒྲེང་བ་། ཆོས་ཀྱི་བ་དན་ཆེན་པོ་འཛིན་པ་། ཆོས་ཀྱི་སྒྲོན་མ་ཆེན་པོ་རབ་ཏུ་འབར་བར་བྱེད་པ་།
 dharmolkāṃ prajvālayantaḥ prajñāvilokino 'saṃmūḍhā nirdoṣāḥ śāntakhilāḥ śuddhā nirāmagandhā	ཤེས་རབ་ཀྱིས་རྣམ་པར་ལྟ་བ་རྨོངས་པ་མེད་པ་། ཞེ་སྡང་མེད་པ་། ཐ་བ་བཏུལ་བ་། དག་པ་། དྲིང་བ་མེད་པ་། བརྐམ་པ་མེད་པ་།
 alubdhāḥ saṃvibhāgaratā muktatyāgāḥ prasṛtapāṇayo dānasaṃvibhāgaratā dharmāmiṣābhyāṃ	ཡང་དག་པར་འགེང་བ་ལ་དགའ་བ་། གཏོང་བ་བཏང་བ་། སྦྱིན་པ་ལ་ལག་བརྐྱང་བ་། ཆོས་དང་ཟང་ཟིང་ཡང་དག་པར་འགྱེད་པ་ལ་དགའ་བ་སྦྱིན་པ་ལ་སེར་སྣ་མེད་པ་། འདྲེས་པ་མེད་པ་། ཡིད་འཇིགས་པ་མེད་པ་། ཆགས་པ་མེད་པ་། བརྟན་པ་། དཔའ་བ་། གཅེས་པར་འཛིན་པ་། མོས་པ་དང་ལྡན་པ་།
 dāne 'matsariṇo 'saṃsṛṣṭā urtrastamānasā viraktā dhīrā dhaureyā dhṛtimanto hrīmantaḥ	ངོ་ཚ་ཤེས་པ་དང་ལྡན་པ་། ཟུག་རྔུ་ཕྱུང་བ༏་གཏན་པ་མེད་པ་། མངོན་པར་ཤེས་པ་ཐོབ་པ་། དེས་པ་།
 suvyūḍhasattvā nirgāḍhāḥ prāptābhijñāḥ suratāḥ sukhasaṃvāsā arthakarā lokapradyotā	འགྲོགས་ན་བདེ་བ་། དོན་བྱེད་པ་། འཇིག་རྟེན་གསལ་བར་བྱེད་པ་། འདྲེན་པ་།
 nāpadāgantuṃ dhīrā rāgaṃ tamaḥ pranekasvaṣṭhaḥ(?)	དགའ་བའི་འདོད་ཆགས་དང་། རྗེས་སུ་ཆགས་པ་དང་། ཁོང་ཁྲོ་བ་སྤངས་པ་། དག་པ་།
 śokāpagatā nirmalā nimeṣaprahīṇā vikrīḍitābhijñā hetubalikāḥ praṇidhānabalikā ajihmā	མྱ་ངན་དང་བྲལ་བ་། དྲི་མ་མེད་པ་། དྲི་མ་གསུམ་སྤངས་པ་། མངོན་པར་ཤེས་པས་རྣམ་པར་བརྩེན་པ་། རྒྱུའི་སྟོབས་ཅན་། སྨོན་ལམ་གྱི་སྟོབས་ཅན་། མི་དམན་པ་། གྱ་གྱུ་མེད་པ་།
 akuṭilā ete lakṣakoṭīniyutaśatasahasrāvaropitakuśalamūlā utpāṭitamānaśalyā apagatarāgadveṣamohāḥ	སངས་རྒྱས་བྱེ་བ་ཁྲག་ཁྲིག་བརྒྱ་སྟོང་ཕྲག་མང་པོ་ལ་དགེ་བའི་རྩ་བ་བསྐྱེད་པ་། ང་རྒྱལ་གྱི་ཟུག་རྔུ་བཏོན་པ་། འདོད་ཆགས་དང་། ཞེ་སྡང་དང་། གཏི་མུག་དང་བྲལ་བ་། དག་པ་། དགེ་༄༤༠༩ཨ་༌༎ བ་ལ་མོས་པ་། རྒྱལ་བ་། དམ་པས་བསྔགས་པས་འཇིག་རྟེན་ན་མཁས་པ་། སྦྱངས་པའི་ཡེ་ཤེས་ཡང་དག་པར་བསྒྲུབས་པ་།
 śuddhāḥ śuddhādhimuktā jinabalapraśastā lokapaṇḍitā uttaptajñānasamudāgatā jinasutāścittaudbilyasamanvāgatāḥ śūrā dṛḍhā amamā akhilā atulā arajaskāḥ sahitā udārā ṛṣabhā hrīmanto dhṛtimantaḥ	རྒྱལ་བས་བསྟོད་པ་། སེམས་དགའ་བ་དང་ལྡན་པ་། རྟུལ་ཕོད་པ་། སྲན་ཐུབ་པ་། མཉམ་པ་མེད་པ་། ཐ་བ་མེད་པ་། གཞལ་དུ་མེད་པ་། རྡུལ་མེད་པ་། འདུས་པ་རྒྱ་ཆེ་བ་། ཁྱུ་མཆོག་ཏུ་གྱུར་པ་། བདེན་པ་སྨྲ་བ་། བློ་དང་ལྡན་པ་། དྲན་པ་དང་ལྡན་པ་། བློ་གྲོས་དང་ལྡན་པ་། རྟོགས་པ་དང་ལྡན་པ་།
 smṛtimanto matimanto gatimantaḥ prajñāśastrapraharaṇā puṇyavanto dyutimanto vyapagatakhilā	ཤེས་རབ་ཀྱི་མཚོན་ཆའི་ལག་ཆ་ཅན་། བསོད་ནམས་དང་ལྡན་པ་། འོད་དང་ལྡན་པ་།
 malaprahīṇāḥ smṛtiyuktāḥ śāntajñānālambhāḥ |	ཐ་བ་དང་། དྲི་མ་དང་། ཁོང་ཁྲོ་བ་དང་བྲལ་བ་། ཆོས་ལ་རྟག་ཏུ་བརྩོན་པ་། ཆོས་ཐམས་ཅད་ལ་ཐོས་བརྒྱ་མཚོ་ལྟ་བུར་གྱུར་པ་ཤ་སྟག་གོ་། ཀུན་དགའ་བོ་།
 īdṛśā ānanda tasmin buddhakṣetre sattvāḥ saṃkṣiptena ca | vistareṇa punaḥ sacetkalpakoṭīniyutaśatasahasrasthitikenāpyāyuṣpramāṇena tathāgatā nirdiśyeran, naiva śakyaṃ teṣāṃ satpuruṣāṇāṃ guṇaparyantamadhigantum,	མདོར་བསྡུ་ན་སངས་རྒྱས་ཀྱི་ཞིང་དེའི་བྱང་ཆུབ་སེམས་དཔའ་རྣམས་ནི་འདི་ལྟ་བུ་ཤ་སྟག་སྟེ་། རྒྱས་པར་བྱ་ན་གལ་ཏེ་དེ་བཞིན་གཤེགས་པ་ཚེའི་ཚད་བསྐལ་པ་བྱེ་བ་ཁྲག་ཁྲིག་བརྒྱ་སྟོང་དུ་གནས་པས་བསྟན་ཀྱང་སྐྱེས་བུ་དམ་པ་དེ་དག་གི་ཡོན་ཏན་གྱི་མཐའ་བསྟན་པ་མི་། ནུས་ལ་། 
 na ca tathāgatasya vaiśāradyopacchedo bhavet |	དེ་བཞིན་གཤེགས་པའི་མི་འཇིགས་པ་ཡང་རྒྱུན་ཆད་པར་མི་འགྱུར་རོ་༎
 tatkasya hetoḥ?	དེ་ཅིའི་ཕྱིར་ཞེ་ན་། ཀུན་དགའ་བོ་། འདི་ལྟ་སྟེ་།
 ubhayamapyeva ānanda acintyamatulyaṃ yadidaṃ teṣāṃ bodhisattvānāṃ guṇāstathāgatasya cānuttaraprajñāpratibhānam || sukhv_38 || start sukhv 39:	བྱང་ཆུབ་སེམས་དཔའ་དེ་དག་གི་ཡོན་ཏན་རྣམས་དང་། དེ་བཞིན་གཤེགས་པའི་ཤེས་རབ་ཀྱི་སྤོབས་པ་བླ་ན་མེད་པ་དེ་གཉིས་ཀ་ཡང་བསམ་གྱིས་མི་ཁྱབ་ཅིང་མཚུངས་པ་མེད་པའི་ཕྱིར་རོ་༎
 api cānanda uttiṣṭha,	ཀུན་དགའ་བོ་།
 paścānmukhībhūtvā puṣpāvakīrṇāñjalīṃ pragṛhya praṇipata |	ལོངས་ལ་ནུབ་༄༤༠༩བ་ཕྱོགས་སུ་ཕྱོགས་ཏེ་མེ་ཏོག་གཏོར་ལ་ཐལ་མོ་སྦྱོར་ཏེ་།
 eṣā sā dig yatra sa bhagavānamitābhastathāgato 'rhan samyaksaṃbuddhastiṣṭhati dhriyate yāpayati,	གང་ན་བཅོམ་ལྡན་འདས་དེ་བཞིན་གཤེགས་པ་དགྲ་བཅོམ་པ་ཡང་དག་པར་རྫོགས་པའི་སངས་རྒྱས་འོད་དཔག་མེད་རྡུལ་མེད་ཅིང་རྣམ་པར་དག་པ་བཞུགས་ཤིང་འཚོ་ལ་གཞེས་ཤིང་ཆོས་ཀྱང་སྟོན་པའི་ཕྱོགས་དེར་ཕྱག་འཚོལ་ཅིག་།
 dharmaṃ ca deśayati virajo viśuddhaṃ yasya tannāmadheyamanāvaraṇe daśadiśi loke vighuṣṭam	དེའི་མཚན་དེ་ཡང་སྒྲིབ་པ་མེད་པར་ཕྱོགས་བཅུར་གྲགས་ཏེ་།
 ekaikasyāṃ diśi gaṅgānadīvālukāsamā buddhā bhagavanto varṇayanti stuvanti praśaṃsantyasakṛdasakṛdasaṅgavācāprativākyāḥ |	ཕྱོགས་རེ་རེ་ན་ཡང་སངས་རྒྱས་བཅོམ་ལྡན་འདས་གསུང་ཆགས་པ་མི་མངའ་ཞིང་གསུང་ཐོགས་པ་མི་མངའ་བ་གངགའའི་ཀླུང་གི་བྱེ་མ་སྙེད་དག་ལན་འགའ་ལན་འགའ་མ་ཡིན་པར་བསྔགས་པ་བརྗོད་ཅིང་བསྟོད་དེ་སྙན་བ་གསུང་ངོ་༎
 evamukte āyuṣmānānando bhagavantametadavocat - icchāmyahaṃ bhagavaṃstamamitābhamamitaprabhamamitāyuṣaṃ tathāgatamarhantaṃ samyaksaṃbuddhaṃ draṣṭum,	དེ་སྐད་ཅེས་བཀའ་སྩལ་བ་དང་། བཅོམ་ལྡན་འདས་ལ་ཚེ་དང་ལྡན་པ་ཀུན་དགའ་བོས་འདི་སྐད་ཅེས་གསོལ་ཏོ་༎ བཅོམ་ལྡན་འདས་། བདག་དེ་བཞིན་གཤེགས་པ་དགྲ་བཅོམ་པ་ཡང་དག་པར་རྫོགས་པའི་སངས་རྒྱས་འོད་དཔག་ཏུ་མེད་པ་དེ་དང་། 
 tāṃśca bodhisattvān mahāsattvān bahubuddhakoṭīniyutaśatasahasrāvaropitakuśalamūlān |	ཚེ་དཔག་ཏུ་མེད་པ་དེ་དང་། བྱང་ཆུབ་སེམས་དཔའ་སེམས་དཔའ་ཆེན་པོ་སངས་རྒྱས་བྱེ་བ་ཁྲག་ཁྲིག་བརྒྱ་སྟོང་མང་པོ་ལ་དགེ་བའི་རྩ་བ་བསྐྲུན་པ་དེ་དག་ལ་ལྟ་འཚལ་ལོ་༎ 
 samanantarabhāṣitā āyuṣmatānandeneyaṃ (sukhv, vaidya 248)	ཚེ་དང་ལྡན་པ་ཀུན་དགའ་བོས་ཚིག་འདི་སྨྲས་མ་ཐག་ཏུ་དེ་ནས་དེའི་མོད་ལ་ལོ་༎ 
 vāk, atha tāvadeva so 'mitābhastathāgato 'rhan samyaksaṃbuddhaḥ svapāṇitalāttathārūpaṃ raśmiṃ prāmuñcadyadidaṃ koṭīniyutaśatasahasratamaṃ buddhakṣetraṃ mahatāvabhāsena sphuṭamabhūt |	། དེ་བཞིན་གཤེགས་པ་དགྲ་བཅོམ་པ་ཡང་དག་པར་རྫོགས་པའི་སངས་རྒྱས་དེའི་ཕྱག་གི་མཐིལ་ནས་འོད་གང་གིས་སངས་རྒྱས་ཀྱི་ཞིང་བྱེ་བ་བརྒྱ་སྟོང་སྣང་བས་ཁྱབ་པར་འགྱུར་བ་དེ་ལྟ་བུའི་འོད་ཕྱུང་ངོ་༎
 tena khalu punaḥ samayena sarvatra koṭīśatasahasrabuddhakṣetrāṇāṃ ye kecitkālaparvatā	དེའི་ཚེ་སངས་རྒྱས་ཀྱི་ཞིང་བྱེ་བ་བརྒྱ་སྟོང་ཐམས་ཅད་༄༤༡༠ཨ་༌༎ ནི་རི་ནག་པོའམ་། རིན་པོ་ཆེའི་རིའམ་། ལྷུན་པོའམ་།
 vā ratnaparvatā vā merumahāmerumucilindamahāmucilindacakravālamahācakravālā vā citayo	ལྷུན་པོ་ཆེན་པོའམ་། བཏང་བཟུང་ངམ་། བཏང་བཟུང་ཆེན་པོའམ་། ཁོར་ཡུག་གམ་། ཁོར་ཡུག་ཆེན་པོའམ་། རྩིག་པའམ་། ཀ་བའམ་།
 vā stambhā vā vṛkṣagahanodyānavimānāni divyamanuṣyakāṇi,	ཤིང་ལྗོན་པ་སྟུག་པོའམ་། སྐྱེད་མོས་ཚལ་ལམ་། གཞལ་མེད་ཁང་ངམ་།
 tāni sarvāṇi tasya tathāgatasya tayā prabhayābhinirbhinnānyabhūvan samabhibhūtāni |	ལྷ་དང་མི་གང་སུ་དག་ཡོད་པ་དེ་དག་ཐམས་ཅད་ལས་དེ་བཞིན་གཤེགས་པ་འོད་དཔག་མེད་དེའི་འོད་ཀྱིས་ཐལ་བར་གྱུར་ཅིང་ཟིལ་གྱིས་ནོན་པར་གྱུར་ཏོ་༎ 
 tadyathāpi nāma puruṣo vyāmamātrake 'nvito dvitīyaṃ puruṣaṃ pratyavekṣedāditye 'bhyudgate,	འདི་ལྟ་སྟེ་། དཔེར་ན་། ཉི་མ་ཤར་ནས་མི་ཞིག་འོད་མ་གང་ཙམ་ན་འདུག་པ་ལ་མི་ཞིག་བལྟ་བ་དེ་བཞིན་དུ༏་དེའི་ཚེ་འདི་ལྟ་སྟེ་།
 evamevāsmin buddhakṣetre bhikṣubhikṣuṇyupāsakopāsikādevanāgayakṣarākṣasagandharvāsuragaruḍakinnaramahoragamanuṣyāmanuṣyāśca	སངས་རྒྱས་ཀྱི་མཐུ་དང་། འོད་དེ་ཡོངས་སུ་དག་པའི་ཕྱིར་དགེ་སློང་དང་། དགེ་སློང་མ་དང་། དགེ་བསྙེན་དང་། དགེ་བསྙེན་མ་དག་དང་། ལྷ་དང་། ཀླུ་དང་། གནོད་སྦྱིན་དང་། དྲི་ཟ་དང་། ལྷ་མ་ཡིན་དང་། ནམ་མཁའ་ལྡིང་དང་། མིའམ་ཅི་དང་། ལྟོ་འཕྱེ་ཆེན་པོ་དང་། མི་དང་། མི་མ་ཡིན་པ་དག་སངས་རྒྱས་ཀྱི་ཞིང་འདི་ནས་།
 tasyāṃ velāyāmadrākṣustamamitābhaṃ tathāgatamarhantaṃ samyaksaṃbuddhaṃ sumerumiva parvatarājaṃ sarvakṣetrābhyudgataṃ sarvā diśo 'bhibhūya bhāsamānaṃ tapantaṃ virocamānaṃ vibhrājamānam,	དེ་བཞིན་གཤེགས་པ་དགྲ་བཅོམ་པ་ཡང་དག་པར་རྫོགས་པའི་སངས་རྒྱས་འོད་དཔག་མེད་རིའི་རྒྱལ་པོ་རི་རབ་ལྟར་སངས་རྒྱས་ཀྱི་ཞིང་ཐམས་ཅད་ནས་མངོན་པར་འཕགས་ཏེ་།
 taṃ ca mahāntaṃ bodhisattvagaṇaṃ taṃ ca bhikṣusaṃghaṃ yadidaṃ buddhānubhāvena tasyāḥ prabhāyāḥ pariśuddhatvāt |	ཕྱོགས་ཐམས་ཅད་ཟིལ་གྱིས་མནན་ནས་ལྷ་མ་མེ་ལྷན་ནེ་ལྷང་ངེར་མཛེས་པ་དེ་དང་། བྱང་ཆུབ་སེམས་དཔའི་ཚོགས་ཆེན་པོ་དང་། དགེ་སློང་གི་དགེ་འདུན་དེ་ལ་བལྟའོ་༎ འདི་ལྟ་སྟེ་།
 tadyatheyaṃ mahāpṛthivī ekodakajātā bhavet,	དཔེར་ན་། ས་ཆེན་པོ་འདི་ཆུ་༄༤༡༠བ་གཅིག་ཏུ་གྱུར་ན་། དེ་ལ་ཤིང་ལྗོན་པ་རྣམས་མེད་། རི་རྣམས་མེད་། གླིང་རྣམས་མེད་།
 tatra na vṛkṣā na parvatā na dvīpā na tṛṇagulmauṣadhivanaspatayo na nadīśvabhraprapātāḥ prajñāpayeran,	རཙབ༹་དང་ཤིང་གེལ་བ་དང་། སྨན་དང་། ནགས་ཚལ་རྣམས་མེད་། ཆུ་ཀླུང་རྣམས་མེད་ཅིང་། ངམ་གྲོག་དང༏་ག-ཡང་ས་རྣམས་མི་སྣང་སྟེ་།
 anyatraikārṇavībhūtā mahāpṛthivyekā syāt,	གཞན་དུ་ན་ས་ཆེན་པོ་རྒྱ་མཚོ་གཅིག་ཏུ་གྱུར་པ་ནི་མ་གཏོགས་སོ་༎
 evameva tasmin buddhakṣetre nāstyanyatkiṃcilliṅgaṃ vā nimittaṃ vā anyatraiva vyāmaprabhāḥ śrāvakāste ca yojanakoṭīśatasahasraprabhā bodhisattvāḥ	དེ་བཞིན་དུ་སངས་རྒྱས་ཀྱི་ཞིང་དེ་ན་ཉན་ཐོས་རྣམས་ཀྱི་ལུས་ལས་མངོན་པར་འགྲུབ་པའི་འོད་འདོམ་གང་བ་དང་། བྱང་ཆུབ་སེམས་དཔའ་རྣམས་ཀྱི་འོད་དཔག་ཚད་བྱེ་བ་བརྒྱ་སྟོང་ཡོད་པ་མ་གཏོགས་པར་གཞན་རྟགས་སམ་། མཚན་མ་ཅུང་ཟད་མེད་དོ་༎ བཅོམ་ལྡན་འདས་།
 sa ca bhagavānamitābhastathāgato 'rhan samyaksaṃbuddhastaṃ ca śrāvakagaṇaṃ taṃ ca bodhisattvagaṇamabhibhūya sarvā diśaḥ prabhāsayan saṃdṛśyate tena khalvapi samayena tasyāṃ sukhāvatyāṃ lokadhātau bodhisattvāḥ śrāvakadevamanuṣyāśca sarve te imāḥ sahālokadhātuṃ śākyamuniṃ ca tathāgatamarhantaṃ samyaksaṃbuddhamarhatā bhikṣusaṃghena parivṛtaṃ paśyanti sma dharmaṃ deśayantam || sukhv_39 || start sukhv 40:	དེ་བཞིན་གཤེགས་པ་དགྲ་བཅོམ་པ་ཡང་དག་པར་རྫོགས་པའི་སངས་རྒྱས་འོད་དཔག་མེད་དེས་ཉན་ཐོས་ཀྱི་ཚོགས་དེ་དང་། བྱང་ཆུབ་སེམས་དཔའི་ཚོགས་དེ་ཟིལ་གྱིས་མནན་ནས་ཕྱོགས་ཐམས་ཅད་དུ་གསལ་བར་ཀུན་དུ་སྣང་ངོ་༎ དེའི་ཚེ་འཇིག་རྟེན་གྱི་ཁམས་བདེ་བ་ཅན་དེར་བྱང་ཆུབ་སེམས་དཔའ་དང་། ཉན་ཐོས་དང་། རང་སངས་རྒྱས་ཐམས་ཅད་དང་། ལྷ་དང་། མི་དེ་དག་ཐམས་ཅད་དང་། འཇིག་རྟེན་གྱི་ཁམས་མི་མཇེད་འདི་དང་། དེ་བཞིན་གཤེགས་པ་ཤའཀྱ་ཐུབ་པ་དགེ་སློང་གི་དགེ་འདུན་ཆེན་པོས་བསྐོར་ཞིང་ཆོས་སྟོན་པ་ཡང་སྣང་ངོ་༎ 
 tatra khalu bhagavānajitaṃ bodhisattvaṃ mahāsattvamāmantrayate sma - paśyasi tvamajita amuṣmina buddhakṣetre guṇālaṃkāravyūhasaṃpadam?	དེ་ནས་བཅོམ་ལྡན་འདས་ཀྱིས་བྱང་ཆུབ་སེམས་དཔའ་སེམས་དཔའ་ཆེན་པོ་མི་ཕམ་པ་ལ་བཀའ་སྩལ་པ་། མི་འཕམ་པོ་ཁྱོད་ཀྱིས་སངས་རྒྱས་ཀྱི་ཞིང་དེའི་ཡོན་ཏན་གྱི་རྒྱན་བཀོད་པ་ཕུན་སུམ་ཚོགས་པ་འདི་དང་། 
 upariṣṭāccāntarīkṣe ārāmaramaṇīyānyudyānaramaṇīyāni nadīpuṣkariṇīramaṇīyāni nānāratnapadmotpalakumudapuṇḍarīkākīrṇāni?	༄༤༡༡ཨ་༌༎ སྟེང་གི་པར་སྣང་ལ་ཀུན་དགའི་ར་མཉམ་དགའ་བ་དག་དང་། ནགས་ཚལ་ཉམས་དགའ་བ་དག་དང་། སྐྱེད་མོས་ཚལ་ཉམས་དགའ་བ་དག་དང་། ཆུ་ཀླུང་དང་། རྫིང་བུ་ཉམས་དགའ་བ་དག་དང་། རིན་པོ་ཆེའི་མེ་ཏོག་པདམ་དང་། ཀུ་མུ་ད་དང་། པདམ་དཀར་པོས་གང་བ་དག་དང་། འོག་ཏུ་སའི་སྟེང་ནས་བཟུང་སྟེ་།
 adhastācca dharaṇītalamupādāya yāvadakaniṣṭhabhavanādgaganatalaṃ puṣpābhikīrṇaṃ puṣpāvalisamupaśobhitaṃ nānāratnastambapaṅktiparisphuṭaṃ tathāgatābhinirmitanānādvijasaṃghaniṣevitam?	འོག་མིན་གྱི་གནས་ཀྱི་བར་གྱི་ནམ་མཁའི་ངོས་ལ་མེ་ཏོག་བཀྲམ་པ་དང་། མེ་ཏོག་གི་ཕྲེང་བ་སྐུན་དུ་མཛེས་པར་བྱས་པ་དང་། རིན་པོ་ཆེ་སྣ་ཚོགས་བཀྲ་བའི་ཕྲེང་གིས་གང་བ་དང་། དེ་བཞིན་གཤེགས་པས་སྤྲུལ་པའི་བྱ་སྣ་ཚོགས་ཀྱིས་བསྟེན་པ་མཐོང་ངམ་།
 ajito bodhisattva āha - paśyāmi bhagavan |	གསོལ་པ་། བཅོམ་ལྡན་འདས་། མཐོང་ལགས་སོ་༎
 bhagavānāha - paśyasi punastvamajita etānamarān dvijasaṃghān sarvabuddhakṣetraṃ buddhasvareṇābhivijñāpayantaṃ yenaite bodhisattvā nityamavirahitā	བཅོམ་ལྡན་འདས་ཀྱིས་བཀའ་སྩལ་པ་། མི་ཕམ་པ་ཁྱོད་ཀྱིས་འདི་ལས་གཞན་པའི་བྱའི་ཚོགས་སངས་རྒྱས་ཀྱི་ཞིང་ཐམས་ཅད་སྒྲས་གོ་བར་བྱེད་ཅིང་། དེས་བྱང་ཆུབ་སེམས་དཔའ་དེ་དག་རྟག་ཏུ་སངས་རྒྱས་རྗེས་སུ་དྲན་པ་དང་མི་འབྲལ་བར་གྱུར་པ་དག་མཐོང་ངམ་།
 ajita āha - paśyāmi bhagavan |	གསོལ་པ་། བཅོམ་ལྡན་འདས་། མཐོང་ལགས་སོ་༎
 bhagavānāha - paśyasi punastvamajita atra buddhakṣetre 'mūn sattvān yojanaśatasahasrikeṣu vimāneṣvabhirūḍhānantarīkṣe sasatkārān krāmantaḥ?	བཅོམ་ལྡན་འདས་ཀྱིས་བཀའ་སྩལ་པ་། མི་ཕམ་པ་ཁྱོད་ཀྱིས་སངས་རྒྱས་ཀྱི་ཞིང་འདི་ན་སེམས་ཅན་འདི་དག་གཞལ་མེད་ཁང་དཔག་ཚད་བརྒྱ་སྟོང་ཡོད་པ་དག་ཏུ་ཞུགས་ཏེ་། བར་སྣང་ལ་ཆགས་པ་མེད་པར་འགྲོ་བ་དག་མཐོང་ངམ་།
 ajita āha - paśyāmi bhagavan |	གསོལ་པ་། བཅོམ་ལྡན་འདས་། མཐོང་ལགས་སོ་། བཅོམ་ལྡན་འདས་ཀྱིས་༄༤༡༡བ་། བཀའ་སྩལ་པ་།
 bhagavānāha - tatkiṃ manyase ajita asti kiṃcinnānātvaṃ devānāṃ paranirmitavaśavartināṃ sukhāvatyāṃ lokadhātau manuṣyāṇāṃ vā?	མི་ཕམ་པ་། འདི་ཇི་སྙམ་དུ་སེམས་། གཞན་འཕྲུལ་དབང་བྱེད་ཀྱི་ལྷ་རྣམས་དང་། འཇིག་རྟེན་གྱི་ཁམས་བདེ་བ་ཅན་དུ་སྐྱེས་པའི་མི་རྣམས་ཐ་དད་དུ་བྱ་བ་ཡོད་དམ་། གསོལ་པ་།
 ajita āha - ekamapyahaṃ bhagavan nānātvaṃ na samanupaśyāmi yāvanmaharddhikā atra sukhāvatyāṃ lokadhātau manuṣyāḥ |	བཅོམ་ལྡན་འདས་། བདག་གིས་ནི་ཐ་དད་དུ་བགྱི་བ་གཅིག་ཀྱང་ཡང་དག་པར་རྗེས་སུ་མ་མཐོང་སྟེ་། འཇིག་རྟེན་གྱི་ཁམས་བདེ་བ་ཅན་དེའི་མི་རྣམས་ནི་རྫུ་འཕྲུལ་ཆེ་བའི་བར་དུ་ལགས་སོ་༎
 bhagavānāha - paśyasi punastvamajita tatra sukhāvatyāṃ lokadhātāveteṣāṃ manuṣyāṇāmudāreṣu padmeṣu garbhāvāsam?	བཅོམ་ལྡན་འདས་ཀྱིས་བཀའ་སྩལ་པ་། མི་ཕམ་པ་ཁྱོད་ཀྱིས་འཇིག་རྟེན་གྱི་ཁམས་བདེ་བ་ཅན་དེ་ན་མི་ཁ་ཅིག་པདམ་ཆེན་པོ་དག་གི་མངལ་ན་གནས་པ་མཐོང་ངམ་། གསོལ་པ་། བཅོམ་ལྡན་འདས་།
 āha - tadyathāpi nāma devāstrāyastriṃśā devā yāmā vā pañcāśadyojanikeṣu vā (sukhv, sukhv, vaidya 249)	འདི་ལྟ་སྟེ་། དཔེར་ན་། སུམ་ཅུ་རྩ་གསུམ་དང་། འཐབ་བྲལ་གྱི་ལྷ་རྣམས་གཞལ་མེད་ཁང་དཔག་ཚད་ལྔ་བཅུ་པའམ་།
 yojanaśatikeṣu vā pañcayojanaśatikeṣu vā vimāneṣu praviṣṭāḥ krīḍanti ramanti paricārayanti,	དཔག་ཚད་བརྒྱ་པའམ་། དཔག་ཚད་ལྔ་བརྒྱ་པ་རྣམས་སུ་ཞུགས་ཏེ་། རྩེ་དགའ་ཞིང་དགའ་མགུར་སྤྱོད་པ་དེ་བཞིན་དུ་།
 evamevāhaṃ bhagavan atra sukhāvatyāṃ lokadhātāveteṣāṃ manuṣyāṇāmudāreṣu padmeṣu garbhāvāsaṃ paśyāmi || sukhv_40 || start sukhv 41:	བཅོམ་ལྡན་འདས་། བདག་གིས་འཇིག་རྟེན་གྱི་ཁམས་བདེ་བ་ཅན་དེའི་མི་ཁ་ཅིག་པདམ་ཆེན་པོ་དག་གི་མངལ་ན་གནས་པར་མཐོང་ལགས་སོ་༎
 santi khalu punaratra bhagavan sattvā ya aupapādukāḥ padmeṣu paryaṅkaiḥ prādurbhavanti |	བཅོམ་ལྡན་འདས་། དེ་ན་སེམས་ཅན་བརྫུས་ཏེ་འབྱུང་བ་གང་དག་པདམ་རྣམས་ལ་སྐྱིལ་མོ་ཀྲུང་བཅས་ཏེ་འབྱུང་བ་དག་ཀྱང་མཆིས་ན་། བཅོམ་ལྡན་འདས་།
 tatko 'tra bhagavan hetuḥ kaḥ pratyayo yadanye garbhāvāsaṃ prativasanti, anye punaraupapādukāḥ padmeṣu paryaṅkaiḥ prādurbhavanti?	ཁ་ཅིག་པདམའི་མངལ་ན་གནས་པ་དང་། ཁ་ཅིག་པདམ་ལ་སྐྱིལ་མོ་ཀྲུང་བཅས་ནས་བརྫུས་ཏེ་འབྱུང་བ་དེའི་རྒྱུ་ནི་གང་ལགས་། རྐྱེན་ནི་གང་ལགས་། བཅོམ་ལྡན་འདས་ཀྱིས་བཀའ་སྩལ་པ་།
 bhagavānāha - ye te ajita bodhisattvā anyeṣu buddhakṣetreṣu sthitāḥ sukhāvatyāṃ lokadhātāvupapattaye vicikitsāmutpādayanti,	མི་ཕམ་པ་། བྱང་ཆུབ་སེམས་དཔའ་གང་༄༤༡༢ཨ་༌༎ དག་སངས་རྒྱས་ཀྱི་ཞིང་གཞན་དག་ན་གནས་ཏེ་།
 tena cittena kuśalamūlānyavaropayanti, teṣāmatra garbhāvāso bhavati | ye punarnirvicikitsāmutpādya cchinnakāṅkṣāḥ sukhāvatyāṃ lokadhātāvupapattaye kuśalamūlānyavaropayanti,	ཐོ་ཚོམ་དུ་ལྷུང་བའི་སེམས་ཀྱི་འཇིག་རྟེན་གྱི་ཁམས་བེ་བ་ཅན་དུ་སྐྱེ་བ་བྱ་བའི་ཕྱིར་དགེ་བའི་རྩ་བ་རྣམས་བསྐྱེད་པ་དེ་དག་ནི་དེ་ན་མངལ་ན་གནས་སོ་༎ གང་དག་ཐེ་ཚོམ་མེད་ཅིང་སོམ་ཉི་མ་མེད་དེ་།
 buddhānāṃ bhagavatāmasaṅgajñānamevākalpayanti abhiśraddadhati adhimucyante, te aupapādukāḥ padmeṣu paryaṅkaiḥ prādurbhavanti |	འཇིག་རྟེན་གྱི་ཁམས་བདེ་བ་ཅན་དུ་སྐྱེ་བར་བྱ་བའི་ཕྱིར་དགེ་བའི་རྩ་བ་རྣམས་བསྐྱེད་ལ་སངས་རྒྱས་བཅོམ་ལྡན་འདས་རྣམས་ཀྱི་ཡེ་ཤེས་ཆགས་པ་མེད་པ་ལ་ཡིད་ཆེས་ཤིང་དད་ལ་མོས་པ་དེ་དག་ནི་པདམ་རྣམས་ལ་སྐྱིལ་མོ་ཀྲུང་བཅས་ནས་བརྫུས་ཏེ་བྱུང་ངོ་༎ མི་ཕམ་པ་།
 ye te ajita bodhisattvā mahāsattvā anyatra buddhakṣetreṣu sthitāścittamutpādayanti amitābhasya tathāgatasyārhataḥ samyaksaṃbuddhasya darśanāya, na vicikitsāmutpādayanti, na kāṅkṣanti asaṅgaṃ buddhajñānam, svakuśalamūlaṃ cābhiśraddadhati,	བྱང་ཆུབ་སེམས་དཔའ་སེམས་དཔའ་ཆེན་པོ་སངས་རྒྱས་ཀྱི་ཞིང་གཞན་ན་གནས་པ་གང་དག་དེ་བཞིན་གཤེགས་པ་དགྲ་བཅོམ་པ་ཡང་དག་པར་རྫོགས་པའི་སངས་རྒྱས་འོད་དཔག་མེད་ལ་བལྟ་བ་དང་། ཕྱག་བྱ་བ་དང་། བསྙེན་བཀུར་བྱ་བར་སེམས་བསྐྱེད་ཅིང་ཐེ་ཚོམ་མི་བསྐྱེད་ལ་། སངས་རྒྱས་ཀྱི་ཡེ་ཤེས་ཆགས་པ་མེད་པ་ལ་སོམ་ཉི་མེད་ཅིང་རང་གི་དགེ་བའི་རྩ་བ་ཡང་གསོག་པ་དེ་དག་ནི་སྐྱིལ་མོ་ཀྲུང་བཅས་ནས་བརྫུས་ཏེ་འབྱུང་བར་འགྱུར་ཏེ་། འདི་ལྟ་སྟེ་། དཔེར་ན་།
 teṣāmaupapādukānāṃ paryaṅkaiḥ prādurbhūtānāṃ muhūrtamātreṇa evaṃrūpaḥ kāyo bhavati tadyathānyeṣāṃ ciropapannānāṃ sattvānām |	བྱང་ཆུབ་སེམས་དཔའ་སྐྱེས་ནས་རིང་པོ་མ་ལོན་པ་གཞན་དག་དང་འདྲ་བར་ཡུད་ཙམ་གྱིས་ལུས་རྣམ་པ་དེ་ལྟ་བུར་འགྱུར་རོ་༎ མི་ཕམ་པ་།
 paśya ajita prajñāviśeṣaṃ prajñāvaimātryaṃ prajñāparihāṇiṃ prajñāparīttatām - yattu	ཤེས་རབ་ཀྱི་ཁྱད་པར་དང་། ཤེས་རབ་ཀྱི་རིམ་པ་དང་། འདི་ལྟ་སྟེ་།
 hitāya pañcavarṣaśatāni parihīṇā bhavanti buddhadarśanādbodhisattvadarśanāddharmaśravaṇāddharmasaṃkathanāt |	ཐེ་ཚོམ་དུ་ལྷུང་བའི་འདུ་ཤེས་ཡིད་ལ་བྱེད་པས་འདི་ལྟར་༄༤༡༢བ་ལོ་ལྔ་བརྒྱར་སངས་རྒྱས་མཐོང་བ་ལས་ཡོངས་སུ་ཉམས་ཤིང་།
 kuśalamūlacaryāyāḥ parihīṇā bhavanti sarvakuśalamūlasaṃpattibhiḥ yadidaṃ vicikitsāpatitaiḥ saṃjñāmanasikāraiḥ |	བྱང་ཆུབ་སེམས་དཔའ་མཐོང་བ་དང་། ཆོས་མཉམ་པ་དང་། ཆོས་ཀྱི་གཏམ་དང་། དགེ་བའི་སྤྱོད་པ་དང་། དགེ་བ་ཕུན་སུམ་ཚོགས་པ་ཐམས་ཅད་ལས་ཡོངས་སུ་ཉམས་པའི་ཤེས་རབ་ཡོངས་སུ་ཉམས་པ་དང་། ཤེས་རབ་ཆུང་བ་ལ་ལྟོས་། མི་ཕམ་པ་། འདི་ལྟ་སྟེ་། འདི་ལྟ་སྟེ་།
 tadyathāpi nāma ajita rājñaḥ kṣatriyasya mūrdhābhiṣiktasya bandhanāgāraṃ bhavetsarvasauvarṇavaiḍūryapratyuptamavasaktapaṭṭamālyadāmakalāpaṃ	དཔེར་ན་། རྒྱལ་པོ་རྒྱལ་རིགས་སྤྱི་བོ་ནས་དབང་བསྐུར་བ་ལ་ཁྲི་མོན་གསེར་དང་། བེདའུ་རྱ་ཐམས་ཅད་ཀྱིས་སྤྲས་པ་། དར་དང་། ཕྲེང་བ་དང་། ལྔ་ལྡིའི་ཚོགས་དཔྱངས་པ་།
 nānāraṅgavibhavavitānaṃ dūṣyapaṭṭasaṃchannaṃ nānāpuṣpakusumābhikīrṇamudāradhūpanirdhūpitaṃ	ཚོན་སྣ་ཚོགས་ཀྱིས་བླ་རེ་བྲེས་པ་། རས་བཅོས་བུ་གཏིང་བ༏་མེ་ཏོག་གི་སིལ་མ་སྣ་ཚོགས་བཀྲམ་པ་། བདུག་པ་རྒྱ་ཆེན་པོས་གདུགས་པ་།
 prāsādaharmyaniryūhagavākṣavedikātoraṇavicitraṃ saptaratnaṃ kiṅkiṇījālasaṃchannaṃ	ཁང་བཟང་དང་། བསིལ་ཁང་དང་། སྐར་ཁུང་དང་། ཁ་ཁྱེར་དང་། རྟ་བབས་དང་། བ་གམ་རིན་པོ་ཆེ་སྣ་ཚོགས་ཐམས་ཅད་ཀྱིས་བརྒྱན་པ་། གསེར་དང་རིན་པོ་ཆེའི་དྲིལ་བུ་ག-ཡེར་ཁའི་དྲ་བས་བྲེས་པ་།
 caturasraṃ catuḥsthūṇaṃ caturdvāraṃ catuḥsopānam |	གྲུ་བཞི་ལྷམ་པ་། ཀ་བ་བཞི་ཟུག་པ་། སྒོ་བཞི་བཏོད་པ་། ཐེམ་སྐས་བཞི་བཅས་པ་ཞིག་ཡོད་ལ་།
 tatra tasya sa rājñaḥ putraḥ kenacideva kṛtyena prakṣipya jāmbūnadasuvarṇamayairnigaḍairbaddho bhavati |	རྒྱལ་པོ་དེའི་བུ་ཉེས་པ་ཞིག་གི་ཕྱིར་ཁྲི་མོན་དེར་བཅུག་སྟེ་། འཛམ་བུའི་ཆུ་བོའི་གསེར་གྱི་ཁོང་སྒྲིལ་དུ་བཅུག་ལ་། དེར་དེའི་ཁྲི་བཤམས་ཏེ་སྟན་ཀོ་ནི་ཀ་བཏིང་བ་ལ་། བར་ཚངས་ཅན་དང༏་པ་ལ་ལི་ཀ་བཏིང་སྟེ་།
 tasya ca tatra paryaṅkaḥ prajñaptaḥ syādanekagoṇikāstīrṇastūlikāparṇakāstīrṇaḥ kāliṅgaprāvaraṇapratyāstaraṇasottarapadacchada ubhayāntalohitopadhānaścitro darśanīyaḥ |	ཡུལ་ཀ་ལིང་ཀའི་རས་ཀྱིས་གདིང་བ་བཏིང་ལ་། དེའི་སྟེང་དུ་དར་བཏིང་སྟེ་། ག-ཡས་ག-ཡོན་གཉིས་སུ་རྟེན་མ་དམར་པོ་བཞག་ལ་། བཀྲ་བ་།
 sa tatra tadābhiṣaṇṇo vā abhisaṃpanno vā bhavet |	བལྟ་ན་སྡུག་པ་དེ་ལ་དེ་༄༤༡༣ཨ་༌༎ འདུག་ཀྱང་རུང་། ཉལ་ཡང་རུང་།
 bahu cāsyānekavidhaṃ śuci vinītaṃ pānabhojanaṃ tatropanāmyeta |	དེའི་ཟས་སྐོམ་གཙང་མ་བསོད་བ་རྣམ་པ་མང་པོ་དུ་མ་བཤམས་ན་།
 tatkiṃ manyase ajita udārastasya rājaputrasya sa paribhogo bhavet?	མི་ཕམ་པ་། འདི་ཇི་སྙམ་དུ་སེམས་། རྒྱལ་པོའི་བུ་དེ་ཡོངས་སུ་སྤྱད་པ་རྒྱ་ཆེ་བ་ཡིན་ནམ་།
 ajita āha - udāro bhagavan |	གསོལ་པ་། བཅོམ་ལྡན་འདས་། རྒྱ་ཆེ་ལགས་སོ་༎ བཅོམ་ལྡན་འདས་ཀྱིས་བཀའ་སྩལ་པ་།
 bhagavānāha - tatkiṃ manyase ajita api tvāsvādayettatra niśāmayecca,	མི་ཕམ་པ་། འདི་ཇི་སྙམ་དུ་སེམས་། དེས་དེའི་རོ་མྱང་བར་བྱེད་དམ་། མིད་པར་བྱེད་དམ་།
 tena vā tuṣṭiṃ vidyāt?	དེས་དགའ་བ་འཐོབ་བམ་།
 āha - no hīdaṃ bhagavan |	གསོལ་པ་། བཅོམ་ལྡན་འདས་། དེ་ནི་མ་ལགས་ཏེ་།
 api tu khalu punaryadyapanītya rājñā tatra bandhanāgāre prakṣipto bhavet, sa tato mokṣamevākāṅkṣet |	ནོངས་པ་གང་གི་སླད་དུ་རྒྱལ་པོས་ཁྲི་མོན་དེར་སྩལ་པ་།
 abhijātān kumārānamātyān stryāgārān śreṣṭhino gṛhapatīn koṭṭarājāṃśca paryeṣayet,	དེ་ལས་ཐར་པར་འཚལ་ཞིང་རིགས་བཟང་པོ་རིགས་བཟང་པོའི་གཞོན་ནུ་དང་། བློན་པོ་དང་། བཙུན་མོའི་འཁོར་དང་། ཚོང་དཔོན་དང་། ཁྱིམ་བདག་དང་། ཁམས་ཀྱི་རྒྱལ་པོའམ་།
 ya enaṃ tato bandhanāgārātparimocayeyuḥ |	གང་གིས་ཁྲི་མོན་དེ་ལས་ཡོངས་སུ་ཐར་པར་འགྱུར་བ་ཡོངས་སུ་ཚོལ་ཏེ་། བཅོམ་ལྡན་འདས་།
 kiṃcāpi bhagavaṃstasya rājakumārasya tatra bandhānāgāre nābhiratiḥ, nātra parimucyate, yāvanna rājā prasādamupadarśayati |	རྒྱལ་པོའི་བུ་དེ་བཙོན་ར་དེ་ན་དགའ་བ་མ་མཆིས་ཤིང་རྒྱལ་པོས་མ་གནང་གི་བར་དུ་མི་ཐར་རོ་༎ བཅོམ་ལྡན་འདས་ཀྱིས་བཀའ་སྩལ་པ་། མི་ཕམ་པ་།
 bhagavānāha - evameva ajita ye te bodhisattvā vicikitsāpatitāḥ kuśalamūlānyavaropayanti, (sukhv, vaidya 250) kāṅkṣati buddhajñānam, kiṃcāpi tena buddhanāmaśravaṇena tena ca cittaprasādamātreṇa atra sukhāvatyāṃ lokadhātāvupapadyante, na tu khalvaupapādukāḥ padmeṣu paryaṅkaiḥ prādurbhavanti,	དེ་བཞིན་དུ་བྱང་ཆུབ་སེམས་དཔའ་གང་དག་ཐེ་ཚོམ་དུ་ལྷུང་བས་དགེ་བའི་རྩ་བ་བསྐྱེད་ཅིང་སངས་རྒྱས་ཀྱི་ཡེ་ཤེས་མི་མཉམ་པ་དང་། མཉམ་པའི་ཡེ་ཤེས་ལ་སོམ་ཉི་ཟ་བ་དེ་དག་སངས་རྒྱས་ཀྱི་མཚན་ཐོས་པ་དེ་དང་། སེམས་དང་བ་ཙམ་དེས་འཇིག་རྟེན་གྱིས་ཁམས་བདེ་བ་ཅན་དེར་སྐྱེ་ཡང་པདམ་རྣམས་ལ་སྐྱིལ་མོ་ཀྲུང་༄༤༡༣བ་བཅས་ཤིང་བརྫུས་ཏེ་འབྱུང་བ་མ་ཡིན་གྱི་། 
 api tu padmeṣu garbhāvāsaṃ prativasanti |	པདམ་རྣམས་ཀྱི་མངལ་ན་གནས་པ་མྱོང་སྟེ་།
 kiṃcāpi teṣāṃ tatrodyānavimānasaṃjñāḥ saṃtiṣṭhante,	དེ་དག་དེ་ལ་སྐྱེད་མོས་ཚལ་དང་། གཞལ་མེད་ཁང་དུ་འདུ་ཤེས་ཤིང་གནས་ཏེ་།
 nāstyuccāraprasrāvam,	བཤང་གཅི་མེད་།
 nāsti kheṭasiṃhāṇakam,	མཆིལ་མ་མེད་། སྣབས་མེད་།
 na pratikūlaṃ manasaḥ pravartate,	ཡིད་དང་མི་མཐུན་པ་མི་འབྱུང་མོད་ཀྱི་།
 api tu khalu punaḥ pañca varṣaśatāni virahitā bhavanti buddhadarśanena dharmaśravaṇena bodhisattvadarśanena dharmasāṃkathyaviniścayena sarvakuśalamūlena dharmacaryābhiśca |	ལོ་ལྔ་བརྒྱར་སངས་རྒྱས་མཐོང་བ་དང་། ཆོས་མཉན་པ་དང་། བྱང་ཆུབ་སེམས་དཔའ་མཐོང་བ་དང་། འབེལ་བའི་ཆོས་ཀྱི་གཏམ་རྣམ་པར་ངེས་པ་དང་། དགེ་བའི་ཆོས་སྤྱོད་པ་ཐམས་ཅད་དང་བྲལ་བ་ཡིན་ཏེ་།
 kiṃcāpi te tatra nābhiramante na tuṣṭiṃ vijānanti,	དེ་དག་དེ་ན་མངོན་པར་མི་དགའ་ཞིང་མགུ་བ་མི་འཐོབ་ཀྱི་།
 api tu khalu punaḥ pūrvāparān kṣapayitsate bhūyastataḥ paścānniskrāmanti |	སྔོན་གྱི་ཉེས་པ་ཟད་ནས་དེ་དག་པདམའི་མངལ་ནས་འབྱུང་སྟེ༏་དེ་དག་དེ་ནས་བྱུང་ཡང་སྟེང་ངམ་། 
 na caiṣāṃ tato niṣkrāmatāṃ niṣkramaḥ prajñāyate ūrdhvamadhastiryagvā |	འོག་གམ་། ཐད་ཀར་བྱུང་བ་མི་ཤེས་སོ་༎
 paśya ajita etarhi nāma pañcabhirvarṣaśatairbahūni buddhakoṭīniyutaśatasahasropasthānāni syurbahvaparimāṇāsaṃkhyeyāprameyāṇi ca kuśalamūlānyavaropayitavyāni	མི་ཕམ་པ་། འདི་ལྟར་ལོ་ལྔ་བརྒྱར་སངས་རྒྱས་བྱེ་བ་ཁྲག་ཁྲིག་བརྒྱ་སྟོང་མང་པོ་ལ་བསྙེན་བཀུར་བྱ་བ་དང་། དགེ་བའི་རྩ་བ་མང་པོ་གྲངས་མེད་། ཚད་མེད་། དཔག་ཏུ་མེད་པ་དག་བསྐྱེད་པར་བྱ་བ་དང་། སངས་རྒྱས་ཀྱི་ཆོས་དཔག་ཏུ་མེད་པ་ཡོངས་སུ་གཟུང་བར་བྱ་བ་དེ་ཐམས་ཅད་ཀྱང་ཐེ་ཚོམ་ཟ་བའི་ཉེས་པས་བསྒྲུབས་པར་མ་གྱུར་པ་ལ་ལྟོས་། མི་ཕམ་པ་།
 tatsarvaṃ vicikitsādoṣeṇa vināśayanti | paśya ajita kiyanmahate 'narthāya bodhisattvānāṃ vicikitsā saṃvartata iti |	ཐེ་ཚོམ་གྱིས་བྱང་ཆུབ་སེམས་དཔའ་རྣམས་ལ་གནོད་པ་ཆེན་པོ་ཇི་ཙམ་དུ་འགྱུར་བ་ལ་ལྟོས་། མི་ཕམ་པ་།
 tasmāttarhi ajita bodhisattvairnirvicikitsairbodhaye cittamutpādya kṣipraṃ sarvasattvahitasukhādhānāya	དེ་ལྟ་བས་ན་བྱང་ཆུབ་སེམས་དཔའ་དག་གིས་ཐེ་ཚོམ་ཡོངས་སུ་སྤངས་ཏེ་། བྱང་ཆུབ་ཏུ་སེམས་བསྐྱེད་ལ་མྱུར་དུ་སེམས་ཅན་ཐམས་ཅད་ལ་ཕན་པ་དང་བདེ་བའི་སྟོབས་བསྐྱེད་པའི་མཐུ་ཐོབ་པར་བྱ་བའི་ཕྱིར་། གང་ན་བཅོམ་ལྡན་༄༤༡༤ཨ་༌༎
 sāmarthyapratilambhārthaṃ sukhāvatyāṃ lokadhātāvupapattaye kuśalamūlāni pariṇāmayitavyāni, yatra bhagavānamitābhastathāgato 'rhan samyaksaṃbuddhaḥ || sukhv_41 ||	འདས་དེ་བཞིན་གཤེགས་པ་དགྲ་བཅོམ་པ་ཡང་དག་པར་རྫོགས་པའི་སངས་རྒྱས་འོད་དཔག་མེད་བཞུགས་པའི་འཇིག་རྟེན་གྱི་ཁམས་བདེ་བ་ཅན་དུ་སྐྱེ་བར་བྱ་བའི་ཕྱིར་དགེ་བའི་རྩ་བ་རྣམས་ཡོངས་སུ་བསྔོ་བར་བྱའོ་༎ 
 start sukhv 42: evamukte ajito bodhisattvo bhagavantametadavocat - kiṃ punarbhagavan bodhisattvā	དེ་སྐད་ཅེས་བཀའ་སྩལ་པ་དང་། བཅོམ་ལྡན་འདས་ལ་བྱང་ཆུབ་སེམས་དཔའ་མི་ཕམ་པས་འདི་སྐད་ཅེས་གསོལ་ཏོ་༎
 ito buddhakṣetrātpariniṣpannā anyeṣāṃ vā buddhānāṃ bhagavatāmantikātsukhāvatyāṃ lokadhātāvupapatsyante?	བཅོམ་ལྡན་འདས་། སངས་རྒྱས་ཀྱི་ཞིང་འདི་ནས་བྱང་ཆུབ་སེམས་དཔའ་ཡོངས་སུ་གྲུབ་པ་དང་། སངས་རྒྱས་ཀྱི་ཞིང་གཞན་དག་གི་སངས་རྒྱས་བཅོམ་ལྡན་འདས་རྣམས་ཀྱི་གན་ནས་ཇི་སྙེད་ཅིག་འཇིག་རྟེན་གྱི་ཁམས་བདེ་བ་ཅན་དུ་སྐྱེ་བར་འགྱུར་། བཅོམ་ལྡན་འདས་ཀྱིས་བཀའ་སྩལ་པ་། མི་ཕམ་པ་།
 bhagavānāha - ito hyajita buddhakṣetrād dvāsaptatikoṭīniyutāni bodhisattvānāṃ pariniṣpannāni	བྱང་ཆུབ་སེམས་དཔའ་ཡོངས་སུ་གྲུབ་པ་བྱེ་བ་ཁྲག་ཁྲིག་ཕྲག་བདུན་ཅུ་རྩ་གཉིས་སངས་རྒྱས་ཀྱི་ཞིང་འདི་ནས་འཇིག་རྟེན་གྱི་ཁམས་བདེ་བ་ཅན་དུ་སྐྱེ་བར་འགྱུར་ཏེ་།
 yāni sukhāvatyāṃ lokadhātāvupapatsyante pariniṣpannānāmavaivartikānāṃ bahubuddhakoṭīniyutaśatasahasrāṇyavaropitaiḥ kuśalamūlaiḥ, kaḥ punarvādastataḥ parīttataraiḥ kuśalamūlaiḥ duṣprasahasya tathāgatasyāntikādaṣṭādaśakoṭīniyutaśatāni bodhisattvānāṃ sukhāvatyāṃ lokadhātāvupapatsyante	སངས་རྒྱས་བྱེ་བ་ཁྲག་ཁྲིག་བརྒྱ་སྟོང་ཕྲག་མང་པོ་ལ་དགེ་བའི་རྩ་བ་བསྐྱེད་པས་ཕྱིར་མི་ལྡོག་པར་ཡོངས་སུ་འགྲུབ་ན་དགེ་བའི་རྩ་བ་དེ་བས་ཆུང་ངུ་རྣམས་ལྟ་སྨོས་ཀྱང་ཅི་དགོས་། དེ་བཞིན་གཤེགས་པ་བཟོད་པར་དཀའ་བའི་གན་ནས་བྱང་ཆུབ་སེམས་དཔའ་བྱེ་བ་ཁྲག་ཁྲིག་ཕྲག་བཅོ་བརྒྱད་འཇིག་རྟེན་གྱི་ཁམས་བདེ་བ་ཅན་དུ་སྐྱེ་བར་འགྱུར་རོ་༎
 pūrvāntare digbhāge ratnākaro nāma tathāgato viharati |	བྱང་ཤར་གྱི་ཕྱོགས་མཚམས་ན་དེ་བཞིན་གཤེགས་པ་དཀོན་མཆོག་འབྱུང་གནས་ཞེས་བྱ་བ་བཞུགས་ཏེ་།
 tasyāntikānnavatibodhisattvakoṭyaḥ sukhāvatyāṃ lokadhātāvupapatsyante |	དེའི་གན་༄༤༡༤བ་ནས་བྱང་ཆུབ་སེམས་དཔའ་བྱེ་བ་ཕྲག་དགུ་བཅུ་འཇིག་རྟེན་གྱི་ཁམས་བདེ་བ་ཅན་དུ་སྐྱེ་བར་འགྱུར་རོ་༎
 jyotiṣprabhasya tathāgatasyāntikāddvāviṃśatibodhisattvakoṭyaḥ sukhāvatyāṃ lokadhātāvupapatsyante |	དེ་བཞིན་གཤེགས་པ་སྐར་མའི་འོད་ཀྱི་གན་ནས་བྱང་ཆུབ་སེམས་དཔའ་བྱེ་བ་ཕྲག་ཉི་ཤུ་རྩ་གཉིས་འཇིག་རྟེན་གྱི་ཁམས་བདེ་བ་ཅན་དུ་སྐྱེ་བར་འགྱུར་རོ་༎ 
 amitaprabhasya tathāgatasyāntikātpañcaviṃśatibodhisattvakoṭyaḥ sukhāvatyāṃ lokadhātāvupapatsyante |	དེ་བཞིན་གཤེགས་པ་དབྱངས་དཔག་མེད་ཀྱི་གན་ནས་བྱང་ཆུབ་སེམས་དཔའ་བྱེ་བ་ཕྲག་ཉི་ཤུ་རྩ་ལྔ་འཇིག་རྟེན་གྱི་ཁམས་བདེ་བ་ཅན་དུ་སྐྱེ་བར་འགྱུར་རོ་༎
 lokapradīpasya tathāgatasyāntikātṣaṣṭibodhisattvakoṭyaḥ sukhāvatyāṃ lokadhātāvupapatsyante |	དེ་བཞིན་གཤེགས་པ་འཇིག་རྟེན་གྱི་སྒྲོན་མའི་གན་ནས་བྱང་ཆུབ་སེམས་དཔའ་བྱེ་བ་ཕྲག་དྲུག་ཅུ་འཇིག་རྟེན་གྱི་ཁམས་བདེ་བ་ཅན་དུ་སྐྱེ་བར་འགྱུར་རོ་༎ 
 nāgābhibhuvastathāgatasyāntikāccatuḥṣaṣṭirbodhisattvakoṭyaḥ sukhāvatyāṃ lokadhātāvupapatsyante |	དེ་བཞིན་གཤེགས་པ་ཀླུ་ཟིལ་གྱིས་གནོན་པའི་གན་ནས་བྱང་ཆུབ་སེམས་དཔའ་བྱེ་བ་ཕྲག་དྲུག་ཅུ་རྩ་བཞི་འཇིག་རྟེན་གྱི་ཁམས་བདེ་བ་ཅན་དུ་སྐྱེ་བར་འགྱུར་རོ་༎
 virajaḥprabhasya tathāgatasyāntikātpañcaviṃśatibodhisattvakoṭyaḥ sukhāvatyāṃ lokadhātāvupapatsyante |	དེ་བཞིན་གཤེགས་པ་རྡུལ་བྲལ་འོད་ཀྱི་གན་ནས་བྱང་ཆུབ་སེམས་དཔའ་བྱེ་བ་ཕྲག་ཉི་ཤུ་རྩ་ལྔ་འཇིག་རྟེན་གྱི་ཁམས་བདེ་བ་ཅན་དུ་སྐྱེ་བར་འགྱུར་རོ་༎ 
 siṃhasya tathāgatasyāntikātṣoḍaśabodhisattvakoṭyaḥ sukhāvatyāṃ lokadhātāvupapatsyante | siṃhasya tathāgatasyāntikādaṣṭādaśabodhisattvasahasrāni sukhāvatyāṃ lokadhātāvupapatasyante |	དེ་བཞིན་གཤེགས་པ་སེང་གེའི་གན་ནས་བྱང་ཆུབ་སེམས་དཔའ་ཁྲི་བརྒྱད་སྟོང་འཇིག་རྟེན་གྱི་ཁམས་བདེ་བ་ཅན་དུ་སྐྱེ་བར་འགྱུར་བར་འགྱུར་རོ་༎ 
 śrīkūṭasya tathāgatasyāntikādekāśītibodhisattvakoṭīniyutāni sukhāvatyāṃ lokadhātāvupapatsyante |	རོ་༎ དེ་བཞིན་གཤེགས་པ་དཔལ་བརྩེགས་ཀྱི་གན་ནས་བྱང་ཆུབ་སེམས་དཔའ་བྱེ་བ་ཁྲག་ཁྲིག་ཕྲག་བརྒྱད་ཅུ་རྩ་གཅིག་འཇིག་རྟེན་གྱི་ཁམས་བདེ་བ་ཅན་དུ་སྐྱེ་བར་འགྱུར་རོ་བར་འགྱུར་རོ་༎ རོ་༎ 
 narendrarājasya tathāgatasyāntikāddaśabodhisattvakoṭīniyutāni sukhāvatyāṃ lokadhātāvupapatsyante |	༎ དེ་བཞིན་གཤེགས་པ་མིའི་དབང་པོའི་གན་ནས་བྱང་ཆུབ་སེམས་དཔའ་བྱེ་བ་ཁྲག་ཁྲིག་ཕྲག་བཅུ་འཇིག་རྟེན་གྱི་ཁམས་བདེ་བ་ཅན་དུ་སྐྱེ་བར་འགྱུར་རོ་༎
 balābhijñasya tathāgatasyāntikāddvādaśabodhisattvasahasrāṇi sukhāvatyāṃ lokadhātāvupapatsyante |	དེ་བཞིན་གཤེགས་པ་སྟོབས་མངོན་པར་ཤེས་པའི་གན་ནས་བྱང་ཆུབ་སེམས་དཔའ་ཉིས་ཁྲི་ཉིས་སྟོང་འཇིག་རྟེན་གྱི་ཁམས་བདེ་བ་ཅན་དུ་སྐྱེ་བར་འགྱུར་རོ་༎ དེ་བཞིན་གཤེགས་པ་མེ་ཏོག་རྒྱལ་༄༤༡༥ཨ་༌༎
 puṣpadhvajasya (sukhv, vaidya 251) tathāgatasyāntikātpañcaviṃśatirvīryaprāptā bodhisattvakoṭya ekaprasthānaprasthitā ekenāṣṭāhena navatikalpakoṭīniyutaśatasahasrāṇi paścānmukhīkṛtya sukhāvatyāṃ lokadhātāvupapatsyante |	མཚན་གྱི་གན་ནས་བྱང་ཆུབ་སེམས་དཔའ་བརྩོན་འགྲུས་ཐོབ་པ་འཇུག་པ་གཅིག་གིས་ཡང་དག་པར་ཞུགས་པ་ཉི་མ་བརྒྱད་པ་གཅིག་གིས་བསྐལ་པ་བྱེ་བ་ཁྲག་ཁྲིག་བརྒྱ་སྟོང་ཕྲག་དགུ་བཅུ་རྩ་དགུའི་འཁོར་བ་བསྙིལ་བ་བྱེ་བ་ཕྲག་ཉི་ཤུ་རྩ་ལྔ་འཇིག་རྟེན་གྱི་ཁམས་བདེ་བ་ཅན་དུ་སྐྱེ་བར་འགྱུར་རོ་༎ 
 jvalanādhipatestathāgatasyāntikāddvādaśabodhisattvakoṭyaḥ sukhāvatyāṃ lokadhātāvupapatsyante |	དེ་བཞིན་གཤེགས་པ་འབར་བའི་བདག་པོའི་གན་ནས་བྱང་ཆུབ་སེམས་དཔའ་བྱེ་བ་ཕྲག་བཅུ་གཉིས་འཇིག་རྟེན་གྱི་ཁམས་བདེ་བ་ཅན་དུ་སྐྱེ་བར་འགྱུར་རོ་༎
 vaiśāradyaprāptasya tathāgatasyāntikādekonasaptatibodhisattvakoṭyaḥ sukhāvatyāṃ lokadhātāvupapatsyante amitābhasya tathāgatasya darśanāya vandanāya paryupāsanāya paripṛcchanāya paripraśnīkaraṇāya |	དེ་བཞིན་གཤེགས་པ་མི་འཇིགས་པ་བརྙེས་པའི་གན་ནས་བྱང་ཆུབ་སེམས་དཔའ་བྱེ་བ་ཕྲག་དྲུག་ཅུ་རྩ་དགུ་དེ་བཞིན་གཤེགས་པ་འོད་དཔག་མེད་དེ་ལ་བལྟ་བ་དང་། ཕྱག་བྱ་བ་དང་། བསྙེན་བཀུར་བྱ་བ་དང་། ཡོངས་སུ་དྲི་བ་དང་། ཡོངས་སུ་དྲི་བར་བྱ་བའི་ཕྱིར་འཇིག་རྟེན་གྱི་ཁམས་བདེ་བ་ཅན་དུ་སྐྱེ་བར་འགྱུར་རོ་༎ མི་ཕམ་པ་།
 etena ajita paryāyeṇa paripūrṇakalpakoṭīniyutaṃ nāmadheyāni parikīrtayeyaṃ teṣāṃ tathāgatānāṃ yebhyaste bodhisattvā upasaṃkrāmanti sukhāvatyāṃ lokadhātau tamamitābhaṃ tathāgataṃ draṣṭuṃ vanditu paryupāsitum, na śakyaśca paryanto 'dhigantum || sukhv_42 || start sukhv 43:	རྣམ་གྲངས་དེ་ལྟ་བུས་དེ་བཞིན་གཤེགས་པ་གང་དག་གི་གན་ནས་བྱང་ཆུབ་སེམས་དཔའ་དེ་དག་འཇིག་རྟེན་གྱི་ཁམས་བདེ་བ་ཅན་དུ་དེ་བཞིན་གཤེགས་པ་འོད་དཔག་མེད་དེ་ལ་བལྟ་བ་དང་། ཕྱག་བྱ་བ་དང་། བསྙེན་བཀུར་བྱ་བའི་ཕྱིར་འདོང་བའི་དེ་བཞིན་གཤེགས་པ་དེ་དག་གི་མཚན་བསྐལ་པ་བྱེ་བ་ཁྲག་ཁྲིག་ཚང་བར་བརྗོད་ཀྱང་མཐའ་རྟོགས་པར་མི་ནུས་སོ་༎ 
 paśya ajita kiyatsulabdhalābhāste sattvā ye 'mitābhasya tathāgatasyārhataḥ samyaksaṃbuddhasya nāmadheyaṃ śroṣyanti |	མི་ཕམ་པ་། གང་དག་དེ་བཞིན་གཤེགས་པ་དགྲ་བཅོམ་པ་ཡང་དག་པར་རྫོགས་པའི་སངས་རྒྱས་འོད་དཔག་མེད་ཀྱི་མཚན་ཐོས་པའི་སེམས་ཅན་དེ་དག་རྙེད་པ་ཇི་སྙེད་ཅིག་ལེགས་པར་རྙེད་པ་ལ་ལྟོས་།
 nāpi te sattvā hīnādhimuktikā bhaviṣyanti ye 'ntaśaekacittaprasādamapi tasmiṃstathāgate 'bhilapyante, asmiṃśca dharmaparyāye |	སེམས་ཅན་གང་དག་དེ་བཞིན་གཤེགས་པ་འོད་དཔག་མེད་དེ་ལ་ཐན་སེམས་དད་པ་གཅིག་ཙམ་༄༤༡༥བ་རྙེད་པ་དང་། ཆོས་ཀྱི་རྣམ་གྲངས་འདི་ལས་དད་པ་མི་ཕྱེད་པ་དེ་དག་ནི་དམན་པ་ལ་མོས་པར་མི་འགྱུར་རོ་༎
 tasmāttarhi ajita ārocayāmi vaḥ,	མི་ཕམ་པ་། དེ་ལྟ་བས་ན་ཁྱོད་མོས་པར་བྱ་། ཁྱོད་ཀྱིས་ཁོང་དུ་ཆུད་པར་བྱ་སྟེ་།
 prativedayāmi sadevakasya lokasya purato 'sya dharmaparyāyasya śrāvaṇāya |	ལྷ་དང་བཅས་པ་དང་། བདུད་དང་བཅས་པ་དང་། ཚངས་པ་དང་བཅས་པ་དང་། དགེ་སྦྱོང་དང་བྲམ་ཟེའི་སྐྱེ་དགུ་དང་བཅས་པའི་འཇིག་རྟེན་གྱི་མདུན་དུ་ཆོས་ཀྱི་རྣམ་གྲངས་འདི་གཟུང་བ་དང་། བཅང་བ་དང་། བཀླག་པ་དང་། ཀུན་ཆུབ་པར་བྱ་བ་དང་། གཞན་དག་ལ་ཡང་རྒྱ་ཆེར་ཡང་དག་པར་བསྟན་པར་བྱ་བ་དང་། བསྒོམ་པ་ལ་མངོན་པར་དགའ་བར་བྱའོ་༎ མི་ཕམ་པ་། ཆོས་ཀྱི་རྣམ་གྲངས་འདི་ཉིད་ཞག་གཅིག་ཙམ་ཡང་བཟུང་ཞིང་བཅས་ཏེ་བཀླགས་ཤིང་ཀུན་ཆུབ་པར་བྱས་ལ་། བསམ་པ་ཐག་པ་ནས་གཞན་དག་ལ་ཡང་རྒྱ་ཆེར་ཡང་དག་པར་བཤད་པར་བྱའོ་༎ ཐ་ན་གླེགས་བམ་ལ་ལེགས་པར་བྲིས་ཏེ་བཅང་བར་བྱ་ཞིང་དེ་ལ་སྟོན་པའི་འདུ་ཤེས་ཀྱང་བསྐྱེད་པར་བྱའོ་༎ གང་ཞིག་སེམས་ཅན་དཔག་ཏུ་མེད་པ་དག་མྱུར་དུ་བླ་ན་མེད་པ་ཡང་དག་པར་རྫོགས་པའི་བྱང་ཆུབ་ལས་ཕྱིར་མི་ལྡོག་པ་ལ་དགོད་པ་དང་། བཅོམ་ལྡན་འདས་དེ་བཞིན་གཤེགས་པ་ཚེ་དཔག་མེད་དེ་ལ་བལྟ་བ་དང་། བདག་ཉིད་ཀྱང་སངས་རྒྱས་ཀྱི་ཞིང་གི་ཡོན་ཏན་གྱི་རྒྱན་བཀོད་པ་ཕུན་སུམ་ཚོགས་པ་ཁྱད་པར་དུ་འཕགས་པ་ཡོངས་སུ་གཟུང་བར་འདོད་པ་དེས་ཆོས་ཀྱི་རྣམ་གྲངས་འདི་མཉན་པའི་ཕྱིར་སྟོང་གསུམ་གྱི་སྟོང་ཆེན་པོའི་འཇིག་རྟེན་གྱི་ཁམས་མེས་ཡོངས་སུ་གང་བ་ལས་བརྒལ་ཏེ་། ཆོས་ཀྱི་རྣམ་གྲངས་འདི་མཉན་པར་བྱའོ་༎ ཐོས་ནས་ཀྱང་ག-ཡོར་མ་ལྷུང་བའི་རྒྱུད་ཀྱིས་བསམ་པ་ཐག་པ་ནས་རྗེས་སུ་༄༤༡༦ཨ་༌༎ དགའ་བར་བྱའོ་༎ ཆོས་ཀྱི་རྣམ་གྲངས་འདི་གཟུང་བ་དང་། ཀུན་ཆུབ་པར་བྱ་བ་དང་། བཅང་བ་དང་། ཡི་གེར་བྲི་བ་དང་། བསྒོམ་པའི་ཕྱིར་བརྩོན་འགྲུས་རླབས་པོ་ཆེ་ཆེན་པོ་བརྩམ་པར་བྱའོ༏་༏ཐ་ན་བ་གཅིག་འཇོས་པ་དེ་སྲིད་དུ་ཡང་གཞན་དག་ལ་བརྗོད་པར་བྱའོ་༎
 trisāhasramahāsāhasramapi lokadhātumagnipūrṇamavagāhya atikramaikacittotpādamapi pratisāro na kartavyaḥ |	སྟོང་གསུམ་གྱི་སྟོང་ཆེན་པོའི་འཇིག་རྟེན་གྱི་ཁམས་མེས་ཡོངས་སུ་གང་བ་དེ་བརྒལ་ནས་ཀྱང་འགྱོད་པ་དང་ལྡན་པའི་སེམས་གཅིག་ཀྱང་བསྐྱེད་པར་མི་བྱའོ་༎ 
 tatkasya hetoḥ?	དེ་ཅིའི་ཕྱིར་ཞེ་ན་། མི་ཕམ་པ་།
 bodhisattvakoṭyo hyajita aśravaṇādeṣāmevaṃrūpāṇāṃ dharmaparyāyāṇāṃ vivartante 'nuttarāyāḥ samyaksaṃbodheḥ | tasmādasya dharmaparyāyasyādhyāśayena śravaṇodgrahaṇadhāraṇārthaṃ paryāvāptaye vistareṇa saṃprakāśāya bhāvanārthaṃ ca sumahadvīryamārabdhavyam antaśa ekarātriṃdinamapi, ekagodohamātramapi, antaśaḥ pustakāvaropitaṃ kṛtvā sulikhito dhārayitavyaḥ | śāstṛsaṃjñā ca tatropādhyāye kartavyā ya icchati kṣipramaparimitān sattvānavaivartikatve 'nuttarāyāḥ samyaksaṃbodheḥ pratiṣṭhāpayitum, tacca tasya bhagavato 'mitābhasya tathāgatasya buddhakṣetraṃ draṣṭum, ātmanaśca viśiṣṭāṃ buddhakṣetraguṇālaṃkāravyūhasaṃpadaṃ parigrahītumiti | api tu khalu ajita atyarthaṃ sulabdhalābhāste sattvā avaropitakuśalamūlāḥ pūrvajinakṛtādhikārā buddhādhiṣṭhitāśca bhaviṣyanti,	འདི་ལྟར་བྱང་ཆུབ་སེམས་དཔའ་བྱེ་བ་ཁྲག་ཁྲིག་ཕྲག་དུ་མ་དག་ཆོས་ཀྱི་རྣམ་གྲངས་རྣམ་པ་འདི་ལྟ་བུ་འདི་ཉན་ཅིང་བླ་ན་མེད་པ་ཡང་དག་པར་རྫོགས་པའི་བྱང་ཆུབ་ལས་ཕྱིར་མི་ལྡོག་པའི་ཕྱིར་རོ་༎
 yeṣāmanāgate 'dhvani yāvatsaddharmavipralope vartamāne ime evaṃrūpā udārā dharmaparyāyāḥ	མ་འོངས་པའི་དུས་ན་དམ་པའི་ཆོས་རབ་ཏུ་རྣམ་པར་འཇིག་པའི་བར་དུ་ཆོས་ཀྱི་རྣམ་གྲངས་རྒྱ་ཆེན་པོ་རྣམ་པ་འདི་ལྟ་བུ་སངས་རྒྱས་ཐམས་ཅད་ཀྱིས་ཡང་དག་པར་བསྔགས་པ་།
 sarvabuddhasaṃvarṇitāḥ sarvabuddhapraśastāḥ sarvabuddhānujñātā mahataḥ sarvajñajñānasya kṣipramāhārakāḥ śrotrāvabhāsamāgamiṣyanti |	སངས་རྒྱས་ཐམས་ཅད་ཀྱིས་བསྟོད་པ་། སངས་རྒྱས་ཐམས་ཅད་ཀྱིས་གནང་བ་། ཐམས་ཅད་མཁྱེན་པའི་ཡེ་ཤེས་ཆེན་པོ་མྱུར་དུ་བསྒྲུབ་པ་འདི་གང་དག་གི་རྣ་ལམ་དུ་གྲགས་པའི་སེམས་ཅན་དེ་དག་ནི་རྙེད་པ་ཤིན་ཏུ་ལེགས་པ་རྙེད་ཅིང་དགེ་བའི་རྩ་བ་རྣམས་བསྐྱེད་པ་དང་། སྔོན་གྱི་རྒྱལ་བ་ལ་ལྷག་པར་བྱ་བ་བྱས་པ་དང་། སངས་རྒྱས་ཀྱི་བྱིན་གྱི་རླབས་ཀྱིས་བྱིན་གྱིས་བརླབས་པར་འགྱུར་རོ་༎
 ye śrutvā codāraprītiprāmodyaṃ pratilapsyanta udgrahīṣyanti dhārayiṣyanti vācayiṣyanti paryavāpsyanti parebhyo vistareṇa saṃprakāśayiṣyanti, bhāvanābhiratāśca bhaviṣyanti, antaśo likhitvā pūjayiṣyanti, bahu ca te puṇyaṃ prasaviṣyanti,	ཐོས་ནས་ཀྱང་དགའ་བ་དང་། མཆོག་ཏུ་དགའ་བ་རྒྱ་ཆེན་པོ་ཐོབ་པ་དང་། འཛིན་པ་དང་། འཆང་བ་དང་། ཀློག་པ་དང་། ཀུན་ཆུབ་པར་བྱེད་པ་དང་། གཞན་དག་ལ་ཡང་རྒྱ་ཆེར་ཡང་དག་པར་རབ་ཏུ་སྟོན་པ་དང་། བསྒོམ་པ་ལ་དགའ་བར་༄༤༡༦བ་འགྱུར་བ་དང་། ཐ་ན་ཡི་གེར་བྲིས་ཏེ་མཆོད་པ་བྱེད་པ་དེ་དག་ཀྱང་བསོད་ནམས་མང་དུ་བསྐྱེད་པར་འགྱུར་ཏེ་། 
 yasya na sukarā saṃkhyā kartum |	དེ་བགྲང་བར་སླ་བ་མ་ཡིན་ནོ་༎
 iti hi ajita yattathāgatena kartavyam, kṛtaṃ mayā |	མི་ཕམ་པ་། དེ་ལྟར་ན་ངས་དེ་བཞིན་གཤེགས་པའི་མཛད་པ་དེ་བྱས་པ་ཡིན་ཏེ་།
 yuṣmābhiridānīṃ nirvicikitsāyogaḥ karaṇīyaḥ |	ཁྱོད་ཀྱང་ད་ཐེ་ཚོམ་མེད་པར་བརྩོན་པར་གྱིས་ཤིག་།
 mā saṃśayata asaṅgamanāvaraṇaṃ buddhajñānam |	སངས་རྒྱས་ཀྱི་ཡེ་ཤེས་ཆགས་པ་མེད་ཅིང་སྒྲིབ་པ་མེད་པ་ལ་སོམ་ཉི་མ་ཟ་ཅིག་།
 mā bhūtsarvākārāvaropitaratnamaye bandhanāgāre praveśaḥ |	རྣམ་པ་ཐམས་ཅད་ཀྱི་མཆོག་དང་ལྡན་པའི་རིན་པོ་ཆེའི་བཙོན་རར་ཆུད་ད་རེ་།
 durlabho hi ajita buddhotpādaḥ |	མི་ཕམ་པ་། སངས་རྒྱས་འབྱུང་བ་རྙེད་པར་དཀའོ་༎
 durlabhā dharmadeśanā |	ཆོས་བསྟན་པ་རྙེད་པར་དཀའོ་༎
 durlabhā kṣaṇasaṃpat |	དལ་བ་ཕུན་སུམ་ཚོགས་པ་རྙེད་པར་དཀའོ་༎ མི་ཕམ་པ་།
 ākhyātā ca ajita mayā sarvakuśalamūlapāramitāprāptiḥ |	ངས་ཁྱོད་ལ་དགེ་བའི་རྩ་བ་ཐམས་ཅད་ཀྱི་ཕ་རོལ་ཏུ་ཕྱིན་པ་བསྙེད་ཀྱི་།
 yūyamidānīmabhiyujyata pratipadyadhvam |	ད་ཁྱོད་ཀྱིས་མངོན་པར་སྦྱོར་ལ་སྒྲུབས་ཤིག་། མི་ཕམ་པ་།
 asya khalu punarajita dharmaparyāyasya mahatīṃ parīndanāṃ karomi |	ཆོས་ཀྱི་རྣམ་གྲངས་འདི་ཆུད་མི་ཟ་བར་བྱ་བའི་ཕྱིར་ཡོངས་སུ་གཏད་པ་ཆེན་པོ་བྱའོ་༎
 avipraṇāśāya buddhadharmāṇāmanantardhānāya parākramiṣyatha |	སངས་རྒྱས་ཀྱི་ཆོས་མི་ནུབ་པར་བྱ་བའི་ཕྱིར་བརྩོན་པར་གྱིས་ཤིག་།
 mā tathāgatājñāṃ kṣobhayiṣyatha || sukhv_43 ||	དེ་བཞིན་གཤེགས་པའི་བཀའ་མ་འཁྲུགས་པར་གྱིས་ཤིག་། ཡུན་རིང་པོར་གནོད་པ་དང་། མི་ཕན་པ་དང་། མི་བདེ་བ་དང་། སྡུག་བསྔལ་བ་དང་། ལོག་པར་ལྟུང་བར་གྱུར་ཏ་རེ་།
 start sukhv 44: (sukhv, vaidya 252) atha khalu punarbhagavāṃstasyāṃ velāyāmimā gāthā abhāṣata -	དེ་ནས་དེའི་ཚེ་བཅོམ་ལྡན་འདས་ཀྱིས་ཚིགས་སུ་བཅད་པ་འདི་དག་བཀའ་སྩལ་ཏོ་༎
 na me akṛtapuṇyānāṃ śravā bheṣyanti īdṛśāḥ |	བསོད་ནམས་དག་ནི་མ་བྱས་པ་༎ འདི་འདྲ་འདི་དག་ཐོས་མི་འགྱུར་༎
 ye tu te śūra siddhārthāḥ śroṣyanti ca imāṃ giram || sukhv_vs_49 ||	དཔའ་བོ་གང་དག་དོན་གྲུབ་པ་༎ དེ་དག་གསུང་འདི་ཐོས་པར་འགྱུར་༎
 dṛṣṭo yaiśca hi saṃbuddho lokanāthaḥ prabhaṃkaraḥ ||	གང་གིས་འོད་མཛད་འཇིག་རྟེན་མགོན་༎ རྫོགས་པའི་སངས་རྒྱས་མཐོང་ནས་ནི་༎
 sagauravaiḥ śruto dharmaḥ prītiṃ prāpsyanti te parām || sukhv_vs_50 ||	གུས་དང་བཅས་པས་ཆོས་ཐོས་པས་༎ དེ་དག་དགའ་བ་དམ་པ་འཐོབ་༎
 na śakta hīnehi kusīdadṛṣṭibhiḥ buddhāna dharmeṣu prasāda vinditum |	ལྟ་བ་ཅན་དང་དམན་༄༤༡༧ཨ་༌༎ དང་ཞུམ་རྣམས་ཀྱིས་༎ སངས་རྒྱས་ཆོས་ལ་དད་པ་རྙེད་མི་ནུས་༎ གང་དག་སྔོན་གྱི་སངས་རྒྱས་མཆོད་བྱས་པ་༎
 ye buddhakṣetreṣu akārṣi pūjāṃ trailokanāthāna caryāsu śikṣiṣu || sukhv_vs_51 ||	དེ་དག་འཇིག་རྟེན་མགོན་གྱི་སྤྱད་ལ་སློབ་༎
 yathāndhakāre puruṣo hyacakṣuḥ mārgaṃ na jāne kutu saṃprakāśayet |	དཔེར་ན་སྐྱེས་བུ་ཡོང་བ་མུན་ཁུང་ན་༎ ལམ་ཡང་མི་ཤེས་བསྟན་པར་ག་ལ་ནུས་༎
 sarvaṃ tathā śrāvaka buddhajñāne ajānakāḥ kiṃ punaradya sattvāḥ || sukhv_vs_52 ||	དེ་ལྟར་ཉན་ཐོས་ཐམས་ཅད་སངས་རྒྱས་ཀྱི་༎ ཡེ་ཤེས་མི་རྟོག་སེམས་ཅན་གཞན་ཅི་སྨོས་༎
 buddho hi buddhasya guṇāṃ prajānate na devanāgāsurayakṣaśrāvakāḥ |	སངས་རྒྱས་ཀྱིས་ནི་སངས་རྒྱས་ཡོན་ཏན་མཁྱེན་༎ ལྷ་ཀླུ་ལྷ་མིན་གནོད་སྦྱིན་ཉན་ཐོས་མིན་༎
 anekabuddhāna pi no gatī yatho buddhasya jñāne hi prakāśyamāne || sukhv_vs_53 ||	སངས་རྒྱས་ཡེ་ཤེས་རབ་ཏུ་བཤད་པ་ནི་༎ རང་སངས་རྒྱས་ཀྱི་ལམ་ཡང་འདི་མ་ཡིན་༎ གལ་ཏེ་སེམས་ཅན་ཐམས་ཅད་བདེ་བར་གཤེགས་༎
 yadi sarvasattvāḥ samatā bhaveyuḥ viśuddhajñāne paramārthakovidāḥ |	ཡེ་ཤེས་རྣམ་དག་དོན་ལ་མཁས་གྱུར་ཏེ་༎
 te kalpakoṭīratha vāpi uttare naikasya buddhasya guṇān katheyuḥ || sukhv_vs_54 ||	དེ་དག་བསྐལ་པ་འམ་འོན་ཏེ་ལྷག་པར་ནི་༎ སངས་རྒྱས་གཅིག་གི་ཡོན་ཏན་རྗོད་བྱེད་ཀྱང་༎ དེ་དག་རབ་ཏུ་མྱ་ངན་འདས་གྱུར་གྱི་༎
 atrāntare nirvṛta te bhaveyuḥ prakāśamānā bahukalpakoṭīḥ |	བསྐལ་པ་བྱེ་བ་མང་པོར་རབ་བརྗོད་ཀྱང་༎
 na ca buddhajñānasya pramāṇu labhyate tathā hi jñānāścaryaṃ jinānām || sukhv_vs_55 ||	སངས་རྒྱས་ཡེ་ཤེས་ཚད་མེད་མི་འགྱུར་ཏེ་༎ དེ་ལྟར་རྒྱལ་བའི་ཡོན་ཏན་ངོ་མཚར་ཏོ་༎
 tasmānnaraḥ paṇḍita vijñajātiyaḥ yo mahya vākyamabhiśraddadheya |	དེ་བས་མཁས་པ་རིག་པའི་རང་བཞིན་མི་༎ གང་ཞིག་ང་ཡི་ཚིག་ལ་ཡིད་ཆེས་ཏེ་༎ རྒྱལ་བའི་ཡེ་ཤེས་ཕུང་པོ་དབང་བྱས་ཏེ་༎
 kṛtsnāṃ sa sākṣājjinajñānamārgān buddhaḥ prajānaṃ ti girāmudīrayet || sukhv_vs_56 ||	སངས་རྒྱས་ཉིད་ཀྱིས་མཁྱེན་ཅེས་ཚིག་ཏུ་བརྗོད་༎
 kadāci labhyati manuṣyalābhaḥ kadāci buddhāna pi prādurbhāvaḥ | (sukhv, vaidya 253)	བརྒྱ་ལམ་ན་ནི་མི་ཡི་ལུས་རྙེད་ལ་༎ བརྒྱ་ལམ་ན་ནི་སངས་རྒྱས་འབྱུང་བར་འགྱུར་༎
 śraddhārthaprajñā sucireṇa labhyate tasyārthaprāptyai janayet vīryam || sukhv_vs_57 ||	དད་དང་ཤེས་རབ་ཡུན་རིང་རྙེད་པར་འགྱུར༏། དེ་བས་དོན་ཐོབ་བྱ་ཕྱིར་བརྩོན་འགྲུས་བསྐྱེད་༎
 ya īdṛśāṃ dharma śruṇitva śreṣṭhāṃ labhyanti prītiṃ sugataṃ smarantaḥ |	གང་ཞིག་ཆོས་མཆོག་འདི་འདྲ་ཐོས་ནས་ནི་༎ བདེ་གཤེགས་དྲན་པ་དགའ་བ་འཐོབ་པར་འགྱུར་༎ གང་ཞིག་སངས་རྒྱས་བྱང་ཆུབ་༄༤༡༧བ་མོས་བསྐྱེད་པ་༎
 te mitramasmākamatītamadhvani ye cāpi bodhāya jananti chandam || sukhv_vs_58 ||	དེ་དག་འདས་པའི་དུས་ན་དེང་དང་ཤེས་༎
 iti || sukhv_44 || start sukhv 45: asmin khalu punardharmaparyāye bhāṣyamāṇe dvādaśānāṃ sattvaniyutakoṭīnāṃ virajo vigatamalaṃ dharmeṣu dharmacakṣurviśuddham |	ཆོས་ཀྱི་རྣམ་གྲངས་འདི་བཤད་པ་ན་སེམས་ཅན་བྱེ་བ་ཕྲག་བཅུ་གཉིས་ཆོས་རྣམས་ལ་ཆོས་ཀྱི་མིག་རྡུལ་དང་བྲལ་ཞིང་དྲི་མ་མེད་པ་རྣམ་པར་དག་གོ་། 
 caturviṃśatyā koṭiniyutaśataphalaṃ prāptam |	བྱེ་བ་ཕྲག་ཉི་ཤུ་རྩ་བཞིས་ནི་ཕྱིར་མི་འོང་བའི་འབྲས་བུ་ཐོབ་བོ་པར་དག་གོ་། 
 aṣṭānāṃ bhikṣuśatānāmanupādāyāsravebhyaścittāni vimuktāni |	༎ དགེ་སློང་བརྒྱད་བརྒྱ་ནི་ལེན་པ་མེད་པའི་ཟག་པ་རྣམས་ལས་སེམས་རྣམ་པར་དག་གོ་། ༎ པར་གྲོལ་ལོ་༎ 
 pañcaviṃśatyā bodhisattvakoṭībhiranutpattikadharmakṣāntiḥ pratilabdhā |	བྱང་ཆུབ་སེམས་དཔའ་བྱེ་བ་ཕྲག་ཉི་ཤུ་རྩ་ལྔ་ནི་མི་སྐྱེ་བའི་ཆོས་ལ་བཟོད་པ་ཐོབ་བོ་པར་དག་གོ་། 
 devamānuṣikāyāśca prajāyāścatvāriṃśatkoṭīniyutaśatasahasrāṇāmanutpannapūrvāṇyanuttarāyāṃ samyaksaṃbodhau cittānyutpannāni |	༎ པར་གྲོལ་ལོ་༎ ༎ ལྷ་དང་མིའི་སྐྱེ་དགུ་བྱེ་བ་ཁྲག་ཁྲིག་བརྒྱ་སྟོང་ཕྲག་བཞི་བཅུ་ནི་སྔོན་སེམས་མ་བསྐྱེད་པ་ལས་བླ་ན་མེད་པ་ཡང་དག་པར་རྫོགས་པའི་བྱང་ཆུབ་ཏུ་སེམས་བསྐྱེད་ནས་བཅོམ་ལྡན་འདས་དེ་བཞིན་གཤེགས་པ་འོད་དཔག་མེད་ལ་བལྟ་བ་དང་པར་དག་གོ་། ༎ པར་གྲོལ་ལོ་༎ 
 sukhāvatyāṃ lokadhātāvupapattaye ca kuśalamūlānyavaropitāni bhagavato 'mitābhasya tathāgatasya darśanakāmatayā |	༎ ། ཕྱག་བྱ་བ་དང་། བསྙེན་བཀུར་བྱ་བའི་ཕྱིར་བདེ་བ་ཅན་དུ་སྐྱེ་བར་དགེ་བའི་རྩ་བ་རྣམས་ཡོངས་སུ་བསྔོ་བར་བྱེད་དོ་༎ 
 sarve ca te tatropapadya anupūrveṇa mañjusvarā nāma tathāgatā anyeṣu lokadhātuṣūpapatsyante |	དེ་དག་ཐམས་ཅད་དེར་སྐྱེས་ནས་ཀྱང་མཐར་གྱིས་བྱང་ཆུབ་སེམས་དཔའི་སྤྱོད་པ་ཡོངས་སུ་རྫོགས་པར་བྱས་ཏེ་། སངས་རྒྱས་ཀྱི་ཞིང་གཞན་དག་ཏུ་དེ་བཞིན་གཤེགས་པ་འཇམ་པའི་དབྱངས་ཞེས་བྱ་བར་བླ་ན་མེད་པ་ཡང་དག་པར་རྫོགས་པའི་བྱང་ཆུབ་མངོན་པར་རྫོགས་པར་འཚང་རྒྱ་བར་འགྱུར་རོ་༎
 aśītiśca niyutakoṭyo dīpaṃkare tathāgate labdhakṣāntikā avaivartikā anuttarāyāḥ samyaksaṃbodheramitāyuṣaiva	དེ་བཞིན་གཤེགས་པ་མར་མེ་མཛད་ལས་བཟོད་པ་ཐོབ་སྟེ་། བླ་ན་མེད་པ་ཡང་དག་པར་རྫོགས་པའི་བྱང་ཆུབ་ལས་ཕྱིར་མི་ལྡོག་པ་བྱེ་བ་ཁྲག་ཁྲིག་ཕྲག་བརྒྱད་ཅུ་དེ་བཞིན་གཤེགས་པ་འོད་དཔག་མེད་ཀྱིས་སྔོན་བྱང་ཆུབ་སེམས་དཔའི་སྤྱད་པ་སྤྱོད་པ་ན་། 
 tathāgatena paripācitāḥ pūrvabodhisattvacaryāṃ carantastāśca sukhāvatyāṃ lokadhātāvupapadya	བླ་ན་མེད་པ་ཡང་དག་པར་རྫོགས་པའི་བྱང་ཆུབ་ཏུ་ཡོངས་སུ་སྨིན་པར་བྱས་པ་དེ་དག་ཀྱང་འཇིག་༄༤༡༨ཨ་༌༎ རྟེན་གྱི་ཁམས་བདེ་བ་ཅན་དུ་སྐྱེས་ཏེ་།
 pūrvapraṇidhānacaryāḥ paripūrayiṣyanti || sukhv_45 || start sukhv 46:	སྔོན་གྱི་སྨོན་ལམ་དང་། སྤྱོད་པ་ཡོངས་སུ་རྫོགས་པར་འགྱུར་རོ་༎
 tasyāṃ velāyāmayaṃ trisāhasramahāsāhasralokadhātuḥ ṣadvikāraṃ prākampat |	དེའི་ཚེ་སྟོང་གསུམ་གྱི་སྟོང་ཆེན་པོའི་འཇིག་རྟེན་གྱི་ཁམས་འདི་རྣམ་པ་དྲུག་ཏུ་ག-ཡོས་ཏེ་།
 vividhāni ca prātihāryāṇi saṃdṛśyante sma | pṛthivyāṃ saṃskṛtamabhūt |	ཆོ་འཕྲུལ་རྣམ་པ་སྣ་ཚོགས་ཀྱང་ཀུན་དུ་སྣང་ངོ་༎ མེ་ཏོག་མན་ད་ར་བ་དག་ཀྱང་ས་ལ་པུས་མོ་ནུབ་ཙམ་དུ་བཀྲམ་པར་གྱུར་ཏོ་༎
 divyamānuṣyakāni ca tūryāṇi saṃpravāditānyabhūvan |	ལྷ་དང་། མིའི་སིལ་སྙན་རྣམས་ཀྱང་རབ་ཏུ་གྲག་པར་གྱུར་ཏོ་༎
 anumodanāśabdena ca yāvadakaniṣṭhabhuvanaṃ vijñaptamabhūt || sukhv_46 || start sukhv 47:	འོག་མིན་གྱི་གནས་ཀྱི་བར་དུ་ཡང་རྗེས་སུ་ཡི་རང་ངོ་ཞེས་བྱ་བའི་སྒྲ་གྲག་པར་གྱུར་ཏོ་༎ 
 idamavocadbhagavānāttamanāḥ |	བཅོམ་ལྡན་འདས་ཀྱིས་དེ་སྐད་ཅེས་བཀའ་སྩལ་ནས་།
 ajito bodhisattvo mahāsattva āyuṣmāṃścānandaḥ sā ca sarvāvatī parṣat sadevamānuṣāsuragaruḍagandharvasya loko bhagavato bhāṣitamabhyanandanniti	བྱང་ཆུབ་སེམས་དཔའ་སེམས་དཔའ་ཆེན་པོ་མི་ཕམ་པ་དང་། ཚེ་དང་ལྡན་པ་ཀུན་དགའ་བོ་དང་། ཐམས་ཅད་དང་ལྡན་པའི་འཁོར་དེ་དག་དང་། ལྷ་དང་། མི་དང་། ལྷ་མ་ཡིན་དང་དྲི་ཟར་བཅས་པའི་འཇིག་རྟེན་ཡི་རངས་ཏེ་། བཅོམ་ལྡན་འདས་ཀྱིས་གསུངས་པ་ལ་མངོན་པར་བསྟོད་དོ་༎ འཕགས་པ་དཀོན་མཆོག་བརྩེགས་པ་ཆེན་པོའི་ཆོས་ཀྱི་རྣམ་གྲངས་སྟོང་ཕྲག་བརྒྱ་པ་ལས་།
 bhagavato 'mitābhasya tathāgatasya sukhāvatīguṇavarṇaparikīrtanaṃ bodhisattvānāmavaivartyabhūmipraveśaḥ amitābhasya parivartaḥ sukhāvatīvyūho mahāyānasūtraṃ samāptam || * * * * * ye dharmā hetuprabhavā hetuṃ teṣāṃ tathāgato hyavadat |	དེ་བཞིན་གཤེགས་པ་འོད་དཔག་མེད་ཀྱི་སངས་རྒྱས་ཀྱི་ཞིང་གི་བཀོད་པའི་ལེའུ་ཞེས་བྱ་སྟེ་། ལེའུ་ལྔ་པ་རྫོགས་སོ་༎༎ རྒྱ་གར་གྱི་མཁན་པོ་ཛི་ན་མི་ཏྲ་དང་། དའ་ན་ཤའི་ལ་དང་། ཞུ་ཆེན་གྱི་ལོཙཚ་བ་བན་དེ་ཡེ་ཤེས་སྡེས་བ་སྒྱུར་ཅིང་ཞུས་། ཏེ་སྐད་གསར་བཅད་ཀྱིས་ཀྱང་བཅོས་ནས་གཏན་ལ་ཕབ་པ་༎༎
