skt	tib
 namo 'mitābhāya| namo 'mitāyuṣe| namo 'cintyaguṇāka- rātmane| namo 'mitābhāya jināya, te mune| sukhāvatīṃ yāmi te cānukampayā| sukhāvatīṃ kanakavicitrakānanāṃ manoramāṃ sugatasutair alaṃkṛtāṃ| tathāśrayāṃ prathitayaśasya dhīmataḥ, prayāmi tāṃ bahuguṇaratnasaṃcayām|	༄༣༦༧ཨ་། །རྒྱ་གར་སྐད་དུ་། ཨའརྱ་ཨཨ་མི་ཏའ་བྷ་བ་བྱུ་ཧ་། ནའ་མ་མ་ཧའ་ཡའ་ན་སའུ་ཏྲ་། བོད་སྐད་དུ་། འཕགས་པ་འོད་དཔག་མེད་ཀྱི་བཀོད་པ་ཞེས་བྱ་བ་ཐེག་པ་ཆེན་པོའི་མདོ་། བམ་པོ་དང་པོ་། སངས་རྒྱས་དང་བྱང་ཆུབ་སེམས་དཔའ་ཐམས་ཅད་ལ་ཕྱག་འཚལ་ལོ་༎
 evaṃ mayā śrutam : ekasmin samaye bhagavān rājagṛhe	འདི་སྐད་བདག་གིས་ཐོས་པ་དུས་གཅིག་ན་།
 viharati sma, gṛdhrakūṭe parvate mahatā bhikṣusaṃghena sārdhaṃ dvātriṃśatā bhikṣusahasraiḥ,	བཅོམ་ལྡན་འདས་རྒྱལ་པོའི་ཁབ་ན་བྱ་རྒོད་ཀྱི་ཕུང་པོའི་རི་ལ་དགེ་སློང་སུམ་ཁྲི་ཉིས་སྟོང་གི་དགེ་སློང་གི་དགེ་འདུན་ཆེན་པོ་དང་ཐབས་གཅིག་ཏུ་བཞུགས་ཏེ་།
 sarvair arhadbhiḥ	ཐམས་ཅད་ཀྱང་དགྲ་བཅོམ་པ་། ཟག་པ་ཟད་པ་།
 kṣīṇāsravair niḥkleśair uṣitavadbhiḥ samyagājñāsuvimuktacittaiḥ	ཉོན་མོངས་པ་མེད་པ་། གནས་པ་དང་ལྡན་པ་། ཡང་དག་པའི་ཤེས་པས་སེམས་ཤིན་ཏུ་རྣམ་པར་གྲོལ་བ་།
 parikṣīṇabhavasaṃyojanasahasrair anuprāptasvakārthair	སྲིད་པར་ཀུན་ཏུ་སྦྱོར་བ་ཡོངས་སུ་ཟད་པ་། ༄༣༦༧བ་བདག་གི་དོན་རྗེས་སུ་ཐོབ་པ་།
 vijitavadbhir,	རྣམ་པར་རྒྱལ་བ་དང་ལྡན་པ་།
 uttamadamane śamathaprāptaiḥ,	དུལ་བ་དང་ཞི་བའི་མཆོག་ཐོབ་པ་།
 suvimuktacittaiḥ suvimuktaprajñair mahānāgaiḥ,	སེམས་ཤིན་ཏུ་རྣམ་པར་གྲོལ་བ་། ཤེས་རབ་ཤིན་ཏུ་རྣམ་པར་གྲོལ་བ་། ཅང་ཤེས་པ་། གླང་པོ་ཆེན་པོ་།
 ṣaḍabhijñair	མངོན་པར་ཤེས་པ་དྲུག་དང་ལྡན་པ་། དབང་དང་ལྡན་པར་གྱུར་པ་།
 vaśībhūtair aṣṭavimokṣadhyāyibhir balaprāptair abhijñānābhijñātaiḥ,	རྣམ་པར་ཐར་པ་བརྒྱད་ལ་བསམ་གཏན་པ་། སྟོབས་ཐོབ་པ་། མངོན་པར་ཤེས་པས་མངོན་པར་ཤེས་པ་།
 sthavirair, mahāśrāvakaiḥ| tad yathā : ājñātakauṇḍinyena ca, aśvajitā ca, bāṣpeṇa ca, mahānāmnā ca, bhadrajitā p2 ca, yaśodevena ca, vimalena ca, subāhunā ca, pūrṇena ca maitrāyaṇīputreṇa, gavāṃpatinā ca, uruvilvākāśyapena ca, nadīkāśyapena ca, bhadrakāśyapena ca, kumārakāśyapena ca, mahākāśyapena ca, śāriputreṇa ca, mahāmaudgalyāyanena ca, mahākapphinena ca, mahācundena ca, aniruddhena ca, rādhena ca, nandikena ca, kimpilena ca, subhūtinā ca, revatena ca, khadiravanikena ca, vakkulena ca, svāgatena ca, amogharājena ca, pārāyaṇikena ca, panthena ca, cūlapanthena ca, nandena ca,	གནས་བརྟན་ཉན་ཐོས་ཆེན་པོ་ཤ་སྟག་ལ་འདི་ལྟ་སྟེ་།
 rāhulena ca, āyuṣmatā cānandena| ebhiś cānyaiś cābhijñānābhijñātaiḥ sthavirair mahāśrāvakair,	ཚེ་དང་ལྡན་པ་ཀུན་ཤེས་ཀོའུ་དི་ནྱ་དང་། ཚེ་དང་ལྡན་པ་རྟ་ཐུལ་དང་། ཚེ་དང་ལྡན་པ་རླངས་པ་དང་། ཚེ་དང་ལྡན་པ་མིང་ཆེན་དང་། ཚེ་དང་ལྡན་པ་རྒྱལ་བཟང་དང་། ཚེ་དང་ལྡན་པ་གྲགས་ལྷ་དང་། ཚེ་དང་ལྡན་པ་དྲི་མ་མེད་པ་དང་། ཚེ་དང་ལྡན་པ་ལག་བཟང་དང་། ཚེ་དང་ལྡན་པ་བྱམས་མའི་བུ་གང་པོ་དང་། ཚེ་དང་ལྡན་པ་བ་གླང་བདག་དང༏་ཚེ་དང་ལྡན་པ་ལྟེང་རྒྱས་འོད་སྲུང་དང་། ཚེ་དང་ལྡན་པ་ཆུ་ཀླུང་འོད་སྲུང་དང་། ཚེ་དང་ལྡན་པ་ག་ཡ་འོད་སྲུང་དང་། ཚེ་དང་ལྡན་པ་གཞོན་ནུ་འོད་སྲུང་དང་། ཚེ་དང་ལྡན་པ་འོད་སྲུང་ཆེན་པོ་དང༏་ཚེ་དང་ལྡན་པ་ཤའ་རིའི་བུ་དང་། ཚེ་དང་ལྡན་པ་མོའུ་དགལ་གྱི་བུ་ཆེན་པོ་དང་། ཚེ་དང་ལྡན་པ་གསུས་པོ་ཆེ་དང་། ཚེ་དང་ལྡན་པ་ཀ་པི་ན་ཆེན་པོ་དང་། ཚེ་དང་ལྡན་པ་སྐུལ་བྱེད་ཆེན་པོ་དང་། ཚེ་དང་ལྡན་པ་མ་འགགས་པ་དང་། ཚེ་དང་ལྡན་པ་གྲུམ་པོ་དང་། ཚེ་དང་ལྡན་པ་དགའ་ཡོད་དང་། ཚེ་དང་ལྡན་པ་ཀིམ་པི་ལ་དང་། ཚེ་དང་ལྡན་པ་རབ་འབྱོར་དང་། ཚེ་དང་ལྡན་པ་ནམ་གྲུ་དང་། ༄༣༦༨ཨ་༌༎ ཚེ་དང་ལྡན་པ་སེང་ལྡེང་ནགས་པ་དང་། ཚེ་དང་ལྡན་པ་བ་ཀུ་ལ་དང་། ཚེ་དང་ལྡན་པ་ལེགས་འོངས་དང་། ཚེ་དང་ལྡན་པ་དོན་ཡོད་རྒྱལ་པོ་དང་། ཚེ་དང་ལྡན་པ་ཕ་རོལ་སོན་དང་། ཚེ་དང་ལྡན་པ་ལམ་བསྟན་པ་དང་། ཚེ་དང་ལྡན་པ་ལམ་ཕྲན་བསྟན་པ་དང་། ཚེ་དང་ལྡན་པ་སྒྲ་གཅན་ཟིན་དང་། ཚེ་དང་ལྡན་པ་དགའ་བོ་དང་། དེ་དག་དང་གཞན་ཡང་མངོན་པར་ཤེས་པས་མངོན་པར་ཤེས་པ་གནས་བརྟན་ཉན་ཐོས་ཆེན་པོ་ཤ་སྟག་སྟེ་། 
 ekapudgalaṃ sthāpayitvā śaikṣapratipady uttarikaraṇīyaṃ,	གང་ཟག་གཅིག་མ་གཏོགས་པ་ནི་།
 yad idam : āyuṣmantam ānandaṃ, maitreyapūrvaṃgamaiś	འདི་ལྟ་སྟེ་། སློབ་པའི་ལམ་ལ་གོང་དུ་བྱ་བ་ཡོད་པ་ཚེ་དང་ལྡན་པ་ཀུན་དགའ་བོའོ་༎
 ca saṃbahulaiś ca bodhisattvair mahāsattvaiḥ| atha khalv āyuṣmān ānanda utthāyāsanād ekāṃśam uttarāsaṅgaṃ kṛtvā dakṣiṇaṃ jānumaṇḍalaṃ pṛthivyāṃ pratiṣṭhāpya	བྱམས་པ་ལ་སོགས་པ་བྱང་ཆུབ་སེམས་དཔའ་སེམས་དཔའ་ཆེན་པོ་མང་པོ་དང་ཡང་ཐབས་གཅིག་གོ་། དེ་ནས་ཚེ་དང་ལྡན་པ་ཀུན་དགའ་བོ་སྟན་ལས་ལངས་ཏེ་བླ་གོས་ཕྲག་པ་གཅིག་ཏུ་གཟར་ནས་པུས་མོ་ག-ཡས་པའི་ལྷ་ང་ས་ལ་། བཙུགས་ཏེ་། 
 yena bhagavāṃs tenāñjaliṃ praṇamya bhagavantam etad avocat :	བཅོམ་ལྡན་འདས་ག་ལ་བ་དེ་ལོངས་སུ་ཐལ་མོ་སྦྱར་བ་བཏུད་ནས་། བཅོམ་ལྡན་འདས་ལ་འདི་སྐད་ཅེས་གསོལ་ཏོ་༎
 viprasannāni ca tava bhagavata indriyāṇi, pariśuddhaś chavivarṇaḥ,	བཅོམ་ལྡན་འདས་ཁྱོད་ཀྱི་དབང་པོ་རྣམས་ནི་ཤིན་ཏུ་དང་། ཞལ་གྱི་མདོག་ནི་ཡོངས་སུ་དག་།
 paryavadāto mukhavarṇaḥ pītanirbhāsaḥ, tad yathā śāradaṃ vanadaṃ pāṇḍu pariśuddhaṃ	པགས་པའི་མདོག་ནི་ཡོངས་སུ་བྱང་ཞིང་སེར་པོར་གདའ་སྟེ༏་འདི་ལྟ་སྟེ་། དཔེར་ན་། སྟོན་གྱི་གོས་སེར་སྐྱ་ཡོངས་སུ་དག་པ་། ཡོངས་སུ་སྦྱངས་པ་།
 paryavadātaṃ pītanirbhāsaṃ| evam eva bhagavato	སེར་པོ་གདའ་བ་དེ་བཞིན་དུ་།
 viprasannānīndriyāṇi, pariśuddho mukhavarṇaḥ, paryavadātaś	བཅོམ་ལྡན་འདས་ཀྱི་དབང་པོ་རྣམས་ནི་ཤིན་ཏུ་དང་། ཞལ་གྱི་༄༣༦༨བ་མདོག་ནི་ཡོངས་སུ་དག་།
 chavivarṇaḥ pītanirbhāsaḥ| tad yathāpi nāma bhagavañ	པགས་པའི་མདོག་ནི་ཡོངས་སུ་བྱང་ཞིང་སེར་པོར་གདའ་སྟེ་། བཙུན་པ་བཅོམ་ལྡན་འདས་། འདི་ལྟ་སྟེ་། དཔེར་བགྱི་ན་།
 jāṃbūnadasuvarṇaniṣko, dakṣeṇa karmāreṇa karmāraputreṇa volkāmukhe saṃpraveśya supariniṣṭhitaḥ pāṇḍukambalair p3 upari kṣipto,	འཛམ་བུའི་ཆུ་བོའི་གསེར་བརྒྱ་ཆད་པ་མགར་བའམ་། མགར་བའི་སློབ་མ་མཁས་པ་ཞིག་གི་ནང་དུ་སྩལ་ཏེ་།
 'tīvapariśuddho bhavati ; paryavadātaḥ pītanirbhāsaḥ| evam eva bhagavato viprasannānīndriyāṇi,	ཤིན་ཏུ་སྦྱངས་ནས་ལ་བ་སེར་པོའི་ནང་དུ་སྩལ་ན་ཤིན་ཏུ་ཡོངས་སུ་དག་ཅིང་ཡོངས་སུ་བྱང་ལ་སེར་པོར་གདའ་བར་འགྱུར་རོ༏་༏དེ་བཞིན་དུ་བཅོམ་ལྡན་འདས་ཀྱི་དབང་པོ་རྣམས་ནི་ཤིན་ཏུ་དང་། 
 pariśuddho mukhavarṇaḥ,	ཞལ་གྱི་མདོག་ནི་ཡོངས་སུ་དག་།
 paryavadātaś chavivarṇaḥ pītanirbhāsaḥ|	པགས་པའི་མདོག་ནི་ཡོངས་སུ་བྱང་ཞིང་སེར་པོར་གདའོ་༎
 na khalu punar ahaṃ bhagavann abhijānāmi : iti	བཅོམ་ལྡན་འདས་།
 pūrvaṃ purvataram, evaṃ viprasannāni tathāgatasyendriyāṇy, evaṃ pariśuddhaṃ mukhavarṇaṃ, paryavadātaṃ chavivarṇaṃ	བདག་གིས་སྔ་བས་ཀྱང་ཆེས་སྔ་བ་ན་དེ་བཞིན་གཤེགས་པའི་དབང་པོ་འདི་ལྟར་དང་བ་དང་། ཞལ་གྱི་མདོག་འདི་ལྟར་ཡོངས་སུ་དག་པ་དང་། པགས་པའི་མདོག་ཡོངས་སུ་བྱང་ཞིང་སེར་པོར་གདའ་བ་མ་འཚལ་ཏོ་༎
 pītanirbhāsam| tasya me bhagavann evaṃ bhavati : buddhavihāreṇa vatādya tathāgato viharati ; jinavihāreṇa, sarvajñatāvihāreṇa,	བཅོམ་ལྡན་འདས་། དེ་ལ་བདག་འདི་སྙམ་དུ་བགྱིད་དེ་།
 mahānāgavihāreṇa vatādya tathāgato viharati| atītānāgatapratyutpannān tathāgatān arhataḥ samyaksaṃbuddhān samanupaśyatīti|	དེ་བཞིན་གཤེགས་པ་དེ་རིང་འདས་པ་དང་། མ་བྱོན་པ་དང་། ད་ལྟར་བྱུང་བའི་དེ་བཞིན་གཤེགས་པ་དགྲ་བཅོམ་པ་ཡང་དག་པར་རྫོགས་པའི་སངས་རྒྱས་རྣམས་རྗེས་སུ་དགོངས་ཤིང་། དེ་བཞིན་གཤེགས་པ་དེ་རིང་སངས་རྒྱས་ཀྱི་གནས་པས་བཞུགས་ཏེ་། རྒྱལ་བར་གནས་པ་དང་། ཐམས་ཅད་མཁྱེན་པ་ཉིད་ཀྱི་གནས་པ་དང་། གླང་པོ་ཆེན་པོའི་གནས་པས་བཞུགས་པ་སྙམ་བགྱིད་དོ་༎
 evam ukte, bhagavān āyuṣmantam ānandam etad avocat :	དེ་སྐད་ཅེས་གསོལ་པ་དང་། བཅོམ་ལྡན་འདས་ཀྱིས་ཚེ་དང་ལྡན་པ་ཀུན་དགའ་བོ་ལ་འདི་༄༣༦༩ཨ་༌༎ སྐད་ཅེས་བཀའ་སྩལ་ཏོ་༎
 sādhu sādhv ānanda,	ཀུན་དགའ་བོ་། ལེགས་སོ་༎ ལེགས་སོ་༎
 kiṃ punas te devatā etam artham ārocayanty,	ཅི་དོན་འདི་ཁྱོད་ལ་ལྷ་རྣམས་ཀྱིས་བསྙད་དམ་།
 utāho buddhā bhagavantaḥ| atha svena pratyutpanna-	འོན་ཏེ་སངས་རྒྱས་བཅོམ་ལྡན་འདས་རྣམས་ཀྱིས་སམ་།
 mīmāṃsājñānenaivaṃ prajānāsīti| evam ukte, āyuṣmān	འོན་ཏེ་བདག་རང་གི་དཔྱོད་པའི་ཤེས་པས་དེ་ལྟར་ཤེས་།
 ānando bhagavantam etad avocat :	དེ་སྐད་ཅེས་བཀའ་སྩལ་པ་དང་། བཅོམ་ལྡན་འདས་ལ་ཚེ་དང་ལྡན་པ་ཀུན་དགའ་བོས་འདི་སྐད་ཅེས་གསོལ་ཏོ་༎ བཅོམ་ལྡན་འདས་།
 na me bhagavan devatā etam artham ārocayanti,	དོན་འདི་ནི་ལྷ་རྣམས་ཀྱིས་བདག་ལ་བསྙད་པ་ཡང་མ་མཆིས་།
 nāpi buddhā bhagavantaḥ| atha	སངས་རྒྱས་བཅོམ་ལྡན་འདས་ཀྱིས་ཀྱང་མ་ལགས་ཀྱི་། བཅོམ་ལྡན་འདས་།
 tarhi me bhagavan svenaiva pratyātmamīmāṃsājñānenaivaṃ	བདག་རང་གི་དཔྱོད་པའི་འཚལ་བས་འདི་སྙམ་དུ་དེ་བཞིན་གཤེགས་པ་ནི་དེ་རིང་འདས་པ་དང་། མ་བྱོན་པ་དང་། ད་ལྟར་བྱུང་བའི་དེ་བཞིན་གཤེགས་པ་དགྲ་བཅོམ་པ་ཡང་དག་པར་རྫོགས་པའི་སངས་རྒྱས་རྣམས་རྗེས་སུ་དགོངས་ཤིང་། 
 bhavati : buddhavihāreṇādya tathāgato viharati ;	དེ་བཞིན་གཤེགས་པ་དེ་རིང་སངས་རྒྱས་ཀྱི་གནས་པས་བཞུགས་ཏེ་།
 jinavihāreṇa, sarvajñatāvihāreṇa, mahānāgavihāreṇa vatādya tathāgato viharati ; atītānāgatapratyutpannān sarvān buddhān bhagavataḥ p4	རྒྱལ་བའི་གནས་པ་དང་། ཐམས་ཅད་མཁྱེན་པ་ཉིད་ཀྱི་གནས་པ་དང་། གླང་པོ་ཆེན་པོའི་གནས་པས་བཞུགས་སོ་སྙམ་བགྱིད་དོ་༎
 samanupaśyatīti| evam ukte, bhagavān āyuṣmantam ānandam etad avocat : sādhu sādhv ānanda ;	དེ་སྐད་ཅེས་གསོལ་པ་དང་། བཅོམ་ལྡན་འདས་ཀྱིས་ཚེ་དང་ལྡན་པ་ཀུན་དགའ་བོ་ལ་འདི་སྐད་ཅེས་བཀའ་སྩལ་ཏོ་༎
 udāraḥ khalu ta unmiñjiḥ, bhadrikā	ཀུན་དགའ་བོ་། ཁྱོད་ཀྱི་རྟོག་པ་རྒྱ་ཆེ་སྟེ་།
 mīmāṃsā, kalyānaṃ pratibhānaṃ, bahujanahitāya yas	དཔྱོད་པ་བཟང་ཞིང་སྤོབས་པས་དགེ་སྟེ་། ཀུན་དགའ་བོ་།
 tvam ānanda pratipanno, bahujanasukhāya, lokānukampāyai, mahato janakāyasyārthāya, hitāya sukhāya devānāṃ ca manuṣyānāṃ	ཁྱོད་སྐྱེ་བོ་མང་པོ་ལ་ཕན་པ་དང་། སྐྱེ་བོ་མང་པོ་ལ་བདེ་བའི་ཕྱིར་ཞུགས་པ་དང་། འཇིག་རྟེན་ལ་སྙིང་༄༣༦༩བ་བརྩེ་བ་དང་། སྐྱེ་བོའི་ཚོགས་ཕལ་པོ་ཆེ་དང་། ལྷ་དང་མི་རྣམས་ཀྱི་དོན་དང་། ཕན་པ་དང་། བདེ་བའི་ཕྱིར་ཁྱོད་དེ་བཞིན་གཤེགས་པ་ལ་དོན་འདི་འདྲི་བར་སེམས་པ་ལེགས་སོ་༎
 ca, yas tvaṃ tathāgatam etam arthaṃ paripraṣṭavyaṃ	ལེགས་སོ་༎
 manyase| evam etad bhavaty ānanda, tathāgateṣv arhatsu	ཀུན་དགའ་བོ༏་དེ་དེ་བཞིན་ཏེ་།
 samyaksaṃbuddheṣv aprameyeṣv asaṃkhyeyeṣu jñānadarśanam upasaṃharataḥ,	དེ་བཞིན་གཤེགས་པ་དགྲ་བཅོམ་པ་ཡང་དག་པར་རྫོགས་པའི་སངས་རྒྱས་དཔག་ཏུ་མེད་།
 na ca tathāgatasya jñānam upahanyate|	གྲངས་མེད་པ་དག་གིས་ཡེ་ཤེས་མཐོང་བ་སྡུད་ཀྱང་དེ་བཞིན་གཤེགས་པའི་ཡེ་ཤེས་མཐོང་བ་ལ་གནོད་པ་མེད་དོ་༎
 tat kasya hetoḥ| apratihatahetujñānadarśano hy ānanda tathāgataḥ|	དེ་ཅིའི་ཕྱིར་ཞེ་ན་། ཀུན་དགའ་བོ་། དེ་བཞིན་གཤེགས་པའི་ཡེ་ཤེས་མཐོང་བ་ཐོགས་པ་མེད་པའི་ཕྱིར་ཏེ་། ཀུན་དགའ་བོ་།
 ākāṅkṣan ānanda tathāgata ekapiṇḍapātena kalpaṃ vā tiṣṭhet,	དེ་བཞིན་གཤེགས་པ་བཞེད་ན་། བསོད་སྙོམས་གཅིག་གིས་བསྐལ་པའམ་།
 kalpaśataṃ vā,	བསྐལ་པ་བརྒྱའམ་།
 kalpasahasraṃ vā,	བསྐལ་པ་སྟོང་ངམ་།
 kalpaśatasahasraṃ vā, yāvat kalpakoṭīnayutaśatasahasraṃ vā, tato	བསྐལ་པ་བརྒྱ་སྟོང་ངམ་།
 vottari, na ca tathāgatasyendriyāṇy upanaśyeyuḥ ; na mukha-	དེ་བས་ཀྱང་ལྷག་པར་བཞུགས་ཀྱང་དེ་བཞིན་གཤེགས་པའི་དབང་པོ་རྣམས་ལ་ཉམས་པ་མེད་དོ་༎
 varṇasyānyathātvaṃ bhavet ;	ཞལ་གྱི་མདོག་གཞན་དུ་འགྱུར་བ་མེད་དོ་༎
 nāpi chavivarṇa upahanyate| tat	པགས་པའི་མདོག་ལ་གནོད་པ་མེད་དོ་༎
 kasya hetoḥ| tathā hy ānanda tathāgataḥ samādhimukha-	དེ་ཅིའི་ཕྱིར་ཞེ་ན་། ཀུན་དགའ་བོ་། འདི་ལྟར་དེ་བཞིན་གཤེགས་པ་ནི་ཏིང་ངེ་འཛིན་གྱི་བདེ་བའི་ཕ་རོལ་ཏུ་བྱོན་པའོ་༎ ཀུན་དགའ་བོ་།
 pāramitāprāptaḥ| samyaksaṃbuddhānām ānanda loke sudurlabhaḥ prādurbhāvaḥ ;	ཡང་དག་པར་རྫོགས་པའི་སངས་རྒྱས་རྣམས་འཇིག་རྟེན་དུ་འབྱུང་བ་ཤིན་ཏུ་དཀའ་སྟེ་།
 tad yathodumbarapuṣpāṇāṃ loke prādurbhāvaḥ sudurlabho bhavati,	འདི་ལྟ་སྟེ་། དཔེར་ན་། ཨཽ་དུ་མ་བ་རའི་མེ་ཏོག་འཇིག་རྟེན་དུ་འབྱུང་བ་དཀའ་བ་དེ་བཞིན་དུ་། ཀུན་དགའ་བོ་།
 evam eva tathāgatānām arthakāmānāṃ	དེ་བཞིན་གཤེགས་པ་དགྲ་བཅོམ་པ་ཡང་དག་པར་རྫོགས་པའི་སངས་རྒྱས་སེམས་ཅན་ཐམས་ཅད་ཀྱི་དོན་བཞེད་པ་། 
 hitaiṣiṇām anukampakānāṃ mahākaruṇāpratipannānāṃ	ཕན་པ་བཞེད་པ་། ༄༣༧༠ཨ་༌༎ ཐུགས་བརྩེ་བ་ཅན་། ཐུགས་རྗེ་ཆེན་པོ་ལ་ཞུགས་པ་རྣམས་འཇིག་རྟེན་དུ་འབྱུང་བ་ནི་ཤིན་ཏུ་དཀའོ་༎
 sudurlabhaḥ prādurbhāvaḥ| api tu khalv āryānanda p5	ཀུན་དགའ་བོ་།
 tathāgatasyaivaiṣo 'nubhāvo, yas tvaṃ sarvalokācāryāṇām	གང་ཁྱོད་འཇིག་རྟེན་ཐམས་ཅད་ཀྱི་སློབ་དཔོན་ཁོང་དཔའ་བ་དག་འཇིག་རྟེན་དུ་འབྱུང་བར་བྱ་བ་དང་། 
 sattvānāṃ loke prādurbhāvāya bodhisattvānāṃ mahāsattvānām arthāya tathāgatam etam arthaṃ paripraṣṭavyaṃ manyase|	བྱང་ཆུབ་སེམས་དཔའ་སེམས་དཔའ་ཆེན་པོ་རྣམས་ཀྱི་དོན་གྱི་ཕྱིར་དེ་བཞིན་གཤེགས་པ་ལ་དོན་འདྲི་བར་སེམས་པ་དེ་ནི་དེ་བཞིན་གཤེགས་པའི་མཐུ་ཡིན་ནོ་༎
 tena hy ānanda śṛṇu sādhu ca suṣṭḥu ca, manasi kuru,	ཀུན་དགའ་བོ་། དེའི་ཕྱིར་ལེགས་པར་རབ་ཏུ་ཉོན་ལ་ཡིད་ལ་གཟུང་ཞིག་དང་། ངས་ཁྱོད་ལ་བཤད་དོ་༎
 bhāṣiṣye 'haṃ te| evaṃ bhagavann ity āyuṣmān ānando bhagavataḥ pratyaśrauṣīt|	ཀུན་དགའ་བོས་བཅོམ་ལྡན་འདས་དེ་བཞིན་ནོ་ཞེས་གསོལ་ཏེ་།
 bhagavāṃs tasyaitad avocat :	བཅོམ་ལྡན་འདས་ཀྱི་ལྟར་ཉན་པ་དང་། བཅོམ་ལྡན་འདས་ཀྱིས་འདི་སྐད་ཅེས་བཀའ་སྩལ་ཏོ་༎ ཀུན་དགའ་བོ་།
 bhūtapūrvam ānandātīte 'dhvanīto 'saṃkhyeye kalpe 'saṃkhyeyatare vipule 'prameye	སྔོན་བྱུང་བ་འདས་པའི་དུས་ན་འདི་ནས་བསྐལ་པ་གྲངས་མེད་པའི་ཡང་ཆེས་གྲངས་མེད་པ་།
 'cintye, yadāsīt tena kālena tena samayena dīpaṃkaro nāma	ཤིན་ཏུ་རྒྱས་པ་ཚང་མེད་པ་དང་། བསམ་གྱིས་མི་ཁྱབ་པར་གྱུར་པ་དེའི་ཚེ་དེའི་དུས་ན་དེ་བཞིན་གཤེགས་པ་དགྲ་བཅོམ་པ་ཡང་དག་པར་རྫོགས་པའི་སངས་རྒྱས་མར་མེ་མཛད་ཅེས་བྱ་བ་འཇིག་རྟེན་དུ་བྱུང་ངོ་༎ ཀུན་དགའ་བོ་།
 tathāgato 'rhan samyaksaṃbuddho loka udapādi| dīpaṃkarasyānanda pareṇa parataraṃ pratāpavān nāma tathāgato 'bhūt| tasya pareṇa parataraṃ prabhākaro nāma tathāgato	དེ་བཞིན་གཤེགས་པ་མར་མེ་མཛད་ཀྱི་སྔ་རོལ་གྱི་ཡང་ཆེས་སྔ་རོལ་དུ་དེ་བཞིན་གཤེགས་པ་འོད་ལྡན་ཞེས་བྱ་བ་བྱུང་ངོ་༎
 'bhūt| tasya pareṇa parataraṃ candanagandho nāma tathāgato	དེའི་སྔ་རོལ་གྱི་ཡང་ཆེས་སྔ་རོལ་དུ་དེ་བཞིན་གཤེགས་པ་འོད་མཛད་ཅེས་བྱ་བ་བྱུང་ངོ་༎ དེའི་སྔ་རོལ་གྱི་ཡང་ཆེས་སྔ་རོལ་དུ་དེ་བཞིན་གཤེགས་པ་ཙན་དན་༄༣༧༠བ་གྱི་དྲི་ཞེས་བྱ་བ་བྱུང་ངོ་༎ ཀུན་དགའ་བོ་།
 'bhūt| tasya pareṇa parataraṃ sumerukalpo nāma tathāgato 'bhūt| evaṃ candrānano nāma, vimalānano nāma, anupalipto nāma,	དེ་བཞིན་གཤེགས་པ་ཙན་དན་གྱི་དྲི་དེའི་སྔ་རོལ་གྱི་ཡང་ཆེས་སྔ་རོལ་དུ་དེ་བཞིན་གཤེགས་པ་རི་རབ་ལྟ་བུ་ཞེས་བྱ་བ་བྱུང་ངོ་༎ དེ་བཞིན་དུ་དེ་བཞིན་གཤེགས་པ་ཟླ་བའི་ཞལ་ཞེས་བྱ་བ་བྱུང་ངོ་༎
 vimalaprabho nāma, nāgābhibhūr nāma, sūryānano nāma, girirājaghoṣo nāma, sumerukūṭo nāma, suvarṇaprabhāso nāma, jyotiṣprabho nāma, vaiḍūryanirbhāso nāma, brahmaghoṣo nāma,	དེ་བཞིན་གཤེགས་པ་དྲི་མ་མེད་པའི་ཞལ་ཞེས་བྱ་བ་དང་། དེ་བཞིན་གཤེགས་པ་མི་གོས་པ་ཞེས་བྱ་བ་དང་། དེ་བཞིན་གཤེགས་པ་འོད་དྲི་མ་མེད་པ་ཞེས་བྱ་བ་དང་། དེ་བཞིན་གཤེགས་པ་ཀླུ་ཟིལ་གྱིས་གནོན་པ་ཞེས་བྱ་བ་དང་། དེ་བཞིན་གཤེགས་པ་ཉི་མའི་ཞལ་ཞེས་བྱ་བ་དང་། དེ་བཞིན་གཤེགས་པ་རིའི་རྒྱལ་པོ་དབྱངས་ཞེས་བྱ་བ་དང་། དེ་བཞིན་གཤེགས་པ་རི་རབ་དབྱངས་ཞེས་བྱ་བ་དང་། དེ་བཞིན་གཤེགས་པ་རི་རབ་བརྩེགས་པ་ཞེས་བྱ་བ་དང་། དེ་བཞིན་གཤེགས་པ་གསེར་འོད་ཅེས་བྱ་བ་དང་། དེ་བཞིན་གཤེགས་པ་སྐར་མའི་འོད་ཅེས་བྱ་བ་དང་། དེ་བཞིན་གཤེགས་པ་བེཨེདའུརྱ་སྣང་བ་ཞེས་བྱ་བ་དང་། དེ་བཞིན་གཤེགས་པ་ཚངས་པའི་དབྱངས་ཞེས་བྱ་བ་དང་། དེ་བཞིན་གཤེགས་པ་ཟླ་བ་ཟིལ་གྱིས་གནོན་པ་ཞེས་བྱ་བ་དང་། དེ་བཞིན་གཤེགས་པ་ཉི་མའི་དབྱངས་ཞེས་བྱ་བ་དང་། དེ་བཞིན་གཤེགས་པ་མེ་ཏོག་སིལ་མའི་འོད་ཀྱི་རྒྱན་ཞེས་བྱ་བ་དང་། དེ་བཞིན་གཤེགས་པ་དཔལ་བརྩེགས་ཞེས་བྱ་བ་དང་། དེ་བཞིན་གཤེགས་པ་རྒྱ་མཚོ་མཆོག་གི་བློས་རྣམ་པར་རོལ་པ་མངོན་པར་མཁྱེན་པ་ཞེས་བྱ་བ་དང་། 
 candrābhibhūr nāma, sūryaghoṣo nāma, muktakusumapratimaṇḍitaprabho nāma,	དེ་བཞིན་གཤེགས་པ་འོད་མཆོག་ཅེས་བྱ་བ་དང་། དེ་བཞིན་གཤེགས་པ་སྤོས་ཀྱི་རྒྱལ་པོ་༄༣༧༡ཨ་༌༎
 śrīkūto nāma, sāgaravarabuddhivikrīḍitābhijño nāma, varaprabho nāma, mahāgandharājanirbhāso nāma, vyapagatakhilamalapratigho nāma, śūrakūṭo nāma, ratnajaho nāma, mahāguṇadharabuddhiprāptābhijño	ཆེན་པོར་སྣང་བ་ཞེས་བྱ་བ་དང་། དེ་བཞིན་གཤེགས་པ་ཐ་བ་དང་། དྲི་མ་དང་། ཁོང་ཁྲོ་བ་དང་བྲལ་བ་ཞེས་བྱ་བ་དང་། དེ་བཞིན་གཤེགས་པ་དཔལ་བརྩེགས་ཞེས་བྱ་བ་དང་། དེ་བཞིན་གཤེགས་པ་རིན་པོ་ཆེ་གཏོང་བ་ཞེས་བྱ་བ་དང་། དེ་བཞིན་གཤེགས་པ་ཡོན་ཏན་ཆེན་པོ་མངའ་བའི་བློ་བརྙེས་པའི་མངོན་པར་མཁྱེན་པ་ཞེས་བྱ་བ་དང་། 
 nāma, candrasūryajihmīkaraṇo nāma, uttaptavaiḍūryanirbhāso nāma, cittadhārābuddhisaṃkusumitābhyudgato p6	དེ་བཞིན་གཤེགས་པ་འོད་ཀྱིས་ཉི་ཟླའི་ཟིལ་དུ་བརླག་པར་མཛད་ཅེས་བྱ་བ་དང་། དེ་བཞིན་གཤེགས་པ་བེཨེ་དའུརྱ་སྦྱངས་པར་སྣང་བ་ཞེས་བྱ་བ་དང་། དེ་བཞིན་གཤེགས་པ་སེམས་ཀྱི་རྒྱུད་ཀྱི་བློ་ཤིན་ཏུ་རྒྱས་པ་མངོན་པར་འཕགས་པ་ཞེས་བྱ་བ་དང་། 
 nāma puṣpāvatīvanarājasaṃkusumitābhijño nāma, puṣpākaro nāma, udakacandropamo nāma, avidyāndhakāravidhvaṃsanakaro nāma, lokendro nāma, muktacchatrāpravāḍasadṛśo nāma, tiṣyo nāma,	དེ་བཞིན་གཤེགས་པ་མེ་ཏོག་གི་ཕྲེང་བའི་ནགས་ཀྱི་རྒྱལ་པོ་མེ་ཏོག་ཀུན་དུ་རྒྱས་པ་མངོན་པར་མཁྱེན་པ་ཞེས་བྱ་བ་དང་། དེ་བཞིན་གཤེགས་པ་མེ་ཏོག་གི་འབྱུང་གནས་ཞེས་བྱ་བ་དང་། དེ་བཞིན་གཤེགས་པ་ཆུ་ཟླ་ལྟ་བུ་ཞེས་བྱ་བ་དང་། དེ་བཞིན་གཤེགས་པ་མ་རིག་པའི་མུན་པ་རྣམ་པར་འཇོམས་པ་ཞེས་བྱ་བ་དང་། དེ་བཞིན་གཤེགས་པ་འཇིག་རྟེན་དབང་པོ་ཞེས་བྱ་བ་དང་། དེ་བཞིན་གཤེགས་པ་མུ་ཏིག་བྱི་རུ་འདྲ་བའི་གདུགས་ཞེས་བྱ་བ་དང་། དེ་བཞིན་གཤེགས་པ་བཞེད་པ་ཞེས་བྱ་བ་དང་། དེ་བཞིན་གཤེགས་པ་ཆོས་ཀྱི་བློ་གྲོས་ཀྱིས་བསྒྲགས་པའི་རྒྱལ་པོ་ཞེས་བྱ་བ་དང་། དེ་བཞིན་གཤེགས་པ་སེང་གེ་དང་རྒྱ་མཚོ་བརྩེགས་པ་ལྟར་བསྒྲགས་པའི་རྒྱལ་པོ་ཞེས་བྱ་བ་དང་། དེ་༄༣༧༡བ་བཞིན་གཤེགས་པ་རྒྱ་མཚོ་རི་རབ་ཟླ་བ་ཞེས་བྱ་བ་དང་། དེ་བཞིན་གཤེགས་པ་ཚངས་པའི་དབྱངས་ཀྱི་ང་རོ་ལ་མངོན་པར་དགོས་པ་ཞེས་བྱ་བ་དང་། དེ་བཞིན་གཤེགས་པ་མེ་ཏོག་འབྱུང་ཞེས་བྱ་བ་དང་། དེ་བཞིན་གཤེགས་པ་སྡེ་བརྙེས་ཞེས་བྱ་བ་དང་། དེ་བཞིན་གཤེགས་པ་ཉི་ཟླ་ཞེས་བྱ་བ་དང་། དེ་བཞིན་གཤེགས་པ་ལྷུན་པོ་བརྩེགས་ཞེས་བྱ་བ་དང་། དེ་བཞིན་གཤེགས་པ་ཟླ་འོད་ཅེས་བྱ་བ་དང་། དེ་བཞིན་གཤེགས་པ་དྲི་མ་མེད་པའི་སྤྱན་ཞེས་བྱ་བ་དང་། དེ་བཞིན་གཤེགས་པ་རི་བོའི་རྒྱལ་པོ་སྒྲ་དབྱངས་ཞེས་བྱ་བ་དང་། དེ་བཞིན་གཤེགས་པ་མེ་ཏོག་འོད་ཅེས་བྱ་བ་དང་། དེ་བཞིན་གཤེགས་པ་མེ་ཏོག་གི་ཆར་རབ་ཏུ་འཐོར་བ་ཞེས་བྱ་བ་དང་། དེ་བཞིན་གཤེགས་པ་རིན་པོ་ཆེའི་གདུགས་ཞེས་བྱ་བ་དང་། དེ་བཞིན་གཤེགས་པ་པདམས་སྲང་མཛེས་པར་མཛད་ཅེས་བྱ་བ་དང་། དེ་བཞིན་གཤེགས་པ་ཙན་དན་གྱི་དྲི་ཞེས་བྱ་བ་དང་། དེ་བཞིན་གཤེགས་པ་རྒྱ་སྤོས་དྲི་ཞེས་བྱ་བ་དང་། དེ་བཞིན་གཤེགས་པ་རིན་པོ་ཆེར་སྣང་བ་ཞེས་བྱ་བ་དང་། དེ་བཞིན་གཤེགས་པ་མུ་ཁྱུད་ཅེས་བྱ་བ་དང་། དེ་བཞིན་གཤེགས་པ་བཀོད་པ་ཆེན་པོ་ཞེས་བྱ་བ་དང་། དེ་བཞིན་གཤེགས་པ་ཐ་བ་དང་། ཞེ་སྡང་དང་བྲལ་བ་ཞེས་བྱ་བ་དང་། དེ་བཞིན་གཤེགས་པ་ཚངས་པའི་དབྱངས་ཞེས་བྱ་བ་དང་། དེ་བཞིན་གཤེགས་པ་རིན་པོ་ཆེ་སྣ་བདུན་གྱི་ཆར་འབེབས་པ་ཞེས་བྱ་བ་དང་། དེ་བཞིན་གཤེགས་པ་ཡོན་ཏན་ཆེན་པོ་མངའ་བ་ཞེས་བྱ་བ་དང་། དེ་༄༣༧༢ཨ་༌༎
 dharmamativinanditarājo nāma, siṃha- sāgarakūṭavinanditarājo nāma, sāgaramerucandro nāma, brahma- svaranādābhinandino nāma, kusumasaṃbhavo nāma, prāptaseno nāma, candrabhānur nāma, merukūṭo nāma, candraprabho	བཞིན་གཤེགས་པ་ཏ་མ་ལའི་ལོ་མ་དང་། ཙན་དན་གྱི་རྫབ་ཅན་ཞེས་བྱ་བ་དང་། དེ་བཞིན་གཤེགས་པ་མེ་ཏོག་མངོན་པར་མཁྱེན་ཞེས་བྱ་བ་དང་། དེ་བཞིན་གཤེགས་པ་མི་ཤེས་པ་རྣམ་པར་འཇོམས་ཞེས་བྱ་བ་དང་། དེ་བཞིན་གཤེགས་པ་རལ་པ་ཅན་ཞེས་བྱ་བ་དང་། དེ་བཞིན་གཤེགས་པ་མུ་ཏིག་གི་གདུགས་ཞེས་བྱ་བ་དང་། དེ་བཞིན་གཤེགས་པ་གསེར་གྱི་སྙིང་པོ་ཞེས་བྱ་བ་དང་། དེ་བཞིན་གཤེགས་པ་བེཨེ་དའུརྱའི་སྙིང་པོ་ཞེས་བྱ་བ་དང་། དེ་བཞིན་གཤེགས་པ་མེ་ཏོག་ཆེན་པོ་ཞེས་བྱ་བ་དང་། དེ་བཞིན་གཤེགས་པ་ཆོས་ཀྱི་ཏོག་ཅེས་བྱ་བ་དང་། དེ་བཞིན་གཤེགས་པ་རིན་ཆེན་དཔལ་ཞེས་བྱ་བ་དང་། དེ་བཞིན་གཤེགས་པ་མིའི་དབང་པོ་ཞེས་བྱ་བ་དང་། དེ་བཞིན་གཤེགས་པ་འཇིག་རྟེན་དབང་པོ་ཞེས་བྱ་བ་དང་། དེ་བཞིན་གཤེགས་པ་ཐུགས་རྗེ་ཅན་ཞེས་བྱ་བ་དང་། དེ་བཞིན་གཤེགས་པ་འཇིག་རྟེན་མཛེས་ཞེས་བྱ་བ་དང་། དེ་བཞིན་གཤེགས་པ་ཚངས་པའི་ཏོག་ཅེས་བྱ་བ་དང་། དེ་བཞིན་གཤེགས་པ་ཆོས་ཀྱི་བློ་གྲོས་ཞེས་བྱ་བ་དང་། དེ་བཞིན་གཤེགས་པ་སེང་གེ་ཞེས་བྱ་བ་དང་། དེ་བཞིན་གཤེགས་པ་སེང་གེའི་བློ་གྲོས་ཞེས་བྱ་བ་བྱུང་སྟེ་།
 nāma, vimalanetro nāma, girirājaghoṣeśvaro nāma, kusumaprabho nāma, kusumavṛṣṭyābhiprakīrṇo nāma, ratnacchatro nāma, padmavīthyupaśobhito nāma, tagaragandho nāma, ratnanirbhāso nāma, nirmito nāma, mahāvyūho nāma, vyapagatakhiladoṣo nāma, brahmaghoṣo nāma, saptaratnābhivṛṣṭo nāma, mahāguṇadharo nāma, tamālapatracandanakardamo nāma, kusumābhijño nāma, ajñānavidhvaṃsano nāma, keśarī nāma, muktacchatro nāma, suvarṇagarbho nāma, vaiḍūryagarbho nāma, mahāketur nāma, dharmaketur nāma, ratnaśrīr nāma, narendro nāma, lokendro nāma, kāruṇiko nāma, lokasundaro nāma, brahmaketur nāma, dharmamatir nāma, siṃho nāma, siṃhamatir nāma,	ཀུན་དགའ་བོ་།
 siṃhamater ānanda pareṇa parataraṃ lokeśvararājo nāma tathāgato 'rhan samyaksaṃbuddho loka udapādi,	དེ་བཞིན་གཤེགས་པ་སེང་གེའི་བློ་གྲོས་ཀྱི་སྔ་རོལ་གྱི་ཡང་ཆེས་སྔ་རོལ་དུ་དེ་བཞིན་གཤེགས་པ་དགྲ་བཅོམ་པ་ཡང་དག་པར་རྫོགས་པའི་སངས་རྒྱས་མཁྱེན་པ་དང་ཞབས་སུ་ལྡན་པ་།
 vidyācaraṇa- saṃpannaḥ, sugato, lokavidanuttaraḥ,	བདེ་བར་གཤེགས་༄༣༧༢བ་པ་འཇིག་རྟེན་མཁྱེན་པ་།
 puruṣadamyasārathiḥ,	སྐྱེས་བུ་འདུལ་བའི་ཁ་ལོ་སྒྱུར་བ་བླ་ན་མེད་པ་།
 śāstā devānāṃ ca manuṣyāṇāṃ ca,	ལྷ་དང་མི་རྣམས་ཀྱི་སྟོན་པ་།
 buddho, bhagavān|	སངས་རྒྱས་བཅོམ་ལྡན་འདས་འཇིག་རྟེན་དབང་ཕྱུག་རྒྱལ་པོ་ཞེས་བྱ་བ་འཇིག་རྟེན་དུ་བྱུང་ངོ་༎ ཀུན་དགའ་བོ་།
 tasya khalu punar ānanda lokeśvararājasya tathāgatasyārhataḥ samyaksaṃbuddhasya pravacane dharmākaro nāma bhikṣur abhūd, adhimātraṃ smṛtimān,	དེ་བཞིན་གཤེགས་པ་དགྲ་བཅོམ་པ་ཡང་དག་པར་རྫོགས་པའི་སངས་རྒྱས་འཇིག་རྟེན་དབང་ཕྱུག་རྒྱལ་པོ་དེའི་བསྟན་པ་ལ་དགེ་སློང་ཆོས་ཀྱི་འབྱུང་གནས་ཞེས་བྱ་བ་ཤས་ཆེར་དྲན་པ་དང་ལྡན་པ་། བློ་གྲོས་དང་ལྡན་པ་། རྟོགས་པ་དང་ལྡན་པ་།
 gativān, prajñāvān,	ཤེས་རབ་དང་ལྡན་པ་།
 adhimātraṃ vīryavān,	བརྩོན་འགྲུས་དང་ལྡན་པ་།
 udārādhimuktiḥ|	རྒྱ་ཆེན་པོ་ལ་མོས་པ་ཞིག་བྱུང་ངོ་༎ ཀུན་དགའ་བོ་།
 atha khalu ānanda sa dharmākaro bhikṣur utthāyāsanād p7 ekāṃsam uttarāsaṅgaṃ kṛtvā, dakṣiṇaṃ jānumaṇḍalaṃ pṛthivyāṃ	དེ་ནས་དགེ་སློང་ཆོས་ཀྱི་འབྱུང་གནས་དེ་སྟན་ལས་ལངས་ཏེ་བླ་གོས་ཕྲག་པ་གཅིག་ཏུ་གཟར་ནས་པུས་མོ་ག-ཡས་པའི་ལྷ་ང་ས་ལ་བཙུགས་ཏེ་། 
 pratiṣṭhāpya, yenāsau bhagavān lokeśvararājas tathāgatas tenāñjaliṃ praṇamya,	བཅོམ་ལྡན་འདས་དེ་བཞིན་གཤེགས་པ་འཇིག་རྟེན་དབང་ཕྱུག་རྒྱལ་པོ་ག་ལ་བ་དེ་ལོགས་སུ་ཐལ་མོ་སྦྱར་བ་བཏུད་ནས་།
 bhagavantaṃ namaskṛtya,	བཅོམ་ལྡན་འདས་ལ་ཕྱག་འཚལ་ཏེ་།
 tasmin samaye saṃmukham ābhir gāthābhir abhyaṣṭāvīt :	དེའི་ཚེ་ཚིགས་སུ་བཅད་པ་འདི་དག་གིས་མངོན་སུམ་དུ་བསྟོད་དོ་༎ འོད་ནི་དཔག་མེད་བློ་ནི་མཐའ་ཡས་མཚུངས་༎
 amitaprabha, anantatulyabuddhe, na ca iha anyaprabhā vibhāti kācit|	གཞན་གྱི་འོད་ནི་གང་ཡང་མི་གསལ་ཏེ་༎
 sūryamaṇisirīṇa candra-ābhā, na tapi na bhāsiṣu ebhi sarvaloke| (1)	ཉི་ཟླ་ནོར་བུ་སྣ་ཚོགས་འོད་རྣམས་ནི་༎ འཇིག་རྟེན་ཀུན་ན་ལྷམ་མེ་ལྷན་མེ་ལགས་༎
 rūpam api anantu sattvasāre,	སེམས་ཅན་སྙིང་པོའི་གཟུགས་ནི་མཐའ་ཡས་ཏེ་༎
 tatha api buddhasvaro anantaghoṣaḥ|	དེ་བཞིན་སངས་རྒྱས་གསུང་ནི་མཐའ་ཡས་དབྱངས་༎
 śīlam api samādhiprajñavīryaiḥ	ཚུལ་ཁྲིམས་ཏིང་འཛིན་ཤེས་རབ་བརྩོན་འགྲུས་ཀྱང་༎
 sadṛśu na te 'stiha loki kaścid anyaḥ| (2)	ཁྱོད་འདྲ་འཇིག་རྟེན་འདི་ན་གཞན་༄༣༧༣ཨ་༌༎ མ་མཆིས་༎
 gabhiru vipulu sūkṣma prāptu dharmo,	ཟབ་ཅིང་ཤིན་ཏུ་རྒྱས་པའི་ཆོས་བརྙེས་པ་༎
 acintatu buddhavaro yathā samudraḥ|	སངས་རྒྱས་མཆོག་གི་ཐུགས་ནི་རྒྱ་མཚོ་བཞིན་༎
 tenonnamanā na cāsti śāstuḥ,	དེས་ཀྱང་སྟོན་ལ་ཁེངས་པ་མི་མངའ་སྟེ་༎
 khiladoṣaṃ jahiyā atārṣi pāram| (3)	ཐ་བ་ཞེ་སྡང་སྤངས་ནས་ཕ་མཐར་སྒྲོལ་༎
 yatha buddhavaro anantatejā pratapati sarvadiśā narendrarājā,	ཇི་ལྟར་སངས་རྒྱས་མཆོག་གི་གཟི་མཐའ་ཡས་༎ མི་དབང་གཟི་བརྗིད་ཕྱོགས་ཀུན་ལྷམ་མེར་གདའ༎
 tatha ahu buddha bhavitva dharmasvāmī,	དེ་ལྟར་བདག་ཀྱང་སངས་རྒྱས་ཆོས་རྒྱལ་གྱུར་༎
 jaramaraṇān prajāṃ pramocayeyam| (4)	སྐྱེ་རྒུ་རྒ་དང་འཆི་ལས་རབ་ཐར་བགྱི་༎
 dānadamathaśīlakṣāntivīrya-	སྦྱིན་དང་དུལ་དང་ཚུལ་ཁྲིམས་བཟོད་བརྩོན་འགྲུས་༎
 dhyānasamādhi tathaiva agraśreṣṭhāṃ,	བསམ་གཏན་ཏིང་འཛིན་དེ་བཞིན་ཤེས་རབ་མཆོག་། བརྟུལ་ཞུགས་འདི་དག་བདག་གིས་ཡང་དག་བླང་༎
 ebhi ahu vratāṃ samādadāmi, buddha bhaviṣyāmi sarvasattvatrātā| (5)	སེམས་ཅན་ཀུན་སྐྱོབ་སངས་རྒྱས་འགྱུར་བར་བགྱི་༎ བྱང་ཆུབ་ཞི་མཆོག་མཚུངས་མེད་ཚོལ་བགྱིད་ཅིང་༎
 buddhaśatasahasrakoṭy anekā p8	སངས་རྒྱས་བྱེ་བ་བརྒྱ་སྟོང་དུ་མའི་ཕྲག་།
 yathariva vālika gaṅgayā anantā,	གངགའའི་བྱེ་མ་ལྟ་བུར་མཐའ་ཡས་པ་༎
 sarva ta ahu pūjayiṣya nāthān śivavarabodhigaveṣako atulyāṃ| (6)	མགོན་པོ་དེ་ཀུན་བདག་གིས་མཆོད་པར་བགྱི་༎
 gaṅgarajasamāna lokadhātūṃ	གང་གིས་རྡུལ་དང་མཉམ་པའི་འཇིག་རྟེན་ཁམས་༎
 tatra bhūyottari ye ananta kṣetrā,	དེ་བས་གོང་དུ་མཐའ་ཡས་ཞིང་གི་ཁམས་༎
 sarvata prabha muñcayiṣye tatrā	དེ་དག་ཀུན་དུ་འོད་ནི་རབ་འབྱིན་པ་༎
 iti etādṛśi vīryam ārabhiṣye| (7)	འདི་འདྲའི་བརྩོན་འགྲུས་སྟོབས་ནི་བརྩམ་པར་བགྱི་༎
 kṣetra mama udāru agraśreṣṭho,	བདག་གིས་ཞིང་ཡངས་གཙོ་བོ་དམ་པ་མཆོག་།
 varam iha maṇḍa pi saṃskṛtesmin|	འདུས་བྱས་འདིར་ནི་བརྒྱན་པར་བགྱིས་ནས་སུ་༎
 asadṛśa nirvāṇalokadhātusaukhyaṃ,	མཚུངས་པ་མ་མཆིས་མྱ་ངན་འདས་དབྱིངས་བདེ་༎
 tac ca asattvatayā viśodhayiṣye| (8)	དེ་ཡང་མ་མཆིས་པས་ནི་རྣམ་པར་སྦྱང་༎
 daśadiśata samāgatāni sattvā tatra gatāḥ sukham edhiṣyanti kṣipram|	ཕྱོགས་བཅུ་དག་ནས་ལྷགས་པའི་སེམས་ཅན་རྣམས་༎ དེར་ལྷགས་མྱུར་དུ་བདེ་ལ་དགའ་བར་གྱུར་༎
 buddha mama pramāṇa atra sākṣī,	༄༣༧༣བ་སངས་རྒྱས་ཚད་མ་འདི་ནི་བདག་གི་དབང་༎
 avitathavīryabalaṃ janemi cchandaṃ| (9)	མ་ལོག་བརྩོན་འགྲུས་སྟོབས་ནི་བསྐྱེད་པར་འཚལ་༎
 daśadiśe lokavidū asaṅgajñānī sada mama cittu prajānayantu te pi|	ཕྱོགས་བཅུའི་འཇིག་རྟེན་མི་ཆགས་མཁྱེན་པ་ཅན་༎ མཁས་པ་དེ་དག་རྟག་ཏུ་བདག་སེམས་མཁྱེན་༎
 avicigatu ahaṃ sadā vaseyaṃ, praṇidhibalaṃ na punar nivartayiṣye| (10)	བདག་ནི་མཚམས་མེད་མཆིས་ཏེ་རྟག་གནས་བགྱི་༎ སྨོན་ལམ་སྟོབས་ལས་ལོག་པར་ཡོང་མི་བགྱི་༎
 atha khalu ānanda sa dharmākaro bhikṣus taṃ bhagavantaṃ	ཀུན་དགའ་བོ་། དེ་ནས་དགེ་སློང་ཆོས་ཀྱི་འབྱུང་གནས་དེས་།
 lokeśvararājaṃ tathāgatam saṃmukham ābhir gātābhir abhiṣṭutyaitad avocat :	བཅོམ་ལྡན་འདས་དེ་བཞིན་གཤེགས་པ་འཇིག་རྟེན་དབང་ཕྱུག་རྒྱལ་པོ་ལ་ཚིགས་སུ་བཅད་པ་འདི་དག་གིས་མངོན་པར་བསྟོད་ནས་འདི་སྐད་ཅེས་གསོལ་ཏོ་༎ བཅོམ་ལྡན་འདས་།
 aham asmi bhagavann anuttarāṃ samyaksaṃbodhim abhisaṃbodhukāmaḥ, punaḥ punar	བདག་ནི་བླ་ན་མེད་པ་ཡང་དག་པར་རྫོགས་པའི་བྱང་ཆུབ་མངོན་པར་རྫོགས་པར་འཚང་རྒྱ་བར་འཚལ་ཏེ་། 
 anuttarāyāṃ samyaksaṃbodhau cittam utpādayāmi, pariṇāmayāmi| tasya me bhagavān sādhu tathā dharmaṃ deśayatu,	ཡང་དང་ཡང་བླ་ན་མེད་པ་ཡང་དག་པར་རྫོགས་པའི་བྱང་ཆུབ་ཏུ་སེམས་བསྐྱེད་ཅིང་ཡོངས་སུ་བསྔོ་བ་བགྱིད་ན་།
 yathāhaṃ kṣipram anuttarāṃ samyaksaṃbodhim abhisaṃbudheyaṃ ; p9 asamasamas tathāgato loke bhaveyaṃ ; tāṃś ca me bhagavān ākārān parikīrtayatu, yair ahaṃ buddhakṣetrasya	ཅི་ནས་ཀྱང་བདག་མྱུར་དུ་བླ་ན་མེད་པ་ཡང་དག་པར་རྫོགས་པའི་བྱང་ཆུབ་མངོན་པར་རྫོགས་པར་འཚང་རྒྱ་བ་དང་། འཇིག་རྟེན་དུ་དེ་བཞིན་གཤེགས་པ་མི་མཉམ་པ་དང་མཉམ་པར་འགྱུར་བ་དེ་ལྟ་བུའི་ཆོས་བཅོམ་ལྡན་འདས་ཀྱིས་བདག་ལ་ལེགས་པར་བསྟན་དུ་གསོལ་། རྣམ་པ་གང་དག་གིས་བདག་གི་སངས་རྒྱས་ཀྱི་ཞིང་གི་ཡོན་ཏན་གྱི་རྒྱན་བཀོད་པ་ཕུན་སུམ་ཚོགས་པ་ཡོངས་སུ་འཛིན་པར་འགྱུར་བའི་རྣམ་པ་དེ་ཡང་བཅོམ་ལྡན་འདས་ཀྱིས་བདག་ལ་ཡོངས་སུ་བརྗོད་དུ་གསོལ་། ཀུན་དགའ་བོ་།
 guṇavyūhasaṃpadaṃ parigṛhnīyām| evam uktaś cānanda sa	དེ་སྐད་ཅེས་གསོལ་པ་དང་། བཅོམ་ལྡན་འདས་དེ་བཞིན་གཤེགས་པ་༄༣༧༤ཨ་༌༎
 bhagavāṃl lokeṣvararājas tathāgatas taṃ bhikṣum etad avocat : tena hi tvaṃ bhikṣo svayam eva buddhakṣetra- guṇālaṃkāravyūhasaṃpadaṃ parigṛhṇīṣe| so 'vocat : nāhaṃ	འཇིག་རྟེན་དབང་ཕྱུག་རྒྱལ་པོས་དགེ་སློང་ཆོས་ཀྱི་འབྱུང་གནས་དེ་ལ་འདི་སྐད་ཅེས་བཀའ་སྩལ་ཏོ་༎ དེའི་ཕྱིར་དགེ་སློང་ཁྱོད་བདག་ཉིད་ཀྱི་སངས་རྒྱས་ཀྱི་ཞིང་གི་ཡོན་ཏན་གྱི་རྒྱན་བཀོད་པ་ཕུན་སུམ་ཚོགས་པ་ཡོངས་སུ་གཟུང་ཞིག་། དེས་གསོལ་པ་།
 bhagavann utsahe| api tu bhagavān eva bhāṣatv anyeṣāṃ	བཅོམ་ལྡན་འདས་། བདག་སྤྲོ་བ་མ་མཆིས་སོ་༎
 tathāgatānāṃ buddhakṣetraguṇavyūhālaṃkārasaṃpadaṃ, yāṃ śrutvā vayaṃ sarvākārāṃ paripūrayiṣyāma iti|	དེ་བཞིན་གཤེགས་པ་གཞན་དག་གིས་སངས་རྒྱས་ཀྱི་ཞིང་གི་ཡོན་ཏན་བཀོད་པའི་རྒྱན་ཕུན་སུམ་ཚོགས་པ་གང་ཐོས་ནས་བདག་གིས་རྒྱན་བཀོད་པ་ཐམས་ཅད་ཡོངས་སུ་རྫོགས་པར་འགྱུར་བ་བཅོམ་ལྡན་འདས་ཀྱིས་བཤད་དུ་གསོལ་། ཀུན་དགའ་བོ་།
 athānanda sa lokeśvararājas tathāgato 'rhan samyaksaṃbuddhas tasya bhikṣor āśayaṃ jñātvā,	དེ་ནས་དེ་བཞིན་གཤེགས་པ་དགྲ་བཅོམ་པ་ཡང་དག་པར་རྫོགས་པའི་སངས་རྒྱས་འཇིག་རྟེན་དབང་ཕྱུག་རྒྱལ་པོ་དེས་དགེ་སློང་དེའི་བསམ་པ་མཁྱེན་ནས་དོན་བཞེད་པ་ཕན་པ་བཞེད་པ་ཐུགས་བརྩེ་བ་ཅན་གྱི་ཐུགས་བརྩེ་བ་ཉེ་བར་གཟུང་སྟེ་།
 paripūrṇāṃ varṣakoṭīm ekāśītibuddhakoṭīnayutaśatasahasrāṇāṃ buddhakṣetraguṇālaṃkāra-	སངས་རྒྱས་ཀྱི་ཚུལ་མི་གཅད་པའི་ཕྱིར་སེམས་ཅན་རྣམས་ལ་ཐུགས་རྗེ་ཆེན་པོ་བསྐྱེད་ནས་ལོ་བྱེ་བ་ཐམ་པར་སངས་རྒྱས་བྱེ་བ་ཁྲག་ཁྲིག་བརྒྱ་སྟོང་ཕྲག་བརྒྱད་ཅུ་རྩ་གཅིག་གི་སངས་རྒྱས་ཀྱི་ཞིང་གི་ཡོན་ཏན་གྱི་རྒྱན་བཀོད་པ་ཕུན་སུམ་ཚོགས་པ་རྣམ་པ་དང་བཅས་། ཡུལ་ཕྱོགས་དང་བཅས་།
 vyūhasaṃpadaṃ sākārāṃ soddeśāṃ sanirdeśāṃ saṃprakāśitavān ; arthakāmo, hitaiṣy, anukampako, 'nukampām upādāya, buddhanetryānupacchedāya, sattveṣu mahākaruṇāṃ	གཞི་ཅི་ལས་གྱུར་པ་དང་བཅས་པར་ཡང་དག་པར་རབ་ཏུ་བཤད་དོ་༎ དེ་ནས་བཅོམ་ལྡན་འདས་ལ་ཚེ་དང་ལྡན་པ་ཀུན་དགའ་བོས་འདི་སྐད་ཅེས་གསོལ་ཏོ་༎ བཅོམ་ལྡན་འདས་། བཅོམ་ལྡན་འདས་འཇིག་རྟེན་༄༣༧༤བ་དབང་ཕྱུག་རྒྱལ་པོ་དེའི་སྐུ་ཚེའི་ཚད་ཇི་ཙམ་ཞིག་ཐུབ་པར་འགྱུར་། དེ་སྐད་ཅེས་གསོལ་པ་དང་། བཅོམ་ལྡན་འདས་ཀྱིས་ཚེ་དང་ལྡན་པ་ཀུན་དགའ་བོ་ལ་འདི་སྐད་ཅེས་བཀའ་སྩལ་ཏོ་༎
 saṃjanayitvā| paripūrṇāṃś ca dvācatvārimśatkalpāṃs tasya bhagavata āyuṣpramāṇam abhūt|	དེ་བཞིན་གཤེགས་པ་འཇིག་རྟེན་དབང་ཕྱུག་རྒྱལ་པོ་དེའི་ཚེའི་ཚད་ནི་བསྐལ་པ་བྱེ་བ་ཁྲག་ཁྲིག་བརྒྱ་སྟོང་ཕྲག་བཞི་བཅུ་ཐམ་པ་ཐུབ་པར་གྱུར་ཏོ་༎ ཀུན་དགའ་བོ་།
 atha khalv ānanda sa dharmākaro bhikṣur yās teṣām ekāśīti- buddhakoṭīnayutaśatasahasrāṇāṃ buddhakṣetraguṇālaṃkāra- vyūhasaṃpadas tāś ca sarvā ekabuddhakṣetre parigṛhya,	དེ་ནས་དགེ་སློང་ཆོས་ཀྱི་འབྱུང་གནས་དེས་སངས་རྒྱས་བྱེ་བ་ཁྲག་ཁྲིག་བརྒྱ་སྟོང་ཕྲག་བརྒྱད་ཅུ་རྩ་གཅིག་པོ་དེ་དག་གི་སངས་རྒྱས་ཀྱི་ཞིང་གི་ཡོན་ཏན་གྱི་རྒྱན་བཀོད་པ་ཕུན་སུམ་ཚོགས་པ་གང་ཡིན་པ་དེ་དག་ཐམས་ཅད་སངས་རྒྱས་ཀྱི་ཞིང་གཅིག་ཏུ་ཡོངས་སུ་བཟུང་ནས་།
 bhagavato lokeśvarasya tathāgatasya pādau śirasā vanditvā, pradakṣiṇīkṛtya,	བཅོམ་ལྡན་འདས་དེ་བཞིན་གཤེགས་པ་འཇིག་རྟེན་དབང་ཕྱུག་རྒྱལ་པོ་དེའི་ཞབས་ལ་མགོ་བོས་ཕྱག་འཚལ་ཏེ་། 
 tasya bhagavato 'ntikāt prākrāmat| uttari	བསྐོར་བ་བྱས་ནས་བཅོམ་ལྡན་འདས་དེའི་གན་ནས་སོང་ངོ་༎
 ca pañcakalpān buddhakṣetraguṇālaṃkāravyūhasaṃpadam, p10 udāratarāṃś ca praṇītatarāṃś ca,	གང་དུ་ཡང་བསྐལ་པ་ལྔར་སངས་རྒྱས་ཀྱི་ཞིང་གི་ཡོན་ཏན་གྱི་རྒྱན་བཀོད་པ་ཕུན་སུམ་ཚོགས་པ་ཤིན་ཏུ་ཐ་གྲུ་ཆེ་བ་། ཤིན་ཏུ་གྱ་ནོམ་པ་།
 sarvaloke daśasu dikṣv apracaritapūrvāṃ parigṛhītavān ;	སྔོན་ཕྱོགས་བཅུའི་འཇིག་རྟེན་གྱི་ཁམས་ཐམས་ཅད་དུ་མ་བྱུང་བ་དག་ཀྱང་ཡོངས་སུ་བཟུང་བར་གྱུར་ཏོ་༎ 
 udāraṃ ca praṇidhānam akārṣīt| iti hy ānanda yā tena bhagavatā lokeśvararājena	སྨོན་ལམ་ཤིན་ཏུ་རྒྱ་ཆེན་པོ་ཡང་བཏབ་བོ་༎ ཀུན་དགའ་བོ་།
 tathāgatena teṣām ekāśītibuddhakṣetrakoṭīnayutaśatasahasrāṇāṃ saṃpattiḥ kathitā, tato 'tirekāny udārapraṇītāprameyatarāṃ	དེ་ལྟར་དགེ་སློང་ཆོས་ཀྱི་འབྱུང་གནས་དེས་སངས་རྒྱས་བྱེ་བ་ཁྲག་ཁྲིག་བརྒྱ་སྟོང་ཕྲག་བརྒྱད་ཅུ་རྩ་གཅིག་པོ་དེ་དག་གི་ཞིང་ཕུན་སུམ་ཚོགས་པ་གང་བརྗོད་པ་དེ་བས་ཀྱང་སངས་རྒྱས་ཀྱི་ཞིང་ཕུན་སུམ་ཚོགས་པ་ཆེས་ལྷག་པར་ཐ་གྲུ་ཆེ་བ་། ཆེས་གྱ་༄༣༧༥ཨ་༌༎ ནོམ་པ་།
 buddhakṣetrasaṃpattiṃ parigṛhya,	ཆེས་དཔག་ཏུ་མེད་པ་ཡོངས་སུ་བཟུང་སྟེ་།
 yena sa tathāgatas tenopasaṃkramya,	བཅོམ་ལྡན་འདས་འཇིག་རྟེན་དབང་ཕྱུག་རྒྱལ་པོ་ག་ལ་བ་དེར་སོང་སྟེ་།
 tasya bhagavataḥ pādau śirasā vanditvaitad	ཕྱིན་ནས་བཅོམ་ལྡན་འདས་དེའི་ཞབས་ལ་མགོ་བོས་ཕྱག་འཚལ་ཏེ་། འདི་སྐད་ཅེས་གསོལ་ཏོ་༎ བཅོམ་ལྡན་འདས་།
 avocat : parigṛhītā me bhagavan buddhakṣetraguṇālaṃkāra-	བདག་གིས་སངས་རྒྱས་ཀྱི་ཞིང་གི་ཡོན་ཏན་གྱི་རྒྱན་བཀོད་པ་ཕུན་སུམ་ཚོགས་པ་ཡོངས་སུ་བཟུང་ལགས་སོ་༎ 
 vyūhasaṃpad iti| evam ukte, ānanda,	ཀུན་དགའ་བོ་།
 sa lokeśvararājas tathāgatas taṃ bhikṣum etad avocat : tena hi bhikṣo bhāṣasva|	དེ་སྐད་ཅེས་གསོལ་པ་དང་། དེ་བཞིན་གཤེགས་པ་འཇིག་རྟེན་དབང་ཕྱུག་རྒྱལ་པོ་དེས་དགེ་སློང་ཆོས་ཀྱི་འབྱུང་གནས་དེ་ལ་འདི་སྐད་ཅེས་བཀའ་སྩལ་ཏོ་༎
 anumodate tathāgataḥ| ayaṃ kālo bhikṣo, pramodaya	དེའི་ཕྱིར་དེ་བཞིན་གཤེགས་པ་ཡང་རྗེས་སུ་ཡི་རང་བ་མཛད་ཀྱི་དགེ་སློང་གིས་སྨྲོས་ཤིག་། འདི་ནི་དེའི་དུས་ཡིན་གྱི་། འཁོར་དགའ་བར་གྱིས་ཤིག་།
 parṣadaṃ, harṣaṃ janaya,	མགུ་བ་སྐྱེད་ཅིག་།
 siṃhanādaṃ nada, yaṃ śrutvā	སེང་གེའི་སྒྲ་སྒྲོགས་ཤིག་།
 bodhisattvā mahāsattvā etarhy anāgate cādhvany evaṃrūpāṇi buddhakṣetrasaṃpattipraṇidhānāni parigṛhīṣyanti|	དེ་ཐོས་ནས་བྱང་ཆུབ་སེམས་དཔའ་སེམས་དཔའ་ཆེན་པོ་དག་ད་ལྟར་དང་། མ་འོངས་པའི་དུས་ན་སངས་རྒྱས་ཀྱི་ཞིང་ཕུན་སུམ་ཚོགས་པ་སྨོན་ལམ་གྱི་གནས་འདི་ལྟ་བུ་ཡོངས་སུ་འཛིན་པར་འགྱུར་། ཡོངས་སུ་རྫོགས་པར་བྱེད་པར་འགྱུར་རོ་༎
 athānanda sa dharmākaro bhikṣus tasyāṃ velāyāṃ taṃ bhagavantam etad avocat : tena hi śṛṇotu me bhagavān, ye	ཀུན་དགའ་བོ་། དེ་ནས་དགེ་སློང་ཆོས་ཀྱི་འབྱུང་གནས་དེས་དེའི་ཚེ་བཅོམ་ལྡན་འདས་དེ་ལ་འདི་སྐད་ཅེས་གསོལ་ཏོ་༎ 
 mama praṇidhānaviśeṣāḥ, yathā me 'nuttarāṃ samyaksaṃbodhim abhisaṃbuddhasye| acintyaguṇālaṃkāravyūhasamanvāgataṃ	དེའི་སླད་དུ་ཇི་ལྟར་བདག་བླ་ན་མེད་པ་ཡང་དག་པར་རྫོགས་པའི་བྱང་ཆུབ་ཏུ་མངོན་པར་རྫོགས་པར་སངས་རྒྱས་པའི་ཚེ་སངས་རྒྱས་ཀྱི་ཞིང་དེའི་ཡོན་ཏན་གྱི་རྒྱན་བཀོད་པ་བསམ་གྱིས་མི་ཁྱབ་པ་༄༣༧༥བ་དང་ལྡན་པར་འགྱུར་བའི་བདག་གི་སྨོན་ལམ་གྱི་ཁྱད་པར་བཅོམ་ལྡན་འདས་ཀྱིས་བདག་ལ་གསན་དུ་གསོལ་། བཅོམ་ལྡན་འདས་།
 tad buddhakṣetraṃ bhaviṣyati : 1| sacen me bhagavaṃs tasmin buddhakṣetre nirayo vā, tiryagyonir vā, pretaviṣayo vāsuro vā kāyo bhavet, mā tāvad aham anuttarāṃ samyaksaṃbodhim abhisaṃbudhyeyam|	གལ་ཏེ་བདག་གི་སངས་རྒྱས་ཀྱི་ཞིང་དེ་ན་སེམས་ཅན་དམྱལ་བ་དང་། དུད་འགྲོའི་སྐྱེ་གནས་དང་། ཡི་དབ༹གས་ཀྱི་ཡུལ་དང་། ལྷ་མ་ཡིན་གྱི་རིས་མཆིས་པར་གྱུར་པ་དེ་སྲིད་དུ་བདག་བླ་ན་མེད་པ་ཡང་དག་པར་རྫོགས་པའི་བྱང་ཆུབ་ཏུ་མངོན་པར་རྫོགས་པར་འཚང་རྒྱ་བར་མི་བགྱིའོ་༎ བཅོམ་ལྡན་འདས་།
 2| sacen me bhagavaṃs tatra buddhakṣetre ye sattvāḥ p11 pratyājātā bhaveyus, te punas tataś cyutvā, nirayaṃ vā,	གལ་ཏེ་བདག་གིས་སངས་རྒྱས་ཀྱི་ཞིང་དེར་སེམས་ཅན་གང་དག་སྐྱེས་པར་གྱུར་པ་དེ་དག་དེ་ནས་ཤི་འཕོས་ནས་སེམས་ཅན་དམྱལ་བའམ་།
 tiryagyoniṃ vā,	དུད་འགྲོའི་སྐྱེ་གནས་སམ་།
 pretaviṣayaṃ vāsuraṃ vā kāyaṃ prapateyur,	ཡི་དབ༹གས་ཀྱི་ཡུལ་ལམ་།
 mā tāvad aham anuttarāṃ samyaksaṃbodhim abhisaṃbudhye- yam|	ལྷ་མ་ཡིན་གྱི་རིས་སུ་མི་ལྟུང་བར་གྱུར་པ་དེ་སྲིད་དུ་བདག་བླ་ན་མེད་པ་ཡང་དག་པར་རྫོགས་པའི་བྱང་ཆུབ་མངོན་པར་རྫོགས་པར་འཚང་རྒྱ་བར་མི་བགྱིའོ་༎ བཅོམ་ལྡན་འདས་།
 3| sacen me bhagavaṃs tatra buddhakṣetre ye sattvāḥ pratyājātās, te ca sarve naikavarṇāḥ syur,	གལ་ཏེ་བདག་གི་སངས་རྒྱས་ཀྱི་ཞིང་དེར་སེམས་ཅན་གང་དག་སྐྱེས་པ་དེ་དག་ཐམས་ཅད་འདི་ལྟ་སྟེ་། 
 yad idaṃ : suvarṇavarṇāḥ, mā tāvad aham anuttarāṃ samyaksaṃbodhim abhisambudhyeyam|	གསེར་གྱི་ཁ་དོག་ཏུ་ཁ་དོག་གཅིག་པར་མ་གྱུར་པ་དེ་སྲིད་དུ་བདག་བླ་ན་མེད་པ་ཡང་དག་པར་རྫོགས་པའི་བྱང་ཆུབ་མངོན་པར་རྫོགས་པར་འཚང་རྒྱ་བར་མི་བགྱིའོ་༎ བཅོམ་ལྡན་འདས་།
 4| sacen me bhagavaṃs tasmin buddhakṣetre devānāṃ ca manuṣyānāṃ ca nānātvaṃ prajñayetānyatra nāmasaṃketa- saṃvṛtivyavahāramātrā devā manuṣyā iti saṃkhyāgaṇanāto,	གལ་ཏེ་བདག་གི་སངས་རྒྱས་ཀྱི་ཞིང་དེ་ན་ལྷ་དང་། མི་ཐ་དད་པ་དག་གདའ་བར་གྱུར་པར་གཞན་དུ་ན་ཀུན་རྫོབ་ཀྱི་ཐ་སྙད་ཙམ་དུ་མིང་དང་བརྡས་ལྷ་དང་མི་ཞེས་བགྱི་བའི་གྲངས་སུ་མཆི་བར་མ་གྱུར་པ་དེ་སྲིད་དུ་བདག་བླ་ན་མེད་པ་ཡང་དག་པར་རྫོགས་༄༣༧༦ཨ་༌༎
 mā tāvad aham anuttarāṃ samyaksaṃbodhim abhisaṃbudhye- yam|	པའི་བྱང་ཆུབ་མངོན་པར་རྫོགས་པར་འཚང་རྒྱ་བར་མི་བགྱིའོ་༎ བཅོམ་ལྡན་འདས་།
 5| sacen me bhagavaṃs tasmin buddhakṣetre ye sattvāḥ pratyājātās te cet sarve na rddhivaśitā paramapāramitāprāptā bhaveyur, antaśa ekacittakṣaṇalavena buddhakṣetrakoṭīniyuta- śatasahasrātikramaṇatayāpi,	གལ་ཏེ་བདག་གི་སངས་རྒྱས་ཀྱི་ཞིང་དེར་སེམས་ཅན་གང་དག་སྐྱེས་པར་གྱུར་པ་དེ་དག་ཐམས་ཅད་གལ་ཏེ་ཐ་ན་སེམས་ཀྱི་སྐད་ཅིག་ཐང་ཅིག་ལ་སངས་རྒྱས་ཀྱི་ཞིང་བྱེ་བ་ཁྲག་ཁྲིག་བརྒྱ་སྟོང་འདའ་བའི་རྫུ་འཕྲུལ་ལ་དབང་དམ་པའི་ཕ་རོལ་དུ་སོན་པར་མ་གྱུར་པ་དེ་སྲིད་དུ་བདག་བླ་ན་མེད་པ་ཡང་དག་པར་རྫོགས་པའི་བྱང་ཆུབ་ཏུ་མངོན་པར་རྫོགས་པར་འཚང་རྒྱ་བར་མི་བགྱིའོ་༎ 
 mā tāvad aham anuttarāṃ samyaksaṃbodhim abhisaṃbudhyeyam| 6| sacen me bhagavaṃs tasmin buddhakṣetre ye sattvāḥ pratyājātā bhaveyus, te cet sarve na jātismarā syur, antaśaḥ kalpakoṭīniyutaśatasahasrānusmaraṇatayāpi,	བཅོམ་ལྡན་འདས་།
 mā tāvad aham anuttarāṃ samyaksaṃbodhim abhisaṃbudhyeyam| 7| sacen me bhagavaṃs tasmin buddhakṣetre ye sattvāḥ pratyājāyeraṃs,	གལ་ཏེ་བདག་གི་སངས་རྒྱས་ཀྱི་ཞིང་དེར་སེམས་ཅན་གང་དག་སྐྱེས་པར་གྱུར་པ་དེ་དག་ཐམས་ཅད་ཐ་ན་བསྐལ་པ་བྱེ་བ་ཁྲག་ཁྲིག་བརྒྱ་སྟོང་རྗེས་སུ་དྲན་པའི་ཚེ་རབས་དྲན་པར་མ་གྱུར་པ་དེ་སྲིད་དུ་བདག་བླ་ན་མེད་པ་ཡང་དག་པར་རྫོགས་པའི་བྱང་ཆུབ་མངོན་པར་རྫོགས་པར་འཚང་རྒྱ་བར་མི་བགྱིའོ་༎ བཅོམ་ལྡན་འདས་།
 te sarve na divyasya cakṣuṣo lābhino bhaveyur, antaśo lokadhātukoṭīnayutaśatasahasrādarśanatayāpi, mā p12 tāvad aham anuttarāṃ samyaksaṃbodhim abhisaṃbudhyeyam| 8| sacen me bhagavaṃs tasmin buddhakṣetre ye	གལ་ཏེ་བདག་གི་སངས་རྒྱས་ཀྱི་ཞིང་དེར་སེམས་ཅན་གང་དག་སྐྱེས་པར་གྱུར་པ་དེ་དག་ཐམས་ཅད་ཐ་ན་འཇིག་རྟེན་གྱི་ཁམས་བྱེ་བ་ཁྲག་ཁྲིག་བརྒྱ་སྟོང་མཐོང་བའི་ལྷའི་མིག་ཐོབ་པར་མ་གྱུར་པ་དེ་སྲིད་དུ་བདག་བླ་ན་མེད་པ་ཡང་དག་པར་རྫོགས་པའི་བྱང་ཆུབ་མངོན་པར་རྫོགས་པར་འཚང་རྒྱ་བར་མི་བགྱིའོ་༎ བཅོམ་ལྡན་འདས་།
 sattvāḥ pratyājāyeraṃs, te sarve na divyasya śrotrasya lābhino bhaveyur, antaśo buddhakṣetrakoṭīnayutaśatasahasrād api yugapat saddharmaśravaṇatayā,	གལ་ཏེ་བདག་གི་སངས་རྒྱས་ཀྱི་ཞིང་དེར་སེམས་ཅན་གང་དག་སྐྱེས་པར་གྱུར་པ་དེ་དག་ཐམས་ཅད་ཐ་ན་སངས་རྒྱས་ཀྱི་ཞིང་བྱེ་བ་ཁྲག་ཁྲིག་བརྒྱ་༄༣༧༦བ་སྟོང་དུ་ཅིག་ཅར་ཆོས་ཉན་པའི་ལྷའི་རྣ་བ་ཐོབ་པར་མ་གྱུར་པ་དེ་སྲིད་དུ་བདག་བླ་ན་མེད་པར་ཡང་དག་པར་རྫོགས་པའི་བྱང་ཆུབ་མངོན་པར་རྫོགས་པར་འཚང་རྒྱ་བར་མི་བགྱིའོ་༎ 
 mā tāvad aham anuttarāṃ samyaksaṃbodhim abhisaṃbudhyeyam| 9| sacen me bhagavaṃs tasmin buddhakṣetre ye sattvāḥ	བཅོམ་ལྡན་འདས་།
 pratyājāyeraṃs, te sarve na paracittajñānakovidā bhaveyur, antaśo buddhakṣetrakoṭīnayutaśatasahasraparyāpannānāṃ sattvānāṃ cittacaritraparijñānatayā,	གལ་ཏེ་བདག་གི་སངས་རྒྱས་ཀྱི་ཞིང་དེར་སེམས་ཅན་གང་དག་སྐྱེས་པར་གྱུར་པ་དེ་དག་ཐམས་ཅད་ཐ་ན་སངས་རྒྱས་ཀྱི་ཞིང་བྱེ་བ་ཁྲག་ཁྲིག་བརྒྱ་སྟོང་དུ་གཏོགས་པའི་སེམས་ཅན་རྣམས་ཀྱི་སེམས་ཀྱི་སྤྱོད་པ་ཡོངས་སུ་འཚལ་བར་ཕ་རོལ་གྱི་སེམས་འཚལ་བ་ལ་མཁས་པར་མ་གྱུར་པ་དེ་སྲིད་དུ་བདག་བླ་ན་མེད་པ་ཡང་དག་པར་རྫོགས་པའི་བྱང་ཆུབ་མངོན་པར་རྫོགས་པར་འཚང་རྒྱ་བར་མི་བགྱིའོ་༎
 mā tāvad aham anuttarāṃ samyaksaṃbodhim abhisaṃbudhyeyam|	བཅོམ་ལྡན་འདས་།
 10| sacen me bhagavaṃs tasmin buddhakṣetre ye sattvāḥ pratyājāyeraṃs, teṣāṃ kācit parigrahasaṃjñotpadyetāntaśaḥ svaśarīre 'pi, mā tāvad aham anuttarāṃ samyaksaṃbodhim abhisaṃbudhyeyam|	གལ་ཏེ་བདག་གི་སངས་རྒྱས་ཀྱི་ཞིང་དེར་སེམས་ཅན་གང་དག་སྐྱེས་པར་གྱུར་པ་དེ་དག་ཐ་ན་རང་གི་ལུས་ལ་ཡོངས་སུ་འཛིན་པའི་འདུ་ཤེས་འགའ་ཞིག་བསྐྱེད་ན་ཡང་དེ་སྲིད་དུ་བདག་བླ་ན་མེད་པ་ཡང་དག་པར་རྫོགས་པའི་བྱང་ཆུབ་མངོན་པར་རྫོགས་པར་འཚང་རྒྱ་བར་མི་བགྱིའོ་༎ བཅོམ་ལྡན་འདས་།
 11| sacen me bhagavaṃs tasmin buddhakṣetre ye sattvāḥ pratyājāyeraṃs, te sarve na niyatāḥ syur, yad idaṃ : samyaktve	གལ་ཏེ་བདག་གི་སངས་རྒྱས་ཀྱི་ཞིང་དེར་སེམས་ཅན་གང་དག་སྐྱེས་པར་གྱུར་པ་དེ་དག་ཐམས་ཅད་ཡོངས་སུ་མྱ་ངན་ལས་འདས་པ་ཆེན་པོའི་བར་དུ་འདི་ལྟ་སྟེ་།
 yāvan mahāparinirvāṇād, mā tāvad anuttarāṃ samyaksaṃbodhim abhisaṃbudhyeyam|	ཡང་དག་པ་ཉིད་ལ་ངེས་པར་མ་གྱུར་པ་དེ་སྲིད་དུ་བདག་བླ་ན་མེད་པ་ཡང་དག་པར་རྫོགས་པའི་བྱང་ཆུབ་ཏུ་མངོན་པར་རྫོགས་པར་འཚང་རྒྱ་བར་མི་བགྱིའོ་༎ བཅོམ་ལྡན་འདས་།
 12| sacen me bhagavaṃs tasmin buddhakṣetre 'nuttarāṃ	གལ་ཏེ་བདག་བླ་ན་མེད་པ་ཡང་དག་པར་རྫོགས་པའི་བྱང་༄༣༧༧ཨ་༌༎
 samyaksaṃbodhim abhisaṃbuddhasya,	ཆུབ་ཏུ་མངོན་པར་རྫོགས་པར་སངས་རྒྱས་པའི་ཚེ་།
 kaścid eva sattvaḥ śrāvakānāṃ gaṇānām adhigacched,	སངས་རྒྱས་ཀྱི་ཞིང་དེ་ན་སེམས་ཅན་འགའ་ཞིག་གིས་ཉན་ཐོས་རྣམས་ཀྱི་ཚད་ཀྱི་གྲངས་རྙེད་པར་འགྱུར་པ་ལྟ་ན་།
 antaśas trisāhasra- mahāsāhasraparyāpannā api sarvasattvāḥ pratyekabuddhabhūtāḥ	ཐ་ན་སྟོང་གསུམ་གྱི་སྟོང་ཆེན་པོའི་འཇིག་རྟེན་གྱི་ཁམས་སུ་གཏོགས་པའི་སེམས་ཅན་ཐམས་ཅད་རང་སངས་རྒྱས་སུ་གྱུར་པ་ལ་།
 kalpakoṭīniyutaśatasahasram api gaṇayanto, mā tāvad aham anuttarāṃ samyaksaṃbodhim abhisaṃbudhyeyam|	བསྐལ་པ་བྱེ་བ་ཁྲག་ཁྲིག་བརྒྱ་སྟོང་དུ་བགྲངས་ཏེ་གྲངས་རྙེད་པར་གྱུར་ན་ཡང་དེ་སྲིད་དུ་བདག་བླ་ན་མེད་པ་ཡང་དག་པར་རྫོགས་པའི་བྱང་ཆུབ་མངོན་པར་རྫོགས་པར་འཚང་རྒྱ་བར་མི་བགྱིའོ་༎ བཅོམ་ལྡན་འདས་།
 13| sacen me bhagavann anuttarāṃ samyaksaṃbodhim p13 abhisaṃbuddhasya,	གལ་ཏེ་བདག་བླ་ན་མེད་པ་ཡང་དག་པར་རྫོགས་པའི་བྱང་ཆུབ་མངོན་པར་རྫོགས་པར་སངས་རྒྱས་པའི་ཚེ་། 
 tasmin buddhakṣetre prāmāṇikī me prabhā bhaved, antaśo buddhakṣetrakoṭīnayutaśatasahasrapramāṇenāpi, mā tāvad aham anuttarāṃ samyaksaṃbodhim abhi-	སངས་རྒྱས་ཀྱི་ཞིང་དེར་བདག་གི་འོད་ཐ་ན་སངས་རྒྱས་ཀྱི་ཞིང་བྱེ་བ་ཁྲག་ཁྲིག་བརྒྱ་སྟོང་གི་ཚད་ཀྱི་ཚད་དང་ལྡན་པར་གྱུར་ན་ཡང་དེ་སྲིད་དུ་བདག་བླ་ན་མེད་པ་ཡང་དག་པར་རྫོགས་པའི་བྱང་ཆུབ་མངོན་པར་རྫོགས་པར་འཚང་རྒྱ་བར་མི་བགྱིའོ་༎ བཅོམ་ལྡན་འདས་།
 saṃbudhyeyam| 14| sacen me bhagavaṃs tasmin buddhakṣetre 'nuttarāṃ samyaksambodhim abhisaṃbuddhasya bodhiprāptasya,	གལ་ཏེ་བདག་བླ་ན་མེད་པ་ཡང་དག་པར་རྫོགས་པའི་བྱང་ཆུབ་མངོན་པར་རྫོགས་པར་སངས་རྒྱས་པའི་ཚེ་། 
 sattvānāṃ pramāṇīkṛtyam āyuṣpramānaṃ bhaved, anyatra praṇidhānavaśena, mā tāvad aham anuttarāṃ samyaksaṃbodhim abhisaṃbudhyeyam|	སངས་རྒྱས་ཀྱི་ཞིང་དེ་ན་སྨོན་ལམ་གྱི་དབང་མ་གཏོགས་པར་སེམས་ཅན་རྣམས་ཀྱི་ཚེའི་ཆེད་ལ་ཆད་མཆིས་པར་གྱུར་པ་དེ་སྲིད་དུ་བདག་བླ་ན་མེད་པ་ཡང་དག་པར་རྫོགས་པའི་བྱང་ཆུབ་ཏུ་མངོན་པར་རྫོགས་པར་འཚང་རྒྱ་པའི་ཚེ་། བར་མི་བགྱིའོ་༎ 
 15| sacen me bhagavan bodhiprāptasyāyuṣpramāṇaṃ paryantīkṛtyaṃ	བཅོམ་ལྡན་འདས་།
 bhaved, antaśaḥ kalpakoṭīnayutaśatasahasragaṇanayāpi, mā tāvad aham anuttarāṃ samyaksaṃbodhim abhi- saṃbudhyeyam|	གལ་ཏེ་༄༣༧༧བ་བདག་བྱང་ཆུབ་ཐོབ་པའི་ཚེ་ཚེའི་ཚད་ཐ་ན་བསྐལ་པ་བྱེ་བ་ཁྲག་ཁྲིག་བརྒྱ་སྟོང་དུ་བགྲངས་བས་མཐར་ཕྱིན་པར་གྱུར་ན་ཡང་དེ་སྲིད་དུ་བདག་བླ་ན་མེད་པ་ཡང་དག་པར་རྫོགས་པའི་བྱང་ཆུབ་མངོན་པར་རྫོགས་པར་འཚང་རྒྱ་བར་མི་བགྱིའོ་༎ བཅོམ་ལྡན་འདས་།
 16| sacen me bhagavan bodhiprāptasya tasmin buddhakṣetre sattvānām akuśalasya nāmadheyam api bhaven, mā tāvad aham anuttarāṃ samyaksaṃbodhim abhisaṃbudhyeyam|	གལ་ཏེ་བདག་བྱང་ཆུབ་ཐོབ་པའི་ཚེ་སངས་རྒྱས་ཀྱི་ཞིང་དེ་ན་སེམས་ཅན་རྣམས་ལ་མི་དགེ་བའི་མིང་མཆིས་པར་གྱུར་ན་ཡང་དེ་སྲིད་དུ་བདག་བླ་ན་མེད་པ་ཡང་དག་པར་རྫོགས་པའི་བྱང་ཆུབ་མངོན་པར་རྫོགས་པར་འཚང་རྒྱ་བར་མི་བགྱིའོ་༎ བཅོམ་ལྡན་འདས་།
 17| sacen me bhagavan bodhiprāptasya, nāprameyeṣu buddhakṣetreṣv aprameyāsaṃkhyeyā buddhā bhagavato nāmadheyaṃ parikīrtayeyur,	གལ་ཏེ་བདག་བྱང་ཆུབ་ཐོབ་པའི་ཚེ་སངས་རྒྱས་ཀྱི་ཞིང་དཔག་ཏུ་མ་མཆིས་པ་དག་ན་སངས་རྒྱས་བཅོམ་ལྡན་འདས་གྲངས་མ་མཆིས་པ་དཔག་ཏུ་མ་མཆིས་པ་དག་མིང་ཡོངས་སུ་བརྗོད་པར་མ་གྱུར་ཏམ་། 
 na varṇaṃ bhāṣeran,	བསྔགས་པ་མི་བརྗོད་དམ་།
 na praśaṃsām abhyudīrayeyur,	བསྟོད་པ་མི་བརྗོད་དམ་།
 na samudīrayeyur, mā tāvad aham anuttarāṃ samyaksaṃbodhim abhisaṃbudhyeyam|	གྲགས་པ་མི་བརྗོད་པ་དེ་སྲིད་དུ་བདག་བླ་ན་མེད་པ་ཡང་དག་པར་རྫོགས་པའི་བྱང་ཆུབ་མངོན་པར་རྫོགས་པར་འཚང་རྒྱ་བར་མི་བགྱིའོ་༎ བཅོམ་ལྡན་འདས་།
 18| sacen me bhagavan bodhiprāptasya, ye sattvā anyeṣu lokadhātuṣv anuttarāyāḥ samyaksaṃbodheś cittam utpādya, mama nāmadheyaṃ śrutvā,	གལ་ཏེ་བདག་བྱང་ཆུབ་ཐོབ་པའི་ཚེ་སེམས་ཅན་གང་དག་འཇིག་རྟེན་གྱི་ཁམས་གཞན་དག་ཏུ་བླ་ན་མེད་པ་ཡང་དག་པར་རྫོགས་པའི་བྱང་ཆུབ་ཏུ་སེམས་བསྐྱེད་ནས་བདག་གི་མིང་ཐོས་ཏེ༏་སེམས་རབ་ཏུ་དང་བར་གྱུར་ལ་།
 prasannacittā mām anusmareyus, teṣāṃ ced ahaṃ maraṇakālasamaye pratyupasthite bhikṣusaṃgha- parivṛtaḥ puraskṛto na puratas tiṣṭheyam, yad	བདག་རྗེས་སུ་དྲན་པ་དེ་དག་ལ་གལ་ཏེ་འགུམ་པའི་དུས་ཉེ་བར་གནས་པའི་ཚེ་བདག་དགེ་སློང་གི་དགེ་འདུན་གྱིས་ཡོངས་སུ་བསྐོར་ཅིང་མདུན་དུ་བདར་༄༣༧༨ཨ་༌༎ བའི་མདུན་དུ་འདི་ལྟ་སྟེ་།
 idaṃ : cittāvikṣepatāyai, mā tāvad aham anuttarāṃ samyaksaṃbodhim p14 abhisaṃbudhyeyam|	ག-ཡེང་བ་མ་མཆིས་པའི་སེམས་ཀྱིས་གནས་པར་མ་གྱུར་པ་དེ་སྲིད་དུ་བདག་བླ་ན་མེད་པ་ཡང་དག་པར་རྫོགས་པའི་བྱང་ཆུབ་མངོན་པར་རྫོགས་པར་འཚང་རྒྱ་བར་མི་བགྱིའོ་༎ བཅོམ་ལྡན་འདས་།
 19| sacen me bhagavan bodhiprāptasyāprameyāsaṃkhyeyeṣu buddhakṣetreṣu ye sattvāḥ mama nāmadheyaṃ śrutvā, tatra buddhakṣetre cittaṃ preṣayeyur, upapattaye kuśalamūlāni	གལ་ཏེ་བདག་བྱང་ཆུབ་ཐོབ་པའི་ཚེ་སངས་རྒྱས་ཀྱི་ཞིང་གྲངས་མ་མཆིས་པ་།
 ca pariṇāmayeyus, te ca tatra buddhakṣetre nopapadyeran, antaśo daśabhiś cittotpādaparivartaiḥ, sthāpayitvānantaryakāriṇaḥ saddharmapratikṣepāvaraṇāvṛtāṃś ca sattvān, mā tāvad aham anuttarāṃ samyaksaṃbodhim abhisaṃbudhyeyam| 20| sacen me bhagavan bodhiprāptasya, tatra buddhakṣetre bodhisattvāḥ pratyājāyeran,	དཔག་ཏུ་མ་མཆིས་པ་དག་ན་སེམས་ཅན་གང་དག་གིས་བདག་གི་མིང་ཐོས་ནས་སངས་རྒྱས་ཀྱི་ཞིང་དེར་སྐྱེ་བར་བགྱི་བའི་སླད་དུ་སེམས་གཏོང་ཞིང་དགེ་བའི་རྩ་བ་རྣམས་ཀྱང་ཡོངས་སུ་བསྔོ་བར་བགྱིད་ན་མཚམས་མ་མཆིས་པ་བགྱིད་པ་དང་། དམ་པའི་ཆོས་སྤོང་བའི་སྒྲིབ་པས་བསྒྲིབས་པའི་སེམས་ཅན་རྣམས་མ་གཏོགས་པར་དེ་དག་ཐ་ན་སེམས་བསྐྱེད་པའི་འགྱུར་བ་བཅུས་སངས་རྒྱས་ཀྱི་ཞིང་དེར་སྐྱེ་བར་མ་གྱུར་པ་དེ་སྲིད་དུ་བདག་བླ་ན་མེད་པ་ཡང་དག་པར་རྫོགས་པའི་བྱང་ཆུབ་མངོན་པར་རྫོགས་པར་འཚང་རྒྱ་བར་མི་བགྱིའོ་། ༎ བཅོམ་ལྡན་འདས་།
 te sarve na dvātriṃśatā mahāpuruṣalakṣaṇaiḥ samanvāgatā bhaveyur, mā tāvad aham anuttarāṃ samyaksaṃbodhim abhisaṃbudhyeyam|	གལ་ཏེ་བདག་བྱང་ཆུབ་ཐོབ་པའི་ཚེ་སངས་རྒྱས་ཀྱི་ཞིང་དེར་སེམས་ཅན་གང་དག་སྐྱེས་པར་གྱུར་པ་དེ་དག་ཐམས་ཅད་སྐྱེས་བུ་ཆེན་པོའི་མཚན་སུམ་ཅུ་རྩ་གཉིས་དང་ལྡན་པར་མ་གྱུར་པ་དེ་སྲིད་དུ་བདག་བླ་ན་མེད་པ་ཡང་དག་པར་རྫོགས་པའི་བྱང་ཆུབ་མངོན་པར་རྫོགས་པར་འཚང་རྒྱ་བར་མི་བགྱིའོ་༎ བཅོམ་ལྡན་འདས་།
 21| sacen me bhagavan bodhiprāptasya, tatra buddhakṣetre ye sattvāḥ pratyājātā bhaveyus, te sarve naikajātibaddhāḥ syur anuttarāyāṃ samyaksaṃbodhau, sthāpayitvā praṇidhānaviśeṣāṃs	གལ་ཏེ་བདག་བྱང་ཆུབ་ཐོབ་པའི་ཚེ་སངས་རྒྱས་ཀྱི་ཞིང་དེར་༄༣༧༨བ་སེམས་ཅན་གང་དག་སྐྱེས་པར་གྱུར་པ་། 
 teṣām eva bodhisattvānāṃ mahāsattvānāṃ, mahā- saṃnāhasaṃnaddhānāṃ,	བྱང་ཆུབ་སེམས་དཔའ་སེམས་དཔའ་ཆེན་པོ་གོ་ཆ་ཆེན་པོ་བགོས་པ་།
 sarvalokārthasaṃnaddhānāṃ, sarva- lokārthābhiyuktānāṃ,	འཇིག་རྟེན་ཐམས་ཅད་ཀྱི་དོན་དུ་གོ་ཆ་བགོས་པ་། འཇིག་རྟེན་ཐམས་ཅད་ཀྱི་དོན་ལ་བརྩོན་པ་།
 sarvalokaparinirvāpitābhiyuktānāṃ,	འཇིག་རྟེན་ཐམས་ཅད་ཡོངས་སུ་མྱ་ངན་ལས་བཟླ་བ་ལ་མངོན་པར་བརྩོན་པ་།
 sarvalokadhātuṣu bodhisattvacaryāṃ caritukāmānāṃ, sarva-	འཇིག་རྟེན་གྱི་ཁམས་ཐམས་ཅད་དུ་བྱང་ཆུབ་སེམས་དཔའི་སྤྱད་པ་སྤྱོད་པར་འཚལ་བ་།
 buddhān satkartukāmānāṃ,	སངས་རྒྱས་ཐམས་ཅད་ལ་ཕུ་དུད་བགྱི་བར་འཚལ་བ་།
 gaṅgānadīvālukasamān sattvān anuttarāyāṃ samyaksaṃbodhau pratiṣṭhāpakānāṃ, bhūyaś cottari-	སེམས་ཅན་གངགའའི་ཀླུང་གི་བྱེ་མ་སྙེད་བླ་ན་མེད་པ་ཡང་དག་པར་རྫོགས་པའི་བྱང་ཆུབ་ལ་དགོད་པར་འཚལ་བ་ཡང་གོང་མའི་སྤྱོད་པ་ལ་མངོན་དུ་ཕྱོགས་པ་།
 caryābhimukhānāṃ samantabhadracaryāniyatānāṃ, mā tāvad aham anuttarāṃ samyaksaṃbodhim abhisaṃbudhyeyam|	ཀུན་ཏུ་བཟང་པོའི་སྤྱོད་པས་ངེས་པར་བྱུང་བ་རྣམས་ཀྱི་སྨོན་ལམ་གྱི་ཁྱད་པར་མ་གཏོགས་པར་དེ་དག་ཐམས་ཅད་བླ་ན་མེད་པ་ཡང་དག་པར་རྫོགས་པའི་བྱང་ཆུབ་ཏུ་སྐྱེ་བ་གཅིག་གིས་ཐོག་པར་མ་གྱུར་པ་དེ་སྲིད་དུ་བདག་བླ་ན་མེད་པ་ཡང་དག་པར་རྫོགས་པའི་བྱང་ཆུབ་མངོན་པར་རྫོགས་པར་འཚང་རྒྱ་བར་མི་བགྱིའོ་༎
 22| sacen me bhagavan bodhiprāptasya, tad-buddhakṣetre p15 ye bodhisattvāḥ pratyājātā bhaveyus, te sarva ekapurobhaktenānyāni	བཅོམ་ལྡན་འདས་། གལ་ཏེ་བདག་བྱང་ཆུབ་ཐོབ་པའི་ཚེ་།
 buddhakṣetrāṇi gatvā, bahūni buddhaśatāni, bahūni buddhasahasrāṇi, bahūni buddhaśatasahasrāṇi, bahvīr buddhakoṭīr, yāvad bahūni buddhakoṭīniyutaśatasahasrāṇi, nopatiṣṭheran	སངས་རྒྱས་ཀྱི་ཞིང་དེར་སེམས་ཅན་གང་དག་སྐྱེས་པར་གྱུར་པ་དེ་དག་ཐམས་ཅད་སྔ་དྲོ་གཅིག་བཞིན་སངས་རྒྱས་ཀྱི་ཞིང་གཞན་དག་ཏུ་མཆིས་ལ་། སངས་རྒྱས་བརྒྱ་ཕྲག་མང་པོ་དང་། སངས་རྒྱས་སྟོང་ཕྲག་མང་པོ་དང་། སངས་རྒྱས་བརྒྱ་སྟོང་ཕྲག་མང་པོ་དང་། སངས་རྒྱས་བྱེ་བ་ཕྲག་མང་པོ་ནས་སངས་རྒྱས་བྱེ་བ་ཁྲག་ཁྲིག་བརྒྱ་སྟོང་ཕྲག་མང་པོ་དག་ལ་༄༣༧༩ཨ་༌༎ འདི་ལྟ་སྟེ་།
 sarvasukhopadhānair, yad idaṃ : buddhānubhāvena, mā tāvad aham anuttarāṃ samyaksaṃbodhim abhisaṃ- budhyeyam|	སངས་རྒྱས་ཀྱི་མཐུས་བདེ་བར་སྦྱར་བ་ཐམས་ཅད་ཀྱིས་བསྙེན་བཀུར་བགྱིད་པར་མ་གྱུར་པ་དེ་སྲིད་དུ་བདག་བླ་ན་མེད་པ་ཡང་དག་པར་རྫོགས་པའི་བྱང་ཆུབ་མངོན་པར་རྫོགས་པར་འཚང་རྒྱ་བར་མི་བགྱིའོ་༎ བཅོམ་ལྡན་འདས་།
 23| sacen me bhagavan bodhiprāptasya, tatra buddhakṣetre ye bodhisattvā yathārūpair ākārair ākāṃkṣeyuḥ kuṣalamūlāny	གལ་ཏེ་བདག་བྱང་ཆུབ་ཐོབ་པའི་ཚེ་སངས་རྒྱས་ཀྱི་ཞིང་དེ་ན་བྱང་ཆུབ་སེམས་དཔའ་དེ་དག་འདི་ལྟ་སྟེ་། གསེར་རམ་།
 avalopituṃ,	དངུལ་ལམ་།
 yad idaṃ : suvarṇena vā,	ནོར་བུའམ་།
 rajatena vā,	མུ་ཏིག་གམ་། བེཨེ་དའུརྱའམ་། དུང་ངམ་། མན་ཤེལ་ལམ་།
 maṇimuktāvaiḍūryaśaṅkhaśilāpravāḍasphaṭikamusālagalvālohita-	བྱི་རུའམ་། ཤེལ་ལམ་། སྤུག་གམ་། རྡོའི་སྙིང་པོའམ་།
 muktāśmagarbhādibhir vānyatamānyatamaiḥ sarvaratnair	མུ་ཏིག་དམར་པོ་ལ་སོགས་པ་གང་ཡང་རུང་བའམ་། རིན་པོ་ཆེ་ཐམས་ཅད་དམ་།
 vā, sarvapuṣpagandhamālyavilepanacūrṇacīvaracchatra- dhvajapatākāpradīpair vā, sarvanṛtyagītavādyair vā, teṣāṃ	མེ་ཏོག་དང་། སྤོས་དང་། ཕྲེང་བ་དང་། བྱུག་པ་དང་། བདུག་པ་དང་། ཕྱེ་མ་དང་། གོས་དང་། གདུགས་དང་། རྒྱལ་མཚན་དང་། བ་དན་དང་། མར་མེ་ཐམས་ཅད་དང་། གླུ་དང་། གར་དང་། རོལ་མོའི་དབྱངས་སྒྲའམ་།
 cet tathārūpā ākārāḥ sahacittotpādān na prādur bhaveyur, mā tāvad aham anuttarāṃ samyaksaṃbodhim abhisaṃbudhye- yam| 24| sacen me bhagavan bodhiprāptasya, tatra buddhakṣetre ye sattvāḥ pratyājātā bhaveyus, te sarve na sarvajñatāsahagatāṃ dharmāṃ kathām kathayeyur,	རྣམ་པ་ཇི་ལྟ་བུ་དག་འཚལ་བར་གྱུར་ནས་དགེ་བའི་རྩ་བ་རྣམས་བསྐྲུན་པ་རྣམ་པ་དེ་ལྟ་བུ་དེ་དག་སེམས་བསྐྱེད་མ་ཐག་ཏུ་གལ་ཏེ་དེ་དག་ལ་བྱུང་བར་མ་གྱུར་པ་དེ་སྲིད་དུ་བདག་བླ་ན་མེད་པ་ཡང་དག་པར་རྫོགས་པའི་བྱང་ཆུབ་མངོན་པར་རྫོགས་པར་འཚང་རྒྱ་བར་མི་བགྱིའོ་༎ 
 mā tāvad aham anuttarāṃ	བཅོམ་ལྡན་འདས་།
 samyaksaṃbodhim abhisaṃbudhyeyam| 25| sacen me bhagavan bodhiprāptasya, tatra buddhakṣetre	གལ་ཏེ་བདག་བྱང་ཆུབ་ཐོབ་པའི་ཚེ་སངས་རྒྱས་ཀྱི་ཞིང་དེར་སེམས་ཅན་གང་དག་སྐྱེས་པར་གྱུར་པ་དེ་དག་ཐམས་ཅད་ཐམས་ཅད་མཁྱེན་པ་ཉིད་༄༣༧༩བ་དང་ལྡན་པའི་ཆོས་ཀྱི་བཀའ་མཆིད་མཆི་བར་མ་གྱུར་པ་དེ་སྲིད་དུ་བདག་བླ་ན་མེད་པ་ཡང་དག་པར་རྫོགས་པའི་བྱང་ཆུབ་མངོན་པར་རྫོགས་པར་འཚང་བརྒྱ་བར་མི་བགྱིའོ་༎ བཅོམ་ལྡན་འདས་།
 bodhisattvānām evaṃ cittam utpādyeta, yan nv ihaiva vayaṃ lokadhātau sthitvāprameyāsaṃkhyeyeṣu buddhakṣetreṣu buddhān bhagavataḥ satkuryāmo gurukuryāmo mānayemaḥ p16 pūjayemaḥ, yad idaṃ :	གལ་ཏེ་བདག་བྱང་ཆུབ་ཐོབ་པའི་ཚེ་སངས་རྒྱས་ཀྱི་ཞིང་དེ་ན་བྱང་ཆུབ་སེམས་དཔའ་གང་དག་འདི་སྙམ་དུ་བདག་ཅག་འཇིག་རྟེན་གྱི་ཁམས་འདི་ན་གནས་བཞིན་དུ་སངས་རྒྱས་ཀྱི་ཞིང་གྲངས་མེད་དཔག་ཏུ་མེད་པ་དག་ཏུ་སངས་རྒྱས་བཅོམ་ལྡན་འདས་རྣམས་ལ་འདི་ལྟ་སྟེ་།
 cīvarapiṇḍapātaśayanāsanaglāna- pratyayabhaiṣajyapariṣkāraiḥ puṣpadhūpagandhamālyavilepana- cūrṇacīvaracchatradhvajapatākābhir nānāvidhanṛttagītavādita-	ན་བཟའ་དང་། ཞལ་ཟས་དང་། གཟིམས་ཆ་དང་། སྙུན་གསོས་ཀྱི་སྨན་དང་། ཡོ་བྱད་རྣམས་དང་། མེ་ཏོག་དང་། བདུག་པ་དང་། སྤོས་དང་། ཕྲེང་བ་དང་། བྱུག་པ་དང་། ཕྱེ་མ་དང་། ན་བཟའ་དང་། གདུགས་དང་། རྒྱལ་མཚན་དང་། བ་དན་རྣམས་དང་། གླུ་དང་། གར་དང་། སིལ་སྙན་དང་། རིན་པོ་ཆེ་རྣམ་པ་ཐ་དད་པའི་ཆར་རྣམས་ཀྱིས་བསྟི་སྟང་དུ་བགྱི་བ་དང་། བླ་མར་བགྱི་བ་དང་། རིམ་གྲོར་བགྱི་བ་དང་། མཆོད་པར་བགྱི་བར་སེམས་བསྐྱེད་ལ་།
 ratnavarṣair iti, teṣāṃ cet te buddhā bhagavantaḥ sahacittotpādān tan na pratigṛhṇīyur, yad idam : anukampām upādāya,	དེ་དག་གིས་སེམས་བསྐྱེད་མ་ཐག་ཏུ་གལ་ཏེ་འདི་ལྟར་སངས་རྒྱས་བཅོམ་ལྡན་འདས་དེ་དག་གིས་ཐུགས་བརྩེ་བ་ཉེ་བར་བཟུང་སྟེ་།
 mā tāvad aham anuttarāṃ samyaksaṃbodhim abhisaṃ- budhyeyam|	མཆོད་པ་དེ་དག་བཞེས་པར་མ་གྱུར་པ་དེ་སྲིད་དུ་བདག་བླ་ན་མེད་པ་ཡང་དག་པར་རྫོགས་པའི་བྱང་ཆུབ་མངོན་པར་རྫོགས་པར་འཚང་རྒྱ་བར་མི་བགྱིའོ་༎ བཅོམ་ལྡན་འདས་།
 26| sacen me bhagavan bodhiprāptasya, tad-buddhakṣetre ye bodhisattvāḥ pratyājātā bhaveyus, te sarve na nārāyaṇa- vajrasaṃhananātmabhāvasthāmapratilabdhā bhaveyur, mā tāvad aham anuttarāṃ samyaksaṃbodhim abhisaṃbudhye- yam|	གལ་ཏེ་བདག་བྱང་ཆུབ་ཐོབ་པའི་ཚེ་སངས་རྒྱས་ཀྱི་ཞིང་དེར་སེམས་ཅན་གང་དག་སྐྱེས་པར་༄༣༨༠ཨ་༌༎ གྱུར་པ་དེ་དག་ཐམས་ཅད་སྲེད་མེད་ཀྱི་བུ་དང་། རྡོ་རྗེ་ལྟར་མཁྲེགས་པའི་ལུས་དང་། མཐུ་ཐོབ་པར་མ་གྱུར་པ་དེ་སྲིད་དུ་བདག་བླ་ན་མེད་པ་ཡང་དག་པར་རྫོགས་པའི་བྱང་ཆུབ་མངོན་པར་རྫོགས་པར་འཚང་རྒྱ་བར་མི་བགྱིའོ་༎ བཅོམ་ལྡན་འདས་།
 27| sacen me bhagavan bodhiprāptasya, tatra buddhakṣetre kaścit sattvo 'laṃkārasya varṇaparyantam anugṛhṇīyād,	གལ་ཏེ་བདག་བྱང་ཆུབ་ཐོབ་པའི་ཚེ་སངས་རྒྱས་ཀྱི་ཞིང་དེ་ན་རྒྱན་གྱི་ཁ་དོག་སེམས་ཅན་འགའ་ཞིག་གིས་ལྷའི་མིག་གིས་མཐའ་བལྟ་ན་ཡང་སངས་རྒྱས་ཀྱི་ཞིང་འདིའི་གཟི་བརྗིད་ནི་འདི་ལྟ་བུའོ་༎ 
 antaśo na divyenāpi cakṣuṣaivaṃvarṇam evaṃvibhūtir iti	ཁ་དོག་ནི་འདི་ལྟ་བུའོ་༎
 buddhakṣetram iti nānāvarṇatāṃ saṃjānīyān, mā tāvad aham anuttarāṃ samyaksaṃbodhim abhisaṃbudhyeyam|	འབྱོར་པ་ནི་འདི་ལྟ་བུའོ་ཞེས་ཁ་དོག་ཐ་དད་པ་དག་འཚལ་བར་མ་གྱུར་པ་དེ་སྲིད་དུ་བདག་བླ་ན་མེད་པ་ཡང་དག་པར་རྫོགས་པའི་བྱང་ཆུབ་མངོན་པར་རྫོགས་པར་འཚང་རྒྱ་བར་མི་བགྱིའོ་༎ བཅོམ་ལྡན་འདས་།
 28| sacen me bhagavan bodhiprāptasya, tatra buddhakṣetre yaḥ sarvaparīttakuśalamūlo bodhisattvaḥ sa ṣoḍaśayojana- śatocchritam udāravarṇabodhivṛkṣaṃ na saṃjānīyān, mā	གལ་ཏེ་བདག་བྱང་ཆུབ་ཐོབ་པའི་ཚེ་སངས་རྒྱས་ཀྱི་ཞིང་དེ་ན་ཐམས་ཅད་ཀྱི་ནང་ནས་བྱང་ཆུབ་སེམས་དཔའ་གང་དགེ་བའི་རྩ་བ་ཆུང་བ་དེས་ཀྱང་བྱང་ཆུབ་ཀྱི་ཤིང་དཔག་ཚད་སྟོང་དྲུག་བརྒྱ་ཙམ་དུ་མཐོང་བར་འཚལ་བར་མ་གྱུར་པ་དེ་སྲིད་དུ་བདག་བླ་ན་མེད་པ་ཡང་དག་པར་རྫོགས་པའི་བྱང་ཆུབ་མངོན་པར་རྫོགས་པར་འཚང་རྒྱ་བར་མི་བགྱིའོ་༎ བཅོམ་ལྡན་འདས་།
 tāvad aham anuttarāṃ samyaksaṃbodhim abhisaṃbudhye- yam| 29| sacen me bhagavan bodhiprāptasya, tatra buddhakṣetre p17 kasyacit sattvasyoddeśo vā svādhyāyo vā kartavyaḥ syān,	གལ་ཏེ་བདག་བྱང་ཆུབ་ཐོབ་པའི་ཚེ་སངས་རྒྱས་ཀྱི་ཞིང་དེ་ན་བྱང་ཆུབ་སེམས་དཔའ་གང་ལུང་ནོད་པ་དང་། 
 na te sarve pratisaṃvitprāptā bhaveyur, mā tāvad aham anuttarāṃ samyaksaṃbodhim abhisaṃbudhyeyam|	ཁ་ཏོན་བགྱིད་པར་གྱུར་པ་དེ་དག་ཐམས་ཅད་སོ་སོ་ཡང་དག་པར་རིག་པ་ཐོབ་པར་མ་གྱུར་པ་དེ་སྲིད་དུ་བདག་བླ་ན་མེད་༄༣༨༠བ་པ་ཡང་དག་པར་རྫོགས་པའི་བྱང་ཆུབ་མངོན་པར་རྫོགས་པར་འཚང་རྒྱ་བར་མི་ནོད་པ་དང་། བགྱིའོ་༎ བཅོམ་ལྡན་འདས་། གལ་ཏེ་བདག་བྱང་ཆུབ་ཐོབ་པའི་ཚེ་སངས་རྒྱས་ཀྱི་ཞིང་དེར་སེམས་ཅན་གང་དག་སྐྱེས་པར་གྱུར་པ་དེ་དག་ཐམས་ཅད་ཤེས་རབ་དང་སྤོབས་པ་མཐའ་ཡས་པ་ཐོབ་པར་མ་གྱུར་པ་དེ་སྲིད་དུ་བདག་བླ་ན་མེད་པ་ཡང་དག་པར་རྫོགས་པའི་བྱང་ཆུབ་མངོན་པར་རྫོགས་པར་འཚང་རྒྱ་བར་མི་བགྱིའོ་༎ བཅོམ་ལྡན་འདས་།
 30| sacen me bhagavan bodhiprāptasya, naivaṃprabhāsvaraṃ tad buddhakṣetraṃ bhaved,	གལ་ཏེ་བདག་བྱང་ཆུབ་ཐོབ་པའི་ཚེ་སངས་རྒྱས་ཀྱི་ཞིང་དེར་གང་ན་ཀུན་དུ་སངས་རྒྱས་ཀྱི་ཞིང་དཔག་ཏུ་མ་མཆིས་།
 yatra samantād aprame-	གྲངས་མ་མཆིས་།
 yāsaṃkhyeyācintyātulyāparimāṇāni buddhakṣetrāṇi saṃdṛśyeran,	བསམ་གྱིས་མི་ཁྱབ་། མཚུངས་པ་མ་མཆིས་། ཚད་མ་མཆིས་པ་དག་ཀུན་དུ་གདའ་བ་འདི་ལྟ་སྟེ་། དཔེར་བགྱི་ན་།
 tad yathāpi nāma suparimṛṣṭa ādarśamaṇḍale mukhamaṇḍalaṃ, mā tāvad aham anuttarāṃ samyaksaṃbodhim abhisaṃbudhyeyam|	ཤིན་ཏུ་ཕྱིས་པའི་མེ་ལོང་གི་དཀྱིལ་འཁོར་ལ་བཞིན་གྱི་དཀྱིལ་འཁོར་གདའ་བ་དེ་ལྟ་བུའི་འོད་གསལ་བར་མ་གྱུར་པ་དེ་སྲིད་དུ་བདག་བླ་ན་མེད་པ་ཡང་དག་པར་རྫོགས་པའི་བྱང་ཆུབ་མངོན་པར་རྫོགས་པར་འཚང་རྒྱ་བར་མི་བགྱིའོ་༎ བཅོམ་ལྡན་འདས་།
 31| sacen me bhagavan bodhiprāptasya, tatra buddhakṣetre dharaṇitalam upādāya, yāvad antarīkṣād, devamanṣyavi-	གལ་ཏེ་བདག་བྱང་ཆུབ་ཐོབ་པའི་ཚེ་སངས་རྒྱས་ཀྱི་ཞིང་དེ་ན་སའི་སྟེང་ནས་བཟུང་སྟེ་བར་སྣང་གི་བར་ལས་ལྷ་དང་མིའི་ཡུལ་ལས་ཤིན་ཏུ་འདས་པའི་གདུག་པ་རིགས་བཟང་པོ་དེ་བཞིན་གཤེགས་པ་དང་། 
 ṣayātikrāntasyābhijātasya dhūpasya tathāgatasya bodhisattvasya pūjā pratyahaṃ sarvaratnamayāni nānāsurabhigandhaghaṭikāśata- sahasrāṇi sadā nirdhūpitāny eva na syur, mā tāvad	བྱང་ཆུབ་སེམས་དཔའ་ལ་འོས་པ་དག་དྲི་རབ་ཏུ་བདའ་བའི་པོག་སྣོད་རིན་པོ་ཆེ་སྣ་ཚོགས་ལས་བགྱིས་པ་བརྒྱ་སྟོང་དག་ནས་རྟག་ཏུ་གདུགས་པར་མ་གྱུར་པ་དེ་སྲིད་དུ་བདག་བླ་ན་མེད་པ་ཡང་དག་པར་༄༣༨༡ཨ་གཤེགས་པ་དང་། 
 aham anuttarāṃ samyaksaṃbodhim abhisaṃbudhyeyam|	༌༎ རྫོགས་པའི་བྱང་ཆུབ་མངོན་པར་རྫོགས་པར་འཚང་རྒྱ་བར་མི་བགྱིའོ་༎ བཅོམ་ལྡན་འདས་།
 32| sacen me bhagavan bodhiprāptasya, tatra buddhakṣetre na sadābhipraviṣṭāny eva sugandhinānāratnapuṣpavarṣāṇi,	གལ་ཏེ་བདག་བྱང་ཆུབ་ཐོབ་པའི་ཚེ་སངས་རྒྱས་ཀྱི་ཞིང་དེ་ན་མེ་ཏོག་དྲི་རབ་ཏུ་བདའ་བ་ཐ་དད་པའི་ཆར་རྟག་ཏུ་འབབ་པར་གྱུར་པ་དང་། 
 sadā pravāditāś ca manojñasvarā vādyameghā na syur, mā tāvad aham anuttarāṃ samyaksaṃbodhim abhisaṃbudhye- yam|	རོལ་མོའི་དབྱངས་སྒྲའི་ང་རོ་ཡིད་དུ་མཆི་བའི་སྤྲིན་རྟག་ཏུ་སྒྲ་འབྱུང་བར་མ་གྱུར་པ་དེ་སྲིད་དུ་བདག་བླ་ན་མེད་པ་ཡང་དག་པར་རྫོགས་པའི་བྱང་ཆུབ་མངོན་པར་རྫོགས་པར་འཚང་རྒྱ་བར་མི་བགྱིའོ་༎ བཅོམ་ལྡན་འདས་།
 33| sacen me bhagavan bodhiprāptasya, ye sattvā apra- meyāsaṃkhyeyācintyātulyeṣu lokadhātuṣv ābhayā sphuṭā bhaveyus,	གལ་ཏེ་བདག་བྱང་ཆུབ་ཐོབ་པའི་ཚེ་བདག་གི་འོད་ཀྱིས་འཇིག་རྟེན་གྱི་ཁམས་གྲངས་མ་མཆིས་། བསམ་གྱིས་མི་ཁྱབ་།
 te sarve na devamanuṣyasamatikrāntena sukhena samanvāgatā p18 bhaveyur, mā tāvad aham anuttarāṃ samyaksaṃbodhim abhisaṃbudhyeyam|	མཚུངས་པ་མ་མཆིས་པ་དག་ཏུ་སེམས་ཅན་གང་དག་ལ་གསལ་བར་གྱུར་པ་དེ་དག་ཐམས་ཅད་ལྷ་དང་མི་ལས་ཤིན་ཏུ་འདས་པའི་བདེ་བ་དང་ལྡན་པར་མ་གྱུར་པ་དེ་སྲིད་དུ་བདག་བླ་ན་མེད་པ་ཡང་དག་པར་རྫོགས་པའི་བྱང་ཆུབ་མངོན་པར་རྫོགས་པར་འཚང་རྒྱ་བར་མི་བགྱིའོ་༎ བཅོམ་ལྡན་འདས་།
 34| sacen me bhagavan bodhiprāptasya, samantāc cāpra- meyāsaṃkhyeyācintyātulyāparimāṇeṣu buddhakṣetreṣu bodhisattvā	གལ་ཏེ་བདག་བྱང་ཆུབ་ཐོབ་པའི་ཚེ་ཀུན་དུ་སངས་རྒྱས་ཀྱི་ཞིང་དཔག་ཏུ་མ་མཆིས་།
 mama nāmādheyaṃ śrutvā, tac-chravaṇasahagatena kuśalamūlena jātivyavṛttāḥ santo,	གྲངས་མ་མཆིས་། བསམ་གྱིས་མི་ཁྱབ་།
 na dhāraṇīpratilabdhā	མཚུངས་པ་མ་མཆིས་། ཚད་མ་མཆིས་པ་དག་ཏུ་བྱང་ཆུབ་སེམས་དཔའ་དག་གིས་བདག་གི་མིང་ཐོས་ཏེ་།
 bhaveyur, yāvad bodhimaṇḍaparyantam iti, mā tāvad aham anuttarāṃ samyaksaṃbodhim abhisaṃbudhyeyam|	ཐོས་མ་ཐག་པ་ལས་བྱུང་བའི་དགེ་བའི་རྩ་བས་ཚེ་བརྗེས་ནས་བྱང་ཆུབ་ཀྱི་སྙིང་པོའི་མཐའི་བར་དུ་གཟུངས་ཐོབ་པར་མ་གྱུར་པ་དེ་སྲིད་དུ་བདག་བླ་ན་མེད་པ་༄༣༨༡བ་ཡང་དག་པར་རྫོགས་པའི་བྱང་ཆུབ་མངོན་པར་རྫོགས་པར་འཚང་རྒྱ་བར་མི་བགྱིའོ་༎ བཅོམ་ལྡན་འདས་།
 35| sacen me bhagavan bodhiprāptasya,	གལ་ཏེ་བདག་བྱང་ཆུབ་ཐོབ་པའི་ཚེ་ཀུན་དུ་སངས་རྒྱས་ཀྱི་ཞིང་གྲངས་མ་མཆིས་། བསམ་གྱིས་མི་ཁྱབ་།
 samantād aprame-	མཚུངས་པ་མ་མཆིས་།
 yāsaṃkhyeyācintyātulyāparimāneṣu buddhakṣetreṣu yāḥ striyo mama nāmadheyaṃ śrutvā, prasādaṃ saṃjanayeyur,	ཚད་མ་མཆིས་པ་དག་ན་བུད་མེད་གང་དག་གིས་བདག་གི་མིང་ཐོས་ནས་རབ་ཏུ་དང་བ་སྐྱེས་ཏེ་། 
 bodhicittaṃ cotpādayeyuḥ,	བྱང་ཆུབ་ཏུ་སེམས་བསྐྱེད་པར་གྱུར་ལ་།
 strībhāvaṃ ca vijugupsyeran, jātivyativṛttāḥ	བུད་མེད་ཀྱི་ལུས་ལ་སྨོད་པར་གྱུར་ཏེ་།
 samānāḥ saced dvitīyaṃ strībhāvaṃ pratilabheran, mā tāvad aham anuttarāṃ samyaksaṃbodhim abhisaṃ- budhyeyam|	དེ་དག་ཚེ་བརྗེས་ནས་གལ་ཏེ་བུད་མེད་ཀྱི་ལུས་ལན་གཉིས་ཐོབ་པར་གྱུར་པ་དེ་སྲིད་དུ་བདག་བླ་ན་མེད་པ་ཡང་དག་པར་རྫོགས་པའི་བྱང་ཆུབ་མངོན་པར་རྫོགས་པར་འཚང་རྒྱ་བར་མི་བགྱིའོ་༎ བཅོམ་ལྡན་འདས་། གལ་ཏེ་བདག་བྱང་ཆུབ་ཐོབ་པའི་ཚེ་སངས་རྒྱས་ཀྱི་ཞིང་དཔག་ཏུ་མ་མཆིས་། གྲངས་མ་མཆིས་། བསམ་གྱིས་མི་ཁྱབ་། མཚུངས་པ་མ་མཆིས་། ཚད་མ་མཆིས་པ་དག་ན་སེམས་ཅན་གང་དག་གིས་བདག་གི་མིང་ཐོས་པར་གྱུར་ལ་། མིང་ཐོས་པ་ཙམ་གྱིས་བྱང་ཆུབ་ཀྱི་སྙིང་པོའི་མཐའི་བར་དུ་ཚངས་པར་སྤྱོད་པར་མ་གྱུར་པ་དེ་སྲིད་དུ་བདག་བླ་ན་མེད་པ་ཡང་དག་པར་རྫོགས་པའི་བྱང་ཆུབ་མངོན་པར་རྫོགས་པར་འཚང་རྒྱ་བར་མི་བགྱིའོ་༎ བཅོམ་ལྡན་འདས་།
 36| sacen me bhagavan bodhiprāptasya, samantād daśasu dikṣv aprameyāsaṃkhyeyācintyātulyāparimāṇeṣu buddhakṣetreṣu	གལ་ཏེ་བདག་བྱང་ཆུབ་ཐོབ་པའི་ཚེ་ཕྱོགས་བཅུ་ཀུན་དུ་སངས་རྒྱས་ཀྱི་ཞིང་དཔག་ཏུ་མ་མཆིས་། གྲངས་མ་མཆིས་། བསམ་གྱིས་མི་ཁྱབ་། མཚུངས་པ་མ་མཆིས་།
 ye bodhisattvā mama nāmadheyaṃ śrutvā, praṇipatya pañcamaṇḍalanamaskāreṇa vandiṣyante,	ཚད་མ་མཆིས་པ་དག་ན་སེམས་ཅན་གང་དག་གིས་བདག་གི་མིང་ཐོས་པ་༄༣༨༢ཨ་༌༎
 te bodhisattvacaryāṃ caranto, na sadevakena lokena namasā satkṛtyeran, mā tāvad aham anuttarāṃ samyaksaṃbodhim abhisaṃbudhyeyam|	ལ་ཡན་ལག་ལྔའི་ཕྱག་བགྱི་བས་ཕྱག་འཚལ་བ་དང་། དེ་དག་བྱང་ཆུབ་སེམས་དཔའི་སྤྱད་པ་སྤྱོད་པ་ན་ལྷ་དང་བཅས་པའི་འཇིག་རྟེན་གྱིས་བསྟི་སྟང་དུ་བགྱི་བར་མ་གྱུར་པ་དེ་སྲིད་དུ་བདག་བླ་ན་མེད་པ་ཡང་དག་པར་རྫོགས་པའི་བྱང་ཆུབ་མངོན་པར་རྫོགས་པར་འཚང་རྒྱ་བར་མི་བགྱིའོ་༎ བཅོམ་ལྡན་འདས་།
 37| sacen me bhagavan bodhiprāptasya,	གལ་ཏེ་བདག་བྱང་ཆུབ་ཐོབ་པའི་ཚེ་སངས་རྒྱས་ཀྱི་ཞིང་དེ་ན་བྱང་ཆུབ་སེམས་དཔའ་གང་ཆོས་གོས་འཁྲུའམ་། 
 kasyacid bodhisattvasya	སྐེམས་སམ་། འདྲུབ་བམ་།
 cīvaradhāvanaśoṣaṇasīvanarajanakarma kartavyaṃ bhaven, p19 na navanavābhijātacīvararatnaiḥ prāvṛtam evātmānaṃ	འཚེད་པའི་ལས་བགྱིད་པར་གྱུར་ལ་།
 saṃjānīyuḥ, sahacittotpādāt tathāgatasyājñānujñātair, mā tāvad aham anuttarāṃ samyaksaṃbodhim abhisaṃbudhyeyam|	ཆོས་གོས་རིན་པོ་ཆེ་སར་པ་ཁྲེའུ་ཚང་རིགས་བཟང་བ་དེ་བཞིན་གཤེགས་པས་གནང་བ་དག་སེམས་བསྐྱེད་མ་ཐག་ཏུ་བགོས་པར་བདག་གིས་འཚལ་བར་མ་གྱུར་པ་དེ་སྲིད་དུ་བདག་བླ་ན་མེད་པ་ཡང་དག་པར་རྫོགས་པའི་བྱང་ཆུབ་མངོན་པར་རྫོགས་པར་འཚང་རྒྱ་བར་མི་བགྱིའོ་༎ བཅོམ་ལྡན་འདས་།
 38| sacen me bhagavan bodhiprāptasya, tatra buddhakṣetre sahotpannāḥ sattvā naivaṃvidhaṃ sukhaṃ pratilabheraṃs,	གལ་ཏེ་བདག་བྱང་ཆུབ་ཐོབ་པའི་ཚེ་སངས་རྒྱས་ཀྱི་ཞིང་དེར་སེམས་ཅན་གང་དག་སྐྱེས་མ་ཐག་ཏུ་འདི་ལྟ་སྟེ་།
 tad yathāpi nāma niṣparidāhasyārhato bhikṣos tṛtīyadhyāna-	དཔེར་ན་། དགེ་སློང་དགྲ་བཅོམ་པ་ཡོངས་སུ་གདུང་བ་མ་མཆིས་པ་།
 samāpannasya, mā tāvad aham anuttarāṃ samyaksaṃbodhim abhisaṃbudhyeyam|	བསམ་གཏན་གསུམ་པ་ལ་སྙོམས་པར་ཞུགས་པ་ལྟ་བུར་བདེ་བ་རྣམ་པ་དེ་ལྟ་བུ་ཐོབ་པར་མ་གྱུར་པ་དེ་སྲིད་དུ་བདག་བླ་ན་མེད་པ་ཡང་དག་པར་རྫོགས་པའི་བྱང་ཆུབ་མངོན་པར་རྫོགས་པར་འཚང་རྒྱ་བར་མི་བགྱིའོ་༎ བཅོམ་ལྡན་འདས་།
 39| sacen me bhagavan bodhiprāptasya, tatra buddhakṣetre ye bodhisattvāḥ pratyajātās, te yathārūpaṃ buddhakṣetra- guṇālaṃkāravyūham ākāṃkṣeyus, tathārūpaṃ nānā- ratnavṛkṣebhyo na saṃjānīyur,	གལ་ཏེ་བདག་བྱང་ཆུབ་ཐོབ་པའི་ཚེ་༄༣༨༢བ་སངས་རྒྱས་ཀྱི་ཞིང་དེར་བྱང་ཆུབ་སེམས་དཔའ་གང་དག་སྐྱེས་པར་གྱུར་པ་དེ་དག་སངས་རྒྱས་ཀྱི་ཞིང་གི་ཡོན་ཏན་གྱི་རྒྱན་བཀོད་པ་རྣམ་པ་ཇི་ལྟ་བུ་དག་འདོད་པར་གྱུར་པ་རྣམ་པ་དེ་ལྟ་བུ་དག་རིན་པོ་ཆེའི་ཤིང་སྣ་ཚོགས་ལས་འཚལ་བར་མ་གྱུར་པ་དེ་སྲིད་དུ་བདག་བླ་ན་མེད་པ་ཡང་དག་པར་རྫོགས་པའི་བྱང་ཆུབ་མངོན་པར་རྫོགས་པར་འཚང་རྒྱ་བར་མི་བགྱིའོ་༎
 mā tāvad aham anuttarāṃ samyaksaṃbodhim abhisaṃbudhyeyam|	བཅོམ་ལྡན་འདས་།
 40| sacen me bhagavan bodhiprāptasya, taṃ mama nāmadheyaṃ śrutvānyabuddhakṣetropapannā bodhisattvā indriyabalavaikalpaṃ	གལ་ཏེ་བདག་བྱང་ཆུབ་ཐོབ་པའི་ཚེ་བྱང་ཆུབ་སེམས་དཔའ་སངས་རྒྱས་ཀྱི་ཞིང་གཞན་དུ་སྐྱེས་པ་དག་གིས་བདག་གི་མིང་ཐོས་ལ་།
 nirgaccheyur, mā tāvad aham anuttarāṃ samyaksaṃbodhim abhisaṃbudhyeyam|	དབང་པོ་མ་ཚང་པ་མེད་པ་ཐོབ་པར་མ་གྱུར་པ་དེ་སྲིད་དུ་བདག་བླ་ན་མེད་པ་ཡང་དག་པར་རྫོགས་པའི་བྱང་ཆུབ་མངོན་པར་རྫོགས་པར་འཚང་རྒྱ་བར་མི་བགྱིའོ་༎
 41| sacen me bhagavan bodhiprāptasya, tad-anyabuddhakṣetra- sthā bodhisattvā mama nāmadheyaṃ śrutvā, sahaśravaṇān	བཅོམ་ལྡན་འདས་། གལ་ཏེ་བདག་བྱང་ཆུབ་ཐོབ་པའི་ཚེ་།
 na suvibhaktavatīṃ nāma samādhiṃ pratilabheran, yatra samādhau sthitvā bodhisattvā ekakṣaṇavyatihāreṇāprameyā- saṃkhyeyācintyātulyāparimāṇān buddhān bhagavataḥ	སངས་རྒྱས་ཀྱི་ཞིང་གཞན་ན་གནས་པའི་བྱང་ཆུབ་སེམས་དཔའ་དག་གིས་བདག་གི་མིང་ཐོས་མ་ཐག་ཏུ་ཤིན་ཏུ་རྣམ་པར་ཕྱེ་བ་ཞེས་བགྱི་བའི་ཏིང་ངེ་འཛིན་ཐོབ་པར་མ་གྱུར་པ་དང་། བྱང་ཆུབ་སེམས་དཔའ་ཏིང་ངེ་འཛིན་དེ་ལ་གནས་ནས་སྐད་ཅིག་གཅིག་འདས་པ་ཙམ་གྱིས་སངས་རྒྱས་བཅོམ་ལྡན་འདས་དཔག་ཏུ་མ་མཆིས་། གྲངས་མ་མཆིས་། བསམ་གྱིས་མི་ཁྱབ་། མཚུངས་པ་མ་མཆིས་།
 paśyanti, sa caiṣāṃ samādhir antarā vipranaśyen, mā tāvad	ཚད་མ་མཆིས་པ་དག་མཐོང་ལ་།
 aham anuttarāṃ samyaksaṃbodhim abhisaṃbudhyeyam| p20	ཏིང་ངེ་འཛིན་དེ་བར་མ་དོར་ཆབ་འཚལ་བར་མ་གྱུར་པ་དེ་སྲིད་དུ་བདག་བླ་ན་མེད་པ་ཡང་དག་པར་རྫོགས་པའི་བྱང་ཆུབ་མངོན་པར་རྫོགས་པར་༄༣༨༣ཨ་༌༎ འཚང་རྒྱ་བར་མི་བགྱིའོ་༎ བཅོམ་ལྡན་འདས་།
 42| sacen me bhagavan bodhiprāptasya, mama nāmadheyaṃ śrutvā, tac-chravaṇasahagatena kuśalamūlena sattvā	གལ་ཏེ་བདག་བྱང་ཆུབ་ཐོབ་པའི་ཚེ་སེམས་ཅན་དག་གིས་བདག་གི་མིང་ཐོས་ལ་།
 nābhijātakulopapattiṃ pratilabheran, yāvad bodhimaṇḍa- paryantaṃ, mā tāvad aham anuttarāṃ samyaksaṃbodhim abhisaṃbudhyeyam|	ཐོས་མ་ཐག་པ་ལས་བྱུང་བའི་དགེ་བའི་རྩ་བས་སེམས་ཅན་རྣམས་བྱང་ཆུབ་ཀྱི་མཐའི་བར་དུ་རིགས་བཟང་པོའི་རིགས་སུ་སྐྱེ་བ་ཐོབ་པར་མ་གྱུར་པ་དེ་སྲིད་དུ་བདག་བླ་ན་མེད་པ་ཡང་དག་པར་རྫོགས་པའི་བྱང་ཆུབ་མངོན་པར་རྫོགས་པར་འཚང་རྒྱ་བར་མི་བགྱིའོ་༎ བཅོམ་ལྡན་འདས་།
 43| sacen me bhagavan bodhiprāptasya, tad-anyeṣu buddhakṣetreṣu ye sattvā mama nāmadheyaṃ śrutvā, tac-chravaṇa-	གལ་ཏེ་བདག་བྱང་ཆུབ་ཐོབ་པའི་ཚེ་འདི་ལས་གཞན་དུ་གྱུར་པའི་སངས་རྒྱས་ཀྱི་ཞིང་རྣམས་སུ་བྱང་ཆུབ་སེམས་དཔའ་གང་དག་གིས་བདག་གི་མིང་ཐོས་པར་གྱུར་ལ་།
 sahagatena kuśalamūlena yāvad bodhiparyantaṃ na sarve bodhisattvacaryāyāṃ prītiprāmodyakuśalamūlasamavadhāna- gatā bhaveyur,	དེ་ཐོས་མ་ཐག་པ་ལས་བྱུང་བའི་དགེ་བའི་རྩ་བས་བྱང་ཆུབ་ཀྱི་མཐའི་བར་དུ་ཐམས་ཅད་བྱང་ཆུབ་སེམས་དཔའི་སྤྱོད་པ་ལ་དགའ་བ་དང་། མཆོག་ཏུ་དགའ་བའི་དགེ་བའི་རྩ་བ་དང་ཕྲད་པར་མ་གྱུར་པ་དེ་སྲིད་དུ་བདག་བླ་ན་མེད་པ་ཡང་དག་པར་རྫོགས་པའི་བྱང་ཆུབ་མངོན་པར་རྫོགས་པར་འཚང་རྒྱ་བར་མི་བགྱིའོ་༎
 mā tāvad aham anuttarāṃ samyaksaṃbodhim abhisaṃbudhyeyam|	བཅོམ་ལྡན་འདས་།
 44| sacen me bhagavan bodhiprāptasya, sahanāmadheya- śravaṇāt tad-anyeṣu lokadhātuṣu bodhisattvā na samantānugataṃ	གལ་ཏེ་བདག་བྱང་ཆུབ་ཐོབ་པའི་ཚེ་འདི་ལས་གཞན་དུ་གྱུར་པའི་འཇིག་རྟེན་གྱི་ཁམས་རྣམས་སུ་བྱང་ཆུབ་སེམས་དཔའ་གང་དག་གིས་བདག་གི་མིང་ཐོས་མ་ཐག་ཏུ་ཀུན་གྱི་རྗེས་སུ་སོང་བ་ཞེས་བགྱི་བའི་ཏིང་ངེ་འཛིན་ཐོབ་པར་མ་གྱུར་པ་དང་། 
 nāma samādhiṃ pratilabheran, yatra sthitvā bodhisattvā ekakṣaṇavyatihāreṇāprameyāsaṃkhyeyācintyāparimāṇān	བྱང་ཆུབ་སེམས་དཔའ་དག་ཏིང་ངེ་འཛིན་དེ་ལ་གནས་ནས་སྐད་ཅིག་གཅིག་༄༣༨༣བ་འདས་པ་ཙམ་གྱིས་སངས་རྒྱས་བཅོམ་ལྡན་འདས་གྲངས་མ་པ་དང་། མཆིས་། དཔག་ཏུ་མ་མཆིས་། བསམ་གྱིས་མི་ཁྱབ་། མཚུངས་པ་མ་མཆིས་།
 buddhān bhagavataḥ satkurvanti, sa caiṣāṃ samādhir antarād vipranaśyed,	ཚད་མ་མཆིས་པ་དག་ལ་བསྟི་སྟང་བགྱིད་ལ་།
 yāvad bodhimaṇḍaparyantaṃ, mā tāvad aham anuttarāṃ samyaksaṃbodhim abhisaṃbudhyeyam| 45| sacen me bhagavan bodhiprāptasya, tatra buddhakṣetre ye bodhisattvāḥ pratyājātā bhaveyus, te yathārūpāṃ dharmadeśanām ākāṃkṣeyuḥ, śrotum tathārupāṃ sahacittotpādān p21	ཏིང་ངེ་འཛིན་དེ་བྱང་ཆུབ་ཀྱི་སྙིང་པོའི་མཐའི་བར་དུ་བར་མ་དོར་ཆ་བ་འཚལ་བར་མ་གྱུར་པ་དེ་སྲིད་དུ་བདག་བླ་ན་མེད་པ་ཡང་དག་པར་རྫོགས་པའི་བྱང་ཆུབ་མངོན་པར་རྫོགས་པར་འཚང་རྒྱ་བར་མི་བགྱིའོ་༎
 na śṛṇuyur, mā tāvad aham anuttarāṃ samyaksaṃbodhim	བཅོམ་ལྡན་འདས་།
 abhisaṃbudhyeyam 46| sacen me bhagavan bodhiprāptasya, tatra buddhakṣetre	གལ་ཏེ་བདག་བྱང་ཆུབ་ཐོབ་པའི་ཚེ་སངས་རྒྱས་ཀྱི་ཞིང་དེར་སེམས་ཅན་གང་དག་སྐྱེས་པར་གྱུར་པ་དེ་དག་ཆོས་བསྟན་པ་རྣམ་པ་ཇི་ལྟ་བུ་ཉན་འཚལ་བར་གྱུར་པ་ཆོས་བསྟན་པ་རྣམ་པ་དེ་ལྟ་བུ་སེམས་བསྐྱེད་མ་ཐག་ཏུ་ཐོས་པར་མ་གྱུར་པ་དེ་སྲིད་དུ་བདག་བླ་ན་མེད་པ་ཡང་དག་པར་རྫོགས་པའི་བྱང་ཆུབ་མངོན་པར་རྫོགས་པར་འཚང་རྒྱ་བར་མི་བགྱིའོ་༎ བཅོམ་ལྡན་འདས་།
 tad-anyeṣu buddhakṣetreṣu ye bodhisattvā mama nāmadheyaṃ śṛṇuyur, yas te sahanāmadheyaśravaṇān nāvaivarttikā bhaveyur anuttarāyāḥ samyaksaṃbodher, mā tāvad aham anuttarāṃ samyaksaṃbodhim abhisaṃbudhyeyam|	གལ་ཏེ་བདག་བྱང་ཆུབ་ཐོབ་པའི་ཚེ་སངས་རྒྱས་ཀྱི་ཞིང་གཞན་དག་ཏུ་བྱང་ཆུབ་སེམས་དཔའ་གང་དག་གིས་བདག་གི་མིང་ཐོས་པ་དེ་དག་བདག་གི་མིང་ཐོས་མ་ཐག་ཏུ་བླ་ན་མེད་པ་ཡང་དག་པར་རྫོགས་པའི་བྱང་ཆུབ་ལས་ཕྱིར་མི་ལྡོག་པར་མ་གྱུར་པ་དེ་སྲིད་དུ་བདག་བླ་ན་མེད་པ་ཡང་དག་པར་རྫོགས་པའི་བྱང་ཆུབ་མངོན་པར་རྫོགས་པར་འཚང་རྒྱ་བར་མི་བགྱིའོ་༎ བཅོམ་ལྡན་འདས་།
 47| sacen me bhagavan bodhiprāptasya, tatra buddhakṣetre ye bodhisattvā mama nāmadheyaṃ śṛṇuyus, te sahanāmadheya-	གལ་ཏེ་བདག་བྱང་ཆུབ་ཐོབ་པའི་ཚེ་སངས་རྒྱས་ཀྱི་ཞིང་གཞན་དག་ཏུ་བྱང་ཆུབ་སེམས་དཔའ་གང་དག་གིས་བདག་གི་མིང་ཐོས་པར་གྱུར་པ་དེ་དག་གི་མིང་ཐོས་མ་ཐག་ཏུ་བཟོད་པ་དང་པོ་དང་། 
 śravaṇān na prathamadvitīyatṛtīyāḥ kṣāntīḥ pratilabheran, nāvaivarttiko bhaved buddhadharmebhyo, mā tāvad aham anuttarāṃ samyaksaṃbodhim abhisaṃbudhyeyam|	༄༣༨༤ཨ་༌༎ གཉིས་པ་དང་། གསུམ་པ་ཐོབ་པར་མ་གྱུར་པ་དང་། སངས་རྒྱས་ཀྱི་ཆོས་རྣམས་ལས་ཕྱིར་མི་ལྡོག་པར་མ་གྱུར་པ་དེ་སྲིད་དུ་བདག་བླ་ན་མེད་པ་ཡང་དག་པར་རྫོགས་པའི་བྱང་ཆུབ་མངོན་པར་རྫོགས་པར་འཚང་རྒྱ་བར་མི་བགྱིའོ་༎ ཀུན་དགའ་བོ་།
 atha khalv ānanda sa dharmākaro bhikṣur imān evaṃrūpān praṇidhānaviśeṣān nirdiśya, tasyāṃ velāyāṃ buddhānubhāvenemā	དེ་ནས་དགེ་སློང་ཆོས་ཀྱི་འབྱུང་གནས་དེས་སྨོན་ལམ་གྱི་ཁྱད་པར་རྣམ་པ་འདི་ལྟ་བུ་འདི་དག་བསྟན་ནས་སངས་རྒྱས་ཀྱི་མཐུས་དེའི་ཚེ་ཚིགས་སུ་བཅད་པ་འདི་དག་གསོལ་ཏོ་༎ གལ་ཏེ་དག་གིས་བྱང་ཆུབ་ཐོབ་ཚེ་སྨོན་ལམ་མཆོག་། ཁྱད་པར་འཕགས་པ་རྣམ་པ་འདི་འདྲར་མ་གྱུར་ན་༎
 gāthā abhāṣata : saci mi imi viśiṣṭa naikarūpā varapraṇidhāna siyā khu bodhiprāpte,	སྟོབས་བཅུ་མངའ་བ་མཚུངས་པ་མ་མཆིས་སྦྱིན་པའི་གནས་༎
 ma ahu siya narendra sattvasāro,	མི་ཡི་སེང་གེ་སེམས་ཅན་སྙིང་པོར་བདག་མ་གྱུར་༎ གལ་ཏེ་བདག་ཞིང་རྣམ་པ་དེ་འདྲར་མ་གྱུར་ལ་༎
 daśabaladhāri atulyadakṣiṇīyaḥ (1) saci mi siya na kṣetra evarūpaṃ bahu adhanāna prabhūta divyacitraṃ,	སེམས་ཅན་དབུལ་མང་ནོར་མང་སྩལ་པར་མ་གྱུར་ཅིང་༎
 sukhi na narakamaya duḥkhaprāpto, ma ahu siyā ratano narāṇa rājā| (2)	སྡུག་བསྔལ་གྱུར་པའི་མི་དག་བདེ་བར་མ་བགྱིས་པར་༎ མི་ཡི་རྒྱལ་པོ་དཀོན་མཆོག་ཏུ་ནི་བདག་མ་གྱུར་༎
 saci mi upagatasya bodhimaṇḍaṃ, daśadiśi pravraji nāmadheyu kṣipraṃ p22	བདག་ནི་བྱང་ཆུབ་སྙིང་པོར་ཉེ་བར་མཆིས་པའི་ཚེ་༎
 pṛthu bahava anantabuddhakṣetrāṃ,	ཕྱོགས་བཅུ་དག་གི་ཞིང་རྣམས་མང་པོ་ཐ་གྲུ་ཆེ་༎ མཐའ་ཡས་དག་ཏུ་མྱུར་དུ་མིང་གྲགས་མ་གྱུར་པར་༎
 ma ahu siyā balaprāptu lokanātha| (3)	འཇིག་རྟེན་མགོན་པོ་སྟོབས་བརྙེས་པར་ནི་བདག་མ་གྱུར་༎
 saci khu ahu rameya kāmabhogāṃ, smṛtimatigatiyā vihīnu santaḥ, atulaśiva sameyamāṇa bodhi,	བྱང་ཆུབ་མཚུངས་མེད་ཞི་བ་ཡང་དག་ཚོལ་བ་ན་༎ དྲན་དང་བློ་གྲོས་རྟོགས་པ་རྣམ་པར་ཉམས་གྱུར་ཅིང་༎ གལ་ཏེ་བདག་ནི་འདོད་པའི་ལོངས་སྤྱོད་སྤྱོད་གྱུར་༄༣༨༤བ་ན༏་༏འཇིག་རྟེན་སྟོན་པ་སྟོབས་བརྙེས་པར་ནི་བདག་མ་གྱུར་༎ 
 ma ahu siyā balaprāptu śāstu loke| (4)	ཤིན་ཏུ་རྒྱས་འོད་མཚུངས་པ་མ་མཆིས་མཐའ་ཡས་པ་༎
 vipulaprabha atulyananta nāthā diśi vidiśi sphuri sarvabuddhakṣetrāṃ, rāga praśami praśamiya sarvadoṣamohāṃ,	ཕྱོགས་དང་ཕྱོགས་མཚམས་མགོན་པོའི་སངས་རྒྱས་ཞིང་ཀུན་ཁྱབ༏་༏འདོད་ཆགས་ཞེ་སྡང་གཏི་མུག་ཐམས་ཅད་རབ་ཞི་ཞིང་༎ 
 narakagatismi praśāmi dhūmaketuṃ| (5)	སེམས་ཅན་དམྱལ་བར་དོང་བའི་མེ་རྣམས་ཞི་བར་བགྱི་༎
 jāniya suruciraṃ viśālanetraṃ,	ཤིན་ཏུ་མཛེས་ཤིང་ཡངས་པའི་མིག་ནི་ཕྱི་ནས་སུ་༎
 vidhuniya sarvanarāṇa andhakāram, apaniya suna akṣaṇān aśeṣān,	མི་རྣམས་ཀུན་གྱི་མུན་ནག་རྣམ་པར་བསལ་བར་བགྱི་༎ དལ་བ་མེད་པ་དག་ནི་མ་ལུས་བསལ་ནས་སུ་༎
 upaniya svargapathān anantatejā| (6)	གཟི་བརྗིད་མཐའ་ཡས་མཐོ་རིས་ལམ་དུ་གཟུང་བར་བགྱི་༎ སྔོན་གྱི་སྤྱོད་པ་ཡོངས་སུ་དག་པར་སྤྱད་ནས་ནི་༎
 na tapati nabha candrasūrya-ābhā	མཁའ་ལ་ཉི་ཟླའི་འོད་ནི་ལམ་མེ་མ་ལགས་ཤིང་༎
 maṇigaṇa agniprabhā va devatānāṃ,	ནོར་བུའི་ཚོགས་དང་མེ་དང་ལྷ་ཡི་འོད་རྣམས་ཀྱང་༎ མི་ཡི་སེང་གེའི་འོད་ཀྱིས་ཐམས་ཅད་ཟིལ་གྱིས་མནན་༎
 abhibhavati narendra-ābha sarvān purimacariṃ pariśuddha ācaritvā| (7) puruṣavaru nidhāna duḥkhitānāṃ,	སྐྱེས་བུ་མཆོག་གྱུར་སྡུག་བསྔལ་རྣམས་ཀྱི་གཏེར་གྱུར་ཏེ་༎
 diśi vidiśāsu na asti evarūpā|	ཕྱོགས་མཚམས་ཕྱོགས་ན་དེ་འདྲའི་གཟུགས་ནི་མ་མཆིས་ཤིང་༎
 kuśalaśatasahasra sarva pūrṇā, parṣagato nadi buddhasiṃhanadaṃ| (8)	དགེ་བ་བརྒྱ་སྟོང་དག་ནི་རབ་ཏུ་རྫོགས་གྱུར་ནས་༎ འཁོར་ནའང་མཆིས་ཏེ་སངས་རྒྱས་སེང་གེའི་སྒྲ་བསྒྲག་གོ་།
 purimajina svayaṃbhu satkaritvā,	སྔོན་གྱི་རྒྱལ་བ་རང་བྱུང་དག་ལ་གུས་བགྱིས་ཏེ་༎
 vratatapakoṭi caritva aprameyāṃ, pravara vara samesti jñānaskandhaṃ,	བརྟུལ་ཞུགས་དཀའ་ཐུབ་བྱེ་བ་དཔག་མེད་སྤྱད་ནས་ནི་༎ ཡེ་ཤེས་ཕུང་པོ་དམ་པ་མཆོག་རབ་བཙལ་ནས་སུ་༎
 praṇidhibalaṃ paripūrṇa sattvasāro| (9) p23	སྨོན་ལམ་སྟོབས་ནི་རྫོགས་བགྱིས་སེམས་ཅན་སྙིང་པོར་འགྱུར་༎
 yathā bhagavan asaṅgajñānadarśī,	ཇི་ལྟར་བཅོམ་ལྡན་འདས་ཡེ་ཤེས་གཟིགས་པ་ཆགས་མི་མངའ༎
 trividha prajānati saṃskṛtaṃ narendraḥ|	མི་ཡི་དབང་པོ་འདུས་བྱས་རྣམ་གསུམ་རབ་༄༣༨༥ཨ་༌༎ མཁྱེན་པ་༎
 aham api siya tulyadakṣiṇīyo, viduḥ pravaro naranāyako narāṇāṃ| (10)	བདག་ཀྱང་མཚུངས་པ་མ་མཆིས་སྦྱིན་གནས་མཁས་པ་དང་༎ མི་རྣམས་ནང་ན་མི་ཡི་འདྲེན་པ་མཆོག་གྱུར་ཅིག་།
 saci mi ayu narendra evarūpā praṇidhi samṛdhyati bodhi prāpuṇitvā,	མི་དབང་བདག་གིས་བྱང་ཆུབ་རབ་ཏུ་ཐོབ་ནས་ནི་༎ གལ་ཏེ་སྨོན་ལམ་འདི་འདྲ་འདི་དག་འགྲུབ་ཅེ་ན་༎
 calatu ayu sahasralokadhātūṃ	སྟོང་གི་འཇིག་རྟེན་ཁམས་འདི་རབ་ཏུ་ག-ཡོས་གྱུར་ཅིང་༎
 kusumu pravarṣa nabhātu devasaṃghān| (11)	ལྷ་ཡི་ཚོགས་ཀྱིས་མཁའ་ལས་མེ་ཏོག་ཆར་ཕོབ་ཅིག་།
 pracalita vasudhā pravarṣi puṣpāḥ,	ས་ཡང་རབ་ཏུ་ག-ཡོས་ཏེ་མེ་ཏོག་ཆར་ཡང་བབ་༎
 tūryaśatā gagane tha saṃpraṇeduḥ|	ནམ་མཁའ་ལས་ཀྱང་སིལ་སྙན་རྣམས་ཀྱི་སྒྲ་ཡང་བྱུང་༎
 divyaruciracandanasya cūrṇā,	ལྷ་ཡི་ཙན་དན་མཛེས་པ་དག་གི་ཕྱེ་མ་ཡང་༎
 abhikiri caiva bhaviṣyi loki buddha, iti| (12)	མངོན་པར་འཐོབ་བར་གྱུར་ཏེ་འཇིག་རྟེན་སངས་རྒྱས་འགྱུར་༎༎ བམ་པོ་གཉིས་པ་། ཀུན་དགའ་བོ་།
 evaṃrūpayānanda praṇidhisaṃpadā sa dharmākaro bhikṣur bodhisattvo mahāsattvaḥ samanvāgato 'bhūt| evaṃrūpayā	དགེ་སློང་ཆོས་ཀྱི་འབྱུང་གནས་བྱང་ཆུབ་སེམས་དཔའ་སེམས་དཔའ་ཆེན་པོ་དེ་སྨོན་ལམ་ཕུན་སུམ་ཚོགས་པ་རྣམ་པ་དེ་ལྟ་བུ་དང་ལྡན་ཏེ་། ཀུན་དགའ་བོ་། སྨོན་ལམ་ཕུན་སུམ་ཚོགས་པ་རྣམ་པ་འདི་ལྟ་བུ་དང་ལྡན་པའི་བྱང་ཆུབ་སེམས་དཔའ་ནི་ཉུང་ངོ་༎ 
 cānanda praṇidhisaṃpadā alpakā bodhisattvāḥ samanvāgatāḥ| alpakānāṃ caivaṃrūpāṇāṃ praṇidhīnāṃ loke prādurbhāvo	སྨོན་ལམ་རྣམ་པ་འདི་ལྟ་བུ་དག་འཇིག་རྟེན་དུ་བྱུང་བ་ཉུང་སྟེ་། ཉུང་དུ་ཟད་ཀྱི་།
 bhavati, parīttānāṃ na punaḥ sarvaśo nāsti|	ཡེ་མེད་པ་ནི་མ་ཡིན་ནོ་༎ ཀུན་དགའ་བོ་།
 sa khalu punar ānanda dharmākaro bhikṣus tasya bhagavato lokeśvararājasya tathāgatasya purataḥ, sadevakasya lokasya	དགེ་སློང་ཆོས་ཀྱི་འབྱུང་གནས་དེས་བཅོམ་ལྡན་འདས་དེ་བཞིན་གཤེགས་པ་འཇིག་རྟེན་དབང་ཕྱུག་རྒྱལ་པོ་དེའི་སྤྱན་སྔར་ལྷ་དང་བཅས་པའི་འཇིག་རྟེན་བདུད་དང་བཅས་པ་དང་། ཚངས་པ་དང་བཅགས་པ་།
 samārakasya sabrahmakasya saśramaṇabrāhmaṇikāyāḥ	དགེ་སྦྱོང་དང་བྲམ་ཟེའི་སྐྱེ་དགུ་དང་བཅས་པ་།
 prajāyāḥ sadevamānuṣāsurāyāḥ purata, imān evaṃrūpān praṇidhiviśeṣān nirdiśya, yathābhūtaṃ pratijñāpratipattisthito	ལྷ་དང་མི་དང་ལྷ་མ་༄༣༨༥བ་ཡིན་དུ་བཅས་པའི་མདུན་དུ་སྨོན་ལམ་གྱི་ཁྱད་པར་རྣམ་པ་དེ་ལྟ་བུ་དེ་དག་བསྟན་ནས་ཡང་དག་པ་ཇི་ལྟ་བ་བཞིན་དུ་སྒྲུབ་པ་ལ་གནས་པར་གྱུར་ཏེ་། 
 'bhūt| sa imām evaṃrūpāṃ buddhakṣetrapariśuddhiṃ buddhakṣetra- māhātmyaṃ buddhakṣetrodāratāṃ samudānayan,	དེ་སངས་རྒྱས་ཀྱི་ཞིང་ཡོངས་སུ་དག་པ་དང༏་སངས་རྒྱས་ཀྱི་ཞིང་གི་ཆེ་བ་གྱུར་ཏེ་། ཉིད་དང་། སངས་རྒྱས་ཀྱི་ཞིང་ཐ་གྲུ་ཆེན་པོ་རྣམ་པ་དེ་ལྟ་བུ་དེ་གྱུར་ཏེ་། 
 bodhisattvacaryāṃ	།
 caran, aprameyāsaṃkhyeyācintyātulyāmāpyāparimāṇānabhilāpyāni p24 varṣakoṭīnayutāśatasahasrāṇi na jātu	ལོ་བྱེ་བ་ཁྲག་ཁྲིག་བརྒྱ་སྟོང་དཔག་ཏུ་མེད་། གྲངས་མེད་། བསམ་གྱིས་མི་ཁྱབ་། མཚུངས་པ་མེད་། གཞལ་དུ་མེད་། ཚད་མེད་།
 kāmavyāpādavihiṃsāvitarkā vitarkitavān,	བརྗོད་དུ་མེད་པར་ལན་འགའ་ཡང་འདོད་པ་དང་། གནོད་སེམས་དང་། རྣམ་པར་འཚེ་བའི་རྣམ་པར་རྟོག་པས་རྣམ་པར་རྟོག་པར་མ་གྱུར་།
 na jātu kāmavyāpāda- vihiṃsāsaṃjñā utpāditavān,	ལན་འགའ་ཡང་འདོད་པ་དང་། གནོད་སེམས་དང་། རྣམ་པར་འཚེ་བའི་འདུ་ཤེས་བསྐྱེད་པར་མ་གྱུར་།
 na jātu rūpaśabdagandharasa- spraṣṭavyasaṃjñā utpāditavān| sa daharo manohara eva surato 'bhūt ; sukhasaṃvāso, 'dhivāsanajātīyaḥ, subharaḥ, supoṣo, 'lpecchasaṃtuṣṭaḥ, pravivikto, 'duṣṭo, 'mūḍho, 'vaṅko, 'jihmo, 'śatho, 'māyāvī, sukhilo, madhuraḥ,	ལན་འགའ་ཡང་གཟུགས་དང་། སྒྲ་དང་། དྲི་དང་། རོ་དང་། རེག་བྱའི་འདུ་ཤེས་བསྐྱེད་པར་མ་གྱུར་ཏེ་།
 priyālāpo, nityābhiyuktaḥ śukladharmaparyeṣṭau ; anikṣiptadhuraḥ,	གཞོན་ནུ་དེས་ཤིང་འགྲོགས་ན་བདེ་བ་དང་། དང་དུ་ལེན་པའི་རང་བཞིན་ཅན་དང་། དགང་སླ་བ་དང་། གསོལ་བ་དང་། འདོད་པ་ཆུང་བ་དང་། ཆོག་ཤེས་པ་དང་། རབ་ཏུ་དབེན་པ་དང་། ཞེ་སྡང་མེད་པ་དང་། རྨོངས་པ་མེད་པ་དང་། དྲང་བ་དང་། མི་དམན་པ་དང་། ག-ཡོ་མེད་པ་དང་། སྒྱུ་མེད་པ་དང་། ངང་ཚུལ་བཟང་བ་དང་། མཉེན་པ་དང་། སྙན་པར་སྨྲ་བ་དང་། རྟག་ཏུ་བརྩོན་པ་དང་། དཀར་པོའི་ཆོས་ཡོངས་སུ་ཚོལ་བ་ལ་བརྩོན་པ་མི་འདོར་བར་གྱུར་ཏེ་།
 sarvasattvānām	སེམས་ཅན་ཐམས་ཅད་ཀྱི་དོན་དུ་༄༣༨༦ཨ་༌༎
 arthāya mahāpraṇidhānaṃ samudānītavān ; buddhadharma-	སྨོན་ལམ་ཆེན་པོ་ཡང་དག་པར་བསྒྲུབས་པར་གྱུར་ཏོ་༎
 saṃghācāryopādhyāyakalyāṇamitrasagauravo ; nityasaṃnaddho bodhisattvacaryāyām ; ārjavo, mārdavo, 'kuhako,	སངས་རྒྱས་དང་། ཆོས་དང་། དགེ་འདུན་དང་། སློབ་དཔོན་དང་། མཁན་པོ་དང་། དགེ་བའི་བཤེས་གཉེན་ལ་གུས་པ་དང་བཅས་ཤིང་བྱང་ཆུབ་སེམས་དཔའི་སྤྱོད་པ་ལ་རྟག་ཏུ་གོ་ཆ་བགོས་ཏེ་། 
 nilapako, guṇavān, pūrvaṃgamaḥ sarvasattvakuśaladharmasamādāpanatāyai ;	དྲང་བ་དང་། མཉེན་པ་དང་། ཚུལ་འཆོས་པ་མེད་པ་དང་། ཁ་གསག་མེད་པ་དང་། ཡོན་ཏན་དང་ལྡན་ཞིང་སེམས་ཅན་ཐམས་ཅད་དགེ་བའི་ཆོས་ཐམས་ཅད་ཡང་དག་པར་འཛིན་དུ་འཇུག་པའི་སྔོན་དུ་ནི་འགྲོ་།
 śūnyatānimittāpraṇihitānabhisaṃskārānutpādavihāravihārī ;	སྟོང་པ་ཉིད་དང་། མཚན་མ་མེད་པ་དང་། སྨོན་པ་མེད་པ་དང་། མངོན་པར་འདུ་བྱ་བ་མེད་པ་དང་། སྐྱེ་བ་མེད་པ་དང་། འགག་པ་མེད་པའི་གནས་པས་ནི་གནས་ཏེ་། ང་རྒྱལ་མེད་ཅིང་ངག་ལེགས་པར་བསྲུངས་པར་གྱུར་ཏོ་༎
 nirmāṇaḥ svārakṣitavākyaś cābhūt| bodhisattvacaryāṃ caran, sa yad vākkarmotsṛṣṭam, ātmaparobhayaṃ vyāvādhāya saṃvartate ;	བྱང་ཆུབ་སེམས་དཔའི་སྤྱད་པ་སྤྱོད་པ་ན་དེས་ངག་གི་ལས་འབྱུང་བ་གང་བདག་དང་གཞན་དང་གཉིས་ཀ་ལ་གནོད་པར་འགྱུར་བ་རྣམ་པ་དེ་ལྟ་བུ་སྤངས་ནས་།
 tathāvidhaṃ tyaktvā yad vākkarma svaparobhaye hitasukhasaṃvartakaṃ, tad evābhiprayuktavān|	ངག་གི་ལས་གང་བདག་དང་གཞན་དང་གཉིས་ཀ་ལ་ཕན་པར་འགྱུར་བ་དེ་ལ་བརྩོན་པར་གྱུར་ཏེ་། 
 evaṃ ca saṃprajāno 'bhūt| yad grāmanagara- nigamajanapadarāṣṭrarājadhānīṣv avataran, na jātu rūpaśabda- gandharasaspraṣṭavyadharmeṇa nīto 'bhūt| apratihataḥ sa	དེ་ལྟར་ཤེས་བཞིན་ཅན་དུ་གྱུར་ཅིང་གྲོང་དང་། གྲོང་ཁྱེར་དང་། གྲོང་བརྡལ་དང་། ཡུལ་འཁོར་དང་། རྒྱལ་པོའི་ཕོ་བྲང་འཁོར་རྣམས་སུ་འཇུག་པ་ན་ནམ་ཡང་གཟུགས་དང་། སྒྲ་དང་། དྲི་དང་། རོ་དང་། རེག་བྱ་དང་། ཆོས་ལ་རྗེས་སུ་ཆགས་པ་དང་། ཁོང་ཁྲོ་བ་མེད་པར་གྱུར་ཏོ་༎
 bodhisattvacaryāṃ caran, svayaṃ ca dānapāramitāyām acarat ;	དེ་བྱང་ཆུབ་སེམས་དཔའི་༄༣༨༦བ་སྤྱད་པ་སྤྱོད་པ་ན་བདག་ཉིད་ཀྱང་སྦྱིན་པའི་ཕ་རོལ་ཏུ་ཕྱིན་པ་ལ་སྤྱོད་ཅིང་།
 parāṃś ca tatraiva samādāpitavān| svayaṃ ca śīlakṣāntivīrya- dhyānaprajñāpāramitāsv acarat ;	གཞན་ཡང་དེ་ཉིད་ཡང་དག་པར་འཛིན་དུ་བཅུག་གོ་། བདག་ཉིད་ཀྱང་ཚུལ་ཁྲིམས་དང་། བཟོད་པ་དང་། བརྩོན་འགྲུས་དང༏་བསམ་གཏན་དང་། ཤེས་རབ་ཀྱི་ཕ་རོལ་ཏུ་ཕྱིན་པ་ལ་སྤྱོད་ཅིང་།
 parāṃś ca tatraiva samādāpitavān| tathārūpāṇi ca kuśalamūlāni samudānītavān| yaiḥ	གཞན་ཡང་དེ་ཉིད་ཡང་དག་པར་འཛིན་དུ་བཅུག་གོ་།
 samanvāgato yatra yatropapadyate, tatra tatrāsyānekāni nidhana- p25 koṭīnayutaśatasahasrāṇi dharaṇyāḥ prādurbhavanti|	གང་དག་དང་ལྡན་ན་གང་དང་གང་དུ་སྐྱེས་པ་དེ་དང་དེར་གཏེར་བྱེ་བ་ཁྲག་ཁྲིག་བརྒྱ་སྟོང་དུ་མས་ལས་འབྱུང་བར་འགྱུར་བ་རྣམ་པ་དེ་ལྟ་བུའི་དགེ་བའི་རྩ་བ་རྣམས་ཡང་དག་པར་བསྒྲུབས་པར་གྱུར་ཏོ་༎
 tena bodhisattvacaryāṃ caratā, tāvad aprameyāsaṃkhyeyāni sattvakoṭīniyutaśatasahasrāṇy anuttarāyāṃ samyaksaṃbodhau pratiṣṭhāpitāni, yeṣāṃ na sukaro vākkarmaṇā paryanto 'dhigantum ;	དེ་བྱང་ཆུབ་སེམས་དཔའི་སྤྱད་པ་སྤྱོད་པ་ན་སེམས་ཅན་བྱེ་བ་ཁྲག་ཁྲིག་བརྒྱ་སྟོང་གྲངས་མེད་དཔག་ཏུ་མེད་པ་གང་དག་ངག་གི་ལས་ཀྱིས་མཐར་ཕྱིན་པར་སླ་བ་མ་ཡིན་པ་དེ་སྙེད་བླ་ན་མེད་པ་ཡང་དག་པར་རྫོགས་པའི་བྱང་ཆུབ་ལ་བཀོད་དོ་༎
 tāvad aprameyāsaṃkhyeyā buddhā bhagavantaḥ satkṛtā gurukṛtā mānitāḥ pūjitāś,	སངས་རྒྱས་བཅོམ་ལྡན་འདས་གྲངས་མེད་དཔག་ཏུ་མེད་པ་དེ་སྙེད་ལ་།
 cīvarapiṇḍapāta- śayanāsanaglānapratyayabhaiṣajyapariṣkāraiḥ sarvasukhopadhānaiḥ sparśavihāraiś ca pratipāditāḥ ;	ན་བཟའ་དང་། ཞལ་ཟས་དང་། གཟིམས་ཆ་དང་། སྙུན་གྱི་གསོས་སྨན་དང་། ཡོ་བྱད་རྣམས་དང་། བདེ་བར་སྦྱར་བ་ལ་རེག་པར་གནས་པ་ཐམས་ཅད་ཀྱིས་བསྟི་སྟང་དུ་བྱས་། བླ་མར་བྱས་། རིམ་གྲོར་བྱས་། མཆོད་པར་བྱས་སོ་༎
 yāvantaḥ sattvāḥ śreṣṭhigṛhapatyāmātyakṣatriyabrāhmaṇamahāśālakuleṣu pratiṣṭhāpitās, teṣāṃ na sukaro vākkarmanirdeśena paryanto	སེམས་ཅན་ཇི་སྙེད་རབ་ཏུ་སྨིན་པར་བྱས་པ་དང་། ཚོང་དཔོན་དང་། ཁྱིམ་བདག་དང་། བློན་པོ་དང་། རྒྱལ་རིགས་དང་། བྲམ་ཟེའི་རིགས་ཤིང་སའ་ལ་ཆེན་པོ་ལྟ་བུ་དག་ལ་རབ་ཏུ་བཀོད་པ་དེ་དག་ཀྱང་ཚིག་གིས་བསྟན་པས་མཐར་ཕྱིན་པར་སླ་བ་མ་ཡིན་ནོ་༎ 
 'dhigantum ; evaṃ jāmbūdvīpeśvaratve pratiṣṭhāpitāś,	དེ་བཞིན་དུ་འཛམ་བུའི་གླིང་གི་དབང་༄༣༨༧ཨ་༌༎
 cakravartitve lokapālatve śakratve suyāmatve saṃtuṣitatve sunirmitatve vaśavartitve devarājatve mahābrāhmatve ca pratiṣṭhāpitāḥ ;	ཕྱུག་ཉིད་དང་། འཁོར་ལོས་བསྒྱུར་བ་ཉིད་དང་། འཇིག་རྟེན་སྐྱོང་བ་ཉིད་དང་། བརྒྱ་བྱིན་ཉིད་དང་། རབ་འཐབ་བྲལ་ཉིད་དང་། ཡོངས་སུ་དགའ་ལྡན་ཉིད་དང་། རབ་འཕྲུལ་དགའ་ཉིད་དང་། དབང་སྒྱུར་ཉིད་དང་། ལྷའི་རྒྱལ་པོ་ཉིད་དང་། ཚངས་པ་ཆེན་པོ་ཉིད་ལ་རབ་ཏུ་བཀོད་དོ་༎
 tāvad aprameyāsaṃkhyeyā buddhā bhagavantaḥ satkṛtā	སངས་རྒྱས་བཅོམ་ལྡན་འདས་གྲངས་མེད་དཔག་ཏུ་མེད་པ་དེ་སྙེད་ལ་བསྟི་སྟང་དུ་བྱས་།
 gurukṛtā mānitāḥ pūjitā,	བླ་མར་བྱས་། རིམ་གྲོར་བྱས་ཏེ་།
 dharmacakrapravartanārthaṃ cādhiṣṭhās, teṣāṃ na sukaro vākkarmanirdeśena paryanto 'dhi- gantum| sa evaṃrūpaṃ kuśalaṃ samudānīyaṃ,	མཆོད་ནས་ཆོས་ཀྱི་འཁོར་ལོ་རབ་ཏུ་བསྐོར་བར་བྱ་བའི་ཕྱིར་གསོལ་བ་བཏབ་པ་དེ་དག་ཀྱང་ངག་གི་ལས་ཀྱིས་བསྟན་པ་མཐར་ཕྱིན་པར་སླ་བ་མ་ཡིན་ནོ་༎
 yad asya bodhisattvacaryāś carato, 'prameyāsaṃkhyeyācintyātulyāmāpyāparimāṇānabhilāpyāni	དེ་བྱང་ཆུབ་སེམས་དཔའི་སྤྱད་པ་སྤྱོད་པ་ན་།
 kalpakoṭīnayutaśatasahasrāṇi surabhidivyātikrānta-	བསྐལ་པ་བྱེ་བ་ཁྲག་ཁྲིག་བརྒྱ་སྟོང་དཔག་ཏུ་མེད་། གྲངས་མེད་། བསམ་གྱིས་མི་ཁྱབ་། མཚུངས་པ་མེད་། གཞལ་དུ་མེད༏་ཚད་མེད་།
 candanagandho mukhāt pravāti sma ;	བརྗོད་དུ་མེད་པར་ཁ་ནས་ལྷའི་ལས་ཤིན་ཏུ་འདས་པའི་ཙན་དན་དྲི་རབ་ཏུ་ཞིམ་པའི་བསུང་འབྱུང་བ་དང་། 
 sarvaromakūpebhya utpalagandho vāti sma ; sarvalokābhirūpaś cābhūt,	སྤུའི་ཁུང་བུ་ཐམས་ཅད་ནས་མེ་ཏོག་ཨཽཏཔ་ལའི་བསུང་འབྱུང་བ་དང༏་འཇིག་རྟེན་ཐམས་ཅད་ན་གཟུགས་བཟང་ཞིང་མཛེས་ལ་བལྟ་ན་འབྱུང་བ་དང་། 
 prāsādiko, darśanīyaḥ, paramaśubhavarṇapuṣkalatayā samanvāgataḥ| lakṣaṇānuvyañjanasamalaṃkṛtenātmabhāvena tasya sarvaratnālaṃkārāḥ, sarvavastracīvarābhinirhārāḥ, sarvapuṣpa-	སྡུག་པ་དང་། 
 dhūpagandhamālyavilepanacchatradhvajapatākābhinirhārāḥ, p26 sarvavādyasaṃgītyabhinirhārāś ca sarvaromakūpebhyaḥ pāṇitalābhyāṃ ca niścaranti sma| sarvānnapānakhādyabhojyalehya- rasābhinirhārāḥ sarvopabhogaparibhogābhinirhārāś ca pāṇitalābhyāṃ	ཁ་དོག་བཟང་པོ་རྒྱས་པ་མཆོག་དང་ལྡན་པ་དང་། མཚན་དང་དཔེ་བྱད་བཟང་པོས་ལུས་ལེགས་པར་བརྒྱན་པ་དང་། དེའི་རིན་པོ་ཆེའི་རྒྱན་ཐམས་ཅད་དང་། གོས་དང་ཆོས་གོས་མངོན་པར་བསྒྲུབ་པ་ཐམས་ཅད་དང་། མེ་ཏོག་དང་། སྤོས་དང་། བདུག་པ་དང་། ཕྲེང་བ་དང་། བྱུག་པ་དང་། ༄༣༨༧བ་གདུགས་དང་། རྒྱལ་མཚན་དང་། བ་དན་མངོན་པར་བསྒྲུབ་པ་ཐམས་ཅད་དང་། རོལ་མོའི་དབྱངས་སྒྲ་དང་གླུ་དབྱངས་མངོན་པར་བསྒྲུབ་པ་ཐམས་ཅད་ཀྱང་སྤུའི་ཁུང་བུ་ཐམས་ཅད་དང་། ལག་པ་གཉིས་ནས་འབྱུང་བ་དང་། ཟས་དང་། སྐོམ་དང་། བཟའ་བ་དང་། བཅའ་བ་དང་། བལྡག་པ་དང་། རོ་བྲོ་བ་མངོན་པར་བསྒྲུབ་པ་ཐམས་ཅད་དང་ལོངས་སྤྱོད་དང་ཡོངས་སུ་སྤྱད་པ་མངོན་པར་བསྒྲུབ་པ་ཐམས་ཅད་ཀྱང་ལག་པ་གཉིས་ནས་ཟག་ཅིང་འབྱུང་བར་འགྱུར་བ་རྣམ་པ་དེ་ལྟ་བུའི་དགེ་བ་ཡང་དག་པར་བསྒྲུབས་སོ་༎
 prasyandantaḥ prādurbhavanti| iti hi sarva-	ཀུན་དགའ་བོ་།
 pariṣkāravaśitāpāramiprāptaḥ sa ānanda dharmākaro bhikṣur abhūt, pūrvaṃ bodhicaryāś caran|	དེ་ལྟར་དགེ་སློང་ཆོས་ཀྱི་འབྱུང་གནས་དེ་སྔོན་བྱང་ཆུབ་སེམས་དཔའི་སྤྱད་པ་སྤྱོད་པ་ན་། ཡོ་བྱད་ཐམས་ཅད་ལ་དབང་བའི་ཕ་རོལ་ཏུ་ཕྱིན་པར་གྱུར་ཏོ་༎
 evam ukte, āyuṣmān ānando bhagavantam etad avocat :	དེ་སྐད་ཅེས་བཀའ་སྩལ་པ་དང་། བཅོམ་ལྡན་འདས་ལ་ཚེ་དང་ལྡན་པ་ཀུན་དགའ་བོས་འདི་སྐད་ཅེས་གསོལ་ཏོ་༎ བཅོམ་ལྡན་འདས་། ཅི་ལགས་།
 kiṃ punar bhagavan sa dharmākaro bodhisattvo mahāsattvo 'nuttarāṃ samyaksaṃbodhim abhisaṃbudhyātītaḥ parinirvṛta,	བྱང་ཆུབ་སེམས་དཔའ་སེམས་དཔའ་ཆེན་པོ་ཆོས་ཀྱི་འབྱུང་གནས་དེ་བླ་ན་མེད་པ་ཡང་དག་པར་རྫོགས་པའི་བྱང་ཆུབ་མངོན་པར་རྫོགས་པར་སངས་རྒྱས་ཏེ་། ཡོངས་སུ་མྱ་ངན་ལས་འདས་ལགས་སམ་།
 utāho 'nabhisaṃbuddho,	འོན་ཏེ་མངོན་པར་རྫོགས་པར་སངས་རྒྱས་མ་རྒྱས་སམ་།
 'tha pratyutpanno 'bhisaṃbuddha,	འོན་ཏེ་དེ་ལྟར་བྱུང་བ་ན་མངོན་པར་རྫོགས་པར་སངས་རྒྱས་ཏེ་།
 etarhi tiṣṭhati dhriyate yāpayati, dharmaṃ ca deśayati| bhagavān	ད་ལྟ་ན་བཞུགས་ལ་འཚོ་ཞིང་གཞེས་ཏེ་ཆོས་ཀྱང་སྟོན་། བཅོམ་ལྡན་འདས་ཀྱིས་བཀའ་སྩལ་པ་།
 āha : na khalu punar ānanda sa tathāgato 'tīto, nānāgataḥ|	ཀུན་དགའ་བོ་། དེ་བཞིན་གཤེགས་པ་དེ་ནི་འདས་པ་ཡང་མ་ཡིན་། མ་འོངས་པ་༄༣༨༨ཨ་༌༎ ཡང་མ་ཡིན་གྱི་།
 api tv eṣa sa tathāgato 'nuttarāṃ samyaksaṃbodhim abhisaṃbuddha, etarhi tiṣṭhati dhriyate yāpayati, dharmaṃ	དེ་བཞིན་གཤེགས་པ་དེ་བླ་ན་མེད་པ་ཡང་དག་པར་རྫོགས་པའི་བྱང་ཆུབ་མངོན་པར་རྫོགས་པར་སངས་རྒྱས་ནས་ད་ལྟར་ན་བཞུགས་ཏེ་འཚོ་ཞིང་གཞེས་ལ་ཆོས་ཀྱང་སྟོན་ཏེ་།
 ca deśayati| paścimāyāṃ diśītaḥ koṭīnayutaśatasahasratame buddhakṣetre sukhāvatyāṃ lokadhātāv amitābho nāma tathāgato 'rhan samyaksaṃbuddho,	འདི་ནས་ནུབ་ཕྱོགས་སུ་སངས་རྒྱས་ཀྱི་ཞིང་བྱེ་བ་ཁྲག་ཁྲིག་བརྒྱ་སྟོང་ན་འཇིག་རྟེན་གྱི་ཁམས་བདེ་བ་ཅན་ན་དེ་བཞིན་གཤེགས་པ་དགྲ་བཅོམ་པ་ཡང་དག་པར་རྫོགས་པའི་སངས་རྒྱས་འོད་དཔག་མེད་ཅེས་བྱ་སྟེ་།
 'parimāṇair bodhisattvaiḥ parivṛtaḥ puraskṛto, 'nantaiḥ śrāvakair anantyā buddhakṣetra-	བྱང་ཆུབ་སེམས་དཔའ་སེམས་དཔའ་ཆེན་པོ་ཚད་མེད་པ་དག་དང་། ཉན་ཐོས་མཐའ་ཡས་པ་དག་གིས་ཡོངས་སུ་བསྐོར་ཞིང་མདུན་དུ་བདར་ཏེ་། སངས་རྒྱས་ཀྱི་ཞིང་ཕུན་སུམ་ཚོགས་པ་མཐའ་ཡས་པ་དང་ལྡན་ནོ་༎
 saṃpadā samanvāgataḥ| amitā cāsya prabhā, yasyā na sukaraṃ prāmāṇaṃ paryanto vādhigantum ; iyanti buddhakṣetrāṇi, iyanti buddhakṣetraśatāni, iyanti buddhakṣetrasahasrāṇi, iyanti buddhakṣetraśatasahasrāṇi, iyanti buddhakṣetrakoṭī, iyanti buddhakṣetrakoṭīśatāni, iyanti buddhakṣetra- koṭīsahasrāṇi,	དེའི་འོད་ནི་དཔག་ཏུ་མེད་དེ་།
 iyanti buddhakṣetrakoṭīśatasahasrāṇi, iyanti buddhakṣetra- koṭīnayutaśatasahasrāni sphuritvā tiṣṭhantīti| api tv p27 khalv ānanda saṃkṣiptena pūrvasyāṃ diśi gaṅgānadīvālikāsamāni buddhakṣetrakoṭīnayutaśatasahasrāṇi tayā tasya bhagavato 'mitābhasya tathāgatasya prabhayā sadā sphuṭāni| evaṃ dakṣiṇapaścimottarāsu dikṣv adha ūrdhvam anuvidikṣv	དེ་ནི་སངས་རྒྱས་ཀྱི་ཞིང་འདི་སྙེད་ཅིག་དང་། སངས་རྒྱས་ཀྱི་ཞིང་བརྒྱ་ཕྲག་འདི་སྙེད་ཅིག་དང་། སངས་རྒྱས་ཀྱི་ཞིང་སྟོང་ཕྲག་འདི་སྙེད་ཅིག་དང་། སངས་རྒྱས་ཀྱི་ཞིང་བརྒྱ་སྟོང་ཕྲག་འདི་སྙེད་ཅིག་དང་། སངས་རྒྱས་ཀྱི་ཞིང་བྱེ་བ་ཕྲག་འདི་སྙེད་ཅིག་དང་། སངས་རྒྱས་ཀྱི་ཞིང་བྱེ་བ་བརྒྱ་ཕྲག་འདི་སྙེད་ཅིག་དང་། སངས་རྒྱས་ཀྱི་ཞིང་བྱེ་བ་སྟོང་ཕྲག་འདི་སྙེད་ཅིག་དང་། སངས་རྒྱས་ཀྱི་ཞིང་བྱེ་བ་བརྒྱ་སྟོང་ཕྲག་འདི་སྙེད་ཅིག་དང་། སངས་རྒྱས་ཀྱི་ཞིང་བྱེ་བ་ཁྲག་ཁྲིག་བརྒྱ་སྟོང་ཕྲག་འདི་སྙེད་ཅིག་ཁྱབ་པར་བྱས་ཏེ་འདུག་གོ་ཞེས་མཐའི་ཚད་རྟོགས་པར་སླ་བ་མ་ཡིན་ནོ་༎ ཀུན་དགའ་བོ་།
 ekaikasyāṃ diśi samantād gaṅgānadīvālikāsamāni buddhakṣetra- koṭīnayutaśatasahasrāṇi tasya bhagavato 'mitābhasya tathāgatasya tayā prabhayā sadā sphuṭāni, sthāpayitvā	འོན་ཀྱང་མདོར་བསྟན་ན་ཤར་ཕྱོགས་སུ་སངས་༄༣༨༨བ་རྒྱས་ཀྱི་ཞིང་བྱེ་བ་ཁྲག་ཁྲིག་བརྒྱ་སྟོང་ཕྲག་གངགའའི་ཀླུང་གི་བྱེ་མ་སྙེད་དག་བཅོམ་ལྡན་འདས་འོད་དཔག་མེད་དེའི་འོད་ཀྱིས་རྟག་ཏུ་ཁྱབ་བོ་༎ དེ་བཞིན་དུ་ལྷོ་དང་། ནུབ་དང་། བྱང་དང་། འོག་དང་། སྟེང་དང་། ཕྱོགས་མཚམས་ཀྱི་ཕྱོགས་རེ་རེ་ཡང་སངས་རྒྱས་ཀྱི་ཞིང་བྱེ་བ་ཁྲག་ཁྲིག་བརྒྱ་སྟོང་ཕྲག་གངགའའི་ཀླུང་གི་བྱེ་མ་སྙེད་དག་བཅོམ་ལྡན་འདས་དེ་བཞིན་གཤེགས་པ་འོད་དཔག་མེད་དེའི་འོད་ཀྱིས་རྟག་ཏུ་ཁྱབ་སྟེ་། 
 buddhān bhagavataḥ pūrvapraṇidhānādhiṣṭhānena ye vyoma- prabhayaikadvitricatuḥpañcadaśaviṃśatitriṃśaccatvāriṃśadyojana- prabhayā, yojanaśataprabhayā, yojanasahasraprabhayā, yojana- śatasahasraprabhayā, yāvad anekayojanakoṭīnayutaśatasahasra- prabhayā, yāval lokaṃ spharitvā tiṣṭhanti|	སངས་རྒྱས་བཅོམ་ལྡན་འདས་རྣམས་ཀྱི་སྔོན་གྱི་སྨོན་ལམ་གྱི་བྱིན་གྱི་རླབས་ཀྱིས་འོད་འདོམ་གང་བ་དང་། འདོམ་དོ་པ་དང་། གསུམ་པ་དང་། བཞི་པ་དང་། ལྔ་པ་དང་། བཅུ་པ་དང་། ཉི་ཤུ་པ་དང་། སུམ་ཅུ་པ་དང་། བཞི་བཅུ་པ་དང་། ལྔ་བཅུ་པ་དང་། འོད་དཔག་ཚད་བཅུ་པ་དང་། འོད་དཔག་ཚད་བརྒྱ་པ་དང་། འོད་དཔག་ཚད་སྟོང་པ་དང་། འོད་དཔག་ཚད་བརྒྱ་སྟོང་པ་ནས་འོད་དཔག་ཚད་བྱེ་བ་ཁྲག་ཁྲིག་བརྒྱ་སྟོང་ཕྲག་དུ་མའི་འོད་ཀྱིས་འཇིག་རྟེན་གྱི་ཁམས་ཀྱི་བར་དུ་ཁྱབ་པར་གྱུར་ཏེ་། གནས་པ་ནི་མ་གཏོགས་སོ་༎ ཀུན་དགའ་བོ་།
 nāsty ānandopamopanyāso, yena śakyaṃ tasyāmitābhasya tathāgatasya prabhayāḥ pramāṇam udgṛhitum| tad anenānanda	དཔེ་གང་གིས་བཅོམ་ལྡན་འདས་དེ་བཞིན་གཤེགས་པ་འོད་དཔག་མེད་དེའི་འོད་ཀྱི་ཚད་གཟུང་བའི་དཔེ་གཞག་པ་མེད་དེ་།
 paryāyeṇa sa tathāgato 'mitābha ity ucyate ; amitaprabho,	ཀུན་དགའ་བོ་། རྣམ་གྲངས་དེས་ན་དེ་བཞིན་གཤེགས་པ་དེ་འོད་དཔག་མེད་ཅེས་བྱ་སྟེ་།
 'mitaprabhāso, 'samāptaprabho, 'saṇgaprabho, 'pratihataprabho, nityotsṛṣṭaprabho,	འོད་དཔག་ཏུ་མེད་པ་དང་། སྣང་བ་དཔག་ཏུ་མེད་པ་དང་། འོད་ཐུག་པ་མེད་པ་དང་། འོད་ཆགས་པ་མེད་པ་དང་། འོད་ཐོགས་པ་མེད་པ་དང་། འོད་རྟག་ཏུ་གཏོང་བ་དང་། ལྷའི་༄༣༨༩ཨ་༌༎
 divyamaṇiprabho, 'pratihata- raśmirājaprabho, rañjanīyaprabhaḥ, premaṇīyaprabhaḥ, prāmodanīya- prabhaḥ, prahlādanīyaprabha, ullokanīyaprabho, nibandhanīya- prabho, 'cintyaprabho, 'tulyaprabho, 'bhibhūyanarendrāsurendra- prabho, 'bhibhūyacandrasūryajihmīkaraṇaprabho, 'bhibhūyalokapālaśakrabrahmaśuddhāvāsamaheśvarasarvadeva-	ནོར་བུའི་འོད་དང་། ཐོགས་པ་མེད་པའི་འོད་ཟེར་གྱི་རྒྱལ་པོའི་འོད་དང་། ཆགས་པར་འགྱུར་བའི་འོད་དང་། དགའ་བར་འགྱུར་བའི་འོད་དང་། མཆོག་ཏུ་དགའ་བར་འགྱུར་བའི་འོད་དང་། ཚིམ་པར་འགྱུར་བའི་འོད་དང་། ལྟ་བར་འགྱུར་བའི་འོད་དང་། འབྲེལ་བར་འགྱུར་བའི་འོད་དང་། བསམ་གྱིས་མི་ཁྱབ་པའི་འོད་དང་། མཚུངས་པ་མེད་པའི་འོད་དང་། མིའི་དབང་པོ་དང་། ལྷའི་དབང་པོ་ཟིལ་གྱིས་གནོན་པའི་འོད་དང་། ཉི་མ་དང་ཟླ་བ་ཟིལ་གྱིས་གནོན་ཞིང་མོག་མོག་པོར་བྱེད་པའི་འོད་དང་། འཇིག་རྟེན་སྐྱོང་བ་དང་། བརྒྱ་བྱིན་དང༏་ཚངས་པ་དང་། གནས་གཙང་མ་དང་། དབང་ཕྱུག་ཆེན་པོ་དང་། ལྷ་ཐམས་ཅད་ཟིལ་གྱིས་གནོན་ཅིང་མོག་མོག་པོར་བྱེད་པའི་འོད་དང་། མདོར་བསྡུ་ན་འོད་ཐམས་ཅད་ཀྱི་ཕ་རོལ་ཏུ་ཕྱིན་པ་ཞེས་བྱའོ་༎
 jihmīkaraṇaprabhaḥ, sarvaprabhāpāragata ity ucyate| sā cāsya prabhā vimalā, vipulā,	དེའི་འོད་དེ་ནི་དྲི་མ་མེད་པ་ཤིན་ཏུ་རྒྱས་པ་ལུས་ལ་བདེ་བ་སྐྱེད་པ་།
 kāyasukhasaṃjananī,	སེམས་དགའ་བར་བྱེད་པ་།
 cittaudbilyakaraṇī, devāsuranāgayakṣagandharvagaruḍamahoraga- kinnaramanuṣyāmanuṣyāṇāṃ prītiprāmodyasukhakaraṇī,	ལྷ་དང་། ལྷ་མ་ཡིན་དང་། ཀླུ་དང་། གནོད་སྦྱིན་དང་། དྲི་ཟ་དང་། ནམ་མཁའ་ལྡིང་དང་། ལྟོ་འཕྱེ་ཆེན་པོ་དང་། མི་འམ་ཅི་དང་། མི་དང་། མི་མ་ཡིན་པ་རྣམས་ལ་དགའ་བ་དང་། མཆོག་ཏུ་དགའ་བ་དང་། བདེ་བ་བསྐྱེད་པ་།
 kuśalāśayānāṃ kalyalaghugativicakṣaṇabuddhiprāmodyakaraṇy p28	སེམས་ཅན་དགེ་བའི་བསམ་པ་ཅན་རྣམས་ལ་དགེ་བ་དང་། ཡང་བ་དང་། རྟོགས་པ་དང་། མཁས་པ་དང་། བློ་དང་། མཆོག་ཏུ་དགའ་བ་བྱེད་པའོ་༎ ཀུན་དགའ་བོ་།
 anyeṣv api anantāparyanteṣu buddhakṣetreṣu| anena cānanda paryāyeṇa tathāgataḥ paripūrṇaṃ kalpaṃ	རྣམ་གྲངས་འདིས་སངས་རྒྱས་ཀྱི་ཞིང་གཞན་མཐའ་ཡས་མུ་༄༣༨༩བ་མེད་པ་དག་དེ་བཞིན་གཤེགས་པས་ཡོངས་སུ་གང་སྟེ་། 
 bhāṣeta, tasyāmitābhasya tathāgatasya nāmakarmopādāya prabhām	བསྐལ་པར་དེ་བཞིན་གཤེགས་པ་འོད་དཔག་མེད་དེའི་མཚན་གྱི་ལས་རྒྱུར་བྱས་པ་སུ་གང་སྟེ་། དང་། འོད་ཕུན་སུམ་ཚོགས་པ་ལས་བརྩམས་ཏེ་བརྗོད་ཀྱང་མཚན་བསྟན་པ་དང་སུ་གང་སྟེ་། དང་། ། འོད་ཕུན་སུམ་ཚོགས་པའི་ཡོན་ཏན་གྱི་མཐའ་ཡང་རྟོགས་པར་མི་སུ་གང་སྟེ་། དང་། 
 ārabhya, na ca śakto guṇaparyanto 'dhigantuṃ tasyāḥ prabhāyāḥ|	། ནུས་ལ་།
 na ca tathāgatasya vaiśāradyopacchedo bhavet| tat	དེ་བཞིན་གཤེགས་པའི་མི་འཇིགས་པ་ཡང་རྒྱུན་ཆད་པར་མི་འགྱུར་རོ་༎
 kasya hetoḥ| ubhayam apy etad ānandāprameyam asaṃkhyeyam	དེ་ཅིའི་ཕྱིར་ཞེ་ན་། ཀུན་དགའ་བོ་། འདི་ལྟ་སྟེ་།
 acintyāparyantam, yad idaṃ tasya bhagavato prabhāguṇavibhūtis tathāgatasya cānuttaraṃ prajñāpratibhānam|	བཅོམ་ལྡན་འདས་འོད་དཔག་མེད་དེའི་འོད་ཀྱི་ཡོན་ཏན་འབྱོར་པ་དང་། དེ་བཞིན་གཤེགས་པའི་ཤེས་རབ་དང་། སྤོབས་པ་བླ་ན་མེད་པ་དང་། དེ་གཉིས་ཀ་ཡང་གྲངས་མེད་དཔག་ཏུ་མེད་ཅིང་བསམ་གྱིས་མི་ཁྱབ་ལ་མུ་མེད་པའི་ཕྱིར་རོ་༎ ཀུན་དགའ་བོ་།
 tasya khalu punar ānandāmitābhasya tathāgatasyāprameyaḥ śrāvakasaṃgho, yasya na sukaraṃ pramāṇam udgṛhītum ;	དེ་བཞིན་གཤེགས་པ་འོད་དཔག་མེད་དེའི་ཉན་ཐོས་ཀྱི་དགེ་འདུན་དཔག་ཏུ་མེད་དེ༏་ཉན་ཐོས་བྱེ་བ་ཕྲག་འདི་སྙེད་ཅིག་ཅེའམ་།
 iyatyaḥ śrāvakakoṭya, iyanti śrāvakakoṭīśatāni,	ཉན་ཐོས་བྱེ་བ་བརྒྱ་ཕྲག་འདི་སྙེད་ཅིག་ཅེའམ་།
 iyanti śrāvaka- koṭīsahasrāṇi,	ཉན་ཐོས་བྱེ་བ་སྟོང་ཕྲག་འདི་སྙེད་ཅིག་ཅེའམ་།
 iyanti śrāvakakoṭīśatasahasrāṇi,	ཉན་ཐོས་བྱེ་བ་བརྒྱ་སྟོང་ཕྲག་འདི་སྙེད་ཅིག་ཅེའམ་།
 iyanti kaṅkarāṇi,	གཏམས་ཕྲག་འདི་སྙེད་ཅིག་ཅེའམ་།
 iyanti biṃbarāṇi,	དཀྲིགས་ཕྲག་འདི་སྙེད་ཅིག་ཅེའམ་།
 iyanti nayutāni,	ཁྲག་ཁྲིག་ཕྲག་འདི་སྙེད་ཅིག་ཅེའམ་།
 iyanty ayutāni,	ཐེར་འབུམ་ཕྲག་འདི་སྙེད་ཅིག་ཅེའམ་།
 iyanti akṣobhyāṇi,	མི་འཁྲུགས་པ་ཕྲག་འདི་སྙེད་ཅིག་ཅེའམ་།
 iyantyo vivāhā,	རྣམ་འདེག་ཕྲག་འདི་སྙེད་ཅིག་ཅེའམ་།
 iyanti śrotāṃsi, iyantyo	རྒྱུན་འབབ་ཕྲག་འདི་སྙེད་ཅིག་ཅེའམ་། རྒྱལ་བ་ཕྲག་འདི་སྙེད་ཅིག་ཅེའམ་།
 jāyā, iyanty aprameṇeyāṇi,	དཔག་ཏུ་མེད་པ་ཕྲག་འདི་སྙེད་ཅིག་ཅེའམ་།
 iyanty asaṃkhyeyāni, iyanty	༄༣༩༠ཨ་༌༎ གྲངས་མེད་པ་ཕྲག་འདི་སྙེད་ཅིག་ཅེའམ་།
 agaṇyāni, iyanty atulyāṇi,	བགྲང་དུ་མེད་པ་ཕྲག་འདི་སྙེད་ཅིག་ཅེའམ་།
 iyanty acintyānīti|	མཚུངས་པ་མེད་པ་ཕྲག་འདི་སྙེད་ཅིག་ཅེའམ་། བསམ་གྱིས་མི་ཁྱབ་པ་ཕྲག་འདི་སྙེད་ཅིག་ཅེས་དེའི་ཚད་གཟུང་བར་སླ་བ་མ་ཡིན་ནོ་༎ ཀུན་དགའ་བོ་། འདི་ལྟ་སྟེ་།
 tad yathānanda maudgalyāyano bhikṣur ṛddhivaśitāprāptaḥ	དཔེར་ན་།
 sa ākāṃkṣan trisāhasramahāsāhasralokadhātau yāvanti tārārūpāṇi tāni sarvāṇy ekarātriṃ divena gaṇayed, evaṃrūpānāṃ	དགེ་སློང་མོའུ་དགལ་གྱི་བུ་ཆེན་པོའི་རྫུ་འཕྲུལ་ལ་དབང་ཐོབ་པ་དེ་འདོད་ན་སྟོང་གསུམ་གྱི་སྟོང་ཆེན་པོའི་འཇིག་རྟེན་གྱི་ཁམས་ན་སྐར་མའི་གཟུགས་ཇི་སྙེད་ཡོད་པ་དེ་དག་ཐམས་ཅད་ཉིན་ཞག་གཅིག་གིས་བགྲང་པ་དེ་ལྟ་བུའི་རྣམ་པའི་རྫུ་འཕྲུལ་དང་ལྡན་པ་བྱེ་བ་ཁྲག་ཁྲིག་བརྒྱ་སྟོང་ཡོད་པར་གྱུར་ལ་།
 ca rddhimatāṃ koṭīnayutaśatasahasraṃ bhavet, te varṣakoṭī- nayutaśatasahasram ananyakarmaṇo 'mitābhasya tathāgatasya prathamaṃ śrāvakasannipātaṃ gaṇayeyus, tair gaṇayadbhiḥ śatatamo 'pi bhāgo na gaṇito bhavet ; sahasratamo	དེ་དག་ལས་གཞན་མི་བྱེད་པར་ལོ་བྱེ་བ་ཁྲག་ཁྲིག་བརྒྱ་སྟོང་དུ་དེ་བཞིན་གཤེགས་པ་འོད་དཔག་མེད་ཀྱི་ཉན་ཐོས་དང་པོ་འདུས་པ་བགྲངས་ཀྱང་དེ་དག་གིས་བརྒྱའི་ཆར་ཡང་བགྲངས་པར་མི་འགྱུར་ཏེ་། 
 'pi, śatasahasratamo 'pi, yāvat kalām apy, upamām apy, upaniśām	སྟོང་དང་། བརྒྱ་སྟོང་དང་། ཆ་དང་། དཔེ་དང་། རྒྱུའི་བར་དུ་ཡང་བགྲངས་པར་མི་འགྱུར་རོ་༎
 api, na gaṇito bhavet|	ཀུན་དགའ་བོ་།
 tad yathānanda mahāsamudrāc caturaśītiyojanasahasrāṇy	འདི་ལྟ་སྟེ་། དཔེར་ན་། རྒྱ་མཚོ་ཆེན་པོ་ཟབས་སུ་དཔག་ཚད་བརྒྱད་ཁྲི་བཞི་སྟོང་ཡོད་པ་།
 āvedhena tiryag aprameyāt, kaścid eva puruṣaḥ śatadhābhinnayā p29 vālāgrakoṭyaikam udakabindum abhyutkṣipet, tat kiṃ	ཁྱོན་དཔག་ཏུ་མེད་པ་ལ་མི་ལ་ལ་ཞིག་གིས་སྐྲ་ཚལ་པ་བརྒྱར་བཤགས་པའི་རྩེ་མོས་ཆུ་ཐིགས་པ་གཅིག་བླངས་ན་།
 manyase, ānanda, katamo bahutaro, yo vā śatadhābhinnayā	ཀུན་དགའ་བོ་། འདི་ཇི་སྙམ་དུ་སེམས་།
 vālāgrakoṭyābhyutkṣipta eka udakabindur, yo vā mahāsamudre 'pskandho 'vaśiṣṭa iti| āha :	གང་སྐྲ་ཚལ་པ་བརྒྱར་བཤགས་པའི་རྩེ་མོས་ཆུའི་ཐིགས་པ་གཅིག་བླངས་པ་དང་། གང་རྒྱ་མཚོ་ཆེན་པོའི་ཆུའི་ཕུང་པོ་ཕྱི་ན་ལས་པ་དེ་༄༣༩༠བ་གཉིས་གང་མང་། གསོལ་པ་། བཅོམ་ལྡན་འདས་།
 yojanasahasram api tāvad	དཔག་ཚད་སྟོང་ཡང་རྒྱ་མཚོ་ཆེན་པོ་བས་ཉུང་ལགས་ན་།
 bhagavan mahāsamudrasya parīttaṃ bhavet| kim aṅga punar, yaḥ śatadhābhinnayā vālāgrakoṭyābhyutkṣipta eka udakabinduḥ|	སྐྲ་ཚལ་པ་བརྒྱར་བཤགས་པའི་རྩེ་མོས་ཆབ་ཐིགས་པ་གཅིག་བླངས་པ་ལྟ་སྨོས་ཀྱང་ཅི་འཚལ་།
 bhagavān āha :	བཅོམ་ལྡན་འདས་ཀྱིས་བཀའ་སྩལ་པ་། ཀུན་དགའ་བོ་།
 tad yathā sa eka udakabindur ;	ཆུའི་ཐིགས་པ་གཅིག་ལྟ་བུར་ནི་།
 iyantaḥ sa prathamasannipāto 'bhūt, tair maudgalyāyanasadṛśair bhikṣubhir gaṇayadbhis tena varṣakoṭīnayutaśatasahasreṇa gaṇitaṃ bhaved,	བཅོམ་ལྡན་འདས་དེ་བཞིན་གཤེགས་པ་འོད་དཔག་མེད་ཀྱི་ཉན་ཐོས་དང་པོར་འདུས་པ་ལ་མོའུ་དགལ་གྱི་བུ་འདི་ལྟ་བུའི་དགེ་སློང་རྣམས་ཀྱིས་ལོ་བྱེ་བ་ཁྲག་ཁྲིག་བརྒྱ་སྟོང་དུ་བགྲངས་ཏེ་འདི་སྙེད་གཅིག་གོ་ཞེས་གྲངས་ཀྱིས་ཆོད་པ་ལྟ་བུ་ཡིན་ནོ་༎ 
 yathā mahāsamudre 'pskandho 'vaśiṣṭa,	རྒྱ་མཚོ་ཆེན་པོའི་ཆུའི་ཕུང་པོ་ཕྱི་ན་ལས་པ་ལྟ་བུ་ནི་གྲངས་ཀྱིས་མ་ཆོད་པ་ལྟ་བུ་ཡིན་ན་།
 evam agaṇitaṃ draṣṭavyam| kaḥ punar vādo dvitīyatṛtīyādīnāṃ	ཉན་ཐོས་འདུས་པ་གཉིས་པ་དང་། གསུམ་པ་རྣམས་ལྟ་སྨོས་ཀྱང་ཅི་དགོས་ཏེ་།
 śrāvakasannipātādīnām| evam anantāparyantas tasya bhagavataḥ śrāvakasaṃgho,	བཅོམ་ལྡན་འདས་དེའི་ཉན་ཐོས་ཀྱི་དགེ་འདུན་ནི་དེ་ལྟར་མཐའ་ཡས་མུ་མེད་དེ་།
 yo 'prameyāsaṃkhyeya ity	དེ་ནི་དཔག་ཏུ་མེད་དོ་༎ ཞེས་བྱ་བའི་གྲངས་སུ་འགྲོ་བ་ཡིན་ནོ་༎ ཀུན་དགའ་བོ་།
 eva saṃkhyāṃ gacchanti| aparimitaṃ cānanda tasya bhagavato 'mitābhasya tathāgatasyāyuṣpramāṇaṃ, yasya na sukaraṃ pramāṇam adhigantum ;	བཅོམ་ལྡན་འདས་དེ་བཞིན་གཤེགས་པ་འོད་དཔག་མེད་དེའི་ཚེའི་ཚད་ཀྱང་དཔག་ཏུ་མེད་དེ་།
 iyanti vā kalpā,	བསྐལ་པ་འདི་སྙེད་ཅིག་ཅེའམ་།
 iyanti vā kalpaśatāni,	བསྐལ་པ་བརྒྱ་ཕྲག་འདི་སྙེད་ཅིག་ཅེའམ་།
 iyanti vā kalpasahasrāṇi,	བསྐལ་པ་སྟོང་ཕྲག་འདི་སྙེད་ཅིག་ཅེའམ་།
 iyanti vā kalpaśatasahasrāṇi,	བསྐལ་པ་བརྒྱ་སྟོང་ཕྲག་འདི་སྙེད་ཅིག་ཅེའམ་།
 iyatyo vā kalpakoṭya, iyanti vā kalpakoṭīśatāni,	བསྐལ་པ་བྱེ་བ་ཁྲག་འདི་སྙེད་ཅིག་ཅེའམ་།
 iyanti vā kalpakoṭīsahasrāṇi,	བསྐལ་དབྱེ་བ་བརྒྱ་ཕྲག་འདི་སྙེད་ཅིག་ཅེའམ་།
 iyanti vā kalpakoṭī- śatasahasrāṇi,	བསྐལ་པ་བྱེ་བ་སྟོང་ཕྲག་འདི་སྙེད་ཅིག་ཅེའམ་།
 iyanti vā kalpakoṭīnayutaśatasahasrāṇīti|	བསྐལ་པ་བྱེ་བ་བརྒྱ་སྟོང་ཕྲག་འདི་སྙེད་ཅིག་ཅེས་བྱ་༄༣༩༡ཨ་༌༎ བ་ནས་བསྐལ་པ་བྱེ་བ་ཁྲག་ཁྲིག་བརྒྱ་སྟོང་ཕྲག་འདི་སྙེད་ཅིག་གོ་ཞེས་བྱ་བའི་བར་དུ་ཚེའི་ཚད་རྟོགས་པར་སླ་བ་མ་ཡིན་ནོ་༎ ཀུན་དགའ་བོ་།
 atha tarhy ānandāparimitam eva tasya bhagavata āyuṣpramāṇam aparyantam| tena sa tathāgato 'mitāyur ity ucyate|	བཅོམ་ལྡན་འདས་དེ་བཞིན་གཤེགས་པ་འོད་དཔག་མེད་དེའི་སྐུ་ཚེའི་ཚད་དེ་ལྟར་དཔག་ཏུ་མེད་དེ་། དེའི་ཕྱིར་དེ་བཞིན་གཤེགས་པ་དེ་ཚེ་དཔག་མེད་ཅེས་བྱའོ་༎ ཀུན་དགའ་བོ་། བཅོམ་ལྡན་འདས་དེ་བཞིན་གཤེགས་པ་འོད་དཔག་མེད་དེ་བླ་ན་མེད་པ་ཡང་དག་པར་རྫོགས་པའི་བྱང་ཆུབ་མངོན་པར་རྫོགས་པར་སངས་རྒྱས་ནས་ཇི་ལྟར་ད་ལྟར་འཇིག་རྟེན་གྱི་ཁམས་འདི་ན་།
 yathā cānandeha lokadhātau kalpasaṃkhyā kalpagaṇanā prajñaptikasaṃketas, tathā sāṃprataṃ daśakalpās tasya bhagavato 'mitāyuṣas tathāgatasyotpannasyānuttarāṃ samyaksaṃbodhim p30	བསྐལ་པའི་གྲངས་དང་། བསྐལ་པ་བགྲང་བའི་བརྡར་བཏགས་པ་དེ་ལྟ་བུའི་བསྐལ་པ་བཅུ་ལོན་ནོ་༎
 abhisaṃbuddhasya|	ཀུན་དགའ་བོ་།
 tasya khalu punar ānanda bhagavato 'mitābhasya sukhāvatī nāma lokadhātur, ṛddhā ca, sphītā ca,	བཅོམ་ལྡན་འདས་འོད་དཔག་མེད་ཀྱི་འཇིག་རྟེན་གྱི་ཁམས་བདེ་བ་ཅན་ཞེས་བྱ་བ་ནི་འབྱོར་བ་། མོད་པ་།
 kṣemā ca, subhikṣā	བདེ་བ་། ལོ་ལེགས་པ་།
 ca, ramaṇīyā ca,	ཉམས་དགའ་བ་།
 bahudevamanuṣyākīrṇā ca| tatra khalv	ལྷ་དང་མི་མང་པོས་གང་བའོ་༎ ཀུན་དགའ་བོ་།
 apy ānanda lokadhātau na nirayāḥ santi, na tiryagyonir,	འཇིག་རྟེན་གྱི་ཁམས་དེ་ན་སེམས་ཅན་དམྱལ་བ་མེད་དོ༏་༏དུད་འགྲོའི་སྐྱེ་གནས་མེད་དོ་༎
 na pretaviṣayo,	ཡི་དབ༹གས་ཀྱི་ཡུལ་མེད་དོ་༎
 nāsurāḥ kāyā,	ལྷ་མ་ཡིན་གྱི་རིས་མེད་དོ་༎
 nākṣaṇopapattayaḥ ; na ca	མི་ཁོམ་པར་སྐྱེ་བ་མེད་དོ་༎
 tāni ratnāni loke pracaranti, yāni sukhāvatyāṃ lokadhātau saṃvidyante| sā khalv ānanda sukhāvatī lokadhātuḥ surabhinānāgandhasamīritā,	འཇིག་རྟེན་གྱི་ཁམས་བདེ་བ་ཅན་ན་སྣང་བའི་རིན་པོ་ཆེ་གང་ཡིན་པ་དེ་དག་ནི་འཇིག་རྟེན་ན་མི་སྤྱོད་དོ་༎ ཀུན་དགའ་བོ་།
 nānāpuṣpaphalasamṛddhā, ratnavṛkṣasamalaṃkṛtā, tathāgatābhinirmitamanojñasvaranānādvijasaṃghaniṣevitā|	འཇིག་རྟེན་གྱི་ཁམས་བདེ་བ་ཅན་དེ་ནི་སྤོས་སྣ་ཚོགས་དྲི་རབ་ཏུ་ཞིམ་པ་ངད་ལྡང་བའི་མེ་ཏོག་དང་འབྲས་བུ་སྣ་ཚོགས་འབྱོར་༄༣༩༡བ་པའོ༏་༏རིན་པོ་ཆེའི་ཤིང་ལྗོན་པས་ལེགས་པར་བརྒྱན་པའོ་༎ དེ་བཞིན་གཤེགས་པའི་སྤྲུལ་པའི་བྱ་རྣམ་པ་སྣ་ཚོགས་སྒྲ་ཡིད་དུ་འོང་བ་ཅན་གྱི་ཚོགས་༎ ཀྱིས་བརྒྱན་པའོ་༎ 
 te cānanda ratnavṛkṣā nānāvarṇā,	ཀུན་དགའ་བོ་། རིན་པོ་ཆེའི་ཤིང་ལྗོན་པ་དེ་དག་ནི་ཁ་དོག་ཐ་དད་པ་། ཁ་དོག་དུ་མ་།
 anekavarṇā, anekaśata- sahasravarṇāḥ :	ཁ་དོག་བརྒྱ་སྟོང་ཕྲག་དུ་མ་ཡོད་པའོ་༎
 santi tatra ratnavṛkṣāḥ suvarṇavarṇāḥ suvarṇa-	ཀུན་དགའ་བོ་། དེ་ན་རིན་པོ་ཆེའི་ཤིང་ལྗོན་པ་གསེར་གྱི་ཁ་དོག་ལྟ་བུ་དང་། གསེར་གྱི་རང་བཞིན་དག་ཡོད་དོ་༎
 mayāḥ ; santi rūpyavarṇā rūpyamayāḥ ;	དངུལ་གྱི་ཁ་དོག་ལྟ་བུ་དང་། དངུལ་གྱི་རང་བཞིན་དག་ཡོད་དོ་༎
 santi vaiḍūryavarṇā vaiḍūryamayāḥ ;	བེཨེ་དའུརྱའི་ཁ་དོག་ལྟ་བུ་དང་། བེཨེ་དའུརྱའི་རང་བཞིན་དག་ཡོད་དོ་༎
 santi sphaṭikavarṇāḥ sphaṭikamayāḥ ;	ཤེལ་གྱི་ཁ་དོག་ལྟ་བུ་དང་། ཤེལ་གྱི་རང་བཞིན་དག་ཡོད་དོ་༎
 santi musāragalvavarṇā musāragalvamayāḥ ;	སྤུག་གི་ཁ་དོག་ལྟ་བུ་དང་། སྤུག་གི་རང་བཞིན་དག་ཡོད་དོ་༎
 santi lohitamuktāvarṇā lohitamuktāmayāḥ ;	མུ་ཏིག་དམར་པོའི་ཁ་དོག་ལྟ་བུ་དང་། མུ་ཏིག་དམར་པོའི་རང་བཞིན་དག་ཡོད་དོ་༎
 santy aśmagarbhavarṇā aśmagarbhamayāḥ|	རྡོའི་སྙིང་པོའི་ཁ་དོག་ལྟ་བུ་དང་། རྡོའི་སྙིང་པོའི་རང་བཞིན་དག་ཡོད་དོ་༎
 santi kecid dvayo ratnavṛkṣayoḥ suvarṇasya	ཁ་ཅིག་ནི་གསེར་དང་། དངུལ་དང་། རིན་པོ་ཆེ་སྣ་གཉིས་པ་དག་ཡོད་དོ་༎
 rūpyasya ca| santi trayāṇāṃ ratnānāṃ suvarṇasya rūpyasya	གསེར་དང་། དངུལ་དང་། བེཨེ་དའུརྱ་དང་། རིན་པོ་ཆེ་སྣ་གསུམ་པ་དག་ཀྱང་ཡོད་དོ་༎
 vaiḍūryasya ca| santi caturṇāṃ suvarṇasya rūpyasya vaiḍūryasya sphaṭikasya ca| santi pañcānāṃ suvarṇasya rūpyasya	གསེར་དང་། དངུལ་དང་། བེཨེ་དའུརྱ་དང་། ཤེལ་དང་། རིན་པོ་ཆེ་སྣ་བཞི་པ་དག་ཀྱང་ཡོད་དོ་༎
 vaiḍūryasya sphaṭikasya musāragalvasya ca| santi ṣaṇṇāṃ	གསེར་དང་། དངུལ་དང་། བེཨེ་དའུརྱ་དང་། ཤེལ་དང་། སྤུག་དང་། རིན་པོ་ཆེ་སྣ་ལྔ་པ་དག་ཀྱང་ཡོད་དོ་༎
 suvarṇasya rūpyasya vaiḍūryasya sphaṭikasya musāragalvasya lohitamuktāyāś ca| santi saptānāṃ ratnānāṃ suvarṇasya	གསེར་དང་། དངུལ་དང་། བེཨེ་དའུརྱ་དང་། ཤེལ་དང་། སྤུག་དང་། མུ་ཏིག་དམར་པོ་དང་། རིན་པོ་ཆེ་སྣ་དྲུག་པ་དག་ཀྱང་ཡོད་དོ་༎ གསེར་དང་། དངུལ་༄༣༩༢ཨ་༌༎
 rūpyasya vaiḍūryasya sphaṭikasya musālagalvasya lohitamuktāyā,	དང༏་བེཨེ་དའུརྱ་དང་། ཤེལ་དང་། སྤུག་དང་། མུ་ཏིག་དམར་པོ་དང་། རྡོའི་སྙིང་པོ་དང་། རིན་པོ་ཆེ་སྣ་བདུན་པ་དག་ཀྱང་ཡོད་དོ་༎ ཀུན་དགའ་བོ་།
 aśmagarbhasya ca saptamasya| p31 tatrānanda sauvarṇāṇāṃ vṛkṣāṇāṃ suvarṇamayāni mūla- skandhaviṭapaśākhāpattrapuṣpāni phalāni raupyamayāni ;	དེ་ན་གསེར་གྱི་ཤིང་ལྗོན་པ་རྣམས་ཀྱི་རྩ་བ་དང་། སྡོང་པོ་དང་། ཡལ་ག་དང་། ལོ་མ་དང་། འདབ་མ་དང་། མེ་ཏོག་རྣམས་གསེར་གྱི་རང་བཞིན་ལ་།
 raupyamayānāṃ	རྩ་བ་རྣམས་དངུལ་གྱི་རང་བཞིན་ནོ་༎
 vṛkṣāṇāṃ rūpyamayāny eva mūlaskandhaviṭapa- śākhāpattrapuṣpāni phalāni vaiḍūryamayāni ;	དངུལ་གྱི་ཤིང་ལྗོན་པ་རྣམས་ཀྱི་རྩ་བ་དང་། སྡོང་པོ་དང་། ཡལ་ག་དང་། ལོ་མ་དང་། འདབ་མ་དང་། མེ་ཏོག་རྣམས་དངུལ་གྱི་རང་བཞིན་ལ་། འབྲས་བུ་རྣམས་བེཨེ་དའུརྱའི་རང་བཞིན་ནོ་༎
 vaiḍūryamayānāṃ vṛkṣānāṃ vaiḍūryamayāni mūlaskandhaviṭapaśākhāpattra-	བེཨེ་དའུརྱའི་ཤིང་ལྗོན་པ་རྣམས་ཀྱི་རྩ་བ་དང་། སྡོང་པོ་དང་། ཡལ་ག་དང་། ལོ་མ་དང་། འདབ་མ་དང་། མེ་ཏོག་རྣམས་བེཨེ་དའུརྱའི་རང་བཞིན་ལ་།
 puṣpāṇi phalāni sphaṭikamayāni ;	འབྲས་བུ་རྣམས་ཤེལ་གྱི་རང་བཞིན་ནོ་༎
 sphaṭikamayānāṃ vṛkṣāṇāṃ sphaṭikamayāny eva mūlaskandhaviṭapaśākhāpattra- puṣpāṇi phalāni musāragalvamayāni ;	ཤེལ་གྱི་ཤིང་ལྗོན་པ་རྣམས་ཀྱི་རྩ་བ་དང་། སྡོང་པོ་དང་། ཡལ་ག་དང་། ལོ་མ་དང་། འདབ་མ་དང་། མེ་ཏོག་རྣམས་ཤེལ་གྱི་རང་བཞིན་ལ་།
 musāragalvamayānāṃ vṛkṣāṇāṃ musāragalvamayāny eva mūlaskandhaviṭapaśākhā-	འབྲས་བུ་རྣམས་སྤུག་གི་རང་བཞིན་ནོ༏་༏སྤུག་གི་ཤིང་ལྗོན་པ་རྣམས་ཀྱི་རྩ་བ་དང་། སྡོང་པོ་དང་། ཡལ་ག་དང་། ལོ་མ་དང་། འདབ་མ་དང་། མེ་ཏོག་རྣམས་སྤུག་གི་རང་བཞིན་ལ་།
 pattrapuṣpāṇi phalāni lohitamuktāmayāni ;	འབྲས་བུ་རྣམས་མུ་ཏིག་དམར་པོའི་རང་བཞིན་ནོ་༎
 lohitamuktāmayānāṃ vṛkṣāṇāṃ lohitamuktāmayāny eva mūlaskandhaviṭapaśākhā-	མུ་ཏིག་དམར་པོའི་ཤིང་ལྗོན་པ་རྣམས་ཀྱི་རྩ་བ་དང་། སྡོང་པོ་དང་། ཡལ་ག་དང་། ལོ་མ་དང་། འདབ་མ་དང་། མེ་ཏོག་རྣམས་མུ་ཏིག་དམར་པོའི་རང་བཞིན་ལ་།
 pattrapuṣpāṇi phalāny aśmagarbhamayāṇi ;	༄༣༩༢བ་འབྲས་བུ་རྣམས་རྡོའི་སྙིང་པོའི་རང་བཞིན་ནོ་༎
 aśmagarbha- mayāṇāṃ vṛkṣānām aśmagarbhamayāṇy eva mūlaskandhaviṭapa- śākhāpattrapuṣpāṇi phalāni suvarṇamayāni|	རྡོའི་སྙིང་པོའི་ཤིང་ལྗོན་པ་རྣམས་ཀྱི་རྩ་བ་དང་། སྡོང་པོ་དང་། ཡལ་ག་དང་། ལོ་མ་དང་། འདབ་མ་དང་། མེ་ཏོག་རྣམས་རྡོའི་སྙིང་པོའི་རང་བཞིན་ལ༏་འབྲས་བུ་རྣམས་གསེར་གྱི་རང་བཞིན་ནོ་༎
 keṣāṃcid ānanda vṛkṣāṇāṃ suvarṇamayāni mūlāni,	ཀུན་དགའ་བོ་། ཤིང་ལྗོན་པ་ཁ་ཅིག་ནི་རྩ་བ་རྣམས་གསེར་གྱི་རང་བཞིན་ལ་།
 raupyamayāḥ	སྡོང་པོ་རྣམས་དངུལ་གྱི་རང་བཞིན་།
 skandhā, vaiḍūryamayā viṭapāḥ,	ཡལ་ག་རྣམས་བེཨེ་དའུརྱའི་རང་བཞིན་། ལོ་མ་རྣམས་ཤེལ་གྱི་རང་བཞིན་།
 sphaṭikamayāḥ śākhā,	འདབ་མ་རྣམས་སྤུག་གི་རང་བཞིན་།
 musāragalvamayāni pattrāṇi, lohitamuktāmayāni puṣpāṇy,	མེ་ཏོག་རྣམས་མུ་ཏིག་དམར་པོའི་རང་བཞིན་།
 aśmagarbhamayāṇi phalāni ;	འབྲས་བུ་རྣམས་རྡོའི་སྙིང་པོའི་རང་བཞིན་ནོ་༎ ཀུན་དགའ་བོ་།
 keṣāṃcid ānanda vṛkṣāṇāṃ rūpyamayāni	ཤིང་ལྗོན་པ་ཁ་ཅིག་ནི་རྩ་བ་རྣམས་དངུལ་གྱི་རང་བཞིན་ལ་།
 mūlāni, vaiḍūryamayāḥ skandhāḥ,	སྡོང་པོ་རྣམས་བེཨེ་དའུརྱའི་རང་བཞིན་།
 sphaṭikamayā viṭapā, musāragalvamayāḥ śākhā,	ཡལ་ག་རྣམས་ཤེལ་གྱི་རང་བཞིན་།
 lohitamuktāmayāni pattrāṇy,	ལོ་མ་རྣམས་སྤུག་གི་རང་བཞིན་། འདབ་མ་རྣམས་མུ་ཏིག་དམར་པོའི་རང་བཞིན་།
 aśmagarbhamayāṇi puṣpāṇi,	མེ་ཏོག་རྣམས་རྡོའི་སྙིང་པོའི་རང་བཞིན་།
 suvarṇamayāni phalāni ; keṣāṃcid	འབྲས་བུ་རྣམས་གསེར་གྱི་རང་བཞིན་ནོ་༎ ཀུན་དགའ་བོ་།
 ānanda vṛkṣāṇāṃ vaiḍūryamayāni mūlāni,	ཤིང་ལྗོན་པ་ཁ་ཅིག་ནི་རྩ་བ་རྣམས་བེཨེ་དའུརྱའི་རང་བཞིན་ལ་།
 sphaṭikamayāḥ	སྡོང་པོ་རྣམས་ཤེལ་གྱི་རང་བཞིན་།
 skandhā, musāragalvamayā viṭapā,	ཡལ་ག་རྣམས་སྤུག་གི་རང་བཞིན་།
 lohitamuktāmayāḥ	ལོ་མ་རྣམས་མུ་ཏིག་དམར་པོའི་རང་བཞིན་།
 śākhā, aśmagarbhamayāṇi pattrāṇi,	འདབ་མ་རྣམས་རྡོའི་སྙིང་པོའི་རང་བཞིན་།
 suvarṇamayāni puṣpāṇi,	མེ་ཏོག་རྣམས་གསེར་གྱི་རང་བཞིན་།
 raupyamayāni phalāni ;	འབྲས་བུ་རྣམས་དངུལ་གྱི་རང་བཞིན་ནོ་༎ ཀུན་དགའ་བོ་།
 keṣāṃcid ānanda vṛkṣāṇāṃ p32 sphaṭikamayāni mūlāni,	ཤིང་ལྗོན་པ་ཁ་ཅིག་ནི་རྩ་བ་རྣམས་ཤེལ་གྱི་རང་བཞིན་ལ་།
 musāragalvamayāḥ skandhā,	སྡོང་པོ་རྣམས་སྤུག་གི་རང་བཞིན་།
 lohitamuktāmayā viṭapā, aśmagarbhamayāḥ śākhāḥ,	༄༣༩༣ཨ་༌༎ ཡལ་ག་རྣམས་མུ་ཏིག་དམར་པོའི་རང་བཞིན་༎ ལོ་མ་རྣམས་རྡོའི་སྙིང་པོའི་རང་བཞིན་།
 suvarṇamayāni	འདབ་མ་རྣམས་གསེར་གྱི་རང་བཞིན་།
 pattrāṇi, raupyamayāni puṣpāṇi,	མེ་ཏོག་རྣམས་དངུལ་གྱི་རང་བཞིན་།
 vaiḍūryamayāni phalāni ; keṣāṃcid	འབྲས་བུ་རྣམས་བེཨེ་དའུརྱའི་རང་བཞིན་ནོ་༎ ཀུན་དགའ་བོ་།
 ānanda vṛkṣānāṃ musāragalvamayāni mūlāni, lohita- muktāmayāḥ skandhā,	ཤིང་ལྗོན་པ་ཁ་ཅིག་ནི་རྩ་བ་རྣམས་སྤུག་གི་རང་བཞིན་ལ་། སྡོང་པོ་རྣམས་མུ་ཏིག་དམར་པོའི་རང་བཞིན་།
 aśmagarbhamayā viṭapāḥ, suvarṇa-	ཡལ་ག་རྣམས་རྡོའི་སྙིང་པོའི་རང་བཞིན་།
 mayāḥ śākhā,	ལོ་མ་རྣམས་གསེར་གྱི་རང་བཞིན་།
 raupyamayāni pattrāṇi,	འདབ་མ་རྣམས་དངུལ་གྱི་རང་བཞིན་།
 vaiḍūryamayāni puṣpāṇi,	མེ་ཏོག་རྣམས་བེཨེ་དའུརྱའི་རང་བཞིན་།
 sphaṭikamayāni phalāni ;	འབྲས་བུ་རྣམས་ཤེལ་གྱི་རང་བཞིན་ནོ་༎
 keṣāṃcid ānanda vṛkṣāṇāṃ lohitamuktāmayāni mūlāny,	ཀུན་དགའ་བོ༏་ཤིང་ལྗོན་པ་ཁ་ཅིག་ནི་རྩ་བ་རྣམས་མུ་ཏིག་དམར་པོའི་རང་བཞིན་ལ་།
 aśmagarbhamayāḥ skandhāḥ,	སྡོང་པོ་རྣམས་རྡོའི་སྙིང་པོའི་རང་བཞིན་།
 suvarṇamayā	ཡལ་ག་རྣམས་གསེར་གྱི་རང་བཞིན་།
 viṭapā, raupyamayā śākhā,	ལོ་མ་རྣམས་དངུལ་གྱི་རང་བཞིན་།
 vaiḍūryamayāṇi pattrāṇi,	འདབ་མ་རྣམས་བེཨེ་དའུརྱའི་རང་བཞིན་།
 sphaṭikamayāni puṣpāṇi,	མེ་ཏོག་རྣམས་ཤེལ་གྱི་རང་བཞིན་།
 musāragalvamayāni phalāni ; keṣāṃcid	འབྲས་བུ་རྣམས་སྤུག་གི་རང་བཞིན་ནོ་༎ ཀུན་དགའ་བོ་།
 ānanda vṛkṣāṇām aśmagarbhamayāni mūlāni,	ཤིང་ལྗོན་པ་ཁ་ཅིག་ནི་རྩ་བ་རྣམས་རྡོའི་སྙིང་པོའི་རང་བཞིན་ལ་།
 suvarṇamayāḥ	སྡོང་པོ་རྣམས་གསེར་གྱི་རང་བཞིན་།
 skandhā, raupyamayā viṭapā,	ཡལ་ག་རྣམས་དངུལ་གྱི་རང་བཞིན་།
 vaiḍūryamayāḥ śākhāḥ, sphaṭikamayāni pattrāni,	ལོ་མ་རྣམས་བེཨེ་དའུརྱའི་རང་བཞིན་། འདབ་མ་རྣམས་ཤེལ་གྱི་རང་བཞིན་།
 musāragalvamayāni puṣpāṇi,	མེ་ཏོག་རྣམས་སྤུག་གི་རང་བཞིན་།
 lohitamuktāmayāni phalāni ;	འབྲས་བུ་རྣམས་མུ་ཏིག་དམར་པོའི་རང་བཞིན་ནོ་༎ ཀུན་དགའ་བོ་།
 keṣāṃcid ānanda vṛkṣāṇāṃ saptaratnamayāni mūlāni,	ཤིང་ལྗོན་པ་ཁ་ཅིག་ནི་རྩ་བ་རྣམས་རིན་པོ་ཆེ་སྣ་བདུན་གྱི་རང་བཞིན་ལ་།
 saptaratnamayāḥ skandhāḥ,	སྡོང་པོ་༄༣༩༣བ་རྣམས་ཀྱང་རིན་པོ་ཆེ་སྣ་བདུན་གྱི་རང་བཞིན་།
 saptaratnamayā viṭapāḥ, saptaratnamayāḥ śākhāḥ,	ཡལ་ག་རྣམས་ཀྱང་རིན་པོ་ཆེ་སྣ་བདུན་གྱི་རང་བཞིན་།
 saptaratnamayāni	ལོ་མ་རྣམས་ཀྱང་རིན་པོ་ཆེ་སྣ་བདུན་གྱི་རང་བཞིན་།
 pattrāṇi, saptaratnamayāni puṣpāni,	འདབ་མ་རྣམས་ཀྱང་རིན་པོ་ཆེ་སྣ་བདུན་གྱི་རང་བཞིན་། མེ་ཏོག་རྣམས་ཀྱང་རིན་པོ་ཆེ་སྣ་བདུན་གྱི་རང་བཞིན་།
 saptaratnamayāni phalāni|	འབྲས་བུ་རྣམས་ཀྱང་རིན་པོ་ཆེ་སྣ་བདུན་གྱི་རང་བཞིན་ནོ་༎ ཀུན་དགའ་བོ་།
 sarveṣāṃ cānanda teṣāṃ vṛkṣāṇāṃ mūlaskandhaviṭapaśākhā- pattrapuṣpaphalāni mṛdūni sukhasaṃsparśāni sugandhīni ; vātena	ཤིང་ལྗོན་པ་དེ་དག་ཐམས་ཅད་ཀྱི་རྩ་བ་དང༏་སྡོང་པོ་དང་། ཡལ་ག་དང་། ལོ་མ་དང་། འདབ་མ་དང་། མེ་ཏོག་དང་། འབྲས་བུ་རྣམས་ནི་འཇམ་པ་། རེག་ན་བདེ་བ་། དྲི་ཞིམ་པ་དག་གོ་།
 preritānāṃ ca teṣāṃ valgumanojñanirghoṣo niścaraty,	རླུང་གིས་བསྐྱོད་ན་དེ་དག་ལས་སྙན་ཅིང་ཡིད་དུ་འོང་བའི་སྒྲ་འབྱུང་སྟེ་།
 asecanako 'pratikūlaḥ śravaṇāya|	མཉན་པ་དང་མཐུན་ཞིང་མཉན་པས་ཆོག་མི་ཤེས་པའོ་༎
 evaṃrūpair ānanda saptaratnamayair vṛkṣaiḥ saṃtataṃ tad	ཀུན་དགའ་བོ་། སངས་རྒྱས་ཀྱི་ཞིང་དེ་ནི་རིན་པོ་ཆེ་སྣ་བདུན་གྱི་ཤིང་ལྗོན་པ་རྣམ་པ་དེ་ལྟ་བུ་དག་གིས་གང་སྟེ་།
 buddhakṣetraṃ samantāc ca kadalīstambhaiḥ saptaratnamayai ratnatālapaṇktibhiś cānuparikṣiptaṃ,	མཐའ་ན་རིན་པོ་ཆེ་སྣ་བདུན་གྱི་ཆུ་ཤིང་གི་སྡོང་པོ་དང་། རིན་པོ་ཆེའི་ཤིང་ཏ་ལའི་ཕྲེང་གིས་ཡོངས་སུ་བསྐོར་ཏོ་༎
 sarvataś ca hemajālapraticchannaṃ, p33	ཐམས་ཅད་ཀྱང་གསེར་གྱི་དྲ་བས་ཁེབས་པའོ་༎
 samantataś ca saptaratnamayaiḥ padmaiḥ saṃcchannaṃ|	ཀུན་དུ་རིན་པོ་ཆེ་སྣ་བདུན་གྱི་པདམ་རྣམས་ཀྱིས་ཁེབས་པའོ་༎
 santi tatra padmāny ardhayojanapramāṇāni, santi	དེ་ན་པདམའི་ཚད་དཔག་ཚད་ཕྱེད་པ་ཙམ་ཡང་ཡོད་།
 yojanapramāṇāni,	དཔག་ཚད་ཀྱི་ཚད་ཙམ་ཡང་ཡོད་།
 santi dvitricatuḥpañcayojanapramāṇāni,	དཔག་ཚད་གཅིག་དང་། གཉིས་དང་། གསུམ་དང་། བཞི་དང་། ལྔའི་ཚད་ཙམ་ཡང་ཡོད་།
 santi yāvad daśayojanapramāṇāni| sarvataś ca ratnapadmāt	དཔག་ཚད་བཅུའི་བར་གྱི་ཚད་ཙམ་དག་ཀྱང་ཡོད་དོ་༎
 ṣaṭtriṃśadraśmikoṭīsahasrāṇi niścaranti| sarvataś ca	རིན་པོ་ཆེའི་པདམ་ཐམས་ཅད་ལས་ཀྱང་འོད་ཟེར་བྱེ་བ་སྟོང་ཕྲག་སུམ་ཅུ་རྩ་དྲུག་དྲུག་འབྱུང་ངོ་༎ འོད་ཟེར་གྱི་རྩེ་མོ་༄༣༩༤ཨ་༌༎
 raśmimukhāt ṣaṭtriṃśadbuddhakoṭīsahasrāṇi niścaranti ; suvarṇa- varṇaiḥ kāyair dvātriṃśan mahāpuruṣalakṣaṇadharair, yāni pūrvasyāṃ diśy aprameyāsaṃkhyeyāsu lokadhātuṣu	ཐམས་ཅད་ལས་ཀྱང་སངས་རྒྱས་ཀྱི་སྐུ་གསེར་གྱི་ཁ་དོག་ཅན་སྐྱེས་བུ་ཆེན་པོའི་མཚན་སུམ་ཅུ་རྩ་གཉིས་མངའ་བ་བྱེ་བ་སྟོང་ཕྲག་སུམ་ཅུ་རྩ་དྲུག་དྲུག་འབྱུང་སྟེ༏་དེ་དག་ཤར་ཕྱོགས་སུ་འཇིག་རྟེན་གྱི་ཁམས་གྲངས་མེད་དཔག་ཏུ་མེད་པ་དག་ཏུ་གཤེགས་ནས་སེམས་ཅན་རྣམས་ལ་ཆོས་སྟོན་ཏོ་༎ 
 gatvā, sattvebhyo dharmaṃ deśayanti| evaṃ dakṣiṇapaścimottarāsu dikṣv adha ūrdhvam anuvidikṣu cānāvaraṇe loke 'prameyāsaṃkhyeyāṃl lokadhātūn gatvā, sattvebhyo dharmaṃ	དེ་བཞིན་དུ་ལྷོ་དང་། ནུབ་དང་། བྱང་ཕྱོགས་དང༏་འོག་དང་། སྟེང་དང་། ཕྱོགས་མཚམས་རྣམས་སུ་འཇིག་རྟེན་གྱི་ཁམས་ཐ་དད་པ་གྲངས་མེད་དཔག་ཏུ་མེད་པ་དག་ཏུ་གཤེགས་ནས་སེམས་ཅན་རྣམས་ལ་ཆོས་སྟོན་ཏོ་༎ ཀུན་དགའ་བོ་།
 deśayanti| tasmin khalu punar ānanda buddhakṣetre sarvaśaḥ kālaparvatā	སངས་རྒྱས་ཀྱི་ཞིང་དེ་ན་རི་ནག་པོ་རྣམས་ཡེ་མེད་དེ་།
 na santi, sarvato ratnaparvatāḥ| sarvaśaḥ sumeravaḥ	རི་ཐམས་ཅད་ཀྱང་རིན་པོ་ཆེའི་རི་ཤ་སྟག་གོ་།
 parvatarājānaḥ, sarvaśaś cakravāḍamahācakravāḍāḥ parvata- rājāno, mahāsamudrāś ca na santi| samantāc ca tad	རིའི་རྒྱལ་པོ་རི་རབ་ཐམས་ཅད་དང་། ཁོར་ཡུག་དང་། རིའི་རྒྱལ་པོ་ཁོར་ཡུག་ཆེན་པོ་ཐམས་ཅད་དང་། མཚོ་ཆེན་པོ་རྣམས་མེད་དོ་༎
 buddhakṣetraṃ samaṃ ramaṇīyaṃ pāṇitalajātaṃ nānāvidha-	སངས་རྒྱས་ཀྱི་ཞིང་དེ་ནི་ཀུན་དུ་མཉམ་པ་། ཉམས་དགའ་བ་། ལག་མཐིལ་ལྟར་མཉམ་པ་།
 ratnasaṃnicitabhūmibhāgam|	ས་ཕྱོགས་རིན་པོ་ཆེ་རྣམ་པ་སྣ་ཚོགས་ཀྱིས་སྤྲས་པའོ་༎
 evam ukta āyuṣmān ānando bhagavantam etad avocat : ye	དེ་སྐད་ཅེས་བཀའ་སྩལ་པ་དང་། བཅོམ་ལྡན་འདས་ལ་ཚེ་དང་ལྡན་པ་ཀུན་དགའ་བོས་འདི་སྐད་ཅེས་གསོལ་ཏོ་༎ བཅོམ་ལྡན་འདས་།
 punas te bhagavaṃś cāturmahārājakāyikā devāḥ sumerupārśva- nivāsinas trāyastriṃśā vā sumerumūrdhni nivāsinas, te kutra pratiṣṭhitāḥ| bhagavān āha :	རྒྱལ་ཆེན་བཞིའི་རིས་ཀྱི་ལྷ་རི་རབ་ཀྱི་ངོས་ལ་གནས་པ་དང་། སུམ་ཅུ་རྩ་གསུམ་པའི་ལྷ་རི་རབ་ཀྱི་རྩེ་མོ་ལ་གནས་པ་དེ་དག་གང་ན་གནས་། བཅོམ་ལྡན་འདས་ཀྱིས་བཀའ་སྩལ་པ་།
 tat kiṃ manyase, ānanda,	ཀུན་དགའ་བོ་། འདི་ཇི་༄༣༩༤བ་སྙམ་དུ་སེམས་།
 ye ta iha sumeroḥ parvatarājasyopari yāmā devās, tuṣitā devā, nirmāṇaratayo devāḥ, paranirmitavaśavartino devā, brahmakāyikā devā, brahmapurohitā devā, mahābrahmaṇo p34 devā, yāvad akaniṣṭhā devāḥ,	འདི་ན་རིའི་རྒྱལ་པོ་རི་རབ་ཀྱི་གོང་མ་འཐབ་བྲལ་གྱི་ལྷ་རྣམས་དང་། དགའ་ལྡན་དང་། འཕྲུལ་དགའ་དང་། གཞན་འཕྲུལ་དབང་བྱེད་དང་། ཚངས་རིས་དང་། ཚངས་པའི་མདུན་ན་འདོན་དང་། ཚངས་ཆེན་ནས་འོག་མིན་གྱི་བར་གྱི་ལྷ་རྣམས་གང་ན་གནས་།
 kutra te pratiṣṭhitā iti| āha :	གསོལ་པ་།
 acintyo bhagavan karmāṇāṃ vipākaḥ, karmābhisaṃskāraḥ|	བཅོམ་ལྡན་འདས་། ལས་ཀྱི་རྣམ་པར་སྨིན་པ་དང་། ལས་མངོན་པར་འདུ་བགྱིད་པ་བསམ་གྱིས་མི་ཁྱབ་བོ་༎
 bhagavān āha :	བཅོམ་ལྡན་འདས་ཀྱིས་བཀའ་སྩལ་པ་། ཀུན་དགའ་བོ་།
 labdhas tvayānandehācintyaḥ karmāṇāṃ vipākaḥ, karmābhisaṃskāro ;	ལས་ཀྱི་རྣམ་པར་སྨིན་པ་དང་། ལས་མངོན་པར་འདུ་བྱེད་པ་བསམ་གྱིས་མི་ཁྱབ་པ་ནི་རྙེད་པར་རུང་གི་།
 na punar buddhānāṃ bhagavatām acintyaṃ buddhādhiṣṭhānam| kṛtapuṇyānāṃ ca sattvānām	སངས་རྒྱས་བཅོམ་ལྡན་འདས་རྣམས་ཀྱི་དགེ་བ་དང་། རྫུ་འཕྲུལ་དང་། བྱིན་གྱི་རླབས་བསམ་གྱིས་མི་ཁྱབ་པ་ནི་སུས་ཀྱང་མཐའ་མ་། ཚད་རྟོགས་པའམ་། བསམ་པར་མི་ནུས་ཏེ་། གཞན་དུ་ན་སངས་རྒྱས་ཀྱི་ཡུལ་བསམ་གྱིས་མི་ཁྱབ་པོ་ཞེས་རབ་ཏུ་འབྱེད་དོ་༎
 avaropitakuśalamūlānāṃ tatrācintyā puṇyā vibhūtiḥ| āha :	དེ་ལྟར་སེམས་ཅན་བསོད་ནམས་བྱས་པ་དང་། དགེ་བའི་རྩ་བ་བསྐྱེད་པའི་བསོད་ནམས་དང་ཡེ་ཤེས་དང་། རྫུ་འཕྲུལ་དང་། འབྱོར་པ་བསམ་གྱིས་མི་ཁྱབ་པ་དག་སངས་རྒྱས་ཀྱི་ཞིང་དེར་འབྱུང་ངོ་༎ གསོལ་པ་། བཅོམ་ལྡན་འདས་།
 na me 'tra bhagavan kācit kāṃkṣā vā, vimatir vā,	བདག་ནི་དེ་ལ་དོགས་པའམ་། ཡིད་གཉིས་སམ་། ཐེ་ཚོམ་མ་མཆིས་ཏེ་།
 vicikitsā vā| api tu khalv aham anāgatānāṃ sattvānāṃ kāṃkṣāvimativicikitsāṃ nirghātāya tathāgatam etam arthaṃ paripṛcchāmi| bhagavān āha :	བདག་ནི་མ་འོངས་པའི་སེམས་ཅན་རྣམས་ཀྱི་དོགས་པ་དང་། ཡིད་གཉིས་དང་། ཐེ་ཚོམ་བསལ་བའི་སླད་དུ་དེ་བཞིན་གཤེགས་པ་ལ་དོན་འདི་ཡོངས་སུ་ཞུའོ་༎ བཅོམ་ལྡན་འདས་ཀྱིས་བཀའ་སྩལ་པ་།
 sādhu sādhv ānandaivaṃ te	ཀུན་དགའ་བོ་། ལེགས་༄༣༩༥ཨ་༌༎ སོ༏་༏ལེགས་སོ་༎
 karaṇīyam|	དེ་ལྟ་བུ་ནི་ཁྱོད་ཀྱི་བྱ་བ་ཡིན་ནོ་༎ ཀུན་དགའ་བོ་།
 tasyāṃ khalv ānanda sukhāvatyāṃ lokadhātau nānāprakārā	འཇིག་རྟེན་གྱི་ཁམས་བདེ་བ་ཅན་དེ་ན་ཆུ་ཀླུང་རྣམ་པ་སྣ་ཚོགས་དག་འབབ་སྟེ་།
 nadyaḥ pravahanti| santi tatra mahānadyo yojanavistārāḥ|	དེ་ན་ཆུ་ཀླུང་ཆེན་པོ་ཁ་ཚོན་དཔག་ཚད་ཙམ་དག་ཀྱང་ཡོད་དེ་།
 santi yāvad viṃśatitriṃśaticatvāriṃśatpañcāśad, yāvad yojana- śatasahasravistārāḥ,	དཔག་ཚད་བཅུ་དང་། ཉི་ཤུ་དང་། སུམ་ཅུ་དང་། བཞི་བཅུ་དང་། ལྔ་བཅུའི་བར་དང་། ཁ་ཚོན་དཔག་ཚད་བརྒྱ་སྟོང་གི་ཚད་ཙམ་དག་ཀྱང་ཡོད་དེ་།
 dvādaśayojanāvedhāḥ ; sarvāś ca nadyaḥ sukhavāhinyo,	ཟབས་སུ་ནི་དཔག་ཚད་བཅུ་གཉིས་པ་དག་གོ་།
 nānāsurabhigandhavārivāhinyo, nānāratnaluḍitapuṣpasaṃghātavāhinyo,	ཆུ་ཀླུང་དེ་དག་ཐམས་ཅད་ཀྱང་སྤོས་དྲི་རབ་ཏུ་ཞིམ་པ་སྣ་ཚོགས་ཀྱི་ཆུར་འབབ་ཅིང་རིན་པོ་ཆེའི་མེ་ཏོག་སིལ་མའི་ཚོགས་དག་འབབ་པ་དག་གོ་། 
 nānāmadhurasvaranirghoṣāḥ|	སྒྲ་དབྱངས་སྙན་པ་ཐ་དད་པ་སྣ་ཚོགས་དང་ཡང་ལྡན་པ་དག་གོ་། ཀུན་དགའ་བོ་།
 tāsāṃ cānanda koṭīśatasahasrāṅgasaṃprayuktasya divyasaṅgītisaṃmūrcchitasya tūryasya kuśalaiḥ saṃpravāditasya, tāvan manojñanirghoṣo niścarati| yathārūpas tāsāṃ mahā- nadīnāṃ nirghoṣo niścarati, gambhīra, ājñeyo, vijñeyo, 'nelaḥ karṇasukho hṛdayaṃgamaḥ, premaṇīyo, valgumanojño, 'secanako 'pratikūlaḥ, śravaṇīyo,	ཆུ་ཀླུང་ཆེན་པོ་དེ་དག་ལས་ལྷའི་གླུ་དབྱངས་ཡན་ལག་བྱེ་བ་བརྒྱ་སྟོང་དང་ལྡན་པའི་སིལ་སྙན་དག་མཁས་པ་རྣམས་ཀྱིས་བྱས་པ་བས་ལྷག་པའི་སྒྲ་ཡིད་དུ་འོང་བ་འབྱུང་སྟེ་།
 'cintyaśāntam anātmeti sukhaśravaṇīyo, p35	ཆུ་ཀླུང་ཆེན་པོ་དེ་དག་ལས་རྣམ་པ་འདི་ལྟ་བུའི་སྒྲ་འབྱུང་བ་ནི་ཟབ་པ་དང་། ཀུན་དུ་ཤེས་པར་བྱ་བ་དང་། རྣམ་པར་ཤེས་པར་བྱ་བ་དང་། བརྫུན་པ་མ་ཡིན་པ་དང་། རྣ་བར་བདེ་བ་དང་། སྙིང་དུ་འོང་བ་དང་། དགའ་བར་བྱ་བ་དང་། སྙན་པ་དང་། ཡིད་དུ་འོང་བ་དང་། མཉན་པས་ཆོག་མི་ཤེས་པ་དང་། མཉན་པ་དང་མཐུན་པ་དང་། མི་རྟག་པ་དང་། ཞི་བ་དང་། བདག་མེད་ཅེས་བྱ་བ་དང་། མཉན་ན་བདེ་བ་སྟེ་།
 yas teṣāṃ sattvānāṃ śrotrendriyānāṃ bhāsam āgacchanti|	དེ་དག་སེམས་ཅན་དེ་དག་གི་རྣ་བའི་༄༣༩༥བ་དབང་པོ་ལ་གྲག་གོ་། ཀུན་དགའ་བོ་།
 tāsāṃ khalu punar ānanda mahānadīnām ubhayatas tīrāṇi nānāgandhavṛkṣaiḥ saṃtatāni,	ཆུ་ཀླུང་ཆེན་པོ་དེ་དག་གི་འགྲམ་གཉིས་ནི་རིན་པོ་ཆེའི་སྤོས་ཀྱི་ཤིང་ལྗོན་པ་དག་གིས་གང་སྟེ་། 
 yebhyo nānāśākhāpattra- puṣpamañjaryo 'valaṃbante| tatra ye sattvās tesu nadītīreṣv ākāṃkṣanti,	དེ་དག་ལ་ཡལ་ག་དང་། ལོ་མ་དང་། མེ་ཏོག་དང་། དོག་པ་སྣ་ཚོགས་འཕྱང་ངོ་༎ དེ་ན་སེམས་ཅན་གང་དག་ཆུ་ཀླུང་གི་འགྲམ་དེ་དག་ཏུ་ཟང་ཟིང་མེད་པའི་ལྷའི་དགའ་བ་དང་། 
 divyāṃ nirāmiṣāṃ ratikrīḍāṃ cānubhavituṃ, teṣāṃ tatra nadīṣv avatīrṇānāṃ ākāṃkṣatāṃ gulphamātraṃ vāri saṃtiṣṭhante ;	རྩེ་བ་མྱོང་བར་འདོད་པ་དེ་དག་ཆུ་ཀླུང་དེ་དག་ཏུ་འཇུག་པའི་ཚེ་།
 ākāṃkṣatāṃ jānumātraṃ kaṭīmātraṃ kakṣamātram,	འདོད་ན་ཆུ་ལོང་བུ་ནུབ་ཙམ་དུ་གནས་སོ་༎
 ākāṃkṣatāṃ kaṇṭhamātraṃ vāri saṃtiṣṭhante ;	འདོད་ན་ཆུ་པུས་མོ་ནུབ་ཙམ་དང་། འདོད་ན་རྐེད་པ་ནུབ་ཙམ་དང་། འདོད་ན་མཆན་ཁུང་ནུབ་ཙམ་དང་། འདོད་ན་མིད་པ་ནུབ་ཙམ་དུ་ཆུ་གནས་པར་འགྱུར་ཏེ་། ལྷའི་དགའ་བ་དག་ཀྱང་འབྱུང་ངོ་༎
 divyāś ca ratayaḥ prādurbhavanti| tatra ye sattvā ākāṃkṣanti : śītaṃ vāri bhavatv iti, teṣāṃ śītaṃ bhavati ;	དེར་སེམས་ཅན་གང་དག་ཆུ་གྲང་བར་གྱུར་ཅིག་སྙམ་དུ་འདོད་ན་ཡང་དེ་དག་ལ་བསིལ་བར་འགྱུར་རོ་༎ 
 ye ākāṃkṣanty : uṣṇaṃ bhavatv iti, teṣām uṣṇaṃ bhavati ;	གང་དག་དྲོ་བར་གྱུར་ཅིག་སྙམ་དུ་འདོད་ན་ཡང་དེ་དག་ལ་དྲོ་བར་འགྱུར་འགྱུར་རོ་༎ རོ་༎ 
 ye ākāṃkṣanti : śītoṣṇaṃ bhavatv iti, teṣāṃ śītoṣṇam eva tad vāri	གང་དག་བསིལ་བ་དང་། དྲོ་བར་གྱུར་ཅིག་སྙམ་དུ་འདོད་ན་ཡང་དེ་དག་ལ་ཆུ་དེ་བསིལ་བ་དང་དྲོ་བར་འགྱུར་ཏེ་། 
 bhavaty anusukham|	བདེ་བར་འགྱུར་རོ་༎
 tāś ca mahānadyo divyatamālapattrāgarukālānusāritagaroraga- sāracandanavaragandhavāsitavāriparipūrṇāḥ pravahanti ;	ཆུ་ཀླུང་ཆེན་པོ་དེ་དག་ནི་ལྷའི་ཤིང་ཏ་མ་ལའི་ལོ་མ་དང་། ཨཨ་ཀ་རུ་དང་། དུས་ཀྱི་རྗེས་སུ་འབྲང་བ་དང་། རྒྱ་སྤོས་དང་། ཙན་དན་སྤྲུལ་གྱི་སྙིང་པོ་དང་། སྤོས་མཆོག་གིས་བསྒོས་པའི་ཆུས་ཡོངས་སུ་གང་སྟེ་འབབ་པ་།
 divyotpalapadmakumudapuṇḍarīkasaugandhikādipuṣpasaṃcchannā,	ལྷའི་མེ་ཏོག་ཨཽཏཔ་ལ་དང༏་པདམ་དང་། ཀུ་མུ་ཏ་དང་། པདམ་དཀར་པོ་དང་། དྲི་རབ་ཏུ་ཞིམ་པ་དག་གི་མེ་ཏོག་གིས་ཁེབས་པ་། ཁོལ་ཁོལ་དག་ན་བྱ་ངང་པ་དང་། གཞད་དང་། ཁྲུང་ཁྲུང་དང་། ངུར་པ་དང་། ཀ་༄༣༩༦ཨ་༌༎
 haṃsasārasacakravākakāraṇḍavaśukasārikākokilakuṇāla- kalaviṅkamayūrādimanojñasvaratathāgatābhinirmitapakṣi- saṃghaniṣevitapulinā,	རན་ད་བ་དང་། ནེ་ཙོ་དང་། རི་སྐེགས་དང་། ཁུ་བྱུག་དང་། ཀུ་ན་ལ་དང་། ཀ་ལ་པིང་ཀ་དང་། རྨ་བྱ་ལ་སོགས་པ་སྒྲ་ཡིད་དུ་འོང་བ་དང་ལྡན་པ་།
 dhāturāṣṭropaśobhitāḥ, sūpatīrthā,	དེ་བཞིན་གཤེགས་པས་སྤྲུལ་པའི་བྱའི་ཚོགས་ཀྱིས་བསྟེན་པ་། ངང་པ་དང་། ངང་པའི་རྒྱལ་པོ་རྣམས་ཀྱིས་མཛེས་པར་བྱས་པ་དང་། འབབ་སྟེགས་བདེ་བ་།
 vikardamāḥ,	འདམ་རྫབ་མེད་པ་།
 suvarṇavālikāsaṃstīrṇāḥ| tatra yadā te sattvā	གསེར་གྱི་བྱེ་མ་བདལ་བ་དག་གོ་།
 ākāṃkṣanti : īdṛśā asmākam abhiprāyāḥ paripūryantām iti, tadā teṣāṃ tādṛśā evābhiprāyā dharmyāḥ paripūryante| yaś p36	དེ་ན་གང་གི་ཚེ་སེམས་ཅན་དེ་དག་བདག་ཅག་གི་བསམ་པ་འདི་འདྲ་བ་ཡོངས་སུ་རྫོགས་པར་གྱུར་ཅིག་སྙམ་དུ་འདོད་པ་དེའི་ཚེ་དེ་དག་གི་བསམ་པ་དེ་ལྟ་བུ་དག་ཆོས་དང་ལྡན་པར་ཡོངས་སུ་རྫོགས་པར་འགྱུར་རོ་༎ ཀུན་དགའ་བོ་།
 cāsāv ānanda tasya vāriṇo nirghoṣas tāvad manojño niścarati, yena sarvāvat tad buddhakṣetram abhijñāpyate| tatra ye sattvā nadītīreṣu sthitā ākāṃkṣanti : māsmākam ayaṃ śabdaḥ śrotrendriyābhāsam āgacchann iti, teṣāṃ sa divyasyāpi śrotrendriyasyābhāsaṃ nāgacchati| yaś ca yaś ca yathārūpaṃ	ཆུ་དེ་ལས་ཡིད་དུ་འོང་བའི་སྒྲ་འབྱུང་བ་གང་ཡིན་པ་དེས་སངས་རྒྱས་ཀྱི་ཞིང་དེར་ཐམས་ཅད་དང་ལྡན་པའི་འཁོར་ལ་གོ་བར་བྱེད་དོ་༎ དེ་ན་སེམས་ཅན་གང་དག་ཆུ་ངོགས་ན་འཁོད་པ་དག་སྒྲ་འདི་བདག་ཅག་གི་རྣ་བའི་དབང་པོ་ལ་གྲགས་པར་མ་གྱུར་ཅིག་ཅེས་འདོད་ན་དེ་དེ་དག་གི་ལྷའི་རྣ་བའི་དབང་པོ་ལ་གྲགས་པར་མི་འགྱུར་རོ་༎
 śabdam ākāṃkṣanti śrotuṃ, sa tathārūpam evaṃ manojñaṃ śabdaṃ śṛṇoti ;	གང་སྒྲ་རྣམ་པ་ཇི་ལྟ་བུ་ཐོས་པར་འདོད་པ་དེ་རྣམ་པ་དེ་ལྟ་བུའི་སྒྲ་ཡིད་དུ་འོང་བ་ཐོས་སོ་༎
 tad yathā ; buddhaśabdaṃ, dharmaśabdam, saṃghaśabdaṃ, pāramitāśabdaṃ, bhūmiśabdaṃ, balaśabdaṃ, vaiśāradyaśabdam,	འདི་ལྟ་སྟེ་།
 āveṇikabuddhadharmaśabdam, abhijñāśabdam, pratisaṃvicchabdaṃ śūnyatānimittāpraṇihitānabhisaṃskāra- ajātānutpādābhāvanirodhaśabdaṃ, śāntapraśāntopaśānta- śabdaṃ, mahāmaitrīmahākaruṇāmahāmuditāmahopekṣāśabdam, anutpattikadharmakṣāntyabhiṣekabhūmipratilambhaśabdaṃ ca	སངས་རྒྱས་ཀྱི་སྒྲ་དང་། ཆོས་ཀྱི་སྒྲ་དང་། དགེ་འདུན་གྱི་སྒྲ་དང་། ཕ་རོལ་ཏུ་ཕྱིན་པའི་སྒྲ་དང་། སའི་སྒྲ་དང་། སྟོབས་ཀྱི་སྒྲ་དང་། མི་འཇིགས་པའི་སྒྲ་དང་། སངས་རྒྱས་ཀྱི་ཆོས་མ་འདྲེས་པའི་སྒྲ་དང་། མངོན་པར་ཤེས་པའི་སྒྲ་དང་། ༄༣༩༦བ་སོ་སོ་ཡང་དག་པར་རིག་པའི་སྒྲ་དང་། སྟོང་པ་ཉིད་དང་། མཚན་མ་མེད་པ་དང་། སྨོན་པ་མེད་པ་དང་། མངོན་པར་འདུ་བྱ་བ་མེད་པ་དང་། མ་སྐྱེས་པ་དང་། མ་བྱུང་བ་དང་། དངོས་པོ་མེད་པ་དང་། འགག་པ་མེད་པའི་སྒྲ་དང་། ཞི་བ་དང་། རབ་ཏུ་ཞི་བ་དང་། ཉེ་བར་ཞི་བའི་སྒྲ་དང་། བྱམས་པ་ཆེན་པོ་དང་། སྙིང་རྗེ་ཆེན་པོ་དང་། དགའ་བ་ཆེན་པོ་དང་། བཏང་སྙོམས་ཆེན་པོའི་སྒྲ་དང་། མི་སྐྱེ་བའི་ཆོས་ལ་བཟོད་པ་དང་། དབང་བསྐུར་བའི་ས་རབ་ཏུ་ཐོབ་པའི་སྒྲ་དག་ཐོས་སོ་༎
 śṛṇoti| ta evaṃrūpāṃś chabdāṃś chrutvodāraprītiprāmodyaṃ pratilabhante, vivekasahagataṃ, virāgasahagataṃ, śāntasahagataṃ, nirodhasahagataṃ, dharmasahagataṃ, bodhi-	དེས་སྒྲ་རྣམ་པ་དེ་ལྟ་བུ་ཐོས་ནས་དགའ་བ་དང་། མཆོག་ཏུ་དགའ་བ་རྒྱ་ཆེན་པོ་ཐོབ་བོ་༎
 pariniṣpattikuśalamūlasahagataṃ ca|	དབེན་པ་དང་ལྡན་པ་དང་། འདོད་ཆགས་དང་བྲལ་བ་དང་ལྡན་པ་དང་། ཞི་བ་དང་ལྡན་པ་དང་། འགོག་པ་དང་ལྡན་པ་དང་། ཆོས་དང་ལྡན་པ་དང་། བྱང་ཆུབ་ཡོངས་སུ་འགྲུབ་པའི་དགེ་བའི་རྩ་བ་དང་ལྡན་པའི་སྒྲ་འབྱུང་ངོ་༎ ཀུན་དགའ་བོ་།
 sarvaśaś cānanda sukhāvatyāṃ lokadhātāv akuśalaśabdo	འཇིག་རྟེན་གྱི་ཁམས་བདེ་བ་ཅན་ན་མི་དགེ་བའི་མིང་མེད་དོ་༎
 nāsti ; sarvaśo nīvaraṇaśabdo nāsti ;	སྒྲིབ་པའི་སྒྲ་ཡང་ཡོང་མེད་དོ་༎
 sarvaśo 'pāyadurgativinipāta- śabdo nāsti ;	ངན་སོང་ངན་འགྲོ་རྣམ་པར་ལྟུང་བའི་སྒྲ་ཡང་ཡོང་མེད་དོ་༎
 sarvaśo duḥkhaśabdo nāsti ;	སྡུག་བསྔལ་གྱི་སྒྲ་ཡང་ཡོང་མེད་དོ་༎ ཀུན་དགའ་བོ་།
 aduḥkhāsukha- vedanāśabdo 'pi tāvad ānanda tatra nāsti ;	དེ་ན་སྡུག་བསྔལ་ཡང་མ་ཡིན་། བདེ་བ་ཡང་མ་ཡིན་པའི་ཚོར་བའི་སྒྲ་ཡང་མེད་ན་།
 kutaḥ punar duḥkhaṃ duḥkhaśabdo vā bhaviṣyati| p37	སྡུག་བསྔལ་དང་། སྡུག་བསྔལ་གྱི་སྒྲ་ལྟ་ག་ལ་ཡོད་།
 tad anenānanda paryāyeṇa sā lokadhātuḥ sukhāvaty	ཀུན་དགའ་བོ་། མདོར་བསྡུ་ན་རྣམ་གྲངས་འདིས་འཇིག་རྟེན་གྱི་ཁམས་དེ་བདེ་བ་ཅན་ཞེས་བྱ་སྟེ་།
 ucyate saṃkṣiptena,	རྒྱས་པར་ནི་མ་ཡིན་ནོ་༎ ཀུན་དགའ་བོ་། རྒྱས་པར་བྱེད་༄༣༩༧ཨ་༌༎
 na punar vistareṇa| kalpo 'pi parikṣayaṃ gacchet, sukhāvatyāṃ lokadhātau sukhakāraṇeṣu parikīrtayamāneṣu ; na tv eva śakyaṃ teṣāṃ sukhakāraṇānāṃ	ན༏་བསྐལ་པའམ་བསྐལ་པ་ལས་ལྷག་པར་ཟད་ཟད་དུ་འཇིག་རྟེན་གྱི་ཁམས་བདེ་བ་ཅན་གྱི་བདེ་བའི་རྒྱུ་ཡོངས་སུ་བརྗོད་ཀྱང་བདེ་བའི་རྒྱུ་དེ་དག་གི་མཐའ་རྟོགས་པར་མི་ནུས་སོ་༎
 paryanto 'dhigantum| tasyāṃ khalu punar ānanda sukhāvatyāṃ lokadhātau ye sattvāḥ pratyājātāḥ pratyājaniṣyante vā, sarve ta evaṃrūpeṇa varṇena, balena, sthāmnārohapariṇāhenādhipatyena, puṇya- saṃcayenābhijñābhir vastrābharaṇodyānavimānakūṭāgāra- paribhogair,	ཀུན་དགའ་བོ་།
 evaṃrūpaśabdagandharasasparśāparibhogair, evaṃrūpaiś ca sarvopabhogaparibhogaiḥ samanvāgatāḥ ; tad	འཇིག་རྟེན་གྱི་ཁམས་བདེ་བ་ཅན་དེར་སེམས་ཅན་གང་དག་སྐྱེས་པ་དང་། སྐྱེ་བ་དང་། སྐྱེ་བར་འགྱུར་བ་དེ་དག་ཐམས་ཅད་ཀྱང་གཟུགས་དང་། ཁ་དོག་དང་། སྟོབས་དང་། མཐུ་དང་། ཆུ་ཞེང་དང་། དབང་དང་། བསོད་ནམས་བསགས་པ་དང་། མངོན་པར་ཤེས་པ་དག་དང་། གོས་དང་། རྒྱན་དང་། སྐྱེད་མོས་ཚལ་དང་། གཞལ་མེད་ཁང་དང་། ཁང་པ་བརྩེགས་པ་ཡོངས་སུ་སྤྱད་པ་རྣམ་པ་དེ་ལྟ་བུ་དག་དང་། གཟུགས་དང་། སྒྲ་དང་། དྲི་དང་། རོ་དང་། རེག་བྱ་ཡོངས་སུ་སྤྱད་པ་རྣམ་པ་དེ་ལྟ་བུ་དག་དང་། ལོངས་སྤྱོད་དང་། ཡོངས་སུ་སྤྱད་པ་རྣམ་པ་དེ་ལྟ་བུ་ཐམས་ཅད་དང་ལྡན་ཏེ་།
 yathāpi nāma devāḥ paranirmitavaśavartinaḥ|	དཔེར་ན་། གཞན་འཕྲུལ་དབང་བྱེད་ཀྱི་ལྷ་རྣམས་དང་འདྲའོ་༎ ཀུན་དགའ་བོ་།
 na khalu punar ānanda sukhāvatyāṃ lokadhātau sattvā audārikaṃ kavaḍīkārāhāram āharanti| api tu khalu punar	འཇིག་རྟེན་གྱི་ཁམས་བདེ་བ་ཅན་གྱི་སེམས་ཅན་དག་ཁམ་གྱི་ཟས་ཟ་བ་རགས་པའི་ཁ་ཟས་མི་ཟའི་། 
 yathārūpam evāhāram ākāṃkṣanti, tathārūpam āhṛtam eva	ཁ་ཟས་རྣམ་པ་ཇི་ལྟ་བུ་འདོད་པ་རྣམ་པ་དེ་ལྟ་བུ་འབྱོར་པ་ཉིད་མི་ཟའི་། 
 saṃjānanti| prīṇitakāyāś ca bhavanti,	།
 prīṇitagātrāḥ| na	གཟུགས་ཚིམ་པར་འགྱུར་རོ་༎
 teṣāṃ bhūyaḥ kāye prakṣepaḥ karaṇīyaḥ| te prīṇitakāyās	ཞེས་དེ་དག་ཡང་ལུས་ལ་འཇུག་པར་མི་བྱེད་དོ་༎
 tathārūpāni gandhajātāny ākāṃkṣanti, tādṛśair eva gandhajātair divyais tad-buddhakṣetraṃ sarvam eva nirdhūpitaṃ	དེ་དག་ལུས་ཚིམ་ནས་སྤོས་ཀྱི་རྣམ་པ་ཇི་ལྟ་བུ་འདོད་པ་དེ་ལྟ་བུའི་ལྷའི་སྤོས་ཀྱི་རྣམ་པ་དག་གིས་སངས་རྒྱས་ཀྱི་༄༣༩༧བ་ཞིང་ཐམས་ཅད་བདུགས་པར་འགྱུར་རོ་༎
 bhavati| tatra yas taṃ gandhaṃ nāghrātukāmo bhavati, tasya sarvaśo gandhasaṃjñāvāsanāpi na samudācarati| evaṃ	དེ་ན་གང་དྲི་དེ་ལ་སྣོམ་པར་མི་འདོད་པ་དེ་ལ་སྤོས་དྲིའི་འདུ་ཤེས་དང་། བསྒོས་པ་ཙམ་ཡང་འབྱུང་བར་མི་འགྱུར་རོ་༎
 ye yathārūpāṇi gandhamālyavilepanacūrṇacīvaracchatradhvaja- patākātūryāṇy ākāṃkṣanti, teṣāṃ tathārūpair evaṃ taiḥ sarvaṃ tad-buddhakṣetraṃ parisphuṭaṃ bhavati|	དེ་ལྟར་གང་དག་སྤོས་དང༏་ཕྲེང་བ་དང་། བྱུག་པ་དང་། ཕྱེ་མ་དང་། གདུགས་དང་། རྒྱལ་མཚན་དང་། བ་དན་དང་། སིལ་སྙན་རྣམ་པ་ཇི་ལྟ་བུ་དག་འདོད་པ་དེ་དག་གི་རྣམ་པ་དེ་ལྟ་བུ་དེ་དག་གིས་སངས་རྒྱས་ཀྱི་ཞིང་དེ་ཐམས་ཅད་ཡོངས་སུ་ཁྱབ་པར་འགྱུར་རོ་༎
 te yādṛśāni cīvarāṇy ākāṃkṣanti nānāvarṇāny anekaśata- p38	དེ་དག་གོས་ཁ་དོག་ཐ་དད་པ་།
 sahasravarṇāni, teṣāṃ tādṛśair eva cīvararatnaiḥ samaṃ tad- buddhakṣetraṃ parisphuṭaṃ bhavati ; prāvṛtam eva cātmānaṃ saṃjānanti| te yathārūpāṇy ābharaṇāny ākāṃkṣanti,	ཁ་དོག་བརྒྱ་སྟོང་དུ་མ་ཅི་འདྲ་བ་འདོད་པ་དེ་ལྟ་བུའི་གོས་རིན་པོ་ཆེ་དག་གིས་སངས་རྒྱས་ཀྱི་ཞིང་དེ་ཐམས་ཅད་ཡོངས་སུ་ཁྱབ་པར་འགྱུར་ཞིང་ལུས་ལ་བགོས་པར་བདག་ཉིད་ཀྱིས་ཤེས་སོ་༎ 
 tad yathā : śīrṣābharaṇāni	དེ་དག་འདི་ལྟ་སྟེ་། མགོ་བོའི་རྒྱན་ནམ་།
 vā, karṇābharaṇāni vā,	རྣ་བའི་རྒྱན་ནམ་།
 grīvahastapādābharaṇāni vā, yad idaṃ : makuṭāni, kuṇḍalāni, kaṭakāṃ, keyūrāṃ, vatsahārāṃ, rūcakahārāṃ, karṇikā, mudrikāḥ, suvarṇasūtrāṇi mekhalāḥ, suvarṇajālāni,	མགུལ་པ་དང་། ལག་པ་དང༏་རྐང་པའི་རྒྱན་འདི་ལྟ་སྟེ་།
 sarvaratnakaṃkaṇījālāni, te tathārūpair ābharaṇair anekaratnaśatasahasrapratyuptaiḥ sphuṭaṃ	ཅོད་པན་དང་། རྣ་ཆ་དང་། གདུ་བུ་དང་། དཔུང་རྒྱན་དང་། དོ་ཤལ་དང་། སེ་མོ་དོ་དང་། རྣ་རྒྱན་དང་། སོར་གདུབ་དང་། གསེར་གྱི་ཙོང་ཙོང་དང་། སྐ་རགས་དང་། གསེར་གྱི་དྲ་བ་དང་། མུ་ཏིག་གི་དྲ་བ་དང་། རིན་པོ་ཆེ་ཐམས་ཅད་ཀྱི་དྲིལ་བུ་ག-ཡེར་ཁའི་དྲ་བ་དང་། རྒྱན་ཇི་ལྟ་བུ་འདོད་པ་རྣམ་པ་དེ་ལྟ་བུའི་རྒྱན་རིན་པོ་ཆེ་བརྒྱ་སྟོང་དུ་མས་སྤྲས་པ་འདི་ལྟ་སྟེ་།
 tad-buddhakṣetraṃ paśyanti sma| yad idam : ābharaṇavṛkṣa-	རིན་པོ་ཆེའི་ཤིང་ལྗོན་པ་ལ་འཕྱང་བས་སངས་རྒྱས་ཀྱི་ཞིང་དེ་གང་བར་མཐོང་སྟེ་།
 vastrais taiś cābharaṇair alaṃkṛtam ātmānaṃ saṃjānanti|	རྒྱན་དེ་དག་གིས་བདག་བརྒྱན་པར་ཡང་ཤེས་སོ་༎
 te yādṛśaṃ vimānam ākāṃkṣanti, yad varṇaliṅgasaṃsthānaṃ, yāvad ārohapariṇāho,	དེ་དག་གང་ཁ་༄༣༩༨ཨ་༌༎
 nānāratnamayaniryūhaśata- sahasrasamalaṃkṛtaṃ, nānādivyadūṣyasaṃstīrṇaṃ, vicitropadhāna-	དོག་དང་། རྟགས་དང་། དབྱིབས་དང་། ཆུ་ཞེང་གི་བར་དང་། རིན་པོ་ཆེ་སྣ་ཚོགས་ཀྱི་བ་གམ་བརྒྱ་སྟོང་གིས་བརྒྱན་པ་རིན་པོ་ཆེའི་ཁྲི་ལྷའི་རས་བཅོས་བུ་སྣ་ཚོགས་བཏིང་བ་།
 vinyastaratnaparyaṅkaṃ, tādṛśam eva vimānaṃ teṣāṃ purataḥ prādurbhavati| te teṣu manobhinirvṛteṣu vimāneṣu	སྔས་ཁྲ་བོ་བཞག་པ་དང་ལྡན་པའི་གཞལ་མེད་ཁང་ཇི་ལྟ་བུ་འདོད་པ་དེ་ལྟ་བུའི་གཞལ་མེད་ཁང་དེ་དག་དེ་དག་གི་མདུན་དུ་འབྱུང་སྟེ་། 
 saptāpsaraḥsahasraparivṛtāḥ puraskṛtā viharanti, krīḍanti	དེ་དག་རིན་པོ་ཆེའི་གཞལ་མེད་ཁང་གྲུབ་པ་དེ་དག་གི་ནང་ན་ལྷའི་བུ་མོ་བདུན་སྟོང་བདུན་སྟོང་གིས་ཡོངས་སུ་བསྐོར་ཞིང་མདུན་གྱིས་བལྟས་ནས་འཁོད་དེ་།
 ramante paricārayanti|	རྩེ་ཞིང་དགའ་ལ་དགའ་མགུར་སྤྱོད་དོ་༎
 na ca tatra lokadhātau devānāṃ manuṣyāṇāṃ vā nānātvam	འཇིག་རྟེན་གྱི་ཁམས་དེ་ན་ལྷ་དང་མི་རྣམས་ཐ་དད་པ་མེད་དེ་།
 asti, anyatra saṃvṛtivyavahāreṇa devā manuṣyā veti saṃkhyāṃ	གཞན་དུ་ན་ཀུན་རྫོབ་ཀྱི་ཐ་སྙད་ཀྱིས་ལྷ་དང་མི་ཞེས་བྱ་བའི་གྲངས་སུ་འགྲོ་བ་ནི་མ་གཏོགས་སོ་༎ ཀུན་དགའ་བོ་།
 gacchati| tad yathānanda,	འདི་ལྟ་སྟེ་། དཔེར་ན་།
 rājñaś cakravartinaḥ purato manuṣyahīno manuṣyaṣaṇḍako na bhāsate,	འཁོར་ལོའི་བསྒྱུར་བའི་རྒྱལ་པོའི་མདུན་ན་མི་མ་རབས་དང་། མི་ཟ་མ་ནི་ལམ་མེ་མ་ཡིན་།
 na tapati,	ལྷན་ནེ་མ་ཡིན་།
 na virocate, na bhavati viśārado, na prabhāsvara,	ལྷང་ངེ་མ་ཡིན་ཞིང་མི་འཇིགས་པ་མ་ཡིན་ལ་འོད་གསལ་བ་མ་ཡིན་ནོ་༎
 evam eva devānāṃ paranirmitavaśavartināṃ purataḥ śakro devendro na bhāsate, p39	དེ་བཞིན་དུ་གཞན་འཕྲུལ་དབང་བྱེད་ཀྱི་ལྷ་རྣམས་ཀྱི་མདུན་ན་ལྷའི་དབང་པོ་བརྒྱ་བྱིན་ཡང་འདི་ལྟ་སྟེ་། 
 na tapati, na virocate, yad idam : udyānavimānavastrābharaṇair, ādhipatyena vā,	སྐྱེད་མོས་ཚལ་དང་། གཞལ་མེད་ཁང་དང་། གོས་དང་། རྒྱན་དང་། དབུང་དང་། རྫུ་འཕྲུལ་དང་། ཆོ་འཕྲུལ་དང་། དབང་ཕྱུག་གིས་ལམ་མེ་མ་ཡིན་།
 rddhyā vā, prātihāryeṇa vaiśvaryeṇa	ལྷན་ནེ་མ་ཡིན་། ལྷང་ངེ་མ་ཡིན་ཏེ་།
 vā ; na tu khalu punar dharmābhisamayena dharmaparibhogena	ཆོས་མངོན་པར་རྟོགས་པ་དང་། ཆོས་ལ་ཡོངས་སུ་སྤྱོད་པ་ནི་མ་གཏོགས་སོ་༎ ༄༣༩༨བ་ཀུན་དགའ་བོ་།
 vā| tatrānanda yathā devāḥ paranirmitavaśavartina evaṃ sukhāvatyāṃ lokadhātau manuṣyā draṣṭavyāḥ|	དེ་ལ་གཞན་འཕྲུལ་དབང་བྱེད་ཀྱི་ལྷ་རྣམས་ཅི་འདྲ་བ་དེ་འདྲ་བར་བདེ་བ་ཅན་གྱི་འཇིག་རྟེན་གྱི་ཁམས་ཀྱི་མི་རྣམས་བལྟ་བར་བྱའོ་༎ ཀུན་དགའ་བོ་།
 tasyāṃ khalu punar ānanda sukhāvatyāṃ lokadhātau pūrvāhna- kālasamaye pratyupasthite, samantāc caturdiśam ākula- samākulā vāyavo vānti, yenātra ratnavṛkṣāṃś citrān,	འཇིག་རྟེན་གྱི་ཁམས་བདེ་བ་ཅན་དེ་ན་སྔ་དྲོའི་དུས་ཉེ་བར་གནས་པའི་ཚེ་ཕྱོགས་བཞི་ཀུན་ནས་འཁྲུགས་ཤིང་ཀུན་དུ་འཁྲུགས་པའི་རླུང་ལྡང་སྟེ་། དེ་དག་གིས་རིན་པོ་ཆེའི་ཤིང་ལྗོན་པ་བཀྲ་བ་།
 darśanīyān,	བལྟ་ན་སྡུག་པ་།
 nānāvarṇān,	ཁ་དོག་ཐ་དད་པ་།
 anekavarṇān,	ཁ་དོག་དུ་མ་ཡོད་པ་།
 nānāsurabhidivyagandhaparivāsitān kṣobhayanti,	ལྷའི་སྤོས་དྲི་རབ་ཏུ་ཞིམ་པ་སྣ་ཚོགས་ཀྱིས་བསྒོ་ས་པ་དེ་དག་བསྐྱོད་།
 saṃkṣobhayanti,	ཀུན་དུ་བསྐྱོད་།
 īrayanti,	བསྒུལ་།
 samīrayanti ; yato bahūni puṣpaśatāni tasyāṃ ratnamayyāṃ pṛthivyāṃ prapatanti manojñagandhāni darśanīyāni| taiś ca puṣpais	ཀུན་དུ་བསྒུལ་ནས་དེ་དག་ལ་ས་མེ་ཏོག་རྣམ་པ་མང་པོ་ཡིད་དུ་འོང་བའི་བསུང་ཅན་བལྟ་ན་སྡུག་པ་དག་རིན་པོ་ཆེའི་ས་ཆེན་པོ་དེ་ལ་འབྲུལ་ཏེ་།
 tadbuddhakṣetraṃ samantāt saptapauruṣaṃ saṃskṛtaṃ rūpaṃ	མེ་ཏོག་དེ་དག་གིས་སངས་རྒྱས་ཀྱི་ཞིང་དེ་ཀུན་དུ་མི་འགྲེང་བ་བདུན་སྲིད་དུ་བཀྲམ་པར་འགྱུར་རོ་༎ 
 bhavati| tad yathāpi nāma kaścid eva puruṣaḥ kuśalaḥ	འདི་ལྟ་སྟེ༏་དཔེར་ན་།
 pṛthivyāṃ puṣpasaṃstaraṃ saṃstṛṇuyād, ubhābhyāṃ pāṇibhāṃ samaṃ racayet sucitraṃ darśanīyam, evam etad	སྐྱེས་བུ་ས་ལ་མེ་ཏོག་འགྲེམས་མཁས་པ་ཞིག་གིས་ལག་པ་གཉིས་ཀས་བཀྲམ་སྟེ་མཉམ་པར་བཀོད་ན་ཤིན་ཏུ་བཀྲ་ཞིང་བལྟ་ན་སྡུག་གོ་།
 buddhakṣetraṃ taiḥ puṣpair nānāgandhavarṇaiḥ samantāt	དེ་བཞིན་དུ་མེ་ཏོག་བསུང་དང་། ཁ་དོག་ཐ་དད་པ་དང་ལྡན་པ་དེ་དག་གིས་སངས་རྒྱས་ཀྱི་ཞིང་དེ་ཀུན་དུ་མི་འགྲེང་བདུན་ཙམ་དུ་ཁྱབ་པར་འགྱུར་རོ་༎
 saptapauruṣaṃ sphuṭaṃ bhavati| tāni ca puṣpajātāni mṛdūni	མེ་ཏོག་གི་རྣམ་པ་དེ་དག་ནི་འཇམ་པ་སྟེ་།
 kācalindikasukhasaṃsparśāny ; aupamyamātreṇa yāni nikṣipte pāde caturaṅgulam eva namanty, utkṣipte pāde caturaṅgulam	དཔེ་ཙམ་དུ་ན་གོས་ཀ་ཙ་ལིན་ད་ལྟར་རེག་ན་བདེ་བའོ༏་༏དེ་དག་ནི་རྐང་པ་འཇོག་པ་ན་སོར་བཞི་ཙམ་གྱིས་དམའ་བར་འགྱུར་ཞིང་། རྐང་པ་འདེགས་པ་ན་སོར་བཞི་ཙམ་གྱིས་མཐོ་བར་འགྱུར་རོ་༎
 evānamanti| nirgate punaḥ pūrvāhnakālasamaye, tāni puṣpāni niravaseṣam antardhīyante|	སྔ་དྲོའི་དུས་འདས་ནས་མེ་ཏོག་དེ་དག་ཀྱང་མ་༄༣༩༩ཨ་༌༎ ལུས་པར་མེད་པར་འགྱུར་ཏེ་།
 atha tad-buddhakṣetraṃ viviktaṃ, ramyaṃ, śubhaṃ bhavaty, aparikliṣṭais taiḥ pūrvapuṣpaiḥ| tataḥ punar	དེའི་འོག་ཏུ་སངས་རྒྱས་ཀྱི་ཞིང་བདེ་བ་དང་། ཉམས་དགའ་བ་དང་། དག་པར་འགྱུར་ཞིང་མེ་ཏོག་སྔ་མ་རྣམས་ཀྱིས་རྙོགས་པ་མེད་པར་འགྱུར་རོ་༎
 api samantāc caturdiśaṃ vāyavo vānti,	དེ་ནས་ཡང་ཕྱོགས་བཞི་ཀུན་ནས་རླུང་ལངས་ཏེ་།
 ye pūrvavad abhinavāni puṣpāṇy abhiprakiranti| yathā pūrvāhna eva madhyāhne, p40	གང་སྔོན་མ་བྱུང་བའི་མེ་ཏོག་སར་པ་དག་མངོན་པར་འཐོར་རོ་༎
 'parāhne kālasamaye, saṃdhyāyāṃ, rātryāḥ prathame yāme, madhyame paścime ca yāme| taiś ca vātair vāyadbhir	སྔ་དྲོ་ཇི་ལྟ་བར་ཉི་མའི་གུང་དང་། ཕྱི་དྲོའི་དུས་ཀྱི་ཚེ་དང་། མཚན་མོ་ཡང་སྲོད་དང་། ནམ་གྱི་གུང་དང་། ཐོ་རངས་ཀྱང་དེ་བཞིན་ནོ་༎
 nānāgandhaparivāsitais te sattvāḥ spṛṣṭāḥ santa, evaṃ sukhasamarpitā bhavanti sma,	སྤོས་དང་། དྲི་སྣ་ཚོགས་ཀྱིས་བསྒོས་པའི་རླུང་དེ་དག་ལངས་ནས་སེམས་ཅན་དེ་དག་ལ་རེག་ན་འདི་ལྟ་སྟེ་། 
 tad yathāpi nāma nirodhasamāpanno bhikṣuḥ|	དཔེར་ན་། དགེ་སློང་འགོག་པ་ལ་སྙོམས་པར་ཞུགས་ལྟ་བུའི་བདེ་བ་དང་ལྡན་པར་འགྱུར་རོ་༎ ཀུན་དགའ་བོ་།
 tasmiṃś cānanda buddhakṣetre sarvaśo 'gnicandrasūrya- grahanakṣatratārārūpānāṃ tamo'ndhakārasya ca nāmadheya-	སངས་རྒྱས་ཀྱི་ཞིང་དེ་ན་དེ་བཞིན་གཤེགས་པས་བསྙད་པ་མ་གཏོགས་པར་མེ་དང་། ཉི་མ་དང་། ཟླ་བ་དང་། གཟའ་དང་། རྒྱུ་སྐར་དང་། སྐར་མའི་གཟུགས་དང་། མུན་པ་མུན་ནག་གི་མིང་དུ་གདགས་པ་ཡོང་མེད་དོ་༎
 prajñaptir api nāsti| sarvaśo rātridivaprajñaptir api	ཉིན་མོ་དང་མཚན་མོར་གདགས་པ་ཡང་ཡོང་མེད་དོ་༎
 nāsty, anyatra tathāgatavyavahārāt| sarvaśaś cāgāraparigraha- saṃjñā nāsti|	ཁྱིམ་ཡོངས་སུ་འཛིན་པའི་འདུ་ཤེས་ཀྱང་ཡོང་མེད་དོ་༎ ཀུན་དགའ་བོ་།
 tasyāṃ khalu punar ānanda sukhāvatyāṃ lokadhātau kāle divyagandhodakameghā abhipravarṣanti| divyāni sarva- varṇikāni kusumāni,	འཇིག་རྟེན་གྱི་ཁམས་བདེ་བ་ཅན་དེ་ན་དུས་དུས་སུ་ལྷའི་སྤོས་ཆུའི་སྤྲིན་གྱི་ཆར་མངོན་པར་འབབ་བོ་༎ 
 divyāni saptaratnāni, divyaṃ candana- cūrṇaṃ, divyāś cchatradhvajapatākā abhipravarṣanti| divyāni	ལྷའི་མེ་ཏོག་ཁ་དོག་ཐམས་ཅད་དང་ལྡན་པ་དག་དང་། ལྷའི་རིན་པོ་ཆེ་སྣ་བདུན་དང་། ལྷའི་ཙན་དན་གྱི་ཕྱེ་མ་དང་། ལྷའི་གདུགས་དང་། རྒྱལ་མཚན་དང་། བ་༄༣༩༩བ་དན་གྱི་ཆར་མངོན་པར་འབབ་བོ་༎
 vimānāni, divyāni vitānāni dhriyante,	ལྷའི་བླ་རེ་དག་ཀྱང་འཛིན་ཏོ་༎
 divyāni ratnacchatrāṇi	ལྷའི་རིན་པོ་ཆེའི་གདུགས་རྔ་མའི་བསིལ་ཡབ་དང་བཅས་པ་དག་ཀྱང་ནམ་མཁའ་ལ་འཛིན་ཏོ་༎
 sacāmarāṇy ākāśe dhriyante| divyāni vādyāni pravādyante| divyāś cāpsaraso nṛtyanti sma|	ལྷའི་རོལ་མོའི་དབྱངས་སྒྲ་དག་ཀྱང་སྒྲོགས་ཤིང་ལྷའི་བུ་མོ་དག་ཀྱང་གར་བྱེད་དོ་༎ ཀུན་དགའ་བོ་།
 tasmin khalu punar ānanda buddhakṣetre ye sattvā upapannā utpadyanta upapatsyante, sarve te niyatāḥ samyaktve	སངས་རྒྱས་ཀྱི་ཞིང་དེར་སེམས་ཅན་གང་དག་སྐྱེས་པ་དང་། སྐྱེ་བ་དང་། སྐྱེ་བར་འགྱུར་བ་དེ་དག་ཐམས་ཅད་མྱ་ངན་ལས་འདས་ཀྱི་བར་དུ་ཡང་དག་པ་ཉིད་དུ་ངེས་པར་འགྱུར་རོ་༎
 yāvan nirvāṇāt| tat kasya hetoḥ| nāsti tatra dvayo rāśyor vyavasthānaṃ prajñaptir vā,	དེ་ཅིའི་ཕྱིར་ཞེ་ན་།
 yad idam : aniyatyasya	དེ་ནི་འདི་ལྟ་སྟེ་།
 vā mithyātvaniyatasya vā| tad anenāpy ānanda paryāyeṇa	མ་ངེས་པ་དང་། ལོག་པ་ཉིད་དུ་ངེས་པའི་ཕུང་པོ་གཉིས་རྣམ་པར་བཞག་པའམ་། གདགས་པ་མེད་པའི་ཕྱིར་རོ་༎ ཀུན་དགའ་བོ་།
 sā lokadhātuḥ sukhāvatīty ucyate saṃkṣiptena, na vistareṇa|	མདོར་བསྡུ་ན་རྣམ་གྲངས་འདིས་འཇིག་རྟེན་གྱི་ཁམས་དེ་བདེ་བ་ཅན་ཞེས་བྱ་སྟེ་རྒྱས་པར་ནི་མ་ཡིན་ནོ་༎ 
 kalpo 'py ānanda parikṣayet, sukhāvatyāṃ lokadhātau	ཀུན་དགའ་བོ་།
 sukhakāraṇeṣu parikīrtayamāneṣu ; na ca teṣāṃ sukhakāraṇānāṃ p41 śakyaṃ paryanto 'dhigantum|	རྒྱས་པར་བསྟན་ན་ནི་བསྐལ་པ་ཟད་ཟད་དུ་འཇིག་རྟེན་གྱི་ཁམས་བདེ་བ་ཅན་གྱི་བདེ་བའི་རྒྱུ་རྣམས་ཡོངས་སུ་བརྗོད་ཀྱང་བདེ་བའི་རྒྱུ་དེ་དག་གི་མཐའ་རྟོགས་པར་མི་ནུས་སོ་༎
 atha khalu bhagavāṃs tasyāṃ velāyām imā gāthā abhāṣata : sarve pi sattvāḥ sugatā bhaveyuḥ,	དེ་ནས་དེའི་ཚེ་བཅོམ་ལྡན་འདས་ཀྱིས་ཚིགས་སུ་བཅད་པ་འདི་དག་བཀའ་སྩལ་ཏོ་༎ སེམས་ཅན་ཐམས་ཅད་བདེ་བར་གཤེགས་གྱུར་ལ་༎
 viśuddhajñānāḥ paramārthakovidā|	དམ་པའི་དོན་མཁས་ཡེ་ཤེས་རྣམ་དག་སྟེ་།
 te kalpakoṭīm atha vāpi uttarim, sukhāvatīvarṇa prakāśayeyuḥ|(1)	དེ་དག་བསྐལ་པའམ་འོན་ཏེ་ལྷག་པར་ནི་༎ བདེ་བ་ཅན་གྱི་བསྔགས་པ་རབ་བརྗོད་ཀྱང་༎ བསྔགས་པའི་ཕྲེང་བ་རབ་ཏུ་བརྗོད་པ་ན་༎
 kṣaye kalpakoṭīya vrajeyu tāś ca, sukhāvatīye na ca varṇa antaḥ|	བསྐལ་པ་བྱེ་བ་དེ་དག་ཟད་འགྱུར་གྱི་༎ བདེ་བ་ཅན་གྱི་བསྔགས་པ་མཐར་མི་ཕྱིན་༎ དེ་དག་སྤོབས་པ་༄༤༠༠ཨ་༌༎ པའང་ཟད་པར་འགྱུར་མ་ཡིན་༎
 kṣayaṃ na gacchet pratibhā teṣāṃ prakāśayantāna tha varṇamālā|(2) ye lokadhātūṃ paramāṇusadṛśāṃ	གང་གིས་ཕྲ་རབ་རྡུལ་སྙེད་འཇིག་རྟེན་ཁམས་༎ བཤིག་ཅིང་བཏགས་ཏེ་རྡུལ་དུ་བྱས་གྱུར་པ་༎ དེ་བས་མང་བའི་འཇིག་རྟེན་ཁམས་ཀྱི་རྣམས་༎
 cchindeya bhindeya rajāṃś ca kuryāt, ato bahū uttari lokadhātū pūretva dānaṃ ratanehi dadyāt|(3)	རིན་ཆེན་བཀང་སྟེ་སྦྱིན་པ་བྱིན་པ་ནི་༎ གང་གིས་དཔག་ཏུ་མེད་པའི་འོད་མཚན་དང་༎ བདེ་བ་ཅན་གྱི་ཡོན་ཏན་ཁྱད་འཕགས་རྣམས་༎ ཐོས་ནས་དགའ་སྟེ་ཐལ་མོ་སྦྱོར་བྱེད་པ་༎
 na tā kalāṃ pi upamā pi tasya puṇyasya bhontī pṛthulokadhātavaḥ,	བསོད་ནམས་འདི་ཡི་ཆར་ཡང་འགྱུར་མ་ཡིན་༎ དེ་ལྟ་བས་ན་དེ་བཞིན་གཤེགས་པ་དེའི་༎ ཡོན་ཏན་ཐོས་ནས་མགུ་དང་དད་སྐྱེས་ལ་༎
 yal lokadhātūya sukhāvatīye	བདེ་བ་ཅན་གྱི་འཇིག་རྟེན་ཁམས་མཆོག་ཏུ༏་༏འགྲོ་བར་བྱ་ཕྱིར་མོས་པ་དྲག་པོ་བསྐྱེད་༎ གང་གིས་བདེ་བ་ཅན་གྱི་འཇིག་རྟེན་གྱི་༎ མིང་ཐོས་པ་ཡི་བསོད་ནམས་དེ་ལ་ནི་༎ ཞིང་མཆོག་ཐ་གྲུ་ཆེན་པོ་དེ་དག་ཀུན་༎ ཆ་དང་དཔེར་ཡང་འགྱུར་བ་མ་ཡིན་ནོ་༎ གང་དག་རྒྱལ་བའི་བཀའ་དང་ཤེས་རབ་ཅན་༎
 śrutvaiva nāma bhavatīha puṇyaṃ (4) tato bahū puṇya bhaveta teṣāṃ, ye śraddhaṇeya jinavacanasaṃjñā|	དེ་དག་དེ་བས་བསོད་ནམས་མང་དུ་འགྱུར་༎
 śraddhā hi mūlaṃ jagatasya prāptaye,	དོན་དམ་ཐོབ་ཕྱིར་དད་པ་རྩ་བ་སྟེ་༎
 tasmād dhi śrutvā vimatiṃ vinodayed, iti|(5)	དེ་ལྟ་བས་ན་ཐོས་ནས་ཡིད་གཉིས་སོལ་༎
 evam aprameyaguṇavarṇā ānanda sukhāvatī lokadhātuḥ| tasya khalu punar ānanda bhagavato 'mitābhasya tathāgatasya p42	ཀུན་དགའ་བོ་། འཇིག་རྟེན་གྱི་ཁམས་བདེ་བ་ཅན་གྱི་ཡོན་ཏན་དང་བསྔགས་པ་དེ་ལྟར་དཔག་ཏུ་མེད་དོ་༎ ཀུན་དགའ་བོ་།
 daśasu dikṣv ekaikasyāṃ diśi gaṅgānadīvālukāsameṣu buddhakṣetreṣu gaṅgānadīvālukāsamā buddhā bhagavanto nāmadheyaṃ parikīrtayante,	ཕྱོགས་བཅུའི་ཕྱོགས་རེ་རེ་ཡང་སངས་རྒྱས་ཀྱི་ཞིང་གངགའའི་ཀླུང་གི་བྱེ་མ་སྙེད་དག་ན་སངས་རྒྱས་བཅོམ་ལྡན་འདས་གངགའའི་ཀླུང་གི་བྱེ་མ་སྙེད་དག་བཅོམ་ལྡན་འདས་དེ་བཞིན་གཤེགས་པ་འོད་དཔག་མེད་དེའི་མཚན་ཡོངས་སུ་བརྗོད་༄༤༠༠བ་དོ་༎
 varṇaṃ bhāṣante, yaśaḥ	བསྔགས་པ་གསུང་ངོ་༎
 prakāśayanti,	གྲགས་པ་རབ་ཏུ་སྒྲོགས་སོ་༎
 guṇam udīrayanti| tat kasya hetoḥ| ye	ཡོན་ཏན་བརྗོད་དོ་༎ དེ་ཅིའི་ཕྱིར་ཞེ་ན་།
 kecit sattvās tasya 'mitābhasya tathāgatasya nāmadheyaṃ	སེམས་ཅན་གང་དག་ཁ་ཅིག་གིས་བཅོམ་ལྡན་འདས་འོད་དཔག་མེད་དེའི་མཚན་ཐོས་ལ་།
 śṛṇvanti, śrutvā cāntaśa ekacittotpādam apy adhyāśayena prasādasahagatam utpādayanti, sarve te 'vaivarttikatāyāṃ	ཐོས་ནས་ཀྱང་ཐ་ན་སེམས་བསྐྱེད་པ་གཅིག་ཙམ་ཞིག་བསམ་པ་ཐག་པ་ནས་དད་པ་དང་དགའ་བ་བསྐྱེད་པ་དེ་དག་ཐམས་ཅད་བླ་ན་མེད་པ་ཡང་དག་པར་རྫོགས་པའི་བྱང་ཆུབ་ལས་ཕྱིར་མི་ལྡོག་པའི་ཕྱིར་རོ་༎
 saṃtiṣṭhante 'nuttarāyāḥ samyaksaṃbodheḥ|	ཀུན་དགའ་བོ་།
 ye cānanda kecit sattvās taṃ tathāgataṃ punaḥ punar ākārato manasīkariṣyanti,	སེམས་ཅན་གང་དག་ཁ་ཅིག་ནི་དེ་བཞིན་གཤེགས་པ་དེ་རྣམ་པས་ཡང་དང་ཡང་ཡིད་ལ་བྱེད་པ་དང་། 
 bahuparimitaṃ ca kuśalamūlam avaropayiṣyanti, bodhāya cittaṃ pariṇāmya tatra ca lokadhātāv upapattaye praṇidhāsyanti,	དགེ་བའི་རྩ་བ་མང་པོ་དཔག་ཏུ་མེད་པ་བསྐྱེད་པ་དང་། བྱང་ཆུབ་ཏུ་སེམས་ཡོངས་སུ་བསྔོས་ཏེ་།
 teṣāṃ so 'mitābhas tathāgato 'rhan samyaksaṃbuddho maraṇakālasamaye pratyupasthite 'nekabhikṣugaṇaparivṛtaḥ puraskṛtaḥ sthāsyati| tatas	འཇིག་རྟེན་གྱི་ཁམས་དེར་སྐྱེ་བར་སྨོན་ལམ་འདེབས་པ་དེ་དག་འཆི་བའི་དུས་ཉེ་བར་གནས་པ་ན་དེ་བཞིན་གཤེགས་པ་དགྲ་བཅོམ་པ་ཡང་དག་པར་རྫོགས་པའི་སངས་རྒྱས་འོད་དཔག་མེད་དེ་དགེ་སློང་གི་ཚོགས་དུ་མས་ཡོངས་སུ་བསྐོར་ཞིང་མདུན་གྱིས་བལྟས་ནས་བཞུགས་པར་འགྱུར་ཏེ་།
 te taṃ bhagavantaṃ dṛṣṭvā prasannacittāḥ santi, tatraiva	དེ་དག་གིས་བཅོམ་ལྡན་འདས་འོད་དཔག་མེད་དེ་མཐོང་ནས་རབ་ཏུ་དང་བའི་སེམས་ཀྱིས་ཤི་འཕོས་ཏེ་། 
 sukhāvatyāṃ lokadhātāv upapadyate| ya ānandākāṃkṣata,	འཇིག་རྟེན་གྱི་ཁམས་བདེ་བ་ཅན་དེ་ཉིད་དུ་སྐྱེ་བར་འགྱུར་རོ་༎ ཀུན་དགའ་བོ་།
 kulaputro vā kuladuhitā vā, kim ity ahaṃ dṛṣṭa eva dharme tam amitābhaṃ tathāgataṃ paśyeyam iti, tenānuttarāyāṃ	རིགས་ཀྱི་བུའམ་རིགས་ཀྱི་བུ་མོ་གང་ལ་ལ་དག་གིས་ཚེ་འདི་ཉིད་ལ་དེ་བཞིན་གཤེགས་པ་འོད་དཔག་མེད་མཐོང་ཡང་ཅི་མ་རུང་སྙམ་དུ་སེམས་བ་དེས་བླ་ན་མེད་པ་ཡང་དག་པར་རྫོགས་པའི་བྱང་ཆུབ་ཏུ་སེམས་བསྐྱེད་ལ་།
 samyaksaṃbodhau cittam utpādyādhyāśayapatitayā saṃtatyā	ལྷག་པའི་བསམ་པའི་རྒྱུད་ཀྱིས་སངས་༄༤༠༡ཨ་༌༎
 tasmin buddhakṣetre cittaṃ saṃpreṣyopapattaye kuśalamūlāni	རྒྱས་ཀྱི་ཞིང་དེར་སྐྱེ་བར་བྱ་བའི་ཕྱིར་སེམས་ཡང་དག་པར་བཏང་སྟེ་།
 ca pariṇāmayitavyāni|	དགེ་བའི་རྩ་བ་རྣམས་བསྐྱེད་པར་བྱ་ཞིང་ཡོངས་སུ་བསྔོ་བར་བྱའོ་༎ ཀུན་དགའ་བོ་།
 ye punas taṃ tathāgataṃ na bhūyo manasīkariṣyanti, na ca bahuparimitaṃ kuśalamūlam abhīkṣṇam avaropayiṣyanti,	གང་དག་ཡང་དེ་བཞིན་གཤེགས་པ་དེ་ཡང་ཡིད་ལ་བྱེད་ཅིང་དགེ་བའི་རྩ་བ་མང་པོ་དཔག་ཏུ་མེད་པ་རྒྱུན་དུ་བསྐྱེད་ལ་།
 tatra ca buddhakṣetre cittaṃ saṃpreṣayiṣyanti, teṣāṃ	སངས་རྒྱས་ཀྱི་ཞིང་དེར་སེམས་ཡང་དག་པར་གཏོད་པ་དེ་དག་འཆི་བའི་དུས་ཉེ་བར་གནས་པ་ན་། 
 tādṛśenaiva so 'mitābhas tathāgato 'rhan samyaksaṃbuddho p43	དེ་བཞིན་གཤེགས་པ་དགྲ་བཅོམ་པ་ཡང་དག་པར་རྫོགས་པའི་སངས་རྒྱས་འོད་དཔག་མེད་དེའི་ན་། ཁ་དོག་དང་། 
 varṇasaṃsthānārohapariṇāhena bhikṣusaṃghaparivāreṇa, tādṛśa eva buddhanirmito maraṇakāle purataḥ sthāsyati, te tenaiva	དབྱིབས་དང་། ཆུ་ཞེང་དང་། ཞམ་འབྲིང་བ་དགེ་སློང་གི་དགེ་འདུན་ཅི་འདྲ་བ་དེ་འདྲ་བའི་སངས་རྒྱས་ཀྱི་སྤྲུལ་པ་དག་མདུན་དུ་གནས་པར་འགྱུར་ཏེ་།
 tathagatadarśanaprasādālambanena samādhināpramuṣitayā smṛtyā cyutās, tatraiva buddhakṣetre pratyājaniṣyanti|	དེ་དག་དེ་བཞིན་གཤེགས་པ་མཐོང་བས་རབ་ཏུ་དང་བ་ལ་དམིགས་པའི་ཏིང་ངེ་འཛིན་དེ་དང་། བརྗེད་པ་མེད་པའི་དྲན་པས་ཤི་འཕོས་ནས་སངས་རྒྱས་ཀྱི་ཞིང་དེ་ཉིད་དུ་སྐྱེ་བར་འགྱུར་། རོ་༎ ཀུན་དགའ་བོ་།
 ye punar ānanda sattvās taṃ tathāgataṃ daśacittotpādāṃ samanusmariṣyanti ; spṛhāṃś ca tasmin buddhakṣetre utpādayiṣyanti ;	སེམས་ཅན་གང་དག་དེ་བཞིན་གཤེགས་པ་དེ་ཐ་ན་སེམས་བསྐྱེད་པ་གཅིག་ཙམ་རྗེས་སུ་དྲན་པར་བྱེད་ཅིང་སངས་རྒྱས་ཀྱི་ཞིང་དེར་སྐྱེ་བར་འདོད་ལ་། 
 gambhīreṣu ca dharmeṣu bhāṣyamāṇeṣu tuṣṭiṃ pratilapsyante, na vipatsyante, na viṣādam āpatsyante, na saṃsīdam āpatsyante ;	ཆོས་ཟབ་མོ་དག་འཆད་པ་ན་དགའ་བ་འཐོབ་ཅིང་སྒྱིད་ལུག་པ་མེད་ལ་།
 'ntaśa ekacittotpādenāpi taṃ tathāgataṃ manasikariṣyanti,	མི་འགོང་མི་ཞུམ་ཞིང་ཐ་ན་སེམས་བསྐྱེད་པ་གཅིག་ཙམ་དེ་བཞིན་གཤེགས་པ་འོད་དཔག་མེད་དེ་ཡི་ད་ལ་བྱེད་དེ་།
 spṛhāṃ cotpādayiṣyanti tasmin buddhakṣetre, te 'pi svapnāntaragatās tam amitābhaṃ tathāgataṃ drakṣyanti ; sukhāvatyāṃ lokadhātāv upapatsyante ;	འདོད་པ་ཡང་བསྐྱེད་ན་དེ་དག་རྨི་ལམ་ན་དེ་བཞིན་གཤེགས་པ་འོད་དཔག་མེད་དེ་༄༤༠༡བ་མཐོང་ཞིང་འཇིག་རྟེན་གྱི་ཁམས་བདེ་བ་ཅན་དུ་སྐྱེ་བར་འགྱུར་། 
 'vaivarttikāś ca bhaviṣyanty anuttarāyāḥ samyaksaṃbodheḥ|	བླ་ན་མེད་པ་ཡང་དག་པར་རྫོགས་པའི་བྱང་ཆུབ་ལས་ཕྱིར་མི་ལྡོག་པར་ཡང་བར་འགྱུར་། འགྱུར་རོ་༎ 
 imaṃ khalv ānandārthavasaṃ saṃpaśyantas,	ཀུན་དགའ་བོ་།
 te tathāgatā daśasu dikṣv aprameyāsaṃkhyeyāsu lokadhātusu tasyāmitābhasya tathāgatasya nāmadheyaṃ parikīrtayanto, varṇān ghoṣayantaḥ,	དེ་བཞིན་གཤེགས་པ་དེ་དག་དོན་གྱི་དབང་དེ་གཟིགས་ནས་ཕྱོགས་བཅུའི་འཇིག་རྟེན་གྱི་ཁམས་གྲངས་མེད་དཔག་ཏུ་མེད་པ་དག་ན་དེ་བཞིན་གཤེགས་པ་འོད་དཔག་མེད་དེའི་མཚན་ཀྱང་ཡོངས་སུ་བརྗོད་དོ་༎ བསྔགས་པ་ཡང་གསུང་།
 praśaṃsām abhyudīrayanti| tasmin khalu punar ānanda buddhakṣetre daśabhyo digbhya ekaikasyāṃ diśi gaṅgānadīvālukopamā bodhisattvās tam amitābhaṃ tathāgatam upasaṃkrāmanti darśanāya, vandanāya, paryupāsanāya,	བསྟོད་པ་ཡང་སྒྲོགས་སོ་༎ ཀུན་དགའ་བོ་།
 paripraśnīkaraṇāya ; taṃ ca bodhisattvagaṇaṃ tāṃś ca buddhakṣetraguṇālaṃkāravyūhasaṃpadaviśeṣān draṣṭum|	ཕྱོགས་བཅུའི་ཕྱོགས་རེ་རེ་ནས་ཀྱང་བྱང་ཆུབ་སེམས་དཔའ་གངགའའི་ཀླུང་གི་བྱེ་མ་སྙེད་དག་དེ་བཞིན་གཤེགས་པ་འོད་དཔག་མེད་དེ་ལ་བལྟ་བ་དང་། ཕྱག་བྱ་བ་དང་། བསྙེན་བཀུར་བྱ་བ་དང་། ཡོངས་སུ་དྲི་བ་བྱ་བ་དང་། བྱང་ཆུབ་སེམས་དཔའི་ཚོགས་དེ་དང་། སངས་རྒྱས་ཀྱི་ཞིང་གི་ཡོན་ཏན་གྱི་རྒྱན་བཀོད་པ་ཕུན་སུམ་ཚོགས་པའི་ཁྱད་པར་དེ་དག་བལྟ་བའི་ཕྱིར་སངས་རྒྱས་ཀྱི་ཞིང་དེར་འདོང་ངོ་༎
 atha khalu bhagavāṃs tasyāṃ velāyām imam evārthaṃ bhūyasyā mātrayā paridīpayann imā gāthā abhāṣata : p44	དེ་ནས་དེའི་ཚེ་བཅོམ་ལྡན་འདས་ཀྱིས་དོན་འདི་ཉིད་རྒྱས་པར་གསུང་ཞིང་། ཚིགས་སུ་བཅད་པ་འདི་དག་བཀའ་སྩལ་ཏོ་༎ འདྲེན་པ་འོད་དཔག་མེད་ཀྱི་སངས་རྒྱས་ལ་༎ ཕྱག་བྱའི་ཕྱིར་ནི་ཤར་གྱི་སངས་རྒྱས་ཞིང་༎
 yathaiva gaṅgāya nadīya vālikā,	མཐའ་ཡས་གངགའའི་ཀླུང་གི་བྱེ་སྙེད་ནས་༎
 buddhāna kṣetrā purimena tāttakāḥ| yato hi te āgami buddha vanditum saṃbodhisattvā amitāyu nāyakaṃ|(1)	རྫོགས་པའི་བྱང་ཆུབ་སེམས་དཔའ་དེ་དག་ལྷགས་༎
 bahupuṣpapuṭān gṛhītvā nānāvarṇa surabhī manoramān,	དེ་དག་མེ་ཏོག་ཁ་དོག་ཐ་དད་པ་༎ དྲི་ཞིམ་ཡིད་འོང་མང་པོ་སྙིམ་ཐོགས་ཏེ་༎ ཚེ་དཔག་མེད་པ་ལྷ་དང་མིས་མཆོད་པ་༎
 okiranti naranāyakottamam amita-āyu naradevapūjitam|(2) tatha dakṣiṇapaścimottarāsu	མི་ཡི་འདྲེན་པ་མཆོག་ལ་རབ་ཏུ་འཐོར་༎ ༄༤༠༢ཨ་༌༎ འདྲེན་པ་འོད་དཔག་མེད་ཀྱི་སངས་རྒྱས་ལ་༎
 buddhāna kṣetrā diśatāsu tattakāḥ, yato yato āgami buddha vanditum	ཕྱག་བྱའི་ཕྱིར་ནི་དེ་བཞིན་ལྷོ་ནུབ་དང་༎ བྱང་ཕྱོགས་སངས་རྒྱས་ཞིང་རྣམས་ཇི་སྙེད་ནས་༎ རྫོགས་པའི་བྱང་ཆུབ་སེམས་དཔའ་དེ་དག་ལྷགས་༎ དེ་དག་སྤོས་ཀྱི་ཁ་དོག་ཐ་དད་པ་༎
 saṃbodhisattvā amitāyu nāyakaṃ|(3) bahugandhapuṭān gṛhītvā nānāvarṇa surabhī manoramān,	དྲི་ཞིམ་ཡིད་འོང་མང་པོ་སྙིམ་ཐོགས་ཏེ་༎ ཚེ་དཔག་མེད་པ་ལྷ་དང་མིས་མཆོད་པ་༎
 okiranti naranāyakottamaṃ amita-āyu naradevapūjitam|(4) pūjitva ca te bahubodhisattvān,	མི་ཡི་འདྲེན་པ་མཆོག་ལ་རབ་ཏུ་འཐོར་༎ བྱང་ཆུབ་སེམས་དཔའ་མང་པོ་དེ་དག་གིས་༎
 vanditva pādām amitaprabhasya, pradakṣiṇīkṛtya vadanti caivaṃ : aho 'dbhutaṃ śobhati buddhakṣetraṃ|(5)	མཆོད་པ་བྱས་ཏེ་དཔག་མེད་འོད་ཞབས་ལ་༎ ཕྱག་འཚལ་བསྐོར་བ་བྱས་ནས་འདི་སྐད་དུ་༎ སངས་རྒྱས་ཞིང་ནི་ངོ་མཚར་མཛེས་ཞེས་འཛེར་༎ དགའ་ཞིང་མགུ་བའི་སེམས་ནི་གཞལ་ཡས་ཀྱིས་༎
 te puṣpapuṭāhi samokiranti udagracittā atulāya prītaye,	དེ་དག་གིས་ནི་མེ་ཏོག་སྙིམ་གཏོར་ནས་༎ འདྲེན་པ་དེ་ཡི་སྤྱན་སྔར་འདི་སྐད་དུ་༎
 vācaṃ prabhāṣanti punas tu : nāyake, asmāpi kṣetraṃ siya evarūpaṃ|(6) p45	བདག་ཅག་ཞིང་ཡང་འདི་འདྲར་གྱུར་ཅེས་སྨྲས་༎
 taiḥ puṣpapuṭā iti kṣipta tatra	དེ་དག་མེ་ཏོག་སྙིམ་པ་གཏོར་མ་ཐག་། དེ་ཚེ་དཔག་ཚད་བརྒྱ་པའི་གདུགས་གྱུར་ཏེ་༎
 cchatraṃ tadā saṃsthihi yojanāśatāṃ, svalaṃkṛtaṃ śobhati citradaṇḍaṃ, cchādeti buddhasya samantakāyaṃ|(7)	ལེགས་པར་བརྒྱན་ཞིང་ཡུ་བ་བཀྲ་བས་མཛེས་༎ སངས་རྒྱས་སྐུ་ལ་ཀུན་ཏུ་ཁེབས་པས་གནས་༎ བྱང་ཆུབ་སེམས་དཔའ་དེ་དག་དེ་བཞིན་དུ་༎ བསྙེན་བཀུར་བྱས་ནས་དགའ་སྟེ་འདི་སྐད་དུ་༎
 te bodhisattvās tatha satkaritvā, kathā kathentī iti tatra tuṣṭaḥ : sulabdha lābhāḥ khalu tehi sattvaiḥ,	གང་དག་གིས་ནི་མི་མཆོག་མཚན་ཐོས་པ་༎
 yehī śrutaṃ nāma narottamasya|(8) asmehi pī lābha sulabdha pūrvā yad āgatasya ima buddhakṣetraṃ| paśyātha svapnopama kṣetra kīdṛśaṃ,	སེམས་ཅན་དེ་དག་རྙེད་པ་ལེགས་རྙེད་འཛེར་༎ སངས་རྒྱས་ཞིང་འདིར་བདག་ཅག་ལྷགས་པས་ན་༎ བདག་ཅག་གིས་ནི་སྔོན་རྙེད་ལེགས་པར་རྙེད་༎
 yat kalpitaṃ kalpasahasra śāstunā|(9) paśyatha, buddho varapuṇyarāśiḥ, parīvṛtu śobhati bodhisattvaiḥ|	བསྐལ་པ་སྟོང་དུ་སྟོན་པས་གང་བསྒྲུབས་པ་༎ རྨི་ལམ་ལྟ་བུའི་ཞིང་ནི་༄༤༠༢བ་ཅི་འདྲ་ལྟོས་༎
 amitābhasya ābhā amitaṃ ca tejaḥ, amitā ca āyur, amitaś ca saṃghaḥ|(10)	འོད་ནི་དཔག་མེད་གཟི་བརྗིད་དཔག་མེད་པ་༎ སྐུ་ཚེ་དཔག་མེད་དགེ་འདུན་དཔག་མེད་པ་༎ བྱང་ཆུབ་སེམས་དཔས་བསྐོར་ཞིང་མཛེས་གྱུར་པ་༎ སངས་རྒྱས་བསོད་ནམས་ཕུང་པོ་མཆོག་ལ་ལྟོས་༎
 smitaṃ karontī amitāyu nāthaḥ	དེ་ནས་ཚེ་དཔག་མེད་ཀྱིས་འཛུམ་མཛད་ནས་༎
 ṣaṭtriṃśatkoṭīnayutāni arciṣāṃ,	འོད་འཕྲོ་བྱེ་བ་ཁྲག་ཁྲིག་སུམ་ཅུ་དྲུག་།
 ye niścaritvā mukhamaṇḍalābhaḥ sphuranti kṣetrāṇi sahasrakoṭīḥ|(11)	དེ་དག་ཞལ་གྱི་དཀྱིལ་འཁོར་ནས་བྱུང་སྟེ་༎ ཞིང་སྟོང་བྱེ་བ་དག་ནི་ཁྱབ་པར་མཛད་༎ འོད་འཕྲོ་དེ་དག་ཐམས་ཅད་སླར་ལོག་སྟེ་༎
 tāḥ sarva arcīḥ punaretya tatra, mūrdhne ca astaṃgami nāyakasya|	འདྲེན་པའི་སྤྱི་གཙུག་དེར་ནི་ནུབ་པར་གྱུར་༎ དེ་ཚེ་འོད་འཕྲོ་ནུབ་པར་གྱུར་ནས་ནི་༎
 devamanuṣyā janayanti prītim, p46	ལྷ་དང་མི་རྣམས་དགའ་བ་རབ་ཏུ་སྐྱེད་༎ དེ་ནས་སངས་རྒྱས་སྲས་པོ་གྲགས་ཆེན་པོ་༎
 arcis tadā astam itā viditvā|(12) uttiṣṭhate buddhasuto mahāyaśā nāmnātha so hi avalokiteśvaraḥ :	སྤྱན་རས་གཟིགས་ཀྱི་དབང་ཕྱུག་དེ་ལངས་ཏེ་༎ གང་སླད་འཇིག་རྟེན་མགོན་པོ་འཛུམ་མཛད་པ་༎
 ko hetur atra bhagavan, ko pratyayaḥ,	བཅོམ་ལྡན་དེ་ཡི་རྒྱུ་དང་རྐྱེན་གང་ལགས་༎ སེམས་ཅན་མང་འགྲོལ་ཕན་པ་ཐུགས་བརྩེ་ཅན་༎
 yena smitaṃ kurvasi lokanātha|(13) taṃ vyākarohī paramārthakovidā	དོན་དམ་མཁས་པ་དེ་ནི་ལུང་བསྟན་གསོལ་༎
 hitānukampī bahusattvamocakaḥ| śrutvā ti vācaṃ paramāṃ manoramāṃ,	གསུང་མཆོག་ཡིད་དུ་མཆི་བ་དེ་ཐོས་ནས་༎
 udagracittā bhaviṣyanti sattvāḥ|(14)	སེམས་ཅན་དག་ནི་དགའ་བའི་སེམས་སུ་འགྱུར་༎
 ye bodhisattvā bahulokadhātuṣu sukhāvatīṃ prasthita buddhapaśyanā,	འཇིག་རྟེན་ཁམས་མང་བྱང་ཆུབ་སེམས་དཔའ་དག་། སངས་རྒྱས་བལྟ་སླད་བདེ་ཅན་འདིར་མཆི་བ་༎
 te śrutva prītiṃ vipulāṃ janetvā, kṣipraṃ imaṃ kṣetra vilokayeyuḥ|(15) āgatya ca kṣetram idaṃ udāraṃ,	དེ་དག་ཐོས་ནས་དགའ་བ་ཆེར་བསྐྱེད་དེ་༎ མྱུར་དུ་ཞིང་འདི་རྣམ་པར་བལྟ་བར་འགྱུར་༎
 ṛddhībalaṃ prāpuṇi kṣipram eva, divyaṃ ca cakṣus, tatha śrotra divyaṃ, jātismaraḥ paramatakovidāś ca|(16)	རྒྱ་ཆེན་ཞིང་འདིར་ལྷགས་པར་གྱུར་ནས་ཀྱང༏་༏ལྷ་ཡི་མིག་དང་ལྷ་ཡི་རྣ་བ་དང་༎ ཚེ་རབས་དྲན་དང་བློ་གྲོས་མཁས་མཆོག་དང་༎ རྫུ་འཕྲུལ་སྟོབས་ཀྱང་མྱུར་དུ་ཐོབ་པར་འགྱུར་༎ སངས་རྒྱས་ཚེ་དཔག་མེད་ཀྱིས་ལུང་བསྟན་པ་༎ ངས་ནི་སྔོན་༄༤༠༣ཨ་༌༎ ཚེ་སྨོན་ལམ་འདི་སྐད་བཏབ་༎
 amitāyu buddhas tada vyākaroti : mama hy ayaṃ praṇidhir abhūṣi pūrva| kathaṃ pi sattvāḥ śruṇiyāna nāmaṃ,	སེམས་ཅན་གང་གིས་ང་ཡི་མིང་ཐོས་ན་༎ ང་ཡི་ཞིང་དུ་རྟག་ཏུ་འོང་བར་ཤོག་།
 vrajeyu kṣetraṃ mama nityam eva|(17) sa me aya praṇidhi prapūrṇa śobhanā,	ང་ཡི་སྨོན་ལམ་བཟང་པོ་དེ་རྫོགས་པས་༎ འཇིག་རྟེན་ཁམས་མང་དག་ནས་སེམས་ཅན་འོང་༎
 sattvāś ca enti bahulokadhātutaḥ| āgatya kṣipraṃ mama te 'ntikasmin avivarttikā bhontiha ekajātiyā|(18)	དེ་དག་ང་ཡི་ཞིང་དུ་ལྷགས་ནས་ནི་༎ དེ་དག་སྐྱེ་བ་གཅིག་ལས་ཕྱིར་མི་ལྡོག་།
 tasmād ya icchatiha bodhisattvaḥ :	དེ་ཕྱིར་བྱང་ཆུབ་སེམས་དཔའ་གང་ཞིག་འདིར་༎
 mamāpi kṣetraṃ siya evarūpaṃ| ahaṃ pi sattvā bahu mocayeyaṃ, p47 nāmena ghoṣena tha darśanena|(19)	བདག་གི་ཞིང་ཡང་འདི་འདྲར་གྱུར་པ་དང་༎ བདག་གི་མིང་དང་སྒྲ་དང་ལྟ་བས་ཀྱང་༎ སེམས་ཅན་མང་པོ་གྲོལ་བར་བྱ་འདོད་པ་༎
 sa śīghraśīghraṃ tvaramāṇarūpaḥ,	དེ་ནི་མྱུར་དུ་རིངས་པར་ལ་གོར་དུ་༎ བདེ་བ་ཅན་གྱི་འཇིག་རྟེན་ཁམས་སོང་ལ་༎
 sukhāvatīṃ gacchatu lokadhātuṃ| gatvā ca pūrvam amitaprabhasya,	འོད་དཔག་མེད་ཀྱི་གན་དུ་སོང་ནས་ནི་༎
 pūjetu buddhāna sahasrakoṭī|(20) buddhāna koṭīṃ bahu pūjayitvā,	སངས་རྒྱས་བྱེ་བ་སྟོང་ལ་མཆོད་པ་གྱིས་༎
 ṛddhībalena bahu kṣetra gatvā, kṛtvāna pūjāṃ sugatāna santike,	རྫུ་འཕྲུལ་སྟོབས་ཀྱི་ཞིང་མང་སོང་ནས་ནི་༎ སངས་རྒྱས་བྱེ་བ་མང་ལ་མཆོད་བྱ་སྟེ་༎ བདེ་བར་གཤེགས་ལ་མཆོད་པ་བྱས་ནས་ཀྱང་༎ དྲོ་ཁར་བདེ་བ་ཅན་དུ་སླར་ཡང་འོང་༎༎ བམ་པོ་གསུམ་པ་སྟེ་ཐ་མའོ་༎ ཀུན་དགའ་བོ་།
 bhaktāgram eṣyanti sukhāvatī ta, iti|(21) tasya khalu punar ānanda bhagavato 'mitāyuṣas tathāgatasyārhataḥ samyaksaṃbuddhasya bodhivṛkṣaḥ ṣoḍasayojanaśatāny	དེ་བཞིན་གཤེགས་པ་དགྲ་བཅོམ་པ་ཡང་དག་པར་རྫོགས་པའི་སངས་རྒྱས་འོད་དཔག་མེད་དེའི་བྱང་ཆུབ་ཀྱི་ཤིང་ནི་འཕང་དུ་དཔག་ཚད་སྟོང་དྲུག་བརྒྱ་ཡོད་པ་། 
 uccaitvenāṣṭau yojanaśatāny abhipralambitaśākhāpattrapalāśaḥ	ཡལ་ག་དང་། ལོ་མ་དང་། འདབ་མ་དཔག་ཚད་བརྒྱད་བརྒྱ་ཚུན་ཆད་དུ་འཕྱང་བ་།
 pañcayojanaśatamūlārohapariṇāhaḥ, sadāpattraḥ	རྩ་བའི་སྦོམས་དང་ཁྲུན་དཔག་ཚད་ལྔ་བརྒྱ་ཡོད་པ་།
 sadāpuṣpaḥ sadāphalo,	རྟག་ཏུ་ལོ་མ་ཆགས་པ་། རྟག་ཏུ་མེ་ཏོག་ཆགས་པ་། རྟག་ཏུ་འབྲས་བུ་ཆགས་པ་།
 nānāvarṇo 'nekaśatasahasravarṇo, nānāpattro nānāpuṣpo nānāphalo,	ཁ་དོག་ཐ་དད་པ་། ཁ་དོག་བརྒྱ་༄༤༠༣བ་སྟོང་དུ་མ་ཡོད་པ་། ལོ་མ་ཐ་དད་པ་། མེ་ཏོག་ཐ་དད་པ་། འབྲས་བུ་ཐ་དད་པ་།
 nānāvicitrarūpena samalaṃkṛtaś,	རྒྱན་སྣ་ཚོགས་ཀྱིས་བརྒྱན་པ་།
 candrabhāsamaṇiratnaparisphuṭaḥ,	ཟླ་བ་ལྟ་བུར་སྣང་བའི་ནོར་བུ་རིན་པོ་ཆེས་ཡོངས་སུ་གསལ་བ་།
 śakrābhilagnamaṇiratnavicitritaś, cintāmaṇiratnakīrṇaḥ,	བརྒྱ་བྱིན་ཐོགས་པའི་ནོར་བུ་རིན་པོ་ཆེས་རྣམ་པར་སྤྲས་པ་།
 sāgaravaramaṇiratnasuvicitrito,	ཡིད་བཞིན་གྱི་ནོར་བུ་རིན་པོ་ཆེས་གང་བ་། རྒྱ་མཚོའི་ནོར་བུ་རིན་པོ་ཆེ་མཆོག་གིས་ཤིན་ཏུ་རྣམ་པར་སྤྲས་པ་།
 divyasamatikrāntaḥ,	ཁ་དོག་ལྷའི་ལས་འདས་པ་།
 suvarṇasūtrābhipralambito, rūcakahāro	གསེར་གྱི་སྐུད་པ་འཆང་བ་།
 ratnahāro vajrāhāraḥ kaṭakahāro lohitamuktāhāro	སེ་མོ་དོ་མཛེས་པ་དང་། རིན་པོ་ཆེའི་ཆུན་པོ་དང་། རྒྱན་ཕྲེང་དང་། དོ་ཤལ་ཆིག་རྐྱང་དང་། མུ་ཏིག་དམར་པོའི་རྒྱན་ཕྲེང་དང་། མུ་ཏིག་སྔོན་པོའི་རྒྱན་ཕྲེང་དང་། སེང་གེའི་ཁ་ནས་འཕྱང་བའི་སྐ་རགས་ཀྱི་ཚོགས་ཡོད་པ་།
 nīlamuktāhāraḥ, siṃhalatāmekhalākalāparatnasūtrasarva- ratnakañcukaśatābhivicitritaḥ,	རིན་པོ་ཆེའི་སྐུད་པ་དང་། རིན་པོ་ཆེ་ཐམས་ཅད་དང་། དུང་གིས་མངོན་པར་སྤྲས་པ་།
 suvarṇajālamuktājālasarvaratna- jālakaṅkaṇījālāvanato,	གསེར་གྱི་དྲ་བ་དང་། མུ་ཏིག་གི་དྲ་བ་དང་། རིན་པོ་ཆེ་ཐམས་ཅད་ཀྱི་དྲ་བ་དང་། དྲིལ་བུ་ག-ཡེར་ཁའི་དྲ་བས་བླ་རེར་བྲེས་པ་།
 makarasvastikanandyāvartyardhacandra-	ཆུ་སྲིན་དང་། བཀྲ་ཤིས་པ་དང་། ག-ཡུང་དྲུང་འཁྱིལ་བ་དང་། ཟླ་གམ་ལྟ་བུས་ལེགས་པར་བརྒྱན་པ་།
 samalaṃkṛtaḥ, kiṅkiṇīmaṇisauvarṇasarvaratnālaṃkāravibhūṣito,	ནོར་བུ་འཁྲོལ་བ་དང༏་གསེར་དང་རིན་པོ་ཆེའི་རྒྱན་ཐམས་ཅད་ཀྱིས་བརྒྱན་པ་།
 yathāśayasattvavijñaptisamalaṃkṛtaś ca|	སེམས་ཅན་གྱི་བསམ་པའི་རྣམ་པར་རིག་པ་ཇི་ལྟ་བ་བཞིན་དུ་ལེགས་པར་བརྒྱན་པའོ་༎ ཀུན་དགའ་བོ་།
 tasya khalu punar ānanda bodhivṛkṣasya vātasamīritasya yaḥ śabdaghoṣo niścarati, so 'parimāṇān lokadhātūn abhivijñāpayati|	བྱང་ཆུབ་ཀྱི་ཤིང་དེ་རླུང་གིས་བསྐྱོད་ན་སྒྲ་དབྱངས་འབྱུང་བ་གང་ཡིན་པ་དེས་འཇིག་རྟེན་གྱི་ཁམས་ཚད་མེད་པ་གོ་བར་བྱེད་དོ་༎ ཀུན་དགའ་བོ་།
 tatrānanda yeṣāṃ sattvānāṃ bodhivṛkṣaśabdaḥ p48 śrotrāvabhāsam āgacchati,	དེ་ལ་བྱང་ཆུབ་ཀྱི་ཤིང་གི་སྒྲ་དེ་སེམས་ཅན་གང་དག་གི་རྣ་ལམ་དུ་གྲག་༄༤༠༤ཨ་༌༎
 teṣāṃ śrotrarogo na pratikāṃkṣitavyo,	པ་དེ་དག་བྱང་ཆུབ་ཀྱི་མཐའི་བར་དུ་རྣ་ནད་ཀྱིས་མི་བཏབ་པར་ཤེས་པར་བྱའོ་༎
 yāvad bodhiparyantam| yeṣāṃ cāprameyāsaṃkhyeyā-	སེམས་ཅན་དཔག་ཏུ་མེད་། གྲངས་མེད་། བསམ་གྱིས་མི་ཁྱབ་། མཚུངས་པ་མེད༏་གཞལ་དུ་མེད་། ཚད་མེད་།
 cintyāmāpyāparimāṇānabhilāpyānāṃ sattvānāṃ bodhivṛkṣaś cakṣuṣābhāsam āgacchati, teṣāṃ cakṣūrogo na pratikāṃkṣitavyo,	བརྗོད་དུ་མེད་པ་གང་དག་གི་མིག་ལམ་དུ་བྱང་ཆུབ་ཀྱི་ཤིང་དེ་སྣང་བ་དེ་དག་བྱང་ཆུབ་ཀྱི་མཐའི་བར་དུ་ནམ་ཡང་མིག་ནད་ཀྱིས་མི་བཏབ་པར་ཤེས་པར་བྱའོ་༎
 yāvad bodhiparyantam| ye khalu punar ānanda	ཀུན་དགའ་བོ་།
 sattvās tato bodhivṛkṣād gandhaṃ jighranti, teṣāṃ yāvad bodhiparyantaṃ na jātu ghrāṇarogaḥ pratikāṃkṣitavyaḥ| ye	སེམས་ཅན་གང་དག་བྱང་ཆུབ་ཀྱི་ཤིང་དེའི་དྲི་ཚོར་བ་དེ་དག་ཀྱང་བྱང་ཆུབ་ཀྱི་མཐའི་བར་དུ་ནམ་ཡང་སྣ་ནད་ཀྱིས་མི་བཏབ་པར་ཤེས་པར་བྱའོ་༎ 
 sattvās tato bodhivṛkṣāt phalāny āsvādayanti, teṣāṃ yāvad bodhiparyantaṃ na jātu jihvārogaḥ pratikāṃkṣitavyaḥ|	སེམས་ཅན་གང་དག་བྱང་ཆུབ་ཀྱི་ཤིང་དེའི་འབྲས་བུའི་རོ་མྱོང་བ་དེ་དག་ཐམས་ཅད་ཀྱང་བྱང་ཆུབ་ཀྱི་མཐའི་བར་དུ་ནམ་ཡང་ལྕེ་ནད་ཀྱིས་མི་བཏབ་པར་ཤེས་པར་བྱའོ་༎
 ye sattvās tasya bodhivṛkṣasyābhayā sphuṭā bhavanti, teṣāṃ yāvad bodhimaṇḍaparyantaṃ na jātu kāyarogaḥ pratikāṃkṣitavyaḥ| ye khalu punar ānanda sattvās taṃ	བྱང་ཆུབ་ཀྱི་ཤིང་དེའི་འོད་ཀྱིས་སེམས་ཅན་གང་དག་ལ་ཁྱབ་པར་གྱུར་བ་དེ་དག་ཀྱང་བྱང་ཆུབ་ཀྱི་མཐའི་བར་དུ་ནམ་ཡང་ལུས་ལ་ནད་ཀྱིས་མི་བཏབ་པར་ཤེས་པར་བྱའོ་༎ ཀུན་དགའ་བོ་།
 bodhivṛkṣaṃ dharmato nidhyāyanti, teṣāṃ tatropādāya yāvad bodhiparyantaṃ na jātu cittavikṣepaḥ pratikāṃkṣitavyaḥ| sarve	སེམས་ཅན་གང་དག་བྱང་ཆུབ་ཀྱི་ཤིང་དེ་ཆོས་ཉིད་དུ་ངེས་པར་སེམས་པ་དེ་དག་ཀྱང་དེ་ནས་བཟུང་སྟེ་བྱང་ཆུབ་ཀྱི་མཐའི་བར་དུ་ནམ་ཡང་སེམས་མི་ག-ཡེང་པར་ཤེས་པར་བྱའོ་༎
 ca te sattvāḥ sahadarśanāt tasya bodhivṛkṣasyāvaivarttikāḥ saṃtiṣṭhante ; yad utānuttarāyāḥ samyaksaṃbodhes tisraś ca kṣāntīḥ pratilabhante, yad idaṃ : ghoṣānugām anulomikāṃ anutpattikadharmakṣāntiṃ ca ;	སེམས་ཅན་དེ་དག་ཐམས་ཅད་ནི་བྱང་ཆུབ་ཀྱི་ཤིང་དེ་མཐོང་མ་ཐག་ཏུ་བླ་ན་མེད་པ་ཡང་དག་པར་རྫོགས་པའི་བྱང་ཆུབ་ལས་ཕྱིར་མི་ལྡོག་པར་འགྱུར་རོ་༎
 tasyaivāmitāyuṣas tathāgatasya pūrvapraṇidhānādhiṣṭhānena, pūrvajinakṛtādhikāratayā,	དེ་བཞིན་གཤེགས་པ་ཚེ་དཔག་མེད་དེ་ཉིད་ཀྱི་སྔོན་གྱི་སྨོན་ལམ་གྱི་བྱིན་གྱི་རླབས་༄༤༠༤བ་དང་། སྔོན་གྱི་རྒྱལ་བ་ལ་ལྷག་པར་བྱ་བ་བྱས་པ་དང་། སྔོན་གྱི་སྨོན་ལམ་དང་སྤྱོད་པ་ཤིན་ཏུ་རྫོགས་པ་དང་། ཤིན་ཏུ་བསྒོམས་པ་དང་། མི་ཉུང་བ་དང་། མ་ཚང་བ་མེད་པས་འདི་ལྟ་སྟེ་། སྒྲའི་རྗེས་སུ་འགྲོ་བ་དང་། རྗེས་སུ་མཐུན་པ་དང་། མི་སྐྱེ་བའི་ཆོས་ལ་བཟོད་པ་དང་། བཟོད་པ་རྣམ་པ་གསུམ་འཐོབ་བོ་༎
 pūrvapraṇidhānaparicaryayoś ca susamāptayā, subhāvitayānū- nāvikalatayā| tatra khalu punar ānanda ye bodhisattvāḥ pratyājātāḥ	ཀུན་དགའ་བོ་།
 pratyājāyante pratyājaniṣyante vā, sarve ta ekajātipratibaddhās tata evānuttarāṃ samyaksaṃbodhim abhisaṃbhotsyante ;	བྱང་ཆུབ་སེམས་དཔའ་གང་དག་སངས་རྒྱས་ཀྱི་ཞིང་དེར་སྐྱེས་པ་དང་། སྐྱེ་བ་དང་། སྐྱེ་བར་འགྱུར་བ་དེ་དག་ཐམས་ཅད་སྐྱེ་བ་གཅིག་གིས་ཐོགས་པ་གྱུར་ནས་བླ་ན་མེད་པ་ཡང་དག་པར་རྫོགས་པའི་བྱང་ཆུབ་མངོན་པར་རྫོགས་པར་འཚང་རྒྱ་བར་འགྱུར་ཏེ་།
 sthāpayitvā praṇidhānavaśena ye te bodhisattvā mahāsiṃhanādanāditā, p49	སྨོན་ལམ་གྱི་དབང་ནི་མ་གཏོགས་སོ་༎ བྱང་ཆུབ་སེམས་དཔའ་དེ་དག་ནི་སེང་གེའི་སྒྲ་ཆེན་པོ་སྒྲོགས་པ་།
 udārasaṃnāhasamnaddhāḥ,	གོ་ཆ་ཆེན་པོ་བགོས་པ་།
 sarvasattvaparinirvāṇābhiyuktāś ca|	སེམས་ཅན་ཐམས་ཅད་ཡོངས་སུ་མྱ་ངན་ལས་བཟླ་བ་ལ་མངོན་པར་བརྩོན་པ་ཤ་སྟག་གོ་།
 tasmin khalu punar ānanda buddhakṣetre ye śrāvakās	ཀུན་དགའ་བོ་། སངས་རྒྱས་ཀྱི་ཞིང་དེ་ན་ཉན་ཐོས་གང་དག་འཁོད་པ་དེ་དག་ནི་འོད་འདོམ་གང་བ་ཤ་སྟག་གོ་། 
 te vyomaprabhā, ye bodhisattvās te yojanakoṭīśatasahasraprabhāḥ ; sthāpayitvā dvau bodhisattvau,	བྱང་ཆུབ་སེམས་དཔའ་གང་དག་འཁོད་པ་དེ་དག་ནི་འོད་དཔག་ཚད་བྱེ་བ་བརྒྱ་སྟོང་པ་ཤ་སྟག་སྟེ་༎
 yayoḥ prabhayā sā lokadhātuḥ satatasamitaṃ nityāvabhāsasphuṭā| atha khalv āyuṣmān ānando bhagavantam etad avocat :	བྱང་ཆུབ་སེམས་དཔའ་གང་འོད་ཀྱིས་འཇིག་རྟེན་གྱི་ཁམས་དེ་རྟག་ཏུ་རྒྱུན་མི་འཆད་པར་ཁོར་ཡུག་ཏུ་སྣང་བས་ཁྱབ་པར་བྱེད་པ་གཉིས་ནི་མ་གཏོགས་སོ༏་༏དེ་ནས་བཅོམ་ལྡན་འདས་ལ་ཚེ་དང་ལྡན་པ་ཀུན་དགའ་བོས་འདི་སྐད་ཅེས་གསོལ་ཏོ་༎ བཅོམ་ལྡན་འདས་།
 kiṃ nāmadheyau bhagavan tau satpuruṣau bodhisattvau	བྱང་ཆུབ་སེམས་དཔའ་སེམས་དཔའ་ཆེན་པོ་དེ་གཉིས་ཀྱིས་མིང་ཅི་ཞེས་༄༤༠༥ཨ་༌༎
 mahāsattvau| bhagavān āha :	བགྱི༏་བཅོམ་ལྡན་འདས་ཀྱིས་བཀའ་སྩལ་པ་། ཀུན་དགའ་བོ་།
 ekas tayor ānandāvalokiteśvara bodhisattvo mahāsattvo,	དེ་གཉིས་ལ་གཅིག་གི་མིང་ནི་བྱང་ཆུབ་སེམས་དཔའ་སེམས་དཔའ་ཆེན་པོ་སྤྱན་རས་གཟིགས་དབང་ཕྱུག་ཅེས་བྱའོ་༎ 
 dvitīyaḥ sthāmaprāpto nāma| ita	གཅིག་གི་མིང་ནི་མཐུ་ཆེན་ཐོབ་ཅེས་བྱ་སྟེ་།
 evānanda buddhakṣetrāc cyutvā tatropapannau|	ཀུན་དགའ་བོ་། དེ་གཉིས་ནི་སངས་རྒྱས་ཀྱི་ཞིང་འདི་ནས་ཤི་འཕོས་ནས་སངས་རྒྱས་ཀྱི་ཞིང་དེར་སྐྱེས་སོ༏་༏ཀུན་དགའ་བོ་། 
 tatra cānanda buddhakṣetre ye bodhisattvāḥ pratyājātāḥ, sarve te dvātriṃśatā mahāpuruṣalakṣaṇaiḥ samanvāgatāḥ,	བྱང་ཆུབ་སེམས་དཔའ་གང་དག་སངས་རྒྱས་ཀྱི་ཞིང་དེར་སྐྱེས་པ་དེ་དག་ཐམས་ཅད་ནི་སྐྱེས་བུ་ཆེན་པོའི་མཚན་སུམ་ཅུ་རྩ་གཉིས་དགའ་བོ་། དང་ལྡན་པ་། 
 paripūrṇagātrā, dhyānābhijñākovidāḥ,	ལུས་ཡོངས་སུ་རྫོགས་པ༏་བསམ་གཏན་དང་མངོན་པར་ཤེས་པ་ལ་དགའ་བོ་། དང་ལྡན་པ་། མཁས་པ་།
 prajñāprabhedakovidāḥ,	ཤེས་རབ་ཀྱིས་རབ་ཏུ་དབྱེ་བ་ལ་མཁས་པ་དགའ་བོ་། དང་ལྡན་པ་། མཁས་པ་། 
 kuśalās, tīkṣṇendriyāḥ,	། དབང་པོ་རྣོ་བ་།
 susaṃvṛtendriyā,	དབང་པོ་བསྡམས་པ་།
 ājñātendriyā,	ཀུན་ཤེས་པའི་དབང་པོ་དང་ལྡན་པ་།
 adīnācalendriyāḥ,	མ་ཞུམ་པ་། དབང་པོ་མི་ག-ཡོ་བ་།
 pratilabdhakṣāntikā anantāparyantaguṇāḥ|	བཟོད་པ་ཐོབ་པ་། ཡོན་ཏན་མཐའ་ཡས་པ་མུ་མེད་པ་ཤ་སྟག་གོ་། ཀུན་དགའ་བོ་།
 tasmin khalu punar ānanda buddhakṣetre ye bodhisattvāḥ pratyājātāḥ, sarve te 'virahitā buddhadarśanena dharmaśravaṇenāvinipāta-	བྱང་ཆུབ་སེམས་དཔའ་གང་དག་སངས་རྒྱས་ཀྱི་ཞིང་དེར་སྐྱེས་པ་དེ་དག་ཐམས་ཅད་ནི་སངས་རྒྱས་མཐོང་བ་དང་མི་འདྲ་ལ་བ་།
 dharmāṇo, yāvad bodhiparyantaṃ| sarve ca	བྱང་ཆུབ་ཀྱི་མཐའི་བར་དུ་ལོག་པར་མི་ལྟུང་བའི་ཆོས་ཅན་ཤ་སྟག་སྟེ་།
 te tatropādāya na jātv ajātismarā bhaviṣyanti, sthāpayitvā	དེ་དག་ཐམས་ཅད་འདི་ནས་ཉེ་བར་བཟུང་ནས་ནམ་ཡང་ཚེ་རབས་མི་དྲན་པར་མི་འགྱུར་གྱི་ཚེ་རབས་དྲན་པར་འགྱུར་ཏེ་། གང་དག་དཔེར་ན་།
 tathārūpeṣu kalpasaṃkṣobheṣu ye pūrvasthānapraṇihitāḥ pañcasu kaṣāyeṣu vartamāneṣu, yadā buddhānāṃ bhagavatāṃ p50 loke prādurbhāvo bhavati,	ད་ལྟར་གྱི་ང་བཞིན་དུ་སྙིགས་མ་ལྔའི་དུས་ན་གང་གི་ཚེ་སངས་རྒྱས་བཅོམ་ལྡན་འདས་དག་༄༤༠༥བ་འཇིག་རྟེན་དུ་འབྱུང་བར་འགྱུར་བ་དེ་ལྟ་བུའི་བསྐལ་པས་བཀྲུགས་པ་དག་ཏུ་གནས་པར་སྔོན་སྨོན་ལམ་བཏབ་པ་རྣམས་ནི་མ་གཏོགས་སོ་༎
 tad yathāpi nāma mamaitarhi| tasmin khalu punar ānanda buddhakṣetre ye bodhisattvāḥ pratyājātāḥ,	ཀུན་དགའ་བོ་།
 sarve ta ekapurobhaktenānyalokadhātūṃ gatvānekani buddhakoṭīnayutaśatasahasrāṇy upatiṣṭhanti, yāvac cākāṃkṣanti buddhānubhāvena te yathā cittam utpādayanty :	བྱང་ཆུབ་སེམས་དཔའ་གང་དག་སངས་རྒྱས་ཀྱི་ཞིང་དེར་སྐྱེས་པ་དེ་དག་ཐམས་ཅད་སྔ་དྲོ་གཅིག་བཞིན་འཇིག་རྟེན་གྱི་ཁམས་གཞན་དག་ཏུ་དོང་ནས་སངས་རྒྱས་བྱེ་བ་ཁྲག་ཁྲིག་ཕྲག་དུ་མ་ལ་བསྙེན་བཀུར་བྱེད་དེ་།
 evaṃrūpaiḥ puṣpadīpadhūpagandhamālyavilepanacūrṇa- cīvaracchatradhvajapatākāvaijayantītūryasaṃgītivādyaiḥ pūjāṃ kuryāma iti,	དེ་དག་རྣམ་པ་འདི་ལྟ་བུའི་མེ་ཏོག་དང་། བདུག་པ་དང་། མར་མེ་དང་། སྤོས་དང་། ཕྲེང་བ་དང་། བྱུག་པ་དང་། ཕྱེ་མ་དང་། གོས་དང་། གདུགས་དང་། རྒྱལ་མཚན་དང་། བ་དན་དང་། སིལ་སྙན་དང་། གླུ་དབྱངས་དང༏་རོལ་མོའི་དབྱངས་སྒྲ་དག་གིས་མཆོད་པར་བྱའོ་སྙམ་དུ་ཇི་ལྟ་ཇི་ལྟར་སེམས་བསྐྱེད་ཅིང་། 
 teṣāṃ sahacittotpādāt tathārūpāṇy eva sarvapūjāvidhānāni pāṇau prādurbhavanti| te taiḥ puṣpair yāvad vādyais teṣu buddheṣu bhagavatsu pūjāṃ kurvanto bahvapa-	ཇི་ལྟར་འདོད་པ་རྣམས་དེ་དག་གིས་སེམས་བསྐྱེད་མ་ཐག་ཏུ་སངས་རྒྱས་ཀྱི་མཐུས་རྣམ་པ་དེ་ལྟ་བུའི་མཆོད་པའི་ཡོ་བྱད་ཐམས་ཅད་ལག་པ་ནས་འབྱུང་བར་འགྱུར་ཏེ་། དེ་དག་གིས་མེ་ཏོག་ནས་རོལ་མོའི་དབྱངས་སྒྲའི་བར་དེ་དག་གིས་སངས་རྒྱས་བཅོམ་ལྡན་འདས་དེ་དག་ལ་མཆོད་པ་བྱེད་ལ་།
 rimāṇāsaṃkhyeyaṃ kuśalamūlam upacinvanti| sacet punar	དགེ་བའི་རྩ་བ་མང་པོ་ཚད་མེད་། གྲངས་མེད་པ་དག་ཀྱང་བསྐྱེད་ཅིང་གསོག་གོ་།
 ākāṃkṣanty : evaṃrūpāḥ puṣpapuṭāḥ pāṇau prādurbhavanti, teṣāṃ sahacittotpādān nānāvarṇā anekavarṇā nānāgandhā divyāḥ	གལ་ཏེ་མེ་ཏོག་གི་སྐོན་བུ་རྣམ་པ་འདི་ལྟ་བུ་ལག་པ་ནས་འབྱུང་བར་གྱུར་ཅིག་ཅེས་འདོད་ན་ཡང་དེ་དག་གིས་སེམས་བསྐྱེད་མ་ཐག་ཏུ་ལྷའི་མེ་ཏོག་ཁ་དོག་ཐ་དད་པ་།
 puṣpapuṭāḥ pāṇau prādurbhavanti| te tais tathārūpaiḥ	དྲི་ཐ་དད་པ་། དྲི་དུ་མ་ཡོད་པའི་སྐོན་བུ་དག་ལག་པ་ནས་འབྱུང་སྟེ་། དེ་དག་གིས་སྐོན་བུའི་མེ་ཏོག་རྣམ་པ་དེ་ལྟ་བུ་དེ་དག་༄༤༠༦ཨ་༌༎
 puṣpapuṭaiḥ tān buddhān bhagavato 'vakiranti sma,	སངས་རྒྱས་བཅོམ་ལྡན་འདས་དེ་དག་ལ་འཐོར་། མངོན་པར་འཐོར་།
 abhyavakiranty,	མངོན་པར་རབ་ཏུ་འཐོར་རོ་༎
 abhiprakiranti| teṣāṃ ca yaḥ sarvaparīttaḥ puṣpapuṭa utsṛṣṭo, daśayojanavistāram puṣpacchatraṃ prādurbhavanti|	སྐོན་བུའི་མེ་ཏོག་གཏོར་བ་དེ་དག་ཐམས་ཅད་ལས་ནང་གི་ཆུང་དུ་གང་ཡིན་པ་དེ་ཡང་སྟེང་གི་བར་སྣང་ལ་དཔག་ཚད་བཅུའི་ཚད་ཙམ་གྱི་མེ་ཏོག་གི་གདུགས་སུ་འགྱུར་ཏེ་།
 upary antarīkṣe dvitīye cānutsṛṣṭe,	ཕྱི་མ་ཤོས་མ་གཏོར་གྱི་བར་སྔ་མས་ལ་མི་ལྟུང་ངོ་༎
 na prathamo dharaṇyāṃ prapatati| santi tatra puṣpapuṭā ya utsṛṣṭāḥ santo viṃśatiyojanavistārāṇi puṣpacchatrāṇy upary antarīkṣe	དེ་ན་སྐོན་བུའི་མེ་ཏོག་གཏོར་བ་གང་སྟེང་གི་བར་སྣང་ལ་དཔག་ཚད་ཉི་ཤུའི་ཚད་ཙམ་གྱི་གདུགས་སུ་འགྱུར་བ་ཡང་ཡོད་།
 prādurbhavanti| santi triṃśatcatvāriṃśatpañcāśat,	དཔག་ཚད་སུམ་ཅུ་དང་། བཞི་བཅུའི་ཚད་ཙམ་ཡང་ཡོད་།
 santi yojana- śatasahasravistārāṇi puṣpacchatrāṇy upary antarīkṣe prādurbhavanti|	སྟེང་གི་བར་སྣང་ལ་མེ་ཏོག་གི་གདུགས་དཔག་ཚད་བརྒྱ་སྟོང་གི་ཚད་ཀྱི་བར་ཙམ་དུ་འགྱུར་བ་དག་ཀྱང་ཡོད་དོ་༎
 tatra ya udāraṃ prītiprāmodyaṃ saṃjanayanty ; udāraṃ ca cittaudbilyaṃ pratilabhyante ;	དེ་ན་གང་དག་དགའ་བ་དང་མཆོག་ཏུ་དགའ་བ་རྒྱ་ཆེན་པོ་བསྐྱེད་ཅིང་།
 te bahv aparimitam asaṃkhyeyaṃ ca kuśalamūlam avaropya, bahūni buddhakoṭīnayutaśatasahasrāṇy upasthāyaikapūrvāhnena punar	སེམས་དགའ་བ་ཆེན་པོ་ཐོབ་པ་དེ་དག་དགེ་བའི་རྩ་བ་གྲངས་མེད་དཔག་ཏུ་མེད་པ་བསྐྱེད་ནས་སངས་རྒྱས་བྱེ་བ་ཁྲག་ཁྲིག་བརྒྱ་སྟོང་ཕྲག་མང་པོ་ལ་བསྙེན་བཀུར་བྱས་ཏེ་།
 api sukhāvatyāṃ lokadhātau pratiṣṭhante,	སྔ་དྲོ་གཅིག་ལ་སླར་ལོག་ནས་འཇིག་རྟེན་གྱི་ཁམས་བདེ་བ་ཅན་དུ་གནས་སོ་༎
 tasyaivāmitāyuṣas p51 tathāgatasya pūrvapraṇidhānādhiṣṭhānaparigraheṇa, pūrvapraṇidhāna- samṛddhiparipūryānūnayā suvibhaktābhāvitayā|	བཅོམ་ལྡན་འདས་དེ་བཞིན་གཤེགས་པ་ཚེ་དཔག་མེད་དེའི་སྔོན་གྱི་སྨོན་ལམ་གྱི་བྱིན་གྱི་རླབས་ཀྱིས་ཡོངས་སུ་ཟིན་པ་དང་། སྔོན་ཆོས་མཉན་པ་བྱིན་པ་དང་། སྔོན་གྱི་རྒྱལ་བ་ལ་དགེ་བའི་རྩ་བ་བསྐྱེད་པ་དང་། སྔོན་གྱི་སྨོན་ལམ་འབྱོར་ཞིང་ཡོངས་སུ་རྫོགས་པ་དང་། མི་ཉུང་བ་དང་། ཤིན་ཏུ་རྣམ་པར་ཕྱེ་བ་དང་། ༄༤༠༦བ་ཤིན་ཏུ་བསྒོམས་པས་སྨོན་ལམ་བཏབ་པ་འགྲུབ་པ་། ཀུན་དགའ་བོ་།
 tasmin khalu punar ānanda buddhakṣetre ye bodhisattvāḥ pratyājātāḥ, sarve te sarvajñatāsahagatām eva dharmakathāṃ	བྱང་ཆུབ་སེམས་དཔའ་གང་དག་སངས་རྒྱས་ཀྱི་ཞིང་དེར་སྐྱེས་པར་གྱུར་པ་དེ་དག་ཐམས་ཅད་ནི་ཐམས་ཅད་མཁྱེན་པ་ཉིད་དང་ལྡན་པའི་ཆོས་ཀྱི་གཏམ་སྨྲ་བ་དག་གོ་།
 kathyanti| na ca tatra buddhakṣetre sattvānāṃ kācit parigrahasaṃjñāsti,	སངས་རྒྱས་ཀྱི་ཞིང་དེ་ན་སེམས་ཅན་གང་དག་ཡོངས་སུ་འཛིན་པའི་འདུ་ཤེས་འགའ་ཡང་མི་བསྐྱེད་དོ་༎ 
 sarvaṃ tad-buddhakṣetraṃ samanucaṃkramamāṇā,	དེ་དག་ཐམས་ཅད་སངས་རྒྱས་ཀྱི་ཞིང་དེ་ཀུན་དུ་འཆག་ཅིང་རྣམ་པར་རྒྱུ་བ་ན་དོ་༎ དགའ་བ་དང་། 
 anuvicaranto na ratiṃ nāratim utpādayanti| prakrāmantas tāś cānupekṣā evaṃ prakrāmanti,	མི་དགའ་བ་མི་བསྐྱེད་དོ་༎ འགྲོ་བ་ན་ཡང་ལྟོས་པ་མེད་པ་ཉིད་དུ་འགྲོའི་།
 na sāpekṣāḥ	ལྟོས་པ་དང་བཅས་པར་ནི་མ་ཡིན་ནོ་༎ འདི་ལྟ་སྟེ་།
 sarvaśas caiṣām evaṃ cittam nāsti|	དངོས་པོ་ཡོངས་སུ་འཛིན་པ་དང་། གནས་ཀྱི་སེམས་དང་། སེམས་དེ་ལྟ་བུ་དག་དེ་དག་ལ་ཡོད་མེད་དོ་༎ ཀུན་དགའ་བོ་།
 tatra khalu punar ānanda sukhāvatyāṃ lokadhātau ye sattvāḥ pratyājātā, nāsti teṣām anyātakasaṃjñā,	བྱང་ཆུབ་སེམས་དཔའ་གང་དག་འཇིག་རྟེན་གྱི་ཁམས་བདེ་བ་ཅན་དེར་སྐྱེས་པ་དེ་དག་ལ་གཞན་གྱི་འདུ་ཤེས་མེད་།
 nāsti svakasaṃjñā,	རང་གི་འདུ་ཤེས་མེད་།
 nāsti mamasaṃjñā,	བདག་གི་འདུ་ཤེས་མེད་།
 nāsti vigraho,	འཐབ་པ་མེད་།
 nāsti vivādo, nāsti	རྩོད་པ་མེད་།
 virodho, nāsti asamacittaḥ ; samacittās te, hitacittā, maitracittā, mṛducittāḥ, snigdhacittāḥ,	མི་མཐུན་པ་མེད་།
 karmaṇyacittāḥ,	མི་མཉམ་པའི་སེམས་མེད་དེ་།
 prasannacittāḥ, sthiracittā, vinīvaraṇacittā, akṣubhitacittā, aluḍitacittāḥ, prajñāpāramitācaryācaraṇacittāś,	དེ་དག་ནི་སེམས་ཅན་ཐམས་ཅད་ལ་སེམས་མཉམ་པ་དང་། ཕན་པའི་སེམས་དང་། བྱམས་པའི་སེམས་དང་། མཉེན་པའི་སེམས་དང་། འཇམ་པའི་སེམས་དང་། དགེ་བའི་སེམས་དང་། རབ་ཏུ་དང་བའི་སེམས་དང༏་བརྟན་པའི་སེམས་དང་། སྒྲིབ་པ་མེད་པའི་སེམས་དང་། འཁྲུག་པ་མེད་པའི་སེམས་དང་། རྙོག་པ་མེད་པའི་སེམས་དང་། ཤེས་རབ་ཀྱི་ཕ་རོལ་ཏུ་ཕྱིན་པ་ལ་སྤྱད་པ་སྤྱོད་པའི་སེམས་༄༤༠༧ཨ་༌༎
 cittādhārabuddhipraviṣṭāḥ,	དང༏་སེམས་ཀྱི་རྒྱུད་སྒྱུ་མའི་རང་བཞིན་ལ་བློ་རབ་ཏུ་ཞུགས་པ་།
 sāgarasamāḥ prajñayā,	ཤེས་རབ་རྒྱ་མཚོ་ཆེན་པོ་དང་མཉམ་པ་།
 merusamā buddhyānekaguṇasaṃnicayā,	བློ་རི་རབ་དང་མཚུངས་པ་།
 bodhyaṅgasaṃgītyā vikrīḍitā, buddhasaṃgītyābhiyuktā ;	ཡོན་ཏན་དུ་མ་བསགས་པ༏་བྱང་ཆུབ་ཀྱི་ཡན་ལག་ཡང་དག་པར་འགྲོ་བས་རྣམ་པར་བརྩེན་པ་། སངས་རྒྱས་ཡང་དག་པར་འགྲོ་བ་ལ་མངོན་པར་བརྩོན་པ་། ཤའི་མིག་རབ་ཏུ་རྣམ་པར་འབྱེད་པ་།
 māṃsacakṣuḥ praticinvanti| divyaṃ cakṣur abhinirharanti|	ལྷའི་མིག་མངོན་པར་བསྒྲུབ་པ་།
 prajñācakṣurgatiṃgatāḥ,	ཤེས་རབ་ཀྱི་མིག་རྟོགས་པར་ཁོང་དུ་ཆུད་པ་།
 dharmacakṣuḥpāraṃgatāḥ ;	ཆོས་ཀྱི་མིག་གི་ཕ་རོལ་ཏུ་སོན་པ་།
 buddhacakṣur niṣpādayanto, deśayanto, dyotayanto, vistāreṇa	སངས་རྒྱས་ཀྱི་སྤྱན་སྒྲུབ་ཅིང་འཆད་དེ་སྟོན་པ་།
 prakāśayanto ; 'saṅgajñānam abhinirharantas,	རྒྱ་ཆེར་ཡང་དག་པར་རབ་ཏུ་སྟོན་ཅིང་ཆགས་པ་མེད་པའི་ཡེ་ཤེས་མངོན་པར་སྒྲུབ་པ་།
 traidhātukasamatayābhiyuktā,	ཁམས་གསུམ་མཉམ་པ་ཉིད་དུ་མངོན་པར་བརྩོན་པ་།
 dāntacittāḥ,	སེམས་དུལ་བ་།
 śāntacittāḥ,	སེམས་ཞི་བ་།
 sarvadharmānupalabdhi- p52 samanvāgatāḥ,	ཆོས་ཐམས་ཅད་མི་དམིགས་པ་དང་ལྡན་པ་།
 samudayaniruktikuśalā,	ཀུན་འབྱུང་བའི་ངེས་པའི་ཚིག་ལ་མཁས་པ་།
 dharmaniruktisamanvāgatā,	ཆོས་ཀྱི་ངེས་པའི་ཚིག་དང་ལྡན་པ་།
 hārāhārakuśalā,	གསལ་བ་དང་མི་གསལ་བ་ལ་མཁས་པ་།
 nayānayasthānakuśalā ; lokikīṣu	ཚུལ་དང་ཚུལ་མ་ཡིན་པའི་གནས་ལ་མཁས་པ་།
 kathāsv anapekṣā viharanti| lokottarābhiḥ kathābhiḥ sāraṃ	འཇིག་རྟེན་པའི་གཏམ་ལ་མི་ལྟ་བར་གནས་པ་། འཇིག་རྟེན་ལས་འདས་པའི་གཏམ་རྣམས་ཀྱི་སྙིང་པོ་རྟོགས་པ་།
 pratyayanti| sarvadharmaparyeṣṭikusalāḥ,	ཆོས་ཐམས་ཅད་ཡོངས་སུ་ཚོལ་བ་ལ་མཁས་པ་།
 sarvadharmaprakṛtivyupasamajñāna-	ཆོས་ཐམས་ཅད་རང་བཞིན་གྱིས་ཉེ་བར་ཞི་བར་ཤེས་པས་གནས་པ་།
 vihārino, 'nupalambhagocarā,	དམིགས་པ་མེད་པའི་སྤྱོད་ཡུལ་བ་།
 niṣkiñcanā,	ཅི་ཡང་མེད་པ་།
 nirupādānā,	ལེན་པ་མེད་པ་།
 niścintā,	སེམས་པ་མེད་པ་།
 nirupāyāsā,	ཕུང་པོ་མེད་པ་།
 anupādāya suvimuktā, anaṅgaṇā, aparyantasthāyino,	ལེན་པ་མེད་པས་ཤིན་ཏུ་རྣམ་༄༤༠༧བ་པར་གྲོལ་བར་ཉོན་མོངས་པ་མེད་པ་། མངོན་པར་ཤེས་པ་རྣམས་ལ་ཐུག་པ་མེད་པར་གནས་པ་།
 'bhijñāsv amūlasthāyino,	རྩ་བ་མེད་པ་ལ་གནས་པ་།
 'saṅgacittā,	སེམས་ཆགས་པ་མེད་པ་།
 anavalīnā,	ཞུམ་པ་མེད་པ་།
 gambhīreṣu dharmeṣv abhiyuktā na	ཆོས་ཟབ་མོ་རྣམས་ལ་མངོན་པར་བརྩོན་པ་། སྒྱིད་ལུག་པ་མེད་པ་།
 saṃsīdanti| duranubodhabuddhajñānapraveśodgatā,	སངས་རྒྱས་ཀྱི་ཡེ་ཤེས་རྟོགས་པར་དཀའ་བ་ལ་འཇུག་པས་།
 ekāyatanamārgānuprāptā,	འཕགས་པ་བགྲོད་པ་གཅིག་པུའི་ལམ་རྗེས་སུ་ཐོབ་པ་།
 nirvicikitsās, tīrṇakathaṃkathā,	ཐེ་ཚོམ་མེད་པ་།
 aparapratyayajñānā,	དོགས་པ་ལས་བརྒལ་པ༏་ཤེས་པ་གཞན་གྱི་དྲིང་ལ་མི་འཇོག་པ་།
 anadhimāninaḥ ;	ལྷག་པའི་ང་རྒྱལ་མེད་པ་།
 sumerusamā jñāne 'bhyudgatāḥ ;	ཡེ་ཤེས་ཀྱིས་མངོན་པར་འཕགས་ཏེ་རི་རབ་དང་མཚུངས་པ་།
 sāgarasamā buddhyākṣobhyā ; candrasūryaprabhātikrāntāḥ prajñayā,	འཁྲུགས་པ་མེད་པའི་བློས་རྒྱ་མཚོ་དང་འདྲ་བ་།
 pāṇḍarasuśuklaśubhacittayā ca ; uttaptahemavrṇasadṛaśāvabhāsa- nirbhāsaguṇapradhānatayā ca ;	ཤེས་རབ་ཀྱི་འོད་དང་དཀར་ཞིང་ཤིན་ཏུ་དཀར་ལ་དག་ཅིང་དགེ་བའི་སེམས་དང་། གསེར་བཙོ་མའི་ཁ་དོག་འདྲ་བར་སྣང་ཞིང་འོད་འབྱུང་བའི་ཡོན་ཏན་གྱི་མཆོག་གིས་ཉི་ཟླའི་འོད་ལས་ཤིན་ཏུ་འདས་པ་།
 vasuṃdharāsadṛśāḥ sarvasattva- śubhāśubhakṣapanatayā ;	སེམས་ཅན་ཐམས་ཅད་ཀྱི་དགེ་བ་དང་། མི་དགེ་བ་བཟོད་པས་ས་དང་མཚུངས་པ་།
 apsadṛśāḥ sarvakleśamalanidhāvana-	ཉོན་མོངས་པའི་དྲི་མ་འཁྲུ་བར་འབབ་པས་ཆུ་དང་འདྲ་བ་།
 pravāhanatayā ; agnirājasadṛśāḥ sarvadharmamanyanākleśanirdahanatayā ;	ཆོས་ཐམས་ཅད་ལ་རློམ་སེམས་སུ་བྱེད་པ་དང་། ཉོན་མོངས་པ་སྲེག་པའི་ཕྱིར་མེའི་ཕུང་པོ་དང་མཚུངས་པ་།
 vāyusadṛśāḥ sarvalokāsaṃjanatayā ;	འཇིག་རྟེན་ཐམས་ཅད་ལ་མི་ཆགས་པའི་ཕྱིར་རླུང་དང་འདྲ་བ་།
 ākāśasadṛśāḥ sarvadharmanairvedhikatayā, sarvaśo niṣkiṃcanatayā ca|	ཆོས་ཐམས་ཅད་ངེས་པར་ཕིགས་པ་དང་ཐམས་ཅད་དུ་ཅི་ཡང་མེད་པའི་ཕྱིར་ནམ་མཁའ་དང་མཚུངས་པ་དང་། 
 padmasadṛśāḥ sarvalokānupaliptayā ; kālānusārimahāmeghasadṛśā	འཇིག་རྟེན་ཐམས་ཅད་ཀྱིས་མི་གོས་པའི་ཕྱིར་པདམ་དང་འདྲ་བ་།
 dharmābhigarjanatayā ;	ཆོས་དང་ཆོས་མ་ཡིན་པ་མངོན་པར་སྒྲོགས་པས་དུས་ཀྱི་རྗེས་སུ་འབྲང་བའི་༄༤༠༨ཨ་༌༎
 mahāvṛṣṭisadṛśā dharmasalilābhivarṣaṇatayā ;	འབྲུག་ཆེན་པོ་དང་མཚུངས་པ་། ཆོས་ཀྱི་ཆུའི་ཆར་མངོན་པར་འབེབས་པས་ཆར་བ་ཆེན་པོ་དང་འདྲ་བ་།
 ṛṣabhasadṛśā mahāgaṇābhibhavanatayā ;	ཚོགས་ཆེན་པོ་ཟིལ་གྱིས་གནོན་པས་ཁྱུ་མཆོག་དང་མཚུངས་པ་།
 mahānāgasadṛśāḥ paramasudāntacittatayā ;	སེམས་ཤིན་ཏུ་མཆོག་ཏུ་དུལ་བས་གླང་པོ་ཆེ་ཆེན་པོ་དང་འདྲ་བ་།
 bhadrāśvājāneyasadṛśāḥ	ཤིན་ཏུ་དུལ་བས་རྟ་ཅང་ཤེས་བཟང་པོ་དང་མཚུངས་པ་།
 suvinītatayā ; siṃhamṛgarājasadṛśā vikramavaiśāradyāsaṃtrastatayā ; p53 nyagrodhadrumarājasadṛśāḥ sarvasattvaparitrāṇatayā ;	རྩལ་དང་མི་འཇིགས་པས་སྐྲག་པ་མེད་པའི་ཕྱིར་རི་དབ༹གས་ཀྱི་རྒྱལ་པོ་སེང་གེ་དང་འདྲ་བ་། སེམས་ཅན་ཐམས་ཅད་ཡོངས་སུ་སྐྱོད་པས་ཤིང་གི་རྒྱལ་པོ་ནྱ་གྲོ་ད་དང་མཚུངས་པ་།
 sumeruparvatarājasadṛśāḥ sarvaparavādyakampanatayā ;	ཕས་ཀྱི་རྒོལ་བ་ཐམས་ཅད་ཀྱིས་མི་ག-ཡོས་པས་རིའི་རྒྱལ་པོ་རི་རབ་དང་འདྲ་བ་།
 gaganasadṛśā aparimāṇamaitrībhāvanatayā ; mahābrahmasamāḥ	བྱམས་པ་ཚད་མེད་པ་བསྒོམས་པས་ནམ་མཁའ་དང་མཚུངས་པ་།
 sarvakuśalamūladharmādhipatyapūrvaṃgamanatayā ; pakṣisadṛśāḥ saṃnicayasthānatayā ;	དགེ་བའི་ཆོས་ཐམས་ཅད་ཀྱི་དབང་དུ་བྱ་བའི་སྔོན་དུ་འགྲོ་བས་ཚངས་པ་ཆེན་པོ་དང་འདྲ་བ༏་གནས་སུ་གསོག་པ་མེད་པས་བྱ་དང་མཚུངས་པ་། 
 garuḍadvijarājasadṛśāḥ parapravādividhvaṃsanatayā ;	ཕས་ཀྱི་རྒོལ་བ་ཐམས་ཅད་རྣམ་པར་འཇོམས་པས་བྱའི་རྒྱལ་པོ་ནམ་མཁའི་ལྡིང་དང་འདྲ་པ་། བ་། 
 udumbarapuṣpasadṛśā durlabhotpattyarthitayā ;	འབྱུང་བར་དཀའ་བའི་ཕྱིར་ཨཽ་དུམ་ཝ་རའི་མེ་ཏོག་དང་མཚུངས་པ་།
 nāgavat susamāhitā, avikṣiptā,	གླང་པོ་ཆེ་ལྟར་ཤིན་ཏུ་མཉམ་པར་བཞགས་པས་རྣམ་པར་ག-ཡེང་བ་མེད་པ་།
 ajihmendriyā ;	དབང་པོ་རྨུགས་པ་མེད་པ་།
 viniścayakuśalāḥ,	རྣམ་པར་གཏན་ལ་འབེབས་པ་ལ་མཁས་པ་།
 kṣāntisaurabhyabahulā ; anīrṣyakāḥ	བཟོད་པ་དང་དེས་པ་མང་བ་། ཕ་རོལ་ཕུན་སུམ་ཚོགས་པར་སྨོན་པས་ཕྲག་དོག་མེད་པ་།
 parasaṃpattyaprārthatayā| viśāradā dharmakathāsv ;	ཆོས་ཀྱི་གཏམ་རྣམས་ལ་འཇིགས་པ་མེད་པ་།
 atṛptā dharmaparyeṣṭau ;	ཆོས་ཡོངས་སུ་ཚོལ་བས་ངོམས་མི་༄༤༠༨བ་མྱོང་བ་།
 vaiḍūryasadṛśāḥ śīlena ;	ཚུལ་ཁྲིམས་ཀྱིས་བེཨེ་དའུརྱ་དང་འདྲ་བ་།
 ratnākarāḥ	ཐོས་པ་རིན་པོ་ཆེའི་འབྱུང་གནས་དང་མཚུངས་པ་།
 śrutena ; mañjusvarā mahādharmadundubhighoṣena ;	ཆོས་ཀྱི་རྔ་སྒྲ་ཆེན་པོས་སྒྲ་སྙན་པ་།
 mahādharmabherīṃ parāghnanto ;	ཆོས་ཀྱི་རྔ་ཆེན་པོ་བརྡུང་བ་།
 mahādharmaśaṅkham āpūrayanto ;	ཆོས་ཀྱི་དུང་ཆེན་པོ་འབུད་པ་།
 mahādharmadhvajām ucchrāpayanato ;	ཆོས་ཀྱི་རྒྱལ་མཚན་ཆེན་པོ་བསྒྲེང་བ་། ཆོས་ཀྱི་བ་དན་ཆེན་པོ་འཛིན་པ་།
 mahādharmolkāṃ prajvālayantaḥ ;	ཆོས་ཀྱི་སྒྲོན་མ་ཆེན་པོ་རབ་ཏུ་འབར་བར་བྱེད་པ་།
 prajñāvilokino,	ཤེས་རབ་ཀྱིས་རྣམ་པར་ལྟ་བ་རྨོངས་པ་མེད་པ་།
 'saṃmūḍhā, nirdoṣāḥ,	ཞེ་སྡང་མེད་པ་།
 śāntākhilāḥ,	ཐ་བ་བཏུལ་བ་།
 śuddhā,	དག་པ་།
 nirāmagandhā,	དྲིང་བ་མེད་པ་།
 alubdhāḥ,	བརྐམ་པ་མེད་པ་།
 saṃvibhāgaratā,	ཡང་དག་པར་འགེང་བ་ལ་དགའ་བ་།
 muktatyāgāḥ,	གཏོང་བ་བཏང་བ་།
 prasṛtapāṇayo,	སྦྱིན་པ་ལ་ལག་བརྐྱང་བ་།
 dānasaṃvibhāgaratā dharmāmiṣābhyām, dāne 'matsariṇo, 'saṃsṛṣṭā,	ཆོས་དང་ཟང་ཟིང་ཡང་དག་པར་འགྱེད་པ་ལ་དགའ་བ་སྦྱིན་པ་ལ་སེར་སྣ་མེད་པ་།
 anuttrastamānasā,	འདྲེས་པ་མེད་པ་། ཡིད་འཇིགས་པ་མེད་པ་།
 viraktā, dhīrā,	ཆགས་པ་མེད་པ་། བརྟན་པ་།
 vīrā, dhaureyā,	དཔའ་བ་།
 dhṛtimanto,	གཅེས་པར་འཛིན་པ་། མོས་པ་དང་ལྡན་པ་།
 hrīmanto, 'sādṛśyā,	ངོ་ཚ་ཤེས་པ་དང་ལྡན་པ་། ཟུག་རྔུ་ཕྱུང་བ༏་གཏན་པ་མེད་པ་།
 nirargaḍā, prāptābhijñāḥ,	མངོན་པར་ཤེས་པ་ཐོབ་པ་། དེས་པ་།
 suratāḥ sukhasaṃvāsā, arthakarā, p54	འགྲོགས་ན་བདེ་བ་། དོན་བྱེད་པ་།
 lokapradyotā,	འཇིག་རྟེན་གསལ་བར་བྱེད་པ་།
 nāyakā,	འདྲེན་པ་།
 nandīrāgānunayapratighāḥ, prahīṇāḥ,	དགའ་བའི་འདོད་ཆགས་དང་། རྗེས་སུ་ཆགས་པ་དང་། ཁོང་ཁྲོ་བ་སྤངས་པ་།
 śuddhāḥ, śokāpagatā,	དག་པ་། མྱ་ངན་དང་བྲལ་བ་།
 nirmalās,	དྲི་མ་མེད་པ་།
 trimalaprahīṇā,	དྲི་མ་གསུམ་སྤངས་པ་།
 vikrīḍitābhijñā,	མངོན་པར་ཤེས་པས་རྣམ་པར་བརྩེན་པ་།
 hetubalikāḥ,	རྒྱུའི་སྟོབས་ཅན་།
 praṇidhānabalikā, ajihmā, akuṭilāḥ|	སྨོན་ལམ་གྱི་སྟོབས་ཅན་།
 ye te bahubuddhakoṭīnayutaśatasahasrāvaropitakuśalamūlā,	མི་དམན་པ་། གྱ་གྱུ་མེད་པ་། སངས་རྒྱས་བྱེ་བ་ཁྲག་ཁྲིག་བརྒྱ་སྟོང་ཕྲག་མང་པོ་ལ་དགེ་བའི་རྩ་བ་བསྐྱེད་པ་།
 utpāṭitamānaśalyā,	ང་རྒྱལ་གྱི་ཟུག་རྔུ་བཏོན་པ་།
 apagatarāgadveṣamohāḥ,	འདོད་ཆགས་དང་། ཞེ་སྡང་དང་། གཏི་མུག་དང་བྲལ་བ་།
 śuddhāḥ,	དག་པ་། དགེ་༄༤༠༩ཨ་༌༎
 śuddhādhimuktā,	བ་ལ་མོས་པ་།
 jinavarapraśastā,	རྒྱལ་བ་།
 lokapaṇḍitā,	དམ་པས་བསྔགས་པས་འཇིག་རྟེན་ན་མཁས་པ་།
 uttaptajñānasamudgatā,	སྦྱངས་པའི་ཡེ་ཤེས་ཡང་དག་པར་བསྒྲུབས་པ་།
 jinastutās,	རྒྱལ་བས་བསྟོད་པ་།
 cittaudbilyasamanvāgatāḥ,	སེམས་དགའ་བ་དང་ལྡན་པ་།
 śūrā,	རྟུལ་ཕོད་པ་། སྲན་ཐུབ་པ་།
 dṛḍhā, asamā,	མཉམ་པ་མེད་པ་།
 akhilā, atulā,	ཐ་བ་མེད་པ་། གཞལ་དུ་མེད་པ་།
 arajasaḥ, sahitā,	རྡུལ་མེད་པ་།
 udārā,	འདུས་པ་རྒྱ་ཆེ་བ་།
 ṛṣabhā, hrīmanto,	ཁྱུ་མཆོག་ཏུ་གྱུར་པ་། བདེན་པ་སྨྲ་བ་།
 dhṛtimantaḥ,	བློ་དང་ལྡན་པ་།
 smṛtimanto,	དྲན་པ་དང་ལྡན་པ་།
 matimanto,	བློ་གྲོས་དང་ལྡན་པ་།
 gatimantaḥ,	རྟོགས་པ་དང་ལྡན་པ་།
 prajñāśastrapraharaṇāḥ,	ཤེས་རབ་ཀྱི་མཚོན་ཆའི་ལག་ཆ་ཅན་།
 puṇyavanto,	བསོད་ནམས་དང་ལྡན་པ་།
 dyutimanto,	འོད་དང་ལྡན་པ་།
 vyapagatakhilamalaprahīṇā,	ཐ་བ་དང་། དྲི་མ་དང་། ཁོང་ཁྲོ་བ་དང་བྲལ་བ་།
 abhiyuktāḥ sātatyeṣu dharmeṣu|	ཆོས་ལ་རྟག་ཏུ་བརྩོན་པ་། ཆོས་ཐམས་ཅད་ལ་ཐོས་བརྒྱ་མཚོ་ལྟ་བུར་གྱུར་པ་ཤ་སྟག་གོ་། ཀུན་དགའ་བོ་།
 īdṛśā ānanda tasmin buddhakṣetre bodhisattvā mahāsattvāḥ saṃkṣiptena| vistareṇa punaḥ sacet kalpakoṭīnayutaśatasahasrasthitikenāpy āyuṣpramāṇena tathāgato nirdiśed, na tv eva śakyaṃ teṣāṃ satpuruṣāṇāṃ guṇaparyanto 'dhigantum| na ca	མདོར་བསྡུ་ན་སངས་རྒྱས་ཀྱི་ཞིང་དེའི་བྱང་ཆུབ་སེམས་དཔའ་རྣམས་ནི་འདི་ལྟ་བུ་ཤ་སྟག་སྟེ་། རྒྱས་པར་བྱ་ན་གལ་ཏེ་དེ་བཞིན་གཤེགས་པ་ཚེའི་ཚད་བསྐལ་པ་བྱེ་བ་ཁྲག་ཁྲིག་བརྒྱ་སྟོང་དུ་གནས་པས་བསྟན་ཀྱང་སྐྱེས་བུ་དམ་པ་དེ་དག་གི་ཡོན་ཏན་གྱི་མཐའ་བསྟན་པ་མི་། ནུས་ལ་། 
 tathāgatasya vaiśāradyopacchedo bhavet| tat kasya hetoḥ| ubhayam apy etad ānandācintyam atulyam,	དེ་བཞིན་གཤེགས་པའི་མི་འཇིགས་པ་ཡང་རྒྱུན་ཆད་པར་མི་འགྱུར་རོ་༎ དེ་ཅིའི་ཕྱིར་ཞེ་ན་། ཀུན་དགའ་བོ་།
 yad idam : teṣāṃ	འདི་ལྟ་སྟེ་།
 ca bodhisattvānāṃ guṇās tathāgatasya cānuttaraṃ prajñāpratibhānam|	བྱང་ཆུབ་སེམས་དཔའ་དེ་དག་གི་ཡོན་ཏན་རྣམས་དང་། དེ་བཞིན་གཤེགས་པའི་ཤེས་རབ་ཀྱི་སྤོབས་པ་བླ་ན་མེད་པ་དེ་གཉིས་ཀ་ཡང་བསམ་གྱིས་མི་ཁྱབ་ཅིང་མཚུངས་པ་མེད་པའི་ཕྱིར་རོ་༎ ཀུན་དགའ་བོ་།
 api cānanda uttiṣṭha paścānmukho bhūtvā, puṣpāṇy avakīryāñjaliṃ pragṛhya, praṇipata| eṣāsau dig,	ལོངས་ལ་ནུབ་༄༤༠༩བ་ཕྱོགས་སུ་ཕྱོགས་ཏེ་མེ་ཏོག་གཏོར་ལ་ཐལ་མོ་སྦྱོར་ཏེ་།
 yatra sa bhagavān amitābhas tathāgato 'rhan samyaksaṃbuddhas tiṣṭhati dhriyate p55 yāpayati, dharmaṃ ca deśayati ; virajo viśuddho, yasya	གང་ན་བཅོམ་ལྡན་འདས་དེ་བཞིན་གཤེགས་པ་དགྲ་བཅོམ་པ་ཡང་དག་པར་རྫོགས་པའི་སངས་རྒྱས་འོད་དཔག་མེད་རྡུལ་མེད་ཅིང་རྣམ་པར་དག་པ་བཞུགས་ཤིང་འཚོ་ལ་གཞེས་ཤིང་ཆོས་ཀྱང་སྟོན་པའི་ཕྱོགས་དེར་ཕྱག་འཚོལ་ཅིག་།
 taṃ nāmadheyam anāvaraṇaṃ daśadiśi loke vighuṣṭam ekaikasyāṃ	དེའི་མཚན་དེ་ཡང་སྒྲིབ་པ་མེད་པར་ཕྱོགས་བཅུར་གྲགས་ཏེ་།
 diśi gaṅgānadīvālikāsamā buddhā bhagavanto varṇayanti, stuvanti, praśaṃsanty, asakṛd asakṛd asaṅgavācāprativākyāḥ|	ཕྱོགས་རེ་རེ་ན་ཡང་སངས་རྒྱས་བཅོམ་ལྡན་འདས་གསུང་ཆགས་པ་མི་མངའ་ཞིང་གསུང་ཐོགས་པ་མི་མངའ་བ་གངགའའི་ཀླུང་གི་བྱེ་མ་སྙེད་དག་ལན་འགའ་ལན་འགའ་མ་ཡིན་པར་བསྔགས་པ་བརྗོད་ཅིང་བསྟོད་དེ་སྙན་བ་གསུང་ངོ་༎
 evam ukta, āyusmān ānando bhagavantam etad avocat :	དེ་སྐད་ཅེས་བཀའ་སྩལ་བ་དང་། བཅོམ་ལྡན་འདས་ལ་ཚེ་དང་ལྡན་པ་ཀུན་དགའ་བོས་འདི་སྐད་ཅེས་གསོལ་ཏོ་༎
 icchāmy ahaṃ bhagavantaṃ tam amitābham	བཅོམ་ལྡན་འདས་།
 amitaprabham amitāyuṣaṃ tathāgatam arhantaṃ samyaksaṃbuddhaṃ	བདག་དེ་བཞིན་གཤེགས་པ་དགྲ་བཅོམ་པ་ཡང་དག་པར་རྫོགས་པའི་སངས་རྒྱས་འོད་དཔག་ཏུ་མེད་པ་དེ་དང་། 
 draṣṭum, tāṃś ca bodhisattvān mahāsattvān bahubuddhakoṭīnayutaśatasahasrāvaropitakuśalamūlān| samanantarābhāṣitā	ཚེ་དཔག་ཏུ་མེད་པ་དེ་དང་། བྱང་ཆུབ་སེམས་དཔའ་སེམས་དཔའ་ཆེན་པོ་སངས་རྒྱས་བྱེ་བ་ཁྲག་ཁྲིག་བརྒྱ་སྟོང་མང་པོ་ལ་དགེ་བའི་རྩ་བ་བསྐྲུན་པ་དེ་དག་ལ་ལྟ་འཚལ་ལོ་༎ 
 cāyuṣmatānandeneyaṃ vāk, atha tāvad eva so 'mitābhas tathāgato 'rhan samyaksaṃbuddhaḥ svapāṇitalāt	ཚེ་དང་ལྡན་པ་ཀུན་དགའ་བོས་ཚིག་འདི་སྨྲས་མ་ཐག་ཏུ་དེ་ནས་དེའི་མོད་ལ་ལོ་༎ 
 tathārūpāṃ prabhāṃ prāmuñcat, yayedaṃ koṭīśatasahasratamaṃ buddhakṣetraṃ mahatāvabhāsena sphuṭam abhūt|	། དེ་བཞིན་གཤེགས་པ་དགྲ་བཅོམ་པ་ཡང་དག་པར་རྫོགས་པའི་སངས་རྒྱས་དེའི་ཕྱག་གི་མཐིལ་ནས་འོད་གང་གིས་སངས་རྒྱས་ཀྱི་ཞིང་བྱེ་བ་བརྒྱ་སྟོང་སྣང་བས་ཁྱབ་པར་འགྱུར་བ་དེ་ལྟ་བུའི་འོད་ཕྱུང་ངོ་༎
 tena khalv api samayena sarvatra koṭīśatasahasrabuddhakṣetrāṇāṃ,	དེའི་ཚེ་སངས་རྒྱས་ཀྱི་ཞིང་བྱེ་བ་བརྒྱ་སྟོང་ཐམས་ཅད་༄༤༡༠ཨ་༌༎
 ye kecit kālaparvatā vā,	ནི་རི་ནག་པོའམ་།
 ratnaparvatā vā,	རིན་པོ་ཆེའི་རིའམ་། ལྷུན་པོའམ་།
 merumahāmerumucilindamahāmucilindacakravāḍamahācakravāḍā	ལྷུན་པོ་ཆེན་པོའམ་། བཏང་བཟུང་ངམ་། བཏང་བཟུང་ཆེན་པོའམ་། ཁོར་ཡུག་གམ་། ཁོར་ཡུག་ཆེན་པོའམ་།
 vā, bhittayo vā,	རྩིག་པའམ་།
 stambhā vā,	ཀ་བའམ་།
 vṛkṣagahanodyānavimānāni	ཤིང་ལྗོན་པ་སྟུག་པོའམ་། སྐྱེད་མོས་ཚལ་ལམ་། གཞལ་མེད་ཁང་ངམ་།
 vā divyamānuṣyakāni, tāni sarvāṇi tasya tathāgatasya tayā prabhayābhinirbhinnāny abhūvan, samabhibhūtāni|	ལྷ་དང་མི་གང་སུ་དག་ཡོད་པ་དེ་དག་ཐམས་ཅད་ལས་དེ་བཞིན་གཤེགས་པ་འོད་དཔག་མེད་དེའི་འོད་ཀྱིས་ཐལ་བར་གྱུར་ཅིང་ཟིལ་གྱིས་ནོན་པར་གྱུར་ཏོ་༎ 
 tad yathāpi nāma puruṣo vyāmamātrake sthito dvitīyaṃ	འདི་ལྟ་སྟེ་། དཔེར་ན་།
 puruṣaṃ pratyavekṣata āditye 'bhyudgata ;	ཉི་མ་ཤར་ནས་མི་ཞིག་འོད་མ་གང་ཙམ་ན་འདུག་པ་ལ་མི་ཞིག་བལྟ་བ་དེ་བཞིན་དུ༏་དེའི་ཚེ་འདི་ལྟ་སྟེ་།
 evam evāsmin buddhakṣetre bhikṣubhikṣuṇyupāsakopāsikā devanāgayakṣa- gandharvāsuragaruḍakinnaramahoragāś ca tasyāṃ velāyām	སངས་རྒྱས་ཀྱི་མཐུ་དང་། འོད་དེ་ཡོངས་སུ་དག་པའི་ཕྱིར་དགེ་སློང་དང་། དགེ་སློང་མ་དང་། དགེ་བསྙེན་དང་། དགེ་བསྙེན་མ་དག་དང་། ལྷ་དང་། ཀླུ་དང་། གནོད་སྦྱིན་དང་། དྲི་ཟ་དང་། ལྷ་མ་ཡིན་དང་། ནམ་མཁའ་ལྡིང་དང་། མིའམ་ཅི་དང་། ལྟོ་འཕྱེ་ཆེན་པོ་དང་། མི་དང་། མི་མ་ཡིན་པ་དག་སངས་རྒྱས་ཀྱི་ཞིང་འདི་ནས་།
 adrākṣus tam amitābhaṃ tathāgatam arhantaṃ samyaksaṃbuddhaṃ, sumerum iva parvatarājānaṃ sarvakṣetrābhyudgatam, sarvadiso 'bhibhūya, bhāsamānaṃ tapantaṃ virocamānaṃ p56 bibhrājamānaṃ,	དེ་བཞིན་གཤེགས་པ་དགྲ་བཅོམ་པ་ཡང་དག་པར་རྫོགས་པའི་སངས་རྒྱས་འོད་དཔག་མེད་རིའི་རྒྱལ་པོ་རི་རབ་ལྟར་སངས་རྒྱས་ཀྱི་ཞིང་ཐམས་ཅད་ནས་མངོན་པར་འཕགས་ཏེ་།
 taṃ ca mahāntaṃ bodhisattvagaṇaṃ, taṃ ca bhikṣusaṃghaṃ, yad idaṃ buddhānubhāvena tasyāḥ prabhayāḥ pariśuddhatvāt|	ཕྱོགས་ཐམས་ཅད་ཟིལ་གྱིས་མནན་ནས་ལྷ་མ་མེ་ལྷན་ནེ་ལྷང་ངེར་མཛེས་པ་དེ་དང་། བྱང་ཆུབ་སེམས་དཔའི་ཚོགས་ཆེན་པོ་དང་། དགེ་སློང་གི་དགེ་འདུན་དེ་ལ་བལྟའོ་༎ འདི་ལྟ་སྟེ་།
 tad yatheyaṃ mahāpṛthivy ekodakajātā bhavet, tatra na	དཔེར་ན་། ས་ཆེན་པོ་འདི་ཆུ་༄༤༡༠བ་གཅིག་ཏུ་གྱུར་ན་།
 vṛkṣā, na parvatā,	དེ་ལ་ཤིང་ལྗོན་པ་རྣམས་མེད་། རི་རྣམས་མེད་།
 na dvīpā,	གླིང་རྣམས་མེད་།
 na tṛṇagulmauṣadhivanaspatayo,	རཙབ༹་དང་ཤིང་གེལ་བ་དང་། སྨན་དང་། ནགས་ཚལ་རྣམས་མེད་། ཆུ་ཀླུང་རྣམས་མེད་ཅིང་།
 na nadīśvabhraprapātāḥ prajñāyeran,	ངམ་གྲོག་དང༏་ག-ཡང་ས་རྣམས་མི་སྣང་སྟེ་།
 anyatraikārṇavībhūtamahāpṛthivy	གཞན་དུ་ན་ས་ཆེན་པོ་རྒྱ་མཚོ་གཅིག་ཏུ་གྱུར་པ་ནི་མ་གཏོགས་སོ་༎
 aikā syāt ; evam eva tasmin buddhakṣetre nāsty	དེ་བཞིན་དུ་སངས་རྒྱས་ཀྱི་ཞིང་དེ་ན་ཉན་ཐོས་རྣམས་ཀྱི་ལུས་ལས་མངོན་པར་འགྲུབ་པའི་འོད་འདོམ་གང་བ་དང་། བྱང་ཆུབ་སེམས་དཔའ་རྣམས་ཀྱི་འོད་དཔག་ཚད་བྱེ་བ་བརྒྱ་སྟོང་ཡོད་པ་མ་གཏོགས་པར་གཞན་རྟགས་སམ་། 
 anyat kiṃcil liṅgaṃ vā, nimittaṃ vānyatraiva vyāmaprabhāḥ	མཚན་མ་ཅུང་ཟད་མེད་དོ་༎ བཅོམ་ལྡན་འདས་།
 śrāvakās, te ca yojanakoṭīśatasahasraprabhā bodhisattvāḥ, sa ca bhagavān amitābhas tathāgato 'rhan samyaksaṃbuddhas, taṃ ca śrāvakagaṇaṃ taṃ ca bodhisattvagaṇam abhibhūya, sarvā diśaḥ prabhāsayan saṃdṛśyate| tena khalv api samayena tasyāṃ sukhāvatyāṃ lokadhātau bodhisattvāḥ śrāvākadevamanuṣyāś ca sarve ta imāṃ lokadhātuṃ, śākyamuniṃ ca tathāgataṃ mahatā bhikṣusaṃghena parivṛtaṃ paśyanti sma,	དེ་བཞིན་གཤེགས་པ་དགྲ་བཅོམ་པ་ཡང་དག་པར་རྫོགས་པའི་སངས་རྒྱས་འོད་དཔག་མེད་དེས་ཉན་ཐོས་ཀྱི་ཚོགས་དེ་དང་། བྱང་ཆུབ་སེམས་དཔའི་ཚོགས་དེ་ཟིལ་གྱིས་མནན་ནས་ཕྱོགས་ཐམས་ཅད་དུ་གསལ་བར་ཀུན་དུ་སྣང་ངོ་༎ དེའི་ཚེ་འཇིག་རྟེན་གྱི་ཁམས་བདེ་བ་ཅན་དེར་བྱང་ཆུབ་སེམས་དཔའ་དང་། ཉན་ཐོས་དང་། རང་སངས་རྒྱས་ཐམས་ཅད་དང་། ལྷ་དང་། མི་དེ་དག་ཐམས་ཅད་དང་། འཇིག་རྟེན་གྱི་ཁམས་མི་མཇེད་འདི་དང་། དེ་བཞིན་གཤེགས་པ་ཤའཀྱ་ཐུབ་པ་དགེ་སློང་གི་དགེ་འདུན་ཆེན་པོས་བསྐོར་ཞིང་ཆོས་སྟོན་པ་ཡང་སྣང་ངོ་༎ 
 dharmaṃ ca deśayantam| tatra khalu bhagavān ajitaṃ bodhisattvaṃ mahāsattvam āmantrayate sma :	དེ་ནས་བཅོམ་ལྡན་འདས་ཀྱིས་བྱང་ཆུབ་སེམས་དཔའ་སེམས་དཔའ་ཆེན་པོ་མི་ཕམ་པ་ལ་བཀའ་སྩལ་པ་།
 paśyasi tvam ajitāmuṣmin buddhakṣetre guṇālaṃkāravyūhasaṃpadam ; upariṣṭāś cāntarīkṣa ārāmaramaṇīyāni, vanaramaṇīyāny, udyānaramaṇīyāni,	མི་འཕམ་པོ་ཁྱོད་ཀྱིས་སངས་རྒྱས་ཀྱི་ཞིང་དེའི་ཡོན་ཏན་གྱི་རྒྱན་བཀོད་པ་ཕུན་སུམ་ཚོགས་པ་འདི་དང་། 
 nadīpuṣkiriṇīramaṇīyāni, nānāratnamayotpalapadmakumudapuṇḍaṛīkākīrṇāni ; adhastāc ca dharaṇitalam upādāya, yāvad akaniṣṭhabhavanād,	༄༤༡༡ཨ་༌༎ སྟེང་གི་པར་སྣང་ལ་ཀུན་དགའི་ར་མཉམ་དགའ་བ་དག་དང་། ནགས་ཚལ་ཉམས་དགའ་བ་དག་དང་། སྐྱེད་མོས་ཚལ་ཉམས་དགའ་བ་དག་དང་། ཆུ་ཀླུང་དང་། རྫིང་བུ་ཉམས་དགའ་བ་དག་དང་། རིན་པོ་ཆེའི་མེ་ཏོག་པདམ་དང་། ཀུ་མུ་ད་དང་། པདམ་དཀར་པོས་གང་བ་དག་དང་། འོག་ཏུ་སའི་སྟེང་ནས་བཟུང་སྟེ་།
 gaganatalaṃ puṣpābhikīrṇaṃ, puṣpāvalisamupaśobhitaṃ, nānāstambhapaṅktiparisphuṭaṃ tathāgatābhinirmita-	འོག་མིན་གྱི་གནས་ཀྱི་བར་གྱི་ནམ་མཁའི་ངོས་ལ་མེ་ཏོག་བཀྲམ་པ་དང་། མེ་ཏོག་གི་ཕྲེང་བ་སྐུན་དུ་མཛེས་པར་བྱས་པ་དང་། རིན་པོ་ཆེ་སྣ་ཚོགས་བཀྲ་བའི་ཕྲེང་གིས་གང་བ་དང་། དེ་བཞིན་གཤེགས་པས་སྤྲུལ་པའི་བྱ་སྣ་ཚོགས་ཀྱིས་བསྟེན་པ་མཐོང་ངམ་།
 nānādvijasaṃghaniṣevitam| āha :	གསོལ་པ་།
 paśyāmi bhagavan, bhagavān	བཅོམ་ལྡན་འདས་། མཐོང་ལགས་སོ་༎
 āha : paśyasi punas tvam ajitaitān aparān dvijasaṃghān p57	བཅོམ་ལྡན་འདས་ཀྱིས་བཀའ་སྩལ་པ་།
 sarvabuddhakṣetrān buddasvareṇābhijijñāpayanti, yenaite	མི་ཕམ་པ་ཁྱོད་ཀྱིས་འདི་ལས་གཞན་པའི་བྱའི་ཚོགས་སངས་རྒྱས་ཀྱི་ཞིང་ཐམས་ཅད་སྒྲས་གོ་བར་བྱེད་ཅིང་། 
 bodhisattvā nityam avirahitā buddhānusmṛtyā| āha : paśyāmi	དེས་བྱང་ཆུབ་སེམས་དཔའ་དེ་དག་རྟག་ཏུ་སངས་རྒྱས་རྗེས་སུ་དྲན་པ་དང་མི་འབྲལ་བར་གྱུར་པ་དག་མཐོང་ངམ་། གསོལ་པ་། བཅོམ་ལྡན་འདས་།
 bhagavan| bhagavān āha :	མཐོང་ལགས་སོ་༎ བཅོམ་ལྡན་འདས་ཀྱིས་བཀའ་སྩལ་པ་།
 paśyasi tvam ajitātra buddhakṣetre amūn sattvān yojanaśatasahasrakeṣu vimāneṣv abhirūḍhān,	མི་ཕམ་པ་ཁྱོད་ཀྱིས་སངས་རྒྱས་ཀྱི་ཞིང་འདི་ན་སེམས་ཅན་འདི་དག་གཞལ་མེད་ཁང་དཔག་ཚད་བརྒྱ་སྟོང་ཡོད་པ་དག་ཏུ་ཞུགས་ཏེ་།
 antarīkṣe 'saktān krāmataḥ| āha :	བར་སྣང་ལ་ཆགས་པ་མེད་པར་འགྲོ་བ་དག་མཐོང་ངམ་། གསོལ་པ་།
 paśyāmi bhagavan|	བཅོམ་ལྡན་འདས་། མཐོང་ལགས་སོ་།
 bhagavān āha :	བཅོམ་ལྡན་འདས་ཀྱིས་༄༤༡༡བ་། བཀའ་སྩལ་པ་། མི་ཕམ་པ་།
 tat kiṃ manyase 'jita ; asti kiṃcin	འདི་ཇི་སྙམ་དུ་སེམས་།
 nānātvaṃ devānāṃ vā paranirmitavaśavartināṃ sukhāvatyām lokadhātau manuṣyaṇāṃ vā| āha :	གཞན་འཕྲུལ་དབང་བྱེད་ཀྱི་ལྷ་རྣམས་དང་། འཇིག་རྟེན་གྱི་ཁམས་བདེ་བ་ཅན་དུ་སྐྱེས་པའི་མི་རྣམས་ཐ་དད་དུ་བྱ་བ་ཡོད་དམ་། གསོལ་པ་། བཅོམ་ལྡན་འདས་།
 ekam apy ahaṃ bhagavan	བདག་གིས་ནི་ཐ་དད་དུ་བགྱི་བ་གཅིག་ཀྱང་ཡང་དག་པར་རྗེས་སུ་མ་མཐོང་སྟེ་།
 nānātvaṃ na samanupaśyāmi| yāvad maharddhikā atra sukhāvatyāṃ lokadhātau manuṣyāḥ| bhagavān āha : paśyasi	འཇིག་རྟེན་གྱི་ཁམས་བདེ་བ་ཅན་དེའི་མི་རྣམས་ནི་རྫུ་འཕྲུལ་ཆེ་བའི་བར་དུ་ལགས་སོ་༎ བཅོམ་ལྡན་འདས་ཀྱིས་བཀའ་སྩལ་པ་།
 punas tvam ajita tatra sukhāvatyāṃ lokadhātāv ekeṣāṃ manuṣyāṇām udāreṣu padmeṣu garbhāvāsam| āha ;	མི་ཕམ་པ་ཁྱོད་ཀྱིས་འཇིག་རྟེན་གྱི་ཁམས་བདེ་བ་ཅན་དེ་ན་མི་ཁ་ཅིག་པདམ་ཆེན་པོ་དག་གི་མངལ་ན་གནས་པ་མཐོང་ངམ་། གསོལ་པ་། བཅོམ་ལྡན་འདས་།
 tad yathāpi	འདི་ལྟ་སྟེ་། དཔེར་ན་།
 nāma bhagavan trayaśtriṃśā devā yāmā devā vā, pañcāśadyojanakeṣu	སུམ་ཅུ་རྩ་གསུམ་དང་། འཐབ་བྲལ་གྱི་ལྷ་རྣམས་གཞལ་མེད་ཁང་དཔག་ཚད་ལྔ་བཅུ་པའམ་།
 vā, yojanaśatikeṣu vā,	དཔག་ཚད་བརྒྱ་པའམ་།
 pañcayojanaśatikeṣu	དཔག་ཚད་ལྔ་བརྒྱ་པ་རྣམས་སུ་ཞུགས་ཏེ་།
 vimāneṣu praviṣṭāḥ krīḍanti, ramanti, paricārayanti ; evam	རྩེ་དགའ་ཞིང་དགའ་མགུར་སྤྱོད་པ་དེ་བཞིན་དུ་། བཅོམ་ལྡན་འདས་།
 evāhaṃ bhagavan atra sukhāvatyāṃ lokadhātāv ekeṣāṃ manuṣyāṇām udārapadmeṣu garbhāvāsaṃ paśyāmi|	བདག་གིས་འཇིག་རྟེན་གྱི་ཁམས་བདེ་བ་ཅན་དེའི་མི་ཁ་ཅིག་པདམ་ཆེན་པོ་དག་གི་མངལ་ན་གནས་པར་མཐོང་ལགས་སོ་༎ བཅོམ་ལྡན་འདས་།
 santi khalu punar atra bhagavan sattvā ya upapādukāḥ padmeṣu paryaṅkaiḥ prādurbhavanti| tat ko 'tra bhagavan	དེ་ན་སེམས་ཅན་བརྫུས་ཏེ་འབྱུང་བ་གང་དག་པདམ་རྣམས་ལ་སྐྱིལ་མོ་ཀྲུང་བཅས་ཏེ་འབྱུང་བ་དག་ཀྱང་མཆིས་ན་། བཅོམ་ལྡན་འདས་།
 hetuḥ, kaḥ pratyayo, yad anye punar garbhāvāse prativasanti ; anye punar upapādukāḥ paryaṅkaiḥ padmeṣu prādurbhavanti|	ཁ་ཅིག་པདམའི་མངལ་ན་གནས་པ་དང་། ཁ་ཅིག་པདམ་ལ་སྐྱིལ་མོ་ཀྲུང་བཅས་ནས་བརྫུས་ཏེ་འབྱུང་བ་དེའི་རྒྱུ་ནི་གང་ལགས་། རྐྱེན་ནི་གང་ལགས་།
 bhagavān āha :	བཅོམ་ལྡན་འདས་ཀྱིས་བཀའ་སྩལ་པ་། མི་ཕམ་པ་།
 ye te 'jita bodhisattvā anyeṣu buddhakṣetreṣu	བྱང་ཆུབ་སེམས་དཔའ་གང་༄༤༡༢ཨ་༌༎ དག་སངས་རྒྱས་ཀྱི་ཞིང་གཞན་དག་ན་གནས་ཏེ་།
 sthitāḥ sukhāvatyāṃ lokadhātāv upapattaye vicikitsām p58 utpādayanti, tena cittena kuśalamūlāny avaropayanti,	ཐོ་ཚོམ་དུ་ལྷུང་བའི་སེམས་ཀྱི་འཇིག་རྟེན་གྱི་ཁམས་བེ་བ་ཅན་དུ་སྐྱེ་བ་བྱ་བའི་ཕྱིར་དགེ་བའི་རྩ་བ་རྣམས་བསྐྱེད་པ་དེ་དག་ནི་དེ་ན་མངལ་ན་གནས་སོ་༎
 teṣām atra garbhāvāso bhavati| ye punar nirvicikitsāś cchinnakāṃkṣāḥ	གང་དག་ཐེ་ཚོམ་མེད་ཅིང་སོམ་ཉི་མ་མེད་དེ་།
 sukhāvatyāṃ lokadhātāv upapattaye kuśalamūlāny avaropayanti, buddhānāṃ bhagavatām asaṅgajñānam avakalpayanty abhiśraddhadhaty adhimucyante ; tatropapādukāḥ	འཇིག་རྟེན་གྱི་ཁམས་བདེ་བ་ཅན་དུ་སྐྱེ་བར་བྱ་བའི་ཕྱིར་དགེ་བའི་རྩ་བ་རྣམས་བསྐྱེད་ལ་སངས་རྒྱས་བཅོམ་ལྡན་འདས་རྣམས་ཀྱི་ཡེ་ཤེས་ཆགས་པ་མེད་པ་ལ་ཡིད་ཆེས་ཤིང་དད་ལ་མོས་པ་དེ་དག་ནི་པདམ་རྣམས་ལ་སྐྱིལ་མོ་ཀྲུང་བཅས་ནས་བརྫུས་ཏེ་བྱུང་ངོ་༎ མི་ཕམ་པ་།
 padmeṣu paryaṅkaiḥ prādurbhavanti| ye te 'jita bodhisattvā mahāsattvā anyatrabuddhakṣetrasthāś cittam utpādayanty amitābhasya tathāgatasyārhataḥ samyaksaṃbuddhasya darśanāya, na vicikitsām utpādayanti,	བྱང་ཆུབ་སེམས་དཔའ་སེམས་དཔའ་ཆེན་པོ་སངས་རྒྱས་ཀྱི་ཞིང་གཞན་ན་གནས་པ་གང་དག་དེ་བཞིན་གཤེགས་པ་དགྲ་བཅོམ་པ་ཡང་དག་པར་རྫོགས་པའི་སངས་རྒྱས་འོད་དཔག་མེད་ལ་བལྟ་བ་དང་། ཕྱག་བྱ་བ་དང་། བསྙེན་བཀུར་བྱ་བར་སེམས་བསྐྱེད་ཅིང་ཐེ་ཚོམ་མི་བསྐྱེད་ལ་།
 na kāṃkṣanty asaṅgabuddhajñānaṃ, svakucalamūlaṃ cābhiśraddhadhati, teṣām aupapādukānāṃ paryaṅkaiḥ padmeṣu prādurbhūtānāṃ muhūrtamātreṇaivaivaṃrūpaḥ kāyo bhavati,	སངས་རྒྱས་ཀྱི་ཡེ་ཤེས་ཆགས་པ་མེད་པ་ལ་སོམ་ཉི་མེད་ཅིང་རང་གི་དགེ་བའི་རྩ་བ་ཡང་གསོག་པ་དེ་དག་ནི་སྐྱིལ་མོ་ཀྲུང་བཅས་ནས་བརྫུས་ཏེ་འབྱུང་བར་འགྱུར་ཏེ་།
 tad yathānyeṣāṃ ciropapannānāṃ sattvānām|	འདི་ལྟ་སྟེ་། དཔེར་ན་། བྱང་ཆུབ་སེམས་དཔའ་སྐྱེས་ནས་རིང་པོ་མ་ལོན་པ་གཞན་དག་དང་འདྲ་བར་ཡུད་ཙམ་གྱིས་ལུས་རྣམ་པ་དེ་ལྟ་བུར་འགྱུར་རོ་༎
 paśyājita prajñādaurbalyaṃ prajñāvaimātraṃ prajñāparihāṇiṃ	མི་ཕམ་པ་།
 prajñāparīttatāṃ,	ཤེས་རབ་ཀྱི་ཁྱད་པར་དང་། ཤེས་རབ་ཀྱི་རིམ་པ་དང་། འདི་ལྟ་སྟེ་།
 yatra hi nāma pañcavarṣaśatāni parihīṇā bhavanti buddhadarśanād, bodhisattvadarśanāt,	ཐེ་ཚོམ་དུ་ལྷུང་བའི་འདུ་ཤེས་ཡིད་ལ་བྱེད་པས་འདི་ལྟར་༄༤༡༢བ་ལོ་ལྔ་བརྒྱར་སངས་རྒྱས་མཐོང་བ་ལས་ཡོངས་སུ་ཉམས་ཤིང་།
 saddharmadarśanād, dhārmasaṃkathyāt ; kuśalamūlacaryāyāḥ parihīṇā bhavanti sarvakuśalamūlasaṃpatter,	བྱང་ཆུབ་སེམས་དཔའ་མཐོང་བ་དང་། ཆོས་མཉམ་པ་དང་། ཆོས་ཀྱི་གཏམ་དང་། དགེ་བའི་སྤྱོད་པ་དང་། དགེ་བ་ཕུན་སུམ་ཚོགས་པ་ཐམས་ཅད་ལས་ཡོངས་སུ་ཉམས་པའི་ཤེས་རབ་ཡོངས་སུ་ཉམས་པ་དང་། ཤེས་རབ་ཆུང་བ་ལ་ལྟོས་། མི་ཕམ་པ་།
 yad idaṃ vicikitsāpatitaiḥ saṃjñāmanasikāraiḥ|	འདི་ལྟ་སྟེ་། འདི་ལྟ་སྟེ་།
 tad yathājita rājñaḥ kṣatriyasya mūrdhānābhiṣiktasya bandhanāgāraṃ bhavet,	དཔེར་ན་། རྒྱལ་པོ་རྒྱལ་རིགས་སྤྱི་བོ་ནས་དབང་བསྐུར་བ་ལ་ཁྲི་མོན་གསེར་དང་། བེདའུ་རྱ་ཐམས་ཅད་ཀྱིས་སྤྲས་པ་། དར་དང་། ཕྲེང་བ་དང་། ལྔ་ལྡིའི་ཚོགས་དཔྱངས་པ་། ཚོན་སྣ་ཚོགས་ཀྱིས་བླ་རེ་བྲེས་པ་།
 sarvasauvarṇavaiḍūryapratyuptam, avasaktapaṭṭamālyadāmakalāpaṃ, nānāraṅgavitatavitānaṃ,	རས་བཅོས་བུ་གཏིང་བ༏་མེ་ཏོག་གི་སིལ་མ་སྣ་ཚོགས་བཀྲམ་པ་།
 dūṣyapaṭṭasaṃcchannaṃ,	བདུག་པ་རྒྱ་ཆེན་པོས་གདུགས་པ་།
 nānāmuktakusumābhikīrṇam, udāraṃ, dhūpanirdhūpitaṃ, prāsādaharmyagavākṣavedikātoraṇavicitra-	ཁང་བཟང་དང་། བསིལ་ཁང་དང་། སྐར་ཁུང་དང་། ཁ་ཁྱེར་དང་། རྟ་བབས་དང་། བ་གམ་རིན་པོ་ཆེ་སྣ་ཚོགས་ཐམས་ཅད་ཀྱིས་བརྒྱན་པ་།
 sarvaratnapratimaṇḍitaṃ, hemaratnakaṃkaṇījālasaṃcchannaṃ,	གསེར་དང་རིན་པོ་ཆེའི་དྲིལ་བུ་ག-ཡེར་ཁའི་དྲ་བས་བྲེས་པ་།
 caturasraṃ,	གྲུ་བཞི་ལྷམ་པ་།
 catuḥsthūṇaṃ caturdvāraṃ,	ཀ་བ་བཞི་ཟུག་པ་། སྒོ་བཞི་བཏོད་པ་།
 catuḥsopānakam|	ཐེམ་སྐས་བཞི་བཅས་པ་ཞིག་ཡོད་ལ་།
 tatra tasya rājñaḥ putraḥ kenacid eva kṛtyena prakṣipto p59	རྒྱལ་པོ་དེའི་བུ་ཉེས་པ་ཞིག་གི་ཕྱིར་ཁྲི་མོན་དེར་བཅུག་སྟེ་།
 jāmbūnadasuvarṇamayair nigaḍair baddho bhavati| tasya	འཛམ་བུའི་ཆུ་བོའི་གསེར་གྱི་ཁོང་སྒྲིལ་དུ་བཅུག་ལ་།
 ca tatra paryaṅkaḥ prajñaptaḥ syād, anekagoṇikāstīrṇas,	དེར་དེའི་ཁྲི་བཤམས་ཏེ་སྟན་ཀོ་ནི་ཀ་བཏིང་བ་ལ་།
 tūlikāpalālikāstīrṇaḥ,	བར་ཚངས་ཅན་དང༏་པ་ལ་ལི་ཀ་བཏིང་སྟེ་།
 kācilindikasukhasaṃsparśaḥ, kāliṅga- prāvaraṇasottarapaṭacchadana,	ཡུལ་ཀ་ལིང་ཀའི་རས་ཀྱིས་གདིང་བ་བཏིང་ལ་། དེའི་སྟེང་དུ་དར་བཏིང་སྟེ་། ག-ཡས་ག-ཡོན་གཉིས་སུ་རྟེན་མ་དམར་པོ་བཞག་ལ་།
 ubhayāntalohitopadhānaś, citro,	བཀྲ་བ་།
 darśanīyaḥ| sa tatrābhiniṣaṇṇo vābhinipanno vā bhavet| bahu	བལྟ་ན་སྡུག་པ་དེ་ལ་དེ་༄༤༡༣ཨ་༌༎ འདུག་ཀྱང་རུང་།
 cāsyānekavidhaṃ śucipraṇītaṃ pānabhojanaṃ tatropanāmyet|	ཉལ་ཡང་རུང་། དེའི་ཟས་སྐོམ་གཙང་མ་བསོད་བ་རྣམ་པ་མང་པོ་དུ་མ་བཤམས་ན་།
 tat kiṃ manyase 'jita ;	མི་ཕམ་པ་། འདི་ཇི་སྙམ་དུ་སེམས་།
 udāras tasya rājaputrasya sa paribhogo	རྒྱལ་པོའི་བུ་དེ་ཡོངས་སུ་སྤྱད་པ་རྒྱ་ཆེ་བ་ཡིན་ནམ་། གསོལ་པ་།
 bhavet| āha : udāro bhagavan| bhagavān āha : tat kiṃ	བཅོམ་ལྡན་འདས་། རྒྱ་ཆེ་ལགས་སོ་༎ བཅོམ་ལྡན་འདས་ཀྱིས་བཀའ་སྩལ་པ་།
 manyase 'jita ;	མི་ཕམ་པ་། འདི་ཇི་སྙམ་དུ་སེམས་།
 api tv āsvādayet,	དེས་དེའི་རོ་མྱང་བར་བྱེད་དམ་།
 sa tan nigamayed vā,	མིད་པར་བྱེད་དམ་།
 tena vā tuṣṭiṃ vidyāt| āha :	དེས་དགའ་བ་འཐོབ་བམ་། གསོལ་པ་།
 no hīdaṃ bhagavan| api tu	བཅོམ་ལྡན་འདས་། དེ་ནི་མ་ལགས་ཏེ་།
 khalu punar yena vyapanītena rājñā tatra bandhanāgāre prakṣipto bhavet,	ནོངས་པ་གང་གི་སླད་དུ་རྒྱལ་པོས་ཁྲི་མོན་དེར་སྩལ་པ་།
 sa tato mokṣam evākāṃkṣayet| abhijātān kumārān amātyān stryāgārān śreṣṭhino gṛhapatīn koṭṭarājño	དེ་ལས་ཐར་པར་འཚལ་ཞིང་རིགས་བཟང་པོ་རིགས་བཟང་པོའི་གཞོན་ནུ་དང་། བློན་པོ་དང་། བཙུན་མོའི་འཁོར་དང་། ཚོང་དཔོན་དང་། ཁྱིམ་བདག་དང་། ཁམས་ཀྱི་རྒྱལ་པོའམ་།
 vā paryeṣed, ya enaṃ tato bandhanāgārāt parimocayeyuḥ|	གང་གིས་ཁྲི་མོན་དེ་ལས་ཡོངས་སུ་ཐར་པར་འགྱུར་བ་ཡོངས་སུ་ཚོལ་ཏེ་། བཅོམ་ལྡན་འདས་།
 kiṃ cāpi bhagavaṃs tasya kumārasya tatra bandhanāgāre nābhiratiḥ| nātra parimucyate, yāvan na rājā prasādam upadarśayati|	རྒྱལ་པོའི་བུ་དེ་བཙོན་ར་དེ་ན་དགའ་བ་མ་མཆིས་ཤིང་རྒྱལ་པོས་མ་གནང་གི་བར་དུ་མི་ཐར་རོ་༎ 
 bhagavān āha :	བཅོམ་ལྡན་འདས་ཀྱིས་བཀའ་སྩལ་པ་།
 evam evājita, ye te bodhisattvāḥ	མི་ཕམ་པ་།
 vicikitsāpatitāḥ kuśalamūlāny avaropayanti, kāṃkṣanti buddhajñānam asamasamajñānaṃ, kiṃ cāpi te buddhanāmaśravaṇena, tena ca cittaprasādamātreṇātra sukhāvatyāṃ lokadhātāv upapadyante| na tu khalv aupapādukāḥ padmeṣu	དེ་བཞིན་དུ་བྱང་ཆུབ་སེམས་དཔའ་གང་དག་ཐེ་ཚོམ་དུ་ལྷུང་བས་དགེ་བའི་རྩ་བ་བསྐྱེད་ཅིང་སངས་རྒྱས་ཀྱི་ཡེ་ཤེས་མི་མཉམ་པ་དང་། མཉམ་པའི་ཡེ་ཤེས་ལ་སོམ་ཉི་ཟ་བ་དེ་དག་སངས་རྒྱས་ཀྱི་མཚན་ཐོས་པ་དེ་དང་། སེམས་དང་བ་ཙམ་དེས་འཇིག་རྟེན་གྱིས་ཁམས་བདེ་བ་ཅན་དེར་སྐྱེ་ཡང་པདམ་རྣམས་ལ་སྐྱིལ་མོ་ཀྲུང་༄༤༡༣བ་བཅས་ཤིང་བརྫུས་ཏེ་འབྱུང་བ་མ་ཡིན་གྱི་། 
 paryaṅkaiḥ prādurbhavanti| api tu padmeṣu garbhāvāse p60	པདམ་རྣམས་ཀྱི་མངལ་ན་གནས་པ་མྱོང་སྟེ་།
 prativasanti| kiṃ cāpi teṣāṃ tatrodyānavimānasaṃjñāḥ	དེ་དག་དེ་ལ་སྐྱེད་མོས་ཚལ་དང་། གཞལ་མེད་ཁང་དུ་འདུ་ཤེས་ཤིང་གནས་ཏེ་།
 saṃtiṣṭhante| nāsty uccāraprasrāvaṃ,	བཤང་གཅི་མེད་།
 nāsti kheṭasiṃhānakaṃ,	མཆིལ་མ་མེད་། སྣབས་མེད་།
 na pratikūlaṃ manasaḥ pravartate| api tu khalu punaḥ pañca varṣaśatāni virahitā bhavanti buddhadarśanena, dharmaśravaṇena,	ཡིད་དང་མི་མཐུན་པ་མི་འབྱུང་མོད་ཀྱི་།
 bodhisattvadarśanena, dharmasāṃkathyaviniścayena, sarvakuśaladharmacaryābhiś ca| kiṃ cāpi te	ལོ་ལྔ་བརྒྱར་སངས་རྒྱས་མཐོང་བ་དང་། ཆོས་མཉན་པ་དང་། བྱང་ཆུབ་སེམས་དཔའ་མཐོང་བ་དང་། འབེལ་བའི་ཆོས་ཀྱི་གཏམ་རྣམ་པར་ངེས་པ་དང་། དགེ་བའི་ཆོས་སྤྱོད་པ་ཐམས་ཅད་དང་བྲལ་བ་ཡིན་ཏེ་།
 tatra nābhiramante,	དེ་དག་དེ་ན་མངོན་པར་མི་དགའ་ཞིང་མགུ་བ་མི་འཐོབ་ཀྱི་།
 na tuṣṭiṃ vidanti| api tu khalu punaḥ pūrvāparādhaṃ kṣapayitvā, te bhūyas tataḥ paścān niṣkrāmanti|	སྔོན་གྱི་ཉེས་པ་ཟད་ནས་དེ་དག་པདམའི་མངལ་ནས་འབྱུང་སྟེ༏་དེ་དག་དེ་ནས་བྱུང་ཡང་སྟེང་ངམ་། འོག་གམ་།
 na caiṣāṃ tato niṣkrāmatāṃ niṣkramaḥ prajñāyata, ūrdhvam	ཐད་ཀར་བྱུང་བ་མི་ཤེས་སོ་༎ མི་ཕམ་པ་།
 adhas tiryag vā| paśyājita ; yatra hi nāma pañcabhir varṣaśatair bahūni buddhakoṭīnayutaśatasahasrāṇy upasthātavyāni,	འདི་ལྟར་ལོ་ལྔ་བརྒྱར་སངས་རྒྱས་བྱེ་བ་ཁྲག་ཁྲིག་བརྒྱ་སྟོང་མང་པོ་ལ་བསྙེན་བཀུར་བྱ་བ་དང་། 
 bahvasaṃkhyeyāprameyāni	དགེ་བའི་རྩ་བ་མང་པོ་གྲངས་མེད་། ཚད་མེད་།
 ca kuśalamūlāny avaropayitavyāni ca syuḥ| buddhadharmāś ca parigṛhītavyāḥ| tat sarvaṃ vicikitsādoṣeṇa	དཔག་ཏུ་མེད་པ་དག་བསྐྱེད་པར་བྱ་བ་དང་། སངས་རྒྱས་ཀྱི་ཆོས་དཔག་ཏུ་མེད་པ་ཡོངས་སུ་གཟུང་བར་བྱ་བ་དེ་ཐམས་ཅད་ཀྱང་ཐེ་ཚོམ་ཟ་བའི་ཉེས་པས་བསྒྲུབས་པར་མ་གྱུར་པ་ལ་ལྟོས་། 
 virāgayanti| paśyājita kiyan mahate 'narthāya	མི་ཕམ་པ་།
 bodhisattvānāṃ vicikitsā saṃvartata iti|	ཐེ་ཚོམ་གྱིས་བྱང་ཆུབ་སེམས་དཔའ་རྣམས་ལ་གནོད་པ་ཆེན་པོ་ཇི་ཙམ་དུ་འགྱུར་བ་ལ་ལྟོས་། མི་ཕམ་པ་།
 tasmāt tarhy ajita ; bodhisattvair nirvicikitsair bodhāya	དེ་ལྟ་བས་ན་བྱང་ཆུབ་སེམས་དཔའ་དག་གིས་ཐེ་ཚོམ་ཡོངས་སུ་སྤངས་ཏེ་།
 cittam utpādya, kṣipraṃ sarvasattvahitasukhādhānāya sāmarthāpratilambhārthaṃ,	བྱང་ཆུབ་ཏུ་སེམས་བསྐྱེད་ལ་མྱུར་དུ་སེམས་ཅན་ཐམས་ཅད་ལ་ཕན་པ་དང་བདེ་བའི་སྟོབས་བསྐྱེད་པའི་མཐུ་ཐོབ་པར་བྱ་བའི་ཕྱིར་། གང་ན་བཅོམ་ལྡན་༄༤༡༤ཨ་༌༎
 sukhāvatyāṃ lokadhātāv upapattaye kuśalamūlāni pariṇāmayitavyāni, yatra bhagavān amitāyus tathāgato 'rhan samyaksaṃbuddhaḥ|	འདས་དེ་བཞིན་གཤེགས་པ་དགྲ་བཅོམ་པ་ཡང་དག་པར་རྫོགས་པའི་སངས་རྒྱས་འོད་དཔག་མེད་བཞུགས་པའི་འཇིག་རྟེན་གྱི་ཁམས་བདེ་བ་ཅན་དུ་སྐྱེ་བར་བྱ་བའི་ཕྱིར་དགེ་བའི་རྩ་བ་རྣམས་ཡོངས་སུ་བསྔོ་བར་བྱའོ་༎ 
 evam ukte, 'jito bodhisattvo bhagavantam etad avocat :	དེ་སྐད་ཅེས་བཀའ་སྩལ་པ་དང་། བཅོམ་ལྡན་འདས་ལ་བྱང་ཆུབ་སེམས་དཔའ་མི་ཕམ་པས་འདི་སྐད་ཅེས་གསོལ་ཏོ་༎ བཅོམ་ལྡན་འདས་།
 kiyantaḥ punar bhagavan bodhisattvā ito buddhakṣetrāt pariniṣpannā, anyeṣāṃ vā buddhānāṃ bhagavatām antikād	སངས་རྒྱས་ཀྱི་ཞིང་འདི་ནས་བྱང་ཆུབ་སེམས་དཔའ་ཡོངས་སུ་གྲུབ་པ་དང་། སངས་རྒྱས་ཀྱི་ཞིང་གཞན་དག་གི་སངས་རྒྱས་བཅོམ་ལྡན་འདས་རྣམས་ཀྱི་གན་ནས་ཇི་སྙེད་ཅིག་འཇིག་རྟེན་གྱི་ཁམས་བདེ་བ་ཅན་དུ་སྐྱེ་བར་འགྱུར་། བཅོམ་ལྡན་འདས་ཀྱིས་བཀའ་སྩལ་པ་། མི་ཕམ་པ་།
 ye sukhāvatyāṃ lokadhātāv upapatsyante| bhagavān āha : p61 ito hy ajita buddhakṣetrād dvāsaptatikoṭīnayutāni bodhisattvānāṃ pariniṣpannāni,	བྱང་ཆུབ་སེམས་དཔའ་ཡོངས་སུ་གྲུབ་པ་བྱེ་བ་ཁྲག་ཁྲིག་ཕྲག་བདུན་ཅུ་རྩ་གཉིས་སངས་རྒྱས་ཀྱི་ཞིང་འདི་ནས་འཇིག་རྟེན་གྱི་ཁམས་བདེ་བ་ཅན་དུ་སྐྱེ་བར་འགྱུར་ཏེ་།
 yāni sukhāvatyāṃ lokadhātāv upapatsyante, pariniṣpannānām avaivarttikānāṃ bahubuddhakoṭī- śatasahasrāvaropitaiḥ kuśalamūlaiḥ| kaḥ punar vādas, tataḥ parīttataraiḥ kuśalamūlaiḥ| duṣprasahasya tathāgatasyāntikād aṣṭādaśakoṭīnayutāni bodhisattvānāṃ sukhāvatyāṃ lokadhātāv upapatsyante ;	སངས་རྒྱས་བྱེ་བ་ཁྲག་ཁྲིག་བརྒྱ་སྟོང་ཕྲག་མང་པོ་ལ་དགེ་བའི་རྩ་བ་བསྐྱེད་པས་ཕྱིར་མི་ལྡོག་པར་ཡོངས་སུ་འགྲུབ་ན་དགེ་བའི་རྩ་བ་དེ་བས་ཆུང་ངུ་རྣམས་ལྟ་སྨོས་ཀྱང་ཅི་དགོས་། དེ་བཞིན་གཤེགས་པ་བཟོད་པར་དཀའ་བའི་གན་ནས་བྱང་ཆུབ་སེམས་དཔའ་བྱེ་བ་ཁྲག་ཁྲིག་ཕྲག་བཅོ་བརྒྱད་འཇིག་རྟེན་གྱི་ཁམས་བདེ་བ་ཅན་དུ་སྐྱེ་བར་འགྱུར་རོ་༎
 pūrvāntare digbhāge ratnākaro nāma tathāgato viharati|	བྱང་ཤར་གྱི་ཕྱོགས་མཚམས་ན་དེ་བཞིན་གཤེགས་པ་དཀོན་མཆོག་འབྱུང་གནས་ཞེས་བྱ་བ་བཞུགས་ཏེ་།
 tasyāntikān navatibodhisattvakoṭyaḥ sukhāvatyām lokadhātāv upapatsyante ;	དེའི་གན་༄༤༡༤བ་ནས་བྱང་ཆུབ་སེམས་དཔའ་བྱེ་བ་ཕྲག་དགུ་བཅུ་འཇིག་རྟེན་གྱི་ཁམས་བདེ་བ་ཅན་དུ་སྐྱེ་བར་འགྱུར་རོ་༎
 jyotiṣprabhasya tathāgatasyāntikād dvāviṃśatibodhisattvakoṭyaḥ sukhāvatyāṃ lokadhātāv upapatsyante ;	དེ་བཞིན་གཤེགས་པ་སྐར་མའི་འོད་ཀྱི་གན་ནས་བྱང་ཆུབ་སེམས་དཔའ་བྱེ་བ་ཕྲག་ཉི་ཤུ་རྩ་གཉིས་འཇིག་རྟེན་གྱི་ཁམས་བདེ་བ་ཅན་དུ་སྐྱེ་བར་འགྱུར་རོ་༎ 
 amitaprabhasya tathāgatasyāntikāt pañcaviṃśatibodhisattvakoṭyaḥ sukhāvatyāṃ lokadhātāv upapatsyante ;	དེ་བཞིན་གཤེགས་པ་དབྱངས་དཔག་མེད་ཀྱི་གན་ནས་བྱང་ཆུབ་སེམས་དཔའ་བྱེ་བ་ཕྲག་ཉི་ཤུ་རྩ་ལྔ་འཇིག་རྟེན་གྱི་ཁམས་བདེ་བ་ཅན་དུ་སྐྱེ་བར་འགྱུར་རོ་༎
 lokapradīpasya tathāgatasyāntikāt ṣaṣṭibodhisattvakoṭyaḥ sukhāvatyāṃ lokadhātāv upapatsyante ;	དེ་བཞིན་གཤེགས་པ་འཇིག་རྟེན་གྱི་སྒྲོན་མའི་གན་ནས་བྱང་ཆུབ་སེམས་དཔའ་བྱེ་བ་ཕྲག་དྲུག་ཅུ་འཇིག་རྟེན་གྱི་ཁམས་བདེ་བ་ཅན་དུ་སྐྱེ་བར་འགྱུར་རོ་༎ 
 nāgābhibhuvas tathāgatasyāntikāt catuḥṣaṣtibodhisattvakoṭyaḥ sukhāvatyām lokadhātāv upapatsyante ;	དེ་བཞིན་གཤེགས་པ་ཀླུ་ཟིལ་གྱིས་གནོན་པའི་གན་ནས་བྱང་ཆུབ་སེམས་དཔའ་བྱེ་བ་ཕྲག་དྲུག་ཅུ་རྩ་བཞི་འཇིག་རྟེན་གྱི་ཁམས་བདེ་བ་ཅན་དུ་སྐྱེ་བར་འགྱུར་རོ་༎
 virajaprabhasya tathāgatasyāntikāt pañcaviṃśatibodhisattvakoṭyaḥ sukhāvatyāṃ lokadhātāv upapatsyante ;	དེ་བཞིན་གཤེགས་པ་རྡུལ་བྲལ་འོད་ཀྱི་གན་ནས་བྱང་ཆུབ་སེམས་དཔའ་བྱེ་བ་ཕྲག་ཉི་ཤུ་རྩ་ལྔ་འཇིག་རྟེན་གྱི་ཁམས་བདེ་བ་ཅན་དུ་སྐྱེ་བར་འགྱུར་རོ་༎ 
 siṃhasya tathāgatasyāntikād aṣṭādaśabodhisattvasahasrāṇi sukhāvatyāṃ lokadhātāv upapatsyante ;	དེ་བཞིན་གཤེགས་པ་སེང་གེའི་གན་ནས་བྱང་ཆུབ་སེམས་དཔའ་ཁྲི་བརྒྱད་སྟོང་འཇིག་རྟེན་གྱི་ཁམས་བདེ་བ་ཅན་དུ་སྐྱེ་བར་འགྱུར་བར་འགྱུར་རོ་༎ རོ་༎ 
 śrīkūṭasya tathāgatasyāntikād ekāśītibodhisattvakoṭīnayutāni sukhāvatyāṃ lokadhātāv upapatsyante ;	དེ་བཞིན་གཤེགས་པ་དཔལ་བརྩེགས་ཀྱི་གན་ནས་བྱང་ཆུབ་སེམས་དཔའ་བྱེ་བ་ཁྲག་ཁྲིག་ཕྲག་བརྒྱད་ཅུ་རྩ་གཅིག་འཇིག་རྟེན་གྱི་ཁམས་བདེ་བ་ཅན་དུ་སྐྱེ་བར་འགྱུར་རོ་བར་འགྱུར་རོ་༎ 
 narendrarājasya tathāgatasyāntikād daśabodhisattvakoṭīnayutāni sukhāvatyāṃ lokadhātāv upapatsyante ; p62	རོ་༎ ༎ དེ་བཞིན་གཤེགས་པ་མིའི་དབང་པོའི་གན་ནས་བྱང་ཆུབ་སེམས་དཔའ་བྱེ་བ་ཁྲག་ཁྲིག་ཕྲག་བཅུ་འཇིག་རྟེན་གྱི་ཁམས་བདེ་བ་ཅན་དུ་སྐྱེ་བར་འགྱུར་རོ་༎
 balābhijñasya tathāgatasyāntikād dvādaśabodhisattvasahasrāṇi sukhāvatyāṃ lokadhātāv upapatsyante ;	དེ་བཞིན་གཤེགས་པ་སྟོབས་མངོན་པར་ཤེས་པའི་གན་ནས་བྱང་ཆུབ་སེམས་དཔའ་ཉིས་ཁྲི་ཉིས་སྟོང་འཇིག་རྟེན་གྱི་ཁམས་བདེ་བ་ཅན་དུ་སྐྱེ་བར་འགྱུར་རོ་༎ དེ་བཞིན་གཤེགས་པ་མེ་ཏོག་རྒྱལ་༄༤༡༥ཨ་༌༎
 puṣpadhvajasya tathāgatasyāntikāt pañcaviṃśatir vīryaprāptā bodhisattvakoṭya ekaprasthānasaṃsthitā ekenāṣṭāhena navanavatikalpakoṭīnayutaśatasahasrāṇi paścānmukhīkṛtya	མཚན་གྱི་གན་ནས་བྱང་ཆུབ་སེམས་དཔའ་བརྩོན་འགྲུས་ཐོབ་པ་འཇུག་པ་གཅིག་གིས་ཡང་དག་པར་ཞུགས་པ་ཉི་མ་བརྒྱད་པ་གཅིག་གིས་བསྐལ་པ་བྱེ་བ་ཁྲག་ཁྲིག་བརྒྱ་སྟོང་ཕྲག་དགུ་བཅུ་རྩ་དགུའི་འཁོར་བ་བསྙིལ་བ་བྱེ་བ་ཕྲག་ཉི་ཤུ་རྩ་ལྔ་འཇིག་རྟེན་གྱི་ཁམས་བདེ་བ་ཅན་དུ་སྐྱེ་བར་འགྱུར་རོ་༎ 
 yāḥ sukhāvatyāṃ lokadhātāv upapatsyante ; jvalanādhipates tathāgatasyāntikād dvādaśabodhisattvakoṭyaḥ sukhāvatyāṃ lokadhātāv upapatsyante ;	དེ་བཞིན་གཤེགས་པ་འབར་བའི་བདག་པོའི་གན་ནས་བྱང་ཆུབ་སེམས་དཔའ་བྱེ་བ་ཕྲག་བཅུ་གཉིས་འཇིག་རྟེན་གྱི་ཁམས་བདེ་བ་ཅན་དུ་སྐྱེ་བར་འགྱུར་རོ་༎
 vaiśāradyaprāptasya tathāgatasyāntikād ekonasaptatir bodhisattvakoṭyo yāḥ sukhāvatyāṃ lokadhātāv upapatsyante ; amitābhasya tathāgatasya darśanāya, vandanāya, paryupāsanāya paripṛcchanāyai paripraśnīkaraṇāya| etenājita paryāyeṇa paripūṛṇakalpakoṭīnayutaṃ nāmadheyāni	དེ་བཞིན་གཤེགས་པ་མི་འཇིགས་པ་བརྙེས་པའི་གན་ནས་བྱང་ཆུབ་སེམས་དཔའ་བྱེ་བ་ཕྲག་དྲུག་ཅུ་རྩ་དགུ་དེ་བཞིན་གཤེགས་པ་འོད་དཔག་མེད་དེ་ལ་བལྟ་བ་དང་། ཕྱག་བྱ་བ་དང་། བསྙེན་བཀུར་བྱ་བ་དང་། ཡོངས་སུ་དྲི་བ་དང་། ཡོངས་སུ་དྲི་བར་བྱ་བའི་ཕྱིར་འཇིག་རྟེན་གྱི་ཁམས་བདེ་བ་ཅན་དུ་སྐྱེ་བར་འགྱུར་རོ་༎ མི་ཕམ་པ་།
 parikīrtayeyaṃ teṣāṃ tathāgatānām, yebhyas te bodhisattvā upasaṃkrāmanti sukhāvatīṃ lokadhātuṃ tam amitābhaṃ tathāgataṃ draṣṭuṃ vandituṃ paryupāsituṃ, na ca śakyaḥ paryanto 'dhigantum|	རྣམ་གྲངས་དེ་ལྟ་བུས་དེ་བཞིན་གཤེགས་པ་གང་དག་གི་གན་ནས་བྱང་ཆུབ་སེམས་དཔའ་དེ་དག་འཇིག་རྟེན་གྱི་ཁམས་བདེ་བ་ཅན་དུ་དེ་བཞིན་གཤེགས་པ་འོད་དཔག་མེད་དེ་ལ་བལྟ་བ་དང་། ཕྱག་བྱ་བ་དང་། བསྙེན་བཀུར་བྱ་བའི་ཕྱིར་འདོང་བའི་དེ་བཞིན་གཤེགས་པ་དེ་དག་གི་མཚན་བསྐལ་པ་བྱེ་བ་ཁྲག་ཁྲིག་ཚང་བར་བརྗོད་ཀྱང་མཐའ་རྟོགས་པར་མི་ནུས་སོ་༎ མི་ཕམ་པ་།
 paśyājita kiyat sulabdhalābhās te sattvā ye 'mitābhasya tathāgatasyārhataḥ samyaksaṃbuddhasya nāmadheyaṃ śroṣyanti, napi te sattvā hīnādhimuktikā bhaviṣyanti,	གང་དག་དེ་བཞིན་གཤེགས་པ་དགྲ་བཅོམ་པ་ཡང་དག་པར་རྫོགས་པའི་སངས་རྒྱས་འོད་དཔག་མེད་ཀྱི་མཚན་ཐོས་པའི་སེམས་ཅན་དེ་དག་རྙེད་པ་ཇི་སྙེད་ཅིག་ལེགས་པར་རྙེད་པ་ལ་ལྟོས་།
 ye 'ntaśa ekacittaprasādam api tasmin tathāgate pratilapsyante,	སེམས་ཅན་གང་དག་དེ་བཞིན་གཤེགས་པ་འོད་དཔག་མེད་དེ་ལ་ཐན་སེམས་དད་པ་གཅིག་ཙམ་༄༤༡༥བ་རྙེད་པ་དང་། 
 'smiṃś ca dharmaparyāye|	ཆོས་ཀྱི་རྣམ་གྲངས་འདི་ལས་དད་པ་མི་ཕྱེད་པ་དེ་དག་ནི་དམན་པ་ལ་མོས་པར་མི་འགྱུར་རོ་༎
 tasmāt tarhy ajita ;	མི་ཕམ་པ་།
 ārocayāmi vaḥ,	དེ་ལྟ་བས་ན་ཁྱོད་མོས་པར་བྱ་།
 prativedayāmi vaḥ,	ཁྱོད་ཀྱིས་ཁོང་དུ་ཆུད་པར་བྱ་སྟེ་།
 sadevakasya lokasya purato 'sya dharmaparyāyasya sravaṇāya, p63 trisāhasramahāsāhasram api lokadhātum agniparipūṛṇām avagāhyātikramyaikacittotpādam api vipratisāro na kartavyaḥ| tat kasya hetoḥ| bodhisattvakoṭyo hy ajitāśravaṇād eṣām evaṃrūpāṇāṃ dharmaparyāyāṇāṃ vivartante 'nuttarāyāḥ	ལྷ་དང་བཅས་པ་དང་། བདུད་དང་བཅས་པ་དང་། ཚངས་པ་དང་བཅས་པ་དང་། དགེ་སྦྱོང་དང་བྲམ་ཟེའི་སྐྱེ་དགུ་དང་བཅས་པའི་འཇིག་རྟེན་གྱི་མདུན་དུ་ཆོས་ཀྱི་རྣམ་གྲངས་འདི་གཟུང་བ་དང་། 
 samyaksaṃbodheḥ| tasmād asya dharmaparyāyasyādhyāśayena śravaṇodgrahaṇadhāraṇārthāṃ, paryavāptaye,	བཅང་བ་དང་། བཀླག་པ་དང་། ཀུན་ཆུབ་པར་བྱ་བ་དང་། གཞན་དག་ལ་ཡང་རྒྱ་ཆེར་ཡང་དག་པར་བསྟན་པར་བྱ་བ་དང་། བསྒོམ་པ་ལ་མངོན་པར་དགའ་བར་བྱའོ་༎ མི་ཕམ་པ་། ཆོས་ཀྱི་རྣམ་གྲངས་འདི་ཉིད་ཞག་གཅིག་ཙམ་ཡང་བཟུང་ཞིང་བཅས་ཏེ་བཀླགས་ཤིང་ཀུན་ཆུབ་པར་བྱས་ལ་། 
 vistareṇa saṃprakāśanārthāya, bhāvanārthaṃ ca, sumahadvīryam ārabdhavyam| antaśa ekarātrim divasam apy, eka- godohamātram apy antaśaḥ,	བསམ་པ་ཐག་པ་ནས་གཞན་དག་ལ་ཡང་རྒྱ་ཆེར་ཡང་དག་པར་བཤད་པར་བྱའོ་༎
 pustakagatāvaropitam api kṛtvā sulikhito dhārayitavyaḥ, śastṛsaṃjñā ca tatrotpādāya kartavyā,	ཐ་ན་གླེགས་བམ་ལ་ལེགས་པར་བྲིས་ཏེ་བཅང་བར་བྱ་ཞིང་དེ་ལ་སྟོན་པའི་འདུ་ཤེས་ཀྱང་བསྐྱེད་པར་བྱའོ་༎ 
 icchadbhiḥ kṣipram aparimitān sattvān avaivarttikāṃś cānuttarāyāṃ samyaksaṃbodhau pratiṣṭhāpayituṃ, taṃ ca tasya bhagavato 'mitābhasya tathāgatasya buddhakṣetraṃ draṣṭum| ātmanaś ca visiṣṭāṃ buddhakṣetraguṇālaṃkāravyūhasaṃpadaṃ	གང་ཞིག་སེམས་ཅན་དཔག་ཏུ་མེད་པ་དག་མྱུར་དུ་བླ་ན་མེད་པ་ཡང་དག་པར་རྫོགས་པའི་བྱང་ཆུབ་ལས་ཕྱིར་མི་ལྡོག་པ་ལ་དགོད་པ་དང་། བཅོམ་ལྡན་འདས་དེ་བཞིན་གཤེགས་པ་ཚེ་དཔག་མེད་དེ་ལ་བལྟ་བ་དང་། བདག་ཉིད་ཀྱང་སངས་རྒྱས་ཀྱི་ཞིང་གི་ཡོན་ཏན་གྱི་རྒྱན་བཀོད་པ་ཕུན་སུམ་ཚོགས་པ་ཁྱད་པར་དུ་འཕགས་པ་ཡོངས་སུ་གཟུང་བར་འདོད་པ་དེས་ཆོས་ཀྱི་རྣམ་གྲངས་འདི་མཉན་པའི་ཕྱིར་སྟོང་གསུམ་གྱི་སྟོང་ཆེན་པོའི་འཇིག་རྟེན་གྱི་ཁམས་མེས་ཡོངས་སུ་གང་བ་ལས་བརྒལ་ཏེ་། ཆོས་ཀྱི་རྣམ་གྲངས་འདི་མཉན་པར་བྱའོ་༎ ཐོས་ནས་ཀྱང་ག-ཡོར་མ་ལྷུང་བའི་རྒྱུད་ཀྱིས་བསམ་པ་ཐག་པ་ནས་རྗེས་སུ་༄༤༡༦ཨ་༌༎
 parigṛhītum iti|	དགའ་བར་བྱའོ་༎ ཆོས་ཀྱི་རྣམ་གྲངས་འདི་གཟུང་བ་དང་། ཀུན་ཆུབ་པར་བྱ་བ་དང་། བཅང་བ་དང་། ཡི་གེར་བྲི་བ་དང་། བསྒོམ་པའི་ཕྱིར་བརྩོན་འགྲུས་རླབས་པོ་ཆེ་ཆེན་པོ་བརྩམ་པར་བྱའོ༏་༏ཐ་ན་བ་གཅིག་འཇོས་པ་དེ་སྲིད་དུ་ཡང་གཞན་དག་ལ་བརྗོད་པར་བྱའོ་༎ སྟོང་གསུམ་གྱི་སྟོང་ཆེན་པོའི་འཇིག་རྟེན་གྱི་ཁམས་མེས་ཡོངས་སུ་གང་བ་དེ་བརྒལ་ནས་ཀྱང་འགྱོད་པ་དང་ལྡན་པའི་སེམས་གཅིག་ཀྱང་བསྐྱེད་པར་མི་བྱའོ་༎ དེ་ཅིའི་ཕྱིར་ཞེ་ན་།
 api tu khalv ajita ; atyarthaṃ sulabdhalābhās te sattvā avaropitakuśalamūlāḥ, pūrvajinakṛtādhikārā, buddhādhiṣṭhānādhiṣṭhitāś ca bhaviṣyanti,	མི་ཕམ་པ་། འདི་ལྟར་བྱང་ཆུབ་སེམས་དཔའ་བྱེ་བ་ཁྲག་ཁྲིག་ཕྲག་དུ་མ་དག་ཆོས་ཀྱི་རྣམ་གྲངས་རྣམ་པ་འདི་ལྟ་བུ་འདི་ཉན་ཅིང་བླ་ན་མེད་པ་ཡང་དག་པར་རྫོགས་པའི་བྱང་ཆུབ་ལས་ཕྱིར་མི་ལྡོག་པའི་ཕྱིར་རོ་༎
 yeṣām anāgate 'dhvani, yāvat saddharmapralope vartamāna ima evaṃrūpā udārā dharmaparyāyāḥ sarvabuddhasaṃvarṇitāḥ,	མ་འོངས་པའི་དུས་ན་དམ་པའི་ཆོས་རབ་ཏུ་རྣམ་པར་འཇིག་པའི་བར་དུ་ཆོས་ཀྱི་རྣམ་གྲངས་རྒྱ་ཆེན་པོ་རྣམ་པ་འདི་ལྟ་བུ་སངས་རྒྱས་ཐམས་ཅད་ཀྱིས་ཡང་དག་པར་བསྔགས་པ་།
 sarvabuddhapraśastāḥ	སངས་རྒྱས་ཐམས་ཅད་ཀྱིས་བསྟོད་པ་།
 sarvabuddhānujñātā, mahataḥ,	སངས་རྒྱས་ཐམས་ཅད་ཀྱིས་གནང་བ་།
 sarvajñajñānasya kṣipram āhārakāḥ śrotāvabhāsam āgacchanti| śrutvā codāraṃ prītiprāmodyaṃ p64 pratilapsyanta, udgrahīṣyanti, dhārayiṣyanti, vācayiṣyanti, paryavāpsyanti,	ཐམས་ཅད་མཁྱེན་པའི་ཡེ་ཤེས་ཆེན་པོ་མྱུར་དུ་བསྒྲུབ་པ་འདི་གང་དག་གི་རྣ་ལམ་དུ་གྲགས་པའི་སེམས་ཅན་དེ་དག་ནི་རྙེད་པ་ཤིན་ཏུ་ལེགས་པ་རྙེད་ཅིང་དགེ་བའི་རྩ་བ་རྣམས་བསྐྱེད་པ་དང་། སྔོན་གྱི་རྒྱལ་བ་ལ་ལྷག་པར་བྱ་བ་བྱས་པ་དང་། སངས་རྒྱས་ཀྱི་བྱིན་གྱི་རླབས་ཀྱིས་བྱིན་གྱིས་བརླབས་པར་འགྱུར་རོ་༎
 parebhyaś ca vistareṇa saṃprakāśayiṣyanti, bhāvanābhiratāś ca bhaviṣyanty, antaśo likhitvā pūjayiṣyanti, bahu ca te puṇyaṃ prasaviṣyanti, yasya na	ཐོས་ནས་ཀྱང་དགའ་བ་དང་། མཆོག་ཏུ་དགའ་བ་རྒྱ་ཆེན་པོ་ཐོབ་པ་དང་། འཛིན་པ་དང་། འཆང་བ་དང་། ཀློག་པ་དང་། ཀུན་ཆུབ་པར་བྱེད་པ་དང་། གཞན་དག་ལ་ཡང་རྒྱ་ཆེར་ཡང་དག་པར་རབ་ཏུ་སྟོན་པ་དང་། བསྒོམ་པ་ལ་དགའ་བར་༄༤༡༦བ་འགྱུར་བ་དང་། ཐ་ན་ཡི་གེར་བྲིས་ཏེ་མཆོད་པ་བྱེད་པ་དེ་དག་ཀྱང་བསོད་ནམས་མང་དུ་བསྐྱེད་པར་འགྱུར་ཏེ་། 
 sukarā saṃkhyā kartum|	དེ་བགྲང་བར་སླ་བ་མ་ཡིན་ནོ་༎
 iti hy ajita yat tathāgatena kṛtyaṃ kṛtaṃ tan mayā|	མི་ཕམ་པ་། དེ་ལྟར་ན་ངས་དེ་བཞིན་གཤེགས་པའི་མཛད་པ་དེ་བྱས་པ་ཡིན་ཏེ་།
 yūṣmābhir idānīṃ nirvicikitsair yogaḥ karaṇīyaḥ| mā saṃśaya	ཁྱོད་ཀྱང་ད་ཐེ་ཚོམ་མེད་པར་བརྩོན་པར་གྱིས་ཤིག་།
 tam asaṅgam anāvaraṇaṃ buddhajñānam| mā bhūt sarvākārāvaropeta-	སངས་རྒྱས་ཀྱི་ཡེ་ཤེས་ཆགས་པ་མེད་ཅིང་སྒྲིབ་པ་མེད་པ་ལ་སོམ་ཉི་མ་ཟ་ཅིག་།
 ratnamayapadmabandhanāgārapraveśaḥ| durlabho	རྣམ་པ་ཐམས་ཅད་ཀྱི་མཆོག་དང་ལྡན་པའི་རིན་པོ་ཆེའི་བཙོན་རར་ཆུད་ད་རེ་།
 hy ajita buddhotpādaḥ,	མི་ཕམ་པ་། སངས་རྒྱས་འབྱུང་བ་རྙེད་པར་དཀའོ་༎
 durlabhā dharmadeśanā, durlabhā	ཆོས་བསྟན་པ་རྙེད་པར་དཀའོ་༎ དལ་བ་ཕུན་སུམ་ཚོགས་པ་རྙེད་པར་དཀའོ་༎ མི་ཕམ་པ་།
 kṣaṇasaṃpat| ākhyātājita mayā pūrvakuśalamūlapāramiprāptiḥ|	ངས་ཁྱོད་ལ་དགེ་བའི་རྩ་བ་ཐམས་ཅད་ཀྱི་ཕ་རོལ་ཏུ་ཕྱིན་པ་བསྙེད་ཀྱི་།
 yūyam idānīm abhiyujyata pratipadya vai|	ད་ཁྱོད་ཀྱིས་མངོན་པར་སྦྱོར་ལ་སྒྲུབས་ཤིག་། མི་ཕམ་པ་།
 asya khalu punar ajita dharmaparyāyasya mahatīṃ	ཆོས་ཀྱི་རྣམ་གྲངས་འདི་ཆུད་མི་ཟ་བར་བྱ་བའི་ཕྱིར་ཡོངས་སུ་གཏད་པ་ཆེན་པོ་བྱའོ་༎
 parīndanāṃ karomy avipranāśāya| mā buddhadharmāṇām	སངས་རྒྱས་ཀྱི་ཆོས་མི་ནུབ་པར་བྱ་བའི་ཕྱིར་བརྩོན་པར་གྱིས་ཤིག་།
 antardhānāya parākramiṣyatha| mā tathāgatājñāṃ ksobha-	དེ་བཞིན་གཤེགས་པའི་བཀའ་མ་འཁྲུགས་པར་གྱིས་ཤིག་། ཡུན་རིང་པོར་གནོད་པ་དང་། མི་ཕན་པ་དང་། མི་བདེ་བ་དང་། སྡུག་བསྔལ་བ་དང་། ལོག་པར་ལྟུང་བར་གྱུར་ཏ་རེ་།
 yiṣyatha| atha khalu bhagavāṃs tasyāṃ velāyām imā gāthā abhā- ṣata :	དེ་ནས་དེའི་ཚེ་བཅོམ་ལྡན་འདས་ཀྱིས་ཚིགས་སུ་བཅད་པ་འདི་དག་བཀའ་སྩལ་ཏོ་༎
 neme akṛtapuṇyānāṃ śravā bheṣyanti īdṛśāḥ,	བསོད་ནམས་དག་ནི་མ་བྱས་པ་༎ འདི་འདྲ་འདི་དག་ཐོས་མི་འགྱུར་༎
 ye tu te śūra siddhārthāḥ te śroṣyanti imāṃ girāṃ|(1)	དཔའ་བོ་གང་དག་དོན་གྲུབ་པ་༎ དེ་དག་གསུང་འདི་ཐོས་པར་འགྱུར་༎
 dṛṣṭo yaiś ca hi saṃbuddho lokanātha prabhaṃkaraḥ,	གང་གིས་འོད་མཛད་འཇིག་རྟེན་མགོན་༎ རྫོགས་པའི་སངས་རྒྱས་མཐོང་ནས་ནི་༎
 sa gauravaiḥ śruto dharmaḥ	གུས་དང་བཅས་པས་ཆོས་ཐོས་པས་༎
 prītiṃ prāpsyanti te parāṃ|(2)	དེ་དག་དགའ་བ་དམ་པ་འཐོབ་༎ ལྟ་བ་ཅན་དང་དམན་༄༤༡༧ཨ་༌༎ དང་ཞུམ་རྣམས་ཀྱིས་༎
 na śakta hīnebhi kuśīdadṛṣtibhiḥ buddhāna dharmeṣu prasāda vinditum|	སངས་རྒྱས་ཆོས་ལ་དད་པ་རྙེད་མི་ནུས་༎
 ye pūrvabuddheṣu akārṣu pūjāṃ, p65 te lokanāthān caryāsu śikṣiṣu|(3)	གང་དག་སྔོན་གྱི་སངས་རྒྱས་མཆོད་བྱས་པ་༎ དེ་དག་འཇིག་རྟེན་མགོན་གྱི་སྤྱད་ལ་སློབ་༎
 yathāndhakāre puruṣo hy acakṣuḥ	དཔེར་ན་སྐྱེས་བུ་ཡོང་བ་མུན་ཁུང་ན་༎
 mārgaṃ na jāne kutu saṃprakāśayet|	ལམ་ཡང་མི་ཤེས་བསྟན་པར་ག་ལ་ནུས་༎
 sarve tathā śrāvaka buddhajñāne ajānakāḥ kiṃ punar anyasattvāḥ|(4)	དེ་ལྟར་ཉན་ཐོས་ཐམས་ཅད་སངས་རྒྱས་ཀྱི་༎ ཡེ་ཤེས་མི་རྟོག་སེམས་ཅན་གཞན་ཅི་སྨོས་༎
 buddho hi buddhasya guṇā prajānate|	སངས་རྒྱས་ཀྱིས་ནི་སངས་རྒྱས་ཡོན་ཏན་མཁྱེན་༎
 na devanāgāsurayakṣaśrāvakāḥ|	ལྷ་ཀླུ་ལྷ་མིན་གནོད་སྦྱིན་ཉན་ཐོས་མིན་༎
 pratyekabuddhāna pi ko gatī yatho, buddhasya jñāne hi prakāśyamāne|(5)	སངས་རྒྱས་ཡེ་ཤེས་རབ་ཏུ་བཤད་པ་ནི་༎ རང་སངས་རྒྱས་ཀྱི་ལམ་ཡང་འདི་མ་ཡིན་༎
 yadi sarvasattvāḥ sugatā bhaveyuḥ	གལ་ཏེ་སེམས་ཅན་ཐམས་ཅད་བདེ་བར་གཤེགས་༎
 viśuddhajñānā paramakovidā,	ཡེ་ཤེས་རྣམ་དག་དོན་ལ་མཁས་གྱུར་ཏེ་༎
 te kalpakoṭīr atha vāpi uttare	དེ་དག་བསྐལ་པ་འམ་འོན་ཏེ་ལྷག་པར་ནི་༎ སངས་རྒྱས་གཅིག་གི་ཡོན་ཏན་རྗོད་བྱེད་ཀྱང་༎ དེ་དག་རབ་ཏུ་མྱ་ངན་འདས་གྱུར་གྱི་༎
 ekasya buddhasya guṇān katheyuḥ|(6) atrāntare nirvṛta te bhaveyuḥ prakāśyamānā bahukalpakoṭīḥ,	བསྐལ་པ་བྱེ་བ་མང་པོར་རབ་བརྗོད་ཀྱང་༎
 na ca buddhajñānasya pramāṇu labhyate, tathā hi jñānāś cariyaṃ jinānāṃ|(7)	སངས་རྒྱས་ཡེ་ཤེས་ཚད་མེད་མི་འགྱུར་ཏེ་༎ དེ་ལྟར་རྒྱལ་བའི་ཡོན་ཏན་ངོ་མཚར་ཏོ་༎
 tasmān naraḥ paṇḍita vijñajātiyaḥ,	དེ་བས་མཁས་པ་རིག་པའི་རང་བཞིན་མི་༎
 yo mahya vākyam abhiśraddhadheyuḥ,	གང་ཞིག་ང་ཡི་ཚིག་ལ་ཡིད་ཆེས་ཏེ་༎ རྒྱལ་བའི་ཡེ་ཤེས་ཕུང་པོ་དབང་བྱས་ཏེ་༎ སངས་རྒྱས་ཉིད་ཀྱིས་མཁྱེན་ཅེས་ཚིག་ཏུ་བརྗོད་༎
 kṛtsnāṃ sa sākṣī jinajñānarāśiṃ| buddha prajānāti girām udīrayet|(8) kadāci labhyāti manuṣyalābhaḥ,	བརྒྱ་ལམ་ན་ནི་མི་ཡི་ལུས་རྙེད་ལ་༎
 kadāci buddhāna pi prādurbhāvaḥ|	བརྒྱ་ལམ་ན་ནི་སངས་རྒྱས་འབྱུང་བར་འགྱུར་༎
 śraddhā tha prajñā sucireṇa lapsyate,	དད་དང་ཤེས་རབ་ཡུན་རིང་རྙེད་པར་འགྱུར༏། དེ་བས་དོན་ཐོབ་བྱ་ཕྱིར་བརྩོན་འགྲུས་བསྐྱེད་༎
 tasyārthaprajñair janayātha vīryaṃ|(9) ya īdṛśāṃ dharma śruṇitvā śreṣṭhāṃ	གང་ཞིག་ཆོས་མཆོག་འདི་འདྲ་ཐོས་ནས་ནི་༎
 labhyanti prītiṃ sugataṃ smarantaḥ,	བདེ་གཤེགས་དྲན་པ་དགའ་བ་འཐོབ་པར་འགྱུར་༎ གང་ཞིག་སངས་རྒྱས་བྱང་ཆུབ་༄༤༡༧བ་མོས་བསྐྱེད་པ་༎
 te mitram asmākam atītam adhvani, ye buddhā bodhāya janenti cchandam, iti|(10) p66	དེ་དག་འདས་པའི་དུས་ན་དེང་དང་ཤེས་༎
 asmin khalu punar dharmaparyāye bhagavatā bhāṣyamāne dvādaśānāṃ sattvanayutakoṭīnāṃ virajo vigatamalaṃ dharmeṣu dharmacakṣur viśuddhaṃ,	ཆོས་ཀྱི་རྣམ་གྲངས་འདི་བཤད་པ་ན་སེམས་ཅན་བྱེ་བ་ཕྲག་བཅུ་གཉིས་ཆོས་རྣམས་ལ་ཆོས་ཀྱི་མིག་རྡུལ་དང་བྲལ་ཞིང་དྲི་མ་མེད་པ་རྣམ་པར་དག་གོ་། 
 caturviṃśatyā koṭībhir anāgāmiphalaṃ	བྱེ་བ་ཕྲག་ཉི་ཤུ་རྩ་བཞིས་ནི་ཕྱིར་མི་འོང་བའི་འབྲས་བུ་ཐོབ་བོ་པར་དག་གོ་། 
 prāptam| aṣṭānāṃ bhikṣuśatānām anutpādāyāsravebhyaś	༎ དགེ་སློང་བརྒྱད་བརྒྱ་ནི་ལེན་པ་མེད་པའི་ཟག་པ་རྣམས་ལས་སེམས་རྣམ་པར་དག་གོ་། ༎ པར་གྲོལ་ལོ་༎ 
 cittāni vimuktāni| pañcaviṃśatyā bodhisattvakoṭībhir anutpattikadharmakṣāntipratilabdhāḥ| devamānuṣikāyāś	བྱང་ཆུབ་སེམས་དཔའ་བྱེ་བ་ཕྲག་ཉི་ཤུ་རྩ་ལྔ་ནི་མི་སྐྱེ་བའི་ཆོས་ལ་བཟོད་པ་ཐོབ་བོ་པར་དག་གོ་། ༎ པར་གྲོལ་ལོ་༎ 
 ca prajāyāś catvāriṃśatkoṭīnayutaśatasahasrāṇām anutpattipūrvāṇy anuttarāyāṃ samyaksaṃbodhau cittāny utpannāni	༎ ལྷ་དང་མིའི་སྐྱེ་དགུ་བྱེ་བ་ཁྲག་ཁྲིག་བརྒྱ་སྟོང་ཕྲག་བཞི་བཅུ་ནི་སྔོན་སེམས་མ་བསྐྱེད་པ་ལས་བླ་ན་མེད་པ་ཡང་དག་པར་རྫོགས་པའི་བྱང་ཆུབ་ཏུ་སེམས་བསྐྱེད་ནས་བཅོམ་ལྡན་འདས་དེ་བཞིན་གཤེགས་པ་འོད་དཔག་མེད་ལ་བལྟ་བ་དང་པར་དག་གོ་། 
 sukhāvatyupapattaye ca kuśalamūlāny avaropitāni, bhagavato 'mitābhasya darśanakāmatayā|	༎ པར་གྲོལ་ལོ་༎ ༎ ། ཕྱག་བྱ་བ་དང་། བསྙེན་བཀུར་བྱ་བའི་ཕྱིར་བདེ་བ་ཅན་དུ་སྐྱེ་བར་དགེ་བའི་རྩ་བ་རྣམས་ཡོངས་སུ་བསྔོ་བར་བྱེད་དོ་༎ 
 sarve te tatrotpādyānupūrveṇa mañjusvarā nāma tathāgatā	དེ་དག་ཐམས་ཅད་དེར་སྐྱེས་ནས་ཀྱང་མཐར་གྱིས་བྱང་ཆུབ་སེམས་དཔའི་སྤྱོད་པ་ཡོངས་སུ་རྫོགས་པར་བྱས་ཏེ་། སངས་རྒྱས་ཀྱི་ཞིང་གཞན་དག་ཏུ་དེ་བཞིན་གཤེགས་པ་འཇམ་པའི་དབྱངས་ཞེས་བྱ་བར་བླ་ན་མེད་པ་ཡང་དག་པར་རྫོགས་པའི་བྱང་ཆུབ་མངོན་པར་རྫོགས་པར་འཚང་རྒྱ་བར་འགྱུར་རོ་༎ དེ་བཞིན་གཤེགས་པ་མར་མེ་མཛད་ལས་བཟོད་པ་ཐོབ་སྟེ་།
 anyeṣu lokadhātuṣūpapatsyante| aśītiś ca nayutakoṭyo dīpaṅkareṇa tathāgatena labdhakṣāntikā avaivartyā anuttarāyāḥ	བླ་ན་མེད་པ་ཡང་དག་པར་རྫོགས་པའི་བྱང་ཆུབ་ལས་ཕྱིར་མི་ལྡོག་པ་བྱེ་བ་ཁྲག་ཁྲིག་ཕྲག་བརྒྱད་ཅུ་དེ་བཞིན་གཤེགས་པ་འོད་དཔག་མེད་ཀྱིས་སྔོན་བྱང་ཆུབ་སེམས་དཔའི་སྤྱད་པ་སྤྱོད་པ་ན་། 
 samyaksaṃbodher, amitāyuṣaiva tathāgatena paripācitāḥ pūrvabodhisattvacaryāś carantās, tāś ca sukhāvatyāṃ	བླ་ན་མེད་པ་ཡང་དག་པར་རྫོགས་པའི་བྱང་ཆུབ་ཏུ་ཡོངས་སུ་སྨིན་པར་བྱས་པ་དེ་དག་ཀྱང་འཇིག་༄༤༡༨ཨ་༌༎
 lokadhātāv upapadya pūrvapraṇidhānacaryāḥ paripūrayiṣyanti|	རྟེན་གྱི་ཁམས་བདེ་བ་ཅན་དུ་སྐྱེས་ཏེ་། སྔོན་གྱི་སྨོན་ལམ་དང་། སྤྱོད་པ་ཡོངས་སུ་རྫོགས་པར་འགྱུར་རོ་༎
 tasyāṃ ca velāyām ayaṃ trisāhasramahāsāhasro lokadhātuḥ ṣaḍvikāraṃ prakampitaḥ| vividhāni ca prātihāryāṇi	དེའི་ཚེ་སྟོང་གསུམ་གྱི་སྟོང་ཆེན་པོའི་འཇིག་རྟེན་གྱི་ཁམས་འདི་རྣམ་པ་དྲུག་ཏུ་ག-ཡོས་ཏེ་།
 saṃdṛśyanti,	ཆོ་འཕྲུལ་རྣམ་པ་སྣ་ཚོགས་ཀྱང་ཀུན་དུ་སྣང་ངོ་༎
 jānumātraṃ ca mandaravapuṣpaiḥ pṛthivyāṃ	མེ་ཏོག་མན་ད་ར་བ་དག་ཀྱང་ས་ལ་པུས་མོ་ནུབ་ཙམ་དུ་བཀྲམ་པར་གྱུར་ཏོ་༎
 saṃstṛtam abhūt| divyamānuṣikāni ca tūryāṇi saṃvāditāny	ལྷ་དང་། མིའི་སིལ་སྙན་རྣམས་ཀྱང་རབ་ཏུ་གྲག་པར་གྱུར་ཏོ་༎
 abhūvan| anumodakāśabdena ca yāvad akaniṣṭhabhavanaṃ	འོག་མིན་གྱི་གནས་ཀྱི་བར་དུ་ཡང་རྗེས་སུ་ཡི་རང་ངོ་ཞེས་བྱ་བའི་སྒྲ་གྲག་པར་གྱུར་ཏོ་༎ 
 vijñaptam abhūt| idam avocad bhagavān āttamanā, ajito bodhisattvo mahāsattva	བཅོམ་ལྡན་འདས་ཀྱིས་དེ་སྐད་ཅེས་བཀའ་སྩལ་ནས་།
 āyuṣmāṃś cānandaḥ, sā ca sarvāvatī parṣat sadevamānuṣyāsuragandharvaś ca loko bhagavato bhāṣitam p67	བྱང་ཆུབ་སེམས་དཔའ་སེམས་དཔའ་ཆེན་པོ་མི་ཕམ་པ་དང་། ཚེ་དང་ལྡན་པ་ཀུན་དགའ་བོ་དང་། ཐམས་ཅད་དང་ལྡན་པའི་འཁོར་དེ་དག་དང་། ལྷ་དང་། མི་དང་། ལྷ་མ་ཡིན་དང་དྲི་ཟར་བཅས་པའི་འཇིག་རྟེན་ཡི་རངས་ཏེ་།
 abhyanandann iti|	བཅོམ་ལྡན་འདས་ཀྱིས་གསུངས་པ་ལ་མངོན་པར་བསྟོད་དོ་༎
 bhagavato 'mitābhasya guṇaparikīrtanaṃ bodhisattvānām	འཕགས་པ་དཀོན་མཆོག་བརྩེགས་པ་ཆེན་པོའི་ཆོས་ཀྱི་རྣམ་གྲངས་སྟོང་ཕྲག་བརྒྱ་པ་ལས་།
 avaivarttikabhūmipraveśaḥ| amitābhasya sukhāvatī-vyūha-	དེ་བཞིན་གཤེགས་པ་འོད་དཔག་མེད་ཀྱི་སངས་རྒྱས་ཀྱི་ཞིང་གི་བཀོད་པའི་ལེའུ་ཞེས་བྱ་སྟེ་། ལེའུ་ལྔ་པ་རྫོགས་སོ་༎༎ རྒྱ་གར་གྱི་མཁན་པོ་ཛི་ན་མི་ཏྲ་དང་། དའ་ན་ཤའི་ལ་དང་། ཞུ་ཆེན་གྱི་ལོཙཚ་བ་བན་དེ་ཡེ་ཤེས་སྡེས་བ་སྒྱུར་ཅིང་ཞུས་། ཏེ་སྐད་གསར་བཅད་ཀྱིས་ཀྱང་བཅོས་ནས་གཏན་ལ་ཕབ་པ་༎༎
