skt	tib
 kāśyapaparivarta sūtra	༄༢༡༡ཨ་རྒྱ་གར་སྐད་དུ་། ཨའརྱ་ཀའ་ཤྱ་པ་པ་རི་བརྟ་ནའ་མ་མཧའ་ཡའ་ན་སའུ་ཏྲ་། བོད་སྐད་དུ་། འཕགས་པ་འོད་སྲུང་གི་ལེའུ་ཞེས་བྱ་བ་ཐེག་པ་ཆེན་པོའི་མདོ་། བམ་པོ་དང་པོ་། སངས་རྒྱས་དང་བྱང་ཆུབ་སེམས་དཔའ་ཐམས་ཅད་ལ་ཕྱག་འཚལ་ལོ་༎
 siddham evaṃ mayā śrutamekasmin samaye bhagavān rājagṛhe viharati sma |	འདི་སྐད་བདག་གིས་ཐོས་པ་དུས་གཅིག་ན་། བཅོམ་ལྡན་འདས་།
 gṛddhakūṭe parvate mahatā bhikṣusaṅghena sārddham aṣṭābhirbhikṣusahasraiḥ ṣodaśabhiśca	རྒྱལ་པོའི་ཁབ་བྱ་རྒོད་ཕུང་པོའི་རི་ལ་དགེ་སློང་༄༢༡༡བ་བརྒྱད་སྟོང་གི་དགེ་འདུན་ཆེན་པོ་དང་། བྱང་ཆུབ་སེམས་དཔའ་སངས་རྒྱས་ཀྱི་ཞིང་སྣ་ཚོགས་ནས་འདུས་པ་ཁྲི་དྲུག་སྟོང་ཐམས་ཅད་ཀྱང་། འདི་ལྟ་སྟེ་། 
 bodhisattvasahasraiḥ nānābuddhakṣetrasannipatitairekajātiprabaddhairyadutānutarasyāṃ samyaksambodhau |	བླ་ན་མེད་པ་ཡང་དག་པར་རྫོགས་པའི་བྱང་ཆུབ་ཏུ་སྐྱེ་བ་གཅིག་གིས་ཐོགས་པ་ཤ་སྟག་དང་ཐབས་གཅིག་ཏུ་བཞུགས་། འདི་ལྟ་སྟེ་། 
 kp|1 tatra bhagavān āyuṣmantaṃ mahākāśyapam āmantrayati sma |	ཏེ་། དེའི་ཚེ་ན་ཚེ་དང་ལྡན་པ་འོད་སྲུང་ཆེན་པོ་འཁོར་དེ་ཉིད་དུ་འདུས་པར་གྱུར་ནས་འདུག་གོ༏་དེ་ནས་བཅོམ་ལྡན་འདས་ཀྱིས་ཚེ་དང་ལྡན་པ་འོད་སྲུང་ཆེན་པོ་ལ་བཀའ་སྩལ་པ་། འོད་སྲུང་། ཆོས་བཞི་པོ་འདི་དག་ནི་བྱང་ཆུབ་སེམས་དཔའི་ཤེས་རབ་ཡོངས་སུ་ཉམས་པར་འགྱུར་བ་སྟེ་།
 katame catvāraḥ yaduta agauravau bhavati dharme ca dharmabhāṇake ca | dharma |||||| ca bhavanti |	བཞི་གང་ཞེ་ན་། འདི་ལྟ་སྟེ་། ཆོས་དང་ཆོས་སྨྲ་བ་ལ་མི་གུས་པ་ཡིན་།
 dharmācāryamuṣṭiñca karoti dharmakāmānañca pudgalānāṃ dharmāntarāyaṃ karauti vicchanda ||||| vikṣipati |	ཆོས་ལ་སེར་སྣ་བྱེད་ཅིང་ཆོས་ལ་སློབ་དཔོན་གྱི་དཔེ་མཁྱུད་བྱེད་པ་ཡིན་། ཆོས་འདོད་པའི་གང་ཟག་རྣམས་ལ་ཆོས་ཀྱི་བར་ཆད་བྱེད་ཅིང་འདུན་པ་ཟློག་པར་བྱེད་། རྣམ་པར་འཁྲུག་པ་བྱེད་དེ་།
 na deśayati | praticchādayati |	མི་སྟོན་ཅིང་རབ་ཏུ་འཆབ་པ་ཡིན་།
 ābhimāntikaśca bhavatyātmotkarṣī parapaṃsakaḥ |	མངོན་པའི་ང་རྒྱལ་གྱིས་བདག་ལ་བསྟོད་ཅིང་གཞན་ལ་སྨོད་པ་ཡིན་ཏེ་།
 ime kāśyapa catvāro dharma bodhisattvasya prajñāpārihāṇāya saṃvartate |	འོད་སྲུང་། ཆོས་བཞི་པོ་དེ་དག་ནི་བྱང་ཆུབ་སེམས་དཔའི་ཤེས་རབ་ཡོངས་སུ་ཉམས་པར་འགྱུར་བའོ་༎
 tatredam ucyate ||	དེ་ལ་འདི་སྐད་ཅེས་བྱ་སྟེ་། ཆོས་སྨྲ་བ་ལ་གུས་པ་མེད་པ་ཡིན་༎
 agauravo bhavati ca dharmabhāṇake | dharmeṣu mātsaryarato ca bhoti | ācāryamuṣṭiñccha karoti dharme	ཆོས་ལ་སེར་སྣ་བྱེད་པར་གྱུར་པ་དང་༎ ཆོས་ལ་སློབ་དཔོན་དཔེ་མཁྱུད་བྱེད་པ་ཡིན་༎
 dharmārthi kānā ca karoti vighnam	ཆོས་འདོད་རྣམས་ལ་བགེགས་ནི་བྱེད་གྱུར་ཅིང་༎ འདུན་པ་བཟློག་ལ་དེ་བཞིན་༄༢༡༢ཨ་༌༎
 vicchadayanto vividhaṃ kṣipanto	རྣམ་འཁྲུག་བྱེད་༎
 dharmaṃ na deśayati jinapraśastān so ātmotkarṣaṇi nittyayukto	རྒྱལ་བས་བསྔགས་པའི་ཆོས་ནི་ཡོང་མི་སྟོན་། ལེ་ལོ་ཅན་ཏེ་བདག་བསྟོད་རྟག་ཏུ་བརྩོན་༎
 parapaṃsane cābhirataḥ kusidau | caturo ime dharmā jinena proktā	གཞན་ལ་སྨོད་པར་བྱེད་ལ་མངོན་པར་དགའ༏་༏ཆོས་བཞི་འདི་དག་རྒྱལ་བའི་སྲས་རྣམས་ཀྱི་༎ ཤེས་རབ་ཉམས་པར་འགྱུར་བར་རྒྱལ་བས་གསུངས་༎
 prajñāprahāṇāya jinorsānām etāṃ hi catvāri jahitvā dharmāś	ཆོས་བཞི་འདི་དག་རབ་ཏུ་སྤངས་བྱས་ལ་༎
 caturau parāṃ dharma jinokta bhāvayet	རྒྱལ་བས་གསུངས་པའི་ཆོས་བཞི་གཞན་བསྒོམ་མོ་༎
 kp|2 catvārā ime kāśyapa dharmā bodhisattvasya mahāprajñātāyaiḥ saṃvartante |	འོད་སྲུང་། ཆོས་བཞི་པོ་འདི་དག་ནི་བྱང་ཆུབ་སེམས་དཔའི་ཤེས་རབ་ཆེན་པོར་འགྱུར་བ་སྟེ་། བཞི་གང་ཞེ་ན་། འདི་ལྟ་སྟེ་།
 katame catvāraḥ yadu sagauravo bhavati dharme ca dharmabhāṇake ca |	ཆོས་དང་ཆོས་སྨྲ་བ་ལ་གུས་པ་དང་བཅས་པ་ཡིན་།
 yathāśrutāṃśca dharmān yathāparyāptān parebhyo vistareṇa samprakāśayati | nirāmiṣeṇa cittenāpratikāṅkṣayati |||||||||| kp|3 |||||||||||||||||||| ca sattvānām avarṇāyaśaṃ kīrrtiśabdaślokaniścāraṇatayā |	ཟང་ཟིང་མེད་པའི་སེམས་ཀྱིས་རྙེད་པ་དང་བཀུར་སྟི་དང་ཚིགས་སུ་བཅད་པ་ལ་མི་རེ་བར་ཇི་ལྟར་ཐོས་པ་དང་། ཇི་ལྟར་ཁོང་དུ་ཆུད་པའི་ཆོས་རྣམས་གཞན་དག་ལ་རྒྱ་ཆེར་ཡང་དག་པར་རབ་ཏུ་སྟོན་པར་བྱེད་པ་ཡིན་། མང་དུ་ཐོས་པ་ལས་ཤེས་རབ་འབྱུང་བར་རིག་ནས་། མགོ་འམ་གོས་ལ་མེ་འབར་བ་བཞིན་དུ་ཐོས་པ་ཡོངས་སུ་ཚོལ་ཞིང་ཇི་ལྟར་ཐོས་པའི་ཆོས་རྣམས་འཛིན་པར་བྱེད་པ་ཡིན་། ནན་ཏན་སྙིང་པོར་བྱེད་ཀྱི་། སྨྲ་བ་དང་བརྗོད་པའི་ཚིག་ལྷུར་ལེན་པ་མ་ཡིན་ཏེ་། འོད་སྲུང་། ཆོས་བཞི་པོ་འདི་དག་ནི་བྱང་ཆུབ་སེམས་དཔའི་ཤེས་རབ་ཆེན་པོར་འགྱུར་བའོ་༎ དེ་ལ་འདི་སྐད་ཅེས་བྱ་སྟེ་། ཆོས་སྨྲ་བ་ལ་གུས་པ་དང་བཅས་པ་ཡིན་༎ ཟང་ཟིང་མེད་ཅིང་རྙེད་དང་བཀུར་སྟི་ལ་༎
 māyāśāṭṭhyena ca param upacarati nādhyāśaye na |	རེ་བ་མེད་ཅིང་༄༢༡༢བ་ཚིགས་བཅད་མི་སེམས་པར་༎ ཇི་ལྟར་ཐོས་པའི་ཆོས་རྣམས་གཞན་ལ་སྟོན་༎ ཐོས་ལས་ཤེས་རབ་འབྱུང་བར་དེས་རིག་ནས་༎ མགོ་ལ་འབར་བཞིན་རྟག་ཏུ་ཐོས་པ་ཚོལ་༎ དེ་ནི་ཇི་ལྟར་ཐོས་པའི་ཆོས་རྣམས་འཛིན་༎ ཆོས་བཟུང་ནས་ནི་ནན་ཏན་བྱ་ཕྱིར་གནས་༎ མཁས་དེ་ནན་ཏན་སྙིང་པོར་བྱེད་པ་ཡིན་༎ ཚིག་ལྷུར་མི་ལེན་སྨྲ་བ་ལྷུར་མི་ལེན་༎ མཁས་པས་ཆོས་བཞི་འདི་དག་བསྟེན་བྱས་ན་༎ རྒྱལ་བས་བསྔགས་པའི་ཤེས་རབ་ཐོབ་པར་འགྱུར་༎
 ebhiḥ kāśyapa caturbhiḥ dharmaiḥ samanvāgatasya bodhicittaṃ muhyati |	འོད་སྲུང་། བྱང་ཆུབ་སེམས་དཔའ་ཆོས་བཞི་དང་ལྡན་ན་། བྱང་ཆུབ་ཀྱི་སེམས་བརྗེད་པར་འགྱུར་ཏེ་།
 vāṃ tatredamucyate ||	བཞི་གང་ཞེ་ན༏་འདི་ལྟ་སྟེ་། སློབ་དཔོན་དང་། བླ་མ་དང་། སྦྱིན་གནས་ལ་སླུ་བ་དང་། གཞན་འགྱོད་པ་མེད་པ་དག་ལ་འགྱོད་པ་ཉེ་བར་བསྒྲུབ་པ་དང་། ཐེག་པ་ཆེན་པོ་ལ་ཡང་དག་པར་ཞུགས་པའི་སེམས་ཅན་རྣམས་ལ་བསྔགས་པ་མ་ཡིན་པ་དང་། མི་སྙན་པ་དང་། བརྗོད་པ་མ་ཡིན་པའི་སྒྲ་ཚིགས་སུ་བཅད་པ་འབྱིན་པ་དང་། སྒྱུ་དང་ག-ཡོས་གཞན་ལ་ཉེ་བར་སྤྱོད་ཀྱི་། ལྷག་པའི་བསམ་པས་མ་ཡིན་པ་སྟེ་། འོད་སྲུང་། བྱང་ཆུབ་སེམས་དཔའ་ཆོས་བཞི་པོ་དེ་དག་དང་ལྡན་ན་བྱང་ཆུབ་ཀྱི་སེམས་བརྗེད་པར་འགྱུར་རོ་༎ དེ་ལ་འདི་སྐད་ཅེས་བྱ་སྟེ་།
 gurudākṣiṇīye na karoti proktum pareṣu kaukṛtyupasaṃharanti | bodhā ||||| sthita ye ca sattvās	སྦྱིན་གནས་བླ་མས་བསྒོ་བཞིན་མི་བྱེད་དང་༎ གཞན་དག་ལ་ཡང་ཐེ་ཚོམ་ཉེར་བསྒྲུབ་དང་༎ སེམས་ཅན་གང་དག་བྱང་ཆུབ་རབ་ཞུགས་པ་༎
 teṣām avarṇam ayaśaṃ bhaṇanti | māyāya śāṭhyena ca ketavena	དེ་ལ་བསྔགས་མིན་མི་སྙན་སྨྲ་བ་དང་༎ སྒྱུ་དང་ག-ཡོ་དང་རྒྱན་ལ་༄༢༡༣ཨ་༌༎
 par||||||ti ca nāśayena |	དོར་བྱེད་པས་༎ གཞན་ལ་བརྟེན་གྱི་བསམ་པས་མ་ཡིན་པ་༎ ཆོས་བཞི་འདི་དག་ཀུན་དུ་བསྟེན་བྱས་ན་༎
 ime dharmā niṣe|||| mā | a mohe | i cittaṃ vara buddhabodhayeḥ X smād imā XXXX vamāṇo varāgrab | dh | y | sudūr | v | t | t | |	སངས་རྒྱས་བྱང་ཆུབ་སེམས་མཆོག་ཉམས་པར་འགྱུར་༎ དེ་ལྟ་བས་ན་ཆོས་འདི་སྟེན་བྱེད་ན་༎ བྱང་ཆུབ་མཆོག་ལས་དེ་ནི་རིང་བར་འགྱུར་༎ དེ་ལས་བཟློག་པ་སྟེན་པར་བྱེད་ན་ནི་༎ བྱང་ཆུབ་མཆོག་རབ་བསྔགས་པ་རེག་པར་འགྱུར་༎
 XXXXX niṣevamāṇ | varāgrab | dh | spṛś | t | ḥ praśā X	འོད་སྲུང་།
 kp|4 caturbhiḥ kāśyapa dharmaiḥ samanvāgatasya bodhisattvasya |	བྱང་ཆུབ་སེམས་དཔའ་ཆོས་བཞི་དང་ལྡན་ན་སྐྱེ་བ་ཐམས་ཅད་དུ་སྐྱེས་མ་ཐག་ཏུ་བྱང་ཆུབ་ཀྱི་སེམས་མངོན་དུ་འགྱུར་ཏེ་།
 sarvāsu jātiṣu jatamātrasya bodhicittam āmukhī bhavati na cāntarā ||||| hyati yāvad bodhimaṇḍaniṣadanāt |	བྱང་ཆུབ་ཀྱི་སྙིང་པོ་ལ་འདུག་གི་བར་དུ་བར་མ་དོར་བརྗོད་པར་མི་འགྱུར་རོ་༎
 katamaiścaturbhiḥ yaduta jīvitahetorapi samprajāna mṛṣāvādaṃ na bhāṣate |	བཞི་གང་ཞེ་ན་། འདི་ལྟ་སྟེ་། སྲོག་གི་ཕྱིར་རམ་།
 antamaśa hāsyaprekṣyam api | adhyāśayena sarvasattvānām antike tiṣṭhatyapagatamāyāśāṭṭhyatayā | sarvabodhisattveṣu ca śāstṛsañjñām utpādayati | caturdiśāṃ ||||||| cārayati |	ཐ་ན་བཞད་གད་ཀྱི་ཕྱིར་ཡང་རྫུན་གྱི་ཚིག་མི་སྨྲ་བ་དང་། སྒྱུ་དང་ག-ཡོ་མེད་པར་སེམས་ཅན་ཐམས་ཅད་ཀྱི་དྲུང་ན་ལྷག་པའི་བསམ་པས་གནས་པ་དང་། བྱང་ཆུབ་སེམས་དཔའ་ཐམས་ཅད་ལ་སྟོན་པར་འདུ་ཤེས་སྐྱེད་ཅིང་།
 yāśca sattvān paripācayati tān ,	དེ་དག་གི་ཡང་དག་པའི་བསྔགས་པ་ཕྱོགས་བཞིར་བརྗོད་པ་དང་། ཉི་ཚེ་བའི་ཐེག་པ་མི་འདོད་པའི་ཕྱིར་སེམས་ཅན་གང་རྣམས་ཡོངས་སུ་སྨིན་པར་བྱེད་པ་དེ་དག་ཐམས་ཅད་ཀྱང་།
 sarvān uttarasyāṃ samyaksambodhau samādāpaya ||||||| kayānaspṛhaṇatayā |	བླ་ན་མེད་པ་ཡང་དག་པར་རྫོགས་པའི་བྱང་ཆུབ་ཡང་དག་པར་འཛིན་དུ་འཇུག་པ་སྟེ་།
 ebhiḥ kāśyapa caturbhiḥ dharmaiḥ samanvāgatasya bodhisattvasya sarvāsu jātiṣu jātamātrasya bodhicittam āmukhibhavati na cāntarā muhyati yāvad bodhimaṇḍaniṣadanāt |	འོད་སྲུང་། ཆོས་བཞི་པོ་དེ་དག་དང་ལྡན་པའི་བྱང་ཆུབ་སེམས་དཔའ་སྐྱེ་བ་ཐམས་ཅད་དུ་སྐྱེས་མ་ཐག་ཏུ་བྱང་ཆུབ་ཀྱི་སེམས་མངོན་དུ་གྱུར་ཏེ་། བྱང་ཆུབ་ཀྱི་སྙིང་༄༢༡༣བ་པོ་ལ་འདུག་གི་བར་དུ་བར་མ་དོར་བརྗེད་པར་མི་འགྱུར་རོ་༎
 tatredamucyate || 4 ||	དེ་ལ་འདི་སྐད་ཅེས་བྱ་སྟེ་། སྲོག་གི་ཕྱིར་ཡང་རྫུན་ཚིག་མི་སྨྲ་ཞིང་༎
 na jivitārthe anṛtaṃ vadanti bhāṣanti vācaṃ sadā arthayuktaṃ |	རྟག་ཏུ་དོན་དང་ལྡན་པའི་ཚིག་རྣམས་སྨྲ་༎
 māyāya śaṭṭhye ||||| tya varjitā	སྒྱུ་དང་ག-ཡོ་ནི་རྟག་ཏུ་རྣམ་སྤངས་ཏེ་༎
 adhyāśayena sadā sattva paśyati | bodhāya ye prasthita śuddhasattvā śāsteti tān manyati bodhisa(ttva) ||||	ལྷག་པའི་བསམ་པས་རྟག་ཏུ་སེམས་ཅན་ལྟ་༎ སེམས་ཅན་དག་པ་བྱང་ཆུབ་གང་ཞུགས་པ་༎ བྱང་ཆུབ་སེམས་དཔའ་དེ་ལ་སྟོན་པར་སེམས་༎ སྟོན་པའི་འདུ་ཤེས་ཉེ་བར་བཞག་ནས་ཀྱང་༎
 varṇaṃ ca teṣāṃ bhaṇate caturdiśaṃ śāstāra sañjñāṃ sadupasthapitvā 2	དེ་དག་བསྔགས་པ་ཕྱོགས་བཞིར་རྗོད་པར་བྱེད་༎
 yāṃścāpi sattvān paripācayati	སེམས་ཅན་གང་དག་ཡོངས་སུ་སྨིན་བྱེད་པ་༎
 annuttare jñāne samādapeti	བླ་མེད་ཡེ་ཤེས་ཡང་དག་འཛིན་དུ་འཇུག་། ཆོས་དེ་དག་ལ་རབ་ཏུ་གནས་པ་རྣམས་༎
 eteṣu dharmeṣu pratiṣṭhitānāṃ cittaṃ na bodhāya kadāci muhyatiḥ 3 ||	བྱང་ཆུབ་སེམས་ནི་ནམ་ཡང་བརྗེད་མི་འགྱུར་༎
 kp|5 caturbhiḥ kāśyapa dharmaiḥ samanvāgatasya bodhisattvasyotpannotpannāma kuśalā	འོད་སྲུང་། བྱང་ཆུབ་སེམས་དཔའ་ཆོས་བཞི་དང་ལྡན་པའི་དགེ་བའི་ཆོས་སྐྱེས་ཤིང་བྱུང་བ་རྣམས་ཡོངས་སུ་ཟད་པར་འགྱུར་ཏེ་། 
 dharmāḥ paryādīyante yairna vivardhanti ||| rdharmaiḥ katamaiścaturbhiḥ yaduta abhimānikasya	དགེ་བའི་ཆོས་དེ་དག་གིས་རྒྱས་པར་མི་འགྱུར་རོ་༎ བཞི་གང་ཞེ་ན་། འདི་ལྟ་སྟེ་། མངོན་པའི་ང་རྒྱལ་གྱིས་འཇིག་རྟེན་རྒྱང་པན་པའི་གསང་ཚིག་ཚོལ་བ་དང་། རྙེད་པ་དང་བཀུར་སྟི་ལ་ལྷག་པར་ཞེན་པས་ཁྱིམ་ལ་ལྟ་བ་དང་། བྱང་ཆུབ་སེམས་དཔའ་ལ་རྣམ་པར་སྡང་ཞིང་སྐུར་པ་འདེབས་པ་དང་། མ་ཐོས་པ་དང་མ་ཟིན་པའི་མདོ་སྡེ་རྣམས་སྤོང་བ་སྟེ་།
 lokāyatanamantraparyeṣṭyā |	འོད་སྲུང་།
 aśrutānām anuddiṣṭānām ca sū ||||||| ṇa ebhiḥ kāśyapa caturbhirdharmaiḥ samanvāgatasya bodhisattvasyotpannotpannā kuśalān dha ||||| vivardhate kuśalairdharmaiḥ tatredamucyate || 5 || lokāyikam eṣati ābhimāniko kulāni ||||||||	བྱང་ཆུབ་སེམས་དཔའ་ཆོས་བཞི་པོ་དེ་དག་དང་ལྡན་པའི་དགེ་བའི་ཆོས་སྐྱེས་ཤིང་བྱུང་བ་རྣམས་ཡོངས་སུ་ཟད་པར་འགྱུར་ཏེ་། དགེ་བའི་ཆོས་དེ་༄༢༡༤ཨ་༌༎ དག་གིས་རྒྱས་པར་མི་འགྱུར་རོ་༎ དེ་ལ་འདི་སྐད་ཅེས་བྱ་སྟེ་། ང་རྒྱལ་གྱིས་ནི་འཇིག་རྟེན་རྒྱང་པན་ཚོལ་༎ རྙེད་ཀྱི་ཕྱིར་ནི་མི་ལ་སྦྱོར་བར་བྱེད་༎
 buddhaurasā dviṣate ca bodhisattvāṃs teṣām avarṇaṃ bhaṇate samantāt |	བྱང་ཆུབ་སེམས་དཔའ་སངས་རྒྱས་སྲས་ལ་སྡང་༎ དེ་དག་བསྔགས་མིན་ཀུན་དུ་སྨྲ་བར་བྱེད་༎
 noddiṣṭato cāpi śrutā |||	དེ་ནི་མ་ཐོས་པ་དང་མ་ཟིན་མདོ་༎ བདེ་བར་གཤེགས་པས་གསུངས་པ་སྤོང་བར་བྱེད་༎
 ||| kṣipitā imi jinena proktāt | tamehi dharmehi samanvitasya	ཆོས་འདི་དག་དང་ལྡན་པར་གྱུར་པ་ནི་༎
 kuśaleṣu dharmeṣu na vṛddhirasti | tasmād ||||| ta bodhisattvo	དགེ་བའི་ཆོས་ཀྱིས་རྒྱས་པར་མི་འགྱུར་རོ་༎ དེ་ལྟར་བྱང་ཆུབ་སེམས་དཔའ་མཁས་པ་ཡིས་༎
 durān vijahyāccaturo pi dharmān | imā niṣevanta sudūri bodhaye	ཆོས་བཞི་འདི་དག་རྒྱང་བསྲིང་རྣམ་པར་སྤོང་༎ འདི་དག་བསྟེན་ན་བྱང་ཆུབ་རབ་རིང་སྟེ་༎
 nabhaṃ va bhūmīya sudūradūraṃ |||||	གནམ་ས་རིང་བས་ཤིན་ཏུ་རིང་བར་འགྱུར་༎
 kp|6 caturbhiḥ kāśyapa dharmaiḥ samanvāgato bodhisattvaḥ aparihāṇadharmā bhavati viśeṣagāmitayai katamaiścaturbhiḥ suśrutaṃ paryeṣṭi na duśrutaṃ	འོད་སྲུང་། བྱང་ཆུབ་སེམས་དཔའ་ཆོས་བཞི་དང་ལྡན་ན་ཁྱད་པར་དུ་འགྲོ་བས་ཡོངས་སུ་མི་ཉམས་པའི་ཆོས་ཅན་དུ་འགྱུར་ཏེ་། གཞི་གང་ཞེ་ན་། འདི་ལྟ་སྟེ་། འདི་ལྟར་ཕ་རོལ་ཏུ་ཕྱིན་པ་དྲུག་དང་ལྡན་པ་བྱང་ཆུབ་སེམས་དཔའི་སྡེ་སྣོད་ཚོལ་བ་ལ་བརྩམས་ནས་ལེགས་པར་ཐོས་པ་ཚོལ་གྱི་ཉེས་པར་ཐོས་པ་མི་ཚོལ་ཏེ་།
 yaduta ṣaṭpāramitābodhisattvapiṭakaparyeṣt śvasadṛśaśca bhavati nirmāṇatayā sarvasattveṣu dharmalābhasantuṣṭa ca bhavati |	སེམས་ཅན་ཐམས་ཅད་ལ་ང་རྒྱལ་མེད་པའི་སེམས་ཁྱི་དང་འདྲ་བ་ཡིན་། ཆོས་ཀྱི་རྙེད་པས་ཆོག་པར་འཛིན་ཏེ་།
 sarvamithyājīvaparivarjitaḥ āryavaṃśasantuṣṭ||||| tāya cāpatyā na parāṃścodayati |	ལོག་པས་འཚོ་བ་ཐམས་ཅད་ཡོངས་སུ་སྤངས་ཤིང་འཕགས་པའི་རིགས་ཀྱིས་ཆོག་པར་འཛིན་པ་ཡིན་།
 na ca dośāntaraskhalitagaveṣī bhavati | yeṣcāsya buddhirna gāhate tatra tathāgatam eva sākṣīti kṛtvā na pratikṣipati ||	གཞན་དག་གི་ལྟུང་བ་བྱུང་བ་དང་། མ་བྱུང་བ་མི་གླེང་ཞིང་གཞན་དག་གི་འཁྲུལ་པ་གཞན་དང་༄༢༡༤བ་གཞན་མི་ཚོལ་བ་ཡིན་། སངས་རྒྱས་ཀྱི་ཆོས་ཟབ་མོ་གང་དག་དེའི་བློས་མི་རྟོགས་པ་དེ་ལ་།
 tathāgata eva jānāti nāhaṃ ||||||||dhirnānādhimuktikānāṃ sattvānāṃ yathādhimuktikatayā dharmadeśanā pravartate |	སངས་རྒྱས་ཀྱི་བྱང་ཆུབ་ནི་མཐའ་ཡས་ཤིང་སེམས་ཅན་མོས་པ་ཐ་དད་པ་རྣམས་ལ་དེ་བཞིན་གཤེགས་པ་རྣམས་ཀྱི་ཆོས་བསྟན་པ་འཇུག་སྟེ་། དེ་བཞིན་གཤེགས་པ་ཉིད་ཀྱིས་མཁྱེན་གྱི་བདག་གིས་ནི་མི་ཤེས་ཏེ་། དེ་བཞིན་གཤེགས་པས་མངོན་སུམ་མོ་ཞེས་བྱས་ནས་མི་སྤང་པ་སྟེ་།
 ebhiḥ kāśyapa caturbhirdharmaiḥ samanvāgato bodhisattvaḥ aparihāṇadharma bhavati viśeṣagamitāyai |	འོད་སྲུང་། བྱང་ཆུབ་སེམས་དཔའ་ཆོས་བཞི་པོ་དེ་དག་དང་ལྡན་ནོ་། ཁྱད་པར་དུ་འགྲོ་བས་ཡོངས་སུ་མི་ཉམས་པའི་ཆོས་ཅན་དུ་འགྱུར་རོ་༎
 tatredamucyate || 6 ||	དེ་ལ་འདི་སྐད་ཅེས་བྱ་སྟེ་།
 nityaṃ ca so|| yukto upāyakauśalyatha bodhipīṭake ||	དེ་ནི་རྟག་ཏུ་ཕ་རོལ་ཕྱིན་རྣམས་དང་༎ ཐབས་ལ་མཁས་དང་བྱང་ཆུབ་སྡེ་སྣོད་བརྩོན་༎
 nirmānatāyāśca śvacittasādṛśo sarve ca sattveṣu ni ||||||	ང་རྒྱལ་མེད་པས་ཁྱི་འདྲའི་སེམས་ཀྱིས་སུ་༎ སེམས་ཅན་ཀུན་ལ་ང་རྒྱལ་བཅག་པ་ཡིན་༎
 tuṣṭaśca lābhena saddhārmikena ājivaśuddho sthita āryavaṃśe |	ཆོས་དང་མཐུན་པའི་རྙེད་པས་ཆོག་སེམས་ཤིང༏་༏འཚོ་བ་ཡོང་དག་འཕགས་པའི་རིགས་ལ་གནས་༎ གཞན་གྱི་འཁྲུལ་པ་ཚོལ་བར་མི་བྱེད་ཅིང་༎
 paraṃ ca nāpattiṣu codayanto skhalita||||||| na gaveṣamāno 2 na gāhate yatra ca buddhirasya tathāgataṃ sākṣikaroti tatra |	གཞན་གྱི་ལྟུང་བ་གླེང་བར་མི་བྱེད་དོ་༎ གང་དེའི་བློས་ནི་ཟབ་མོ་མི་རྟོགས་པ༏་༏དེ་ལ་དེ་བཞིན་གཤེགས་པ་མངོན་སུམ་སྟེ་༎ བདེ་གཤེགས་བཤད་པའི་བྱང་ཆུབ་མཐའ་ཡས་པས་༎
 nāhaṃ prajānāmi jino prajā||||||	རྒྱལ་བས་མཁྱེན་གྱི་བདག་གིས་མི་ཤེས་སོ་༎
 ananta bodhi sugatena bhāṣitā 3 imā tu dharmāścaturo viditvā	ཆོས་བཞི་འདི་དག་རིག་པར་གྱུར་པ་ནི་༎ ཡེ་ཤེས་ཁྱད་པར་འཕགས་མཆོག་ཉམས་མི་འགྱུར་༎
 na hāpaye jātu viśeṣam uttamam | imeṣu dharmeṣu pratiṣṭhitasya	ཆོས་འདི་དག་ལ་རབ་ཏུ་གནས་པ་ནི་༎
 na durlabhā bodhi jinapraśastān ||	རྒྱལ་བས་བསྔགས་པའི་བྱང་ཆུབ་རྙེད་མི་དཀའ༎ འོད་སྲུང་། ཆོས་༄༢༡༥ཨ་༌༎
 kp|7 catvāra ime kāśyapa kuṭilāścittotpādāstena bodhisattvena parivarjitavyāḥ katameścatvāraryaduta kāṅkṣā vimatirvicikitsā sarvabuddhadharmeṣu	བཞི་པོ་འདི་དག་ནི་གྱ་གྱུ་ཅན་གྱི་སེམས་བསྐྱེད་པ་སྟེ་། དེ་དག་བྱང་ཆུབ་སེམས་དཔས་ཡོངས་སུ་སྤང་བར་བྱའོ་༎ བཞི་གང་ཞེ་ན་།
 mānamadamrakṣakrodhavyāpādāḥ sarvasattveṣu irṣyāmātsaryaṃ paralābheṣu avarṇāyaśokīrtiśabdaślokaniścāraṇatayā||||||	འདི་ལྟ་སྟེ་། སངས་རྒྱས་ཀྱི་ཆོས་རྣམས་ལ་སོམ་ཉི་དང་། ཡིད་གཉིས་དང་། ཐེ་ཚོམ་ཟ་བ་དང་། སེམས་ཅན་རྣམས་ལ་ང་རྒྱལ་དང་། རྒྱགས་པ་དང་། འཆབ་པ་དང་། ཁྲོ་བ་དང་། གནོད་པར་སེམས་པ་དང༏་གཞན་གྱི་རྙེད་པ་རྣམས་ལ་ཕྲག་དོག་དང་སེར་སྣ་བྱེད་པ་དང་། བྱང་ཆུབ་སེམས་དཔའ་རྣམས་ལ་བསྔགས་པ་མ་ཡིན་པ་དང་། མི་སྙན་པ་དང་། བརྗོད་པ་མ་ཡིན་པའི་སྒྲ་ཚིགས་སུ་བཅད་པ་འབྱིན་པ་སྟེ་། འོད་སྲུང་།
 ime kāśyapa catvāraḥ kuṭilāścittotpādāste bodhisattvena parivarjitavyāḥ tatredamucyate || 7 ||	བཞི་པོ་དེ་དག་ནི་གྱ་གྱུ་ཅན་གྱི་སེམས་བསྐྱེད་པ་སྟེ་། དེ་དག་བྱང་ཆུབ་སེམས་དཔས་ཡོངས་སུ་སྤང་བར་བྱའོ་༎ དེ་ལ་འདི་སྐད་ཅེས་བྱ་སྟེ་།
 dharmeṣu kāṅkṣāṃ vimatiṃ ca kurvati	ཆོས་རྣམས་ལ་ནི་སོམ་ཉི་ཡིད་གཉིས་བྱེད་༎
 sattveṣu mānam atha krodhaṃ sevati | mātsaryam irṣyā paralābha kurvate	སེམས་ཅན་རྣམས་ལ་ང་རྒྱལ་རྒྱགས་ཁྲོ་བསྟེན་༎ གཞན་གྱི་རྙེད་ལ་སེར་སྣ་ཕྲག་དོག་བྱེད་༎
 jine prasādaṃ ca na |||||||| akīrtyavarṇam ayaśaṃ ca cārayī so bodhisattveṣu sadā avidvāt |	རྒྱལ་བ་ལ་ནི་ནམ་ཡང་དད་མི་བྱེད༏་༏མི་མཁས་རྟག་ཏུ་བྱང་ཆུབ་སེམས་དཔའ་ལ་༎ བསྔགས་པ་མིན་དང་བརྗོད་མིན་མི་སྙན་བརྗོད་༎
 catvāri cittā kuṭilā vivarjaye |||||| |||||| pakṣaṃ sadā bodhisattvaḥ 2 ||	གྱ་གྱུ་ཅན་གྱི་སེམས་བཞི་རྣམ་པར་སྤང་༎ བྱང་ཆུབ་སེམས་དཔས་རྟག་ཏུ་སེམས་ཅན་བསྟན་༎ འོད་སྲུང་། བཞི་པོ་འདི་དག་ནི་བྱང་ཆུབ་སེམས་དཔའ་དྲང་པོའི་དྲང་བའི་མཚན་ཉིད་ཡིན་ཏེ་།
 kp|8 catvāra ime kāśyapa ṛjukasya bodhisattvasya ṛjukalakṣaṇāni bhavanti katamāni catvāriryaduta āpattiāpanno na pracchādāyatācaṣṭe vivṛṇoti niṣparyutthāno bhavati |	བཞི་གང་ཞེ་ན་། འདི་ལྟ་སྟེ་། ལྟུང་བ་བྱུང་བ་རྣམས་མི་༄༢༡༥བ་འཆབ་ཅིང་བརྗོད་དེ་རྣམ་པར་འབྱེད་པ་དང་། འཆགས་པས་ཀུན་ནས་ལྡང་བ་མེད་པ་ཡིན་།
 yena satyavacanena rājapārihāṇirvā dhanāpārihāṇirvā kāyajīvitāntarāyo bhavet tat satyavacanaṃ na vigūhati nānyenānyaṃ prati nisṛtya vācā bhāṣate	དེའི་བདེན་པའི་ཚིག་གང་གིས་རྒྱལ་སྲིད་སྟོར་བའམ་། ནོར་ཡལ་བའམ་། སྲོག་གི་བར་ཆད་དུ་འགྱུར་ཡང་བདེན་པའི་ཚིག་མི་མཁྱུད་ཅིང་གཞན་ནས་གཞན་དུ་བསྒྱུར་བའི་ཚིག་མི་སྨྲ་བ་ཡིན་།
 sarvaparopakrameṣu cākrośaparibhāṣaṇakuṃsanapaṃsantāḍana tarjanavadhabandhanāparādheṣvātmāparādhī bhavati |	གཞན་གྱིས་གནོད་པ་བྱ་བ་སྐུར་པ་དང་། མཚང་འབྲུ་བ་དང་། སྨོད་པ་དང་། བཤུང་བ་དང་། བསྡིགས་པ་དང་། རྡེག་པ་དང་། གསོད་པ་དང་། འཆིང་བར་བྱེད་པའི་ཉེས་པ་ཐམས་ཅད་ལ་བདག་གི་ཉེས་པར་སེམས་ཤིང་།
 karmavipākapratisaraṇo na pareṣāṃ kupyati nā nuśayaṃ vahati |	ལས་ཀྱི་རྣམ་པར་སྨིན་པ་ལ་སྟོན་པས་གཞན་དག་ལ་མི་འཁྲུག་ཅིང་ཁོང་དུ་འཛིན་པ་མེད་པ་ཡིན་། 
 sa śraddhāpratiṣṭhitaśca bhavati |	དེ་དད་པ་ལ་རབ་ཏུ་གནས་པ་ཡིན་ཏེ་།
 sarvāśraddheyānapi buddhadharmā śraddadhāti āśayaśuddhatām upādāya |	བསམ་པ་ཡོངས་སུ་དག་པའི་ཕྱིར་ཐམས་ཅད་དད་པར་མི་འགྱུར་བའི་སངས་རྒྱས་ཀྱི་ཆོས་ལ་མངོན་པར་དད་པ་སྟེ་།
 ime kāśyapa catvāro ṛjukasya bodhisattvasya ṛjukalakṣaṇāni bhavanti |	འོད་སྲུང་། བཞི་པོ་དེ་དག་ནི་བྱང་ཆུབ་སེམས་དཔའ་དྲང་པོའི་དྲང་བའི་མཚན་ཉིད་ཡིན་ནོ་༎
 tatredamucyate || 8 ||	དེ་ལ་འདི་སྐད་ཅེས་བྱ་སྟེ་།
 āpattim āpanna na cchādayanti	ལྟུང་བ་བྱུང་བ་འཆབ་པར་མི་བྱེད་ཀྱི་༎
 kathenti vivaranti ca eti doṣāt |	བརྗོད་ཅིང་རྣམ་པར་འབྱེད་དེ་ཉེས་པ་འདོར་༎
 dhanarājyaheto na ca jīvi XX	ནོར་དང་རྒྱལ་སྲིད་ཕྱིར་དང་སྲོག་ཕྱིར་ཡང་༎ འདུ་ཤེས་བསྒྱུར་ཏེ་རྫུན་པའི་ཚིག་མི་སྨྲ་༎
 XX vadante vidadīyasañjñām | ākrośanākunsanapaṃsanāsu vadheṣu bandheṣvavarodhaneṣu |	སྐུར་དང་སྨོད་དང་བཤུང་དང་གསོད་པ་དང་༎ འཆིང་བ་བྱེད་དང་གོ་རར་བཅུག་པ་ལ་༎
 ātmāparādhī na pare X kupyate	བདག་གིས་ཉེས་སེམས་གཞན་ལ་འཁྲུག་མི་བྱེད་༎
 karmasvako nānuśayaṃ vahantoḥ 2	ལས་ནི་བདག་གིར་བྱ་བས་ཁོན་མི་འཛིན་༎
 sa śraddadhāti sugātāna bodhiṃ	དེ་ནི་བདེར་གཤེགས་རྣམས་ཀྱི་བྱང་ཆུབ་༄༢༡༦ཨ་༌༎
 śraddhāsthito āśayiśuddhiyukto	དང༏་༏དད་ལ་གནས་ཤིང་བསམ་པ་དད་ལྡན་པ་༎ འདི་དག་དྲང་བའི་མཚན་དུ་སངས་རྒྱས་གསུངས་༎
 ṛjukalakṣaṇā hyeti jinena proktā varāgrasattvena niṣevitavyāḥ 3 ||	སེམས་ཅན་མཆོག་གིས་རྟག་ཏུ་བསྟེན་པར་བྱ་༎ འོད་སྲུང་། བཞི་པོ་འདི་དག་ནི་བྱང་ཆུབ་སེམས་དཔའ་དམུ་རྒོད་དེ་།
 kp|9 catvāra ime kāśyapa bodhisattva khaḍuṅkāḥ katame catvāraḥ śrutoddhatadharmavihārī ca bhavati na ca pratipadyate |	བཞི་གང་ཞེ་ན་། འདི་ལྟ་སྟེ་། ཐོས་པ་ལ་གཅེས་པ་འདོར་བའི་ཆོས་སུ་གནས་ཤིང་།
 dharmānudharmapratipattim anuśāsane nuddhatadharmavihārī ca bhavati |	ཆོས་ཀྱི་རྗེས་སུ་མཐུན་པའི་ཆོས་བསྒྲུབ་པ་ལ་ནན་ཏན་དུ་མི་བྱེད་པ་ཡིན་། རྗེས་སུ་བསྟན་པ་ལ་གཅེས་པ་འདོར་བའི་ཆོས་སུ་གནས་ཤིང་།
 na ca śuśrūṣatyācāryopādhyāyānāṃ |	སློབ་དཔོན་དང་། མཁན་པོ་ལ་སྲི་ཞུ་མི་བྱེད་པ་ཡིན་།
 śraddhādeyaṃ vinipātayati cyuta pratijñaśca śraddhādeyāṃ paribhuṅkte |	དམ་བཅས་པ་ལས་ཉམས་ཀྱང་དད་པས་བྱིན་པ་ཀུན་སྤྱོད་དེ་། དད་པས་བྱིན་པ་ལོག་པར་ལྟུང་བར་བྱེད་པ་ཡིན་།
 dāntājāneyaprāpitāṃśca bodhisattvāṃ dṛṣṭvā agoravo bhavati mānagrāhī |	བྱང་ཆུབ་སེམས་དཔའ་དུལ་བ་ཅང་ཤེས་པ་རྣམས་མཐོང་ན་མི་གུས་ཤིང་ང་རྒྱལ་འཛིན་པ་ཡིན་ཏེ་། 
 ime kāśyapa catvāro bodhisattvākhaḍuṅkāḥ tatredamucyate || 9 ||	འོད་སྲུང་། བཞི་པོ་འདི་དག་ནི་བྱང་ཆུབ་སེམས་དཔའ་དམུ་རྒོད་དོ་༎ དེ་ལ་འདི་སྐད་ཅེས་བྱ་སྟེ་།
 śrutena oddhatyavihāri bhoti na coddhato gacchati ānuśāsaniṃ |	ཐོས་པས་རྒོད་པར་གནས་པར་བྱེད་པ་ཡིན་༎ རྗེས་སུ་བསྟན་པའི་ཆོས་ཉིད་རྟོགས་མི་འགྱུར་༎
 so uddhato sevati sarvadharmān śuśrūṣate na ca āryāṃ kathañcit |	དེ་ནི་ཆོས་ཀུན་གཅེས་པ་འདོར་བ་བསྟེན་༎ འཕགས་པ་རྣམས་ལ་ནམ་ཡང་སྲི་ཞུ་མེད་༎
 cyutapratijño paribhuñjate sadā śraddhāya dinnāni subhojanāni |	དམ་བཅས་ཉམས་ཀྱང་དད་པས་བྱིན་པ་ཡི་༎ ཁ་ཟས་རྣམས་ལ་དེ་ནི་རྟག་ཏུ་ཟ་༎ བྱང་ཆུབ་སེམས་དཔའ་ཅང་ཤེས་ཐོབ་པ་དག་།
 ājanyaprāptānapi bodhisattvān paśyitvā no gauravatā karoti | 2	མཐོང་བར་གྱུར་ན་གུས་པར་མི་བྱེད་ཅིང་༎
 mānaṃ ca so bṛṃhayate khaḍuṅko nirmāṇa to sevati bodhisattvān	དམུ་རྒོད་དག་ནི་ང་རྒྱལ་འཕེལ་བར་བྱེད་༎ བྱང་ཆུབ་༄༢༡༦བ་སེམས་དཔའ་ང་རྒྱལ་བཅག་མི་བརྟེན་༎
 ete khaḍuṅkā sugatena proktā jīnātmajāste parivarjanīyāt 3 ||	འདི་དག་དམུ་རྒོད་བདེ་བར་གཤེགས་པས་གསུངས་༎ དེ་དག་རྒྱལ་སྲས་རྣམས་ཀྱིས་ཡོངས་སུ་སྤང་༎ འོད་སྲུང་། བཞི་པོ་འདི་དག་ནི་བྱང་ཆུབ་སེམས་དཔའ་ཅང་ཤེས་པ་སྟེ་།
 kp|10 catvāra ime kāśyapa ājāneyā bodhisattvāḥ katame catvāraḥ suśrutaṃ śruṇoti tatra ca pratipadyate |	བཞི་གང་ཞེ་ན་། འདི་ལྟ་སྟེ་། ལེགས་པར་ཐོས་པ་ཉན་ཅིང་དེ་ལ་ནན་ཏན་དུ་བྱེད་དེ་།
 arthapratisaraṇaśca bhavati na vyañjanapratisaraṇaḥ pradakṣiṇagrāhī bhavatyavavādānuśāsane |	དོན་ལ་རྟོན་གྱི་ཚིག་འབྲུ་ལ་མི་རྟོན་པ་ཡིན་། གདམས་པ་། རྗེས་སུ་བསྟན་པ་ལ་མཐུན་པར་འཛིན་ཅིང་།
 suvacaḥ sukṛtakarmakārī ca bhavati |	བཀའ་བློ་བདེ་ལ་ལེགས་པར་བྱེད་པའི་ལས་བྱེད་ཅིང་།
 guruśuśrūṣaniryātaḥ ājāneyabhojanāni ca paribhūṅkte |	བླ་མ་ལ་སྲི་ཞུ་བྱ་བ་ཚར་ཕྱིན་པ་ཡིན་།
 acyutaśīlasamādhirdāntājāneyaprāptaśca bodhisattvāṃ dṛṣṭvā sagauravo bhavati sapratīśaḥ tannimnaḥ tatpravaṇaḥ tatprāgbhāraḥ tadguṇapratikāṅkṣī	ཚུལ་ཁྲིམས་དང་། ཏིང་ངེ་འཛིན་ལས་མ་ཉམས་ཏེ་ཅང་ཤེས་པས་ཟས་ཟ་བ་ཡིན་། བྱང་ཆུབ་སེམས་དཔའ་འདུལ་བ་ཅང་ཤེས་རྣམས་མཐོང་ན་གུས་པ་དང་བཅས་ཤིང་ཞེས་དང་བཅས་པར་དེ་ལ་གཞོལ་། དེ་ལ་འབབ་། དེ་ལ་བབ་ཅིང་། དེའི་ཡོན་ཏན་འདོད་པ་ཡིན་ཏེ་།
 ime kāśyapa catvāro ājāneyā bodhisattvā tatredam ucyate 10 ||	འོད་སྲུང་། བཞི་པོ་དེ་དག་ནི་བྱང་ཆུབ་སེམས་དཔའ་ཅང་ཤེས་སོ་༎ དེ་ལ་འདི་སྐད་ཅེས་བྱ་སྟེ་།
 śruṇoti yaṃ suśrutataṃ karoti dharmārthasāro pratipattisusthitaḥ	གང་མཉན་དེ་ནི་ལེགས་པར་ནན་ཏན་བྱེད་༎ ཆོས་དོན་སྙིང་པོར་བྱེད་ཅིང་ནན་ཏན་གནས་༎
 pradakṣiṇaṃ gṛhṇati ānuśāsanīṃ	རྗེས་སུ་བསྟན་པ་མཐུན་པར་འཛིན་བྱེད་ཅིང་༎
 suvaco guru sevati dharmakāma |	ཆོས་འདོད་བཀའ་བློ་བདེ་བར་བླ་མ་བསྟེན་༎
 śīle samādhau ca sadā pratiṣṭhito |	ཚུལ་ཁྲིམས་ཏིང་ངེ་འཛིན་ལ་རྟག་གནས་ཤིང་༎
 subhojanaṃ bhuñjati śīlasaṃvṛtaḥ	ཚུལ་ཁྲིམས་བསྡམས་ནས་དེ་ནི་བཟའ་བ་ཟ་༎
 sagauravo bhavati ca sapradeśo	གུས་དང་བཅས་ཤིང་ཞེ་སར་བཅས་པ་ཡིན་༎
 tannimna tatproṇu guṇābhikāṅkṣi 2	དེ་ལ་གཞོལ་ཞིང་དེར་འབབ་ཡོན་ཏན་འདོད་༎
 ājanyaprāptāśca jinorasā ye premeṇa tāṃ paśyati nityakālam |	རྒྱལ་སྲས་གང་དག་ཅང་ཤེས་ཐོབ་གྱུར་པ་༎ དེ་དག་ལ་ནི་རྟག་ཏུ་དགའ་༄༢༡༧ཨ་༌༎
 catvāra etan sugato X diṣṭā	བས་ལྟ་༎ བདེ་བར་གཤེགས་པས་བསྟན་པ་འདི་བཞི་ནི་༎
 ājanyaprāptā sugatasya putrāḥ 3 ||	བདེར་གཤེགས་སྲས་པོ་ཅང་ཤེས་ཐོབ་པ་ཡིན་༎
 kp|11 catvāra ime kāśyapa bodhisatvaskhalitāni |	འོད་སྲུང་། བཞི་པོ་འདི་དག་ནི་བྱང་ཆུབ་སེམས་དཔའི་འཁྲུལ་པ་སྟེ་།
 katamāni catvāri aparipāciteṣu satveṣu viśvāso bodhisattvasya skhalitaṃ |	བཞི་གང་ཞེ་ན་། འདི་ལྟ་སྟེ་། སེམས་ཅན་ཡོངས་སུ་སྨིན་པར་མ་བྱས་པ་རྣམས་ལ་ཡིད་རྟོན་པ་བྱང་ཆུབ་སེམས་དཔའི་འཁྲུལ་པ་དང་། 
 abhājanībhūte sattveṣūdārabuddhadharmasamprakāśanatā bodhisattvasya skhalitam udārādhimuktikeṣu	སེམས་ཅན་སྣོད་དུ་མ་གྱུར་པ་རྣམས་ལ་སངས་རྒྱས་ཀྱི་ཆོས་རྒྱ་ཆེན་པོ་སྟོན་པ་བྱང་ཆུབ་སེམས་དཔའི་འཁྲུལ་པ་དང་། རྒྱ་ཆེན་པོ་ལ་མོས་པའི་སེམས་ཅན་རྣམས་ལ་ཐེག་པ་དམན་པ་སྟོན་པ་བྱང་ཆུབ་སེམས་དཔའི་འཁྲུལ་པ་དང་། 
 sattveṣu hīnayānasamprakāśanā bodhisattvasya skhalitaṃ samyakpratyupasthiteṣu sattveṣu śīlavatsu kalyāṇadharmaprati mānanā duḥśīlapāpadharmasaṅgraho bodhisattvasya skhali	སེམས་ཅན་ཡང་དག་པ་ལ་རབ་ཏུ་གནས་པ་ཚུལ་ཁྲིམས་དང་ལྡན་པ་དགེ་བའི་ཆོས་ཅན་རྣམས་ལ་བརྙས་ཤིང་ཚུལ་ཁྲིམས་འཆལ་པ་སྡིག་པའི་ཆོས་ཅན་ཀུན་དུ་སྡུད་པ་བྱང་ཆུབ་སེམས་དཔའི་འཁྲུལ་པ་སྟེ་།
 X imā kāśyapa catvāro bodhisattvaskhalitāni |	འོད་སྲུང་། བཞི་པོ་འདི་དག་ནི་བྱང་ཆུབ་སེམས་དཔའི་འཁྲུལ་པའོ་༎
 tatredamucyate || 10 ||	དེ་ལ་འདི་སྐད་ཅེས་བྱ་སྟེ་།
 na viśvaseyāparipāciteṣu abhājane dharma udāra no bhaṇe |	ཡོངས་སྨིན་མ་བྱས་རྣམས་ལ་ཡིད་མི་རྟོན་༎ སྣོད་མིན་རྣམས་ལ་རྒྱ་ཆེན་ཆོས་མི་བཤད་༎ རྒྱ་ཆེན་སེམས་ཅན་རྣམས་ལ་ཐེག་པ་དམན་༎
 udāradharmeṣu na hīnayāne prakāśaye jātu sa bodhisattvo |	བྱང་ཆུབ་སེམས་དཔའ་མཆོག་གིས་བཤད་མི་བྱ་༎
 samyaksthitāṃ śīlaguṇopapetān kalyāṇadharmā na vimānayeta |	ཡང་དག་གནས་ཤིང་ཚུལ་ཁྲིམས་ཡོན་ཏན་ལྡན་༎ དགེ་བའི་ཆོས་ཅན་རྣམས་ལ་བརྙས་མི་བྱ་༎
 duḥśīlasattvā na parigraheyā pāpaṃ ca dharmān parivarjayetaḥ	ཚུལ་ཁྲིམས་འཆལ་པའི་སེམས་ཅན་ཡོངས་མི་བསྡུ་༎ སྡིག་༄༢༡༧བ་པའི་ཆོས་རྣམས་ཡོངས་སུ་སྤང་བར་བྱ་༎
 skhalitāni catvāri imāni jñātvā vivarjayeddūrata bodhisattvāḥ	འཁྲུལ་བའི་ཆོས་བཞི་འདི་དག་ཤེས་གྱུར་ནས་༎
 imā niṣevaṃ tu na bodhi buddhyate tasmād vivarjed imi dharma paṇḍitaḥ 3 ||	བྱང་ཆུབ་སེམས་དཔས་རྒྱང་བསྲིང་རྣམ་པར་སྤང་༎ འདི་དག་བསྟན་ན་བྱང་ཆུབ་འཚང་མི་རྒྱ་༎ དེ་ལྟ་བས་ན་མཁས་པས་ཆོས་འདི་སྤོངས་༎
 kp|12 catvāra ime kāśyapa bodhisattvamārgāḥ katame catvāraḥ samacittatā sarvasattveṣu |	འོད་སྲུང་། བཞི་པོ་འདི་དག་ནི་བྱང་ཆུབ་སེམས་དཔའི་ལམ་སྟེ་། བཞི་གང་ཞེ་ན་།
 buddhajñānasamādāpanatā sarvasattveṣu samadharmadeśanā sarvasattveṣu samyakprayogatā sarvasattveṣu |	འདི་ལྟ་སྟེ་། སེམས་ཅན་ཐམས་ཅད་ལ་སེམས་མཉམ་པ་དང་། སེམས་ཅན་ཐམས་ཅད་ལ་མཚུངས་པར་ཆོས་སྟོན་པ་དང་། སེམས་ཅན་ཐམས་ཅད་སངས་རྒྱས་ཀྱི་ཡེ་ཤེས་ཡང་དག་པར་འཛིན་ཏུ་འཇུག་པ་དང་། སེམས་ཅན་ཐམས་ཅད་ལ་ཡང་དག་པར་སྦྱོར་བ་སྟེ་།
 4 ime kāśyapa catvāro bodhisattvamārgāḥ tatredam idamucyate 12 ||	འོད་སྲུང་། བཞི་པོ་འདི་དག་ནི་བྱང་ཆུབ་སེམས་དཔའི་ལམ་མོ་༎ དེ་ལ་འདི་སྐད་ཅེས་བྱ་སྟེ་།
 samacitta sattveṣu bhata nityaṃ samādapeyādiha buddhayāne |	སེམས་ཅན་རྣམས་ལ་རྟག་ཏུ་སེམས་སྙོམས་བྱ་༎ སངས་རྒྱས་ཐེག་མཆོག་ཡང་དག་འཛིན་དུ་འཇུག་།
 dharmāṃ ca deśetā jinapraśastaṃ sarveṣu sattveṣu prasannacitto |	རྒྱལ་བས་བསྔགས་པའི་ཆོས་ནི་བསྟན་པར་བྱ་༎ སེམས་ཅན་ཀུན་ལ་དང་བའི་སེམས་སུ་བྱ་༎
 samyakprayuktā pratipattisusthito sarveṣu sattveṣu samaṃ careta |	ཡང་དག་སྦྱོར་ཞིང་ནན་ཏན་བྱེད་པར་གནས་༎ སེམས་ཅན་ཀུན་ལ་མཚུངས་པར་སྤྱད་པར་བྱ་༎
 mārgān imāṃścatura jinapraśastāṃ jinorasā sada taṃ bhāvayanti || 3 ||	ཆོས་བཞི་འདི་དག་རྒྱལ་བས་རབ་བསྔགས་ཏེ་༎
 kp|13 catvāra ime kāśyapa bodhisattvasya kumitrāṇi kusahāyāste bodhisattvena parivarjayitavyā |	རྒྱལ་སྲས་རྣམས་ཀྱིས་དེ་དག་རྟག་ཏུ་བསྟན་། འོད་སྲུང༏་བཞི་པོ་འདི་དག་ནི་བྱང་ཆུབ་སེམས་དཔའི་བཤེས་གཉེན་ངན་པ་གྲོགས་པོ་ངན་པ་སྟེ་། དེ་དག་བྱང་ཆུབ་སེམས་དཔས་ཡོངས་སུ་སྤང་བར་བྱའོ་༎
 katamāni catvāri |	བཞི་གང་ཞེ་ན་། འདི་ལྟ་སྟེ་།
 śrāvakayānīyo bhikṣu ātmahitāya pratipannaḥ pratyekabuddhayānīyo 'lpārtho 'lpakṛtyaḥ lokāyatiko vicitramantrapratibhānaḥ yaṃ ca pudgalaṃ sevamāna tato lokāmiṣasaṅgraho	༄༢༡༨ཨ་༌༎ ཉན་ཐོས་ཀྱི་ཐེག་པ་པ་བདག་ལ་ཕན་པའི་ཕྱིར་ཞུགས་པ་དང་། རང་སངས་རྒྱས་ཀྱི་ཐེག་པ་པ་དོན་ཉུང་ཞིང་བྱ་བ་ཉུང་བ་དང་། འཇིག་རྟེན་རྒྱང་པན་པའི་གསང་ཚིག་སྣ་ཚོགས་ཀྱི་སྤོབས་པ་ཅན་དང་། གང་ལ་བརྟེན་པས་འཇིག་རྟེན་གྱི་ཟང་ཟིང་ཀུན་སྡུད་པར་འགྱུར་གྱི་ཆོས་ཀུན་མི་སྡུད་པ་སྟེ་། འོད་སྲུང་།
 bhavati na dharmasaṅgrahaḥ ime kāśyapa catvāro bodhisattvasya kumitrāṇi kusahāyās	བཞི་པོ་དེ་དག་ནི་བྱང་ཆུབ་སེམས་དཔའ་བཤེས་གཉེན་ངན་པ་གྲོགས་པོ་ངན་པ་སྟེ་།
 te bodhisattvena parivarjayitavyāḥ tatredamucyate ||	དེ་དག་བྱང་ཆུབ་སེམས་དཔས་ཡོངས་སུ་སྤང་བར་བྱའོ་༎ དེ་ལ་འདི་སྐད་ཅེས་བྱ་སྟེ་།
 ye śrāvakā ātmahitāya yuktā yogaṃ ca ye pravrajitāścaranti |	ཉན་ཐོས་གང་དག་བདག་ཕན་བརྩོན་པ་དང་༎ གང་དག་རབ་ཏུ་བྱུང་ནས་རྣལ་འབྱོར་སྤྱོད་༎ རང་སངས་རྒྱས་པ་གང་དག་བྱེད་ཉུང་ཞིང་༎ བདག་གི་དོན་དུ་འདུ་འཛི་རྣམ་པར་སྤོང་༎
 pratyekabuddhāpi ca ye 'lpakṛtyā alpārthasaṃsargā vivarjayanti |	བྱིས་པ་གང་དག་འཇིག་རྟེན་རྒྱང་པན་ཀློག་།
 lokāyataṃ ye ca paḥhanti bālā vigrāhikā yatra kathopadiṣṭā |	ཇི་ལྟར་བསྟན་བཞིན་གང་དག་འདིར་རྩོད་བྱེད་༎
 yaṃ sevamānāmiṣasaṅgraho bhaved bhaven na dharmasya ca saṅgraho yahim 2 |	གང་ལ་བརྟེན་ནས་ཟང་ཟིང་ཀུན་སྡུད་ཀྱི་༎ ཆོས་འདི་ནམ་ཡང་སྡུད་པར་མི་བྱེད་པ་༎
 tān bodhisattvāścaturo prahāya kalyāṇamitrāścaturo bhajanti |	དེ་བཞི་བྱང་ཆུབ་སེམས་དཔས་རབ་སྤངས་ནས་༎ དགེ་བའི་བཤེས་གཉེན་བཞི་ལ་བསྟེན་པར་བྱ་༎
 ete kumitrā kusahāyayuktā jinena dūrāt parivarjanīyā | 3 ||	འདི་དག་བཤེས་གཉེན་ངན་དང་གྲོགས་ངན་དུ་༎ རྒྱལ་བས་གསུང་ཏེ་ཐག་བསྲིང་ཡོངས་སུ་སྤོངས་༎
 kp|14 catvāra ime kāśyapa bodhisattvasya bhūtakalyāṇamitrāṇi |	འོད་སྲུང་། བཞི་པོ་འདི་དག་ནི་བྱང་ཆུབ་སེམས་དཔའི་དགེ་བའི་བཤེས་གཉེན་ཏེ་།
 katamāni catvāri | yācanako bodhisattvasya bhūtakalyāṇamitraṃ bodhimārgopastambhāya saṃvartate dharmabhāṇako bodhisattvasya bhūtakalyāṇamitraṃ śrutaprajñopastambhāya saṃvartate |	བཞི་གང་ཞེ་ན་། འདི་ལྟ་སྟེ་།
 pravrajyāsamādapako bodhisattvasya bhūtakalyāṇamitra sarvakuśalamūlopastambhāya | saṃvartate | buddhā bhagavanto bodhisattvasya bhūtakalyāṇamitra sarvabuddhadharmopastambhāya saṃvartate |	བྱང་ཆུབ་ཀྱི་ལམ་སྟོན་པའི་ཕྱིར་སློང་བ་བྱང་ཆུབ་སེམས་༄༢༡༨བ་དཔའི་དགེ་བའི་བཤེས་གཉེན་དང་། ཐོས་པའི་ཤེས་རབ་སྟོན་པའི་ཕྱིར་ཆོས་སྨྲ་བ་བྱང་ཆུབ་སེམས་དཔའི་དགེ་བའི་བཤེས་གཉེན་དང་། དགེ་བའི་རྩ་བ་ཐམས་ཅད་སྟོན་པའི་ཕྱིར་རབ་ཏུ་འབྱུང་བ་ཡང་དག་པར་འཛིན་དུ་འཇུག་པ་བྱང་ཆུབ་སེམས་དཔའི་དགེ་བའི་བཤེས་གཉེན་དང་། སངས་རྒྱས་ཀྱི་ཆོས་ཐམས་ཅད་སྟོན་པའི་ཕྱིར་སངས་རྒྱས་བཅོམ་ལྡན་འདས་རྣམས་བྱང་ཆུབ་སེམས་དཔའི་དགེ་བའི་བཤེས་གཉེན་ཏེ་།
 ime kāśyapa bodhisattvasya bhūtakalyāṇamitrāṇi tatredamucyate || 12 ||	འོད་སྲུང་། བཞི་པོ་དེ་དག་ནི་བྱང་ཆུབ་སེམས་དཔའི་དགེ་བའི་བཤེས་གཉེན་ནོ་༎ དེ་ལ་འདི་སྐད་ཅེས་བྱ་སྟེ་།
 kalyāṇamitraṃ sa ca dāyakānāṃ pratigrāhako bodhiparigrahāya |	བྱང་ཆུབ་ཡོངས་སུ་སྟོན་ཕྱིར་ལེན་པ་པོ་༎ སྦྱིན་བྱེད་རྣམས་ཀྱི་དགེ་བའི་བཤེས་གཉེན་ཡིན་༎
 dharmārthavādī śrutaprajñakarī kalyāṇamitraṃ sugatena proktaṃ |	ཆོས་སྔོན་སྨྲ་བ་ཐོས་དང་ཤེས་རབ་བྱེད་༎ དགེ་བའི་བཤེས་གཉེན་ཡིན་པར་བདེ་གཤེགས་གསུངས་༎
 pravrajya ye cāpi samādapenti te mitramūlaṃ sugatasya vuktāḥ	གང་དག་རབ་འབྱུང་ཡང་དག་འཛིན་འཇུག་པ་༎ དེ་དག་དགེ་རྩ་ཡིན་པས་བཤེས་གཉེན་གསུངས་༎
 buddhaśca mitraṃ sugatātmajānāṃ sambuddhamārgasyupastambhanāyaḥ	རྫོགས་སངས་རྒྱས་ཀྱི་ལམ་ནི་སྟོན་པའི་ཕྱིར་༎ སངས་རྒྱས་རྣམས་ནི་བདེ་གཤེགས་སྲས་ཀྱི་བཤེས་༎
 ete hi catvāri jinapraśastā kalyāṇamitrā sugatātmajānāṃ |	རྒྱལ་བས་བསྔགས་པ་བཞི་པོ་འདི་དག་ནི་། བདེ་གཤེགས་སྲས་ཀྱི་དགེ་བའི་བཤེས་གཉེན་ཏེ་༎ འདི་དག་བསྟེན་ཅིང་རྟག་ཏུ་བག་ཡོད་ན་༎
 eta niṣeva X sadāpramantā prāpnoti bodhi sugatopadiṣṭā | 3 ||	བདེ་གཤེགས་བསྟེན་པའི་བྱང་ཆུབ་ཐོབ་པར་འགྱུར་༎
 kp|15 catvāra ime kāśyapa bodhisattvapratirūpa|||| katame catvāra |	འོད་སྲུང་། བཞི་པོ་འདི་དག་ནི་བྱང་ཆུབ་སེམས་དཔའ་ལྟར་བཅོས་པ་སྟེ་། བཞི་གང་ཞེ་ན་།
 lābhasatkārārthiko bhavati na dharmārthikāḥ kīrtiśabdaślokārthiko bhavati na guṇārthikaḥ	༄༢༡༩ཨ་༌༎ འདི་ལྟ་སྟེ་། རྙེད་པ་དང་བཀུར་སྟི་དོན་དུ་གཉེར་གྱི་ཆོས་དོན་དུ་གཉེར་བ་མ་ཡིན་པ་དང་། བརྗོད་པའི་སྒྲ་ཚིགས་སུ་བཅད་པ་དོན་དུ་གཉེར་གྱི་ཡོན་ཏན་དོན་དུ་གཉེར་བ་མ་ཡིན་པ་དང་། 
 ātmasukhārthiko bhavati na sattvaduḥkhā panayanārthikāḥ parṣadguṇārthiko bhavati	བདག་བདེ་བ་དོན་དུ་གཉེར་གྱི་སེམས་ཅན་གྱི་སྡུག་བསྔལ་བསལ་བ་དོན་དུ་གཉེར་བ་མ་ཡིན་པ་དང་། འཁོར་གྱི་ཚོགས་དོན་དུ་གཉེར་གྱི་དབེན་པ་དོན་དུ་གཉེར་བ་མ་ཡིན་ཏེ་། འོད་སྲུང་།
 na vivekārthikaḥ ime kāśyapa catvāro bodhisattvapratirūpakāḥ tatredamucyate || 14 ||	བཞི་པོ་དེ་དག་ནི་བྱང་ཆུབ་སེམས་དཔའ་ལྟར་བཅོས་པའོ་༎ དེ་ལ་འདི་སྐད་ཅེས་བྱ་སྟེ་།
 lābhārthiko bhavati na dharmakāmo kīrtyarthiko nneva guṇaibhirarthikaḥ	རྙེད་པ་དོན་དུ་གཉེར་གྱི་ཆོས་དོན་མིན་༎ བརྗོད་པ་དོན་གཉེར་ཡོན་ཏན་དོན་གཉེར་མིན་༎ བདག་བདེ་རྟག་ཏུ་དོན་དུ་གཉེར་བྱེད་ཅིང་༎
 na sattvaduḥkhāpanayena cārthiko yo cātmano nitya sukh|||||rthikaḥ	སེམས་ཅན་སྡུག་བསྔལ་བསལ་བ་དོན་མི་གཉེར་༎
 parṣadguṇārthī na vivekakāmo sukhe prasakto na guṇeṣu sakto |	འཁོར་ཚོགས་དོན་དུ་གཉེར་གྱི་དབེན་མི་འདོད་༎ བདེ་ལ་ཆགས་ཀྱི་ཡོན་ཏན་མ་ཆགས་པ་༎
 catvāra ete pratirūpakoktāḥ bodhisattvān parivarjanīyā 2 ||	བཞི་པོ་དེ་དག་བཅོས་པར་གསུངས་པ་སྟེ་༎ དེ་དག་བྱང་ཆུབ་སེམས་དཔས་ཡོངས་སུ་སྤང་༎
 kp|16 catvāra ime kāśyapa bodhisattvasya bhūtā bodhisattvaguṇā |	འོད་སྲུང༏་བཞི་པོ་འདི་དག་ནི་བྱང་ཆུབ་སེམས་དཔའ་རྣམས་ཀྱི་བྱང་ཆུབ་སེམས་དཔའི་ཡང་དག་པའི་ཡོན་ཏན་ཏེ་། 
 katame catvāra śunyatāṃ cādhimucyate | karmavipākaṃ cābhiśraddadhāti |	བཞི་གང་ཞེ་ན་།
 nairātmyaṃ cāsya kṣamate sarvasattveṣu mahākaruṇ| nirvāṇagataścāsyāśayaḥ saṃsāragataśca prayogaḥ sattvaparipākāya ca dānaṃ vipākāpratikāṅkṣanatā ca |	འདི་ལྟ་སྟེ་། སྟོང་པ་ཉིད་ལ་ཡང་མོས་ལ་ལས་ཀྱི་རྣམ་པར་སྨིན་པ་ལ་ཡང་ཡིད་ཆེས་པ་དང་། དེ་བདག་མེད་པར་ཡང་བཟོད་ལ་སེམས་ཅན་ཐམས་ཅད་ལ་ཡང་སྙིང་རྗེ་ཆེ་བ་དང་། དེའི་བསམ་པ་མྱ་ངན་ལས་འདས་པ་༄༢༡༩བ་ལ་ཡང་གནས་ལ་སྦྱོར་བ་འཁོར་བ་ན་ཡང་གནས་པ་དང་། དེ་སེམས་ཅན་ཡོངས་སུ་སྨིན་པར་བྱ་བའི་ཕྱིར་སྦྱིན་པའི་རྣམ་པར་སྨིན་པ་ལ་ཡང་མི་རེ་བ་སྟེ་།
 ime kāśyapa catvāro dharmā bodhisattvasya bhūtā bodhisattvaguṇā tatredamucyate || 15 ||	འོད་སྲུང་། བཞི་པོ་དེ་དག་ནི་བྱང་ཆུབ་སེམས་དཔའ་རྣམས་ཀྱི་བྱང་ཆུབ་སེམས་དཔའི་ཡང་དག་པའི་ཡོན་ཏན་ནོ་༎ དེ་ལ་འདི་སྐད་ཅེས་བྱ་སྟེ་། ཆོས་རྣམས་སྟོང་པ་ཉིད་དུ་རྟག་མོས་ཀྱང་༎
 śunyāśca dharmān adhimucyate sadā vipāka pattīyati karmaṇaṃ ca |	ལས་ཀྱི་རྣམ་པར་སྨིན་པའང་ཡིད་ཆེས་སོ་༎
 nairātmakṣāntyā samatāpratiṣṭhito karuṇāṃ ca sattveṣu janeti nityaṃ |	བདག་མེད་བཟོད་པས་མཉམ་པ་ཉིད་གནས་ཀྱང་༎ སེམས་ཅན་རྣམས་ལ་སྙིང་རྗེ་ཆེན་པོ་བསྐྱེད་༎
 nirvāṇi bhāvo sata tasya bhoti prayoga saṃsāragataśca tasya |	དེ་བསམ་རྟག་ཏུ་མྱ་ངན་འདས་ལ་གནས་༎ དེ་ཡི་སྦྱོར་བ་འཁོར་བར་གནས་པ་ཡིན་༎
 paripācanārthaṃ ca dadāti dānaṃ vipāka nākāṅkṣati karmaṇāṃ ca 2 ||	ཡོངས་སྨིན་བྱ་ཕྱིར་སྦྱིན་པ་སྦྱིན་བྱེད་ཀྱང་༎ ལས་ཀྱི་རྣམ་པར་སྨིན་ལ་རེ་བ་མེད་༎
 kp|17 catvāra ime kāśyapa bodhisattvasya mahānidānapratilambhāḥ katame|||||||||||	འོད་སྲུང་། བཞི་པོ་འདི་དག་ནི་བྱང་ཆུབ་སེམས་དཔའི་གཏེར་ཆེན་པོ་རྙེད་པ་སྟེ་། བཞི་གང་ཞེ་ན་། འདི་ལྟ་སྟེ་།
 buddhotpādārāgaṇatā | ṣaṭpāramitāśravaṇaḥ apratihatacittasya dharmabhāṇakadarśanaṃ |	སངས་རྒྱས་འབྱུང་བ་མཉེས་པར་བྱེད་པ་དང་། ཕ་རོལ་ཏུ་ཕྱིན་པ་དྲུག་ཉན་པ་དང་། ཆོས་སྨྲ་བ་ལ་ཁོང་ཁྲོ་བ་མེད་པའི་སེམས་ཀྱིས་ལྟ་བ་དང་། བག་ཡོད་པར་དགོན་པ་ལ་གནས་པར་མངོན་པར་དགའ་བ་སྟེ་།
 apramattasyāraṇyavāsābhirataḥ ime kāśyapa catvāro bodhisattvasya mahānidhānapratilambhā |	འོད་སྲུང་། བཞི་པོ་དེ་དག་ནི་བྱང་ཆུབ་སེམས་དཔའི་གཏེར་ཆེན་པོ་རྙེད་པའོ་༎
 tatredamucyate | || 16 ||	དེ་ལ་འདི་སྐད་ཅེས་བྱ་སྟེ་། ཚེ་རབས་ཀུན་ཏུ་སངས་རྒྱས་མཉེས་པར་བྱེད་༎
 buddhānam ārāgaṇa sarvajātiṣu śravaśca ṣaṇṇāmapi pāramīṇām |	ཕ་རོལ་ཕྱིན་པ་དྲུག་པོ་རྣམས་ཀྱང་ཉན་༎
 prasannacitto 'pi ca dharmabhāṇakāṃ sampaśyate gaurava jātu nityam |	ཆོས་སྨྲ་བ་ལ་སེམས་ནི་༄༢༢༠ཨ་༌༎ རབ་ཏུ་དང་༎ མཐོང་ན་རྟག་ཏུ་གུས་པ་སྐྱེད་པར་བྱེད་༎ རྟག་ཏུ་བག་ཡོད་གྱུར་ནས་དགོན་པར་གནས་༎
 sadāpramattasya cāraṇyavāso tatreva so bhoti ratiḥ sadāsya |	དེ་ནི་དེ་ཉིད་ལ་ཡང་རྟག་ཏུ་དགའ༎
 catvāra dharmā sugatena proktā mahānidhānāni jinātmajānām | 2 ||	བཞི་པོ་འདི་དག་རྒྱལ་བའི་སྲས་རྣམས་ཀྱི་༎ གཏེར་ཆེན་ཡིན་པར་བདེ་བར་གཤེགས་པས་གསུངས་༎ འོད་སྲུང་།
 kp|18 catvāra ime kāśyapa bodhisattvamārapathasamatikramaṇā dharmāḥ katame catvāraḥ bodhicittasyānutsargaḥ sarvasattveṣvapratihatacittatā | sarvadṛṣṭīkṛtānām avabodhanā |	བཞི་པོ་འདི་དག་ནི་བྱང་ཆུབ་སེམས་དཔའ་བདུད་ཀྱི་ལམ་ལས་ཡང་དག་པར་འདའ་བའི་ཆོས་ཏེ་། བཞི་གང་ཞེ་ན་། འདི་ལྟ་སྟེ་། བྱང་ཆུབ་ཀྱི་སེམས་མི་གཏོང་བ་དང་། སེམས་ཅན་ཐམས་ཅད་ལ་ཁོང་ཁྲོ་བའི་སེམས་མེད་པ་དང་། ལྟ་བར་གྱུར་པ་ཐམས་ཅད་རྟོག་པ་དང་། སེམས་ཅན་ཐམས་ཅད་ལ་མི་བརྙས་པ་སྟེ་། འོད་སྲུང་།
 anatimanyanā sarvasattveṣu ime kāśyapa catvāro bodhisattvasya mārapathasamatikramaṇā dharmā | tatredamucyate || 17 ||	བཞི་པོ་འདི་དག་ནི་བྱང་ཆུབ་སེམས་དཔའ་བདུད་ཀྱི་ལམ་ལས་ཡང་དག་པར་འདའ་བའི་ཆོས་སོ་༎ དེ་ལ་འདི་སྐད་ཅེས་བྱ་སྟེ་།
 bodhāya cittaṃ na parityajanti sattveṣu ca pratigha jahanti nityam |	བྱང་ཆུབ་སེམས་ནི་ཡོངས་སུ་གཏོང་མི་བྱེད་༎ སེམས་ཅན་རྣམས་ལ་ཁོང་ཁྲོ་རྟག་ཏུ་སྤོང་༎ ལྟ་བར་གྱུར་པ་ཐམས་ཅད་འདོར་བར་བྱེད་༎
 sarvāśca dṛṣṭigatanutsṛjaṃ||| na cādhimanyanti ha sattvakāyam	སེམས་ཅན་ཚོགས་ལ་བརྙས་པ་ཡོངས་མི་བྱེད་༎
 catvāra ete sugatena proktā dharmā hi mārasya atikramāya	བདེ་བར་གཤེགས་པས་བཞི་པོ་འདི་དག་ནི་༎ བདུད་ལས་འདའ་བར་འགྱུར་བའི་ཆོས་སུ་གསུངས་༎ འདི་དག་བསྟེན་ན་རྒྱལ་བ་རྣམ་འདྲེན་པ་༎
 ||||||| niṣevitva jinā bhavanti aṅgīrasā apratimā vināyakā 2 ||	གསེར་འདྲའི་སྐུ་མངའ་མཚུངས་པ་མེད་པར་འགྱུར་༎
 kp|19 catvāra ime kāśyapa dharmā bodhisattvasya sarvakuśa ladharmasaṅgrahāya saṃvartante |	འོད་སྲུང་། ཆོས་བཞི་པོ་འདི་དག་༄༢༢༠བ་ནི་བྱང་ཆུབ་སེམས་དཔའི་དགེ་བའི་རྩ་བའི་ཆོས་ཐམས་ཅད་སྡུད་པར་འགྱུར་བ་སྟེ་། བཞི་གང་ཞེ་ན་། འདི་ལྟ་སྟེ་།
 katame catvāraḥ niṣkuhakasyāraṇyavāsābhiratiḥ pratikārāprātikāṅkṣiṇaśc|||||||||| saṅgrahavastūni sarvasattveṣu kāyajīvitotsargaḥ saddharmaparyeṣṭim ārabhyātṛptitā sarvakuśalamūlasamudānanāya |	ཚུལ་འཆོས་པ་མེད་པར་དགོན་པར་གནས་པ་དང་། ལན་དུ་ཕན་འདོགས་པར་རེ་བ་མེད་པའི་བསྡུ་བའི་དངོས་པོ་བཞི་པོ་དང་། སེམས་ཅན་ཐམས་ཅད་ལ་ལུས་དང་སྲོག་གཏོང་ཞིང་དམ་པའི་ཆོས་ཡོངས་སུ་ཚོལ་བ་དང་། ཐོས་པ་དང་དོན་གྱིས་ངོམས་མི་མྱོང་ཞིང་དགེ་བའི་རྩ་བ་ཐམས་ཅད་ཡང་དག་པར་སྡུད་པའི་བརྩོན་འགྲུས་ཏེ་། 
 ime kāśyapa catvāro dharmā bodhisattvasya sarvakuśaladharmasaṅgrahāya saṃvartante tatredamucyate || 18 ||	འོད་སྲུང་། ཆོས་བཞི་པོ་དེ་དག་ནི་བྱང་ཆུབ་སེམས་དཔའི་དགེ་བའི་རྩ་བའི་ཆོས་ཐམས་ཅད་སྡུད་པར་འགྱུར་རོ་༎ དེ་ལ་འདི་སྐད་ཅེས་བྱ་སྟེ་། དགོན་པར་གནས་ཤིང་ཚུལ་འཆོས་རྣམ་པར་སྤོང་༎
 araṇyavāse kuhanāvivarjito sattveṣu ca saṅgraha yo jinoktā |	རྒྱལ་གསུངས་བསྡུ་བ་སེམས་ཅན་རྣམས་ལ་བྱེད་༎ དམ་ཆོས་ཡོངས་སུ་བཙལ་བ་བརྩམ་བྱས་ནས་༎
 utsarga kāyasya ca jīvitasya saddharmaparyeṣṭi samārabhi|||||||||||||	ལུས་དང་སྲོག་ཀྱང་ཡོངས་སུ་གཏོང་བར་བྱེད་༎
 samudānanāyāśca sadā atṛpto kuśalāna mūlāna analpakānāṃ |	དགེ་བའི་རྩ་བ་ཤིན་ཏུ་མི་ཉུང་བ་༎ ཡང་དག་བསྒྲུབ་ཕྱིར་རྟག་ཏུ་ངོམས་མི་མྱོང་༎
 kuśalāna dharmāṇa ca saṅgrahārthe catvāro dharmā sugatena proktā 2 ||	དགེ་བའི་ཆོས་རྣམས་ཡང་དག་བསྡུ་བའི་ཕྱིར་༎ ཆོས་བཞི་འདི་དག་བདེ་བར་གཤེགས་པས་གསུངས་༎
 kp|20 catvāra ime kāśyapa bodhisattvasyāprameyā puṇyasambhārāḥ katame catvāraḥ nirāmiṣacittasyā	འོད་སྲུང་། ཆོས་བཞི་པོ་འདི་དག་ནི་བྱང་ཆུབ་སེམས་དཔའི་བསོད་ནམས་ཀྱི་ཚོགས་དཔག་ཏུ་མེད་པའོ་༎ བཞི་གང་ཞེ་ན་།
 dharmadānaṃ duḥśīleṣu ca sattveṣu mahākaruṇā sarvasattveṣu bodhicittārocanatā durbaleṣu sattveṣu kṣāntyā sevanatā |	འདི་ལྟ་སྟེ་། ཟང་ཟིང་མེད་པའི་སེམས་ཀྱིས་ཆོས་སྤྱིན་པ་དང་། ཚུལ་ཁྲིམས་འཆལ་པ་རྣམས་ལ་ཆེར་སྙིང་རྗེ་བ་དང་། སེམས་༄༢༢༡ཨ་༌༎ ཅན་ཐམས་ཅད་ལ་བྱང་ཆུབ་ཀྱི་སེམས་སྟོན་པ་དང་། ཉམ་ཆུང་བ་རྣམས་ལ་བཟོད་པ་བསྟན་པ་སྟེ་།
 ime kāśyapa catvāro bodhisattvasyāprameyā puṇyasambhārāḥ tatredamucyate || 19 ||	འོད་སྲུང་། བཞི་པོ་དེ་དག་ནི་བྱང་ཆུབ་སེམས་དཔའི་བསོད་ནམས་ཀྱི་ཚོགས་དཔག་ཏུ་མེད་པའོ་༎ དེ་ལ་འདི་སྐད་ཅེས་བྱ་སྟེ་། དག་ཅིང་ཟང་ཟིང་མེད་པའི་སེམས་ཀྱིས་སུ་༎
 dānaṃ ca dharmasya jinapraśastaṃ cittena śuddhenā nirāmiṣeṇa	ཆོས་ཀྱི་སྦྱིན་བྱེད་རྒྱལ་བས་རབ་ཏུ་བསྔགས་༎
 apetaśīle karuṇā ca tīvrā	ཚུལ་ཁྲིམས་མི་ལྡན་པ་ལ་སྙིང་རྗེ་ཆེ་༎
 pareṣu bodhāya janeti cittam |	གཞན་དག་བྱང་ཆུབ་ཕྱིར་ནི་སེམས་བསྐྱེད་འཇུག་།
 kṣāntyādhiseveti ca durbaleṣu	ཉམ་ཆུང་རྣམས་ལ་བཟོད་པས་དང་དུ་ལེན་༎
 dharmeṣva|||||| saṅgrahatā||||||coktā |	འདི་ནི་དགེ་ཆོས་སྡུད་པར་གསུངས་པ་སྟེ་༎ འདི་དག་བསྟེན་ན་རྒྱལ་བར་འགྱུར་བས་ན་༎
 etā niṣevitvā jinā bhavanti te bodhisattve sadā sevitavyāḥ	བྱང་ཆུབ་སེམས་དཔས་དེ་དག་རྟག་ཏུ་བསྟེན་༎ འོད་སྲུང་། ཆོས་བཞི་པོ་འདི་དག་ནི་བྱང་ཆུབ་སེམས་དཔའི་མ་རིག་པའི་བག་ཆགས་ཀྱི་སའི་ཉོན་མོངས་པ་འཇོམས་པར་འགྱུར་བ་སྟེ་། བཞི་གང་ཞེ་ན་། འདི་ལྟ་སྟེ་། ཚུལ་ཁྲིམས་ཀྱི་སྡོམ་པ་ཡང་དག་པར་འཛིན་པ་དང་། དམ་པའི་ཆོས་ཡོངས་སུ་འཛིན་པ་དང་། སྒྲོན་མ་སྦྱིན་པ་དང་། ཐ་ན་འདྲིས་པ་རྣམས་ལ་ཡང་སྦྱིན་པ་སྟེ་། འོད་སྲུང་། ཆོས་བཞི་པོ་དེ་དག་ནི་བྱང་ཆུབ་སེམས་དཔའི་མ་རིག་པའི་བག་ཆགས་ཀྱི་སའི་ཉོན་མོངས་པ་འཇོམས་པར་བྱེད་པའོ་༎ དེ་ལ་འདི་སྐད་ཅེས་བྱ་སྟེ་། ཚུལ་ཁྲིམས་སྡོམ་པ་ཡང་དག་འཛིན་༄༢༢༡བ་བྱེད་དང་༎ དམ་ཆོས་འཛིན་དང་སྒྲོན་མ་སྦྱིན་བྱེད་དང་༎ དེ་བཞིན་ཐ་ན་འདྲིས་ལ་སྦྱིན་བྱེད་ཅིང་༎ མཁས་པ་མ་རིག་ས་ལས་རྣམ་པར་འབྱེད་༎ འོད་སྲུང་། ཆོས་བཞི་པོ་འདི་དག་ནི་བྱང་ཆུབ་སེམས་དཔའི་སྒྲིབ་པ་མེད་པའི་ཡེ་ཤེས་ཐོབ་པར་འགྱུར་བ་སྟེ་། བཞི་གང་ཞེ་ན་། འདི་ལྟ་སྟེ་། དམ་པའི་ཆོས་སྦྱིན་པ་དང་། དམ་པའི་ཆོས་ཡོངས་སུ་འཛིན་པ་དང་། ཕྲག་དོག་མེད་པ་དང༏་གཞན་དག་ལ་མི་བརྙས་པ་སྟེ་། འོད་སྲུང་། ཆོས་བཞི་པོ་འདི་དག་ནི་བྱང་ཆུབ་སེམས་དཔའི་སྒྲིབ་པ་མེད་པའི་ཡེ་ཤེས་ཐོབ་པར་འགྱུར་པའོ་༎ དེ་ལ་འདི་སྐད་ཅེས་བྱ་སྟེ་།
 catuṣkakā aṣṭa jahi|||||||| kā | bodhāya ye āvaraṇaṃ karonti |	གང་དག་བྱང་ཆུབ་ལ་ནི་སྒྲིབ་བྱེད་པ་༎ སྡིག་པའི་བཞི་པ་བཅུ་པོ་རྣམ་སྤངས་ནས་༎ མཁས་པས་དེ་བཞིན་བཅུ་གཉིས་གཞན་བསྟེན་ན་༎
 tathāparā dvādaśa sevya paṇḍitā prāpnoti bodhim amṛtaṃ spṛśitv||||||||||||||| ye cāgrasattvā ima dhramanetrī	འཆི་མེད་རེག་ནས་བྱང་ཆུབ་ཐོབ་པར་འགྱུར་༎ སེམས་ཅན་དམ་པ་གང་དག་ཆོས་ཚུལ་འདི་༎
 dhārayanti vācayanti prakāśayanti |	འཛིན་ཏམ་ཀློག་གམ་རབ་ཏུ་སྟོན་བྱེད་པ་༎
 teṣāṃ jino puṇyam anantu bhāṣate ye|||||| m apramāṇaṃ jina varṇayanti 4	དེ་དག་བསོད་ནམས་མཐའ་ཡས་རྒྱལ་བས་གསུང་༎ དེ་ཡི་ཚད་ནི་རྒྱལ་བ་རྣམས་བརྗོད་དོ་༎
 ye kṣetrakoṭyo yatha gaṅgāvālukā ratnāna pūritvana teṣu dadyāt	གང་གིས་ཞིང་ནི་གངགའའི་བྱེ་མ་སྙེད་༎ རིན་ཆེན་བཀང་སྟེ་རྒྱལ་ལ་ཕུལ་བ་བས་༎
 yo vā ito gātha catuṣpadī paṭhed	གང་གིས་འདི་ལས་ཚིག་བཞིའི་ཚིག་བཅད་ཀློག་།
 imasya puṇyasya na eti saṅkhyā | 5 || kp|21 catvāra ime kāśyapa dharmā bodhisattvasya avidyābhāgīyākleśasamati kramāya saṃvartante | katame catvāraḥ śīlasaṃvaraḥ saddharmaparigrahaḥ pradīpadānam antamaśaḥ saṃstutebhyaḥ ime kāśyapa catvāro dharmā bodhisattvasya avidyābhāgīyākleśasamatikramāya saṃvartante || kp|22 catvāra ime kāśyapa dharmā bodhisattvasya anāvaraṇajñānatāye saṃvartante | katame catvāraḥ yaduta indriyasaṃvaraḥ gambhīrārthavivaraṇatā svalābhenāvamanyanā | paralābhesvanadhya|||||||||| natā | ime kāśyapa catvāro dharmā bodhisattvasyānāvaraṇajñānatāye saṃvartante | || 22 ||	བསོད་ནམས་འདི་ཡི་གྲངས་སུའང་མི་ཕོད་དོ་༎
 kp|23 na khalu kāśyapa nāmamātreṇa bodhisatvo mahāsattva ityucyate dharmacaryayā	འོད་སྲུང་། བྱང་ཆུབ་སེམས་དཔའི་ནི་མིང་ཙམ་གྱིས་བྱང་ཆུབ་སེམས་དཔའ་ཞེས་མི་བྱའོ་༎
 samacaryayā kuśalacaryayā dharm|||||| ritābhiḥ kāśyapa samanvāgato bodhisattvo mahāsattva ityucyate |	འོད་སྲུང་། བྱང་ཆུབ་སེམས་དཔའ་ཆོས་སྤྱོད་པ་དང་། སྙོམས་པར་སྤྱོད་པ་དང་། དགེ་བ་སྤྱོད་པ་དང་། ཆོས་ལ་གནས་པ་དང་ལྡན་པ་ལ་༄༢༢༢ཨ་༌༎ བྱང་ཆུབ་སེམས་དཔའ་ཞེས་བྱའོ་༎
 dvātriṃśadbhi kāśyapa dharmaiḥ samanvāgato bodhisattvo ityucyate |	འོད་སྲུང་། གཞན་ཡང་བྱང་ཆུབ་སེམས་དཔའ་ཆོས་སུམ་ཅུ་རྩ་གཉིས་དང་ལྡན་ན་བྱང་ཆུབ་སེམས་དཔའ་ཞེས་བྱ་སྟེ་། 
 katame dvātriṃśadbhiḥ yaduta hitasukhādhyāśayatayā sarvasattveṣu | sarvajñajñānāvatāraṇatayā kim ahammargāmīti pareṣāṃ jñānākunsanatā niradhimānatayā | dṛḍhādhyāśayatayā | akṛtrimaprematayā | atyantamitratā | mitrāmitreṣu samacittatayā | yāvannirvāṇaparyantatāye | kp|24 anṛtavākyatā smitamukhapūrvābhibhāṣaṇatā nupādatteṣu bhāreṣv | v| ṣ| d|	སུམ་ཅུ་རྩ་གཉིས་གང་ཞེ་ན་། འདི་ལྟ་སྟེ་།
 n||||||||||| sarvasattveṣvaparicinnamahākaruṇatā aparikhinnamānasatayā saddharmaparyeṣṭim ārabhyātṛ||||||| śrutārthatayā | ātmaskhaliteṣu doṣadarśanātayā | paraskhalitesvaruṣṭāpatticodanatayā |	སེམས་ཅན་ཐམས་ཅད་ལ་ཕན་པ་དང་། བདེ་བར་བྱ་བའི་ལྷག་པའི་བསམ་པ་དང་། ཐམས་ཅད་མཁྱེན་པའི་ཡེ་ཤེས་ལ་འཛུད་པ་དང་། བདག་ཅི་རི་ཞེས་ཡོངས་སུ་མཇལ་ཞིང་གཞན་གྱི་ཤེས་པ་ལ་མི་སྨོད་པ་དང་། ང་རྒྱལ་མེད་པ་དང་། ལྷག་པའི་བསམ་པ་བརྟན་པ་དང་། བཅོས་མ་མ་ཡིན་པར་བྱམས་པ་དང་། མཛའ་བ་དང་མི་མཛའ་པ་ལ་སེམས་སྙོམས་པ་དང་། མྱ་ངན་ལས་འདས་པའི་མཐའི་བར་དུ་གཏན་དུ་མཛའ་བ་དང་། ཚིག་རན་ཅིང་འཛུམ་པའི་བཞིན་གྱིས་གསོང་པོར་སྨྲ་བ་དང་། ཁུར་བླངས་པ་རྣམས་ལ་སྒྱིད་ལུག་པ་མེད་པ་དང་། སེམས་ཅན་ཐམས་ཅད་ལ་སྙིང་རྗེ་ཆེན་པོ་ཡོངས་སུ་མ་བཅད་པ་དང་། ཡིད་ཡོངས་སུ་མི་སྐྱོ་བ་དང་། དམ་པའི་ཆོས་ཡོངས་སུ་ཚོལ་བའི་ཕྱིར་ཐོས་པ་དང་དོན་གྱིས་ངོམས་མི་མྱོང་བ་དང་། བདག་གི་འཁྲུལ་པ་རྣམས་ལ་སྐྱོན་དུ་ལྟ་ཞིང་གཞན་གྱི་འཁྲུལ་པ་རྣམས་ལ་མི་གཤེ་བར་བསྒོ་བ་དང་། 
 sarvairyapatheṣu bodhicittaparikarmatayā | vipākāpratikāṅkṣiṇa tyāgaḥ sarvabhavagatyupapa|||||||| niḥśritaṃ śīlam | sarvasattveṣvapratihata kṣāntiḥ kp|25 sarvakuśalamūlasamādānanāya vīryaṃ | ārūpya|||||||| parikarṣitaṃ dhyānām | upāyasaṅgṛhītā prajñā | catuḥsaṅgrahavastusamprayuktā upāya | śīlavaddūḥśī |||||||||||| yatayā maitratā | satkṛtya dharmaśravaṇaṃ | satkṛtyāraṇyavāsaḥ sarvalokavicitrikeṣvanabhiratiḥ|||||| dṛṣṭivigataṃ |	སྤྱོད་ལམ་ཐམས་ཅད་དུ་བྱང་ཆུབ་ཀྱི་སེམས་ཡོངས་སུ་སྤྱོད་པ་དང་། རྣམ་པར་སྨིན་པ་ལ་མི་རེ་བའི་གཏོང་བ་དང་། སྲིད་པའི་འགྲོ་བར་སྐྱེ་བ་ཐམས་ཅད་ལ་མི་གནས་པའི་ཚུལ་ཁྲིམས་དང་། སེམས་ཅན་ཐམས་ཅད་ལ་ཞེ་འགྲས་༄༢༢༢བ་པ་མེད་པའི་བཟོད་པ་དང་། དགེ་བའི་རྩ་བ་ཐམས་ཅད་ཡང་དག་པར་སྒྲུབ་པའི་བརྩོན་འགྲུས་དང་། གཟུགས་མེད་པའི་ཁམས་རྣམ་པར་བསལ་བའི་བསམ་གཏན་དང་། ཐབས་མཁས་པ་བསྡུ་བའི་དངོས་པོ་བཞི་དང་རབ་ཏུ་ལྡན་པའི་ཐབས་ཀྱིས་ཟིན་པའི་ཤེས་པ་དང་། ཚུལ་ཁྲིམས་དང་ལྡན་པ་དང་། ཚུལ་ཁྲིམས་འཆལ་པ་རྣམས་ལ་གཉིས་སུ་མེད་པའི་བྱམས་པ་དང་། གུས་པར་བྱས་ཏེ་ཆོས་ཉན་པ་དང་། གུས་པར་བྱས་ཏེ་དགོན་པ་ལ་གནས་པར་མངོན་པར་དགའ་བ་དང་། འཇིག་རྟེན་གྱི་སྣ་ཚོགས་རྣམས་ལ་མི་དགའ་ཞིང་འཇིག་རྟེན་ལས་འདས་པའི་ཆོས་རྣམས་ལ་མངོན་པར་དགའ་བ་དང་། 
 hīnayānaspṛhaṇatā | mahāyāne cānuśaṃsasandarśitayā |	ཐེག་པ་དམན་པ་མི་འདོད་ཅིང་ཐེག་པ་ཆེན་པོ་ལ་ཕན་ཡོན་དུ་ལྟ་དགའ་བ་དང་། བ་དང་། 
 pāpamitravivarjanat||||||||||| kalyāṇamitrasevanatā |	སྡིག་པའི་གྲོགས་པོ་ཡོངས་སུ་སྤོང་ཞིང་དགེ་བའི་བཤེས་གཉེན་ལ་དགའ་བ་དང་། བ་དང་། 
 catubrahmavihāraniṣpādanatā |	བསྟེན་པ་དང་། 
 pañcābhijñavikrīḍanatā | jñānapratisaraṇatā | pratipattivipratipattisthitānā sattvānām anutsargaḥ ekāñcavacanatā | satyagurukatā | ||||||||||||||||||||| kuśalamūlasamudānatayā atṛptatā | bodhicittapūrvaṅgamatā	ཚངས་པའི་གནས་པ་བཞི་སྒྲུབ་པ་དང་། མངོན་པར་ཤེས་པ་ལྔས་རྣམ་པར་རྩེན་པ་དང་། ཡེ་ཤེས་ལ་རྟོན་པ་དང་། སྒྲུབ་པ་དང་ལོག་པར་སྒྲུབ་པ་ལ་གནས་པའི་སེམས་ཅན་རྣམས་མི་གཏོང་བ་དང༏་གཅིག་ཏུ་ཆད་པར་སྨྲ་བ་དང་། བདེན་པ་གཅེས་སུ་བྱེད་པ་དང་། བྱང་ཆུབ་ཀྱི་སེམས་སྔོན་དུ་འགྲོ་བ་སྟེ་།
 kp|26 ebhiḥ kāśyapa dvāstriṃśadbhirdharmaiḥ samanvāgato bodhisattvo mahāsattva ityucyate ||	འོད་སྲུང་། བྱང་ཆུབ་སེམས་དཔའ་ཆོས་སུམ་ཅུ་རྩ་གཉིས་པོ་དེ་དག་དང་ལྡན་ན་བྱང་ཆུབ་སེམས་དཔའ་ཞེས་བྱའོ་༎ 
 tatredamucyate | ||	དེ་ལ་འདི་སྐད་ཅེས་བྱ་སྟེ་།
 sarveṣu satveṣu hitaṃ sukham ca adhyāśayenāpyadhimucyamānāḥ	སེམས་ཅན་ཀུན་ལ་ཕན་དང་བདེ་བྱ་བའི་༎ ལྷག་པའི་བསམ་ལ་མོས་བར་བྱེད་པ་ཡིན་༎
 sarvajñajñānottaraṇāya kiṃ nu arghāmi nārghāmyahaṃ jñānamānā |	ཀུན་མཁྱེན་ཡེ་ཤེས་ལ་ནི་སེམས་༄༢༢༣ཨ་༌༎ སྒྲོལ་ཞིང་༎ རི་འམ་མི་རི་སྙམ་དུ་བདག་ལ་དཔོག་། སྨོད་པ་མེད་ཅིང་ལྷག་པའི་ང་རྒྱལ་མེད་༎
 akutsan| yānadhimānatāyā dṛḍhāśayākṛtrimaprematāyāḥ	བསམ་པ་བརྟན་ཞིང་བཅོས་པ་མེད་པར་བྱམས་༎ མཛའ་དང་མི་མཛའ་རྣམས་ལ་སེམས་ཀྱང་སྙོམས་༎ མྱ་ངན་འདས་པའི་མཐའ་ལ་ཐུག་བར་དུ་༎
 sattveṣu cātyantasumitratāyā yāvanna nirvāṇaparāyaṇatvaṃ 2 mitre amitre samacittatāyā smitomukhatvam anṛtā ca vāṇī |	སེམས་ཅན་རྣམས་ལ་གཏན་དུ་རབ་ཏུ་མཛའ༎ འཛུམ་པའི་བཞིན་གྱིས་འཇམ་པོར་སྨྲ་བར་བྱེད་༎
 upātabhāre|||||||||||||| dāryaṇatvaṃ karuṇāparicchinna tatheva sattve 3	ཁུར་བླངས་པ་ལ་སྒྱིད་ལུག་ཞུམ་པ་མེད་༎ སེམས་ཅན་དག་ལ་སྙིང་རྗེ་ཡོངས་མ་བཅད་༎
 kp|27 saddharmaparyeṣṭiya nāsti khedaḥ śruteṣvatṛpte skhalitetmadoṣ|||||||| |||||||| raśca ruṣṭena na codanīyaḥ	དམ་ཆོས་ཡོངས་སུ་ཚོལ་བ་སྐྱོ་བ་མེད་༎ ཐོས་པས་མི་ངོམས་བདག་གི་འཁྲུལ་སྐྱོན་ལྟ༏་༏གཞན་ལ་གཤེ་བས་གདུང་བར་བྱེད་པ་མེད་༎
 īryāpathe cittasukarmatāyā 4	སྤྱོད་ལམ་རྣམས་སུ་སེམས་ནི་རབ་ཏུ་སྦྱོང་༎
 tyāgo vipākāpratikāṅkṣaṇaṃ ca	གཏོང་བ་རྣམ་པར་སྨིན་ལ་རེ་བ་མེད་༎
 ana|||||||||||| taṃ śīladbhavaṃ gatīṣu sattveṣu kṣānti pratighātavarjitā samudānanāyā kuśalasya vīrya 5 ārūpyadhā|||||||| vakṛṣṭaṃ ca dhyānaṃ upāyato saṅgṛhītā ca prajñāḥ catuḥsaṅgraheḥ saṅgrahītopāyo	ཚུལ་ཁྲིམས་སྲིད་པའི་འགྲོ་བར་གནས་མ་ཡིན༏་༏སེམས་ཅན་རྣམས་ལ་བཟོད་ཅིང་ཁོང་ཁྲོ་སྤངས་༎
 duḥśīlaśīle dvayā|||||||||| ca maitryā 6 satkṛtya dharmaśravaṇaṃ ca kāle satkṛtya vāso ca araṇyaśānte | lokeṣu citreṣu ratirna kāryam hīneṣu yāneṣu ratirna kāryam 7	དགེ་བ་ཡང་དག་སྒྲུབ་པའི་བརྩོན་འགྲུས་དང་༎ གཟུགས་མེད་ཁམས་སྤངས་པ་ཡི་བསམ་གཏན་དང་༎ ཐབས་ཀྱིས་ཡང་དག་ཟིན་པའི་ཤེས་རབ་དང་༎ བསྡུ་བ་རྣམ་བཞིས་ཡང་དག་ཟིན་ཐབས་དང་༎ ཁྲིམས་ལྡན་ཁྲིམས་མེད་གཉིས་མེད་བྱམས་པ་དང་༎ གུས་པར་བྱས་ཏེ་དུས་སུ་ཆོས་ཉན་དང་༎ གུས་པར་བྱས་ཏེ་དགོན་ཞི་གནས་པ་དང་༎ འཇིག་རྟེན་སྣ་ཚོགས་དགའ་བར་མི་བྱེད་དང་༎ ཐེག་པ་དམན་ལ་དགའ་བར་མི་བྱེད་ཅིང་༎
 udārayāneṣu spṛhā janeyā pāpāṇi mitrāṇi vivarjayeyā |	ཐེག་པ་ཆེ་ལ་འདོད་པ་སྐྱེད་པ་དང་༎ སྡིག་པའི་གྲོགས་༄༢༢༣བ་པོ་རྣམ་པར་སྤོང་བྱེད་ཅིང་༎
 kalyāṇamitrāṇi sadā ca seveś catvāra brahāśca vihāra bhāvayet | 8 kp|28 krīḍetābhījñehi ca pañcabhiḥ sadā jñānānusāri ca bhāaveta|||||||| na utsṛjeyā pratipattiyuktā na ca dvitīyāpi kadācid anyāḥ 9	དགེ་བའི་བཤེས་གཉེན་རྟག་ཏུ་བསྟེན་པ་དང་༎ ཚངས་པའི་གནས་པ་བཞི་ལ་བསྒོམས་པ་དང་༎ མངོན་ཤེས་རྣམ་ལྔས་རྟག་ཏུ་བརྩོན་པ་དང་༎ ཡེ་ཤེས་རྗེས་སུ་རྟག་ཏུ་འབྱུང་བ་དང་༎ སྒྲུབ་དང་ལྡན་པ་གཏོང་བར་མི་བྱེད་དང་༎ སྒྲུབ་དང་མི་ལྡན་གཞན་ཡང་མི་གཏོང་དང་༎ གཅིག་ཏུ་ཆད་པར་རྟག་ཏུ་སྨྲ་བ་དང་༎ བདེན་ལ་རྟག་ཏུ་གུས་དང་བཅས་པ་དང་༎ བྱང་ཆུབ་སེམས་ནི་སྔོན་དུ་བཏང་ནས་སུ་༎
 ekāntavādī ca bhaveta nityaṃ satye ca segaurava nitya bhoti | bhāveti dharmāṃśca jinapraśastā pūrvaṅgamaṃ bodhayi śitta kṛtvā 10	རྒྱལ་བས་བསྔགས་པའི་ཆོས་ནི་སྒོམ་པར་བྱེད་༎
 dvāstriṃśad ete sugatena proktā dharmā niṣevyā sugatoraseti |	བདེ་གཤེགས་གསུངས་པའི་སུམ་ཅུ་རྩ་གཉིས་ཆོས་༎
 imehi dharmehi samanvitā ye te bodhisattvā sugatena proktā 11 ||	འདི་དག་བདེ་གཤེགས་སྲས་ཀྱིས་བསྟེན་པར་བྱ་༎ བྱང་ཆུབ་སེམས་དཔའ་གང་ཡིན་དེ་དག་ནི་༎ ཆོས་འདི་ལྡན་ཞེས་བདེ་བར་གཤེགས་པས་གསུངས་༎ འོད་སྲུང་།
 kp|29 upamopanyāsanirdeśāste kāśyapa nirdekṣyāmi |	དཔེ་ཉེ་བར་དགོད་པ་བསྟན་པ་གང་དག་གིས་བྱང་ཆུབ་སེམས་དཔའ་བྱང་ཆུབ་སེམས་དཔའི་ཡོན་ཏན་རབ་ཏུ་ཤེས་པར་བྱེད་པའི་དཔེ་ཉེ་བར་དགོད་པ་ཁྱོད་ལ་བསྟན་པར་བྱའོ་༎ འོད་སྲུང་། འདི་ལྟ་སྟེ་། དཔེར་ན་།
 yairupamopanyāsanirdeśebhiḥ bodhisattvo mahāsattvaguṇān vijñāpay||||| tad yathā kāśyapa iyaṃ mahāpṛthivī sarvasattvopajīvyā nirvikārā niṣpratikārā	ས་ཆེན་པོ་འདི་ནི་སེམས་ཅན་ཐམས་ཅད་ཀྱི་འཚོ་བ་སྟེ་། འགྱུར་བ་མེད་ཅིང་ལན་དུ་ཕན་གདོགས་པ་ལ་རེ་བ་མེད་དོ་༎
 evam eva kāśyapa prathamacittotpādiko bodhisatvo yāvadbodhimaṇḍaniṣadanātāvat sarvasattvopajīvyo nirvikāro niṣpratikāro bhavati |	འོད་སྲུང་། དེ་བཞིན་དུ་བྱང་ཆུབ་སེམས་དཔའ་སེམས་དང་པོ་བསྐྱེད་པ་ཡང་བྱང་ཆུབ་ཀྱི་སྙིང་པོ་ལ་ཐུག་གི་བར་དུ་སེམས་ཅན་ཐམས་ཅད་ཀྱི་འཚོ་བ་ཡིན་ཏེ་འགྱུར་བ་མེད་ཅིང་ལན་དུ་ཕན་གདོགས་པར་རེ་བ་མེད་དོ་༎
 tatredamucyate ||	དེ་ལ་འདི་སྐད་ཅེས་བྱ་སྟེ་། དཔེར་ན་ས་འདི་སྐྱེ་བོ་ཀུན་གྱི་འཚོ་༎ ལན་ལ་མི་རེ་༄༢༢༤ཨ་༌༎
 pṛthivī yathā sarvajānopajīvyā pratikāra nākāṅkṣati nirvikārā |	འགྱུར་བ་མེད་པ་བཞིན་༎
 citte tathādye sthitā bodhisattvo yāvanna buddho bhavitā jinottama |	བྱང་ཆུབ་སེམས་དཔའ་ཐོག་མར་སེམས་གནས་པ་༎ རྒྱལ་མཆོག་བླ་ན་མེད་པའི་སངས་རྒྱས་སུ་༎
 anuttarā sarvajanopajīvyo pratikāra nākāṅkṣati nirvikāro |	མ་གྱུར་བར་དུ་སྐྱེ་བོ་ཀུན་གྱི་འཚོ་༎ ལན་ལ་རེ་བ་མེད་ཅིང་འགྱུར་བ་མེད་༎
 putre ca śatruṃ hi ca tulyamāna so paryeṣate nitya varāgrabodhim 2 ||	བུ་དང་དགྲ་ལའང་ཡིད་ཀྱིས་མཚུངས་པར་སེམས་༎ བྱང་ཆུབ་མཆོག་རབ་རྟག་པར་ཡོངས་སུ་འཚོལ་༎ འོད་སྲུང་།
 kp|30 tadyathā kāśyapa abdhātu sarvatṛṇagulmoṣadhivanaspatayo rohāpayati |	འདི་ལྟ་སྟེ་། དཔེར་ན་། ཆུའི་ཁམས་ནི་རཙབ༹་དང་། ཤིང་གེལ་པ་དང་། སྨན་དང་། ནགས་ཚལ་ཐམས་ཅད་སྐྱེད་པར་བྱེད་དོ་༎
 evam eva kāśyapa āśayaśuddho bodhisattvaḥ sarvasattvāni maitratayā spharitvā viharan sarvasattvānāṃ sarvaśukladharmān virohayati |	འོད་སྲུང་། དེ་བཞིན་དུ་བྱང་ཆུབ་སེམས་དཔའ་བསམ་པ་དག་པ་། སེམས་ཅན་ཐམས་ཅད་ལ་བྱམས་པས་ཁྱབ་པར་བྱས་ཏེ་གནས་པ་ཡང་སེམས་ཅན་ཐམས་ཅད་ལ་དཀར་པོའི་ཆོས་ཐམས་ཅད་སྐྱེད་དོ་༎
 tatredamucyate	དེ་ལ་འདི་སྐད་ཅེས་བྱ་སྟེ་།
 yathāpi ābdhātu tṛṇagulmamauṣadhī vanaspatīn auṣadhidhānyajātam |	དཔེར་ན་ཆུ་ནི་རཙབ༹་དང་གེལ་པ་དང་༎ ནགས་ཚལ་སྨན་དང་འབྲུ་ཡི་རྣམ་པ་སྐྱེད་༎ དེ་བཞིན་བྱང་ཆུབ་སེམས་དཔའ་བསམ་དག་པ་༎
 evameva śuddhāśayabodhisattvo maitryāya sattvān spharate anantāt	སེམས་ཅན་མཐའ་ཡས་བྱམས་པས་ཁྱབ་པར་བྱེད་༎
 spharitva dharmān vividhā krameṇa	སྣ་ཚོགས་ཆོས་ལ་ཁྱབ་བྱས་རིམ་གྱིས་སུ་༎
 śuklehi dharmehi vivardhamānaḥ a|||||||||||||||| rva prāpnoti jināna bodhiṃ	དཀར་པོའི་ཆོས་ཀྱིས་རྣམ་པར་རྒྱས་འགྱུར་ཞིང་༎
 nihatya mārāṃ sabalāṃ sasainyam 2 ||	དཔུང་བཅས་སྡེ་དང་བཅས་པའི་བདུད་བཅོམ་ནས་༎ རིམ་གྱིས་རྒྱལ་བའི་བྱང་ཆུབ་ཐོབ་པར་འགྱུར་༎ འོད་སྲུང་།
 kp|31 tadyathā kāśyapa tejodhātuḥ sarvasasyāni paripā X yati |	འདི་ལྟ་སྟེ་། དཔེར་ན་། མེའི་ཁམས་ནི་ལོ་ཏོག་ཐམས་ཅད་ཡོངས་སུ་སྨིན་པར་བྱེད་དོ་༎
 evameva kāśyapa bodhisattvasya prajñā sarvasattvānāṃ sarvaśukladharmān paripācayati |	འོད་སྲུང་། དེ་བཞིན་དུ་བྱང་ཆུབ་སེམས་དཔའི་ཤེས་རབ་ཀྱང་སེམས་ཅན་ཐམས་༄༢༢༤བ་ཅད་ཀྱི་དཀར་པོའི་ཆོས་ཐམས་ཅད་ཡོངས་སུ་སྨིན་པར་བྱེད་དོ་༎
 tatredamucyate 3 ||	དེ་ལ་འདི་སྐད་ཅེས་བྱ་སྟེ་།
 yathāpi teja paripācayanti sasyāṇi sarvāṇi tṛṇauṣadhīṃśca |	དཔེར་ན་མེ་ནི་རཙབ༹་དང་སྨན་རྣམས་དང་༎ ལོ་ཏོག་ཐམས་ཅད་ཡོངས་སུ་སྨིན་པར་བྱེད་༎
 emeva prajñā sugatātmajānān dharmān śubhā vardhayate janasya 1 ||	དེ་བཞིན་བདེ་གཤེགས་སྲས་ཀྱི་ཤེས་རབ་ཀྱང་༎ སྐྱེ་བོ་རྣམས་ཀྱི་དགེ་བའི་ཆོས་སྨིན་བྱེད་༎ འོད་སྲུང་། འདི་ལྟ་སྟེ་། དཔེར་ན་།
 kp|32 tadyathā kāśyapa vāyudhātuḥ sarvabuddhakṣetrāni viṭhapayati evameva kāśyapa bodhisattvasyopāyakauśalyaṃ sarvabuddhadharmān viṭhapayati	རླུང་གི་ཁམས་ནི་སངས་རྒྱས་ཀྱི་ཞིང་ཐམས་ཅད་རྣམ་པར་སྒྲུབ་བོ་༎ འོད་སྲུང་། དེ་བཞིན་དུ་བྱང་ཆུབ་སེམས་དཔའི་ཐབས་ལ་མཁས་པ་ཡང་སེམས་ཅན་ཐམས་ཅད་ལ་སངས་རྒྱས་ཀྱི་ཆོས་ཐམས་ཅད་རྣམ་པར་སྒྲུབ་བོ་༎
 tatredamucyate |	དེ་ལ་འདི་སྐད་ཅེས་བྱ་སྟེ་།
 || vāyuryatheva viṭhapeti kṣetrād buddhāna nānāvidha āśayato |	དཔེར་ན་རླུང་ནི་སངས་རྒྱས་དགོངས་པ་བཞིན་༎ རྣམ་པ་སྣ་ཚོགས་ཞིང་རྣམས་རྣམ་པར་སྒྲུབ་༎
 upāya evaṃ hi jinorasānān viṭhapanti dharmān sugatoktam agrān ||	དེ་བཞིན་རྒྱལ་སྲས་རྣམས་ཀྱི་ཐབས་མཁས་ཀྱང་༎ བདེ་གཤེགས་གསུངས་པའི་ཆོས་མཆོག་རྣམ་པར་སྒྲུབ་༎
 kp|33 tadyathāpi nāma kāśyapa mārasya pāpīmataścaturaṅgaṃ balasainya sarvadevairna śakyam abhibhavituṃ paryādatuṃ vā |	འོད་སྲུང༏་འདི་ལྟ་སྟེ་། དཔེར་ན་། བདུད་སྡིག་ཅན་གྱི་དཔུང་གི་ཚོགས་ཡན་ལག་བཞི་པ་ནི་འདོད་པ་ན་སྤྱོད་པའི་ལྷ་ཐམས་ཅད་ཀྱིས་ཟིལ་གྱིས་མནན་པའམ་ཡོངས་སུ་ཟད་པར་བྱ་བར་མི་ནུས་སོ་༎
 evameva kāśyapa śuddhāśayo bodhisattva sarvamārairna śakyam abhibhavitu paryādattuṃ vā |	འོད་སྲུང༏་དེ་བཞིན་དུ་བྱང་ཆུབ་སེམས་དཔའ་བསམ་པ་དག་པ་ཡང་བདུད་ཐམས་ཅད་ཀྱིས་ཟིལ་གྱིས་མནན་པའམ་ཡོངས་སུ་ཟད་པར་བྱ་བར་མི་ནུས་སོ་༎ འོད་སྲུང་། འདི་ལྟ་སྟེ་།
 kp|34 || tadyathāpi nāma kāśyapa śuklapakṣe candramaṇḍalaṃ paripūryate vardhate ca |	དཔེར་ན་། ཟླ་བ་ཡར་གྱི་ངོ་ལ་ཟླ་བའི་དཀྱིལ་འཁོར་སྐྱེ་ཞིང་གང་བར་འགྱུར་རོ་༎
 evameva kāśyapa āśayaśuddho bodhisattvaḥ sarvaśukladharmairvardhate |	འོད་སྲུང་། དེ་བཞིན་དུ་བྱང་ཆུབ་སེམས་དཔའ་བསམ་པ་དག་པ་ཡང་དཀར་པོའི་ཆོས་ཐམས་ཅད་ཀྱིས་རྫོགས་ཤིང་རྒྱས་༄༢༢༥ཨ་༌༎ 
 tatredamucyate 4	པར་འགྱུར་རོ་༎ དེ་ལ་འདི་སྐད་ཅེས་བྱ་སྟེ་།
 || śuklapakṣe yathā candramaṇḍalaṃ||||||||||||	དཔེར་ན་ཟླ་བའི་དཀྱིལ་འཁོར་ཡར་ངོ་ལ་༎
 pūryate vardhati no ca hīyate | evameva śuddhāśayabodhisattvoḥ sic	སྐྱེ་ཞིང་ཡོངས་སུ་གང་འགྱུར་འབྲི་མི་འགྱུར་༎ དེ་བཞིན་བསམ་དག་བྱང་ཆུབ་སེམས་དཔའ་ཡང་༎
 śuddhehi dharmehi sadā vivardhate | ||	དཀར་པོའི་ཆོས་ཀྱིས་རྟག་ཏུ་རྒྱས་པར་འགྱུར་༎ འོད་སྲུང་།
 kp|35 tadyathāpi nāma kāśyapa sūryamaṇḍalam ekapramuktābhi sūryaraśmibhiḥ sattvānām avabhāsaṃ karoti |	འདི་ལྟ་སྟེ་། དཔེར་ན་། ཉི་མའི་དཀྱིལ་འཁོར་ལས་ལན་གཅིག་ཕྱུང་བའི་འོད་ཟེར་རྣམས་ཀྱིས་སེམས་ཅན་ཐམས་ཅད་སྣང་བར་བྱེད་དོ་༎ 
 evameva kāśyapa bodhisattvam ekapramuktābhiḥ prajñāraśmibhiḥ sattvānām jñānāvabhāsaṃ karoti |	འོད་སྲུང་། དེ་བཞིན་དུ་བྱང་ཆུབ་སེམས་དཔའ་རྣམས་ཀྱིས་ལན་གཅིག་ཕྱུང་བའི་ཤེས་རབ་ཀྱི་འོད་ཟེར་རྣམས་ཀྱིས་ཀྱང་སེམས་ཅན་ཐམས་ཅད་ལ་ཤེས་པའི་སྣང་བ་བྱེད་དོ་༎ 
 tatredamucyate 7	དེ་ལ་འདི་སྐད་ཅེས་བྱ་སྟེ་། དཔེར་ན་ཉི་ལས་ལན་གཅིག་ཕྱུང་བ་ཡི་༎
 || mekapramuktābhi yatheva sūryo raśmībhi sattvānna sic karoti bhāsam	འོད་ཟེར་རྣམས་ཀྱིས་སེམས་ཅན་སྣང་བར་བྱེད་༎
 evaṃ jinānāṃ suta jñānaraśmibhi prajñāya sattvānavabhāsa kurvati ||	དེ་བཞིན་རྒྱལ་སྲས་ཡེ་ཤེས་འོད་ཟེར་གྱིས་༎ སེམས་ཅན་རྣམས་ལ་ཤེས་རབ་སྣང་བར་བྱེད་༎
 kp|36 tadyathāpi nāma kāśyapa siṅho mṛgarājā yato yata | eva prakramate sarvatrābhito nutrasta evaṃ prakramati |	འོད་སྲུང་། འདི་ལྟ་སྟེ་། དཔེར་ན་། རི་དབ༹གས་ཀྱི་རྒྱལ་པོ་སེང་གེ་ནི་ག་ལས་གར་འགྲོ་བ་ཐམས་ཅད་དུ་མི་འཇིགས་མི་སྐྲག་པ་ཉིད་དུ་འགྲོའོ་༎ འོད་སྲུང་།
 evameva kāśyapa śīlaśrutaguṇadharmapratiṣṭhito bodhisattvo yato yata eva prakramate sarvatrābhīto nutrasta eva prakramate |	དེ་བཞིན་དུ་བྱང་ཆུབ་སེམས་དཔའ་ཐོས་པ་དང་། ཚུལ་ཁྲིམས་དང་། བསླབ་པ་དང་། སྦྱངས་པའི་ཡོན་ཏན་དང་། ཡོ་བྱད་བསྙུངས་པ་དང་། ཏིང་ངེ་འཛིན་དང༏་ཡེ་ཤེས་ལ་གནས་པ་ཡང་ག་ལས་གར་འགྲོ་བ་ཐམས་ཅད་དུ་མི་འཇིགས་མི་སྐྲག་པ་ཉིད་དུ་འགྲོའོ་༎
 tatredamucyate 8	དེ་ལ་འདི་སྐད་ཅེས་བྱ་སྟེ་།
 || yathā hi siṅho mṛgarāja kesarī yenecchakaṃ yāti asantrasanto |	རི་དབ༹གས་རྒྱལ་པོ་སེང་གེ་རལ་པ་ཅན་༎ འཇིགས་པ་༄༢༢༥བ་མེད་པར་གང་དུ་འདོད་པར་འགྲོ་༎
 evameva śīlaṃśrutajñānasusthito sic yenecchakaṃ gacchati bodhisattvo ||	དེ་བཞིན་བྱང་ཆུབ་སེམས་དཔའ་ཚུལ་ཁྲིམས་དང་༎ ཐོས་དང་ཡེ་ཤེས་གནས་པ་དགའ་མགུར་འགྲོ་༎ འོད་སྲུང་།
 kp|37 tadyathāpi nāma kāśyapa sudāntaḥ kuñjaro nāgassarvabhāravahanatayā na parikhidyate |	འདི་ལྟ་སྟེ་། དཔེར་ན་། བ་གླང་གླང་པོ་ཆེ་ཤིན་ཏུ་དུལ་བ་ནི་ཁལ་ཐམས་ཅད་ཁྱེར་བས་ཡོངས་སུ་སྐྱོ་བ་མེད་དོ་༎ 
 evameva kāśyapa sudāntacitto bodhisattva sarvasattvānāṃ sarvabhāravahanatā na parikhidyate |	འོད་སྲུང་༎ དེ་བཞིན་དུ་བྱང་ཆུབ་སེམས་དཔའ་སེམས་ཤིན་ཏུ་དུལ་བ་ཡང་སེམས་ཅན་ཐམས་ཅད་ཀྱི་དོན་གྱི་ཕྱིར་ཕུང་པོ་ལྔའི་ཁུར་ཁྱེར་བས་ཡོངས་སུ་སྐྱོ་བ་མེད་དོ་༎ 
 tatredamucyate	དེ་ལ་འདི་སྐད་ཅེས་བྱ་སྟེ་།
 yathāpi nāmago sic balavān sudānto bhāraṃ vahanto na dupeti khedaṃ |	དཔེར་ན་རབ་དུལ་སྟོབས་ལྡན་གླང་པོ་ཆེ་༎ ཁལ་རྣམས་ཁྱེར་ཡང་ཡོངས་སུ་སྐྱོ་བ་མེད་༎
 sudāntacitto tathā bodhisattvo sattvāna bhāreṇa na khedamaiti ||	དེ་བཞིན་བྱང་ཆུབ་སེམས་དཔའ་སེམས་རབ་དུལ་༎ སེམས་ཅན་ཁུར་གྱིས་སྐྱོ་བར་འགྱུར་བ་མེད་༎ འོད་སྲུང་།
 kp|38 tadyathāpi nāma kāśyapa padmamudake jātamudakena na lipyate |	འདི་ལྟ་སྟེ་། དཔེར་ན་། པདམ་ཆུ་ལས་སྐྱེས་ཀྱང་ཆུས་མི་གོས་སོ་༎
 evameva kāśyapa bodhisattvo loke jāto lokadharme na lipyate |	འོད་སྲུང་། དེ་བཞིན་དུ་བྱང་ཆུབ་སེམས་དཔའ་འཇིག་རྟེན་དུ་སྐྱེས་ཀྱང་འཇིག་རྟེན་གྱི་ཆོས་རྣམས་ཀྱིས་མི་གོས་སོ་༎ 
 tatredamucyate 10	དེ་ལ་འདི་སྐད་ཅེས་བྱ་སྟེ་།
 || padmaṃ yathā kokanadaṃ jaleruhaṃ jalena no lipyati kardamena vā |	དཔེར་ན་པདམ་ཆུ་ལས་སྐྱེས་གྱུར་ཀྱང་༎ ཆུའམ་རྫབ་ཀྱིས་གོས་པ་མེད་པ་ལྟར་༎
 loke smi jāto tathā bodhisattvo na lokadharmehi kadāci lipyate ||	དེ་བཞིན་བྱང་ཆུབ་སེམས་དཔའ་འཇིག་རྟེན་སྐྱེས་༎ འཇིག་རྟེན་ཆོས་ཀྱིས་ནམ་ཡང་གོས་པ་མེད་༎ འོད་སྲུང་།
 kp|39 tadyathāpi nāma kāśyapa viṭapacchinno vṛkṣo mūle nupahate punareva virohati |	འདི་ལྟ་སྟེ་། དཔེར་ན་། ཤིང་ལྗོན་པ་ཡལ་ག་བཅད་པ་ནི་རྩ་བ་མ་སྣད་ན་སླར་ཡང་ས་ལས་སྐྱེའོ་༎
 evameva kāśyapa upāyakauśalyakleśacchinno bodhisattvaḥ sarvakuśalamūlasaṃyojane nupahate punareva traidhātuke virohati |	འོད་སྲུང་། དེ་བཞིན་དུ་བྱང་ཆུབ་སེམས་དཔའ་ཐབས་ལ་མཁས་པ་ཉོན་མོངས་པའི་ཡལ་ག་བཅད་པ་ཡང་སྙིང་རྗེ་ཆེན་པོས་དགེ་བའི་རྩ་བ་ལ་ཀུན་དུ་སྦྱོར་བ་མ་ཉམས་ན་༄༢༢༦ཨ་༌༎ སླར་ཡང་ཁམས་གསུམ་དུ་སྐྱེའོ་༎
 tatredamucyate 11	དེ་ལ་འདི་སྐད་ཅེས་བྱ་སྟེ་།
 || yathāpi vṛkṣo viṭapasmi cchinno virohate mūla dṛḍhe nupadrute |	དཔེར་ན་ཤིང་ལྗོན་ཡལ་ག་བཅད་པ་ནི་༎ རྩ་བ་བརྟན་པར་མ་སྣད་སླར་ཡང་སྐྱེ་༎
 evam upāyopahato virohate mūlasmi saṃyojana suprahīṇe ||	དེ་བཞིན་རྩ་བ་ཀུན་སྦྱོར་མ་སྤངས་ན་༎ ཐབས་ཀྱིས་བསལ་ཡང་སླར་ཡང་སྐྱེ་བར་འགྱུར་༎ འོད་སྲུང་། འདི་ལྟ་སྟེ་།
 kp|40 tadyathāpi nāma kāśyapa nānādigvidikṣu mahānadīṣvāpskandho mahāsamudre praviṣṭaḥ	དཔེར་ན་། ཕྱོགས་དང་ཕྱོགས་མཚམས་ཐ་དད་པ་ནས་ཀླུང་ཆེན་པོའི་ཆུའི་ཕུང་པོ་རྒྱ་མཚོ་ཆེན་པོར་འབབ་པ་ནི་། འདི་ལྟ་སྟེ་།
 sarvam ekaraso bhavati yaduta lavaṇarasaḥ evameva kāśyapa nānāmukhopacitaṃ kuśalamūlaṃ	ལན་ཚབ༹འི་རོར་རོ་གཅིག་པར་འགྱུར་རོ་༎ འོད་སྲུང་། དེ་བཞིན་དུ་བྱང་ཆུབ་སེམས་དཔའི་དགེ་བའི་རྩ་བ་སྒོ་ཐ་དད་པ་ནས་བསགས་པ་བྱང་ཆུབ་ཏུ་ཡོངས་སུ་བསྔོས་པ་ཐམས་ཅད་ཀྱང་འདི་ལྟ་སྟེ་། 
 bodhisattvasya bodhāya pariṇāmitaṃ sarvam ekarasaṃ yadida vimuktirasaṃ |	ཐམས་ཅད་མཁྱེན་པ་ཉིད་ཀྱི་རོར་རོ་གཅིག་པར་འགྱུར་རོ་༎
 tatredamucyate 12	དེ་ལ་འདི་སྐད་ཅེས་བྱ་སྟེ་།
 || nānānadīnām udakaṃ praviṣṭaṃ mahāsamudrekarasaṃ yathā syāt	དཔེར་ན་ཐ་དད་ཕྱོགས་ཀྱི་ཆུ་ཀླུང་རྣམས་༎ རྒྱ་མཚོ་ཆེར་འབབ་རོ་གཅིག་འགྱུར་བ་བཞིན་༎ ཐ་དད་སྒོ་ནས་དགེ་བ་བསགས་བྱས་པ་༎
 kuśalāni nānāmukhasañcitāni parināmitānyekarasāni bodhye ||	བྱང་ཆུབ་བསྔོས་པ་རྣམས་ཀྱང་རོ་གཅིག་འགྱུར་༎ འོད་སྲུང་།
 kp|41 tadyathāpi nāma kāśyapa sumerupratiṣṭhitā caturmahārājakāyikāstrayastriṃśāśca	འདི་ལྟ་སྟེ་། དཔེར་ན་། རྒྱལ་ཆེན་བཞིའི་རིས་རྣམས་དང་། སུམ་ཅུ་རྩ་གསུམ་པའི་ལྷ་རྣམས་ནི་རི་རབ་ལ་གནས་སོ་༎
 devāḥ evameva kāśyapa bodhicittākuśalamūlapratiṣṭhitā bodhisattvasya sarvajñatā tatredamucyate 13	འོད་སྲུང་། དེ་བཞིན་དུ་བྱང་ཆུབ་སེམས་དཔའི་ཐམས་ཅད་མཁྱེན་པ་ཉིད་ཀྱང་བྱང་ཆུབ་ཀྱི་སེམས་ཀྱི་དགེ་བའི་རྩ་བ་ལ་གནས་སོ་༎ དེ་ལ་འདི་སྐད་ཅེས་བྱ་སྟེ་།
 || caturmahārājikas sic trāyastriñcā yath| sumerusthita devasaṅghā |	དཔེར་ན་རྒྱལ་ཆེན་བཞི་ཡི་རིས་རྣམས་དང་༎ སུམ་ཅུ་རྩ་གསུམ་ལྷ་ཚོགས་རི་རབ་གནས་༎ དེ་བཞིན་བྱང་ཆུབ་སེམས་དཔའ་༄༢༢༦བ་དགེར་གནས་ཏེ་༎
 tatha bodhisattvā kuśale pratiṣṭhāḥ sarvajñatā prāpya vadanti dharmān ||	ཐམས་ཅད་མཁྱེན་ཉིད་ཐོབ་ནས་ཆོས་ཀྱང་སྟོན་༎ འོད་སྲུང་།
 kp|42 tadyathāpi nāma kāśyapa āmātyasaṅgṛhītā rājānaḥ sarvarājakāryāṇi kurvanti |	འདི་ལྟ་སྟེ་། དཔེར་ན་། བློན་པོས་ཡོངས་སུ་ཟིན་པའི་རྒྱལ་པོ་རྣམས་ནི་རྒྱལ་པོའི་བྱ་བ་ཐམས་ཅད་བྱེད་དོ་༎
 evameva kāśyapa upāyasaṅgṛhītā bodhisattvasya prajñā sarvabuddhakāryāṇi karoti |	འོད་སྲུང་། དེ་བཞིན་དུ་བྱང་ཆུབ་སེམས་དཔའ་ཐབས་ལ་མཁས་པས་ཡོངས་སུ་ཟིན་པའི་ཤེས་རབ་ཀྱང་སངས་རྒྱས་ཀྱི་མཛད་པ་ཐམས་ཅད་བྱེད་དོ་༎
 tatredamucyate 14	དེ་ལ་འདི་སྐད་ཅེས་བྱ་སྟེ་།
 || yathā hi rājāna āmātyasaṅgrahā sarvāṇi kāryāṇi karoti nityaṃ |	དཔེར་ན་བློན་པོ་ལྡན་པའི་རྒྱལ་པོ་རྣམས་༎ བྱ་བ་ཐམས་ཅད་རྟག་ཏུ་བྱེད་པ་ལྟར་༎ ཐབས་ལྡན་བྱང་ཆུབ་སེམས་དཔའི་ཤེས་རབ་ཀྱང་༎
 tatha sic bodhisattvasya upāyasaṅgraho buddhārtha prajñāya karonti nitya ||	སངས་རྒྱས་དོན་རྣམས་རྟག་ཏུ་བྱེད་པ་ཡིན་༎ འོད་སྲུང་། འདི་ལྟ་སྟེ་།
 kp|43 tadyathāpi nāma kāśyapa vyabhre deve vigatavalāhake nāsti varṣasyāyadvāram evameva kāśyapa alpaśrutasya bodhisattvasyāntikānāsti saddharmavṛṣṭerāryadvaraṃ	དཔེར་ན་། སྤྲིན་མེད་ཅིང་ནམ་ཐང་བའི་ནམ་མཁའ་ལ་ནི་ཆར་འབབ་པའི་རྒྱུ་མེད་དོ་༎ འོད་སྲུང་། དེ་བཞིན་དུ་བྱང་ཆུབ་སེམས་དཔའ་ཐོས་པ་ཉུང་བ་ལ་ཡང་དམ་པའི་ཆོས་ཀྱི་ཆར་དབབ་པའི་རྒྱུ་མེད་དོ་༎ 
 tatredamucyate 15	དེ་ལ་འདི་སྐད་ཅེས་བྱ་སྟེ་།
 || vyabhre yathā vigatavalāhake nabhe varṣasya ā|||||||||||| na kadāci vidyate |	དཔེར་ན་སྤྲིན་མེད་ནམ་ཐང་ནམ་མཁའ་ལ་༎ ཆར་འབབ་རྒྱུ་ནི་ནམ་ཡང་མི་དམིགས་སོ་༎ དེ་བཞིན་བྱང་ཆུབ་སེམས་དཔའ་ཐོས་ཉུང་ལ་༎
 alpaśrutasyāntikad sic dharmadeśanā na bodhisattvasya kadāci labhyate ||	ཆོས་སྟོན་ནམ་ཡང་དམིགས་པར་མི་འགྱུར་རོ་༎ འོད་སྲུང་།
 kp|44 tadyathāpi nāma kāśyapa|||||||||| bhraghanameghasamutthitā varṣadhārā sasyānyabhivarṣati |	འདི་ལྟ་སྟེ་། དཔེར་ན་། སྤྲིན་ཆེན་པོ་ལས་བྱུང་བའི་ཆར་གྱི་རྒྱུན་ནི་ལོ་ཏོག་ཐམས་ཅད་ལ་མངོན་པར་འབབ་བོ་༎
 evameva kāśyapa mahākaruṇādharmameghasamutth||||||||| bodhisattvasya saddharmavṛṣṭissattvānām abhivarṣati |	འོད་སྲུང་། དེ་བཞིན་དུ་བྱང་ཆུབ་སེམས་དཔའི་སྙིང་པོ་ཆེན་པོ་དང་། མང་དུ་ཐོས་པའི་ཆོས་ཀྱི་སྤྲིན་ལས་བྱུང་བའི་དམ་པའི་ཆོས་ཀྱི་ཆར་ཡང་སེམས་ཅན་ཐམས་ཅད་ལ་མངོན་པར་འབབ་བོ་༎
 tatredamucyate 16	དེ་ལ་འདི་སྐད་ཅེས་བྱ་སྟེ་། དཔེར་ན་༄༢༢༧ཨ་༌༎
 yathāpi megho vipulo savidyuto |||||||||||	སྤྲིན་ཆེན་གློག་དང་བཅས་པ་ལས་༎
 syānuvarṣeṇa karoti tṛptim |	ཆར་པ་བབ་པས་ལོ་ཏོག་ངོམས་པར་བྱེད་༎ དེ་བཞིན་བྱང་ཆུབ་སེམས་དཔའ་དམ་ཆོས་ཀྱི་༎
 saddharmameghotthitavarṣadhārā tarpeti satvāstatha bodhisatvaḥ ||	སྤྲིན་བྱུང་ཆོས་རྒྱུ་སེམས་ཅན་ཚིམ་པར་བྱེད་༎ འོད་སྲུང་།
 kp|45 tadyathāpi nāma kāśyapa yatra rājā cakravarti utpadyate tatra saptaratnānyutpadyante	འདི་ལྟ་སྟེ་། དཔེར་ན་། འཁོར་ལོས་བསྒྱུར་བའི་རྒྱལ་པོ་གང་དུ་བྱུང་བ་དེར་རིན་པོ་ཆེ་སྣ་བདུན་ཡང་འབྱུང་ངོ་༎
 evam eva kāśyapa yatra bodhisattva utpadyate tatra saptātriñcad bodhapakṣyā dharmā utpadyante |	འོད་སྲུང་། དེ་བཞིན་དུ་བྱང་ཆུབ་སེམས་དཔའ་གང་དུ་འབྱུང་བ་དེར་བྱང་ཆུབ་ཀྱི་ཕྱོགས་དང་མཐུན་པའི་ཆོས་སུམ་ཅུ་རྩ་བདུན་པ་དག་ཀྱང་འབྱུང་ངོ་༎
 tatredamucyate 17	དེ་ལ་འདི་སྐད་ཅེས་བྱ་སྟེ་། འཁོར་ལོས་བསྒྱུར་བའི་རྒྱལ་པོ་གང་བྱུང་བ་༎
 || utpadyate yatra hi cakravarti tatrāsya ratnāni bhavanti sapta	དེར་ནི་དེ་ཡི་རིན་ཆེན་སྣ་བདུན་འབྱུང་༎ བྱང་ཆུབ་སེམས་དཔའ་གང་དུ་འབྱུང་གྱུར་པ་༎
 utpadyate yatra ca bodhisattvas tatrāsya bodhyaṅga bhavanti sapta ||	དེར་ནི་བྱང་ཆུབ་ཡན་ལག་བདུན་པོ་འབྱུང་༎ འོད་སྲུང་།
 kp|46 tadyathāpi nāma kāśyapa yatra maṇiratnāyadvāraṃ bhavati bahūnāṃ tatra kārṣāpaṇaśatasahasrāṇām āyadvāraṃ bhavati |	འདི་ལྟ་སྟེ་། དཔེར་ན་། གང་ན་ནོར་བུ་རིན་པོ་ཆེ་བེཨེ་དའུརྱ་འབྱུང་བའི་སྒོ་ཡོད་པ་དེ་ན་ཀར་ཤ་པ་ན་བརྒྱ་སྟོང་མང་པོ་འབྱུང་བའི་སྒོ་ཡོད་དོ་༎ འོད་སྲུང་།
 evameva kāśyapa yatra bodhisattvasyāyadvāraṃ bhavati | bahūnām tatra śrāvakapratyekabuddhahaśatasahasrāṇām āyadvāraṃ bhavati |	དེ་བཞིན་དུ་གང་ན་བྱང་ཆུབ་སེམས་དཔའ་འབྱུང་བའི་སྒོ་ཡོད་པ་དེ་ན་ཉན་ཐོས་དང་། རང་སངས་རྒྱས་འབུམ་ཕྲག་མང་པོ་འབྱུང་བའི་སྒོ་ཡོད་དོ་༎
 tatredamucyate 18	དེ་ལ་འདི་སྐད་ཅེས་བྱ་སྟེ་།
 || yathāpi yasmiṃ maṇiratna bhoti | karṣāpaṇāyo bahu|||||||||||| tra bhoti	དཔེར་ན་གང་དུ་ནོར་བུ་རིན་ཆེན་འབྱུང་༎ དེར་ནི་ཀར་ཤ་པ་ན་མང་འབྱུང་ལྟར་༎
 sambodhicittasya ca yatra āyo	གང་དུ་རྫོགས་པའི་བྱང་ཆུབ་སེམས་འབྱུང་བ་༎
 āyo bahū tatra ca śrāvakānām ||	དེར་ནི་ཉན་ཐོས་མང་པོ་འབྱུང་བར་འགྱུར་༎ འོད་སྲུང་།
 kp|47 tadyathāpi nāma kāśyapa miśrakāvanapratiṣṭhitānā trāyastriṃśānāṃ devānām upabhogaparibhogāḥ samāḥ santiṣṭhante |	འདི་ལྟ་སྟེ་། དཔེར་ན་། སུམ་ཅུ་རྩ་གསུམ་པའི་ལྷ་འདྲེས་པའི་ཚལ་དུ་ཞུགས་པ་རྣམས་ཀྱི་ལོངས་སྤྱོད་དང་ཡོངས་སུ་སྤྱོད་པ་རྣམས་ནི་མཚུངས་༄༢༢༧བ་པར་གནས་སོ་༎
 evameva kāśyapa āśayaśuddhasya bodhisattvasya sarvasattvānām antike samyakprayogo bhavati |	འོད་སྲུང་། དེ་བཞིན་དུ་བྱང་ཆུབ་སེམས་དཔའ་བསམ་པ་དག་པའི་སྦྱོར་བ་ཡང་སེམས་ཅན་ཐམས་ཅད་ཀྱི་བྱ་བ་ཐམས་ཅད་ལ་མཚུངས་པར་འགྱུར་རོ་༎
 tatredamucyate 19	དེ་ལ་འདི་སྐད་ཅེས་བྱ་སྟེ་། དཔེར་ན་འདྲེས་པའི་ཚལ་གནས་ལྷ་རྣམས་ཀྱི་༎
 || yathāpi devāna samā prayogā miśrāvane saṃsthihate sthitānā	ལོངས་སྤྱོད་རྣམས་ནི་མཚུངས་པར་གནས་པ་ཡིན་༎ དེ་བཞིན་བསམ་དག་བྱང་ཆུབ་སེམས་དཔའ་ཡང་༎
 evameva śuddhāsaya bodhisattvo satveṣu samyakkurute prayogam ||	སེམས་ཅན་རྣམས་ལ་རྟག་ཏུ་ལེགས་པར་སྦྱོར༏་༏འོད་སྲུང་།
 kp|48 tadyathāpi nāma kāśyapa mantrauṣadhaparigṛhītaṃ viṣaṃ na vinipātayati |	འདི་ལྟ་སྟེ་། དཔེར་ན་། སྔགས་དང་སྨན་གྱིས་ཡོངས་སུ་ཟིན་པའི་དུག་གིས་ནི་འཆི་བར་བྱེད་མི་ནུས་སོ་༎
 evameva kāśyapa jñānopāyakauśalyaparigṛhīto bodhisattvasya kleśaviṣaṃ na śaknoti vinipātayitum |	འོད་སྲུང་། དེ་བཞིན་དུ་ཡེ་ཤེས་དང་ཐབས་མཁས་པས་ཡོངས་སུ་ཟིན་པའི་བྱང་ཆུབ་སེམས་དཔའི་ཉོན་མོངས་པའི་དུག་གིས་ཀྱང་ལོག་པར་ལྟུང་བར་བྱེད་མི་ནུས་སོ་༎ 
 tatredamucyate 20	དེ་ལ་འདི་སྐད་ཅེས་བྱ་སྟེ་།
 || yathā viṣam mantraparigraheṇa janasya doṣaṃ kriyayāsamarthaṃ	དཔེར་ན་སྔགས་ཀྱིས་ཡོངས་སུ་ཟིན་པའི་དུག་། སྐྱེ་བོ་རྣམས་ལ་ཉེས་པ་བྱེད་མི་ནུས་༎
 evaṃ hi jñānī iha bodhisattvo kleśairna śakyaṃ vinipātanāya | ||	དེ་བཞིན་བྱང་ཆུབ་སེམས་དཔའ་ཡེ་ཤེས་ཅན་༎ ཉོན་མོངས་རྣམས་ཀྱིས་ལོག་ལྟུང་བྱེད་མི་ནུས་༎ འོད་སྲུང་།
 kp|49 tadyathāpi nāma kāśyapa yaṃ mahānagareṣu saṅkarakūtaṃ bhavati sa ikṣukṣetreṣu śālikṣetreṣu mṛdvīkākṣetreṣu copakārībhūte bhavati |	འདི་ལྟ་སྟེ་། དཔེར་ན་། གྲོང་ཁྱེར་ཆེན་པོ་རྣམས་ཀྱི་ལུད་གང་ཡིན་པ་དེ་ནི་བུ་རམ་ཤིང་གི་ཞིང་དག་དང་། རྒུན་འབྲུམ་གྱི་ཞིང་དག་ལ་ཕན་པ་ཡིན་ནོ་༎
 evameva kāśyapa yo bodhisattvasya kleśaḥ sa sarvajñatāyām upakārībhuto bhavati |	འོད་སྲུང་། དེ་བཞིན་དུ་བྱང་ཆུབ་སེམས་དཔའི་ཉོན་མོངས་པའི་ལུད་གང་ཡིན་པ་དེ་ཡང་ཐམས་ཅད་མཁྱེན་པ་ཉིད་ལ་ཕན་པར་འགྱུར་བ་ཡིན་ནོ་༎
 tatredamucyate || 21	དེ་ལ་འདི་སྐད་ཅེས་བྱ་སྟེ་།
 || nagareṣu saṅkāruryathā sucokṣo so ikṣukṣetreṣupakāra kurvati |	དཔེར་ན་གྲོང་ཁྱེར་རྣམས་ཀྱི་མི་གཙང་ལུད་༎ དེ་ནི་བུ་རམ་ཤིང་གི་ཞིང་ལ་ཕན་༎ དེ་བཞིན་བྱང་ཆུབ་སེམས་ཀྱི་ཉོན་མོངས་ལུད་༎
 evameva kleśo upakārā kurvati yo bodhisattvasya jināna dharme ||	༄༢༢༨ཨ་༌༎ དེ་ནི་རྒྱལ་བའི་ཆོས་ལ་ཕན་པར་བྱེད་༎ འོད་སྲུང་།
 kp|50 tadyathāpi nāma kāśyapa iṣvastre aśikṣitasya śastragrahaṇam evameva kāśyapa alpaśrutasya bodhisattvasya dharmapravicayakauśalyamīmāsadarthagrahaṇajñānaṃ draṣṭavyaḥ 22 ||	འདི་ལྟ་སྟེ་། དཔེར་ན་། འཕོང་རྩལ་མ་བསླབས་པ་ལས་མཚོན་ཐབས་སློབ་པ་དེ་བཞིན་དུ་བྱང་ཆུབ་སེམས་དཔའ་ཐོས་པ་ཉུང་བ་ལས་དམ་པའི་ཆོས་རབ་ཏུ་རྣམ་པར་འབྱེད་པ་དང་། དཔྱོད་པ་དང་། དོན་འཛིན་པའི་ཤེས་པར་བལྟའོ་༎ འོད་སྲུང་། འདི་ལྟ་སྟེ་།
 kp|51 tadyathāpi nāma kāśyapa kumbhakārasya bālabhājaneṣūdārāgnidānām evameva kāśyapa bālaprajñeṣu bodhisattvasyodāradharmadeśanā sic veditavyaḥ	དཔེར་ན་། སོ་མ་བཏང་བའི་སྣོད་རྣམས་ལ་ནི་རྫ་མཁན་གྱིས་མེ་ཆེན་པོ་བཏང་དགོས་སོ་༎ འོད་སྲུང་། དེ་བཞིན་དུ་ཤེས་རབ་མ་སྨིན་པའི་སེམས་ཅན་རྣམས་ལ་ཡང་བྱང་ཆུབ་སེམས་དཔས་སངས་རྒྱས་ཀྱི་ཆོས་ཀྱི་མེ་ཆེན་པོ་བཏང་དགོས་པར་བལྟའོ་༎
 kp|52 tasmin tarhi kāśyapa iha mahāratnakūṭe dharmaparyāye śikṣitukāmena bodhisattvena yoniśo dharmaprayuktena bhavitavyaṃ |	འོད་སྲུང་། དེ་ལྟ་བས་ན་བྱང་ཆུབ་སེམས་དཔའ་དཀོན་མཆོག་བརྩེགས་པ་ཆེན་པོའི་ཆོས་ཀྱི་རྣམ་གྲངས་འདི་ལ་སློབ་པར་འདོད་པས་ཚུལ་བཞིན་དུ་ཆོས་ལ་རབ་ཏུ་སྦྱོར་བར་བྱའོ༏་༏འོད་སྲུང་།
 tatra kāśyapa katamo yoniśadharmaprayogaḥ yaduta sarvadharmāṇāṃ bhutapratyavekṣā |	དེ་ལ་བྱང་ཆུབ་སེམས་དཔའི་ཚུལ་བཞིན་དུ་ཆོས་ལ་རབ་ཏུ་སྦྱོར་བ་གང་ཞེ་ན་། འདི་ལྟ་སྟེ་། དབུ་མའི་ལམ་ཆོས་རྣམས་ལ་ཡང་དག་པར་སོ་སོར་རྟོག་པའོ་༎
 katamā ca kāśyapa sarvadharmāṇāṃ bhutapratyavekṣā |	འོད་སྲུང་། དབུ་མའི་ཆོས་རྣམས་ལ་ཡང་དག་པར་སོ་སོར་རྟོག་པ་གང་ཞེ་ན་། འོད་སྲུང་།
 yatra kāśyapa nātmapratyave kṣānasattvanajīvanapoṣanapudgalanamanujanamānavāpratyavekṣā |	གང་ལ་བདག་མེད་པར་སོ་སོར་རྟོག་པ་དང་། སེམས་ཅན་མེད་པ་དང་། སྲོག་མེད་པ་དང་། གསོ་བ་མེད་པ་དང་། སྐྱེས་བུ་མེད་པ་དང་། གང་ཟག་མེད་པ་དང་། ཤེད་ལས་སྐྱེས་པ་མེད་པ་དང་། ཤེད་བུ་མེད་པར་སོ་སོར་རྟོག་པ་སྟེ་།
 iyamucyate kāśyapa madhyamā pratipad dharmāṇāṃ bhūtapratyavekṣā |	འོད་སྲུང་། འདི་ནི་དབུ་མའི་ལམ་ཆོས་རྣམས་ལ་ཡང་དག་པར་༄༢༢༨བ་སོ་སོར་རྟོག་པ་ཞེས་བྱའོ་༎ འོད་སྲུང་།
 kp|53 punaraparaṃ kāśyapa maddhyamā pratipad dharmāṇāṃ bhūtapratyavekṣā yā rūpasya na nityam iti pratyavekṣā nānityānīti pratyavekṣā |	གཞན་ཡང་དབུ་མའི་ལམ་ཆོས་རྣམས་ལ་ཡང་དག་པར་སོ་སོར་རྟོག་པ་ནི་གང་གཟུགས་ལ་རྟག་པར་ཡང་སོ་སོར་མི་རྟོག་། མི་རྟག་པར་ཡང་སོ་སོར་མི་རྟོག་པ་དང་། འོད་སྲུང་།
 yā vedanāyāḥ sañjñāyāḥ saṃskārāṇāṃ vijñānasya na nityam iti pratyavekṣā |	དེ་བཞིན་དུ་ཚོར་བ་དང་། འདུ་ཤེས་དང་། འདུ་བྱེད་དང་། རྣམ་པར་ཤེས་པ་ལ་གང་རྟག་པར་ཡང་སོ་སོར་མི་རྟོག་།
 nānityam iti pratyavekṣā iyamucyate kāśyapa madhyamā pratipad dharmāṇāṃ bhūtapratyavekṣā kp|54 yā pṛthivīdhātorna nityam iti pratyavekṣā nānityam iti pratyavekṣā yābdhātostejodhātorvāyudhāto na nityam iti pratyavekṣā nānityam iti pratyavekṣā |	མི་རྟག་པར་ཡང་སོ་སོར་མི་རྟོག་པ་སྟེ་། འོད་སྲུང་། འདི་ནི་དབུ་མའི་ལམ་ཆོས་རྣམས་ལ་ཡང་དག་པར་སོ་སོར་རྟོག་པ་ཞེས་བྱའོ་༎ འོད་སྲུང་།
 yā ākāśadhātorvijñānadhāto na nityam iti pratyavekṣā nānityam iti pratyavekṣā iyamucyate kāśyapa madhyamā pratipad dharmāṇāṃ bhūtapratyavekṣā	གཞན་ཡང་དབུ་མའི་ལམ་ཆོས་རྣམས་ལ་ཡང་དག་པར་སོ་སོར་རྟོག་པ་ནི་གང་སའི་ཁམས་ལ་རྟག་པར་ཡང་སོ་སོར་མི་རྟོག་། མི་རྟག་པར་ཡང་སོ་སོར་མི་རྟོག་པ་དང་། དེ་བཞིན་དུ་ཆུའི་ཁམས་དང་། མེའི་ཁམས་དང་། རླུང་གི་ཁམས་དང་། ནམ་མཁའི་ཁམས་དང་། རྣམ་པར་ཤེས་པའི་ཁམས་ལ་རྟག་པར་ཡང་སོ་སོར་མི་རྟོག་། མི་རྟག་པར་ཡང་སོ་སོར་མི་རྟོག་པ་སྟེ་།
 kp|55 punaraparaṃ kāśyapa madhyamā pratipad dharmāṇāṃ bhūtapratyavekṣā |	འོད་སྲུང་། འདི་ནི་དབུ་མའི་ལམ་ཆོས་རྣམས་ལ་ཡང་དག་པར་སོ་སོར་རྟོག་པ་ཞེས་བྱའོ་༎ འོད་སྲུང་།
 yā cakṣurāyatanasya na nityam iti pratyavekṣā nānityam iti pratyavekṣā iyam ucyate kāśyapa madhyamā pratipad dharmāṇāṃ bhūtapratyavekṣā |	གཞན་ཡང་དབུ་མའི་ལམ་ཆོས་རྣམས་ལ་ཡང་དག་པར་སོ་སོར་རྟོག་པ་ནི་གང་མིག་གི་སྐྱེ་མཆེད་ལ་རྟག་པར་ཡང་སོ་སོར་མི་རྟོག་།
 evaṃ yāvacchrotraghrāṇajihvākāyamanāyatanasya na nityam ityam iti |	མི་རྟག་པར་ཡང་སོ་སོར་མི་རྟོག་པ་དང་། དེ་བཞིན་དུ་རྣ་བ་དང་། སྣ་དང༏་ལྕེ་དང་། ལུས་དང་། ཡིད་ཀྱི་སྐྱེ་མཆེད་རྣམས་ལ་རྟག་པར་ཡང་སོ་སོར་མི་རྟོག་། མི་རྟག་པར་ཡང་སོ་སོར་མི་རྟོག་པ་སྟེ་།
 pratyavekṣā iyamucyate kāśyapa madhyamā pratipad dharmāṇāṃ bhūtapratyavekṣā |	འོད་སྲུང་། འདི་ནི་དབུ་མའི་ལམ་ཆོས་རྣམས་ལ་ཡང་དག་༄༢༢༩ཨ་༌༎ པར་སོ་སོར་རྟོག་པ་ཞེས་བྱའོ་༎
 kp|56 nityam iti kāśyapa ayam eko 'ntaḥ anityam iti kāśyapa ayaṃ dvitīyo 'ntaḥ yadetayordvayo	འོད་སྲུང་། རྟག་ཅེས་བྱ་བ་དེ་ནི་མཐའ་གཅིག་གོ་། མི་རྟག་ཅེས་བྱ་བ་དེ་ནི་མཐའ་གཉིས་སོ་༎ མཐའ་དེ་གཉིས་ཀྱི་དབུས་གང་ཡིན་པ་དེ་ནི་དཔྱད་དུ་མེད་པ་། བསྟན་དུ་མེད་པ་། རྟེན་མ་ཡིན་པ་། སྣང་བ་མེད་པ་། རྣམ་པར་རིག་པ་མེད་པ་།
 nityānityayormadhyaṃ tadarūpyanidarśanam anābhāsam avijñāptikam apratiṣṭham aniketam	གནས་མེད་པ་སྟེ་།
 iyamucyate kāśyapa madhyamā pratipad dharmāṇāṃ bhūtapratyavekṣā |	འོད་སྲུང་། འདི་ནི་དབུ་མའི་ལམ་ཆོས་རྣམས་ལ་ཡང་དག་པར་སོ་སོར་རྟོག་པ་ཞེས་བྱའོ་༎ འོད་སྲུང་།
 kp|57 ātmeti kāśyapa ayam eko 'ntaḥ nairātmyam ityayaṃ dvitīyo 'ntaḥ yadātmanairātmyayormadhyaṃ	བདག་ཅེས་བྱ་བ་དེ་ནི་མཐའ་གཅིག་གོ་༎ བདག་མེད་ཅེས་བྱ་བ་དེ་ནི་མཐའ་གཉིས་སོ་༎ མཐའ་དེ་གཉིས་ཀྱི་དབུས་གང་ཡིན་པ་དེ་ནི་དཔྱད་དུ་མེད་པ༏་བསྟན་དུ་མེད་པ་།
 tadarūpyanidarśanam anābhāsam avijñaptikam apratiṣṭham aniketam iyamucyate kāśyapa	རྟེན་མ་ཡིན་པ་། སྣང་བ་མེད་པ་། རྣམ་པར་རིག་པ་མེད་པ་། གནས་མེད་པ་སྟེ་།
 madhyamā pratipad dharmāṇāṃ bhūtapratyavekṣā |	འོད་སྲུང་། འདི་ནི་དབུ་མའི་ལམ་ཆོས་རྣམས་ལ་ཡང་དག་པར་སོ་སོར་རྟོག་པ་ཞེས་བྱའོ༏་༏འོད་སྲུང་།
 kp|58 bhūtacittam iti kāśyapa ayam eko 'ntaḥ abhūtacittam iti kāśyapa ayaṃ dvitīyo	སེམས་ཡང་དག་པ་ཞེས་བྱ་བ་དེ་ནི་མཐའ་གཅིག་གོ་༎ སེམས་ཡང་དག་པ་མ་ཡིན་པ་ཞེས་བྱ་བ་དེ་ནི་མཐའ་གཉིས་སོ་༎ འོད་སྲུང་།
 'ntaḥ yatra kāśyapa na cetanā na mano na vijñānam iyamucyate kāśyapa madhyamā pratipad	གང་ན་སེམས་མེད་པ་དང་། སེམས་པ་མེད་པ་དང་། ཡིད་མེད་པ་དང་། རྣམ་པར་ཤེས་པ་མེད་པ་འདི་ནི་། འོད་སྲུང་།
 dharmāṇāṃ bhutapratyavekṣā	དབུ་མའི་ལམ་ཆོས་རྣམས་ལ་ཡང་དག་པར་སོ་སོར་རྟོག་པ་ཞེས་བྱའོ་༎
 kp|59 evaṃ sarvadharmāṇāṃ kuśalākuśalānāṃ lokikalokottarāṇāṃ sāvadyānavadyānāṃ sāsravānāsravānāṃ	དགེ་བ་དང་། མི་དགེ་བ་རྣམས་དང་། འཇིག་རྟེན་པ་དང་། འཇིག་རྟེན་ལས་འདས་པ་རྣམས་དང་། ཁ་ན་མ་ཐོ་བ་དང་བཅས་པ་དང་། ཁ་ན་མ་ཐོ་བ་མེད་པ་རྣམས་དང་། ཟག་པ་དང་བཅས་པ་དང་། ཟག་པ་མེད་༄༢༢༩བ་པ་རྣམས་དང་། འདུས་བྱས་དང་། འདུས་མ་བྱས་ཀྱི་ཆོས་ཐམས་ཅད་ཀྱང་དེ་བཞིན་ནོ་༎
 saṃskṛtāsaṃskṛtānāṃ saṅkleśa iti kāśyapa ayam eko 'ntaḥ vyavadānam ityayam kāśyapa	འོད་སྲུང་། ཀུན་ནས་ཉོན་མོངས་པ་ཞེས་བྱ་བ་དེ་ནི་མཐའ་གཅིག་གོ་༎ རྣམ་པར་བྱང་བ་ཞེས་བྱ་བ་དེ་ནི་མཐའ་གཉིས་སོ་༎
 dvitīyo 'ntaḥ yo syāntadvayasyānugamo nudāhāro pravyāhāra iyamucyate |	མཐའ་དེ་གཉིས་ཁས་མི་ལེན་ཅིང་མི་བརྗོད་མི་སྨྲ་བ་གང་ཡིན་པ་འདི་ནི་།
 kāśyapa madhyāmā pratipad dharmāṇāṃ bhūtapratyavekṣā |	འོད་སྲུང་། དབུ་མའི་ལམ་ཆོས་རྣམས་ལ་ཡང་དག་པར་སོ་སོར་རྟོག་པ་ཞེས་བྱའོ་༎
 kp|60 astīti kāśyapa ayam eko 'ntaḥ nāstityayaṃ dvitīyo 'ntaḥ yadetayordvayorantayormadhyam iyamucyate kāśyapa madhyamā pratipad dharmāṇāṃ bhūtapratyavekṣat	འོད་སྲུང་ཡོད་ཅེས་བྱ་བ་དེ་ནི་མཐའ་གཅིག་གོ་༎ མེད་ཅེས་བྱ་བ་འདི་ནི་མཐའ་གཉིས་སོ་༎ དེ་གཉིས་ཀྱི་དབུས་གང་ཡིན་པ་དེ་ནི་དཔྱད་དུ་མེད་པ་། བསྟན་དུ་མེད་པ་། རྟེན་མེད་པ་། སྣང་བ་མེད་པ་། རྣམ་པར་རིག་པ་མེད་པ་། གནས་མེད་པ་སྟེ་། འོད་སྲུང་། འདི་ནི་དབུ་མའི་ལམ་ཆོས་རྣམས་ལ་ཡང་དག་པར་སོ་སོར་རྟོག་པ་ཞེས་བྱའོ་༎ འོད་སྲུང་། འཁོར་བ་ཞེས་བྱ་བ་འདི་ནི་མཐའ་གཅིག་གོ་༎ མྱ་ངན་ལས་འདས་པ་ཞེས་བྱ་བ་འདི་ནི་མཐའ་གཉིས་སོ་༎ དེ་གཉིས་ཀྱི་དབུས་གང་ཡིན་པ་དེ་ནི་དཔྱད་དུ་མེད་པ་། བསྟན་དུ་མེད་པ་། རྟེན་མ་ཡིན་པ་། སྣང་བ་མེད་པ་། རྣམ་པར་རིག་པ་མེད་པ་། གནས་མེད་པ་སྟེ་། འོད་སྲུང་། འདི་ནི་དབུ་མའི་ལམ་ཆོས་རྣམས་ལ་ཡང་དག་པར་སོ་སོར་རྟོག་པ་ཞེས་བྱའོ་༎ འོད་སྲུང་།
 kp|61 yadapi kāśyapa yuṣmākaṃ mayākhyāta |	གང་ཡང་ངས་ཁྱེད་རྣམས་ལ་མ་རིག་པའི་རྐྱེན་གྱིས་འདུ་བྱེད་རྣམས་།
 yaduta avidyāpratyayā saṃskārāḥ saṃskārapratyayaṃ vijñānaṃ vijñānapratyayan nāmārūpannāmarūpapratyayaṃ	འདུ་བྱེད་ཀྱི་རྐྱེན་གྱིས་རྣམ་པར་ཤེས་པ་། རྣམ་པར་ཤེས་པའི་རྐྱེན་གྱིས་མིང་དང་གཟུགས་། མིང་དང་གཟུགས་ཀྱི་རྐྱེན་གྱིས་སྐྱེ་མཆེད་དྲུག་།
 ṣaḍāyatanaṃ ṣaḍāyatanapratyaya sparśaḥ saparśaprapratyayā vedanā vedanāpratyayā tṛṣṇā	སྐྱེ་མཆེད་དྲུག་གི་རྐྱེན་༄༢༣༠ཨ་༌༎ གྱིས་རེག་པ་། རེག་པའི་རྐྱེན་གྱིས་ཚོར་བ་། ཚོར་བའི་རྐྱེན་གྱིས་སྲེད་པ་། སྲེད་པའི་རྐྱེན་གྱིས་ལེན་པ་།
 tṛṣṇāpratyayam upādānam upādānapratyayo bhavaḥ bhavapratyayā jātiḥ jātipratyayā jarāmaroṇaśokaparidevaduḥkhadaurmanasyopāyāsāḥ	ལེན་པའི་རྐྱེན་གྱིས་སྲིད་པ་། སྲིད་པའི་རྐྱེན་གྱིས་སྐྱེ་བ་། སྐྱེ་བའི་རྐྱེན་གྱིས་རྒ་ཤི་དང་། མྱ་ངན་དང་། སྨྲེ་སྔགས་འདོན་པ་དང་། སྡུག་བསྔལ་བ་དང་། ཡིད་མི་བདེ་བ་དང་། འཁྲུག་པ་རྣམས་འབྱུང་སྟེ་།
 sambhavantyevam asya kevalasya mahato duḥkhaskandhasya samudayo bhavati |	དེ་ལྟར་སྡུག་བསྔལ་གྱི་ཕུང་པོ་ཆེན་པོ་འབའ་ཞིག་པོ་འདི་འབྱུང་བར་འགྱུར་རོ་༎
 kp|62 avidyānirodhā saṃskāranirodhaḥ saṃskāranirodhādvijñānanirodhaḥ vijñānanirodhānnāmarūpanirodhaḥ	མ་རིག་པ་འགགས་པས་འདུ་བྱེད་འགག་། འདུ་བྱེད་འགགས་པས་རྣམ་པར་ཤེས་པ་འགག་། རྣམ་པར་ཤེས་པ་འགགས་པས་མིང་དང་གཟུགས་འགག་།
 nāmarūpanirodhātṣaḍāyatanani ||||||||||||||||||||||||||| |||||||||||||||||||||||||||||||||||||||||	མིང་དང་གཟུགས་འགགས་པས་སྐྱེ་མཆེད་དྲུག་འགག་། སྐྱེ་མཆེད་དྲུག་འགགས་པས་རེག་པ་འགག་། རེག་པ་འགགས་པས་ཚོར་བ་འགག་། ཚོར་བ་འགགས་པས་སྲེད་པ་འགག་། སྲེད་པ་འགགས་པས་ལེན་པ་འགག་། ལེན་པ་འགགས་པས་སྲིད་པ་འགག་། སྲིད་པ་འགགས་པས་སྐྱེ་བ་འགག་། སྐྱེ་བ་འགགས་པས་རྒ་ཤི་དང་། མྱ་ངན་དང་། སྨྲེ་སྔགས་འདོན་པ་དང་། སྡུག་བསྔལ་བ་དང་། ཡིད་མི་བདེ་བ་དང་། འཁྲུག་པ་རྣམས་འགག་སྟེ་། དེ་ལྟར་སྡུག་བསྔལ་གྱི་ཕུང་པོ་ཆེན་པོ་འབའ་ཞིག་པོ་འདི་དག་འགག་པར་འགྱུར་རོ་ཞེས་བསྟན་པ་དེ་ལ་། འོད་སྲུང་། རིག་པ་དང་མ་རིག་པ་དེ་དག་གཉིས་མ་ཡིན་ཞིང་རྣམ་པ་གཉིས་སུ་དབྱེར་མེད་དེ་༎ འོད་སྲུང་། འདི་ལ་ཤེས་པ་གང་ཡིན་པ་དེ་ནི་དབུ་མའི་ལམ་ཆོས་རྣམས་ལ་ཡང་དག་པར་སོ་སོར་རྟོག་པ་ཞེས་༄༢༣༠བ་བྱའོ༏་༏དེ་བཞིན་དུ་འདུ་བྱེད་རྣམས་དང་། འདུ་བྱེད་རྣམས་འགག་པ་དང་། རྣམ་པར་ཤེས་པ་དང་། རྣམ་པར་ཤེས་པ་འགག་པ་དང་། མིང་དང་གཟུགས་དང་། མིང་དང་གཟུགས་འགག་པ་དང༏་སྐྱེ་མཆེད་དྲུག་དང་། སྐྱེ་མཆེད་དྲུག་འགག་པ་དང་། རེག་པ་དང་། རེག་པ་འགག་པ་དང་། ཚོར་བ་དང་། ཚོར་བ་འགག་པ་དང་། སྲེད་པ་དང་། སྲེད་པ་འགག་པ་དང་། ལེན་པ་དང་། ལེན་པ་འགག་པ་དང་། སྲིད་པ་དང་། སྲིད་པ་འགག་པ་དང་། སྐྱེ་བ་དང་། སྐྱེ་བ་འགག་པ་དང་། རྒ་ཤི་དང་། རྒ་ཤི་འགག་པ་དེ་དག་གཉིས་མ་ཡིན་ཞིང་རྣམ་པ་གཉིས་སུ་དབྱེར་མེད་དེ་།
 cyate kāśyapa madhyamā pratipaddharmāṇāṃ bhūtapratyavekṣā ||	འོད་སྲུང་། འདི་ལ་ཤེས་པ་གང་ཡིན་པ་དེ་ནི་དབུ་མའི་ལམ་ཆོས་རྣམས་ལ་ཡང་དག་པར་སོ་སོར་རྟོག་པ་ཞེས་བྱའོ་༎ འོད་སྲུང་།
 kp|63 punaraparaṃ kāśyapa dharmāṇāṃ bhutapratyavekṣā yanna śunyatāyā dharmā śūnyā karoti dharmā eva śūnyā |	གཞན་ཡང་དབུ་མའི་ལམ་ཆོས་རྣམས་ལ་ཡང་དག་པར་སོ་སོར་རྟོག་པ་ནི་གང་སྟོང་པ་ཉིད་ཀྱིས་ཆོས་རྣམས་སྟོང་པར་མི་བྱེད་དེ་།
 yannānimittena dharmān animittān karoti dharmā caivānimittāḥ yannāpraṇihitena dharmā |	ཆོས་རྣམས་ཉིད་སྟོང་པ་དང་། གང་མཚན་མ་མེད་པས་ཆོས་རྣམས་མཚན་མ་མེད་པར་མི་བྱེད་དེ་། ཆོས་རྣམས་ཉིད་མཚན་མ་མེད་པ་དང༏་གང་སྨོན་པ་མེད་པས་ཆོས་རྣམས་སྨོན་པ་མེད་པར་མི་བྱེད་དེ་། 
 praṇihitān karoti dharmā evāpraṇihitāḥ yannānabhisaṃskāreṇa dharmān abhisaṃskaroti dharmā cavānabhisaṃskṛtāḥ evaṃ nānutpadena dharmānnānutpādā karoti dharmā caivānutpannāḥ	ཆོས་རྣམས་ཉིད་སྨོན་པ་མེད་པ་དང་། གང་མངོན་པར་འདུ་བྱེད་པ་མེད་པས་ཆོས་རྣམས་མངོན་པར་འདུ་བྱེད་པ་མེད་པར་མི་བྱེད་དེ་། ཆོས་རྣམས་ཉིད་མངོན་པར་འདུ་བྱེད་པ་མེད་པ་དང་། གང་མ་སྐྱེས་པས་ཆོས་རྣམས་མ་སྐྱེས་པར་མི་བྱེད་དེ་།
 evaṃ najātā dharmān ajātīkaroti dharmā caivājātaḥ eva yanna agrāhyā dharmānnagrāhyā karoti dharmā caivāgrāhyā | evam anāsravā dharmān anāsravā karoti dharmā caivānāsravā |	ཆོས་རྣམས་ཉིད་མ་སྐྱེས་པ་དང་། གང་མ་བྱུང་བས་༄༢༣༡ཨ་༌༎
 evaṃ yo nasvabhāvena dharmān asvabhāvikaroti dharmā caivāsvabhāvā |	ཆོས་རྣམས་མ་བྱུང་བར་མི་བྱེད་དེ་། ཆོས་རྣམས་ཉིད་མ་བྱུང་བ་དང་། གང་ངོ་བོ་ཉིད་མེད་པས་ཆོས་རྣམས་ངོ་བོ་ཉིད་མེད་པར་མི་བྱེད་དེ་།
 evaṃ yanna svabhāvena dharmāsvabhāvatā dharmāṇāṃ yatsvabhāvaṃ nopalabhate yā evaṃ pratyavekṣā iyamucyate kāśyapa madhyamā pratipad dharmāṇāṃ bhūtapratyavekṣāḥ ||	ཆོས་རྣམས་ཉིད་ངོ་བོ་ཉིད་མེད་པར་གང་དག་དེ་ལྟར་སོ་སོར་རྟོག་པ་དེ་ནི་། འོད་སྲུང་། དབུ་མའི་ལམ་ཆོས་རྣམས་ལ་ཡང་དག་པར་སོ་སོར་རྟོག་པ་ཞེས་བྱའོ་༎ ཡང་འོད་སྲུང་།
 kp|64 na khalu punaḥ kāśyapa pudgalabhāvavināśāya śūnyatā pudgalaścaiva śūnyatā śūnyatā caiva śūnyatā |	གང་ཟག་རྣམ་པར་གཞིག་པའི་ཕྱིར་སྟོང་པ་ཉིད་མ་ཡིན་གྱི་སྟོང་པ་ཉིད་སྟོང་པའོ་༎ འོད་སྲུང་།
 atyantaśūnyatā | purvāntaśūnyatā |	སྔོན་གྱི་མཐའ་སྟོང་པ་།
 aparāntaśūnyatā pratyutpannaśūnyatā |	ཕྱི་མའི་མཐའ་སྟོང་པ་། ད་ལྟར་བྱུང་བ་སྟོང་བ་སྟེ་།
 śūnyatā kāśyapa pratisaratha mā pudgalam |	སྟོང་པ་ཉིད་ལ་རྟོན་པར་བྱའི་།
 ye khalu puna kāśyapaḥ śūnyatopalambhena śūnyatā pratisaranti |	གང་ཟག་ལ་མ་ཡིན་ནོ་༎ འོད་སྲུང་། གང་དག་སྟོང་པ་ཉིད་དུ་དམིགས་པས་སྟོང་པ་ཉིད་ལ་རྟོན་པ་དེ་དག་ནི་།
 tān ahaṃ kāśyapa naṣṭapranaṣṭān iti vadāmi ito pravacanāt |	ངས་གསུང་རབ་འདི་ལས་ཉམས་། རབ་ཏུ་ཉམས་ཞེས་བཤད་དོ་༎
 varaṃ khalu puna kāśyapa sumerumātrā pudgaladṛṣṭirāśritā na tyevādhimānikasya śūnyatādṛṣṭimālinā |	འོད་སྲུང་། གང་ཟག་ཏུ་ལྟ་བ་རི་རབ་ཙམ་ལ་གནས་པ་བླའི་། མངོན་པའི་ང་རྒྱལ་ཅན་སྟོང་པ་ཉིད་དུ་ལྟ་བ་ནི་དེ་ལྟ་མ་ཡིན་ནོ་༎ དེ་ཅིའི་ཕྱིར་ཞེ་ན་།
 tatkasmāddheto pudgaladṛṣṭigatānām kāśyapa śūnyatā niḥsaraṇaṃ śunyatādṛṣṭi puna kāśyapa kena niḥsariṣyantiḥ ||	འོད་སྲུང་། ལྟ་བར་གྱུར་པ་ཐམས་ཅད་ལས་འབྱུང་བ་ནི་སྟོང་པ་ཉིད་ཡིན་ན་། འོད་སྲུང་། གང་སྟོང་པ་ཉིད་ཁོ་ནར་ལྟ་བ་དེ་ནི་གསོར་མི་རུང་ངོ་ཞེས་ངས་བཤད་དོ་༎ འོད་སྲུང་།
 kp|65 tadyathāpi nāma kāśyapa kaścid eva puruṣo glāno bhavet |	འདི་ལྟ་སྟེ་། དཔེར་ན་། མི་ནད་པ་ཞིག་ཡོད་ལ་།
 tasmai vaidyo bhaiṣajyaṃ dadyāt tasya tad bhaiṣajyaṃ sarvadoṣā ucālya koṣṭhagata na nirgacchet tatkiṃ manyase kāśyapa api nu sa glānapuruṣastasmād glānyā parimukto bhavet |	སྨན་པས་དེ་ལ་སྨན་བཏང་ནས་སྨན་དེས་དེའི་ནད་ཐམས་ཅད་བསྐྱོད་དེ་། སྨན་ལྟོ་ན་འདུག་པ་དེ་ཉིད་མི་འབྱུང་ན་། འོད་སྲུང་། འདི་ཇི་སྙམ་དུ་སེམས་།
 yasya tad bhaiṣajyaṃ sarvakoṣṭhagatā doṣān uccālya koṣṭhagato na niḥsaret |	མི་དེ་ནད་དེ་ལས་ཐར་པར་འགྱུར་རམ་།
 āha no bhagavān |	གསོལ་པ་། བཅོམ་ལྡན་འདས་།
 gāḍhataraśca tasya puruṣasya tadgelānyaṃ bhavet |	༄༢༣༡བ་དེ་ནི་མི་འགྱུར་ལགས་ཏེ་།
 yasya tad bhaiṣajyaṃ sarvadoṣān ucālya sakoṣṭhagataṃ na niḥsaret |	གང་སྨན་དེས་ནད་ཐམས་ཅད་བསྐྱོད་ནས་། སྨན་ལྟོ་ན་མཆིས་པ་ཉིད་མ་བྱུང་ན་། མི་དེའི་བྲོ་ནད་ཤིན་ཏུ་ཚབས་ཆེ་བར་འགྱུར་ལགས་སོ་༎
 bhagavān āha |	བཅོམ་ལྡན་འདས་ཀྱིས་བཀའ་སྩལ་པ་། འོད་སྲུང་།
 evameva kāśyapa sarvadṛṣṭigatānāṃ śūnyatā niḥsaraṇaṃ yasya khalu punaḥ kāśyapa śūnyatādṛṣṭistam aham acikitsyam iti vadāmi |	དེ་བཞིན་དུ་ལྟ་བར་གྱུར་པ་ཐམས་ཅད་ལས་བྱུང་བ་ནི་སྟོང་པ་ཉིད་ཡིན་ན་། འོད་སྲུང་། གང་སྟོང་པ་ཉིད་ཁོ་ནར་ལྟ་བ་དེ་ནི་གསོར་མི་རུང་ངོ་ཞེས་ངས་བཤད་དོ་༎
 tatredamucyate | ||	དེ་ལ་འདི་སྐད་ཅེས་བྱ་སྟེ་།
 yathā hi vaidyo puruṣasya dadyādd virecanaṃ rogavinigrahāya	དཔེར་ན་སྨན་པས་ནད་ནི་བསལ་བའི་ཕྱིར་༎ མི་ཞིག་ལ་ནི་བཀྲུ་སྨན་བཏང་བ་ལས་༎ ནད་རྣམས་བསྐྱོད་ནས་འཁྲུས་པར་མ་གྱུར་ན་༎
 uccālya doṣāśca na niḥsareta tato nidānaṃ ca na copaśānti |	དེ་ཡི་གཞི་ལས་ནད་ནི་སོས་མི་འགྱུར་༎
 || imeva dṛṣṭigahanāśṛteṣu yā śunyatā niḥsaraṇaṃ paraṃ hi |	དེ་བཞིན་ལྟ་བ་ཐིབས་པོར་གནས་པ་ལས་༎ འབྱུང་བའི་མཆོག་ནི་སྟོང་པ་ཉིད་ཡིན་ན་༎ གང་ཞིག་སྟོང་པ་ཁོ་ནར་ལྟ་གྱུར་པ་༎ དེ་ནི་གསོར་མི་རུང་ཞེས་རྒྱལ་བས་གསུངས་༎ འོད་སྲུང་། འདི་ལྟ་སྟེ་། དཔེར་ན་། མི་ལ་ལ་ཞིག་ནམ་མཁས་འཇིག་སྐྲག་ནས་བྲང་བརྡུང་ཞིང་ངུ་སྟེ་། ནམ་མཁའ་འདི་སོལ་ཅིག་ཅེས་དེ་སྐད་ཟེར་ན་། འོད་སྲུང་། འདི་ཇི་སྙམ་དུ་སེམས་། ནམ་མཁའ་དེ་བསལ་བར་ནུས་སམ་། གསོལ་པ་། བཅོམ་ལྡན་འདས་། དེ་ནི་རྔོ་མི་ཐོགས་ལགས་སོ་༎ བཅོམ་ལྡན་འདས་ཀྱིས་བཀའ་སྩལ་པ་། འོད་སྲུང་། དེ་བཞིན་དུ་དགེ་སྦྱོང་དང་། བྲམ་ཟེ་གང་དག་སྟོང་པ་ཉིད་ཀྱིས་སྐྲག་། རབ་ཏུ་སྐྲག་ན་དེ་དག་གི་སེམས་འཁྲུགས་པ་ཆེན་པོར་འགྱུར་རོ་ཞེས་ངས་བཤད་དོ་༎ དེ་ཅིའི་ཕྱིར་ཞེ་ན་། འོད་སྲུང་། དེ་དག་ནི་སྟོང་པ་ཉིད་ལ་སྤྱོད་པ་དེ་ཉིད་ཀྱིས་སྐྲག་༄༢༣༢ཨ་༌༎
 sāśu ||||||||||||||||||||||||||||||||	པའི་ཕྱིར་རོ་༎ དེ་ལ་འདི་སྐད་ཅེས་བྱ་སྟེ་། དཔེར་ན་ནམ་མཁས་འཇིགས་པ་ཉེན་པའི་མི་༎ བླུན་པོ་ནམ་མཁའ་འདི་ནི་སོལ་ཞེས་ཟེར་༎ ནམ་མཁའ་བསལ་བར་ནུས་པ་མ་ཡིན་ཡང་༎ རྨོངས་པས་བྱིས་པ་དག་ནི་འདི་སྐད་སྨྲ་༎ དེ་བཞིན་དགེ་སྦྱོང་བྲམ་ཟེ་གང་དག་ཅིག་། སྟོང་པ་ཉིད་ཀྱིས་སྐྲག་ཅིང་སེམས་འཁྲུགས་པས་༎ བྱིས་པ་དེ་དག་སྟོང་པ་ཉིད་སྤྱོད་པ་༎ སྟོང་པ་ཉིད་ནི་གང་དུའང་གཞིག་མི་ནུས་༎ འོད་སྲུང་། འདི་ལྟ་སྟེ་། དཔེར་ན་། རི་མོ་མཁན་ཞིག་བདག་ཉིད་ཀྱིས་གནོད་སྦྱིན་གྱི་གཟུགས་འཇིགས་འཇིགས་ལྟ་ཞིག་བྲིས་ནས་དེ་འཇིགས་སྐྲག་སྟེ་། ཁ་སྤུབ་ཏུ་འགྱེལ་ནས་བརྒྱལ་བར་འགྱུར་བ་དེ་བཞིན་དུ་། འོད་སྲུང་། བྱིས་པ་སོ་སོའི་སྐྱེ་བོ་རྣམས་ཀྱང་བདག་ཉིད་ཀྱིས་བྱིས་པའི་གཟུགས་དང་། སྒྲ་དང་། དྲི་དང་། རོ་དང་། རེག་བྱ་རྣམས་ཀྱིས་འཁོར་བ་ན་འཁོར་ཡང་།
 kp|70 |||||||||||||||||||||||||||||||||||||||||||||||||||||||||||||||||||||||||||||||||||||| ye pi śūnyaṃ | ||	ཆོས་དེ་དག་ཡང་དག་པ་ཇི་ལྟ་བ་བཞིན་དུ་རབ་ཏུ་མི་ཤེས་སོ་༎ དེ་ལ་འདི་སྐད་ཅེས་བྱ་སྟེ་། དཔེར་ན་རི་མོ་མཁན་ཞིག་གིས་༎ གནོད་སྦྱིན་འཇིགས་པའི་གཟུགས་བྱས་ནས་༎ དེ་ཡིས་འཇིགས་ཏེ་ཁ་སྤུབ་ཏུ་༎ འགྱེལ་ནས་བརྒྱལ་བར་གྱུར་པ་ལྟར་༎ བྱིས་པ་སོ་སོའི་སྐྱེ་བོ་ཀུན་༎ བདག་ཉིད་ཀྱིས་ནི་བྱིས་པ་ཡི་༎ གཟུགས་སྒྲ་ལ་སོགས་རྨོངས་གྱུར་པས་༎ འགྲོ་བ་དྲུག་ཏུ་འཁྱམས་པར་འགྱུར་༎ འོད་སྲུང་། འདི་ལྟ་སྟེ་། དཔེར་ན་། མི་སྒྱུ་མ་མཁན་ཞིག་གིས་སྒྱུ་མ་སྤྲུལ་ནས་། སྤྲུལ་པ་དེས་སྒྱུ་མ་མཁན་༄༢༣༢བ་དེ་ཉིད་ཟོས་པ་དེ་བཞིན་དུ་། འོད་སྲུང་། དགེ་སྦྱོང་རྣལ་འབྱོར་སྤྱོད་པ་ཡང་གང་དང་གང་ཡིད་ལ་བྱེད་པ་དེ་ཐམས་ཅད་དེ་ལ་གསོག་ཏུ་སྣང་ངོ་༎ གསོབ་དང་། སྟོང་བ་དང་། སྙིང་པོ་མེད་པ་ཉིད་དུ་སྣང་ངོ་༎ དེ་ལ་འདི་སྐད་ཅེས་བྱ་སྟེ་། དཔེར་ན་སྒྱུ་མ་མཁན་གྱིས་མངོན་སྤྲུལ་པ་༎ སྒྱུ་མ་བྱས་པ་དེ་ཡིས་དེ་ཟོས་ལྟར་༎ རྣལ་འབྱོར་པས་ནི་ཡིད་ལ་གང་བྱེད་པ་༎ དེ་ལ་དེ་དག་གསོག་དང་གསོབ་ཏུ་སྣང་༎ འོད་སྲུང་། འདི་ལྟ་སྟེ་། དཔེར་ན་། ཤིང་གཉིས་རླུང་གིས་དྲུད་པ་དེ་ལས་མེ་བྱུང་སྟེ་། བྱུང་ནས་ཤིང་དེ་གཉིས་སྲེག་པ་དེ་བཞིན་དུ་། འོད་སྲུང་། ཡང་དག་པར་སོ་སོར་རྟོག་པ་ཡོད་ན་། འཕགས་པའི་ཤེས་རབ་ཀྱི་དབང་པོ་སྐྱེ་སྟེ་། དེ་སྐྱེས་པས་ཡང་དག་པར་སོ་སོར་རྟོག་པ་དེ་ཉིད་སྲེག་པར་བྱེད་དོ་༎ དེ་ལ་འདི་སྐད་ཅེས་བྱ་སྟེ་། དཔེར་ན་ཤིང་གཉིས་རླུང་གིས་དྲུད་པ་ལས་༎ མེ་བྱུང་བས་ནི་དེ་ཉིད་སྲེག་པར་བྱེད་༎ དེ་བཞིན་ཤེས་རབ་དབང་པོ་སྐྱེས་ནས་ཀྱང་༎ སོ་སོར་རྟོག་པ་དེ་ཉིད་སྲེག་པར་བྱེད་༎ འོད་སྲུང་།
 tadyathāpi nāma kāśyapa tailapradīpasyaivaṃ bhavatyaham andhakāraṃ vidhamāmīti |	འདི་ལྟ་སྟེ་། དཔེར་ན་། མར་མེ་བུས་ན་མུན་པ་མུན་ནག་ཐམས་ཅད་མེད་པར་འགྱུར་ཡང་། མུན་པ་མུན་ནག་དེ་གང་ནས་ཀྱང་འོང་བའམ་འགྲོ་བ་མེད་དེ་། ཤར་ཕྱོགས་དང་། ལྷོ་དང་། ནུབ་དང་། བྱང་ཕྱོགས་སུ་ཡང་འགྲོ་བའམ་འོང་བ་མེད་དོ་༎ ཡང་འོད་སྲུང་།
 athā ca punastailapradyote kṛte ālokaṃ pratītya tamondhakāraṃ vigacchati |	མར་མེ་དེ་འདི་སྙམ་དུ་བདག་གིས་མུན་པ་མུན་ནག་བསལ་ལོ་སྙམ་དུ་མི་སེམས་མོད་ཀྱི་། འོན་ཀྱང་མར་མེ་ལ་བརྟེན་ནས་མུན་པ་མུན་ནག་མེད་པར་འགྱུར་རོ་༎
 yaśca kāśyapa tailapradyoto yaśca tamondhakāram ubhāyam etac śūnyatā |	འོད་སྲུང་། དེ་ལ་མར་མེ་༄༢༣༣ཨ་༌༎ གང་ཡིན་པ་དང་། མུན་པ་མུན་ནག་གང་ཡིན་པ་དེ་གཉི་ག་སྟོང་པ་སྟེ་། གཟུང་དུ་མེད་ཅིང་བྱེད་པ་མེད་དོ་༎ འོད་སྲུང་། དེ་བཞིན་དུ་ཡེ་ཤེས་སྐྱེས་ན་མི་ཤེས་པ་མེད་པར་འགྱུར་ཡང་། མི་ཤེས་པ་དེ་གང་ནས་ཀྱང་འོང་བའམ་འགྲོ་བ་མེད་དེ་། ཤར་ཕྱོགས་དང་། ལྷོ་དང་། ནུབ་དང་། བྱང་ཕྱོགས་སུ་ཡང་འགྲོ་བའམ་འོང་བ་མེད་དོ་༎ ཡང་འོད་སྲུང་། ཡེ་ཤེས་ཀྱང་འདི་སྙམ་དུ་བདག་གིས་མི་ཤེས་པ་བསལ་ལོ་༎ སྙམ་དུ་མི་སེམས་མོད་ཀྱི་། འོན་ཀྱང་ཡེ་ཤེས་ལ་བརྟེན་ནས་མི་ཤེས་པ་མེད་པར་འགྱུར་རོ་༎ འོད་སྲུང་།
 agrāhyā śūnya niśceṣṭāḥ evameva kāśyapa yaṃ ca jñānaṃ cājñānaṃ cājñānaṃ ca ubhayam etac śūnyad agrāhyā śūnyā niśceṣṭyā 7 |	དེ་ལ་ཡེ་ཤེས་གང་ཡིན་པ་དང་། མི་ཤེས་པ་གནག་ཡིན་པ་དེ་གཉི་ག་སྟོང་པ་སྟེ་། གཟུང་དུ་མེད་ཅིང་བྱེད་པ་མེད་དོ་༎ དེ་ལ་འདི་སྐད་ཅེས་བྱ་སྟེ་། དཔེར་ན་སྒྲོན་མས་མུན་པ་མུན་ནག་ཀུན་༎ མེད་པར་གྱུར་ཀྱང་འགྲོ་བའམ་འོང་བ་མེད་༎ དེ་བཞིན་ཤེས་བྱུང་མི་ཤེས་མེད་གྱུར་ཀྱང་༎ དེ་ནི་གང་ནས་འོང་བའམ་འགྲོ་བ་མེད་༎ སྒྲོན་མས་མུན་པ་བསལ་སྙམ་མི་སེམས་ཀྱང་༎ སྣང་བ་བྱུང་ནས་མུན་པ་མེད་པར་བྱུང་༎ སྟོང་པ་གཟུང་མེད་ནམ་མཁའི་མེ་ཏོག་འདྲ་༎ དེ་བཞིན་ཡེ་ཤེས་མི་ཤེས་གཉི་ག་སྟོང་༎ འོད་སྲུང་། འདི་ལྟ་སྟེ་།
 kp|71 || tadyathāpi nāma kāśyapa gṛhe vā layane vā avavarake vā varṣāsahasrasyātyayena na tat kadācit tailapradyotaḥ kṛto bhavet |	དཔེར་ན་།
 atha ca tatra kaścid eva puruṣaḥ tailapradīpaṃ kuryāt |	ཁྱིམ་དང་། ཁང་པ་དང་། ཁང་ཕྲན་ལོ་འབུམ་འདས་པར་སུས་ཀྱང་ལན་འགའ་ཡང་མར་མེ་མ་བུས་པ་དེར་མི་ལ་ལ་ཞིག་གིས་མར་མེ་བུས་ན་། འོད་སྲུང་།
 tatkiṃ manyase kāśyapa maivāṃ tasya tamondhakārasya bhūdvarṣāsahasrasañcito 'haṃ nāham ito vigamiṣyāmīti |	འདི་ཇི་སྙམ་དུ་སེམས་། མུན་པ་མུན་ནག་དེ་འདི་སྙམ་དུ་བདག་༄༢༣༣བ་ནི་ལོ་འབུམ་དུ་བསགས་པ་ཡིན་ཏེ་། བདག་འདི་ནས་མ་འགྲོའོ་སྙམ་དུ་སེམས་སམ་། གསོལ་པ་།
 āha no hīdaṃ bhagavan na||||||| tasya tamondhakārasya śaktirasti yastailapradyota	བཅོམ་ལྡན་འདས་། དེ་ནི་མི་སེམས་ལགས་ཏེ་། མར་མེ་བུས་ན་མུན་པ་མུན་ནག་ལ་མི་མཆི་བའི་མཐུ་མ་མཆིས་ཀྱི་། གདོན་མི་འཚལ་བར་མ་མཆིས་པར་འགྱུར་ལགས་སོ་༎ བཅོམ་ལྡན་འདས་ཀྱིས་བཀའ་སྩལ་པ་། འོད་སྲུང་།
 kṛte na vigantum avaśyaṃ tena vigatavyaṃ bhagavān āha evameva kāśyapa kalpakoṭīnayutaśatasahasrasañcito 'pi karmakleśa ekena yoniśomanasikāraprajñāpratyavekṣaṇena vigacchati |	དེ་བཞིན་དུ་ལས་དང་ཉོན་མོངས་པ་བསྐལ་པ་འབུམ་དུ་བསགས་པ་ཡང་ཚུལ་བཞིན་དུ་ཡིད་ལ་བྱེད་པའི་སོ་སོར་རྟོག་པ་གཅིག་གིས་མེད་པར་འགྱུར་རོ་༎ 
 tailapradyota iti kāśyapa āryasyaitat prajñendriyasyādhivacanaṃ |	འོད་སྲུང་། མར་མེ་ཞེས་བྱ་བ་དེ་ནི་འཕགས་པའི་ཤེས་རབ་ཀྱི་དབང་པོའི་ཚིག་བླ་དབ༹གས་སོ་༎ འོད་སྲུང་།
 tamondhakāra iti kāśyapatkarmakleśasyādhivacanam |	མུན་པ་མུན་ནག་ཅེས་བྱ་བ་དེ་ནི་འཕགས་པ་མ་ཡིན་པའི་ལས་དང་ཉོན་མོངས་པའི་ཚིག་བླ་དབ༹གས་སོ་༎ དེ་ལ་འདི་སྐད་ཅེས་བྱ་སྟེ་། དཔེར་ན་ཁྱིམ་དུ་མི་འགའ་ལ་ལ་ཡིས་༎ རིང་ཞིག་ལོན་ནས་མར་མེ་བུས་བྱས་ན་༎ དེ་ལ་མུན་པ་བདག་གནས་རིང་ལོན་གྱི་༎ འདི་ནས་མི་འགྲོ་སྙམ་དུ་སེམས་པ་མེད་༎ མར་མེ་ཕྱུང་ནས་མུན་པ་མུན་ནག་ལ་༎ མེད་པར་མི་འགྱུར་པ་ཡི་ནུས་མེད་དེ་༎ མར་མེ་བསྟན་ནས་མུན་པ་མེད་པར་འགྱུར་༎ གཉི་ག་སྟོང་པ་རློམ་སེམས་ཅི་ཡང་མེད་༎ དེ་བཞིན་ཟག་མེད་འཕགས་པའི་ཡེ་ཤེས་བསྟན་༎ མི་ཤེས་ཉོན་མོངས་བསགས་པ་མེད་པར་འགྱུར་༎ ཡེ་ཤེས་དང་ནི་ཉོན་མོངས་རྟག་པར་ཡང་༎ དེ་དག་ལན་འགའ་ཙམ་ཡང་འགྲོགས་པ་མེད་༎ ཡེ་ཤེས་མི་ཤེས་མི་བྱ་མི་སེམས་ཀྱང་༎ ཡེ་ཤེས་བསྟན་༄༢༣༤ཨ་༌༎ ནས་མི་ཤེས་མེད་པར་འགྱུར་༎ གཉིས་ཀ་གཟུང་མེད་ནམ་མཁའི་མེ་ཏོག་བཞིན་༎ དེ་བཞིན་ཡེ་ཤེས་མི་ཤེས་གཉིས་ཀ་སྟོང་༎ འོད་སྲུང་། འདི་ལྟ་སྟེ་། དཔེར་ན༏་ནམ་མཁའ་ལ་ནི་ས་བོན་རྣམས་མི་སྐྱེའོ་༎ འོད་སྲུང་། དེ་བཞིན་དུ་གང་འདུས་མ་བྱས་ལས་བྱང་ཆུབ་སེམས་དཔའི་སངས་རྒྱས་ཀྱི་ཆོས་རྣམས་སྐྱེ་བ་ནི་མ་བྱུང་། མི་འབྱུང་ངོ་༎ དེ་ལ་འདི་སྐད་ཅེས་བྱ་སྟེ་། དཔེར་ན་མཁའ་ལས་ས་བོན་སྐྱེ་བ་ནི་༎ འདས་དང་མ་འོངས་པ་དང་ད་ལྟར་མེད་༎ དེ་བཞིན་འདུས་མ་བྱས་ལས་སངས་རྒྱས་ཆོས་༎ སྐྱེ་བ་གང་དུའང་མ་བྱུང་འབྱུང་མི་འགྱུར་༎ འོད་སྲུང་། འདི་ལྟ་སྟེ་། དཔེར་ན་། ལུད་ཀྱིས་གང་བའི་ས་ལ་ནི་ས་བོན་ཐམས་ཅད་སྐྱེའོ་༎ འོད་སྲུང་། དེ་བཞིན་དུ་ཉོན་མོངས་པའི་ལུད་ཀྱིས་གང་བའི་འཇིག་རྟེན་གནས་པ་ལ་བྱང་ཆུབ་སེམས་དཔའི་སངས་རྒྱས་ཀྱི་ཆོས་རྣམས་སྐྱེའོ་༎ དེ་ལ་འདི་སྐད་ཅེས་བྱ་སྟེ་། དཔེར་ན་ལུད་བཅས་རླན་དང་བཅས་པ་ལ་༎ ས་བོན་སྐྱེ་ཡི་དགོན་དུང་རྣམས་ན་མིན་༎ དེ་བཞིན་ཉོན་མོངས་ལོག་ལྡན་སྐྱེ་བོ་ལ་༎ རྒྱལ་སྲས་རྣམས་ཀྱི་རྒྱལ་བའི་ཆོས་རྣམས་སྐྱེ་༎ འོད་སྲུང་། འདི་ལྟ་སྟེ་། དཔེར་ན་། འབྲོག་དགོན་པ་དགོན་དུང་རྣམས་ན་ནི་པདམ་མི་སྐྱེའོ་༎ འོད་སྲུང་། དེ་བཞིན་དུ་གང་འདུས་མ་བྱས་ལས་བྱང་ཆུབ་སེམས་དཔའི་སངས་རྒྱས་ཀྱི་ཆོས་རྣམས་སྐྱེས་པ་དེ་ནི་མ་བྱུང་། མི་འབྱུང་ངོ་༎
 tatredamucyate 8	དེ་ལ་འདི་སྐད་ཅེས་བྱ་སྟེ་། དཔེར་ན་པདམ་ཆུ་རྫིང་རྣམས་ན་སྐྱེ་༎
 || yathāpi dīpo layane cirasya kṛto bhaveta puruṣeṇa kenacit ||||||||||||||||||||||||||||||||||||||||||||||||||||||||||||||||||||||||||||||||||||||||||||||||| uddharet |	དགོན་༄༢༣༤བ་དུང་དག་ན་ནམ་ཡང་སྐྱེ་མི་འགྱུར་༎ དེ་བཞིན་འདུས་མ་བྱས་ལས་སངས་རྒྱས་ཆོས་༎ སྐྱེ་བ་གང་དུའང་མ་བྱུང་འབྱུང་མི་འགྱུར་༎ འོད་སྲུང་། འདི་ལྟ་སྟེ་། དཔེར་ན་། ལུད་ཡོད་པའི་འདམ་རྫབ་ནས་པདམ་སྐྱེའོ་༎ འོད་སྲུང་། དེ་བཞིན་དུ་ཉོན་མོངས་པའི་འདམ་རྫབ་ལོག་པ་ཉིད་དུ་ངེས་པའི་སེམས་ཅན་རྣམས་ལ་བྱང་ཆུབ་སེམས་དཔའི་སངས་རྒྱས་ཀྱི་ཆོས་རྣམས་སྐྱེའོ་༎ དེ་ལ་འདི་སྐད་ཅེས་བྱ་སྟེ་། དཔེར་ན་ལུད་བཅས་འདམ་རྫབ་ཆུ་ལས་ནི་༎ པདམ་སྐྱེ་ཡི་ཐང་ལས་ནམ་ཡང་མིན་༎ དེ་བཞིན་ཉོན་མོངས་ལོག་ལྡན་སྐྱེ་བོ་ལ་༎ རྒྱལ་སྲས་རྣམས་ཀྱི་རྒྱལ་བའི་ཆོས་རྣམས་སྐྱེ་༎ འོད་སྲུང་། འདི་ལྟ་སྟེ་། དཔེར་ན་། རྒྱ་མཚོ་ཆེན་པོ་བཞི་མར་སར་གྱིས་ཡོངས་སུ་གང་བར་གྱུར་པ་དེ་བཞིན་དུ་བྱང་ཆུབ་སེམས་དཔའ་དགེ་བའི་རྩ་བ་མངོན་པར་འདུ་བྱས་པ་བལྟ་བར་བྱའོ་༎ དེ་ལ་འདི་སྐད་ཅེས་བྱ་སྟེ་། དཔེར་ན་རྒྱ་མཚོ་བཞི་པོ་མར་སར་གྱིས་༎ ཡོངས་གང་གཙང་ཞིང་ཀུན་ནས་ཡིད་དུ་འོང་༎ དེ་བཞིན་བྱང་ཆུབ་སེམས་དཔའ་བདེ་གཤེགས་སྲས་༎ དགེ་བའི་ཀླུང་གིས་རྟག་ཏུ་གང་བར་བལྟ་༎ འོད་སྲུང་། འདི་ལྟ་སྟེ་། དཔེར་ན་། མི་ལ་ལ་ཞིག་གིས་སྐྲ་ཚལ་པ་བརྒྱར་བཤགས་པའི་རྩེ་མོས་རྒྱ་མཚོ་ཆེན་པོ་བཞི་ལས་ཆུའི་ཐིགས་པ་གཅིག་བླངས་པ་དེ་བཞིན་དུ་། འོད་སྲུང་། ཉན་ཐོས་ཀྱི་དགེ་བའི་རྩ་བ་མངོན་པར་འདུ་བྱས་པར་བལྟ་བར་བྱའོ་༎ དེ་ལ་འདི་སྐད་ཅེས་བྱ་སྟེ་། དཔེར་ན་ཆུ་ཡི་ཕུང་པོ་དེ་ལ་ནི་༎ སྐྲ་ཚལ་བརྒྱ་ཡི་རྩེ་མོས་ཐིགས་བླངས་པ་༎ དེ་བཞིན་༄༢༣༥ཨ་༌༎
 kuśalānvitaṃ śrāvakam eva paśyatha	ཉན་ཐོས་རྣམས་ཀྱིས་དགེ་བྱས་པའི་༎
 kuśalena yuktam abhisaṃskṛtena |	དགེ་བ་དག་དང་ལྡན་པར་བལྟ་བར་བྱ་༎ འོད་སྲུང་།
 kp|78 || tadyathāpi nāma kāśyapa ghuṇṇakhāditasya sarṣapam abhyamtare ākāśadhātu evameva kāśyapa śrāvakasyābhisaṃskṛtaṃ jñānaṃ draṣṭavya |	འདི་ལྟ་སྟེ་། དཔེར་ན་། ཡུངས་འབྲུ་སྲིན་བུས་ཟོས་པའི་ནང་གི་ནམ་མཁའ་བཞིན་དུ་ཉན་ཐོས་ཀྱི་འདུས་མ་བྱས་ཤེས་པར་བལྟ་བར་བྱའོ་༎ 
 tatredamucyate 14	དེ་ལ་འདི་སྐད་ཅེས་བྱ་སྟེ་།
 || ghuṇakhāditasyaiva hi sarṣapasya ākāśam abhyantaritopariktaṃ |	དཔེར་ན་ཡུངས་འབྲུ་སྲིན་བུས་ཟོས་པ་ཡི་༎ ནང་གི་ནམ་མཁའ་དེ་ནི་ཆུད་པ་ཡིན་༎
 abhisaṃskṛtaṃ jñāna tathā vijānatha yaṃ śrāvakasya laghukaṃ pariktaktaṃ ||	ཉན་ཐོས་འདུས་མ་བྱས་པ་ཤེས་པ་ཡང་༎ དེ་བཞིན་ཆུང་ཤིང་ཤིན་ཏུ་ཆུང་བར་བལྟ་༎ འོད་དྲུང་།
 kp|79 tadyathāpi nāma kāśyapa daśāsu dikṣvākāśadhāturevaṃ bodhisattvasyābhisaṃskṛtaṃ jñānaṃ draṣṭavyaṃ |	འདི་ལྟ་སྟེ་། དཔེར་ན་། ཕྱོགས་བཅུའི་ནམ་མཁའི་ཁམས་བཞིན་དུ་བྱང་ཆུབ་སེམས་དཔའི་འདུས་མ་བྱས་ཤེས་པར་བལྟ་བར་བྱའོ་༎
 tatredamucyate 15	དེ་ལ་འདི་སྐད་ཅེས་བྱ་སྟེ་།
 || yathāpi ākāśa daśadiśāsu anāvṛtaṃ tiṣṭhati sarvaloke |	དཔེར་ན་ཕྱོགས་བཅུའི་འཇིག་རྟེན་ཐམས་ཅད་ན་༎ ནམ་མཁའི་ཁམ་ནི་སྒྲིབ་པ་མེད་པར་འདུག་།
 abhisaṃskṛtaṃ paśyatha bodhisattve jñānaṃ tathā sarvajagatpradhāna | ||	བྱང་ཆུབ་སེམས་དཔའི་ཡེ་ཤེས་འདུས་བྱས་པ་༎ འགྲོ་བ་ཀུན་གྱི་མཆོག་ཀྱང་དེ་ལྟར་བལྟ་༎ འོད་སྲུང་།
 kp|80 tadyathāpi nāma kāśyapa rājñaḥ kṣatriyasya mūrdhābhiṣiktasyāgramahiṣi daridrapuruṣeṇa	འདི་ལྟ་སྟེ་། དཔེར་ན་། རྒྱལ་པོ་རྒྱལ་རིགས་སྤྱི་བོ་ནས་དབང་བསྐུར་བའི་བཙུན་མོ་དམ་པ་སྐྱེས་པ་དབུལ་པོ་དང་ཉལ་ནས་ཕྱིས་དེ་ལས་བུ་བྱུང་བར་འགྱུར་ན་། འོད་སྲུང་།
 sārdhaṃ vipratipadyeta tasya tataḥ putro jāyetaḥ tatkiṃ manyase kāśyapa api nu sa	འདི་ཇི་སྙམ་དུ་སེམས་། དེ་རྒྱལ་པོའི་བུ་ཞེས་བྱའམ་། གསོལ་པ་།
 rājaputra iti vaktavyaḥ āha no hīdaṃ bhagavan bhagavān āha |	བཅོམ་ལྡན་འདས་། དེ་ནི་མི་འགྱུར་ལགས་སོ་༎ བཅོམ་ལྡན་འདས་ཀྱིས་བཀའ་སྩལ་པ་།
 evameva kāśyapa kiñcāpi mama śrāvakārdharmadhātunirjātā na ca punaste tathāgatasyābhiṣekyaputrā iti vaktavyāḥ tatradamucyate 16	འོད་སྲུང་། དེ་བཞིན་དུ་ངའི་ཉན་ཐོས་རྣམས་ཆོས་རྣམས་ཆོས་ཀྱི་དབྱིངས་ལས་སྐྱེས་མོད་ཀྱི་། དེ་དག་དེ་བཞིན་གཤེགས་པའི་༄༢༣༥བ་སྲས་དབང་བསྐུར་བར་འོས་ཞེས་མི་བྱའོ་༎ དེ་ལ་འདི་སྐད་ཅེས་བྱ་སྟེ་།
 || yathāpi rājño mahiṣī manāpī daridrasattvena sahāvaseta |	དཔེར་ན་རྒྱལ་པོའི་བཙུན་མོ་ཡིད་འོང་མ་༎ སྐྱེས་པ་དབུལ་པོ་དང་ནི་ཉལ་གྱུར་ཏེ་༎
 tasyā sutastena ca jāyate yo 40b5 sa rājaputro na tu rājā bheṣyati |	དེ་ཕྱིར་དེ་ལ་བུ་བྱུང་གང་ཡིན་པ་༎ དེ་ནི་རྒྱལ་པོའི་བུ་མིན་དབང་བསྐུར་མིན་༎
 evameva ye śrāvakā vītarāgā na te bhiṣekyā mama jātu putrāḥ	དེ་བཞིན་ཉན་ཐོས་འདོད་ཆགས་བྲལ་གྱུར་པ་༎ དེ་དག་དབུ་དབང་བསྐུར་འོས་མ་ཡིན་༎
 tathā hi te ātmahitāya yuktā svaparobhayārthekarabuddhaputrāḥ ||	འདི་ལྟར་དེ་དག་བདག་ལ་ཕན་ཕྱིར་བརྩོན་༎ བདག་གཞན་གཉི་གའི་དོན་བྱེད་སངས་རྒྱས་སྲས་༎ འོད་སྲུང་། འདི་ལྟ་སྟེ་།
 kp|81 | tadyathāpi nāmā kāśyapa rājā kṣatriyo mūrdhābhiṣiktaḥ pratyavarayā ceṭikayā sahā pratipadyeta |	དཔེར་ན་། རྒྱལ་པོ་རྒྱལ་རིགས་སྤྱི་བོ་ནས་དབང་བསྐུར་བ་། བྲན་མོ་ངན་པ་དང་ཉལ་བ་དེ་ལས་དེའི་བུ་བྱུང་ན་། འོད་སྲུང་།
 tasya tata putra utpadyeta |	དེ་བྲན་མོ་ངན་པ་ལས་བྱུང་དུ་ཟིན་ཀྱང་དེ་ལ་རྒྱལ་པོའི་སྲས་ཞེས་བྱའོ་༎
 kiñcāpi kāśyapa sa pratyavarayā ceṭikayā sāntikādutpanno tha ca puna sa rājaputra	འོད་སྲུང་།
 iti vaktavyaḥ evameva kāśyapa kiñcāpi prathamacittotpādiko bodhisattvaḥ apratibalaḥ	དེ་བཞིན་དུ་བྱང་ཆུབ་སེམས་དཔའ་སེམས་དང་པོ་བསྐྱེད་པ་འཁོར་བ་ན་འཁོར་ཞིང་།
 saṃsāre saṃsaran sattvān vinayi kāmamathā ca puna sa tathāgataputro iti vaktavyaḥ tatredamucyate 17	སེམས་ཅན་རྣམས་འདུལ་བའི་མཐུ་མ་ཐོབ་ཏུ་ཟིན་ཀྱང་དེ་ནི་དེ་བཞིན་གཤེགས་པའི་སྲས་ཞེས་བྱའོ་༎ དེ་ལ་འདི་སྐད་ཅེས་བྱ་སྟེ་།
 || cetiyā sārdhaṃ yathā cakravarttī saṃvāsaṃ gatvā janayeta putraṃ |	དཔེར་ན་འཁོར་ལོས་བསྒྱུར་བ་བྲན་མོ་དང་༎ ཉལ་བར་གྱུར་པ་དེ་ལས་བུ་བྱུང་བ་༎ བྲན་མོ་ལས་ནི་བྱུང་བར་གྱུར་ཀྱང་དེ་༎
 kiñcāpi ceṭiyasakāśajāto taṃ rājaputreti vadeti loke |	རྒྱལ་པོའི་སྲས་ཞེས་འཇིག་རྟེན་ཟེར་བ་ལྟར་༎
 citte tathā prathame bodhisattvo balena hīno tribhave bhramanto |	བྱང་ཆུབ་སེམས་དཔའ་དང་པོ་སེམས་བསྐྱེད་པ་༎ སྲིད་པ་གསུམ་ན་འཁོར་ཞིང་མཐུ་ཆུང་སྟེ་༎
 dānena sattvāvinayann upāyair jinātmajo vuccati śuddhasattvoḥ 3 ||	སྦྱིན་དང་ཐབས་ཀྱིས་སེམས་ཅན་མི་འདུལ་ཡང་༎ སེམས་ཅན་དག་པ་རྒྱལ་བའི་སྲས་ཞེས་བྱ་༎༎ བམ་པོ་གཉིས་པ་སྟེ་ཐ་མའོ་༎ འོད་སྲུང་།
 kp|82 tadyathāpi nāma kāśyapa rājñā cakravartinaḥ putrasahasraṃ bhavet |	འདི་ལྟ་སྟེ་། དཔེར་ན་། འཁོར་༄༢༣༦ཨ་༌༎ ལོས་བསྒྱུར་བའི་རྒྱལ་པོ་ལ་བུ་གཞོན་ནུ་སྟོབས་ཆེ་ཞིང་མགྱོགས་པའི་ཤུགས་དང་ལྡན་པ་མཐུ་རྙེད་པ་སྟོང་མོད་པར་གྱུར་ལ་།
 na cātra kaścicakravartilakṣaṇasamanvāgato bhavet | na tatra rājñaścakravartinaḥ putrasañjñā manyeta |	དེ་དག་གང་ཡང་འཁོར་ལོས་སྒྱུར་བའི་མཚན་དང་མི་ལྡན་ན་དེ་དག་ལ་འཁོར་ལོས་བསྒྱུར་བའི་རྒྱལ་པོའི་སྲས་སུ་འདུ་ཤེས་མི་སྐྱེད་པ་དེ་བཞིན་དུ་། 
 evameva kāśyapa kiñcāpi tathāgato koṭiśatasahasraparivāraḥ śrāvakerna cātra kaścid bodhisattvo bhavati na tatra tathāgatasya putrasañjñotpadyate	འོད་སྲུང་། དེ་བཞིན་གཤེགས་པའི་ཞམ་རིང་བ་ཉན་ཐོས་བྱེ་བ་བརྒྱ་སྟོང་དེ་དག་གང་ཡང་བྱང་ཆུབ་སེམས་དཔར་མ་གྱུར་ན་དེ་དག་ལ་དེ་བཞིན་གཤེགས་པའི་སྲས་སུ་འདུ་ཤེས་མི་བསྐྱེད་དོ་༎
 tatredamucyate 18	དེ་ལ་འདི་སྐད་ཅེས་བྱ་སྟེ་།
 || yathā sahasraṃ nṛpate sutānāṃ na ceka putro 'pi salakṣaṇaḥ syāt |	དཔེར་ན་མི་བདག་རྒྱལ་པོ་སྲས་སྟོང་པོ་༎ འགའ་ཡང་བུ་ཡི་མཚན་དང་མི་ལྡན་ན་༎
 na tatra sañjñā nṛvarasya teṣu voḍhū yataste na dhuraṃ samarthāḥ	དེ་ཕྱིར་དེ་དག་གཅེས་བྱེད་མི་ནུས་པས་༎ དེ་ལ་མི་མཆོག་བུ་ཡི་འདུ་ཤེས་མེད་༎
 tathā hi buddho bahukoṭinirvṛtaḥ syāt teṣu kaścinna ca bodhisattvaḥ	དེ་བཞིན་སངས་རྒྱས་ཞམ་རིང་བྱེ་བ་མང་༎ འགའ་ཡང་བྱང་ཆུབ་སེམས་དཔའ་མ་ཡིན་ན་༎
 na putrasañjñā sugatasya teṣu na bodhisattvo 'sti yato tra kaścit 2 ||	དེ་ན་བྱང་ཆུབ་སེམས་དཔའ་འགའ་མེད་ཕྱིར་༎ དེ་ལ་བདེ་གཤེགས་སྲས་སུ་དགོངས་མི་མཛད་༎ འོད་སྲུང་།
 kp|83 tadyathāpi nāma kāśyapa rājñaścakravartino agramahiṣyā kukṣe saptarātropapannaḥ	འདི་ལྟ་སྟེ་། དཔེར་ན་། འཁོར་ལོས་བསྒྱུར་བའི་རྒྱལ་པོའི་བཙུན་མོ་དམ་པའི་མངལ་དུ་གཞོན་ནུ་འཁོར་ལོས་བསྒྱུར་བའི་མཚན་དང་ལྡན་པ་ཆགས་ནས་ཞག་བདུན་ལོན་ཏེ་།
 kumāraścakravartilakṣaṇasamanvāgataḥ tasya kukṣigatasyāparipakvendriyasya kalalamahābhūtagatasya	འབྱུང་བ་ཆེན་པོ་མེར་མེར་པོ་འདུག་ཀྱང་།
 balavantatarā tatra devatā spṛhām utpādayanti |	ཤིན་ཏུ་སྟོབས་དང་ལྡན་པས་དེ་ལ་ལྷ་རྣམས་རེ་བ་བསྐྱེད་ཀྱི་།
 na tveva teṣu balajavanavegasthāmaprāpteṣu kumāreṣu tatkasmāddheto sa hi cakravartivaṃśasyānupacchedāya sthāsyati |	གཞོན་ནུ་སྟོབས་ཆེ་ལ་མགྱོགས་པའི་ཤུགས་དང་ལྡན་ཞིང་མཐུ་རྙེད་པ་དེ་དག་ལ་ནི་མ་ཡིན་ནོ་༎ དེ་ཅིའི་ཕྱིར་ཞེ་ན་། དེ་ནི་འཁོར་༄༢༣༦བ་ལོས་བསྒྱུར་བའི་རིགས་མི་འཆད་པར་གནས་པའི་ཕྱིར་རོ་༎ འོད་སྲུང་། དེ་བཞིན་དུ་བྱང་ཆུབ་སེམས་དཔའ་སེམས་དང་པོ་བསྐྱེད་པ་། དབང་པོ་ཡོངས་སུ་མ་སྨིན་པ་། ཉོན་མོངས་པའི་འབྱུང་བ་ཆེན་པོ་མེར་མེར་པོར་གྱུར་པ་། འཁོར་བ་ན་འཁོར་ཞིང་།
 evameva kāśyapa prathamacittotpādiko bodhisattvaḥ aparipakvendriya kalalamahābhūtagata eva samānodatha ca punarbalavantatarā tatra pūrvadarśano devā spṛhām utpādayanti | na tvevāṣṭavimokṣadhyāyīṣvarhatsu |	སངས་རྒྱས་ཀྱི་ཆོས་རྣམས་ཡང་དག་པར་སྒྲུབ་པ་ཡང་ཤིན་ཏུ་སྟོབས་དང་ལྡན་པས་དེ་ལ་སྔོན་སངས་རྒྱས་མཐོང་བའི་ལྷ་རྣམས་རེ་བ་བསྐྱེད་ཀྱི་། དགྲ་བཅོམ་པ་རྣམ་པར་ཐར་པ་བརྒྱད་ལ་བསམ་གཏན་པ་དེ་དག་ལ་མ་ཡིན་ནོ་༎
 tatkasmāddhetoḥ sa hi buddhavaṃśasyānupacchedāya sthāsyati |	དེ་ཅིའི་ཕྱིར་ཞེ་ན་། དེ་སངས་རྒྱས་ཀྱི་གདུང་མི་འཆད་པར་གནས་པའི་ཕྱིར་རོ་༎
 tatredamucyate 19	དེ་ལ་འདི་སྐད་ཅེས་བྱ་སྟེ་།
 || yathāgradevīya tu cakravartino kukṣisthito lakṣaṇapuṇyasattvo |	དཔེར་ན་འཁོར་ལོས་སྒྱུར་བའི་བཙུན་མོའི་མཆོག་། དེ་མངལ་བསོད་ནམས་མཚན་ལྡན་སེམས་ཅན་ཆགས་༎
 balavantaraṃ deva spṛhā karonti na sthāmaprāptāna kumārakānāṃ	སྟོབས་དང་ལྡན་པས་ལྷ་རྣམས་རེ་བ་བསྐྱེད་༎ གཞོན་ནུ་མཐུ་ཐོབ་རྣམས་ལ་མ་ཡིན་ལྟར་༎
 ekāgracitte sthitabodhisatve saṃsārasaṃsthe ghaṭamānabodhaye |	བྱང་ཆུབ་སེམས་དཔའ་རྩེ་གཅིག་སེམས་གནས་ཤིང་༎
 janenti tasya spṛha devanāgā na śrāvakeṣu trivimokṣadhyāyiṣu ||	འཁོར་བར་གནས་ཏེ་བྱང་ཆུབ་ཚོལ་བྱེད་པ་༎ དེ་ལ་ལྷ་དང་ཀླུ་རྣམས་རེ་བ་བསྐྱེད་༎ རྣམ་ཐར་བརྒྱད་དང་བསམ་གཏན་བྱེད་ལ་མིན་༎ འོད་སྲུང་། འདི་ལྟ་སྟེ་། དཔེར་ན་། ནོར་བུ་རིན་པོ་ཆེ་བེཨེ་དའུརྱ་གཅིག་གིས་མཆིང་བུའི་ནོར་བུའི་ཕུང་པོ་རི་རབ་ཙམ་ཟིལ་གྱིས་གནོན་ཏེ་། འོད་སྲུང་། དེ་བཞིན་དུ་བྱང་ཆུབ་སེམས་དཔའ་སེམས་དང་པོ་བསྐྱེད་པས་ཀྱང་ཉན་ཐོས་དང་རང་སངས་རྒྱས་ཐམས་ཅད་ཟིལ་གྱིས་གནོན་ཏོ་༎ དེ་ལ་འདི་སྐད་ཅེས་བྱ་སྟེ་། དཔེར་ན་འོད་གསལ་རིན་ཆེན་བེཨེདའུརྱས་༎ ༄༢༣༧ཨ་༌༎ མཆིང་བུའི་ནོར་བུ་མང་པོ་ཟིལ་གྱིས་གནོན་༎ བྱང་ཆུབ་སེམས་དཔའ་ཐོག་མར་སེམས་བསྐྱེད་པས་༎ ཉན་ཐོས་སྟོང་ཡང་དེ་ལྟར་ཟིལ་གྱིས་གནོན་༎ འོད་སྲུང་།
 kp|84 tadyathāpi nāma kāśyapa karaviṅkapotaka āṇḍakośaprakṣipataḥ anirbhinne nayane sarvapakṣigaṇam abhibhavati |	འདི་ལྟ་སྟེ་། དཔེར་ན་། བྱ་ཀ་ལ་པིང་ཀའི་ཕྲུག་གུ་སྒོ་ངའི་སྦུབས་ན་འདུག་པ་མིག་མ་བྱེ་བ་ཡང་འདི་ལྟ་སྟེ་། 
 yaduta gambhīramadhuranirghoṣarutaravitet |	ཟབ་ཅིང་སྙན་བའི་སྒྲ་སྐད་ཀྱིས་བྱའི་ཚོགས་ཐམས་ཅད་ཟིལ་གྱིས་གནོན་ཏོ་༎
 evameva kāśyapaḥ prathamacittotpādiko bodhisattvo avidyāṇḍakośaprakṣipta karmakleśatamastimirapaṭalaparyavanaddhaḥnayano 'pi sarvaśrāvakapratyekabuddhām abhibhavati |	འོད་སྲུང་། དེ་བཞིན་དུ་བྱང་ཆུབ་སེམས་དཔའ་སེམས་དང་པོ་བསྐྱེད་པ་མ་རིག་པའི་སྒོ་ངའི་སྦུབས་ན་འདུག་པ་ལས་དང་ཉོན་མོངས་པའི་མུན་པ་དང་། རབ་རིབ་ཀྱི་ལིང་ཏོག་གིས་མིག་ཁེབས་པ་ཡང་འདི་ལྟ་སྟེ་།
 yaduta kuśalamūlapariṇāmanāprayoganirhārarutaravitena 20 ||	དགེ་བའི་རྩ་བ་ཡོངས་སུ་བསྔོ་བའི་སྦྱོར་བའི་སྒྲ་སྐད་ཀྱིས་ཉན་ཐོས་དང་། རང་སངས་རྒྱས་ཐམས་ཅད་ཟིལ་གྱིས་གནོན་ཏོ་༎ འོད་སྲུང་།
 tadyathāpi nāma kāśyapa rājñaścakravartina agramahiṣyā tatkṣaṇajātaṃ kumāraṃ sarvaśreṣṭhinaigamajānapatayaḥ koṭṭarājānaśca namasyantyevameva kāśyapa prathamacittotpādiko bodhisattvaḥ sadevako loko namaskaronti 21 ||	འདི་ལྟ་སྟེ་། དཔེར་ན་། འཁོར་ལོས་བསྒྱུར་བའི་རྒྱལ་པོའི་བཙུན་མོ་དམ་པ་ལས་གཞོན་ནུ་འཁོར་ལོས་བསྒྱུར་བའི་མཚན་དང་ལྡན་པ་བཙས་མ་ཐག་ཏུ་ཚོང་དཔོན་དང་། གྲོང་རྡལ་གྱི་མི་དང་། ཡུལ་གྱི་མི་ཐམས་ཅད་དང་། རྒྱལ་ཕྲན་ཐམས་ཅད་ཕྱག་འཚལ་བར་འགྱུར་རོ་༎
 kp|85 tadyathāpi nāma kāśyapa ekaṃ vaiḍuryaṃ maṇiratnaṃ sumerumātraṃ rāśi kācamaṇikānabhibhavati	འོད་སྲུང་།
 evameva kāśyapa prathamacittotpādiko bodhisattvaḥ sarvaśrāvakapratyekabuddhān abhibhavati |	དེ་བཞིན་དུ་བྱང་ཆུབ་སེམས་དཔའ་སེམས་དང་པོ་བསྐྱེད་པ་ལ་ཡང་ལྷ་དང་བཅས་པའི་འཇིག་རྟེན་ཕྱག་འཚལ་ལོ་༎ 
 tatredamucyate 22 || yathāpi vaiḍūryamaṇi prabhāsvaraḥ kācāmaṇīn abhibhavate prabhūtān | imeva citte prathame bodhisattvo abhībhavati pṛthakcchrāvakān guṇān ||	དེ་ལ་འདི་སྐད་ཅེས་བྱ་སྟེ་།
 kp|86 tadyathāpi nāma kāśyapa rājño gramahiṣyāḥ tatkṣaṇajātaṃ kumāra sarvaśreṣṭhinaigamajānapadā koṭṭarājānaśca namasyanti | evameva kāśyapa prathamacittotpādiko bodhisattvaḥ sadevako loko namasyanti | tatredamucyate 23	དཔེར་ན་ས་བདག་ཆེན་པོ་རྒྱལ་པོ་ལ་༎
 || yathāpi rājña pṛthivīśvarasya putro bhavellakṣaṇacitritāṅgaṃ	མཚན་གྱིས་ལུས་སྤྲས་བུ་ཞིག་ཡོད་གྱུར་ན་༎
 dṛṣtveva taṃ jātamātraṃ kumāraṃ sakoṭṭarājā praṇamanti paurāḥ	གཞོན་ནུ་དེ་ནི་བཙས་པར་མཐོང་མ་ཐག་། གྲོང་༄༢༣༧བ་ཁྱེར་མི་དང་རྒྱལ་ཕྲན་ཐམས་ཅད་འདུད་༎ དེ་བཞིན་བྱང་ཆུབ་སེམས་ནི་བསྐྱེད་མ་ཐག་།
 utpannamātre tathā bodhisatve sallakṣaṇaṃ taṃ jinarājaputraṃ lokassadevo 'pi namaskaronti prasannacittaṃ bahumānapūrvaṃ ||	མཚན་ལྡན་རྒྱལ་བའི་སྲས་པོ་དེ་ལ་ནི་༎ ལྷ་དང་བཅས་པའི་འཇིག་རྟེན་ཕག་འཚལ་ཞིང་༎ དང་པོའི་སེམས་ཀྱིས་ཤིན་ཏུ་གཅེས་པར་འཛིན་༎ འོད་སྲུང་།
 kp|87 tadyathāpi nāma kāśyapa yāni himavantaḥ parvatarājā bhaiṣajyāni virohanti sarvānyamamānyaparigrahānyavikalpāni |	འདི་ལྟ་སྟེ་། དཔེར་ན་། རིའི་རྒྱལ་པོ་གངས་རི་ལ་སྨན་གང་དག་སྐྱེ་བ་དེ་དག་ཐམས་ཅད་ནི་ང་ཡིར་བྱ་བ་མེད་། རིས་སུ་བཅས་པ་མེད་། རྣམ་པར་རྟོག་པ་མེད་དེ་།
 yatra ca punarvyādhyā vyumpanāmyante taṃ vyādhiṃ praśamayanti |	ནད་གང་ལ་བཏང་ཡང་ནད་དེ་རབ་ཏུ་ཞི་བར་བྱེད་དོ་༎
 evameva kāśyapa prathamacittotpādiko bodhisattvo yajñānabhaiṣajyaṃ samudānayati tatsarva nirvikalpa samudānayati samacittatā sarvasattveṣu cikitsā prayati |	འོད་སྲུང་། དེ་བཞིན་དུ་བྱང་ཆུབ་སེམས་དཔའ་ཡེ་ཤེས་ཀྱི་སྨན་གང་ཡང་དག་པར་སྒྲུབ་པ་དེ་ཐམས་ཅད་རྣམ་པར་མི་རྟོག་པར་སྒྲུབ་ཅིང་། སེམས་ཅན་ཐམས་ཅད་ལ་སྙོམས་པའི་སེམས་ཀྱིས་གསོ་བར་རབ་ཏུ་སྦྱོར་རོ་༎
 tatredamucyate 24	དེ་ལ་འདི་སྐད་ཅེས་བྱ་སྟེ་།
 || himavanta ye paravatarāja bheṣajā rohanti te nirmamanirvikalpā |	དཔེར་ན་རི་རྒྱལ་གངས་ཀྱི་རི་བོ་ལ་༎ སྨན་སྐྱེས་དེ་དག་མི་རྟོག་ངར་འཛིན་མེད་༎ གང་ལ་བཏང་བ་དེ་ཀུན་ཞི་བར་བྱེད་༎
 yatropanāmyanti ca taṃ śamenti vyādhiṃ jarā cāpanayanti kecit	ཁ་ཅིག་ནད་དང་རྒ་བའང་སེལ་བར་བྱེད་༎
 jinātmajāpi samudānayanti yaṃ jñānabhaiṣajya vikalpa muktvā |	དེ་བཞིན་རྒྱལ་བའི་སྲས་པོ་ཡེ་ཤེས་སྨན་༎
 hitārtha sarvaṃ samudānayanti samacitta sattveṣu cikitsa kurvan ||	ཡང་དག་སྒྲུབ་པའང་རྣམ་པར་རྟོག་སྤངས་ནས༏་༏སེམས་ཅན་ཐམས་ཅད་ཕན་ཕྱིར་ཡང་དག་སྒྲུབ་༎ སྙོམས་པའི་སེམས་ཀྱིས་སེམས་ཅན་གསོ་བར་བྱེད་༎ འོད་སྲུང་། འདི་ལྟ་སྟེ་།
 kp|88 tadyathāpi nāma kāśyapa navacandro namaskṛyate sā pūrṇacandro na tathā namaskṛyate |	དཔེར་ན་། ཟླ་བ་ཚེས་པ་ལ་ཕྱག་འཚལ་བ་ལྟར་ཉ་བ་ལ་ནི་མ་ཡིན་ནོ་༎ འོད་སྲུང་།
 evameva kāśyapa ye mama śraddadhanti te balavantataraṃ bodhisattvaṃ namaskartavya |	དེ་བཞིན་དུ་གང་དག་ང་ལ་རབ་ཏུ་དད་པ་དེ་དག་གིས་བྱང་ཆུབ་སེམས་དཔའ་རྣམས་ལ་ཕྱག་བྱའི་༎ དེ་བཞིན་གཤེགས་པ་རྣམས་ལ་ནི་དེ་ལྟ་མ་ཡིན་ནོ་༎ དེ་༄༢༣༨ཨ་༌༎
 na tathāgata tatkasya heto bodhisattvanirjātā hi tathāgatāḥ tatredamucyate 25	ཅིའི་ཕྱིར་ཞེ་ན་། བྱང་ཆུབ་སེམས་དཔའ་ལས་ནི་དེ་བཞིན་གཤེགས་པ་རྣམས་བྱུང་ངོ་༎ དེ་བཞིན་གཤེགས་པ་ལས་ནི་ཉན་ཐོས་དང་། རང་སངས་རྒྱས་ཐམས་ཅད་འབྱུང་ངོ་༎ དེ་ལ་འདི་སྐད་ཅེས་བྱ་སྟེ་།
 || candraṃ navaṃ sarva namaskaronti tameva pūrṇaṃ na namaskaronti |	ཟླ་བ་ཚེས་ལ་ཐམས་ཅད་ཕྱག་འཚལ་གྱི་༎ ཟླ་བ་ཉ་ལ་དེ་ལྟར་ཕྱག་མི་འཚལ་༎ དེ་བཞིན་གང་དག་ང་དང་དེ་དག་གིས་༎
 imeva yaḥ śraddadhatai jinātmajo sa bodhisattvaṃ namatā jinā na tu | ||	རྒྱལ་སྲས་བྱང་ཆུབ་སེམས་དཔའ་ཕྱག་འཚོལ་ཅིག་། འོད་སྲུང་།
 kp|89 tadyathāpi nāma kāśyapa mātrikā sarvaśāstragrahaṇajñāne pūrvaṅgamā |	འདི་ལྟ་སྟེ་། དཔེར་ན་། ཡི་གེའི་ཕྱི་མོ་རྣམས་ནི་བསྟན་བཅོས་ཐམས་ཅད་འཛིན་པ་ཤེས་པའི་སྔོན་དུ་འགྲོའོ་༎
 evameva kāśyapa prathamacittotpādiko bodhisattvaḥ sarvabuddhavikurvitādhiṣṭhāne 'nuttare pūrvaṅgamaḥ ||	འོད་སྲུང་། དེ་བཞིན་དུ་བྱང་ཆུབ་སེམས་དཔའ་སེམས་དང་པོ་བསྐྱེད་པ་ཡང་སངས་རྒྱས་ཀྱི་རྣམ་པར་སྤྲུལ་པ་དང་། བྱིན་གྱི་རླབས་ཐམས་ཅད་འཛིན་པའི་ཡེ་ཤེས་བླ་ན་མེད་པའི་སྔོན་དུ་འགྲོའོ་༎ འོད་སྲུང་། འདི་ལྟ་སྟེ་།
 kp|90 tadyathāpi nāma kāśyapa na jātu kenaciccandramaṇḍalam utsṛjya tārakarūpaṃ namaskṛta pūrvaṃ |	དཔེར་ན་། ཟླ་བའི་དཀྱིལ་འཁོར་བཏང་སྟེ་། སུ་ཡང་སྐར་མའི་གཟུགས་ལ་ནམ་ཡང་སྔོན་ཕྱག་མ་བྱས་སོ་༎ འོད་སྲུང་། དེ་བཞིན་དུ་མཁས་པ་རྣམས་ཀྱང་བྱང་ཆུབ་སེམས་དཔའ་བདག་ལ་ཕན་པ་དང་། གཞན་ལ་ཕན་པ་སྙིང་རྗེ་ཆེན་པོ་དང་ལྡན་པ་ངའི་བསླབ་པ་ལ་ཞུགས་པ་བཏང་སྟེ་།
 evameva kāśyapa na jātu paṇḍito mama śikṣāpratipanna bodhisattvaṃ riñcitvā śrāvakaṃ namaskaroti |	ཉན་ཐོས་ལ་ནམ་ཡང་ཕྱག་མི་འཚལ་ལོ་༎
 tatredamucyate 26	དེ་ལ་འདི་སྐད་ཅེས་བྱ་སྟེ་།
 || na kenaci candra vivarjayi tvā namaskṛtā tāragaṇā kadācit |	སུས་ཀྱང་ཟླ་བ་རྣམ་པར་སྤངས་ནས་སུ་༎ སྐར་མའི་ཚོགས་ལ་ནམ་ཡང་ཕྱག་མ་བྱས་༎
 na jātu śikṣāpratipanna evaṃ mamātmajaṃ tyaja nameta śrāvakaḥ ||	དེ་བཞིན་བསླབ་ལ་ཞུགས་པ་ནམ་དུ་ཡང་༎ ང་སྲས་བཏང་སྟེ་ཉན་ཐོས་ཕྱག་མི་འཚལ་༎ འོད་སྲུང་། འདི་༄༢༣༨བ་ལྟ་སྟེ་།
 kp|91 tadyathāpi nāma kāśyapa sadevako loko kācamaṇikasya parikarma kuryāt na jātu sa kācamaṇiko vaiḍūryamaṇiratno bhaviṣyati |	དཔེར་ན་། ལྷ་དང་བཅས་པའི་འཇིག་རྟེན་གྱིས་མཆིང་བུའི་ནོར་བུ་བྱི་དོར་བྱས་ཀྱང་། མཆིང་བུའི་ནོར་བུ་ནམ་ཡང་ནོར་བུ་རིན་པོ་ཆེ་བེཨེ་དའུར+ཡར་མི་འགྱུར་རོ་༎
 evameva kāśyapa sarvaśīlaśikṣādhutaguṇasamādhisamanvāgato 'pi śrāvako na jātu sa bodhimaṇḍe niṣadyānuttarā samyaksambodhimabhisambotsyate |	འོད་སྲུང་། དེ་བཞིན་དུ་ཉན་ཐོས་ཚུལ་ཁྲིམས་དང་། བསླབ་པ་དང་། སྦྱངས་པའི་ཡོན་ཏན་དང་། ཡོ་བྱད་བསྙུངས་པ་དང་། ཏིང་ངེ་འཛིན་ཐམས་ཅད་དང་ལྡན་ཡང་བྱང་ཆུབ་ཀྱི་སྙིང་པོར་འདུག་སྟེ་། བླ་ན་མེད་པ་ཡང་དག་པར་རྫོགས་པའི་བྱང་ཆུབ་ཏུ་མངོན་པར་རྫོགས་པར་འཚང་རྒྱ་བར་ནམ་ཡང་མི་འགྱུར་རོ་༎
 tatredamucyate 27	དེ་ལ་འདི་སྐད་ཅེས་བྱ་སྟེ་།
 || yathāpi loko parikarma kuryās sadevakaḥ kācamaṇisya śuddhaye |	དཔེར་ན་ལྷ་དང་བཅས་པའི་འཇིག་རྟེན་གྱིས་༎ མཆིང་བུའི་ནོར་བུ་བྱི་དོར་བྱས་ཀྱང་ནི་༎ མཆིང་བུ་དག་སྟེ་བེཨེ་དའུརྱར་མི་འགྱུར་༎
 na kāca vaiḍūrya kadāci bheṣyate anyādṛśī tasya sadeva jātiḥ	འདི་འདྲ་དེ་ཉིད་དེ་ཡི་རང་བཞིན་ཡིན་༎
 evaṃ hi śīlāśrutaddhyānayukto yaḥ śrāvaka sarvaguṇānvito 'pi |	དེ་བཞིན་ཉན་ཐོས་ཁྲིམས་དང་ཐོས་པ་དང་༎ བསམ་གཏན་ལྡན་ཞིང་སྦྱངས་པ་ཀུན་ལྡན་ཡང་༎
 na bodhimaṇḍasthita māra jitvā bodhiṃ spṛśitvā sugato bhaviṣyati ||	བྱང་ཆུབ་སྙིང་པོར་འདུག་སྟེ་བདུད་བཏུལ་ནས་༎ བྱང་ཆུབ་རེག་སྟེ་བདེ་གཤེགས་འགྱུར་བ་མེད་༎ འོད་སྲུང་།
 kp|92 tadyathāpi nāma kāśyapa vaiḍūryasya mahāmaṇiratnasya parikarma kriyamāṇairbahuṇām tatra karṣāpaṇaśatasahasrāṇām āyadvāraṃ bhavati |	འདི་ལྟ་སྟེ་། དཔེར་ན་། ནོར་བུ་རིན་པོ་ཆེ་བེཨེ་དའུརྱ་བྱི་དོར་བྱས་ན་དེ་ཀར་ཤ་པ་ནི་བརྒྱ་སྟོང་མང་པོ་འབྱུང་བའི་སྒོར་འགྱུར་རོ་༎
 evameva kāśyapa yatra bodhisattvasya parikarma kriyamāṇe bahūnāṃ tatra śrāvakapratyekabuddhaśatasahasrāṇām āyadvāraṃ bhavati |	འོད་སྲུང་། དེ་བཞིན་དུ་བྱང་ཆུབ་སེམས་དཔའི་ཡོན་ཏན་གྱི་བྱི་དོར་བྱས་ན་དེ་ཉན་ཐོས་དང་། རང་སངས་རྒྱས་བརྒྱ་སྟོང་མང་པོ་འབྱུང་བའི་སྒོར་འགྱུར་རོ་༎
 tatredamucyate 28	དེ་ལ་འདི་སྐད་ཅེས་བྱ་སྟེ་།
 || vaiḍūryaratne parikarmanīyante karṣāpaṇānāṃ ca bahu āyu bhoti |	རིན་ཆེན་བེཨེ་དའུརྱ་ནི་སྦྱངས་བྱས་ན་༎ ཀར་ཤ་པ་ན་མང་པོ་འབྱུང་བར་འགྱུར་༎ དེ་བཞིན་སངས་རྒྱས་སྲས་ཀྱིས་སྦྱངས་བྱས་ན་༎
 buddhorasānāṃ parikarmaṇaṃ tathā āyo bahūnāṃ śrāvakānāṃ tatheva | 30 ||	༄༢༣༩ཨ་༌༎ ཉན་ཐོས་མང་པོ་འབྱུང་བའི་སྒོར་འགྱུར་རོ་༎
 kp|93 atha khalu bhagavān punarevāyuṣmantaṃ mahākāśyapam āmantrayati sma |	དེ་ནས་ཡང་བཅོམ་ལྡན་འདས་ཀྱིས་ཚེ་དང་ལྡན་པ་འོད་སྲུང་ཆེན་པོ་ལ་བཀའ་སྩལ་པ་། འོད་སྲུང་། ཡུལ་གང་དུ་སྲིན་བུ་རྔ་མོ་དུད་ཀ་ཞེས་བྱ་བ་མགོ་ནག་གན་རྐྱལ་དུ་ཉལ་བ་བྱུང་ན་ཡུལ་དུ་འཇིགས་པ་དང་བཅས་། འཚེ་བ་དང་བཅས་།
 yasmiṃ kāśyapa deśe uṣṭradhūmaka kṛṣṇaśira uttānaśāyī bhavati sa deśa sopadravaḥ sopakleśa sopāyāso bhavati |	ཉེ་བའི་ཉོན་མོངས་པ་དང་བཅས་། འཁྲུག་པ་དང་བཅས་པར་འགྱུར་རོ་༎ འོད་སྲུང་།
 sacetpuna kāśyapa yasmiṃ deśe bodhisattvo bhavati | sa deśa nirupadrava nirupakleśa nirupāyāso bhavati |	གལ་ཏེ་ཡུལ་དེར་བྱང་ཆུབ་སེམས་དཔའ་བྱུང་ན་ཡུལ་དེ་འཇིགས་པ་མེད་པ་དང་། འཚེ་བ་མེད་པ་དང་། ཉེ་བའི་ཉོན་མོངས་པ་མེད་པ་དང་། འཁྲུག་པ་མེད་པར་འགྱུར་རོ་༎
 tasmāttarhi kāśyapa sattvārthodyuktena bodhisattvena bhavitavyaṃ tena sarvakuśalamūlāni sarvasattvānām utsraṣṭavyaṃ |	འོད་སྲུང་། དེ་ལྟ་བས་ན་བྱང་ཆུབ་སེམས་དཔས་སེམས་ཅན་གྱི་དོན་ལ་བརྩོན་པ་སྟེ་། དེས་དགེ་བའི་རྩ་བ་ཐམས་ཅད་ཡང་དག་པར་བསྒྲུབ་པ་བྱའོ་༎
 sarvaṃ ca kuśalamūla samyaksamudānayitavyaṃ |	དགེ་བའི་རྩ་བ་ཐམས་ཅད་ཡང་དག་པར་བསྒྲུབས་ནས་སེམས་ཅན་ཐམས་ཅད་ལ་གཏང་བར་བྱའོ་༎
 yaśca jñānabheṣajyaṃ paryeṣate tena caturdiśam gatvā sarvasattvānāṃ bhūtacikitsā kartavyāḥ bhūtacikitsāyā cca sattvā cikitsitavyāḥ	ཡེ་ཤེས་ཀྱི་སྨན་གང་ཚོལ་བ་དེས་ཕྱོགས་བཞིར་སོང་སྟེ་། སེམས་ཅན་རྣམས་ལ་ཡང་དག་པའི་གསོ་བར་བྱའོ་༎ ཡང་དག་པའི་གསོ་བས་སེམས་ཅན་རྣམས་གསོ་བར་བྱའོ་༎
 kp|94 tatra kāśyapaḥ katamā bhūtacikitsāḥ yaduta rāgasya aśubhā cikitsā | dveṣasya maitrī cikitsāḥ mohasya pratītyasamutpādapratyavekṣaṇā cikitsāḥ sarvadṛṣṭīgatānāṃ	འོད་སྲུང་། དེ་ལ་ཡང་དག་པའི་གསོ་བ་གང་ཞེ་ན་། འདེ་ལྟ་སྟེ་།
 śūnyatā cikitsāḥ sarvakalpavikalpaparikalpārambhaṇavitarkamanasīkārāṇām ānimitta cikitsāḥ sarvakāmadhāturūpadhātvārūpyadhātuprahāṇāyām apraṇihita cikitsāḥ sarvaviparyāsānā catvāro viparyāsa cikitsāḥ anitye nityasañjñāyāḥ anityāḥ sarvasaṃskārā iti cikitsāḥ	འདོད་ཆགས་ལ་མི་སྡུག་པ་དང་། ཞེ་སྡང་ལ་བྱམས་པ་དང་། གཏི་མུག་ལ་རྟེན་ཅིང་འབྲེལ་བར་འབྱུང་བ་དང་། ལྟ་བར་གྱུར་པ་ཐམས་ཅད་ལ་སྟོང་པ་ཉིད་དང་། རྟོག་པ་དང་། རྣམ་པར་རྟོག་པ་དང་། མཚན་མའི་དམིགས་པ་ཡིད་༄༢༣༩བ་ལ་བྱེད་པ་ཐམས་ཅད་ལ་མཚན་མ་མེད་པ་དང་། འདོད་པའི་ཁམས་དང་། གཟུགས་ཀྱི་ཁམས་དང་། གཟུགས་མེད་པའི་ཁམས་ཐམས་ཅད་ལ་གནས་པ་སྤང་བའི་ཕྱིར་སྨོན་པ་མེད་པ་དང༏་ཕྱིན་ཅི་ལིག་ཐམས་ཅད་སྤང་བའི་ཕྱིར་ཕྱིན་ཅི་མ་ལོག་པ་བཞི་སྟེ་། བཞི་གང་ཞེན་ན་།
 duḥkhe sukhasañjñāyā duḥkhā sarvasaṃskārā iti cikitsāḥ anātmīye ātmīyasañjñāyā anātmāna sarvadharmā iti cikitsāḥ aśubhe śubhasañjñāyāḥ śāntaṃ nirvāṇam iti cikitsāḥ kp|95 catvāri smṛtyupasthānāni kāyevedanācittadharmasanniśritānāṃ cikitsāḥ kāye kāyānupasyī viharati na ca kāye kāyānupāśyanāyām ātmyadṛṣṭyāṃ patati |	མི་རྟག་པ་ལ་རྟག་པར་འདུ་ཤེས་པ་ལ་འདུ་བྱེད་ཐམས་ཅད་མི་རྟག་པ་དང་། སྡུག་བསྔལ་བ་ལ་བདེ་བར་འདུ་ཤེས་པ་ལ་འདུ་བྱེད་ཐམས་ཅད་སྡུག་བསྔལ་བ་དང་། བདག་མེད་པ་ལ་བདག་ཏུ་འདུ་ཤེས་པ་ལ་ཆོས་ཐམས་ཅད་ལ་བདག་མེད་པ་དང་། མི་སྡུག་པ་ལ་སྡུག་པར་འདུ་ཤེས་པ་ལ་མྱ་ངན་ལས་འདས་པ་ཞི་བས་གསོ་བ་དང་། ལུས་དང་། ཚོར་བ་དང་། སེམས་དང་། ཆོས་ལ་གནས་པ་རྣམས་ལ་དྲན་པ་ཉེ་བར་བཞག་པ་བཞི་སྟེ་།
 vedanāyāṃ vedanānupaśyī viharati na ca vedanānupaśyanāyā ātmadṛṣṭīgatena patati | citte cittānupaśyī viharati na ca cittānupaśyanāyāṃ jīvadiṣṭīye patati | dharme dharmānupaśyī viharati na ca dharmānupaśyanāyāṃ pudgaladṛṣṭīye patati | catvāri samyakprahāṇāni sarvākuśaladharmaprahāṇāya cikitsā | sarvakuśaladharmapāripūryaiḥ saṃvartante |	དེ་ལ་ལུས་ལ་ལུས་ཀྱི་རྗེས་སུ་ལྟ་བ་ཅན་དུ་གནས་ཀྱང་ལུས་ཀྱི་རྗེས་སུ་ལྟ་བས་བདག་ཏུ་ལྟ་བར་མི་ལྟུང་བ་དང་། ཚོར་བ་རྣམས་ལ་ཚོར་བའི་རྗེས་སུ་ལྟ་བ་ཅན་གནས་ཀྱང་ཚོར་བའི་རྗེས་སུ་ལྟ་བས་བདག་ཏུ་ལྟ་བར་མི་ལྟུང་བ་དང་། སེམས་ལ་སེམས་ཀྱི་རྗེས་སུ་ལྟ་བ་ཅན་དུ་གནས་ཀྱང་སེམས་ཀྱི་རྗེས་སུ་ལྟ་བས་བདག་ཏུ་ལྟ་བར་མི་ལྟུང་བ་དང་། ཆོས་ལ་ཆོས་ཀྱི་རྗེས་སུ་ལྟ་བ་ཅན་དུ་གནས་ཀྱང་ཆོས་ཀྱི་རྗེས་སུ་ལྟ་བས་བདག་ཏུ་ལྟ་བར་མི་ལྟུང་བས་གསོ་བ་དང་། ཡང་དག་པའི་སྤོང་བ་བཞིས་ནི་མི་དགེ་བའི་ཆོས་ཐམས་ཅད་སྤོང་བ་དང་། དགེ་བའི་ཆོས་ཐམས་ཅད་ཡོངས་སུ་རྫོགས་པར་འགྱུར་བ་དང་། རྫུ་འཕྲུལ་༄༢༤༠ཨ་༌༎
 catvāro dṛddhipādāḥ kāyacittapiṇḍagrāhotsargāya saṃvate | cikitsāḥ pañcendriyāṇi pañca balāni aśrādvyakausīdyamuṣitasmṛticittavikṣepaasamprajanyatāduṣprajñātācikitsāḥ sapta bodhyaṅgāni dharmasamūhājñānasya cikitsāḥ āryāṣṭāṅgo mārga dauṣprajñāsarvaparapravādināṃ	གྱི་རྐང་པ་བཞིས་ནི་ལུས་དང་སེམས་ལ་རིལ་པོར་འཛིན་པ་འདོར་བར་འགྱུར་བ་དང་། དབང་པོ་ལྔ་དང་། སྟོབས་ལྡས་ནི་མ་དད་པ་དང་། ལེ་ལོ་དང་། བརྗེད་ངས་པ་དང་། རྣམ་པར་ག-ཡེང་བ་དང་། ཤེས་བཞིན་མེད་པ་རྣམས་གསོ་བ་དང་། བྱང་ཆུབ་ཀྱི་ཡན་ལག་བདུན་གྱིས་ནི་ཆོས་ལ་ཤིན་ཏུ་རྨོངས་ཤིང་མི་ཤེས་པ་གསོ་བ་དང་༎ འཕགས་པའི་ལམ་ཡན་ལག་བརྒྱད་པས་ནི་འཆལ་བའི་ཤེས་རབ་དང་། ཕས་ཀྱིས་རྒོལ་བ་ཐམས་ཅད་དང་། ལམ་ངན་པར་ཞུགས་པ་རྣམས་གསོ་བ་སྟེ་། འོད་སྲུང་།
 kumārgapratipannānāṃ cikitsāḥ iyamucyate kāśyapa bhūtacikitsāḥ tatra kāśyapa bodhisattvena yogaḥ karaṇīyaḥ	འདི་ནི་ཡང་དག་པའི་གསོ་བ་ཞེས་བྱའོ་༎ འོད་སྲུང་། བྱང་ཆུབ་སེམས་དཔས་གསོ་བ་འདི་ལ་བསླབ་པར་བརྩོན་པར་བྱའོ་༎
 kp|96 yāvanta kāśyapa jāmbudvīpe vaidyā vā vaidyāntevāsino vā sarveṣāṃ teṣām jivako vaidyarājā agro mākhyāyate |	འོད་སྲུང་། འཛམ་བུ་གླིང་ན་སྨན་པ་དང་། སྨན་པའི་སློབ་མ་ཇི་སྙེད་ཡོད་པ་དེ་དག་གི་ནང་ན་འཚོ་བྱེད་ནི་མཆོག་ཅེས་བྱའོ་༎
 yāvantaḥ kāśyapa trisāhasramahāsāhasrāyāṃ lokadhātau sattvāḥ te sarve jīvakavaidyarājasadṛśā bhaveyuḥ te sarve paripṛccheran |	འོད་སྲུང་། གལ་ཏེ་སྟོང་གསུམ་གྱི་སྟོང་ཆེན་པོའི་འཇིག་རྟེན་གྱི་ཁམས་ཀྱི་སེམས་ཅན་ཇི་སྙེད་པ་དེ་དག་ཐམས་ཅད་སྨན་པའི་རྒྱལ་པོ་འཚོ་བྱེད་དང་འདྲ་བར་གྱུར་ཀྱང་། 
 dṛṣṭkaukṛtyapratiṣṭhitasya prapatitasya kiṃ bhaiṣajyam iti |	དེ་དག་ལ་ལ་ལ་ཞིག་ལྟ་བ་དང་། འགྱོད་པ་ལ་གནས་པ་གསོ་བའི་སྨན་གང་ཡིན་ཞེས་དྲིས་ན་།
 te na samarthā na ca śaknoti tam artha ākhyātuṃ vā nirdeṣṭuṃ vā jñānavijñātā vā |	དེ་དག་གི་ཤེས་པའམ་། བསྟན་པའམ་། བསྒོ་བར་མི་ནུས་སོ་༎ འོད་སྲུང་།
 tatra kāśyapa bodhisattvenaivam upaparikṣitavya na mayā lokikabhaiṣajyasantuṣṭirveditavyā |	དེ་ལ་བྱང་ཆུབ་སེམས་དཔས་འདི་སྙམ་དུ་བདག་ནི་འཇིག་རྟེན་གྱི་སྨན་ཙམ་གྱིས་ཆོག་པར་མི་བྱའི་། 
 lokottara mayā jñānabhaiṣajyaṃ paryeṣṭitavyaṃ sarvakuśalamūlaṃ ca samyaksamudānayitavyam |	བདག་གིས་འཇིག་རྟེན་ལས་འདས་པའི་ཡེ་ཤེས་ཀྱི་སྨན་ཡོངས་སུ་བཙལ་༄༢༤༠བ་བར་བྱའོ་༎
 mityevaṃ copaparīkṣitavyaḥ yacca jñānabhaiṣajyaṃ samudānayitvā tena caturdiśaṃ gatvā sarvasattvānāṃ bhūtacikitsā kartavyāḥ bhūtacikitsayā ca sattvāni cikitsitavyāḥ	དགེ་བའི་རྩ་བ་ཐམས་ཅད་ཀྱང་ལེགས་པར་ཡང་དག་པར་བསྒྲུབ་པར་བྱའོ་སྙམ་དུ་བརྟག་པར་བྱའོ་༎ དེ་ལྟར་བརྟགས་ནས་འཇིག་རྟེན་ལས་འདས་པའི་ཡེ་ཤེས་ཀྱི་སྨན་གང་ཚོལ་བ་དེས་ཕྱོགས་བཞིར་༎ སོང་ལ་། སེམས་ཅན་རྣམས་ལ་ཡང་དག་པའི་གསོ་བ་བྱ་སྟེ་། ཡང་དག་པའི་གསོ་བས་སེམས་ཅན་རྣམས་གསོ་བར་བྱའོ་༎ འོད་སྲུང་།
 kp|97 tatra kataraṃ lokottaraṃ jñānabhaiṣajyaṃ |	དེ་ལ་འཇིག་རྟེན་ལས་འདས་པའི་ཡེ་ཤེས་ཀྱི་སྨན་གང་ཞེ་ན་། འདི་ལྟ་སྟེ་།
 yadidaṃ hetupratyayajñānaḥ nairātmyeniḥsattvaḥnirjīvaniṣpoṣanīṣpudgaleṣu dharmeṣvadhimuktijñānaṃ | śūnyatānupalambheṣu dharmeṣu anutrāsaḥ cittaparigaveṣatāye vīryaṃ |	རྒྱུ་རྐྱེན་ལ་འཇུག་པ་ཤེས་པ་དང་། བདག་མེད་པ་དང་། སེམས་ཅན་མེད་པ་དང་། སྲོག་མེད་པ་དང་། གསོ་བ་མེད་པ་དང་། གང་ཟག་མེད་པའི་ཆོས་རྣམས་ལ་མོས་པའི་ཤེས་པ་དང་། སྟོང་པ་ཉིད་ཀྱིས་མི་དམིགས་པའི་ཆོས་རྣམས་ལ་མི་སྡང་བ་དང་། སེམས་ཅན་ཡོངས་སུ་ཚོལ་བའི་བརྩོན་འགྲུས་སོ་༎
 sa evaṃ cittaṃ parigaveṣate |	དེ་འདི་ལྟར་སེམས་ཡོངས་སུ་ཚོལ་ཏེ་འདོད་ཆགས་པར་འགྱུར་བའམ་།
 kataraṃ cittaṃ rajyati vā duṣyati vā muhyati vā |	ཞེ་སྡང་བར་འགྱུར་བའམ་། གཏི་མུག་པར་འགྱུར་བའི་སེམས་དེ་གང་ཡིན་།
 atītaṃ vā anāgataṃ vā pratyutpannaṃ vā |	ཅི་འདས་པའམ་། མ་འོངས་པའམ་། ད་ལྟར་བྱུང་བ་ཞིག་ཡིན་ནམ༏་དེ་ལ་སེམས་འདས་པ་གང་ཡིན་པ་དེ་ནི་ཟད་པའོ་༎
 yadi tāvad atītaṃ cittaṃ tatkṣīṇaṃ |	མ་འོངས་པ་གང་ཡིན་པ་དེ་ནི་མ་ཕྱིན་པའོ་༎
 yādanāgataṃ cittaṃ tadasamprāptaḥ atha pratyutpannasya cittasya sthitirnāsti |	ད་ལྟར་བྱུང་བ་ནི་གནས་པ་མེད་དོ་སྙམ་མོ་༎
 kp|98 cittaṃ hi kāśyapa na bahirdhā nobhayāyomantarāle upalabhyate |	འོད་སྲུང་། སེམས་ནི་ནང་ན་ཡང་མེད་། ཕྱི་རོལ་ན་ཡང་མེད་། གཉི་ག་ལ་མེད་པར་ཡང་མི་དམིགས་སོ་༎ འོད་སྲུང་།
 cittaṃ hi kāśyapa arūpyanidarśanam apratigham anābhāsam avijñāptikam apratiṣṭhitam	སེམས་ནི་དཔྱད་དུ་མེད་པ་། བསྟན་དུ་མེད་པ་། རྟེན་མ་ཡིན་པ་། སྣང་བ་མེད་པ་། རྣམ་པར་རིག་པ་མེད་པ་༄༢༤༡ཨ་༌༎ གནས་མེད་པའོ་༎ འོད་སྲུང་།
 aniketaḥ cittaṃ hi kāśyapa sarvabuddhairna dṛṣṭaṃ na paśyanti na paśyiṣyanti na drakṣyanti	སེམས་ནི་སངས་རྒྱས་ཐམས་ཅད་ཀྱིས་ཀྱང་མ་གཟིགས་། མི་གཟིགས་། གཟིགས་པར་མི་འགྱུར་རོ་༎
 yatsarvabuddhairna dṛṣtaṃ na paśyanti na drakṣyanti kīdṛśastasya pracāro draṣṭavyaṃ nānyatra vitathaviparyāsapatitāyā santatyā dharmāḥ pravartante 3 cittaṃ hi kāśyapa	ལོག་པར་ཞུགས་པའི་འདུ་ཤེས་ལས་ཆོས་རྣམས་འབྱུང་བ་མ་གཏོགས་པར་སངས་རྒྱས་ཐམས་ཅད་ཀྱིས་ཀྱང་མ་གཟིགས་། མི་གཟིགས་། གཟིགས་པར་མི་འགྱུར་པ་གང་ཡིན་པ་དེའི་རྒྱུ་བ་ཅི་འདྲ་བ་ལྟ་ཞེ་ན་།
 māyāsadṛśamm abhūtaṃ vikalpya vividhopapattiṃ parigṛhṇāti 4 cittaṃ hi kāśyapa vāyusadṛśaṃ	འོད་སྲུང་། སེམས་ནི་སྒྱུ་མ་དང་མཚུངས་ཏེ་། ཡང་དག་པ་མ་ཡིན་པ་ཀུན་བརྟགས་པས་སྐྱེ་བ་རྣམ་པ་མང་པོ་ཡོངས་སུ་འཛིན་ཏོ་༎ འོད་སྲུང་། སེམས་ནི་འབབ་ཆུའི་རྒྱུན་དང་མཚུངས་ཏེ་། མི་གནས་པ་སྐྱེས་ནས་འཇིག་ཅིང་འཇུ་བའོ་༎
 dūraṅgamam agrāhyam apracāra 5 cittaṃ hi kāśyapa nadīsrotasadṛśamm anavastitam utpannaṃ	འོད་སྲུང་། སེམས་ནི་རླུང་དང་མཚུངས་ཏེ་། རིང་དུ་འགྲོ་ཞིང་གཟུང་དུ་མེད་པར་རྒྱུ་བའོ་༎
 bhagnavilīna 6 cittaṃ hi kāśyapa pradīpārciḥsadṛśaṃ hetupratyayatayā pravartate | jvalati ca 7	འོད་སྲུང་། སེམས་ནི་མར་མེའི་འོད་འཕྲོ་བ་དང་མཚུངས་ཏེ༏་རྒྱུ་དང་རྐྱེན་ལས་འབྱུང་བའོ་༎ འོད་སྲུང་། སེམས་ནི་ནམ་མཁའ་དང་མཚུངས་ཏེ་། ཉེ་བའི་ཉོན་མོངས་པ་གློ་བུར་བ་རྣམས་ཀྱིས་ཉེ་བར་ཉོན་མོངས་པའོ་༎
 kp|99 cittaṃ hi kāśyapa vidyusadṛśa kṣaṇabhaṅgāvyavasthitaṃ 8 |	འོད་སྲུང་། སེམས་ནི་གློག་དང་མཚུངས་ཏེ་། སྐད་ཅིག་ཏུ་འཇིག་ཅིང་མི་གནས་པའོ་༎
 cittaṃ hi kāśyapa ākāśasadṛśam āgantukerupakleśe saṅkiśyate 9 cittaṃ hi kāśyapa vānarasadṛśa	འོད་སྲུང་། སེམས་ནི་སྤྲེའུ་དང་མཚུངས་ཏེ་།
 viṣayābhilāṣi vicitrakarmasaṃsthānatayā 10 cittaṃ hi kāśyapa citrakārsadṛśa vicitrakarmābhisaṃskaraṇatayā |	ཡུལ་ཐམས་ཅད་འདོད་པའོ་༎ འོད་སྲུང་། སེམས་ནི་ལས་རྣམ་པ་སྣ་ཚོགས་མངོན་པར་འདུ་བྱེད་པའི་ཕྱིར་རི་མོ་མཁན་དང་མཚུངས་སོ་༎
 11 cittaṃ hi kāśyapa anavasthitaṃ nānākleśapravartanatayā cittaṃ hi kāśyapa ekacaram	འོད་སྲུང་། སེམས་ནི་ཉོན་མོངས་པ་ཐ་དད་པ་འབྱུང་བའི་ཕྱིར་མི་གནས་པའོ་༎ འོད་སྲུང་། སེམས་ནི་གཉིས་པ་མཚམས་༄༢༤༡བ་སྦྱོར་བ་མེད་པའི་ཕྱིར་གཅིག་པུ་རྒྱུ་སྟེ་གཉིས་སུ་མེད་པའོ་༎
 advitīyacittābhisandhānatayā 13 cittaṃ hi kāśyapa rājasadṛśaṃ sarvadharmādhipateyā	འོད་སྲུང་། སེམས་ནི་ཆོས་ཐམས་ཅད་ལ་དབང་བྱེད་པའི་ཕྱིར་རྒྱལ་པོ་དང་མཚུངས་སོ་༎
 14 cittaṃ hi kāśyapa amitrasadṛśaṃ sarvaduḥkhasañjananatayā 15	འོད་སྲུང་། སེམས་ནི་སྡུག་བསྔལ་ཐམས་ཅད་བསྐྱེད་པའི་ཕྱིར་མི་མཛའ་བ་དང་མཚུངས་སོ་༎ འོད་སྲུང་། སེམས་ནི་བདེ་བའི་རྩ་བ་ཐམས་ཅད་འཇིག་པར་བྱེད་པའི་ཕྱིར་བྱེ་མའི་ཁང་པ་དང་མཚུངས་སོ་༎ འོད་སྲུང་།
 kp|100 cittaṃ hi kāśyapa pāṃsvāgārasadṛśam anitye nityasañjñayā 16 cittam hi kāśyapa	སེམས་ནི་མི་རྟག་པ་ལ་རྟག་པར་འདུ་ཤེས་པའི་ཕྱིར་ཟིལ་པ་དང་མཚུངས་སོ་༎
 nīlamakṣikāsadṛśam aśuco śucisañjñāyā 17 cittaṃ hi kāśyapa matsyabaḍīśasadṛśa duḥkhe	འོད་སྲུང་། སེམས་ནི་སྡུག་བསྔལ་ལ་བདེ་བར་འདུ་ཤེས་པའི་ཕྱིར་ཉའི་མཆིལ་པ་དང་མཚུངས་སོ་༎
 sukhasañjñāyā 18 cittaṃ hi kāśyapa svapnasadṛśam anātmīye ātmīyasañjñāyā 19 cittaṃ	འོད་སྲུང་། སེམས་ནི་བདག་མེད་པ་ལ་བདག་ཏུ་འདུ་ཤེས་པའི་ཕྱིར་རྨི་ལམ་དང་མཚུངས་སོ་༎ འོད་སྲུང་། སེམས་ནི་མི་གཙང་བ་ལ་གཙང་བར་འདུ་ཤེས་པའི་ཕྱིར་སྦྲང་མ་སྔོན་པོ་དང་མཚུངས་སོ་༎
 hi kāśyapa pratyarthikasadṛśam vividhakāraṇākaraṇatayā 20 cittaṃ hi kāśyapa ojāhārayakṣasadṛśa	འོད་སྲུང་། སེམས་ནི་གནོད་པ་རྣམ་པ་མང་པོ་བྱེད་པས་ཕྱིར་རྒོལ་བ་དང་མཚུངས་སོ་༎ འོད་སྲུང་།
 sadāvatāragaveṣaṇatayā 21 cittaṃ hi kāśyapa arisadṛśaṃ sadā cchidrārāmagaveṣaṇatayā 22	སེམས་ནི་རྟག་ཏུ་ཀླན་ཀ་ཚོལ་བའི་ཕྱིར་གནོད་སྦྱིན་མདངས་འཕྲོག་པ་དང་མཚུངས་སོ་༎ འོད་སྲུང་། སེམས་ནི་རྟག་ཏུ་གླགས་ལྟ་བས་དགྲ་དང་མཚུངས་པའོ་༎
 kp|101 cittaṃ hi kāśyapa sadā unnatāvanatam anunayapratighopahataṃ 23 cittaṃ hi kāśyapa	འོད་སྲུང་། སེམས་ནི་རྗེས་སུ་ཆགས་པ་དང་ཁོང་ཁྲོ་བ་དང་ལྡན་པས་རྟག་པར་མཐོན་དམན་ཅན་ནོ་༎ འོད་སྲུང་།
 corasadṛśa sarvakuśalamūlamuṣaṇatayā 24 cittaṃ hi kāśyapa rūpārāma pagataṅganetrasadṛśaṃ	སེམས་ནི་དགེ་བའི་རྩ་བ་ཐམས་ཅད་རྐུ་བས་ཆོམ་རྐུན་དང་མཚུངས་སོ་༎ འོད་སྲུང་། སེམས་ནི་གཟུགས་ལ་དགའ་བས་ཕྱི་བྱི་ཞོ་ལའི་མིག་དང་མཚུངས་སོ་༎
 25 cittaṃ hi kāśyapa śabdārāma saṅgrāmabherīsadṛśa 26 cittaṃ hi kāśyapa sadā gandhārāma	འོད་སྲུང་། སེམས་ནི་སྒྲ་༄༢༤༢ཨ་༌༎ ལ་དགའ་བས་ག-ཡུལ་གྱི་རྔ་དང་མཚུངས་སོ་༎
 varāha iva mīḍakuṇape 27 cittaṃ hi kāśyapa rasārāma rasabhojyaceṭīsadṛśaṃ 28 cittaṃ	འོད་སྲུང་། སེམས་ནི་ཕག་མི་གཙང་བའི་དྲི་ལ་དགའ་བ་བཞིན་དུ་དྲི་ལ་དགའོ་༎ འོད་སྲུང་། སེམས་ནི་རོ་ལ་དགའ་བས་ཟས་ཀྱི་ལྷག་མ་ཟ་བའི་བྲན་མོ་དང་མཚུངས་སོ་༎ འོད་སྲུང་།
 hi kāśyapa sparṣārāma makṣikeva tailapātre 29	སེམས་ནི་རེག་པ་ལ་དགའ་བས་སྦྲང་མ་འབྲུ་མར་གྱི་སྣོད་ལ་ཆགས་པ་དང་མཚུངས་སོ་༎ འོད་སྲུང་། སེམས་ནི་ཀུན་དུ་བཙལ་ན་མི་རྙེད་དོ་༎ གང་མི་རྙེད་པ་དེ་མི་དམིགས་པའོ་༎
 kp|102 cittaṃ hi kāśyapa parigaveṣamaṇaṃ na labhyate 30 yanna labhyate tannopalabhyate tannātītaṃ nānāgataṃ na pratyutpannaṃ |	གང་མི་དམིགས་པ་དེ་ནི་འདས་པ་ཡང་མ་ཡིན་། མ་འོངས་པ་ཡང་མ་ཡིན་། ད་ལྟར་བྱུང་བའང་མ་ཡིན་ནོ༏་༏གང་འདས་པ་ཡང་མ་ཡིན་།
 yannātītaṃ nānāgataṃ na pratyutpannaṃ tatradhvasamatikrāntaṃ yatryadhvasamatikrāntaṃ |	མ་འོངས་པ་ཡང་མ་ཡིན་། ད་ལྟར་བྱུང་བ་ཡང་མ་ཡིན་པ་དེ་ནི་དུས་གསུམ་ལས་ཡང་དག་པར་འདས་པའོ་༎ གང་དུས་གསུམ་ལས་ཡང་དག་པར་འདས་པ་དེ་ནི་ཡོད་པ་ཡང་མ་ཡིན་།
 tannaivāsti neva nāsti |	མེད་པ་ཡང་མ་ཡིན་ནོ་༎
 yannaivāsti na nāsti |	གང་ཡོད་པ་ཡང་མ་ཡིན་།
 tadajātaṃ yadajātaṃ |	མེད་པ་ཡང་མ་ཡིན་པ་དེ་ནི་མ་སྐྱེས་པའོ་༎
 tasya nāsti svabhāvaḥ yasya nāsti svabhāvaḥ tasya nāstyutpāda |	གང་མ་སྐྱེས་པ་དེ་ལ་ངོ་བོ་ཉིད་མེད་དོ་༎ གང་ངོ་བོ་ཉིད་མེད་པ་དེ་ལ་འབྱུང་བ་མེད་དོ་༎
 yasya nāstyutpādaḥ tasya nāsti nirodhaḥ yasya nāsti nirodhaḥ tasya nāsti vigamaḥ	གང་འབྱུང་བ་མེད་པ་དེ་ལ་འགག་པ་མེད་དོ་༎ གང་འགག་པ་མེད་པ་དེ་ལ་འབྲལ་བ་མེད་དོ་༎ གང་འབྲལ་བ་མེད་པ་དེ་ལ་འོང་བ་ཡང་མེད་།
 avigamastasyarna gatirnāgatirna cyutirnopapattiḥ yatra na gatirnāgatirna cyutirnopapattiḥ	འགྲོ་བ་ཡང་མེད་། འཆི་འཕོ་ཡང་མེད་། སྐྱེ་བ་ཡང་མེད་དོ་༎ གང་ལ་འོང་བ་ཡང་མེད་། འགྲོ་བ་ཡང་མེད་། འཆི་འཕོ་ཡང་མེད་།
 tatra na kecit saṃskārāḥ yatra na kecit saṃskārāḥ tadasaṃskṛtaṃ |	སྐྱེ་བ་ཡར་མེད་པ་དེ་ལ་འདུ་བྱེད་གང་ཡང་མེད་དོ་༎ ༄༢༤༢བ་གང་ལ་འདུ་བྱེད་གང་ཡང་མེད་པ་དེ་ནི་འདུས་མ་བྱས་པའོ་༎
 tadāryāṇāṃ gotra	གང་འདུས་མ་བྱས་པ་དེ་ནི་འཕགས་པ་རྣམས་ཀྱི་རིགས་སོ་༎
 kp|103 ya 1 āryāṇāṃ gotra | tatrarna śikṣā na niśrayo nāniśrayaḥ yatra na śikṣā na niḥśrayo nāniśrayaḥ tatra	འཕགས་པ་རྣམས་ཀྱི་རིགས་གང་ཡིན་པ་དེ་ལ་བསླབ་པ་མེད་།
 na śikṣāvyatikramaḥ yatra na śikṣāvyatikramaḥ tatra na saṃvaro nāsaṃvaraḥ yatra na saṃvaro nāsaṃvara |	བསླབ་པ་ལས་འདས་པ་ཡང་མེད་དོ་༎ གང་ལ་བསླབ་པ་ཡང་མེད་། བསླབ་པ་ལས་འདས་པ་ཡང་མེད་པ་དེ་ལ་རྒྱུ་བ་ཡང་མེད་།
 tatra na cāro nācāraḥ na pracāraḥ yatra na cāro nācāra na pracāraḥ tatra na cittaṃ	མི་རྒྱུ་བ་ཡང་མེད་། རབ་ཏུ་རྒྱུ་བ་ཡང་མེད་དོ་༎ གང་ལ་རྒྱུ་བ་ཡང་མེད་།
 na cetasikā dharmāḥ yatra na cittaṃ na cetasikā dharmāḥ tatra na mano na vijñānaḥ	མི་རྒྱུ་བ་ཡང་མེད་། རབ་ཏུ་རྒྱུ་བ་ཡང་མེད་པ་དེ་ལ་སེམས་ཀྱང་མེད་། སེམས་ལས་བྱུང་བའི་ཆོས་རྣམས་ཀྱང་མེད་དོ་༎
 yatra na mano na vijñāna |	གང་ལ་སེམས་ཀྱང་མེད་། སེམས་ལས་བྱུང་བའི་ཆོས་རྣམས་ཀྱང་མེད་པ་དེ་ལ་ལས་ཀྱང་མེད་། ལས་ཀྱི་རྣམ་པར་སྨིན་པ་ཡང་མེད་དོ་༎
 tatra na karmo na vipākaḥ yatra na karmo na vipākaḥ tatra na sukhaṃ na duḥkhaṃ yatra	གང་ལ་ལས་ཀྱང་མེད་། ལས་ཀྱི་རྣམ་པར་སྨིན་པ་ཡང་མེད་པ་དེ་ལ་བདེ་བ་ཡང་མེད་། སྡུག་བསྔལ་བ་ཡང་མེད་དོ་༎ གང་ལ་བདེ་བ་ཡང་མེད་།
 na sukhaṃ na duḥkhaṃ tadāryāṇāṃ gotraṃ yadāryānāṃ gotraṃ tatra na karmo na karmābhisaṃskāro	སྡུག་བསྔལ་བ་ཡང་མེད་པ་དེ་ནི་འཕགས་པ་རྣམས་ཀྱི་རིགས་ཏེ་། འཕགས་པ་རྣམས་ཀྱི་རིགས་གང་ཡིན་པ་དེ་ལ་ནི་ལས་ཀྱང་མེད་། ལས་མངོན་པར་འདུ་བྱེད་པ་ཡང་མེད་དོ༏།
 nāpi tatra gotre kāyena karma kṛyate na vācā na manasā |	གང་ལ་ལས་ཀྱང་མེད་། ལས་མངོན་པར་འདུ་བྱེད་པ་ཡང་མེད་པའི་རིགས་དེ་ལ་ནི་ལུས་ཀྱིས་ལས་བྱེད་པ་མེད་དོ་༎ ངག་གིས་མ་ཡིན་། ཡིད་ཀྱིས་མ་ཡིན་ནོ་༎
 nāpi tatra gotre hīnotkṛṣṭamadhyamavyavasthānaṃ samaṃ tadgotram ākāśasamatayā |	རིགས་དེ་ལ་ཐ་མ་དང་། འབྲིང་དང་། མཆོག་ཏུ་རྣམ་པར་བཞག་པ་ཡང་མེད་དོ་༎ དེ་ཅིའི་ཕྱིར་ཞེ་ན་། རིགས་དེ་ནི་ནམ་མཁའ་དང་མཚུངས་པའི་ཕྱིར་མཉམ་པའོ་༎
 nirviśeṣaṃ tadgotraṃ sarvadharmaikarasatayā |	རིགས་དེ་ནི་ཆོས་ཐམས་༄༢༤༣ཨ་༌༎ ཅད་རོ་གཅིག་པའི་ཕྱིར་ཁྱད་པར་མེད་པའོ་༎
 kp|104 viviktaṃ tadgotraṃ kāyacittavivekatayā |	རིགས་དེ་ནི་ལུས་དང་སེམས་དབེན་པའི་ཕྱིར་དབེན་པའོ་༎
 anulomaṃ tadgotraṃ nirvāṇasya |	རིགས་དེ་ནི་མྱ་ངན་ལས་འདས་པ་དང་མཐུན་པའོ་༎
 vimalaṃ tadgotraṃ sarvakleśamalavigata amamaṃ tadgotram ahaṅkāramamakāravigataṃ |	རིགས་དེ་ནི་ཉོན་མོངས་པ་ཐམས་ཅད་ཀྱི་དྲི་མ་དང་བྲལ་བའི་ཕྱིར་དྲི་མ་མེད་པའོ་༎ རིགས་དེ་ནི་ངར་འཛིན་པ་དང་། ང་ཡིར་འཛིན་པ་མེད་པས་ང་ཡི་བ་མེད་པའོ་༎
 aviṣamaṃ tadgotraṃ bhūtābhūtasamatayā niryātaṃ satyaṃ tadgotraṃ paramārthasatyayā |	རིགས་དེ་ནི་ཡང་དག་པ་དང༏་ཡང་དག་པ་མ་ཡིན་པའི་མཉམ་པ་ལས་བྱུང་བ་སྟེ་། མི་མཉམ་པ་མེད་པའོ་༎ རིགས་དེ་ནི་དོན་དམ་པའི་བདེན་པ་ཡིན་པས་བདེན་པའོ་༎
 akṣayaṃ tadgotra atyantatānutpannaṃ | nityaṃ tadgotraṃ sadā dharmatathatayā |	རིགས་དེ་ནི་གཏན་དུ་མི་སྐྱེ་བའི་ཕྱིར་མི་ཟད་པའོ༏་༏རིགས་དེ་ནི་རྟག་ཏུ་ཆོས་ཐམས་ཅད་ཀྱི་དེ་བཞིན་ཉིད་ཀྱི་ཕྱིར་རྟག་པའོ་༎
 aśubhaṃ tadgotraṃ nirvāṇaparamatayā |	རིགས་དེ་ནི་མྱ་ངན་ལས་འདས་པ་མཆོག་གི་ཕྱིར་བདེ་བའོ་༎
 śubhaṃ tadgotraṃ sarvākāramalavigataṃ |	རིགས་དེ་ནི་རྣམ་པ་ཐམས་ཅད་དུ་དྲི་མ་མེད་པའི་ཕྱིར་དགེ་བའོ་༎
 anātmā tadgotram ātmanaḥ parigaveṣyamāṇanupalambhāt |	རིགས་དེ་ནི་བདག་ཡོངས་སུ་བཙལ་ཏེ་མ་རྙེད་པའི་ཕྱིར་བདག་མེད་པའོ་༎
 viśuddhaṃ tadgotram atyantaviśuddhatayā ||	རིགས་དེ་ནི་རབ་ཏུ་རྣམ་པར་དག་པའི་ཕྱིར་རྣམ་པར་དག་པའོ་༎ འོད་སྲུང་།
 kp|105 adhyātmaṃ kāśyapa parimargatha mā bahirvidhāvadhvaṃ |	ནང་དུ་ཡོངས་སུ་ཚོལ་ལ་ཕྱི་རོལ་དུ་མ་རྒྱུག་ཅིག་།
 tatkasmāddhetoḥ bhaviṣyanti kāśyapa anāgate dhvani bhikṣavaḥ śvaloṣṭvānujavanasadṛśāḥ kathaṃ ca kāśyapa bhikṣavaḥ śvaloṣṭānujavanasadṛśā bhavati	འོད་སྲུང་། མ་འོངས་པའི་དུས་ན་དགེ་སློང་ཁྱི་རྡོ་ལ་སྙེགས་པ་དང་མཚུངས་པ་དག་འབྱུང་ངོ་༎ འོད་སྲུང་། ཇི་ལྟར་ན་དགེ་སློང་ཁྱི་རྡོ་ལ་སྙེགས་པ་དང་མཚུངས་པ་དག་ཡིན་ཞེ་ན་། འོད་སྲུང་།
 tadyathāpi nāma kāśyapa śvāno loṣṭunā trāsitaḥ tameva loṣṭuranudhāvati |	འདི་ལྟ་སྟེ་། དཔེར་ན་། ཁྱི་ནི་རྡོས་འཇིགས་ལ་རྡོ་དེ་ཉིད་ཀྱི་ཕྱིར་སྙེགས་ཀྱི་།
 na tamanudhāvati | yena sa loṣṭuṃ kṣiptaṃ bhavati |	རྡོ་དེ་སུས་འཕངས་པ་དེ་ལ་ནི་མི་སྙེགས་སོ་༎
 evameva kāśyapa satyeke śramaṇabrāhmaṇā ye rūpaśabdagandharasasparśairbhayabhītā araṇyāyataneṣu viharanti |	འོད་སྲུང་། དེ་བཞིན་དུ་འདི་ལ་དགེ་༄༢༤༣བ་སྦྱོང་དང་། བྲམ་ཟེ་ཁ་ཅིག་གཟུགས་དང་། སྒྲ་དང་། དྲི་དང་། རོ་དང་། རེག་བྱས་འཇིགས་ཤིང་སྐྲག་ནས་དགོན་པའི་གནས་རྣམས་ལ་གནས་ཤིང་།
 teṣā tatrekākinām advitīyānāṃ kāyapraviviktavihāriṇāṃ rajanīyāstajjakriyā rupaśabdagandharasasparśāvabhāsam āgacchanti |	དེ་དག་དེ་ན་གཅིག་པུ་གཉིས་སུ་མེད་པར་ལུས་རབ་ཏུ་དབེན་པར་འདུག་སྟེ་། ཆགས་པར་འགྱུར་བའི་གཟུགས་དང་། སྒྲ་དང་། དྲི་དང་། རོ་དང་། རེག་བྱ་རྣམས་སྣང་བར་གྱུར་ན་།
 te tatrāvekṣakāḥ sukhalikānuyogam anuyuktā viharanti ranti |	དེ་དག་དེ་ལ་བཏང་སྙོམས་སུ་འཇོག་ཅིང་བསོད་ནམས་སུ་སྦྱོར་བ་དང་ལྡན་པར་གནས་ཀྱི་། ནང་དུ་སོ་སོར་རྟོག་པ་ལ་མངོན་པར་མི་བརྩོན་ཏེ་།
 kp|106 te na jāna jānanti na buddhyanti kiṃ rūpāśabdagandharasasparśāna nīḥsaraṇam iti |	དེ་དག་གཟུགས་དང་། སྒྲ་དང་། དྲི་དང་། རོ་དང་། རེག་བྱ་རྣམས་ལས་ཅིས་འབྱུང་བ་མི་ཤེས་ཤིང་ཁོང་དུ་མི་ཆུད་དོ་༎
 te ajānantaḥ abuddhyantaḥ teṣāṃ rūpaśabdagandharasasparśānāsvādaṃ cādīnavaṃ cā niḥsaraṇaṃ	དེ་དག་གིས་དེ་མ་ཤེས་ཤིང་ཁོང་དུ་མ་ཆུད་པས་།
 ca avatīrṇā grāmanagaranigamarāṣarājadhāniṣva punareva rūpaśabdagandharasasparśarhannyaṃ	གྲོང་དང་། གྲོང་ཁྱེར་དང་། གྲོང་རྡལ་དང་། ལྗོངས་དང་། ཡུལ་འཁོར་དང་། རྒྱལ་པོའི་ཕོ་བྲང་འཁོར་དག་ཏུ་སོང་ན་ཡང་གཟུགས་དང་། སྒྲ་དང་། དྲི་དང་། རོ་དང་། རེག་བྱ་རྣམས་ཀྱིས་གནོད་པར་འགྱུར་རོ་༎
 saced araṇyagatā kālaṃ kurvanti | teṣāṃ lokikasaṃvarasthitānā svargaloke upapattirbhavati |	གལ་ཏེ་དེ་དག་དགོན་པ་ན་གནས་པ་ལས་འཆི་བའི་དུས་བྱས་བར་གྱུར་ན་འཇིག་རྟེན་པའི་སྡོམ་པ་ལ་གནས་པ་དེ་དག་མཐོ་རིས་ཀྱི་འཇིག་རྟེན་དུ་སྐྱེ་བར་འགྱུར་ཏེ་།
 te tatrāpi divyaiḥ pañcabhiḥ kāmaguṇairhanyaṃ |	དེར་ཡང་དེ་དག་ལྷའི་འདོད་པའི་ཡོན་ཏན་ལྔ་པོ་དག་གིས་གནོད་པར་འགྱུར་རོ་༎ དེ་དག་དེ་ནས་ཤི་འཕོས་ནས་ངན་སོང་བཞི་ལས་ཡོངས་སུ་མ་གྲོལ་བར་འགྱུར་ཏེ་། བཞི་གང་ཞེ་ན་། འདི་ལྟ་སྟེ་།
 te tataścyutā aparimuktā samānāścaturbhirapāyairnirayatiryag niyamalokāsuraiḥ evaṃ hi kāśyapa bhikṣavaḥ śvaloṣṭvanujavanasadṛśā bhavanti | ||	སེམས་ཅན་དམྱལ་བ་དང་། དུད་འགྲོའི་སྐྱེ་གནས་དང་། གཤིན་རྗེའི་འཇིག་རྟེན་དང་། ལྷ་མ་ཡིན་ནོ་༎ འོད་༄༢༤༤ཨ་༌༎ སྲུང༏་དེ་ལྟར་ན་དགེ་སློང་ཁྱི་རྡོ་ལ་སྙེགས་པ་དང་མཚུངས་པ་དག་ཡིན་ནོ་༎ འོད་སྲུང་། ཇི་ལྟར་ན་ཁྱི་རྡོ་ལ་སྙེགས་པ་དང་མི་འདྲ་བ་ཡིན་ཞེ་ན་།
 kp|107 katham ca kāśyapa bhikṣurna śvaloṣṭvanujavanasadṛśo bhavati yaḥ kāśyapa bhikṣu ākruṣṭo na pratyākrośati tāḍito na pratitāḍayati paṃsito na pratipaṃsayati |	འོད་སྲུང་། གང་གཤེ་ཡང་སླར་མི་གཤེ་། ཁྲོས་ཀྱང་སླར་མི་ཁྲོ་༎ མཚང་དྲུས་ཀྱང་སླར་མཚང་མི་འདྲུ་།
 bhaṇḍito na pratibhaṇḍayati |	བརྡེག་ཀྱང་སླར་མི་བརྡེག་། བསྡིགས་ཀྱང་སླར་མི་བསྡིགས་།
 roṣito na pratiroṣayati | ādhyātmaṃ cittaniddhyaptiṃ pratyavekṣate |	སྨད་ཀྱང་སླར་མི་སྨད་ཅིང་ནང་དུ་སེམས་ལ་སོ་སོར་རྟོག་སྟེ་། འདི་ལ་གཤེ་བའམ་།
 ko vākruṣṭo vā tāḍito vā |	ཁྲོས་པའམ་། བརྡེག་པའམ་།
 paṃsito vā bhaṇḍito vā roṣito vā |	བསྡིགས་པའམ་། སྨད་པའམ་། མཚང་བྲུས་པ་དེ་དག་གང་ཡིན་སྙམ་དུ་སོ་སོར་རྟོག་པའོ་༎
 evaṃ hi kāśyapa bhikṣurna śvaloṣṭvanujavanasadṛśo bhavanasadṛśo bhavati |	འོད་སྲུང་། དེ་ལྟར་ན་དགེ་སློང་ཁྱི་རྡོ་ལ་སྙེགས་པ་དང་མི་འདྲ་བ་ཡིན་ནོ་༎
 tatredamucyate ||	དེ་ལ་འདི་སྐད་ཅེས་བྱ་སྟེ་།
 śvāno yathā loṣṭuna trāsyamāno	དཔེར་ན་ཁྱི་ནི་རྡོ་བས་སྐྲག་གྱུར་ཀྱང་༎
 anudhāvate loṣṭu na yena kṣiptaṃ	སུས་འཕངས་མི་སྙེགས་རྡོ་ལ་སྙེགས་པར་བྱེད་༎
 em evihekai śramaṇā dvijā vā	དེ་བཞིན་དགེ་སྦྱོང་བྲམ་ཟེ་ལ་ལ་དག་།
 rūpādibhītā vanavāsam āśritā | || teṣāṃ ca tasmin vasatām araṇye	གཟུགས་ལ་སོགས་པས་སྐྲག་ནས་དགོན་པར་གནས་༎ དེ་དག་དགོན་པ་དེ་ལ་གནས་གྱུར་ཀྱང་༎
 rūpādayo daśanam eta iṣṭā |	གཟུགས་ལ་སོགས་པ་སྡུག་པ་མཐོང་གྱུར་ན་༎
 upekṣakādhyātmagate nabhijñā ādīnavān niḥsaraṇeḥkam eṣā	བཏང་སྙོམས་འཇོག་ཅིང་ནང་གི་ཚུལ་མི་ཤེས་༎ དེ་ཡི་ཉེས་ལས་བྱུང་བ་གང་ཡིན་པ་༎
 ajānamānā puna grāmam āśritā |	མི་ཤེས་པས་ན་སླར་ཡང་གྲོང་དུ་གནས་༎ གཟུགས་ལ་སོགས་པས་དེར་ཡང་གནོད་པར་འགྱུར་༎
 punepi rūpehi vihanyamānā śyutaśca devai manujaiśca kecit tatrāpi divyān upabhujya bhogā 3	འདིར་ཡང་ལྷ་ཡི་ལོངས་སྤྱོད་སྤྱད་གྱུར་ཏེ་༎
 apāyabhūmiḥ prapatanti kecit cyutā cyutā duḥkhamupaiti mūḍhāḥ	ལྷ་དང་མི་ལས་ཁ་ཅིག་ཤི་འཕོས་ནས་༎ དེ་དག་ངན་སོང་སར་ནི་ལྟུང་བར་འགྱུར་༎ བླུན་པོ་དེ་དག་ཤི་འཕོས་སྡུག་བསྔལ་འགྱུར་༎
 evaṃ hi te duḥkhaśatānubaddhā śvaloṣṭatulyā sugatena deśitā | 4	དེ་ལྟར་སྡུག་བསྔལ་༄༢༤༤བ་བརྒྱ་ལྡན་དེ་དག་ནི་༎ ཁྱི་རྡོ་སྙེགས་པ་འདྲ་ཞེས་བདེ་གཤེགས་གསུངས་༎
 ākruṣṭa nākrośati tāḍitastathā na paṃsitaḥ paṃsayateśca kecit na bhaṇḍito bhaṇḍayate tathānyān aroṣito roṣayate ca sūrataḥ 5	སྤྱོས་ཀྱང་མི་གཤེ་བརྡེག་ཀྱང་མི་བརྡེག་དང་༎ སུ་ཞིག་སྨད་ཀྱང་སྨོད་པར་མི་བྱེད་དང་༎ དེ་བཞིན་འཚང་དྲུས་འཚང་འདྲུ་མི་བྱེད་དང་༎ ཁྲོས་ཀྱང་དེས་*nges?་པ་ཁྲོ་བ་མི་བྱེད་ཅིང་༎
 adhyātmacittaṃ pratiprakṣataśca gaveṣate śāntatavi smṛtīmān	ནང་གི་སེམས་ཀྱི་གཉེན་པོར་གྱུར་པ་དག་། ཚོལ་ཞིང་ཡིད་ཞི་དྲན་དང་ལྡན་གྱུར་པ་༎
 evaṃvidhaḥ śīlavratopapaṇnoḥ na śvānatulya kathito jinena | 6 ||	དེ་འདྲའི་ཚུལ་ཁྲིམས་བརྟུལ་ཞུགས་ལྡན་པ་ནི༏་༏རྡོ་སྙེགས་ཁྱི་མི་འདྲ་ཞེས་རྒྱལ་བས་གསུངས་༎
 kp|108 tadyathāpi nāma kāśyapa kuśalo aśvadamaka suto |	འོད་སྲུང་། འདི་ལྟ་སྟེ་། དཔེར་ན་།
 yatra yatra pṛthivīpradeśe aśva skhalati | utkumbhati vā khaḍuṅkakriyā vā karoti | tatra tatra caiva pṛthivīpradeśe nigṛhṇāti sa tathā tathā nigṛhṇāti yanna punarapi na prakupyate |	རྟའི་འདུལ་སྦྱོང་ལ་མཁས་པས་རྟ་དེ་གང་དང་གང་དུ་ག-ཡོ་བྱེད་ཅིང་མ་བྱང་བ་དེ་དང་དེ་རབ་ཏུ་སྦྱོང་ངོ་༎ འོད་སྲུང་།
 evameva kāśyapa yogācāro bhikṣuryatrayatraivaṃ cittasya vikāraṃ paśyati | tatra tatraivāsya nigrahāya pratipadyate | sa tathā tathā cittaṃ nigṛhṇāti yathā na puna prakupyate tatredamucyate | ||	དེ་བཞིན་དུ་དགེ་སློང་རྣལ་འབྱོར་སྤྱོད་པ་ཡང་གང་དང་གང་དུ་སེམས་འགྱུར་བར་མཐོང་བ་དེ་དང་དེར་དེ་རབ་ཏུ་སྦྱོང་བ་ལ་འཇུག་སྟེ་། དེ་ཅི་ནས་ཕྱིས་འཁྲུག་པར་མི་འགྱུར་བ་དེ་ལྟར་སེམས་རབ་ཏུ་འཆོས་སོ་༎ དེ་ལ་འདི་སྐད་ཅེས་བྱ་སྟེ་།
 yathāśvasūta kuśalo bhaveta skhalitaṃ ca aśva samabhigr| hat| |	དཔེར་ན་རྟ་ཡི་འདུལ་སྦྱོང་མཁས་པ་ཞིག་། བྱང་ཞིང་ག-ཡོ་མེད་ཚུལ་དུ་རབ་ཏུ་འདུལ་༎
 yogī tathā cittavikāra dṛṣṭvā tathā nigṛhṇāti yathā na kupyate | ||	རྣལ་འབྱོར་པ་ཡང་སེམས་ནི་འགྱུར་མཐོང་ནས༏་༏ཇི་ལྟར་ཕྱིས་འཁྲུག་མི་འགྱུར་དེ་ལྟར་འཆོས་༎ འོད་སྲུང་།
 kp|109 tadyathāpi nāma kāśyapa galagraha sarvendriyāṇāṃ graho bhavati jīvitendriyasyoparodhe vartate |	འདི་ལྟ་སྟེ་། དཔེར་ན་། ལྐོག་ནད་ལྷ་གོར་གྱིས་ནི་སྲོག་གི་དབང་པོ་འགག་པར་བྱེད་དོ་༎
 evameva kāśyapa sarvadṛṣṭigatānāmmātmagrāho dharmajīvitendriyasyoparodhena vartate |	འོད་སྲུང་། དེ་བཞིན་དུ་ལྟ་བར་གྱུར་པ་ཐམས་ཅད་ཀྱི་ནང་ན་བདག་ཏུ་འཛིན་པ་ནི་ཆོས་ཀྱི་སྲོག་གི་དབང་པོ་འགག་པར་བྱེད་པའོ་༎
 tatredamucyate ||	དེ་ལ་འདི་སྐད་ཅེས་བྱ་སྟེ་། དཔེར་ན་ལྷ་གོར་སྲོག་གི་དབང་པོ་ལ་༎
 galagraho ve yatha jīvitendriyā nigṛhṇate nāsya sukhaṃ dadāti |	གནོད་ཅིང་དེ་ལ་བདེ་བ་སྦྱིན་པ་༄༢༤༥ཨ་༌༎
 dṛṣṭikṛtānāmapi ātmadṛṣṭi vināśayeta ima dharmajīvitaṃ ||	མིན༏་༏དེ་བཞིན་ལྟ་གྱུར་ནང་ན་བདག་ལྟ་བ་༎ དེ་ནི་ཆོས་སྲོག་རྣམ་པར་འཇིག་པར་བྱེད་༎ འོད་སྲུང་། འདི་ལྟ་སྟེ་།
 kp|110 tadyathāpi nāma kāśyapa puruṣo yato yataḥ baddho bhavati tatastata eva mocayitavyo bhavati |	དཔེར་ན་། མི་ནི་གང་དང་གང་དུ་བཅིངས་པ་དེ་དང་དེ་ཉིད་ལས་དགྲོལ་བར་བྱ་བ་ཡིན་ནོ་༎ འོད་སྲུང་།
 evameva kāśyapa yato yata eva cittaṃ sajyati | tatastata eva mocayitavyaṃ bhavati |	དེ་བཞིན་དུ་རྣལ་འབྱོར་སྤྱོད་པའི་སེམས་གང་དང་གང་ལ་ཆགས་པ་དེ་དང་དེ་ལས་དགྲོལ་བར་བྱ་བ་ཡིན་ནོ་༎
 tatredamucyate ||	དེ་ལ་འདི་སྐད་ཅེས་བྱ་སྟེ་།
 yathāpi baddhaḥ puruṣaḥ samantāt samantato mocayitavya bhoti	དཔེར་ན་མི་ནི་གང་དུ་བཅིངས་གྱུར་པ་༎ དེ་དང་དེ་ལས་དགྲོལ་བར་བྱ་བ་ཡིན་༎ དེ་བཞིན་སེམས་རྨོངས་གང་དང་གར་ཆགས་པ་༎
 evaṃ yahīm sajjati mūḍhacittaṃ tatastato yogina mocanīyam ||	རྣལ་འབྱོར་པས་ནི་དེ་དང་དེ་ལས་དགྲོལ་༎
 kp|111 dvāvimau kāśyapa pravrajitasyākāśapaligodhau |	འོད་སྲུང་། འདི་གཉིས་ནི་རབ་ཏུ་བྱུང་བའི་ནམ་མཁའ་ལ་ཡོངས་སུ་ཆགས་པ་སྟེ་།
 katamau dvau |	གཉིས་གང་ཞེ་ན་།
 lokāyatamantraparyeṣṭitā ca | utsadapātracīvaradhāraṇatayā ca | imau dvau |	འཇིག་རྟེན་རྒྱང་པན་པའི་གསང་ཚིག་ཡོངས་སུ་ཚོལ་བ་དང་། ལྷུང་བཟེད་དང་ཆོས་གོས་ལྷག་པར་འཆང་བ་སྟེ་འདི་གཉིས་སོ་༎
 tatredamucyate ||	དེ་ལ་འདི་སྐད་ཅེས་བྱ་སྟེ་།
 lokāyatasyābhyasanābhiyogo tatotsadaṃ cīvarapātradhāraṇaṃ |	འཇིག་རྟེན་རྒྱང་པན་གོམས་བྱེད་བརྩོན་པ་དང་༎ ལྷུང་བཟེད་ཆོས་གོས་ལྷག་པར་འཆང་བྱེད་པ་༎
 ākāśabodhe imi dve pratiṣṭhite tau bodhisattvena vivarjanīyau ||	འདི་གཉིས་ནམ་མཁའ་ལ་ནི་ཆགས་པ་སྟེ་༎ དེ་དག་བྱང་ཆུབ་སེམས་དཔས་སྤང་བར་བྱ་༎
 kp|112 dvāvimau kāśyapa pravrajitasya gāḍhabandhano |	འོད་སྲུང་། འདི་གཉིས་ནི་རབ་ཏུ་བྱུང་བའི་འཆིང་བ་དམ་པ་སྟེ་། གཉིས་གང་ཞེ་ན་།
 katamau dviyadutātmadṛṣṭikṛtabandhanaṃ ca lābhasatkāraślokabandhanaṃ cetīme kāśyapa dvau pravrajitasya gāḍhabandhanaṃ |	ལྟ་བར་གྱུར་པའི་འཆིང་བ་དང་། རྙེད་པ་དང་བཀུར་སྟི་དང་ཚིགས་སུ་བཅད་པའི་འཆིང་བ་སྟེ་འདི་གཉིས་སོ་༎
 tatredamucyate 2 ||	དེ་ལ་འདི་སྐད་ཅེས་བྱ་སྟེ་། ལྟ་འགྱུར་འཆིང་དང་རྙེད་དང་བཀུར་སྟི་དང་༎ གྲགས་པའི་༄༢༤༥བ་འཆིང་བ་རབ་ཏུ་བྱུང་བ་ཡི་༎
 dve bandhane pravrajitasya gāḍhe dṛṣṭikṛtaṃ bandhanam uktam ādaiḥ	འཆིང་བ་དམ་ཞེས་འཕགས་པ་རྣམས་ཀྱིས་གསུངས་༎
 satkāralābho yaśabandhanaṃ ca te sarvadā pravrajitena tyajye ||	དེ་དག་རྟག་ཏུ་རབ་ཏུ་བྱུང་བས་སྤང་༎
 kp|113 dvāvimau kāśyapa pravrajitasyāntārayakaro dharmau |	འོད་སྲུང་། འདི་གཉིས་ནི་རབ་ཏུ་བྱུང་བའི་བར་དུ་གཅོད་པའི་ཆོས་གཉིས་ཏེ་།
 katamo dvau |	གཉིས་གང་ཞེ་ན་།
 gṛhapatipakṣasevanā ca āryapakṣavidveṣaṇatā cetīme kāśyapa dvau pravrajitasyāntarāyakarau dharmau |	ཁྱིམ་པའི་ཕྱོགས་ལ་སྟེན་པ་དང་། འཕགས་པའི་ཕྱོགས་ལ་གནོད་པར་སེམས་པ་སྟེ་འདི་གཉིས་སོ་༎
 tatredamucyate 3 ||	དེ་ལ་འདི་སྐད་ཅེས་བྱ་སྟེ་།
 gṛhasthapakṣasya ca sevanā yā ācāryapakṣasya ca yā vigarhaṇā |	ཁྱིམ་པའི་ཕྱོགས་ལ་སྟེན་པར་བྱེད་པ་དང་༎ འཕགས་པའི་ཕྱོགས་ལ་རྣམ་པར་སྨོད་བྱེད་པ་༎
 dvāvantarāyo paripanthabhūto tau bodhisattvena vivaryanīyo ||	འདི་གཉིས་རབ་བྱུང་བར་ཆད་བགེགས་བྱེད་པ་༎ བྱང་ཆུབ་སེམས་དཔས་དེ་དག་རྣམ་པར་སྤང་༎
 kp|114 dvāvimau kāśyapa pravrajitasya malau katamau dvan |	འོད་སྲུང་། འདི་གཉིས་ནི་རབ་ཏུ་བྱུང་བའི་དྲི་མ་སྟེ་། གཉིས་གང་ཞེ་ན་།
 yaduta kleṣādhivāsanatā ca mitrakulabhekṣākakulādvyavasanatāgrahaṇaṃ cetime kāśyapa dvau pravrajitasya malo |	ཉོན་མོངས་པ་ལ་མི་མཇེད་པ་དང་། མཛའ་བོའི་ཁྱིམ་དང་ཟས་སྟེར་བའི་ཁྱིམ་ཡོངས་སུ་འཛིན་པ་སྟེ་འདི་གཉིས་སོ་༎
 tatredamucyate || 4 || kleśaśca yo pravrajito dhivāsayet mitraṃ sa bhekṣākakulaṃ ca sevati |	དེ་ལ་འདི་སྐད་ཅེས་བྱ་སྟེ༏་རབ་ཏུ་བྱུང་བ་ཉོན་མོངས་མི་འཛིན་དང་༎ མཛའ་བོའི་ཁྱིམ་དང་ཟས་སྟེར་ཁྱིམ་བསྟེན་པ་༎
 etau jinendreṇa hi deśitau malo tau bodhisattvena vivarjanīyoḥ ||	དེ་གཉིས་དྲི་མར་རྒྱལ་བའི་དབང་པོས་གསུངས་༎ བྱང་ཆུབ་སེམས་དཔས་དེ་དག་རྣམ་པར་སྤང༏་༏འོད་སྲུང་།
 kp|115 dvāvimau kāśyapa pravrajitasyāśaniprapātau |	འདི་གཉིས་ནི་རབ་ཏུ་བྱུང་བའི་སེར་བ་འབབ་པ་སྟེ་།
 katamau dvau |	གཉིས་གང་ཞེ་ན་།
 saddharmapratikṣepaśca cyutaśīlasya ca śraddhādeyaparibhogaṃ cetīme kāśyapa dvau pravrajitasya aśanīprapāto dharmaḥ tatredamucyate || 5 ||	དམ་པའི་ཆོས་སྤོང་བ་དང་། ཚུལ་ཁྲིམས་ལས་ཉམས་ཀྱང་དད་པས་བྱིན་པ་ཡོངས་སུ་སྤྱོད་པ་སྟེ་འདི་གཉིས་སོ་༎ དེ་ལ་འདི་སྐད་ཅེས་བྱ་སྟེ་།
 saddharmasya pratikṣepa śyutaśīlasya bhojanaṃ |	དམ་པའི་ཆོས་ནི་སྤོང་བ་དང་༎ ཚུལ་ཁྲིམས་ཉམས་ཀྱང་སྤྱོད་པ་སྟེ་༎
 aśaniprapāto dvāvetau varjanīyo nṛpātmakaiḥ ||	སེར་བ་འབབ་པ་འདི་གཉིས་ནི་༎ རྒྱལ་སྲས་རྣམས་ཀྱིས་སྤང་བར་བྱ་༎
 kp|116 dvāvimau kāśyapa pravrajitasya vraṇau katamau dvau |	འོད་༄༢༤༦ཨ་༌༎ སྲུང༏་འདི་གཉིས་ནི་རབ་ཏུ་བྱུང་བའི་རྨ་ཡིན་ཏེ་། གཉིས་གང་ཞེ་ན་།
 paradau pratyavekṣanatā ca svadauṣapraticchādanatā cetīme kāśyapa dvau pravrajita vraṇau tatredamucyate 16 ||	ཕ་རོལ་གྱི་ཉེས་པ་ལ་སོ་སོར་རྟོག་པ་དང་། བདག་གི་ཉེས་པ་འཆབ་པ་སྟེ་འདི་གཉིས་སོ་༎ དེ་ལ་འདི་སྐད་ཅེས་བྱ་སྟེ་།
 vṛṇute ca svakā dauṣā paridoṣāśca vīkṣate |	བདག་གི་སྐྱོན་ནི་འཆབ་བྱེད་དང་༎ ཕ་རོལ་ཉེས་ལ་རྟོག་བྱེད་པ་༎
 viṣāgnitulyo dvāvetau vraṇau tyajyau parikṣakaiḥ ||	འདི་གཉིས་དུག་གི་མེ་དང་འདྲ་༎ རྟོག་པ་རྣམས་ཀྱིས་རྨ་འདི་སྤང་༎
 kp|117 dvāvimau kāśyapa pravrajitasya paridāgho katamo dvau |	འོད་སྲུང་། འདི་གཉིས་ནི་རབ་ཏུ་བྱུང་བའི་ཡོངས་སུ་གདུང་སྟེ་། གཉིས་གང་ཞེ་ན་།
 yaduta sakāṣāyasya ca kāṣāyadhāraṇaṃ śīlavantā guṇavantā cāntikādupasthānaparicaryāsvīkaraṇaṃ cetīme kāśyapa dvau pravrajitasya paridāgho |	རྙོག་པ་དང་བཅས་པའི་སེམས་ཀྱིས་ངུར་སྨྲིག་འཆང་བ་དང་། ཚུལ་ཁྲིམས་དང་ལྡན་པ་ཡོན་ཏན་དང་ལྡན་པ་ལས་བསྙེན་བཀུར་དང་རིམ་གྲོར་བྱ་བ་བདག་གིར་བྱེད་པ་སྟེ་འདི་གཉིས་སོ་༎
 tatredamucyate 7 ||	དེ་ལ་འདི་སྐད་ཅེས་བྱ་སྟེ་།
 sakaṣāyacittasya kāṣāyadhāraṇaṃ śīlānvitānāṃ ca sakāśa sevanā paricaryupasthānabhivādanaṃ ca dharmāvimau dvau parivarjaṇīyā ||	རྙོག་དང་བཅས་པའི་སེམས་ཀྱིས་ངུར་སྨྲིག་འཆང་བ་དང་༎ བསྙེན་བཀུར་རིམ་གྲོ་བྱེད་དང་གུས་པར་སྨྲ་བ་དག་། ཚུལ་ཁྲིམས་ལྡན་པ་རྣམས་ལས་སྟེན་པར་བྱེད་པ་དང་༎ ཆོས་གཉིས་འདི་དག་ཡོངས་སུ་སྤང་བར་བྱ་བ་ཡིན་༎
 kp|118 dvāvimau kāśyapa pravrajitasya dīrghaglānyau katamau dvau |	འོད་སྲུང་། འདི་གཉིས་ནི་རབ་ཏུ་བྱུང་བའི་ཟུག་རྔུ་སྟེ་། གཉིས་གང་ཞེ་ན་།
 yad abhimānikasya ca cittanidhyaptirmahāyānasamprasthitānāṃ sattvānā vicchandanā ime kāśyapa dvau pravrajitasya dīrghagailā |	བསླབ་པའི་གཞི་ལས་འགལ་བ་དང་། སྙིང་པོ་མ་བླངས་པར་འཆི་བའི་དུས་བྱེད་པ་སྟེ་འདི་གཉིས་སོ་༎
 tatredamucyate 18 ||	དེ་ལ་འདི་སྐད་ཅེས་བྱ་སྟེ་།
 nidhyapti cittasyabhimānikānāṃ vicchandanāyāpi ca buddhayānaṃ |	བསླབ་པའི་གཞི་ལས་འགལ་བར་གྱུར་པ་དང་༎ སྙིང་པོ་མ་བླངས་པར་ནི་དུས་བྱེད་པ་༎
 ime hi dve pravrajitasya glānye ukte jinenāpratipudgalena ||	འདི་གཉིས་རབ་ཏུ་བྱུང་བའི་ཟུག་རྔུ་ཞེས་༎ ལྷ་མིའི་སྟོན་པ་ཐམས་ཅད་མཁྱེན་པས་གསུངས་༎
 kp|119 dvāvimau kāśyapa pravrajitasya acikitso gailānyau |	འོད་སྲུང་། འདི་༄༢༤༦བ་གཉིས་ནི་རབ་ཏུ་བྱུང་བའི་ནད་གསོར་མི་རུང་བ་སྟེ་།
 katamau dvau | yādutābhīkṣṇāpattiāpadyanatā |	གཉིས་གང་ཞེ་ན་།
 avyutthānatā ceti ime kāśyapa dvau pravrajitasya acikitso glānyo 9 ||	མངོན་པའི་ང་རྒྱལ་གྱིས་སེམས་ངེས་པར་སེམས་པ་དང་། ཐེག་པ་ཆེན་པོ་ལ་ཡང་དག་པར་ཞུགས་པའི་གང་ཟག་རྣམས་ཀྱི་འདུན་པ་བཟློག་པ་སྟེ་འདི་གཉིས་སོ་༎ དེ་ལ་འདི་སྐད་ཅེས་བྱ་སྟེ་། མངོན་པའི་ང་རྒྱལ་སེམས་ལ་ངེས་སེམས་དང་༎ སངས་རྒྱས་ཐེག་པ་ལས་ནི་འདུན་པ་བཟློག་།
 kp|120 dvāvimau kāśyapa pravrajitasya śalyo katamau dvau | yaduta śikṣāpadasamatikramaṃ ca anādattasārasya ca kālakriyā ime kāśyapa dvau pravrajitasya śalyo 10 ||	འདི་གཉིས་རབ་ཏུ་བྱུང་བའི་ནད་ཡིན་ཞེས་༎ གང་ཟག་མཚུངས་པ་མེད་པའི་རྒྱལ་བས་གསུངས་༎ འོད་སྲུང་།
 kp|121 śramaṇa śramaṇa iti kāśyapa ucyate | kiyannu tāvat kāśyapa śramaṇaḥ śramaṇa ityucyate |	དགེ་སྦྱོང་དགེ་སྦྱོང་ཞེས་བྱ་བ་ཇི་ཙམ་གྱིས་ན་དགེ་སྦྱོང་དགེ་སྦྱོང་ཞེས་བྱ་ཞེ་ན་།
 catvāra ime kāśyapa śramaṇaḥ katame catvāraḥ yaduta varṇarūpaliṅgasaṃsthānaśramaṇa |	འོད་སྲུང་། བཞི་པོ་འདི་དག་ནི་དགེ་སྦྱོང་སྟེ་། བཞི་གང་ཞེ་ན་།
 ācāraguptikuhakaśramaṇaḥ kīrtiśabdaślokaśramaṇaḥ bhūtapratipattiśramaṇaḥ ime kāśyapa catvāraḥ śramaṇāḥ |	ཁ་དོག་དང་རྟགས་དང་དབྱིབས་ཀྱི་དགེ་སྦྱོང་དང་། ཆོ་ག་སྲུང་ཞིང་ཚུལ་འཆོས་པའི་དགེ་སྦྱོང་དང་། བརྗོད་པའི་སྒྲ་ཚིགས་སུ་བཅད་པའི་དགེ་སྦྱོང་དང་། ཡང་དག་པར་སྒྲུབ་པའི་དགེ་སྦྱོང་ངོ་༎ འོད་སྲུང་།
 kp|122 tatra kāśyapa katamo varṇarūpaliṅgasaṃsthānaśramaṇaḥ iha kāśyapa ihekatyaśramaṇa varaṇarupaliṅgasaṃsthānasamanvāgato bhavati |	དེ་ལ་ཁ་དོག་དང་རྟགས་དང་དབྱིབས་ཀྱི་དགེ་སྦྱོང་གང་ཞེ་ན་། འོད་སྲུང་། འདི་ལ་དགེ་སྦྱོང་ཁ་ཅིག་ཁ་དོག་དང་རྟགས་དང་དབྱིབས་དང་ལྡན་པར་གྱུར་ཏེ་།
 saṅghāṭīpariveṣṭhito muṇḍaśiraḥ supātrapāṇaiḥ parigṛhītaḥ sa ca bhavatyapariśuddhakāyakarmasamudācāra apariśuddhavākkarmasamudācāraḥ apariśuddhamanaskarmasamudācārauḥ bhavati |	ཆོས་གོས་རྣམ་སྦྱར་གྱོན་ཅིང་སྐྲ་བྲེགས་ཏེ་ལག་ན་ལྷུང་བཟེད་ཐོགས་མོད་ཀྱི་། དེ་ལུས་ཀྱི་ལས་ཡོངས་སུ་མ་དག་པར་སྤྱོད་། ངག་གི་ལས་ཡོངས་སུ་མ་དག་པར་སྤྱོད་། ཡིད་ཀྱི་ལས་ཡོངས་སུ་མ་དག་པར་སྤྱོད་ཅིང་།
 ayukta amuktaḥ adāntaḥ aśāntaḥ aguptaḥ avinitaḥ lubdhaḥ alasoḥ duḥśīlappāpadharmasamācāraḥ ayamucyate kāśyapa varṇarūpaliṅgasaṃsthānaśramaṇaḥ	མ་དུལ་བ་། མ་ཞི་བ་། མ་བསྲུངས་པ་། མ་བྱང་བ་། འཚོ་བ་ཡོངས་སུ་མ་དག་པ་། བརྐམ་པ་། ལེ་ལོ་ཅན་། ཚུལ་ཁྲིམས་འཆལ་བ་། ༄༢༤༧ཨ་༌༎ སྡིག་པའི་ཆོས་ཅན་ཡིན་ཏེ་། འོད་སྲུང་། དེ་ནི་ཁ་དོག་དང་རྟགས་དང་དབྱིབས་ཀྱི་དགེ་སྦྱོང་ཞེས་བྱའོ་༎
 kp|123 tatra kāśyapa katamaḥ ācāraguptikuhakaḥ śramaṇaḥ iha kāśyapa ihaikatyaśramaṇaḥ	འོད་སྲུང་། དེ་ལ་ཆོ་ག་སྲུང་ཞིང་ཚུལ་འཆོས་པའི་དགེ་སྦྱོང་གང་ཞེ་ན་། འོད་སྲུང་།
 ācāracāritrasampano bhavati samprajānacārī caturbhi īryāpathairlūhānnapānabhojī santuṣṭaḥ	འདི་ལ་དགེ་སྦྱོང་ཁ་ཅིག་ཆོ་ག་དང་། སྤྱོད་ཡུལ་དང་། སྤྱོད་པ་ཕུན་སུམ་ཚོགས་ཤིང་སྤྱོད་ལམ་བཞིར་ཤེས་བཞིན་དུ་སྤྱོད་ལ་། ཟས་དང་སྐོམ་ངན་པ་ཟ་འཐུང༏་འཕགས་པའི་རིགས་བཞི་པོ་དག་གིས་ཆོག་པར་འཛིན་། བས་མཐའི་གནས་མལ་ལ་མངོན་པར་དགའ། ཁྱིམ་པ་དང་རབ་ཏུ་བྱུང་བ་རྣམས་དང་མི་འདྲེ་ལ་། ཚིག་ཉུང་ཞིང་སྨྲ་བ་ཉུང་མོད་ཀྱི་།
 caturbhirāryavaṃśerasaṃsṛṣṭo gṛhasthapravrajitairalpabhāṣyo 'lpamantraḥ te cāsyeryāpathāḥ kuhanalapanatayā kalpitā bhavanti |	དེའི་སྤྱོད་ལམ་དེ་དག་ཀྱང་ཚུལ་འཆོས་པ་དང་། ཁ་བསག་གིས་ཡོངས་སུ་བརྟགས་པ་ཡིན་ཏེ་།
 na cittapariśuddhaye |	སེམས་ཡོངས་སུ་དག་པར་བྱ་བའི་ཕྱིར་མ་ཡིན་།
 na śamāya nopaśamāya |	དུལ་བར་བྱ་བའི་ཕྱིར་མ་ཡིན་།
 na damāya |	ཉེ་བར་ཞི་བར་བྱ་བའི་ཕྱིར་མ་ཡིན་གྱི་།
 upalambhadṛṣṭikaśca bhavati |	དམིགས་པར་ལྟ་བ་ཡིན་ཏེ་། ངར་འཛིན་པ་དང་། ང་ཡིར་འཛིན་པ་ལ་གནས་ཤིང་།
 śūnyatānupalambhāśca dharmesu śrutvā prapātasañjñī bhavati |	སྟོང་པ་ཉིད་ཀྱིས་མི་དམིགས་པའི་ཆོས་རྣམས་ལ་ག-ཡང་སར་འདུ་ཤེས་པ་ཡིན་།
 śūnyatāvādināṃ ca bhikṣuṇām antike aprasādasañjñim utpādayati iyam ucyate kāśyapa ācāraguptikuhaka śramaṇaḥ ||	སྟོང་པ་ཉིད་སྨྲ་བའི་དགེ་སློང་རྣམས་ལ་ཡང་དགྲར་འདུ་ཤེས་པ་ཡིན་ཏེ་། འོད་སྲུང་། དེ་ནི་ཆོ་ག་སྲུང་ཞིང་ཚུལ་འཆོས་པའི་དགེ་སྦྱོང་ཞེས་བྱའོ་༎ འོད་སྲུང་།
 kp|124 tatra kāśyapa katamaḥ kīrtiśabdaślokaḥ śramaṇaḥ iha kāśyapa ihaikatyaśramaṇaḥ pratisaṅkhyāya śīlaṃ rakṣati |	དེ་ལ་བརྗོད་པའི་སྒྲ་ཚིགས་སུ་བཅད་པའི་དགེ་སྦྱོང་གང་ཞེ་ན་། འོད་སྲུང་། འདི་ལ་དགེ་སྦྱོང་ཁ་ཅིག་ཇི་ལྟར་བདག་ཚུལ་ཁྲིམས་དང་ལྡན་པར་གཞན་གྱིས་ཤེས་པར་འགྱུར་༄༢༤༧བ་སྙམ་དུ་སོ་སོར་བརྟགས་ནས་ཚུལ་ཁྲིམས་སྲུང་།
 kathamān pare jānīyurśīlavatān iti | pratisaṅkhyāya śrutam udgṛhṇīte kathamāṃ pare jānīyurbahuśruta iti | pratisaṅkhyāyāraṇye prativasati |	ཇི་ལྟར་མང་དུ་ཐོས་པར་གཞན་གྱིས་ཤེས་པར་འགྱུར་སྙམ་དུ་སོ་སོར་བརྟགས་ནས་ཐོས་པ་འཛིན་། ཇི་ལྟར་བདག་དགོན་པར་གཞན་གྱིས་ཤེས་པར་འགྱུར་སྙམ་དུ་སོ་སོར་བརྟགས་ནས་དགོན་པ་ལ་། གནས་ཤིང་། 
 kathamāṃ pare jānīyu āraṇyaka iti | pratisaṅkhyāya alpecchaḥ santuṣṭaḥ pravivikto viharat |	སོ་སོར་བརྟགས་ནས་འདོད་པ་ཉུང་ལ་ཆོག་ཤེས་པ་དང་རབ་ཏུ་དབེན་པར་། གནས་ཤིང་། གྱུར་ཏེ་། འདི་ལྟར་གཞན་ལ་བསྟན་པའི་ཕྱིར་ཡིན་གྱི་། སྐྱོ་པར་བྱ་བའི་ཕྱིར་མ་ཡིན་།
 yāvad eva paropadarśanāya na nirvedāya na virāgāya na nirodhāya nopaśamāya |	འདོད་ཆགས་དང་བྲལ་བར་བྱ་བའི་ཕྱིར་མ་ཡིན་། འགོག་པར་བྱ་བའི་ཕྱིར་མ་ཡིན་། ཉེ་བར་ཞི་བར་བྱ་བའི་ཕྱིར་མ་ཡིན་།
 nā sambodhaye |	རྫོགས་པར་བྱང་ཆུབ་པར་བྱ་བའི་ཕྱིར་མ་ཡིན་།
 na śrāmaṇyāya |	དགེ་སྦྱོང་གི་ཕྱིར་མ་ཡིན་།
 na brāhmaṇāya |	ཚངས་པའི་ཕྱིར་མ་ཡིན་།
 na nirvāṇāya |	མྱ་ངན་ལས་འདས་པའི་ཕྱིར་མ་ཡིན་ཏེ་།
 ayamucyate kāśyapa kīrtiśabdaślokaśramaṇa ||	འོད་སྲུང་། དེ་ནི་བརྗོད་པའི་སྒྲ་ཚིགས་སུ་བཅད་པའི་དགེ་སྦྱོང་ཞེས་བྱའོ་༎ འོད་སྲུང་།
 kp|125 tatra kāśyapa katamo bhūtapratipattiḥ śramaṇaḥ yaḥ kāśyapa bhikṣuranarthiko bhavati kāyena ca jīvitenāpi |	དེ་ལ་ཡང་དག་པར་སྒྲུབ་པའི་དགེ་སྦྱོང་གང་ཞེ་ན་། འོད་སྲུང་། གང་ལུས་དང་སྲོག་ལ་ཡང་མི་ལྟ་བ་ཡིན་ན་།
 kaḥ punarvvādo lābhasatkāraśloke |	རྙེད་པ་དང་བཀུར་སྟི་དང་ཚིགས་སུ་བཅད་པ་ལྟ་ཅི་སྨོས་།
 śūnyatā ānimittā apraṇihitāśca dhrmāṃ śrutvā āptamano bhavati tathatvatāyāṃ pratipanno nirvāṇe cāpyanarthikā brahmacaryaṃ carati |	སྟོང་པ་ཉིད་དང་། མཚན་མ་མེད་པ་དང་། སྨོན་པ་མེད་པའི་ཆོས་རྣམས་ཐོས་ན་དགའ་ཞིང་དེ་བཞིན་ཉིད་དུ་ཞུགས་པ་ཡིན་། མྱ་ངན་ལས་འདས་པ་ལ་ཡང་འདོད་པ་མེད་པར་སྤྱད་པ་སྤྱོད་ན་།
 kaḥ punarvādastraidhātukābhinandanatayā śūnyatādṛṣṭyāpyanarthiko bhavati |	ཁམས་གསུམ་པ་ལ་མངོན་པར་དགའ་བ་ལྟ་ཅི་སྨོས་། སྟོང་པ་ཉིད་དུ་ལྟ་བ་ཡང་མི་འདོད་པ་ཡིན་ན་།
 kaḥ punarvāda ātmasattvajīvapauṣapudgaladṛṣṭyā |	བདག་དང་། སེམས་ཅན་དང་། སྲོག་དང་། སྐྱེ་བ་པོ་དང་། གསོ་བ་༄༢༤༨ཨ་༌༎ དང༏་སྐྱེས་བུ་དང་། གང་ཟག་ཏུ་ལྟ་བ་ལྟ་ཅི་སྨོས་། དོན་ལ་རྟོན་གྱི་ཚིག་འབྲུ་ལ་རྟོན་པ་མ་ཡིན་།
 dharmapratisaraṇaśca bhavati | kleṣānāṃ ca adhyātmavimokṣamargati | na bahirdhā dhāvati atyantapariśuddhāśca prakṛtyā sarvadharmā asaṅkliṣṭān paśyati |	ཉོན་མོངས་པ་རྣམས་ལས་རྣམ་པར་ཐར་པ་ནང་དུ་ཚོལ་གྱི་ཕྱི་རོལ་དུ་རྒྱུག་པ་མ་ཡིན་། ཆོས་ཐམས་ཅད་ཤིན་ཏུ་ཡོངས་སུ་དག་ཅིང་རང་བཞིན་གྱིས་ཀུན་ནས་ཉོན་མོངས་པ་མེད་པར་མཐོང་བས་བདག་ཉིད་སྐྱབས་ཡིན་ཏེ་། གཞན་སྐྱབས་མ་ཡིན་།
 ātmadvīpaśca bhavatyananyadvīpaḥ dharmato 'pi tathāgataṃ na samanupaśyati kaḥ punarvāda rūpakāyena |	དེ་བཞིན་གཤེགས་པ་ལ་ཆོས་ཉིད་དུ་ཡང་མི་ལྟ་ན་གཟུགས་ཀྱི་སྐུར་ལྟ་ཅི་སྨོས་།
 virāgato 'pi dharmaṃ nābhiniviśate kaḥ punarvāda uta vākpathodāharaṇena |	ཆོས་ལ་འདོད་ཆགས་དང་བྲལ་བར་ཡང་མི་ལྟ་ན་སྨྲ་བའི་ཚིག་གི་ལམ་ནས་བརྗོད་པར་ལྟ་ཅི་སྨོས་། 
 asaṃskṛtamapi cāryasaṅghaṃ na vikalpayati |	འཕགས་པ་འདུས་མ་བྱས་པའི་དགེ་འདུན་ལ་ཡང་རྣམ་པར་མི་རྟོག་ན་མང་པོ་འདུས་པར་ལྟ་ཅི་སྨོས་།
 kaḥ punarvādo gaṇasaṃ nipātataḥ nāpi kasyaciddharmasya prarhāṇāyābhiyukto bhavati na bhāvanāyairna sākṣīkriyāya |	ཆོས་གང་སྤང་བར་བྱ་བའི་ཕྱིར་བརྩོན་པ་མ་ཡིན་། བསྒོམ་པར་བྱ་བའི་ཕྱིར་མ་ཡིན་། མངོན་སུམ་དུ་བྱ་བའི་ཕྱིར་མ་ཡིན་།
 na saṃsāre virohati |	འཁོར་བར་ཡང་མི་སྐྱེ་།
 na nirvāṇam abhinandati |	མྱ་ངན་ལས་འདས་པ་ལ་ཡང་མངོན་པར་དགའ་བ་མ་ཡིན་།
 na mokṣaṃ paryeṣate |	ཐར་པ་ཡང་མི་དམིགས་།
 na bandhaṃ |	བཅིངས་པ་ཡང་མ་ཡིན་ལ་།
 prakṛtiparinirvṛtā ca sarvadharmān viditvā na saṃsarati na pariṇirvāyati |	ཆོས་ཐམས་ཅད་རང་བཞིན་གྱིས་ཡོངས་སུ་མྱ་ངན་ལས་འདས་པར་རིགས་ནས་། ཀུན་དུ་མི་འཁོར་། ཡོངས་སུ་མྱ་ངན་ལས་མི་འདའ་བ་ཡིན་ཏེ་།
 ayamucyate kāśyapa bhūtapratipattiḥ śramaṇaḥ ||	འོད་སྲུང་། དེ་ནི་ཡང་དག་པར་སྒྲུབ་པའི་དགེ་སྦྱོང་ཞེས་བྱའོ་༎ འོད་སྲུང་།
 bhūtapratipattyā śrāmaṇyāyogaḥ karaṇīya na nāmahetena bhavitavyo ime kāśyapa catvāra śramaṇā |	ཡང་དག་པར་སྒྲུབ་པའི་དགེ་སྦྱོང་དུ་འགྱུར་བར་བརྩོན་པར་བྱའི་། མིང་གིས་གནོད་པར་ནི་མི་བྱ་སྟེ་། ༄༢༤༨བ་འོད་སྲུང་། དགེ་སྦྱོང་ནི་བཞི་པོ་འདི་དག་གོ་།
 tatredamucyate ||	དེ་ལ་འདི་སྐད་ཅེས་བྱ་སྟེ་།
 kp|126 yo kāyavākcittamaneraśuddho adāntagupto avinīta lubdho	གང་ཞིག་ལུས་དང་ངག་དང་སེམས་མ་དག་། མ་དུལ་མ་བསྲུངས་མ་བྱང་འདོད་ཆེན་ཅན་༎
 muṇḍaḥśiraścīvarapātrapāṇī saṃsthānaliṅgā śramaṇeṣu vukto 1	སྐྲ་བྲེགས་ཆོས་གོས་ལྷུང་བཟེད་ལག་ན་ཐོགས་༎ ང་ནི་དབྱིབས་རྟགས་དགེ་སྦྱོང་ཡིན་ཞེས་བསྟན་༎
 ācāracaryāpsamanvito 'pi rūkṣānnabhojī kuhanādisevī	ཆོ་ག་སྤྱོད་པ་ལ་སོགས་ལྡན་གྱུར་ཅིང་༎ ཁ་ཟས་ངན་ཟ་ཚུལ་འཆོས་ལ་སོགས་སྟེན་༎ འདུ་འཛི་རྒྱང་རིང་ཡོངས་སུ་སྤོང་བྱེད་ཅིང་༎
 caturāryavaṃśehi samanvito 'pi saṃsarga durāt parivarjayanto 2	སྤྱོད་ལམ་འཕགས་པའི་རིགས་དང་ལྡན་གྱུར་ཀྱང་༎ དེ་ཡི་དེ་ཀུན་དུལ་བར་བྱ་ཕྱིར་མིན་༎
 te cāsya sarve na damāya bhonti na śāntaye nāpi ca nirvidāya |	ཞི་ཕྱིར་མ་ཡིན་སྐྱོ་བར་བྱ་ཕྱིར་མིན་༎
 śūnyānimitteṣu prapātasañjñī ācāraguptiḥ kuhako dvitīyoḥ 3	སྟོང་པ་མཚན་མེད་ག-ཡང་སར་འདུ་ཤེས་པ་༎ ཆོ་ག་སྲུང་ཞིང་ཚུལ་འཆོས་གཉིས་པ་ཡིན་༎
 dhutā guṇā śīla śrutaṃ samādhiḥ parasya visvāpanahetu kurvati |	ཚུལ་ཁྲིམས་ཏིང་འཛིན་སྦྱངས་པའི་ཡོན་ཏན་ཐོས་༎ གཞན་དག་ངོ་མཚར་འཛིན་དུ་གཞུག་ཕྱིར་བྱེད་༎
 na śāntaye nāpi ca nirvidāya kīrtīyaślokaśramaṇostṛtīya | 4	ཞི་ཕྱིར་མ་ཡིན་སྐྱོ་བར་བྱ་ཕྱིར་མིན་༎ བརྗོད་དང་གྲགས་འདོད་དགེ་སྦྱོང་གསུམ་པ་ཡིན་༎
 kāyena yo arthika jīvitena vā yo lābhasatkāraparāmukhaśca	གང་ཞིག་ལུས་སྲོག་དོན་དུ་མི་གཉེར་ཞིང་༎ རྙེད་དང་བཀུར་སྟི་ལ་ནི་རྒྱབ་ཀྱིས་ཕྱོགས་༎
 vimokṣa utpādamukhaṃ ca śrutvā anarthikā sarvabhavadgatīṣu | 5 ||	རྣམ་པར་ཐར་པ་བསྐྱེད་པའི་སྒོ་ཐོས་ནས་༎ སྲིད་པའི་འགྲོ་བ་ཐམས་ཅད་དོན་མི་གཉེར་༎ ཆོས་རྣམས་ཤིན་ཏུ་སྟོང་པར་ཡོངས་བརྟགས་ནས་༎
 atyantaśūnyāśca parīkṣa dharmān na nirvṛtiṃ paśyati nāpyanirvṛtiṃ |	མྱ་ངན་འདས་དང་མ་འདས་མཐོང་མི་འགྱུར་༎
 virāgato dharmamavekṣate sadā asaṃskṛtaṃ dharmam anitya nirvṛtaḥ 6 ||	ཆོས་ལ་འདོད་ཆགས་བྲལ་བར་རྟག་ཏུ་རྟོག་། མ་བྱས་ཆོས་རྟོགས་མྱ་ངན་འདས་པར་འགྱུར་༎ འོད་སྲུང་། འདི་ལྟ་སྟེ་།
 kp|127 tadythāpi nāma kāśyapa daridrapuruṣasya samṛdhakośa iti nāmadheyamaṃ bhavet |	དཔེར་ན་། མི་དབུལ་པོ་ཞིག་ལ་མཛོད་འབྱོར་པ་༄༢༤༩ཨ་༌༎ ཞེས་མིང་བཏགས་ན་།
 tatkiṃ manyase kāśyapa anurūpaṃ tasya daridrapuruṣasya tannāmadheyaṃ bhavet |	འོད་སྲུང་། འདི་ཇི་སྙམ་དུ་སེམས་། མི་དབུལ་པོ་དེ་དང་མིང་དེ་མཐུན་པ་ཡིན་ནམ་། གསོལ་པ་།
 āha no hīdam bhadanta bhagavan | bhagavān āha |	བཅོམ་ལྡན་འདས་། དེ་ནི་མ་ལགས་སོ༏་༏བཅོམ་ལྡན་འདས་ཀྱིས་བཀའ་སྩལ་པ་། འོད་སྲུང་།
 evameva kāśyapa ye te śramaṇabrāhmaṇa ityucyante | na ca śramaṇabrāhmaṇasamanvāgatā bhavanti | tān ahaṃ daridiapuruṣān iti vadāmi |	དེ་བཞིན་དུ་གང་དགེ་སྦྱོང་དང་། བྲམ་ཟེ་གང་དག་དགེ་སྦྱོང་དང་། བྲམ་ཟེའི་ཡོན་ཏན་དང་མི་ལྡན་པ་དེ་དག་ནི་གསུང་རབ་འདི་ལས་མི་དབུལ་པོ་ཞེས་ངས་བཤད་དོ་༎ 
 tatredamucyate	དེ་ལ་འདི་སྐད་ཅེས་བྱ་སྟེ་།
 || yathā daridrasya bhaveta nāmaṃ samṛddhakośambhi na tacca śobhate |	དཔེར་ན་དབུལ་པོར་གྱུར་པའི་མི་ཞིག་ལ་༎ མཛོད་ལྡན་མིང་བཏགས་དེ་ལ་མཛེས་མ་ཡིན་༎
 śrāmaṇyahīna śramaṇo na śobhate daridra āḍhyetiva ucyamānaḥ ||	དགེ་སྦྱོང་ཉམས་ལ་དགེ་སྦྱོང་མིང་མི་མཛེས་༎ དབུལ་ལ་ཕྱུག་ཅེས་བཏགས་པའི་དཔེ་དང་མཚུངས་༎ འོད་སྲུང་། འདི་ལྟ་སྟེ་།
 kp|128 tadyathāpi nāma kāśyapa kaścideva puruṣo mahatā udakārṇavenohyamānaḥ tṛṣayā kālaṃ kuryāt |	དཔེར་ན་། མི་ལ་ལ་ཞིག་རྒྱ་མཚོའི་ཆུ་ཆེན་པོས་ཁྱེར་ལ་། ཆུས་སྐོམ་བཞིན་དུ་འཆི་བའི་དུས་བྱེད་པ་དེ་བཞིན་དུ་།
 evameva kāśyapa ihekatye śramaṇabrāhmaṇo bahun dharmān paryāpnuvanti na rāgatṛṣṇān vinodayanti |	འོད་སྲུང་། འདི་ལ་དགེ་སྦྱོང་དང་། བྲམ་ཟེ་ཁ་ཅིག་ཆོས་མང་པོ་བླངས་ཏེ་། ཀུན་ཆུབ་པར་བྱས་ཀྱང་འདོད་ཆགས་ལ་སྲེད་པ་མི་སེལ་།
 na dveṣatṛṣṇā na mohatṛṣṇā śaknuvanti vinodayituṃ |	ཞེ་སྡང་ལ་སྲེད་པ་མི་སེལ་།
 te mahatā dharmārṇavenohyamānā kleśatṛṣāyā kālagatā durgatigāmino bhavanti |	གཏི་མུག་ལ་སྲེད་པ་མི་སེལ་བ་དེ་དག་ཆོས་ཀྱི་རྒྱ་མཚོས་ཁྱེར་ལ་། ཉོན་མོངས་པའི་སྐོམ་པས་འཆི་བའི་དུས་བྱེད་པར་འགྱུར་ཏེ་། ངན་འགྲོར་འགྲོ་བར་འགྱུར་རོ་༎
 tatredamucyate 2 ||	དེ་ལ་འདི་སྐད་ཅེས་བྱ་སྟེ་། དཔེར་ན་མི་ཞིག་རྒྱ་མཚོའི་ཆུས་ཁྱེར་ལ་༎
 yathā manuṣyo udakārṇavena uhyanti tṛṣṇāya kareya kālam |	དེ་ནི་སྐོམ་ཞིང་འཆི་བའི་དུས་བྱེད་འགྱུར་༎
 tathā paṭhantā bahudharmatṛṣṇayā dharmārṇavasthāmi vrajantyapāyaṃ ||	དེ་བཞིན་ཆོས་མང་སྲེད་པས་བག་མེད་པ་༎ ཆོས་ཀྱི་༄༢༤༩བ་རྒྱ་མཚོར་གནས་ཀྱང་ངན་སོང་འགྲོ་༎ འོད་སྲུང་།
 kp|129 tadyathāpi nāma kāśyapa vaidyo oṣadhabhāraṃ gṛhītvā anuvicaret tasya kaścid eva vyādhi utpadyeta na ca taṃ vyādhi śaknuyācikitsituṃ |	འདི་ལྟ་སྟེ་། དཔེར་ན་། སྨན་པ་སྨན་སྒྲོ་ཐོགས་ཏེ་ཕྱོགས་དང་ཕྱོགས་མཚམས་སུ་རྒྱུ་བ་དེ་ནད་ཅིག་གིས་བཏབ་ནས་ནད་དེ་གསོ་མི་ནུས་ན་སྨན་དེ་ནི་དོན་མེད་པ་ཡིན་ནོ་༎ 
 evameva kāśyapa bahuśrutasya kleśavyādhi draṣṭavyā yastena śrutena na śaknoti ātmanaḥ kleṣavyādhi cikitsituṃ |	འོད་སྲུང་། དེ་བཞིན་དུ་མང་དུ་ཐོས་པའི་ཉོན་མོངས་པའི་ནད་དུ་ལྟ་སྟེ་། གང་མང་དུ་ཐོས་པ་དེས་བདག་ཉོན་མོངས་པའི་ནད་ལས་གསོ་མི་ནུས་ན་།
 nirarthakaṃ tasya tacchrutaṃ bhaviṣyati |	དེའི་མང་དུ་ཐོས་པ་དེ་ནི་དོན་མེད་པ་ཡིན་ནོ་༎
 tatredamucyate 3 ||	དེ་ལ་འདི་སྐད་ཅེས་བྱ་སྟེ་།
 yatheva vaidyauṣadharbharastrasaṃsthe parilhrameta nikhilaṃhi loke |	དཔེར་ན་སྨན་པའི་སྨན་སྒྲོར་བཅུག་པའི་སྨན་༎ འཇིག་རྟེན་ཀུན་དུ་ཡོངས་སུ་རྒྱུ་བྱེད་ཀྱང་༎ ནད་ཀྱིས་བཏབ་པ་བཟློག་པར་མི་ནུས་ན་༎
 utpannavyādhīn a nivartayeca nirarthakaṃ tasya bhaveta taṃ hi |	དེ་ཡི་སྨན་དེ་དོན་མེད་གྱུར་པ་ཡིན་༎
 bhikṣustathā śīlaguṇerupetaḥ śrutena yukto 'pi na ca ścikitset |	དེ་བཞིན་དགེ་སློང་ཚུལ་ཁྲིམས་ཡོན་ཏན་ལྡན་༎ ཐོས་དང་ལྡན་ཡང་ཚུལ་བཞིན་མ་ཡིན་པའི་༎ ཉོན་མོངས་བྱུང་བའི་ནད་ནི་མི་སེལ་ན་༎
 ayoniśa kleśasamutthitā rujā vṛthā śramastasya śrutābhiyogaḥ ||	དེ་ཡི་ཐོས་ལ་བརྩོན་པ་དོན་མེད་ཡིན་༎
 kp|130 tadyathāpi nāma kāśyapa |	འོད་སྲུང་། འདི་ལྟ་སྟེ་། དཔེར་ན་།
 glānaḥ puruṣo rājārhan bhaiṣajyam upayujyāsaṃvareṇa kālaṃ kuryāt |	མི་ནད་པ་ཞིག་ལ་རྒྱལ་པོ་ལ་འོས་པའི་སྨན་བཏང་ལ་།
 evameva kāśyapa bahuśrutasya kleśavyādhiṃ draṣṭavyāḥ yastenāsṃvareṇa kālaṃ karoti | yo rājārhāṃ bhaiṣajyāṃ paryāpunitvā asaṃvareṇa apāyagāmī bhavati |	ཆོ་ག་བཞིན་མ་བྱས་པས་འཆི་བའི་དུས་བྱས་པ་དེ་བཞིན་དུ་། འོད་སྲུང་། གང་མི་སྡོམ་པ་འཆི་བའི་དུས་བྱེད་པ་དེ་ཡང་མང་དུ་ཐོས་པའི་ཉོན་མོངས་པའི་ནད་དུ་ལྟའོ་༎ 
 tatredamucyate 4 ||	དེ་ལ་འདི་སྐད་ཅེས་བྱ་སྟེ་།
 yathāpi rājārhaṃ pītva bheṣajaṃ vrajennaro saṃvarato nipātaṃ |	དཔེར་ན་རྒྱལ་པོ་འོས་པའི་སྨན་བཏང་ནས་༎ ཆོ་ག་མི་བྱས་མི་དེ་ཤི་བར་གྱུར་༎
 bahuśrutasyeṣa tu kleśavyādhir yo saṃvareṇeha karoti kālam |	དེ་བཞིན་གང་མི་སྡོམ་པས་འདི་ཤི་བ་༎ དེ་ནི་མང་དུ་ཐོས་པའི་ཉོན་མོངས་ནད་༎ འོད་སྲུང་།
 kp|131 tadyathāpi nāma kāśyapa anarghaṃ vaiḍūryamahāmaṇiratnam uccāre patitam akāryopakaṃ bhavati |	འདི་ལྟ་སྟེ་། དཔེར་ན་། ནོར་བུ་རིན་པོ་ཆེ་མི་གཙང་བའི་ནང་དུ་ལྷུང་ན་སྨད་པར་འགྱུར་ཞིང་མཁོ་བར་༄༢༥༠ཨ་༌༎ མི་འགྱུར་རོ་༎
 evameva kāśyapa bahuśrutasya lābhasatkārauccārapatanaṃ draṣṭavya |	འོད་སྲུང་། དེ་བཞིན་དུ་མང་དུ་ཐོས་པ་རྙེད་པ་དང་བཀུར་སྟིའི་མི་གཙང་བའི་ནང་དུ་ལྷུང་བར་ལྟ་སྟེ་། 
 niṣkiñcanaṃ devamanuṣyeṣu |	ཅི་ཡང་མེད་པ་ལ་ནི་ལྷ་དང་མི་རྣམས་དགའ་བར་མི་འགྱུར་རོ་༎
 tatredamucyate 5 ||	དེ་ལ་འདི་སྐད་ཅེས་བྱ་སྟེ་།
 ratnaṃ yathoccāragataṃ juguspitaṃ yathā syānna tathā yathā pura |	དཔེར་ན་རིན་ཆེན་མི་གཙང་ལྷུང་བ་སྨད་༎ ཇི་ལྟར་སྔོན་བཞིན་དེ་ནི་ཕྱིས་མ་ཡིན་༎ དགེ་སློང་མང་དུ་ཐོས་པར་གྱུར་པ་ཡང་༎
 bahuśrutasyāpi vadāmi bhikṣoḥ satkāramīḍe patanaṃ tatheva | || tadyathāpi nāma kāśyapā tadeva vaiḍūryaṃ mahāmaṇiratnam ameddhyāvaskarāduddhṛtaṃ bhavet suddhautaṃ suprakṣālitaṃ suparimārjitaṃ | taṃ maṇiratnasvabhāvam eva na vijahatyevameva kāśyapa bahuśruto 'lpaprayatnena sarvakleśān viśodhayati mahāprajñāratnasvabhāvam eva na vijahāti	བཀུར་སྟིའི་མི་གཙང་ལྷུང་བ་དེ་འདྲར་བཤད་༎
 kp|132 tadyathāpi nāma kāśyapa mṛtakasya śirasi suvarṇamālā |	འོད་སྲུང་། འདི་ལྟ་སྟེ་། དཔེར་ན་།
 evameva kāśyapa duḥśīlasya kāṣāyadhāraṇaṃ draṣṭavyaṃ |	མི་རོའི་མགོ་ལ་གསེར་གྱི་ཕྲེང་བ་བཏགས་པ་དེ་བཞིན་དུ་ཚུལ་ཁྲིམས་འཆལ་བ་ངུར་སྨྲིག་གྱོན་པར་བལྟའོ་༎ 
 tatredamucyate | 7 ||	དེ་ལ་འདི་སྐད་ཅེས་བྱ་སྟེ་།
 suvarṇamāleva mṛtasya śīrṣe nyastā yathā syād atha puṣpamālā	དཔེར་ན་མི་རོའི་མགོ་ལ་གསེར་ཕྲེང་ངམ་༎
 kāṣāyavastrāṇi tathā viśīle dṛṣṭvā 'nna kuryān manasaḥ pradoṣāṃ ||	ཡང་ན་མེ་ཏོག་ཕྲེང་བ་བཏགས་བྱས་པ་༎ དེ་བཞིན་ཁྲིམས་མེད་ངུར་སྨྲིག་གྱོན་པ་ཡང་༎ མཐོང་ནས་དེ་ལ་ཡིད་ནི་དད་མི་འགྱུར་༎ འོད་སྲུང་། འདི་ལྟ་སྟེ་།
 kp|133 tadyathāpi nāma kāśyapa avadātavas||||||||||||||||||||||||||||||||||| sya pravaracandanānuliptasya śreṣṭhiputrasya vā rājaputrasya vā śirasi campakamālābaddhaṃ bhavet |	དཔེར་ན་། ཚོང་དཔོན་གྱི་བུ་ཞིག་ལེགས་པར་ཁྲུས་བྱས་ཏེ་། ལེགས་པར་རྣམ་པར་བྱུགས་ལ་སྐྲ་དང་སེན་མོ་བྲེགས་ནས་གོས་དཀར་པོ་བགོས་ཏེ་ཙན་དན་མཆོག་གིས་བསྐུས་པའི་མགོ་ལ་ཙམ་པ་ཀའི་མེ་ཏོག་གི་ཕྲེང་བ་ཐོགས་པ་དེ་བཞིན་དུ་། འོད་སྲུང་།
 evam e|||||||||||||||||||||||||||||||||||| lavato bahuśrutasya kāṣāyadhāraṇaṃ draṣṭavyaḥ tatredamucyate 8 ||	ཚུལ་ཁྲིམས་དང་ལྡན་ཞིང་མང་དུ་ཐོས་པ་ངུར་སྨྲིག་གྱོན་པར་བལྟའོ་༎ དེ་ལ་འདི་སྐད་ཅེས་བྱ་སྟེ་།
 susnātasyānuliptasya śreṣṭhiputrasya śobhe X	ལེགས་བཀྲུས་ལེགས་པར་བྱུགས་པ་ཡི་༎ ཚོང་དཔོན་བུ་ཡི་མགོ་བོ་ལ་༎
 XXX mpakāmāleva śubhagandhā manoramāṃ	ཙམ་པ་ཀ་ཡི་མེ་ཏོག་ཕྲེང་༎ དྲི་ཞིམ་ཡིད་འོང་བཏགས་པ་མཛེས་༎ དེ་བཞིན་༄༢༥༠བ་ཚུལ་ཁྲིམས་ལྡན་གྱུར་ཅིང་༎ མང་ཐོས་ཚུལ་ཁྲིམས་ཕུན་སུམ་ཚོགས་༎ རྒྱལ་བའི་སྲས་པོ་ཡོན་ཏན་ལྡན་༎
 yathā tatheva kāṣāyaṃ saṃvarasthe bahuśrute draṣṭavyaṃ śīlasampanna XXXX guṇānvite 2 ||	དེ་ལ་ངུར་སྨྲིག་དེ་བཞིན་མཛེས་༎ འོད་སྲུང་། བཞི་པོ་འདི་དག་ནི་ཚུལ་ཁྲིམས་འཆལ་བ་ཚུལ་ཁྲིམས་དང་ལྡན་པ་ལྟར་བཅོས་པ་ཡིན་ཏེ་།
 kp|134 catvāra ime kāśyapa duḥśīlā śīlavantapratirūpakāḥ katame catvāraḥ iha kāśyapa e||||||||||||||||| tyo bhikṣuḥ prātimokṣasaṃvarasaṃvṛto viharati |	བཞི་གང་ཞེ་ན་། འོད་སྲུང་། འདི་ལ་དགེ་སློང་ཁ་ཅིག་ཚུལ་ཁྲིམས་དང་ལྡན་པ་ཡིན་ཏེ་། སོ་སོར་ཐར་པའི་སྡོམ་པས་བསྡམས་ཤིང་གནས་།
 ācāragocarasampanna aṇumātreṣvavadyeṣu bhayadarśī samā||||||||||||||||||||||| ya śikṣate śikṣāpadeṣu |	ཆོ་ག་དང་སྤྱོད་ཡུལ་ཕུན་སུམ་ཚོགས་པ་། ཁ་ན་མ་ཐོ་བ་ཕྲ་རབ་རྣམས་ལ་ཡང་འཇིགས་པར་ལྟ་། ཡང་དག་པར་བླངས་ཏེ་བསླབ་པའི་གཞི་རྣམས་ལ་སློབ་ཅིང་།
 pariśuddhakāyakarmavāṅmanaskarmaṇā samanvāgato viharati |	ལུས་ཀྱི་ལས་དང༏་ངག་གི་ལས་དང་། ཡིད་ཀྱི་ལས་ཡོངས་སུ་དག་པ་དང་ལྡན་པར་གནས་པས་འཚོ་བ་ཡོངས་སུ་དག་ཀྱང་།
 pariśuddhājīvaḥ sa ca bha|||||||||||||||||||||| tyātmavādī ayam kāśyapa prathamo duḥśīlaḥ śīlavantaḥpratirūpako draṣṭavyaḥ ||	དེ་བདག་ཏུ་སྨྲ་བ་ཡིན་ཏེ་། འོད་སྲུང་། དེ་ནི་ཚུལ་ཁྲིམས་འཆལ་པ་ཚུལ་ཁྲིམས་དང་ལྡན་པ་ལྟར་བཅོས་པ་དང་པོའོ་༎
 punar aparaṃ kāśyapa ihekatyo bhikṣurvinayadharo bhavati |	འོད་སྲུང་། གཞན་ཡང་འདི་ལ་དགེ་སློང་ཁ་ཅིག་འདུལ་བ་འཛིན་ཅིང་འདུལ་བ་ལ་ཞུགས་ཏེ་།
 pravartavinayo vinayaguptiḥpratiṣṭhitaḥ satkāyadṛṣṭirasyānucalitā bhavati |	འདུལ་བའི་ཚུལ་ལ་གནས་པ་ཡིན་ཡང་འཇིག་ཚོགས་ལ་ལྟ་བ་ལས་མ་བསྐྱོད་པ་ཡིན་ཏེ་།
 ayaṃ kāśyapa dvitīyo duḥśīlaḥ śīlavantaḥpratirūpakaḥ ||	འོད་སྲུང་། དེ་ནི་ཚུལ་ཁྲིམས་འཆལ་པ་ཚུལ་ཁྲིམས་དང་ལྡན་པ་ལྟར་བཅོས་པ་གཉིས་པའོ་༎ འོད་སྲུང་།
 punaraparaṃ kāśyapa ihekatyo bhikṣuḥ maitrāvihāri bhavati sattvā||||||||||||| ṇayā samanvāgataḥ sa ca ajāti sarvvadharmāṇāṃ śrutvā utrasati	གཞན་ཡང་འདི་ལ་དགེ་སློང་ཁ་ཅིག་བྱམས་པ་ལ་གནས་པ་ལ་གནས་པ་ཡིན་ཏེ་། སེམས་ཅན་ལ་དམིགས་པའི་བྱམས་པ་དང་ལྡན་པ་ཡིན་ཡང་འདུ་བྱེད་ཐམས་ཅད་ལ་སྐྱེ་བ་མེད་པ་ཐོས་ན་སྐྲག་སྟེ་ཀུན་དུ་དངང་བར་འགྱུར་ཅིང་། 
 santrasati | santrāsamāpadyate |	ཀུན་དུ་རབ་ཏུ་དངང་བར་འགྱུར་༄༢༥༡ཨ་༌༎
 ayaṃ kāśyapa tṛtīyo duḥśīlaḥ śīlavantaḥpratirūpakaḥ ||	བ་དེ་ནི་། འོད་སྲུང་། ཚུལ་ཁྲིམས་འཆལ་པ་ཚུལ་ཁྲིམས་དང་ལྡན་པ་ལྟར་བཅོས་པ་གསུམ་པའོ་༎ འོད་སྲུང་། གཞན་ཡང་འདི་ལ་དགེ་སློང་ཁ་ཅིག་སྦྱངས་པའི་ཡོན་ཏན་བཅུ་གཉིས་ཡང་དག་པར་བླངས་ཀྱང་དམིགས་པར་ལྟ་བ་ཡིན་ཏེ་།
 punaraparaṃ kāśyapa ihekatyo bhikṣuḥ dvādaśadhutaguṇasa||||||||||||||||| upalambhadṛṣṭikaśca bhavatyahaṅkārasthitaḥ ayaṃ kāśyapa caturtho duḥśīlaḥ	ངར་འཛིན་པ་དང་། ང་ཡིར་འཛིན་པ་ལ་གནས་པ་དེ་ནི་། འོད་སྲུང་། ཚུལ་ཁྲིམས་འཆལ་པ་ཚུལ་ཁྲིམས་དང་ལྡན་པ་ལྟར་བཅོས་པ་བཞི་པ་སྟེ་།
 dra||||||||||||||||||||| pa catvāro duḥlā śīlavantapratirūpakā draṣṭavyāḥ || kp|135 śīlam śīlam iti kāśyapa ucyate |	འོད་སྲུང་། བཞི་པོ་དེ་དག་ནི་ཚུལ་ཁྲིམས་འཆལ་པ་ཚུལ་ཁྲིམས་དང་ལྡན་པ་ལྟར་བཅོས་པ་ཡིན་ནོ་༎ འོད་སྲུང་།
 yatra nātma||||||||||||||||||||| nātmīya na sattvo na sattvaprajñaptiḥ na kriyā nākriyā | na karaṇaṃ nākaraṇaṃ | cāro nācāraḥ na pracā||||||||||||||||| nāpracāraḥ na nāmaṃ na rūpa | nimittaṃ nānimittaṃ | na śamo napraśamaḥ na grāho notsargaḥ na grāhyaṃ ||||||||||||||| hya | na sattvo na sattvaprajñaptiḥ na vāṅ na vākprajñapti na cittaṃ na cittaprajñaptiḥ na loko nālokaḥ na niśrayo nāniśrayaḥ nā maśīlotkarṣaṇā | na paraduḥśīlapaṃsanā | na śīlamanyanā | na śīlakalpanā | vikalpanā | na saṅkalpanā na parikalpanā | iyamucyate kāśyapa āryāṇā śīla |	ཚུལ་ཁྲིམས་ཞེས་བྱ་བ་ནི་གང་ལ་བདག་མེད་པ་དང་། བདག་གི་བ་མེད་པ་དང་། བྱ་བ་མེད་པ་དང་། མི་བྱ་བ་ཡང་མེད་པ་དང་། བྱེད་པ་མེད་པ་དང་། བྱེད་པ་མེད་པ་ཡང་མ་ཡིན་པ་དང་། རྒྱུ་བ་མ་ཡིན་པ་དང་། མི་རྒྱུ་བ་ཡང་མ་ཡིན་པ་དང་། རབ་ཏུ་སྤྱོད་པ་མེད་པ་དང་། རབ་ཏུ་སྤྱོད་པ་མེད་པ་ཡང་མ་ཡིན་པ་དང་། མིང་མེད་པ་དང་། གཟུགས་མེད་པ་དང་། མཚན་མ་མེད་པ་དང་། མཚན་མ་མེད་པ་ཡང་མ་ཡིན་པ་དང་། རབ་ཏུ་ཞི་བ་མ་ཡིན་པ་དང་། རབ་ཏུ་མ་ཞི་བ་ཡང་མ་ཡིན་པ་དང་། འཛིན་པ་མེད་པ་དང་། འདོར་བ་མེད་པ་དང་། གཟུང་བ་མེད་པ་དང་། གཟུང་བ་མེད་པ་ཡང་མ་ཡིན་པ་དང་། སེམས་ཅན་མེད་པ་དང་། སེམས་ཅན་དུ་འདོགས་པ་མེད་པ་དང་། ཚིག་མེད་པ་དང་། ཚིག་ཏུ་འདོགས་པ་མེད་པ་དང་། སེམས་མེད་པ་དང་། སེམས་སུ་༄༢༥༡བ་འདོགས་པ་མེད་པ་དང་། འཇིག་རྟེན་མེད་པ་དང་། འཇིག་རྟེན་མེད་པ་ཡང་མ་ཡིན་པ་དང་། རྟེན་མེད་པ་དང་། རྟེན་མེད་པ་ཡང་མ་ཡིན་པ་དང་། བདག་གི་ཚུལ་ཁྲིམས་ལ་མི་བསྟོད་པ་དང་། གཞན་གྱི་ཚུལ་ཁྲིམས་ལ་མི་སྨད་པ་དང་། ཚུལ་ཁྲིམས་ཀྱིས་རློམ་སེམས་སུ་མི་བྱེད་པ་དང་། ཚུལ་ཁྲིམས་ལ་མི་རྟོག་པ་ཡིན་ཏེ་།
 anāsravam aparyāpannaṃ traidhātukānu gataṃ sarvaniśrayāpagaṃ |	དེ་ནི་འཕགས་པ་རྣམས་ཀྱི་ཚུལ་ཁྲིམས་ཟག་པ་མེད་པ༏་རྟོག་པ་མ་ཡིན་པ་། ཁམས་གསུམ་པ་དང་བྲལ་བ་། རྟེན་ཐམས་ཅད་མེད་པ་ཞེས་བྱའོ་༎
 kp|136 atha bhagavāṃstasyāṃ velāyam imāṃ gāthām abhāṣataḥ || na śīlavantasya m||||||||||||||| na kiñcana	དེ་ནས་བཅོམ་ལྡན་འདས་ཀྱིས་ཚིགས་སུ་བཅད་པ་འདི་དག་གསུངས་སོ་༎ ཚུལ་ཁྲིམས་ལྡན་ལ་དྲི་མ་མེད་ཅིང་ཅི་ཡང་མེད་༎
 na śīlavantasya mado na niśrayaḥ	ཚུལ་ཁྲིམས་ལྡན་ལ་རྒྱགས་པ་མེད་དེ་རྟེན་པ་མེད་༎
 na śīlavantasya tamo na bandhanam |	ཚུལ་ཁྲིམས་ལྡན་ལ་མུན་པ་མེད་ཅིང་འཆིང་བ་མེད་༎
 na śīlavantasya rajo na|||||||||||||||	ཚུལ་ཁྲིམས་ལྡན་ལ་རྡུལ་རྣམས་མེད་དེ་ཉེས་པ་མེད་༎
 śāntapraśānta upaśāntamānaso	ཞི་བ་རབ་ཏུ་ཞི་བ་ཉེ་བར་ཞི་བའི་ཡིད་༎
 kalpaḥ vikalpāpagato niraṅgaṇaḥ	རྟོག་དང་རྣམ་པར་རྟོག་དང་བྲལ་ཞིང་ཉོན་མོངས་མེད་༎
 sarveñjanāmanyanavipramuktaḥ XśiXX n kāśyapa buddhaśāsaneḥ	ག-ཡོ་བ་དང་ནི་རློམ་སེམས་ཀུན་དང་རྣམ་བྲལ་བར་༎ དེ་ནི་འོད་སྲུང་སངས་རྒྱས་བསྟན་ལ་ཚུལ་ཁྲིམས་ལྡན་༎
 na kāyasāvekṣi na jīvitārthiko	ལུས་ལ་མི་ལྟ་སྲོག་ལ་ཕངས་པར་འཛིན་མི་བྱེད་༎
 hyanarthikaḥ sarvabhavopapattibhiḥ samyaggat| ḥ s||||||||||||||||||| pratiṣṭhitaḥ	སྲིད་པ་རྣམས་སུ་སྐྱེ་བ་ཀུན་ལ་འདོད་པ་མེད་༎ ཡང་དག་ཞུགས་ཤིང་དེ་ཉིད་ཚུལ་ལ་རབ་གནས་པ་༎
 sa śīlavān kāśyapa buddhaśāsane | 3	དེ་ནི་འོད་སྲུང་སངས་རྒྱས་བསྟན་ལ་ཚུལ་ཁྲིམས་ལྡན་༎
 na lokalipto na ca lokaniśritoḥ ālokaprāpto amamo||||||||||||||||||| ñcanaḥ	འཇིག་རྟེན་མ་གོས་འཇིག་རྟེན་དག་ལ་གནས་པ་མེད་༎ སྣང་བ་ཐོབ་ཅིང་བདག་གི་མེད་དེ་ཅི་ཡང་མེད་༎
 na cātmasañjñī na pareṣu sañjñī	བདག་ཏུ་འདུ་ཤེས་༄༢༥༢ཨ་༌༎ མེད་ཅིང་གཞན་དུ་འདུ་ཤེས་མེད་༎
 sañjñā parijñāya viśuddhaśīlaḥ 4	འདུ་ཤེས་ཡོངས་སུ་ཤེས་པས་ཚུལ་ཁྲིམས་རྣམ་པར་དག་།
 yasyā napāraṃ na ca pāramadhy| X pārapāre ca na jātu saktaḥ	གང་ལ་ཚུ་རོལ་མེད་ཅིང་ཕ་རོལ་དབུས་ཀྱང་མེད་༎ ཕ་རོལ་ཚུ་རོལ་དག་ལ་ནམ་ཡང་མི་ཆགས་ཤིང་༎
 avabaddhāsakto akuho anāsravaḥ	བཅིངས་དང་ཆགས་མེད་ཚུལ་འཆོས་མེད་ཅིང་ཟག་པ་མེད་༎
 sa śīlavān kāśyapa buddhaśāsane | 5	དེ་ནི་འོད་སྲུང་སངས་རྒྱས་བསྟན་ལ་ཚུལ་ཁྲིམས་ལྡན་༎ མིང་དང་གཟུགས་རྣམས་ལ་ནི་ཆགས་པ་མེད་པའི་ཡིད་༎
 kp|137 nāme ca rūpe ca asaktamānasaḥ samāhitasso hi sudāntacittaḥ	དེ་ནི་མཉམ་པར་བཞག་ཅིང་ཤིན་ཏུ་དུལ་བའི་སེམས་༎
 yasyeha ātmā na ca ātmanīyām etāvatā śīlasthito nirucyate | 6	གང་ལ་བདག་མེད་བདག་གིར་འཛིན་པ་མེད་པ་ནི་༎ དེ་ཙམ་གྱིས་ནི་ཚུལ་ཁྲིམས་གནས་ཞེས་བརྗོད་པ་ཡིན་༎
 na śikṣayā manyati prātimokṣe na cāpi tena bhavateha tanmayo |	སོ་སོར་ཐར་པ་སློབ་པས་རློམ་སེམས་བྱེད་པ་མེད་༎ དེས་ནི་འདི་ན་དེ་ལ་ཆགས་པར་མི་འགྱུར་ཏེ་།
 athottaraṃ margati āryamārge viśuddhaśīlasya ime nimittā 7	དེ་ཡི་གོང་དུ་འཕགས་པའི་ལམ་རྣམས་ཚོལ་བྱེད་པ་༎ དེ་ནི་ཚུལ་ཁྲིམས་རྣམ་པར་དག་པའི་མཚན་མའོ་༎ ཚུལ་ཁྲིམས་གཙོ་བོར་མ་ཡིན་ཏིང་འཛིན་དེར་ཆགས་མེད་༎
 na śīlaparamo na samādhitannmayoḥ paryeṣate duttari prajñābhāvanā |	དེ་ཡི་གོང་དུ་ཤེས་རབ་བསྒོམ་པ་ཡོངས་སུ་ཚོལ་༎
 anopalambham āryāṇa gotraṃ viśuddhaśīla sugataṃ praśastam |	དམིགས་པ་མེད་པ་འཕགས་པ་རྣམས་ཀྱི་རིགས་ཡིན་ཏེ་༎ ཚུལ་ཁྲིམས་དེ་ནི་བདེ་བར་གཤེགས་པས་རབ་ཏུ་བསྔགས་༎
 satkāyadṛṣṭe hi vimuktamānaso ahaṃ mamaitīha na tasya bhoti |	འཇིག་པའི་ཚོགས་ལ་ལྟ་ལས་རྣམ་པར་གྲོལ་བའི་ཡིད་༎ དེ་འདིར་ང་དང་ང་ཡི་སྙམ་དུ་འགྱུར་བ་མེད་༎
 adhimucyate śūnyatabuddhagocaramm imasya śīlasya samo na vidyate | 9	སངས་རྒྱས་སྤྱོད་ཡུལ་སྟོང་པ་ཉིད་ལ་ལྷག་པར་མོས་༎ དེ་ཡི་ཚུལ་ཁྲིམས་དེ་ནི་མཉམ་པ་མེད་པའོ་༎
 śīle pratiṣṭhāya samādhi śuddhaḥ samādhiprāptasya ca prajñabhāvanā |	ཚུལ་ཁྲིམས་ལ་ནི་གནས་ནས་ཏིང་ངེ་༄༢༥༢བ་འཛིན་ཀྱང་ཐོབ་༎ ཏིང་ངེ་འཛིན་རྣམས་ཐོབ་ནས་ཤེས་རབ་ཤིན་ཏུ་བསྒོམ་༎
 prajñāya jñānaṃ bhavate viśuddhaṃ viśuddhajñānasya ca śīlasampadā | 10 ||	ཤེས་རབ་ཀྱིས་ནི་ཡེ་ཤེས་རྣམ་པར་དག་པ་ཐོབ་༎ ཡེ་ཤེས་རྣམ་པར་དག་པས་ཚུལ་ཁྲིམས་ཕུན་སུམ་ཚོགས་།
 kp|138 asmin khalu punargāthābhinirhāre bhāṣyamāṇe aṣṭānāṃ bhikṣuśatānām anupādāyāsravebhyaścittāni vimuktāni |	ཚིགས་སུ་བཅད་པ་མངོན་པར་བསྒྲུབ་པ་འདི་དག་གསུངས་པའི་ཚེ་། དགེ་སློང་བརྒྱད་བརྒྱ་ནི་ལེན་པ་མེད་པ་ཟག་པ་རྣམས་ལས་སེམས་རྣམ་པར་གྲོལ་ལོ་༎
 dvātriṃśatināṃ ca prāṇasahasrāṇāṃ virajo vigatamalaṃ dharmeṣu dharmacakṣurviśuddhaṃ |	སྲོག་ཆགས་སུམ་ཁྲི་ཉིས་སྟོང་ནི་ཆོས་རྣམས་ལ་ཆོས་ཀྱི་མིག་རྡུལ་དང་བྲལ་ཞིང་དྲི་མ་མེད་པ་རྣམ་པར་དག་གོ་།
 pañca bhikṣuśatāni dhyānalābhī uthāyāsanebhyaḥ prakrāntāni imāṃ gambhīrā dharmadeśanām avataranto nāvagāhamānāḥ anadhimucyamānāḥ	དགེ་སློང་བསམ་གཏན་ཐོབ་པ་ལྔ་བརྒྱ་ནི་ཆོས་བསྟན་པ་ཟབ་མོ་འདི་ལ་མི་འཇུག་སྟེ་། མ་རྟོགས་མ་མོས་པས་སྟན་ལས་ལངས་ཏེ་དོང་ངོ་༎
 kp|139 athāyuṣmān mahākāśyapo bhagavantam etadavocat imāni bhagavan pañca bhikṣuṣatāni dhyānalābhīnyutthāyāsanebhyaḥ prakrāntāni |	དེ་ནས་བཅོམ་ལྡན་འདས་ལ་ཚེ་དང་ལྡན་པ་འོད་སྲུང་ཆེན་པོས་འདི་སྐད་ཅེས་གསོལ་ཏོ་༎ བཅོམ་ལྡན་འདས་། དགེ་སློང་བསམ་གཏན་ཐོབ་པ་ལྔ་བརྒྱ་པོ་འདི་དག་ཆོས་བསྟན་པ་ཟབ་མོ་འདི་ལ་མི་འཇུག་སྟེ་། 
 imām gambhīrā dharmadeśanām avataranto nāvagāhanto manadhimucyamānāḥ bhagavān āha |	མ་རྟོགས་མ་མོས་པས་སྟན་ལས་ལངས་ཏེ་མཆིས་སོ་༎ བཅོམ་ལྡན་འདས་ཀྱིས་བཀའ་སྩལ་པ་། འོད་སྲུང་།
 tathā hyete kāśyapa bhikṣuvaḥ anadhimānite manadhimucyamānā imāṃ gambhīrā gāthābhinirhārām	འདི་ལྟར་དགེ་སློང་མངོན་པའི་ང་རྒྱལ་ཅན་འདི་དག་ནི་ཚུལ་ཁྲིམས་རྣམ་པར་དག་པ་ཟག་པ་མེད་པ་འདི་ལ་མི་འཇུག་སྟེ་།
 anāsravaṃ śīlaviśuddhinirdeśaṃ śrutvā nāvataranti nādhimucyanti nāvagāhanti tatkasmāddheto	མ་རྟོགས་མ་མོས་ཤིང་སྐྲག་སྟེ་ཀུན་དུ་དངངས་། ཀུན་དུ་རབ་ཏུ་དངངས་སོ་༎
 gambhīro yaṃ kāśyapa gāthābhinirhāraṃ gambhīraṃ buddhā bhagavantānāṃ bodhi sā na	འོད་སྲུང་། ཚིགས་སུ་བཅད་པ་མངོན་པར་བསྒྲུབ་པ་ཟབ་པ་། སངས་རྒྱས་བཅོམ་ལྡན་འདས་རྣམས་ཀྱི་བྱང་ཆུབ་ཟབ་སྟེ་།
 śakyam anavaropitakuśalamūle pāpamatraparigṛhīteranadhimuktibahule sattvairadhimucyituṃ vā paryapanituṃ vā avatarituṃ vā |	དེ་ལ་དགེ་བའི་རྩ་བ་མ་བསྐྱེད་པ་། སྡིག་པའི་གྲོགས་པོས་༄༢༥༣ཨ་༌༎ ཡོངས་སུ་ཟིན་པ་དང་། མོས་པ་མི་མང་བ་དག་གིས་མོས་པར་མི་ནུས་སོ་༎
 kp|140 api ca kāśyapa etāni pañca bhikṣuśatāni kāśyapasya tathāgatasyārhata samyaksambuddhasya pravacane anyatīrthikaśrāvakā abhūvan |	འོད་སྲུང་། དགེ་སློང་ལྔ་བརྒྱ་པོ་འདི་དག་ནི་དེ་བཞིན་གཤེགས་པ་འོད་སྲུང་གི་གསུང་རབ་ལ་མུ་སྟེགས་ཅན་གྱི་ཉན་ཐོས་སུ་གྱུར་ཏེ་།
 ste kāśyapasya tathāgatasyāntikāduparambhābhiprāyairekā dharmadeśanā śrutvā śrutvā	དེ་དག་དེ་བཞིན་གཤེགས་པ་འོད་སྲུང་ལས་བརྒལ་བའི་བསམ་པས་ཆོས་བསྟན་པ་གཅིག་ཐོས་སོ་༎ ཐོས་ནས་དད་པའི་སེམས་གཅིག་རྙེད་དེ་།
 ceva cittaprasādo labdha āścāryaṃ yāvanmadhurapriyabhākhalveyaṃ kāśyapastathāgato 'rhāṃ saṃyaksambuddha iti |	ཇི་ཙམ་དུ་དེ་བཞིན་གཤེགས་པ་དགྲ་བཅོམ་པ་ཡང་དག་པར་རྫོགས་པའི་སངས་རྒྱས་འོད་སྲུང་ལས་འཇམ་ཞིང་སྙན་པར་གསུང་བ་ངོ་མཚར་ཏོ་སྙམ་མོ་༎ 
 te tataścyutasamānā ekacittaprasādena kālagatāḥ trāyastriṃśeṣu deveṣūpapannāḥ neva	དེ་དག་འཆི་བའི་དུས་བྱས་ནས་དད་པའི་སེམས་གཅིག་རྙེད་པ་དེས་སུམ་ཅུ་རྩ་གསུམ་པའི་ལྷ་རྣམས་ཀྱི་ནང་དུ་སྐྱེས་སོ་༎ དེ་དག་དེ་ནས་ཤི་འཕོས་ནས་འདིར་སྐྱེས་ཏེ་རྒྱུ་དེ་ཉིད་ཀྱིས་ངའི་བསྟན་པ་འདི་ལ་རབ་ཏུ་བྱུང་སྟེ་། འོད་སྲུང་།
 hetunā iha mamma śāsane pravrajitāḥ tānyetāni kāśyapa pañca bhikṣuśatāni dṛṣṭigatapraskanditāni imāṃ gambhīrā dharmadeśanā nāvataranti nāvagāhanti nādhimucyante na śraddadhanti |	དགེ་སློང་ལྔ་བརྒྱ་པོ་ལྟ་བར་བྱིང་བ་འདི་དག་ནི་ཆོས་བསྟན་པ་ཟབ་མོ་འདི་ལ་མི་འཇུག་སྟེ་། མ་རྟོགས་མི་མོས་ཤིང་སྐྲག་སྟེ་ཀུན་དུ་དངངས་། ཀུན་དུ་རབ་ཏུ་དངངས་སོ་༎
 kṛtaṃ punareṣā m|||| yaṃ dharmadeśanāyā parikarma na bhūyo vinipātagāmino bhaviṣyanti | ebhireva skandhaiḥ parinirvāsyanti | ||	ཡང་འདི་དག་ནི་ཆོས་བསྟན་པ་འདིས་ཡོངས་སུ་སྦྱང་བ་བྱ་སྟེ་། ཕྱིས་ངན་འགྲོ་ལོག་པར་ལྟུང་བར་མི་འགྱུར་ཞིང་ཕུང་པོ་འདི་དག་ཉིད་ཀྱིས་ཡོངས་སུ་མྱ་ངན་ལས་འདའོ་༎ 
 kp|141 tatra bhagavān āyuṣmantaṃ subhūtim āmantrayati sma |	དེ་ནས་བཅོམ་ལྡན་འདས་ཀྱིས་ཚེ་དང་ལྡན་པ་རབ་འབྱོར་ལ་བཀའ་སྩལ་པ་། རབ་འབྱོར་ཁྱོད་སོང་ལ་།
 gacchastvaṃsubhūte etān bhikṣu sañjñapaya subhūtirāha |	དགེ་སློང་དེ་དག་ཀུན་ཤེས་པར་བྱོས་ཤིག་། རབ་འབྱོར་གྱིས་གསོལ་པ་།
 bhagavata eva tāvadete bhikṣavo bhāṣitaṃ prativilomayanti kaḥ punarvādo mama |	བཅོམ་ལྡན་༄༢༥༣བ་འདས་ཉིད་ཀྱིས་འདི་དག་ལ་བཤད་ན་ཡང་མཐུན་པར་མི་བགྱིད་ན་བདག་ལ་ལྟ་སྨོས་ཀྱང་ཅི་འཚལ་།
 atha khalu bhagavāṃstasyāṃ velāyā yena mārgeṇa te bhikṣavo gacchanti sma | tasminmārge dvau bhikṣu nirmimīte sma |	དེ་ནས་བཅོམ་ལྡན་འདས་ཀྱིས་དགེ་སློང་དེ་དག་ལམ་གང་ནས་འདོང་བའི་ལམ་དེར་དགེ་སློང་གཉིས་ཤིག་སྤྲུལ་པ་སྤྲུལ་ཏོ་༎
 atha tāni pañca bhikṣuśatāni yena mārgeṇa tau dvau bhikṣu nirmito tenopasaṅkrāmannupasaṅkramyevamavocan |	དེ་ནས་དགེ་སློང་ལྔ་བརྒྱ་པོ་དེ་དག་སྤྲུལ་པའི་དགེ་སློང་དེ་གཉིས་ལས་གང་ནས་འདོང་བའི་ལམ་དེར་དོང་སྟེ་ཕྱིན་པ་དང་། འདི་སྐད་ཅེས་སྨྲས་སོ་༎ ཚེ་དང་ལྡན་པ་དག་། གར་འདོང་།
 kutra āyuṣmanto gamiṣyathaḥ tāvavocatāḥ gamiṣyāma vayam araṇyāyataneṣu sukhaṃ phāṣaṃ	དེ་གཉིས་ཀྱིས་སྨྲས་པ་། ཁོ་བོ་ཅག་ནི་དགོན་པའི་གནས་རྣམས་སུ་བསམ་གཏན་གྱི་བདེ་བ་ལ་རེག་པར་གནས་པར་བྱ་བར་འདོང་ངོ་༎ 
 vihariṣyāmaḥ tatkasmāddhetoryaṃ hi bhagavān dharmaṃ deśayati tāmāvā dharmadeśanāṃ	དེ་ཅིའི་ཕྱིར་ཞེ་ན་། ཁོ་བོ་ཅག་ནི་བཅོམ་ལྡན་འདས་ཀྱིས་ཆོས་བསྟན་པ་གང་ཡིན་པའི་ཆོས་བསྟན་པ་དེ་ལ་མི་འཇུག་སྟེ་། 
 nāvarāvo nāvagāhāma he |	མ་རྟོགས་མི་མོས་ཤིང་སྐྲག་སྟེ་།
 nadhimucyāvahe |	ཀུན་དུ་དངངས་།
 utrasivaḥ santrasāvaḥ santrāsamāpadyāmahe |	ཀུན་དུ་རབ་ཏུ་དངངས་པར་གྱུར་ནས་།
 tāvāvām āraṇyāyataneṣu sukhaṃ vihariṣyāmaḥ	ཁོ་བོ་ཅག་དགོན་པའི་གནས་རྣམས་སུ་བསམ་གཏན་གྱི་བདེ་བ་ལ་རེག་པར་གནས་པ་རྣམས་ཀྱིས་གནས་པར་བྱའོ་༎ 
 kp|142 tānyapi pañca bhikṣuśatānyetad avocan |	དགེ་སློང་ལྔ་བརྒྱ་པོ་དེ་དག་གིས་འདི་སྐད་ཅེས་སྨྲས་སོ་༎
 vayam apyāyuṣmanto bhagavato dharmadeśanā nāvatarāmo nāvagāhāmahe nādhimucyāmahe |	ཚེ་དང་ལྡན་པ་དག་༏ཁོ་བོ་ཅག་ཀྱང་བཅོམ་ལྡན་འདས་ཀྱིས་ཆོས་བཤད་པ་ལ་མི་འཇུག་སྟེ་། མ་རྟོགས་མ་མོས་ཤིང་སྐྲག་སྟེ་།
 utrasāvaḥ santrasāvaḥ santrāsam āpadyāmahe |	ཀུན་དུ་དངངས་། ཀུན་དུ་རབ་ཏུ་དངངས་པར་གྱུར་ཏོ་༎
 te vayam araṇyāyaneṣu dhyānasukhavihārairvihariṣyāmaḥ nirmitakāvavocatā saṅgāyiṣyāma	དེའི་ཕྱིར་ཁོ་བོ་ཅག་ཀྱང་དགོན་པའི་གནས་རྣམས་སུ་བསམ་གཏན་གྱི་བདེ་བ་ལ་རེག་པར་གནས་པ་རྣམས་ཀྱིས་གནས་པར་བྱའོ་༎ སྤྲུལ་པ་དག་གིས་སྨྲས་པ་། ཚེ་དང་ལྡན་པ་དག་། དེའི་ཕྱིར་བདག་ཅག་ཡང་༄༢༥༤ཨ་༌༎ དག་པར་བགྲོ་བར་བྱའོ་༎
 vayam āyuṣmanto na vivadiṣyāmaḥ avivāda paramo hi śramaṇadharmaḥ yadiha māyuṣmanta	རྩོད་པར་མི་བྱའོ་༎ རྩོད་པ་མེད་པ་ལྷུར་ལེན་པ་ནི་དགེ་སྦྱོང་གི་ཆོས་སོ་༎ ཚེ་དང་ལྡན་པ་དག་།
 ityucyate parinirvāṇam iti | katamaḥ sa dharmo yaḥ pari |||||||||||||| syati kaścit punarasmiṃ kaye ātmā vā sattvo	གང་འདི་ཡོངས་སུ་མྱ་ངན་ལས་འདས་པ་ཞེས་བྱ་བ་གང་ཡོངས་སུ་མྱ་ངན་ལས་འདའ་བར་འགྱུར་བའི་ཆོས་དེ་གང་ལུས་འདི་ལ་བདག་གམ་། སེམས་ཅན་ནམ་།
 vā jīvo vā janturvā pauṣau vā pudgalo vā manujo vā mānavo||||||||||||||||||| kartā vā kārako vā vedako vā jānako vā sañjānako vā utthāpako vā samutthāpako vā yaḥ parinirvāsyati | kp|143 te āhu||||||||||||||||||| na kvacidasti |	སྲོག་གམ་། སྐྱེ་བ་པོའམ་། སྐྱེ་བུའམ་།
 asmiṃ kāye ātmā vā sattvo vā jīvo vā janturvā puruṣo vā pudgalo vā manujo vā mānavo vā kartā vā kārako vā vedako vā jānako vā sañjānako vā utthāpako vā yaḥ parinirvāsyati | nirmitakā prāhu |	གང་ཟག་གམ་། ཤེད་ལས་སྐྱེས་སམ་། ཤེས་བུའམ་། གང་ཡོངས་སུ་མྱ་ངན་ལས་འདའ་བར་འགྱུར་།
 X puna sākṣīkṛyāyā parinirvāsyatīti |	གང་ཟད་པས་ཡོངས་སུ་མྱ་ངན་ལས་འདའ། དེ་དག་གིས་སྨྲས་པ་།
 te āhuḥ rāgakṣayāya dveṣakṣayāya mohakṣayāya āyuṣmanta parinirvāṇam iti |	འདོད་ཆགས་ཟད་། ཞེ་སྡང་ཟད་། གཏི་མུག་ཟད་པས་ཡོངས་སུ་མྱ་ངན་ལས་འདའོ་༎ སྤྲུལ་པ་གཉིས་ཀྱིས་སྨྲས་པ་།
 nirmitakā prāhuḥ kiṃ punarāyuṣmatā rāgadveṣamohāḥ saṃvidyante yāṃ kṣapayiṣyatha |	ཚེ་དང་ལྡན་པ་དག་། འདོད་ཆགས་དང་། ཞེ་སྡང་དང་། གཏི་མུག་ཡོད་པ་ཡིན་ནམ་། ཅི་ན་དེ་ཟད་པར་བྱ་།
 te āhu |	དེ་དག་གིས་སྨྲས་པ་།
 na te ādhyātmena na bahirdhā nobhayam antareṇopalabhyante |	དེ་དག་ནི་ནང་ན་ཡང་མེད་། ཕྱི་རོལ་ན་ཡང་མེད༏་གཉི་ག་མེད་པ་ལ་ཡང་མི་དམིགས་ཏེ་།
 nāpi te aparikalpitā utpadyante nirmitakāv avocatā |	དེ་དག་ནི་ཡོངས་སུ་མ་བརྟགས་པ་ལས་ཀྱང་མི་སྐྱེའོ་༎ སྤྲུལ་པ་གཉིས་ཀྱིས་སྨྲས་པ་།
 tena māyuṣmanto māsmān kalpayataḥ māsman vikalpayataḥ yadāyuṣmanto na kalpayiṣyathaḥ	ཚེ་དང་ལྡན་པ་དག་། དེ་ལྟ་བས་ན་མ་རྟོག་རྣམ་པར་མ་རྟོག་ཅིག་། ཚེ་དང་ལྡན་པ་དག་། ནམ་མི་རྟོག་རྣམ་པར་མི་རྟོག་པ་དེ་ནི་།
 na vikalpayiṣyathaḥ tadāyuṣmanto na raṅkṣyatha na viraṅkṣyathaḥ yaścāyuṣmanto na	ཆགས་པར་ཡང་མི་འགྱུར་།
 rakto na viraktaḥ||||||||||||||||||| śānta ityucyate |	ཆགས་པ་དང་བྲལ་བར་ཡང་མི་འགྱུར་རོ་༎ ཆགས་པ་མེད་ཅིང་ཆགས་པ་དང་བྲལ་བ་ཡང་མེད་པ་གང་ཡིན་པ་དེ་ནི་ཞི་བ་ཞེས་བྱའོ་༎ ཚེ་དང་ལྡན་པ་དག་།
 kp|144 śīlam āyuṣmanto na saṃsarati na parinirvāti samādhiprajñāvimuktivimuktijñānadarśanam āyuṣ||||||||||||||||| na saṃsarati na parinirvāti	ཚུལ་༄༢༥༤བ་ཁྲིམས་ནི་མི་འཁོར་ཞིང་ཡོངས་སུ་མྱ་ངན་ལས་མི་འདའོ་༎ ཚེ་དང་ལྡན་པ་དག་། ཏིང་ངེ་འཛིན་དང་། ཤེས་རབ་དང་། རྣམ་པར་གྲོལ་བ་དང་། རྣམ་པར་གྲོལ་བའི་ཡེ་ཤེས་མཐོང་བ་ཡང་མི་འཁོར་ཞིང་ཡོངས་སུ་མྱ་ངན་ལས་མི་འདའོ་༎ ཚེ་དང་ལྡན་པ་དག་།
 ebhiścevāyuṣmanto dharmai nirvāṇaṃ sūcyate |	ཆོས་དེ་དག་གིས་ཡོངས་སུ་མྱ་ངན་ལས་འདའ་བར་སྟོན་ན་།
 ete ca dharmā śūnyā viviktā agrā|||||||||||||||||||||| prajahīte tāmāyuṣmantaḥ sañjñā	ཆོས་དེ་དག་ཀྱང་སྟོང་པ་། དབེན་པ་། གཟུང་དུ་མེད་པའོ༏་༏ཚེ་དང་ལྡན་པ་དག་། འདི་ལྟ་སྟེ་། མྱ་ངན་ལས་འདས་པའི་འདུ་ཤེས་སྤོང་ཞིང་།
 yaduta parinirvāṇam iti mā ca sañjñāyā sañjñā kārṣvaḥ mā asañjñāyā||||||||||||||||||||	འདུ་ཤེས་ལ་ཡང་འདུ་ཤེས་སུ་མ་བྱེད་ཅིག་།
 ca sañjñayā sañjñā parijñāsiṣva |	འདུ་ཤེས་ལ་འདུ་ཤེས་ཀྱིས་ཡོངས་སུ་ཤེས་པར་མ་བྱེད་ཅིག་།
 yaḥ sañjñayā sañjñā parijānāti sañjñābandhanam evāsya tad bhavati |	གང་འདུ་ཤེས་ལ་འདུ་ཤེས་ཀྱིས་ཡོངས་སུ་ཤེས་པ་དེ་ནི་དེའི་འདུ་ཤེས་ཀྱིས་བཅིངས་པ་ཡིན་ནོ་༎ 
 saṃ|||||||||||||||| vedayitanirodhasamā pattimāyuṣmantaḥ samāpadyadhvaṃ mā ca kalpayatha	ཚེ་དང་ལྡན་པ་དག་། འདུ་ཤེས་དང་ཚོར་བ་འགོག་པའི་སྙོམས་པར་འཇུག་པ་ལ་ཞུགས་ཤིག་། ཚེ་དང་ལྡན་པ་དག་།
 mā vikalpayathaḥ sañjñāvedayita||||||||||||||||||| dhasamāpattisamāpannasya bhikṣornāstyuttare	འདུ་ཤེས་དང་ཚོར་བ་འགོག་པའི་སྙོམས་པར་འཇུག་པ་ལས་གོང་ན་བྱ་བ་མེད་དོ་ཞེས་སྨྲས་སོ་༎ 
 karaṇīyam iti vadāmaḥ kp|145 asmiṃ khalu punardharmaparyāye bhāṣyamāṇe||||||||||||||||||||||||||| ṣāṃ pañcānāṃ bhikṣuśatānām anupādāyāsravebhyaḥ cittāni vimuktāni	ཆོས་ཀྱི་རྣམ་གྲངས་འདི་བཤད་པའི་ཚེ་དགེ་སློང་ལྔ་བརྒྱ་པོ་དེ་དག་ལེན་པ་མེད་པར་ཟག་པ་རྣམས་ལས་སེམས་རྣམ་པར་གྲོལ་ལོ་སོ་༎ 
 te vimuktacittā yena bhagavāṃste||||||||||||||||||| pasaṅkramannupasaṅkramya bhagavataḥ pādau śirobhirvanditvā ekānte myaṣīdan |	༎ དེ་དག་སེམས་རྣམ་པར་གྲོལ་ནས་བཅོམ་ལྡན་འདས་ག་ལ་བ་དེར་དོང་སྟེ་ལྷགས་སོ་༎ ༎ པ་དང་། བཅོམ་ལྡན་འདས་ཀྱི་ཞབས་ལ་མགོ་བོས་ཕྱག་བྱས་ཏེ་ཕྱོགས་གཅིག་ཏུ་སོ་༎ 
 athāyuṣmān subhutistā||||||||||||||||||||||| kṣu etad avocat |	༎ པ་དང་། འཁོད་དོ་༎ དེ་ནས་ཚེ་དང་ལྡན་པ་རབ་འབྱོར་གྱིས་དགེ་སློང་དེ་དག་ལ་འདི་སྐད་ཅེས་སྨྲས་སོ་༎
 kva nu khalvāyuṣmanto gatā kuto vā āgatāḥ te avocanakvacidgamanāya |	ཚེ་དང་ལྡན་པ་དག་། ༄༢༥༥ཨ་༌༎ གར་དོང་། གང་ནས་ལྷགས་། དེ་དག་གིས་སྨྲས་པ་། བཙུན་པ་རབ་འབྱོར་།
 na kutaścidāga||||||||||||||||||||||||||| nāya |	གང་དུ་ཡང་འགྲོ་བ་མེད་པ་དང་། གང་ནས་ཀྱང་འོང་བ་མེད་པའི་ཕྱིར་།
 bhadanta subhūte bhagavatā dharmo deśitaḥ subhūtirāha |	བཅོམ་ལྡན་འདས་ཀྱིས་ཆོས་བསྟན་ཏོ་༎ སྨྲས་པ་། ཚེ་དང་ལྡན་པ་དག་།
 ko nāmāyuṣmantā śāstā |	ཁྱེད་ཀྱི་སྟོན་པ་གང་ཡིན་།
 te āhuḥ yotpanno||||||||||||||||| rinirvāsyati |	སྨྲས་པ་། གང་མ་སྐྱེས་ཤིང་ཡོངས་སུ་མྱ་ངན་ལས་མི་འདའོ་༎
 kp|146 subhūtirāha |	སྨྲས་པ་།
 kasya yuṣme śrāvakā kasya sakāśādyuṣme vinītā te āhuryena na prāptanābhisaṃ||||||||||||||||||| subhūtirāha |	ཁྱེད་ཀྱིས་ཇི་ལྟར་ཆོས་ཐོས་། སྨྲས་པ་། བཅིངས་པའི་ཕྱིར་ཡང་མ་ཡིན་། ཐར་པའི་ཕྱིར་ཡང་མ་ཡིན་ནོ་༎ སྨྲས་པ་།
 kasya sakāśādyuṣmākaṃ dharmaṃ śrutaṃ |	ཁྱེད་སུས་བཏུལ་། སྨྲས་པ་།
 te āhu yasya na skandhā na dhātavo nāyatanāni 3 subhūtirāha |	སུ་ལ་ལུས་མེད་ཅིང་སེམས་མེད་པས་སོ་༎
 kathaṃ punaryuṣme dharmaṃ śrutaṃ |	སྨྲས་པ༏་ཁྱེད་ཇི་ལྟར་བརྩོན་། སྨྲས་པ་།
 te āhurna bandhanāya na mokṣāya |	མ་རིག་པ་སྤང་བའི་ཕྱིར་ཡང་མ་ཡིན་། རིག་པ་བསྐྱེད་པའི་ཕྱིར་ཡང་མ་ཡིན་པའོ་༎
 4 subhūtirāha |	སྨྲས་པ་།
 kathaṃ yūyaṃ pra||||||||||||||||||| ktā te āhu |	ཁྱེད་ཇི་ལྟར་རྣམ་པར་གྲོལ་། སྨྲས་པ་།
 na yogāya na prayogāya |	སྦྱོར་བའི་ཕྱིར་ཡང་མ་ཡིན་།
 na prahāṇāya | 5 subhūtirāha kena yūyaṃ vinītāḥ te āhuḥ yasya na kāyapāriniṣpattirna cittapracāraṃ | 6 subhūtirāha | kathaṃ yuṣmābhi prayujyamānā vimuktāḥ|||||||||||||||||| āhuḥ nāvidyaprabāṇāya na vidyotpādāya 7	སྤང་བའི་ཕྱིར་ཡང་མ་ཡིན་ནོ་༎
 kp|147 subhūtirāha |	སྨྲས་པ་།
 kasya yūyaṃ śrāvakāḥ te āhuḥ yasya na prāpto nā|||||||||||||||||||| sambuddhaḥ 8 subhūtirāha | keva cirena yūyaṃ parinirvāsyathaḥ tāhuḥ yāvaccireṇa tathāgatanirmi|||||||||||||||||||| kāḥ parinirvāsyanti tā vaccireṇa vayaṃ parinirvāsyāmaḥ 9 subhūtirāha |	ཁྱེད་སུའི་ཉན་ཐོས་། སྨྲས་པ་། གང་གིས་ཐོབ་པ་མེད་ཅིང་མངོན་པར་རྫོགས་པར་སངས་རྒྱས་མེད་པའོ་༎
 kṛtaṃ yuṣmābhi svakārtha||||||||||||||||||||||||||| te āhuḥ arthānupalabdhatvāt 10 subhūtirāha | kṛtaṃ yuṣmābhiḥ karaṇīya | te āhu | kārakānupa|||||||||||||||||||||| bdhitvāt | subhūtirāha |	སྨྲས་པ་།
 keva yuṣmākaṃ sabrahmacāriṇa |	ཁྱེད་ཀྱི་ཚངས་པ་མཚུངས་པར་སྤྱོད་པ་གང་།
 te āhuḥ |	སྨྲས་པ་།
 ye traidhātuke nopa caranti |	གང་དག་ཁམས་གསུམ་ན་མི་རྒྱུ་བ་རྣམས་སོ་༎ སྨྲས་པ་། ཚེ་དང་ལྡན་པ་དག་། ཁྱོད་ཇི་སྲིད་ཅིག་ན་ཡོངས་སུ་མྱ་ངན་ལས་འདའ། སྨྲས་པ་། དེ་བཞིན་གཤེགས་པའི་སྤྲུལ་པ་ནམ་ཡོངས་སུ་མྱ་ངན་ལས་འདའ་བ་ནའོ་༎ སྨྲས་པ་། ཁྱེད་ཀྱིས་བྱ་བ་བྱས་སམ་།
 na pracaraṃ||||||||||||||||| kp|148 subhūtirāha |	སྨྲས་པ་། ངར་འཛིན་པ་དང་། ང་ཡིར་འཛིན་པ་ཡོངས་སུ་ཤེས་པས་༄༢༥༥བ་སོ༏་༏སྨྲས་པ་།
 kṣīṇā yūṣmākaṃ kleśāḥ te āhuratyantakṣayatvāt sarvadharmāṇāṃ 13 subhūtirāha |	ཁྱེད་ཀྱིས་ཉོན་མོངས་པ་ཟད་དམ་། སྨྲས་པ་། ཆོས་ཐམས་ཅད་གཏན་དུ་ཟད་པའི་ཕྱིར་རོ་༎ སྨྲས་པ་།
 dharṣitā yu|||||||||||||||||||||| r māraḥ te āhuḥ skandhamārānupalabdhitvāt 14 |	ཁྱེད་ཀྱིས་བདུད་བཏུལ་ཏམ་། སྨྲས་པ་། ཕུང་པོའི་བདུད་མི་དམིགས་པའི་ཕྱིར་རོ་༎
 subhūtirāha |	སྨྲས་པ་། ཁྱེད་ཀྱིས་སྟོན་པ་ལ་བསྙེན་བཀུར་བྱས་སམ་།
 paricīrṇo yuṣmābhistathāgataḥ te āhuḥ||||||||||||||||||||| kāyena na cittena 15 subhūtirāha |	སྨྲས་པ་། ལུས་ཀྱིས་ཀྱང་མ་བྱས་། ངག་གིས་ཀྱང་མ་བྱས་། སེམས་ཀྱིས་ཀྱང་མ་བྱས་སོ་༎
 sthitā yuṣmākaṃ dākṣīṇeyabhūmauḥ te āhuḥ agrāhataḥ a||||||||||||||||||||||||||| tigrāhataḥ 16 subhūtirāha |	སྨྲས་པ་། ཁྱེད་ཀྱིས་སྦྱིན་པའི་གནས་ཀྱིས་སྦྱངས་སམ་། སྨྲས་པ་། འཛིན་པ་མེད་ཅིང་སྡུད་པ་མེད་པས་སོ་༎ སྨྲས་པ་།
 cchinnā yūyaṃ saṃsāraṃ |	ཁྱེད་འཁོར་བ་ལས་བརྒལ་ཏམ་།
 te āhuḥ anuccheda aśāśvatatvāt 17 subhūtirāha |	སྨྲས་པ་། ཆད་པ་མེད་ཅིང་རྟག་པ་མེད་པའི་ཕྱིར་རོ་༎ སྨྲས་པ་།
 pratipannā yūyaṃ śramaṇaśramaṇabhūmau |	ཁྱེད་སྦྱིན་པའི་གནས་ཀྱི་སར་ཞུགས་སམ་། སྨྲས་པ་། འཛིན་པ་ཐམས་ཅད་ལས་རྣམ་པར་གྲོལ་བའི་ཕྱིར་རོ་༎
 tena punarāhuḥ asaṅgāvimuktau |	སྨྲས་པ་།
 18 subhūtirā|||||||||||||||||||||||| kigāmināyuṣmantaḥ te āhuḥryadgaminastathāgatanirmitāḥ 19 ||	ཚེ་དང་ལྡན་པ་དག་གར་འགྲོ་། སྨྲས་པ་། དེ་བཞིན་གཤེགས་པའི་སྤྲུལ་པ་གང་དུ་བཞུད་པར་རོ་༎
 kp|149 iti hyāyuṣmantaḥ subhūti paripṛcchataḥ teṣā||||||||||||||||||||||||| bhikṣūṇāṃ visarjayantānāṃ |	དེ་ལྟར་ཚེ་དང་ལྡན་པ་རབ་འབྱོར་གྱིས་ཡོངས་སུ་དྲིས་ཏེ་། དགེ་སློང་དེ་དག་གིས་ལན་བཏབ་ནས་།
 tasyā parṣadi aṣṭānāṃ bhikṣuśatānāṃ pañcānāṃ ca bhikṣuṇīśatānām anupādāya||||||||||||||||| vebhyaścittāni vimuktāni | dvātriṃśatīnāṃ ca prāṇasahasrāṇāṃ sadevamānuṣikāyāṃ prajāyām virajo vigata ||||||||||||||||||||| dharmeṣu dharmacakṣurviśuddham ||	འཁོར་དེའི་དགེ་སློང་བརྒྱད་བརྒྱ་ནི་ལེན་པ་མེད་པར་ཟག་པ་རྣམས་ལས་སེམས་རྣམ་པར་གྲོལ་ལོ་༎ སྲོག་ཆགས་སུམ་ཁྲི་ཉིས་སྟོང་ནི་ཆོས་རྣམས་ལ་ཆོས་ཀྱི་མིག་རྡུལ་མེད་ཅིང་དྲི་མ་དང་བྲལ་བ་རྣམ་པར་དག་གོ་།
 kp|150 atha khalu samantāloko nāma bodhisattvo mahāsattvo bhagavantametad avocat	དེ་ནས་བྱང་ཆུབ་སེམས་དཔའ་སེམས་དཔའ་ཆེན་པོ་ཀུན་དུ་སྣང་བ་ཞེས་བྱ་བ་འཁོར་དེ་ཉིད་དུ་འདུས་པར་གྱུར་ཏེ་འདུས་པ་དེ་སྟན་ལས་ལངས་ཏེ་། བླ་གོས་ཕྲག་པ་གཅིག་ཏུ་གཟར་ནས་༄༢༥༦ཨ་༌༎ པུས་མོ་ག-ཡས་པའི་ལྷ་ང་ས་ལ་བཙུགས་ཏེ་། བཅོམ་ལྡན་འདས་ག་ལ་བ་དེ་ལོགས་སུ་ཐལ་མོ་སྦྱར་བ་བཏུད་ནས་བཅོམ་ལྡན་འདས་ལ་འདི་སྐད་ཅེས་གསོལ་ཏོ་༎ བཅོམ་ལྡན་འདས་།
 i||||||||||||||||||||||||| gavan mahāratnakūṭe dharmaparyāye śikṣitukāmena bodhisattvena kathaṃ sthātavyaṃ kathaṃ pratipattavyaṃ |	དཀོན་མཆོག་བརྩེགས་པ་ཆེན་པོའི་ཆོས་ཀྱི་རྣམ་གྲངས་འདི་ལ་སློབ་པར་འཚལ་བའི་བྱང་ཆུབ་སེམས་དཔས་ཇི་ལྟར་བསླབ་པར་བགྱི་།
 kathaṃ śikṣitavyaṃ ||||||||||||||||||||||| vānāha |	བཅོམ་ལྡན་འདས་ཀྱིས་བཀའ་སྩལ་པ་།
 udgṛhya kulaputra iha dharmaparyāye śikṣā ākhyātā pratipattisārāṇāṃ satpuruṣāṇām iyaṃ dharmaparyāyo bhavārthakaro bhaviṣyati |	རིགས་ཀྱི་བུ་། ཚར་བཅད་ཅིང་ཚར་བཅད་ནས་ཆོས་ཀྱི་རྣམ་གྲངས་འདིར་བསླབ་པ་སྟོན་ཏེ་། ཆོས་ཀྱི་རྣམ་གྲངས་འདི་ནི་སྐྱེས་བུ་དམ་པ་ནན་ཏན་སྙིང་པོ་བྱེད་པ་རྣམས་ཀྱི་དོན་ཆེན་པོར་འགྱུར་རོ་༎ རིགས་ཀྱི་བུ་། འདི་ལྟ་སྟེ་།
 kp|151 tadyathāpi nāma kulaputra kaścideva puruṣaḥ mṛnmayīnāvabhiruhyaṃ gaṅgānadīm uttartukāmo bhavet |	དཔེར་ན་། མི་ལ་ལ་ཞིག་ཁམས་པའི་གྲུར་ཞུགས་ཏེ་། གངགའའི་ཀླུང་ཆེན་པོ་བརྒལ་བར་འདོད་པར་གྱུར་ན་།
 tatkiṃ manyase kulaputra kīdṛśena vīryeṇa tena puruṣeṇa sā nnorvāhayitavyā bhave||||||||||||||||||| ha balavatā bhagavan vīryeṇa |	རིགས་ཀྱི་བུ་།
 tatkasmāddhetoḥ mā measamprāptapārasyevāntareṇa nnaurvipadyeta |	འདི་ཇི་སྙམ་དུ་སེམས་།
 mahāo||||||||||||||||||||||| rṇavaprāpto smin mā haivāntareṇāyaṃ nāvā vikīryeta |	མི་དེས་ཅི་འདྲ་བའི་བརྩོན་འགྲུས་ཀྱིས་གྲུ་དེ་བཙལ་བར་བྱའོ་༎
 bhagavān āha |	གསོལ་པ་། བཅོམ་ལྡན་འདས་། སྟོབས་དང་ལྡན་པའི་བརྩོན་འགྲུས་ཀྱིས་བགྱིའོ་༎ དེ་ཅིའི་སླད་དུ་ཞེ་ན་། བདག་ནི་ཆུ་བོ་ཆེན་པོའི་ནང་དུ་ཞུགས་ཀྱི་། བདག་འགྲམ་དུ་མ་ཕྱིན་པར་བར་མ་དོར་གྲུ་ཞིག་ཏུ་འོང་ངོ་སྙམ་དུ་སེམས་པའི་སླད་དུའོ་༎ བཅོམ་ལྡན་འདས་ཀྱིས་བཀའ་སྩལ་པ༏་ཀུན་དུ་སྣང་བ་།
 evameva samantāloka ato bahutare||||||||||||||||||||| balavantatareṇa vīryeṇa bodhisattvena	དེ་ལྟར་བྱང་ཆུབ་སེམས་དཔས་དེ་བས་ཀྱང་ཆེས་སྟོབས་དང་ལྡན་པའི་བརྩོན་འགྲུས་ཀྱིས་ཆོས་ཀྱི་རྣམ་གྲངས་འདི་ལ་བསླབ་པར་བྱ་སྟེ་།
 bodhiḥ samudānayitavyāḥ mahābalavīryeṇa ca buddhadharmā samudānayita||||||||||||||||||||||||	སྟོབས་ཆེན་པོ་དང་ལྡན་༄༢༥༦བ་པའི་བརྩོན་འགྲུས་ཀྱིས་སངས་རྒྱས་ཀྱི་ཆོས་ཐམས་ཅད་ཡང་དག་པར་བསྒྲུབ་པར་བྱའོ་༎ 
 kp|152 evamanasīkāreṇa anityo batāyaṃ kāyaḥ caturmahābhūtikaḥ mātāpitṛkalalasambhūta | adhru||||||||||||||||||||||| nāśvāsikaḥ vipariṇāmadharmaḥ ucchadasnapanaparimardanabhedanavikiraṇavidhvaṃsanadharmaḥ	ཀྱེ་མའོ་ལུས་འདི་ནི་མི་རྟག་པ་སྟེ་།
 oda |||||||||||||||||||||||||| lmāsopacitaḥ acirasthāyi anāhāro na tiṣṭhati | jarjaragṛhasadṛśo durabalaḥ mā haiva anādattasā||||||||||||||||||||||| syāntareṇa	བདག་གིས་སྙིང་པོར་མ་བླངས་པར་བར་མ་དོར་འཆི་བའི་དུས་བྱས་སུ་འོང་ངོ་ཞེས་ཡིད་ལ་བྱེད་པ་དེ་ལྟ་བུས་བདག་ནི་ཆུ་བོ་ཆེན་པོར་ཞུགས་ཀྱི་། ཆུ་བོ་བཞིར་ཞུགས་པའི་སེམས་ཅན་རྣམས་ཆུ་བོ་ཆེན་པོར་ཞུགས་པ་ལས་བསྒྲལ་པོར་ཞུགས་ཀྱི་། བའི་ཕྱིར་། 
 kālakriyā bhaviṣyati mahoghārṇavaprāpto 'smi caturottararogaśataprāptānāṃ sattvānām uhyamāna ||||||||||||||||||||||||| m uttāraṇatāyā bodhisattvena mahādharmanāvaṃ samudānayiṣyāmi | yayā dharmanāvā sarvasattvā saṃsār||||||||||||||||||||||||| vaprāptān uhyamānān uttārayiṣyāmi | kp|153 tatra samantāloka kīdṛśe dharmanau bodhisatvasya samudānayi|||||||||||||||||||||||	དམ་པའི་ཆོས་ཀྱི་གྲུ་གང་གིས་སེམས་ཅན་འཁོར་བའི་རྒྱ་མཚོས་ཁྱེར་བ་ཐམས་ཅད་བསྒྲལ་བར་བྱ་བའི་དམ་པའི་ཆོས་ཀྱི་གྲུ་ཆེན་པོ་སྦྱར་བར་བྱའོ་༎ ཀུན་དུ་སྣང་བ་། དེ་ལ་བྱང་ཆུབ་སེམས་དཔས་དམ་པའི་ཆོས་ཀྱི་གྲུ་ཆེན་པོ་སྦྱར་བར་བྱ་བ་དེ་ཅི་འདྲ་ཞེ་ན་། འདི་ལྟ་སྟེ་།
 iha samantāloka bodhisattvena dharmanāvā samudānayitavyā yaduta sarvasamacittasambhārā||||||||||||||||||||	སེམས་ཅན་ཐམས་ཅད་ལ་སེམས་མཉམ་པ་ཉིད་དེ་།
 vanti anantapuṇyopacitā śīlaphalanirjātā dānaparivārālaṅkārālaṅkṛtāḥ āśayadṛḍhasārab||||||||||||||||||||||||	བསོད་ནམས་ཀྱི་ཚོགས་མཐའ་ཡས་པ་བསགས་པ་། ཚུལ་ཁྲིམས་ཀྱི་སྣམ་གྱིས་སྦྱར་བ་སྦྱིན་པའི་འཁོར་གྱི་རྒྱན་གྱིས་བརྒྱན་པ་། བསམ་པ་དང་ལྷག་པའི་བསམ་པའི་བཅིང་བ་སྲ་བས་དམ་པོར་སྦྲེལ་བ་། བཟོད་པ་དང་དེས་*nges?་པ་དང་དྲན་པའི་སྦྱོར་ཀས་ལེགས་པར་སྦྱར་བ་།
 nasubaddhāḥ kṣāntisoratyasmṛtiśalyabaddhāḥ saptabodhyaṅgasambhāradṛḍhavīryakuśaladharmadārusamudānitā	བྱང་ཆུབ་ཀྱི་ཡན་ལག་བདུན་གྱི་ཚོགས་ཅན་། བརྩོན་འགྲུས་བརྟན་པ་དང་དགེ་བའི་ཆོས་ཀྱི་ཤིང་གིས་ཡང་དག་པར་སྦྱར་བ་།
 dhyān|||||||||||||||||||| ttakramanīyakarmaṇikṛtāḥ dāntāśāntājāneyakuśalaśilpasuniṣṭhitā |	བསམ་གཏན་གྱི་སེམས་ཀྱིས་ལས་སུ་རུང་བར་བྱས་པ་། དུལ་བ་དང་ཞི་བ་དང་ཅང་ཤེས་ཀྱི་དགེ་བའི་བཟོས་ལེགས་པར་ཟིན་པར་བྱས་པ་། ཤིན་ཏུ་མི་འཁྲུགས་པའི་ཆོས་ཅན་།
 atyantākopyadharma mahākaruṇāsaṅgṛhī|||||||||||||||||||||||| catuḥsaṅgrahavastuśūraturagavāhinī pratyarthikaprajñājñānasupratirakṣitā |	སྙིང་རྗེ་ཆེན་པོས་ཡང་དག་པར་ཟིན་པ་། བསྡུ་བའི་༄༢༥༧ཨ་༌༎ དངོས་པོ་བཞི་དང་། དཔའ་བར་འགྲོ་བས་བསྟར་བ་།
 upāyakauśalyasukṛtavic|||||||||||||||||||| catubrahmavihārasuśodhitāṃ |	ཤེས་རབ་དང་ཡེ་ཤེས་ཀྱིས་ཕྱིར་རྒོལ་པ་ལེགས་པར་རྣམ་པར་ཟིན་པར་བསྲུངས་པ་། ཐབས་མཁས་པས་རྣམ་པར་བསགས་པ་། ལེགས་པར་བྱས་པ་། ཚངས་པའི་གནས་པ་བཞིས་ལེགས་པར་ཡོངས་སུ་སྦྱངས་པ་།
 kp|154 catusmṛtyupasthānasucintitakāyopanītā |	དྲན་པ་ཉེ་བར་གཞག་པ་བཞིས་ལེགས་པར་རྣམ་པར་བསམས་པའི་ལུས་ཀྱིས་བསྟེན་པ་།
 samyakprahāṇaprasaṭhāri |||||||||||||||| dajavajavitā |	ཡང་དག་པར་སྤོང་བས་འགྲོ་བ་།
 indriyasunirīkṣitadānavakravigata balavegasamudgatā antareṇa śithilabodhyaṅgavibodha||||||||||||||||||||| ariśatrumārapathajahanī mānokramavāhinī	རྫུ་འཕྲུལ་གྱི་རྐང་པའི་མགྱོགས་པའི་ཤུགས་དང་ལྡན་པ་། དབང་པོས་ལེགས་པར་བརྟགས་པས་ལྟ་བ་ངན་པའི་ཤིང་ཡོན་པོ་མེད་པ་། སྟོབས་ཀྱི་ཤུགས་ཡང་དག་པར་བྱུང་བས་བར་ཤག་ཤིག་མེད་པ་། བྱང་ཆུབ་ཀྱི་ཡན་ལག་གིས་འགྲོ་བ་རྣམ་པར་དག་པ་། གཅུགས་ཅན་དགྲ་ཉོན་མོངས་པའི་བདུད་ཀྱི་ལམ་འདོར་བར་བྱེད་པ་། ལམ་དུ་འཇུག་པར་བྱེད་པ་། ཕ་རོལ་གྱི་ངོགས་སུ་ཕྱིན་པར་བྱེད་པ་།
 kutirthyatīrthajahanī |	མུ་སྟེགས་ཅན་ངན་པའི་མུ་སྟེགས་འདོར་བར་བྱེད་པ་།
 śamathaniddhyaptinirdiṣṭā vipaśyanāpra |||||||||||||||| gā |	ཞི་གནས་ཀྱིས་ངེས་པར་སེམས་པ་བརྟན་པ་། ལྷག་མཐོང་གིས་སྦྱོར་བ་།
 ubhayorantayorasaktavāhinī |	མཐའ་གཉིས་ལ་མ་ཆགས་པར་འཇུགས་། རྒྱུའི་ཆོས་དང་ཡང་དག་པར་ལྡན་པ་། སྒྲ་གྲགས་པ་ཡངས་ཤིང་རྒྱ་ཆེ་ལ་མི་ཟད་ཅིང་ཚད་མེད་པ་། ཚུར་ཤོག་།
 hetudharmayuktā vipulvistīrṇākṣayaprahāṇābandhā vighuṣṭaśabdā daśa||||||||||||||||||| kṣu śabdam ādāyatyāgacchatāgacchatābhiruta mahādharmanāvaṃ nirvāṇapuragāminī |	དམ་པའི་ཆོས་ཀྱི་གྲུ་ཆེན་པོ་མྱ་ངན་ལས་འདས་པའི་གྲོང་ཁྱེར་དུ་འགྲོ་བ་། བདེ་བར་འགྲོ་བ་། འཇིགས་པ་མེད་པར་འགྲོ་བ་།
 kṣemamārgagāminī |	ལམ་དུ་འགྲོ་བ་།
 mahā|||||||||||||||||| matīra satkāyadṛṣṭiṃ jahanīṃ |	༄༢༥༧བ་འཇིག་ཚོགས་ལ་ལྟ་བ་འདོར་བར་ཞུགས་པ་།
 parimatīragāminī laghusarvadṛṣṭigatavigatāṃ |	ཚུ་རོལ་གྱི་འགྲམ་ནས་ཕ་རོལ་གྱི་འགྲམ་དུ་ལྟ་བ་ཐམས་ཅད་སེལ་བ་། གཙེ་བ་མེད་པའི་མྱ་ངན་ལས་འདས་པར་མྱུར་དུ་སོང་ཞིག་ཅེས་ཕྱོགས་བཅུར་སྒྲས་གོ་བར་བྱེད་པ་སྟེ་། 
 kp|155 īdṛśi kulaputra dharma|||||||||||||||||||||||||||| bodhisattvena samudānayitavyaḥ aparimāṇakalpakoṭīnayutaśatasahasraparikhinnamānasena	རིགས་ཀྱི་བུ་། སེམས་ཅན་ཐམས་ཅད་ཀྱི་དོན་གྱི་ཕྱིར་བསྐལ་པ་བྱེ་བ་ཁྲག་ཁྲིག་བརྒྱ་སྟོང་དཔག་ཏུ་མེད་པར་ཡིད་ཡོངས་སུ་མི་སྐྱོ་བར་བྱང་ཆུབ་སེམས་དཔས་དམ་པའི་ཆོས་ཀྱི་གྲུ་ཆེན་པོ་འདི་འདྲ་བ་དེ་སྦྱར་བར་བྱའོ་༎
 ||||||||||||||||||||||||| rvasattvānāmarthāya anayā saddharmanāvā sarvasattvā tārayitavyāḥ caturbhiroghe uhyamānāḥ īdṛ||||||||||||||||||||| nāvā kulaputra bodhisattvena samudānayitavyāḥ	དམ་པའི་ཆོས་ཀྱི་གྲུ་འདིས་ཆུ་བོ་བཞིས་ཁྱེར་བའི་སེམས་ཅན་ཐམས་ཅད་བསྒྲལ་བར་བྱའོ་༎
 tatra samantālokaḥ katāmā bodhisattvasya kṣiprābhijñatā |	ཀུན་དུ་སྣང་བ་། དེ་ལ་འདིར་བྱང་ཆུབ་སེམས་དཔའི་མངོན་པ་ཤེས་པ་མྱུར་བ་གང་ཞེ་ན་།
 yaduta akṛ||||||||||||||||||| maḥ prayogaḥ sarvasattveṣu |	གང་འདི་སེམས་ཅན་ཐམས་ཅད་ལས་བཅོས་མ་མ་ཡིན་པའི་སྦྱོར་བ་སྟེ་།
 tīvracchandikatā ācayaśuddhyā | utaptavīryatā sarvakuśalamūlasamudānaya|||||||||||||||||| ye kuśalacchandikatā yoniśamanasikāreṇa śrutatṛptatā | prajñāparipūryaiḥ nirmānatā prajñopa|||||||| ya | pravrajyānimnatāi |	བསམ་པ་དག་པས་རབ་ཏུ་འདུན་པ་དང་། དགེ་བའི་རྩ་བ་ཐམས་ཅད་ཡང་དག་པར་བསྒྲུབ་པའི་ཕྱིར་བརྩོན་འགྲུས་འབར་བ་དང་། ཚུལ་བཞིན་ཡིད་ལ་བྱེད་པས་དགེ་བ་ལ་འདུན་པ་དང་། ཤེས་རབ་ཡོངས་སུ་རྫོགས་པར་བྱ་བའི་ཕྱིར་ཐོས་པས་མི་ངོམས་པ་དང་། ཡེ་ཤེས་བརྟན་པར་བྱ་བའི་ཕྱིར་ང་རྒྱལ་མེད་པ་དང་། ཡོན་ཏན་ཐམས་ཅད་ཡོངས་སུ་རྫོགས་པར་བྱ་བའི་ཕྱིར་།
 sarvaguṇaparipūryai araṇyavāsaḥ kāyacittavivekatayā | kp|156 asaṃsargo durja||||||||||||||||||||||||||| navivarjanatayā | dharmārthikatā paramārthārthapratisaraṇatayā |	རབ་ཏུ་འབྱུང་བ་ལ་གཞོལ་བ་དང་། ལུས་དང་སེམས་དབེན་པར་དགོན་པ་ན་གནས་པ་དང་། སྐྱེ་བོ་མི་སྲུན་པ་རྣམ་པར་སྤངས་པས་འདུ་འཛི་མེད་པ་དང་། དོན་དམ་པ་ལ་རྟོན་པས་ཆོས་དོན་དུ་གཉེར་བ་དང་། ཤིན་ཏུ་མི་འཁྲུགས་པས་༄༢༥༨ཨ་༌༎
 jñānārtho tyantakopanārthatayā | dharmā||||||||||||||||||||| nārthatayā | satyārtho avisaṃvādanārthatayā | śunyatārtho samyakprayogārthatayā | vivekārtho atyantopa|||||||||||||||||| rthatāyeti ||	ཡེ་ཤེས་ཀྱི་དོན་དང་། ཡེ་ཤེས་ཀྱི་དོན་ཡིན་པས་ཆོས་ཀྱི་དོན་དང་། མི་འཁྲུགས་པས་བདེན་པའི་དོན་དང་། ཡང་དག་པར་སྦྱོར་བར་བྱས་པས་སྟོང་པ་ཉིད་ཀྱི་དོན་དང་། ཤིན་ཏུ་ཉེ་བར་ཞི་བའི་དོན་ཡིན་པས་དབེན་པའི་དོན་ཏེ་། རིགས་ཀྱི་བུ་།
 iyamucyate samantāloka bodhisattvasya mahāsattvasya kṣiprābhijñatā ||	འདི་ནི་འདིར་བྱང་ཆུབ་སེམས་དཔའི་མངོན་པར་ཤེས་པ་མྱུར་བའོ་༎
 kp|157 atha khalvāyuṣmān mahākāśyapo bhagavantametadavocat - āścāryaṃ bhagavan |	དེ་ནས་བཅོམ་ལྡན་འདས་ལ་ཚེ་དང་ལྡན་པ་འོད་སྲུང་ཆེན་པོས་འདི་སྐད་ཅེས་གསོལ་ཏོ་༎
 aścāryaṃ sugataḥ yāvacceyaṃ mahāratnakūṭo sūtrāntarā ||||||||||||||||||||||||| upakārībhūto mahāyānasamprasthitānāṃ kulaputrāṇāṃ ca kuladuhitṛṇāṃ ca |	འདི་ལྟར་དཀོན་མཆོག་བརྩེགས་པ་ཆེན་པོའི་ཆོས་ཀྱི་རྣམ་གྲངས་འདི་ཐེག་པ་ཆེན་པོ་ལ་ཡང་དག་པར་ཞུགས་པའི་རིགས་ཀྱི་བུའམ་། རིགས་ཀྱི་བུ་མོ་རྣམས་ལ་ཕན་འདོགས་པར་གྱུར་པ་ནི་། བཅོམ་ལྡན་འདས་། ངོ་མཚར་ཏོ་༎ བདེ་བར་གཤེགས་པ་། ངོ་མཚར་ཏོ་༎
 kiyadbhagavan sa kulaputro||||||||||||||||||||||| kuladuhitā vā puṇyaṃ prasavati | ya ito ratnakūṭaṃ sūtrāntarājñādekagāthām apyupadiśet	བཅོམ་ལྡན་འདས་། དཀོན་མཆོག་བརྩེགས་པ་ཆེན་པོའི་ཆོས་ཀྱི་རྣམ་གྲངས་འདི་ལས་ཚིགས་སུ་བཅད་པ་གཅིག་ཙམ་བསྟན་ན་། རིགས་ཀྱི་བུའམ་རིགས་ཀྱི་བུ་མོ་དེ་བསོད་ནམས་ཀྱི་ཕུང་པོ་ཇི་ཙམ་བསྐྱེད་པར་འགྱུར་།
 kp|158 evamukte bhagavān āyuṣmantaṃ mahākāśyapam etadavocat - yo hi kāśyapa kulaputro	དེ་སྐད་ཅེས་གསོལ་པ་དང་། བཅོམ་ལྡན་འདས་ཀྱིས་ཚེ་དང་ལྡན་པ་འོད་སྲུང་ཆེན་པོ་ལ་འདི་སྐད་ཅེས་བཀའ་སྩལ་ཏོ་༎ འོད་སྲུང་།
 vā kuladuhitā vā gaṅgānadīvālukasameṣu lokadhā|||||||||||||||||||| paramāṇuñjāsi bindeya bhitvā tāttakā caiva vārāvāpeya | tāttakā caiva taṃ sarvalokadhātavaḥ sa|||||||||||||||||||||| paripūrṇaṃ kṛtvā tathāgatebhyo 'rhadbhyaḥ samayaksambuddhebhyo dānaṃ dadyāt |	རིགས་ཀྱི་བུའམ་རིགས་ཀྱི་བུ་མོ་གང་ལ་ལས་འཇིག་རྟེན་གྱི་ཁམས་གངགའའི་ཀླུང་གི་བྱེ་མ་སྙེད་རིན་པོ་ཆེ་སྣ་བདུན་གྱིས་རབ་ཏུ་གང་བར་བྱས་ཏེ་། 
 gaṅgānadīvālukasamānāṃ ca buddhā||||||||||||||||||| bhagavantānām ekekasya ca tathāgatasya gaṅgānadīvālukāsamān vihārān karāpayet | kp|159 gaṅgānadīvā||||||||||||||||||||| mānāṃ ca buddhānāṃ bhagavatām ekekaṃ ca tathāgatasyāprameyaśrāvakasaṅghaṃ gaṅgānadīvālukāsamān kalpāṃ ||||||||||||||| sukhopadhānaiḥ paricaret | teṣām ca buddhānāṃ bhagavataṃ yāvajjīvamanāpena kāyakarmeṇa vākkarmeṇa m|||||||||||||||||| rmeṇa upasthānaparicaryāya tāttakā caiva gaṅgānadīvālukāsamāṃ lokadhātavaḥ paramāṇurajāṃsi |||||||||||||||||| ttakābhidya bhitvā vā tāttakā caiva vārāpeya |	དེ་བཞིན་གཤེགས་པ་དགྲ་བཅོམ་པ་ཡང་དག་པར་རྫོགས་པའི་སངས་རྒྱས་རྣམས་༄༢༥༨བ་ལ་སྦྱིན་པ་བྱིན་པ་དང་། སངས་རྒྱས་བཅོམ་ལྡན་འདས་གངགའའི་ཀླུང་གི་བྱེ་མ་སྙེད་རྣམས་ལས་དེ་བཞིན་གཤེགས་པ་རེ་རེའི་གཙུག་ལག་ཁང་རིན་པོ་ཆེ་སྣ་བདུན་ལས་བྱས་པ་གངགའའི་ཀླུང་གི་བྱེ་མ་སྙེད་བརྩིགས་པ་དང་། སངས་རྒྱས་བཅོམ་ལྡན་འདས་གངགའའི་ཀླུང་གི་བྱེ་མ་སྙེད་རྣམས་ལས་དེ་བཞིན་གཤེགས་པ་རེ་རེའི་ཉན་ཐོས་ཀྱི་དགེ་འདུན་དཔག་ཏུ་མེད་པ་དག་ལ་བསྐལ་པ་གངགའའི་ཀླུང་གི་བྱེ་མ་སྙེད་དུ་བདེ་བའི་ཡོ་བྱད་ཐམས་ཅད་ཀྱིས་རིམ་གྲོ་བྱས་པ་དང་། 
 tān sarvaṃ lokadhātuḥ saptaratnaparipūrṇaṃ kṛtvā||||||||||||||||||||| naṃ dadyādbuddhānāṃ bhagavatāṃ yāvajjīvaṃ ca manapena kāya karmaṇā vākkarmaṇā manaskarmaṇā upa |||||||||||||||||||| pāricaryāya tāttakā caiva gaṅgānadīvālukāsamān api tāttakā caiva buddhānāṃ bhagavataṃ satkuryād|||||||||||||||||| n mānayet pūjayet teṣāṃ ca parinirvṛtānāṃ	དེ་བཞིན་གཤེགས་པ་ཡོངས་སུ་མྱ་ངན་ལས་འདས་པ་དེ་དག་གི་མཆོད་རྟེན་རིན་པོ་ཆེ་བདུན་ལས་བྱས་པ་བས་།
 saptaratnamayā stupā kārāpayet | yaśca kulaputro vā kula|||||||||||||||||||| tā vā ito mahāratnakūṭāt sūtrāntarājñā sarvabuddhabhāṣitādekāmapi gāthā udgṛhṇeya dhāra||||||||||||||||||| asya puṇyaskandhasya sa pūrvakapuṇyaskandhaḥ śatimāmapi | kalānopaiti | sahasrimāmapi | ko|||||||||||||||||||||||| tasahasrimāmapi | saṅkhyāmapi | kalāmapi | gaṇanāmapi | upamāpi | upaniṣāmapi | nakṣa|||||||||||||||||||| yośca śruṇeya śrutvā ca na parikṣipeya |	རིགས་ཀྱི་བུའམ་རིགས་ཀྱི་བུ་མོ་དད་པ་དང་ལྡན་པ་གཞན་ཞིག་གིས་དཀོན་མཆོག་བརྩེགས་པ་ཆེན་པོའི་ཆོས་ཀྱི་རྣམ་གྲངས་འདི་ལས་ཚིགས་སུ་བཅད་པ་གཅིག་ཙམ་ལུང་མནོས་ཏེ་།
 ayaṃ tato bahutaraḥ puṇyaskandhaprasuto bhavet |	ལུང་མནོས་ནས་ཀྱང་མི་སྤོང་ན་དེ་ནི་དེ་བས་ཆེས་བསོད་ནམས་མང་དུ་བསྐྱེད་དོ་༎
 yaśca mātṛ |||||||||||||||||||||||||śṛṇuyād vā likhāpayed vā paryāpnuyād vā tasya na jātu vinipāto bhaviṣyati |	བུད་མེད་གང་ཞིག་ལུང་འབོག་ན་།
 sa eva tasya paśe |||||||||||||||||||||| vo bhaviṣyati |	དེ་ནམ་ཡང་ལོག་པར་ལྟུང་བར་མི་འགྱུར་ཏེ༏་དེ་ཉིད་དེའི་བུད་མེད་ཀྱི་ལུས་ཀྱི་ཐ་མ་ཡིན་ནོ་༎ 
 kp|160 yatra ca pṛthivīpradeśo ayaṃ ratnakūṭo dharmaparyāyo bhāṣyate vā deśyate vā	ས་ཕྱོགས་གང་དུ་ཆོས་ཀྱི་རྣམ་གྲངས་འདི་བཤད་པའམ་། བསྟན་པའམ་།
 likhyate vā|||||||||||||||||||||||||| vā pustagataṃ vā tiṣṭhet sa pṛthivīpradeśe	ཡི་གེར་འདྲི་བའམ་། ཡི་གེར་བྲིས་ནས་གླེགས་བམ་དུ་བྱས་ཏེ་།
 caityabhūto sadevakasya lokasya yasya ca dharmabhāṇakasyānt|||||||||||||||||||||||||	བཞག་པའི་ས་ཕྱོགས་དེ་ལྷ་དང་བཅས་པའི་འཇིག་རྟེན་གྱི་མཆོད་རྟེན་དང་འདྲ་བར་འགྱུར་རོ་༎
 d imaṃ dharmaparyāyaṃ śriṇuyād vā udgṛhṇīyād vā likhed vā paryāpnuyād vā | tasya dharmabhāṇakasyāntike||||||||||||||||||| vaṃrūpā gauravām utpādayitavyaḥ tadyathāpi nāma kāśyapa tathāgatasya |	སུ་ཞིག་ཆོས་སྨྲ་བ་ལས་ཆོས་ཀྱི་རྣམ་གྲངས་འདི་ཉན་པའམ་འཛིན་པའམ་ཡི་གེར་འདྲི་བ་དེ་ལ་༄༢༥༩ཨ་༌༎ འདི་ལྟ་སྟེ་། དེ་བཞིན་གཤེགས་པ་ལ་ཇི་ལྟར་བྱ་བ་དེ་བཞིན་དུ་གུས་པར་བྱའོ་༎ འོད་སྲུང་། རིགས་ཀྱི་བུའམ་རིགས་ཀྱི་བུ་མོ་གང་ཞིག་དེ་བཞིན་གཤེགས་པའི་ཆོས་སྨྲ་བ་ལ་བཀུར་སྟིར་བྱེད་པ་དང་། 
 y||||||||||||||||||||||||||||||||||||||||||||||||||ṇakaṃ satkariṣyati gurukariṣyati mānayiṣyati |	བཙུན་པར་བྱེད་པ་དང་། རི་མོར་བྱེད་པ་དང་། མཆོད་པ་བྱེད་པ་དེ་ལ་། ང་བླ་ན་མེད་པ་ཡང་དག་པར་རྫོགས་པའི་བྱང་ཆུབ་ཏུ་ལུང་སྟོན་ཏོ་༎
 pūj|||||||||||||||||||||| ṇakāle cāsya tathāgatadarśānaṃ bhaviṣyati |	དེ་འཆི་བའི་དུས་ཀྱི་ཚེ་དེ་བཞིན་གཤེགས་པ་མཐོང་བར་འགྱུར་རོ་༎
 kp|161 tathāgatadarśanena ca daśa ca kāyakarmapāriśuddhi pratilap|||||||||||||||||||||||||| katame daśa |	དེ་བཞིན་གཤེགས་པ་མཐོང་ནས་ཀྱང་ལུས་ཀྱི་ལས་ཡོངས་སུ་དག་པ་བཅུ་ཐོབ་པར་འགྱུར་ཏེ་། བཅུ་གང་ཞེ་ན་། འདི་ལྟ་སྟེ་།
 yaduta|||||||||||||||||||vedanāyā aparyādattacitta kālaṃ kariṣyati |	ཚོར་བས་སེམས་ཀུན་དུ་མ་ཟིན་པར་འཆི་བའི་དུས་བྱེད་པ་དང་། དེ་མིག་འཁྲུལ་པར་མི་འགྱུར་བ་དང་། ལག་པ་ག-ཡོ་བར་མི་བྱེད་པ་དང་། རྐང་པ་འཕྲ་བར་མི་བྱེད་པ་དང༏་གཅིན་མི་སྟོར་བ་དང་། ཕྱི་ས་མི་འབྱུང་བ་དང་། དེའི་སྙིང་གར་རྡུལ་མི་འབྱུང་བ་དང་། ཁུ་ཚུར་མི་འཆང་བ་དང་། ནམ་མཁའ་ལ་མི་སྙེགས་པ་དང་། ཇི་ལྟར་འདུག་པ་དེ་བཞིན་དུ་ཚེའི་འདུ་བྱེད་འདོར་བར་འགྱུར་བ་སྟེ་། ལུས་ཀྱི་ལས་ཡོངས་སུ་དག་པ་བཅུ་པོ་དེ་དག་ཐོབ་པར་འགྱུར་རོ་༎ ངག་གི་ལས་ཡོངས་སུ་དག་པ་བཅུ་ཐོབ་པར་འགྱུར་ཏེ་། བཅུ་གང་ཞེ་ན༏་འདི་ལྟ་སྟེ་། གདངས་སྙན་པའི་ཚིག་དང་། མཉེན་པའི་ཚིག་དང་། འཇམ་པའི་ཚིག་དང་། དགའ་བའི་ཚིག་དང་། སྣུམ་པའི་ཚིག་དང་། སླར་བཟློག་པ་མ་ཡིན་པའི་ཚིག་༄༢༥༩བ་དང༏་གཟུང་བར་འོས་པའི་ཚིག་དང་། བཙུན་པའི་ཚིག་དང་། ལྷ་དང་མིས་ཡོངས་སུ་བཟུང་བའི་ཚིག་དང་། སངས་རྒྱས་ཀྱིས་ཡོངས་སུ་བཟུང་བའི་ཚིག་སྟེ་། ངག་གི་ལས་ཡོངས་སུ་དག་པ་བཅུ་པོ་དེ་དག་ཐོབ་པར་འགྱུར་རོ་༎ ཡིད་ཀྱི་ལས་ཡོངས་སུ་དག་པ་བཅུ་ཐོབ་པར་འགྱུར་ཏེ་། བཅུ་གང་ཞེ་ན་། འདི་ལྟ་སྟེ་། ཁྲོ་བར་མི་འགྱུར་བ་དང་། འཁོན་དུ་འཛིན་པ་མེད་པ་དང་། འཆབ་པར་མི་འགྱུར་བ་དང་། ཚིག་པར་མི་འགྱུར་བ་དང་། ཉེས་པ་ལ་མི་དགའ་བ་དང་། འཁོན་གཅུགས་ལ་མི་དགའ་བ་དང་། འདུ་ཤེས་ཕྱིན་ཅི་ལོག་ཏུ་མི་འགྱུར་བ་དང་། སྤོང་བ་ལ་བག་ཡོད་པར་འགྱུར་བ་དང་། མ་ཞུགས་པའི་སེམས་ཀྱིས་སངས་རྒྱས་ཀྱི་ཞིང་ཡོངས་སུ་དག་པར་འཛིན་པ་དང་། ང་རྒྱལ་དང་ཆེ་བའི་ང་རྒྱལ་མེད་པར་སངས་རྒྱས་ཀྱི་ཆོས་ཐམས་ཅད་མངོན་པར་སྒྲུབ་པའི་ཏིང་ངེ་འཛིན་ཐོབ་པར་འགྱུར་བ་སྟེ་། ཡིད་ཀྱི་ལས་ཡོངས་སུ་དག་པ་བཅུ་པོ་དེ་དག་ཐོབ་པར་འགྱུར་རོ་༎ དེ་ལ་འདི་སྐད་ཅེས་བྱ་སྟེ་། ཚོར་བས་ཉེན་ཅིང་འཆི་བའི་དུས་མི་བྱེད་༎ དེ་ཡི་མིག་ལ་འཁྲུལ་པར་འགྱུར་བ་མེད་༎ ལག་པ་མི་ག-ཡོ་བ་རྐང་པ་འཕྲ་མི་འགྱུར་༎
 cakṣuvibhramaścāsya na bhaviṣyati||||||||||||||| stavikṣepaṃ ca kariṣyati 3 na pādavikṣepaṃ ca kariṣyati |	དེ་ནི་བཤང་གཅི་སྟོར་བར་ཡོང་མི་འགྱུར་༎ དེ་ཡི་སྙིང་གར་རྡུལ་ཡང་འབྱུང་མི་འགྱུར་༎
 4 noccāraṃ kariṣyati | 5 na prasrāvaṃ kariṣyati |	ཁུ་ཚུར་མི་འཆད་ནམ་མཁའ་སྙེགས་མི་འགྱུར་༎ འདུག་བཞིན་བདེ་བར་འཆི་བའི་དུས་བྱེད་དེ་༎ ལུས་ལས་ཡོངས་སུ་དག་པ་འདི་བཅུ་ཐོབ་༎ གདངས་སྙན་ཕུན་སུམ་ཚོགས་ལ་འཇམ་མཉེན་ཚིག་། སྣུམ་༄༢༦༠ཨ་༌༎ ཞིང་ཡིད་འོང་དེ་བཞིན་དགའ་བར་འགྱུར་༎
 6 na||||||||||||||||||||||||||||||||||||||||||||| ātsvedaṃ prayariṣyati |	གཞན་གྱིས་སླར་མི་བཟློག་ཅིང་བཟུང་འོས་ཚིག་། སྐྱེ་བོས་བཙུན་པར་བྱ་བའི་ཚིག་ཏུ་འགྱུར་༎ དེ་ཡི་ཚིག་ནི་ལྷ་དང་ཀླུ་དག་དང་༎ མིའམ་ཅི་དང་དེ་བཞིན་རྒྱལ་བས་བསྔགས་༎ དེས་བཤད་པ་ཡི་དོན་ཀྱང་འཛིན་བྱེད་དེ་༎ དེས་ནི་ངག་ལས་དག་པ་དེ་དག་འཐོབ་༎ ཁྲོ་བ་མེད་ཅིང་འཁོན་དུ་འཛིན་པ་མེད་༎ བརྟན་པ་འཆབ་པ་མེད་ཅིང་འཚིག་པ་མེད་༎ ཉེས་ལ་མི་དགའ་འཁོན་གཅུགས་དགའ་བ་མེད་༎ དེ་ཡི་འདུ་ཤེས་ཕྱིན་ཅི་ལོག་མི་འགྱུར་༎ བསླབ་པ་ཡང་དག་བླངས་ལ་སེམས་མི་ཞུམ་༎ སྤོང་བ་ལ་ནི་བག་མེད་མི་འགྱུར་ཏེ་༎ ཞུམ་པ་མེད་པའི་སེམས་ཀྱིས་ཞིང་སྦྱོང་བྱེད་༎ ང་རྒྱལ་ལས་ཀྱང་ང་རྒྱལ་ཡོངས་སྤངས་ནས་༎ ཏིང་འཛིན་འབྱོར་པ་ཐམས་ཅད་མངོན་བསྒྲུབས་ནས་༎ ཡིད་ཀྱིས་མངོན་པར་བསྒྲུབས་པའི་ཆོས་རྣམས་འཐོབ་༎ ཆོས་རྣམས་འདི་དག་ལྡན་པར་གྱུར་པ་ལ་༎ སངས་རྒྱས་དངོས་པོ་དཀོན་པར་མི་འགྱུར་རོ་༎ འོད་སྲུང༏་གང་ལ་ལ་བདེ་བའི་ཡོ་བྱད་ཐམས་ཅད་ཀྱིས་ང་ལ་བཀུར་སྟིར་བྱེད་པར་འདོད་པ་དང་། མཆོད་པ་ཐམས་ཅད་ཀྱིས་མཆོད་པར་འདོད་པ་དེས་དཀོན་མཆོག་བརྩེགས་པ་ཆེན་པོའི་ཆོས་ཀྱི་རྣམ་གྲངས་འདི་གཟུང་བར་བྱ་། ཀུན་ཆུབ་པར་བྱ་། ཡི་གེར་བྲི་བར་བྱ་།
 7 na muṣṭiṃ kariṣyati | 8 na cākāśaṃ parāmṛśati |	བཀླག་པར་བྱ་།
