skt	tib
 āps 1| bhagavāṃc chrāvastyāṃ viharati sma jetavane anāthapiṇḍadasyārāme| tatra bhagavān bhikṣūn āmantrayate sma| icchatha yūyaṃ bhikṣavaḥ satvānām (gbm 1707|1) āyuḥparyantaṃ śrotuṃ| etasya bhagavāṃ kāla, etasya sugata samayo,	བཅོམ་ལྡན་འདས་མཉན་ཡོད་ན་རྒྱལ་བུ་རྒྱལ་བྱེད་ཀྱི་ཚལ་མགོན་མེད་ཟས་སྦྱིན་གྱི་ཀུན་དགའ་ར་བ་ན་བཞུགས་སོ་༎ དེ་ནས་བཅོམ་ལྡན་འདས་ཀྱིས་དགེ་སློང་རྣམས་ལ་བཀའ་སྩལ་པ་། དགེ་སློང་དག་ཁྱེད་སེམས་ཅན་རྣམས་ཀྱི་ཚེའི་མཐའ་ཐོས་པར་འདོད་དམ་། བཅོམ་ལྡན་འདས་། དེའི་དུས་ལ་བབ་ལགས་སོ་༎ བདེ་བར་གཤེགས་པ་། དེའི་དུས་ལ་བབ་ལགས་སོ་༎
 yad bhagavān bhikṣūṇāṃ satvānām āyuḥparyantaṃ deśayed| bhagavataḥ śrutvā bhikṣavo dhārayiṣyanti| tena hi bhikṣavaḥ (gbm 1707|2)	བཅོམ་ལྡན་འདས་། སེམས་ཅན་རྣམས་ཀྱི་ཚེའི་མཐའ་བསྟན་པ་བཅོམ་ལྡན་འདས་ལས་ཐོས་ནས་དགེ་སློང་དག་འཛིན་པར་བགྱིད་ལགས་སོ་༎ 
 śṛṇuta sādhu ca suṣṭhu ca manasikuruta,	དགེ་སློང་དག་། དེའི་ཕྱིར་ལེགས་པར་རབ་ཏུ་ཉོན་ལ་ཡིད་ལ་ཟུངས་ཤིག་དང་ངས་བཤད་དོ་༎ དགེ་སློང་དག་། དམྱལ་བ་རྣམས་ཀྱི་ཚེའི་ཚད་ནི་རིང་ན་བསྐལ་པ་གཅིག་སྟེ་། བར་མ་དོར་འཆི་བ་ནི་ཡོད་དོ་༎
 bhāṣiṣya| evaṃ bhadanteti| te bhikṣavo bhagavataḥ pratyaśroṣuḥ| atha bhagavāṃs tān bhikṣūn idam avocat*| āps 2| paraṃ bhikṣavo narakeṣu kalpa āyuṣaḥ (gbm 1707|3) pramāṇam, asty antareṇa kālakriyā|	དགེ་སློང་དག་།
 āps 3| paraṃ bhikṣavas tiryakṣu kalpa āyuṣaḥ pramāṇam,	༄༢༡༤བ་དུད་འགྲོ་རྣམས་ཀྱི་ཚེའི་ཚད་ནི་རིང་ན་བསྐལ་པ་གཅིག་སྟེ་།
 asty antareṇa kālakriyā|	བར་མ་དོར་འཆི་བ་ནི་ཡོད་དོ་༎ དགེ་སློང་དག་།
 āps 4| yāni bhikṣavo manuṣyāṇāṃ triṃśad rātriṃdivasāni tat pretānām (gbm 1707|4) ekaṃ rātriṃdivasaṃ,	མི་རྣམས་ཀྱི་ཉིན་ཞག་སུམ་ཅུ་གང་ཡིན་པ་དེ་ཡི་དབ༹གས་རྣམས་ཀྱི་ཉིན་ཞག་གཅིག་གོ་།
 tena rātriṃdivasena triṃśad rātrakeṇa māsena,	ཉིན་ཞག་དེ་སུམ་ཅུ་ལ་ཟླ་བ་གཅིག་།
 dvādaśa māsakena saṃvatsareṇa,	ཟླ་བ་བཅུ་གཉིས་ལ་ལོ་གཅིག་སྟེ་།
 tayā saṃvatsaragaṇanayā paṃca varṣaśatāni pretānām āyuṣaḥ (gbm 1707|5)	ཡི་དབ༹གས་རྣམས་ཀྱི་ཚེའི་ཚད་ནི་ལོ་དེ་ལྟ་བུར་བརྩིས་པའི་ལྔ་བརྒྱ་ཐུབ་སྟེ་།
 pramāṇāṃ| tad bhavati mānuṣikayā gaṇanayā paṃcadaśa varṣasahasrāṇy āyuṣaḥ pramāṇam,	དེ་མིའི་ལྟར་བརྩིས་ན་ལོ་ཁྲི་ལྔ་སྟོང་ཡོད་དེ་།
 asty antareṇa kālakriyā|	བར་མ་དོར་འཆི་བ་ནི་ཡོད་དོ་༎
 āps 5| atha bhagavāṃs tasyāṃ velāyāṃ gāthā bhāṣate|	དེ་ནས་བཅོམ་ལྡན་འདས་ཀྱིས་དེའི་ཚེ་ཚིགས་སུ་བཅད་དེ་བཀའ་སྩལ་པ་། ཇི་ལྟར་རབ་ཏུ་ཆེ་བའི་ལུས་འགྲེང་ཞིང་༎
 viśuṣkakaṇṭhauṣṭhapuṭā (gbm 1707|6) suduḥkhitā pravṛddhaśailā iva ucchritāśrayā |	མཆུ་དང་མིད་བསྐམས་ཤིན་ཏུ་སྡུག་བསྔལ་བ་༎
 svakeśasaṃcchannavidāritonmukhā	རང་གི་སྐྲས་ཡོག་ཁ་གདངས་གནམ་དུ་ལྟ་༎
 susūkṣmasūcīsadṛśā nasāḥ kṛśā || 1 nagnā svakeśasaṃchanno asthiyantravadantatā (gbm 1707|7) | kapālapāṇayo ghorāḥ kradantaḥ paridhāvinaḥ || 2	སྣ་ནི་ཁབ་ལྟར་རབ་ཏུ་ཕྲ་བ་དང་༎ རུས་གོང་འདྲ་ལུས་གཅེར་བུ་རང་སྐྲས་ཡོག་། གཟུགས་མི་སྡུག་པ་འགྲེང་ཞིང་ཐོད་པ་ཐོགས་༎ བཀྲེས་དང་སྐོམ་དང་ངལ་བས་ར་བ་གཟིར་གང་༎ ཆོ་ངེས་འདེབས་ཤིང་ཀུན་ཏུ་རྒྱུག་པ་དག་།
 ārtasvarāṇi krandanto duḥkhāṃ vindati vedanām* || 3 X X X X (gbm 1693|1) ^ _ vyehe kṛtverṣyāṃ ca parasparam* | utpannās te pretaloke karma kṛtveha pāpakaḥ || 4	ཉམ་ཐག་སྐད་འབྱིན་སྡུག་བསྔལ་ཚོར་བ་མྱོང་༎ ཕན་ཚུན་ཕྲག་དོག་སེར་སྣ་འདིར་བསྟེན་ཅིང་༎ འདིར་ནི་སྡིག་པའི་ལས་དག་བྱས་པ་ཡིས་༎ ཡི་དབ༹གས་འཇིག་རྟེན་དུ་ནི་དེ་དག་སྐྱེས་༎
 āps 6| pūrvavidehakānāṃ bhikṣavo manuṣyāṇām ardhatritīyāni varṣaśatāny āyuṣaḥ pramāṇam,	དགེ་སློང་དག་། ཤར་གྱི་ལུས་འཕགས་ཀྱི་མི་རྣམས་ཀྱི་ཚེའི་ཚད་ནི་ལོ་ཉིས་བརྒྱ་ལྔ་བཅུ་སྟེ་།
 asty antareṇa (gbm 1693|2) kālakriyā|	བར་མ་དོར་འཆི་བ་ནི་ཡོད་དོ་༎
 āps 7| avaragodānīyakānāṃ bhikṣavo manuṣyāṇāṃ paṃca varṣaśatāny āyuṣaḥ pramāṇam,	དགེ་སློང་དག་། ནུབ་ཀྱི་བ་ལང་སྤྱོད་ཀྱི་མི་རྣམས་ཀྱི་ཚེའི་ཚད་ལོ་ལྔ་བརྒྱ་སྟེ་།
 asty antareṇa kālakriyā|	བར་མ་དོར་འཆི་བ་ནི་ཡོད་དོ་༎ དགེ་སློང་དག་། བྱང་༄༢༡༥ཨ་༌༎
 āps 8| uttarakauravāṇāṃ bhikṣavo manuṣyāṇāṃ varṣasahasrāṇy āyuṣaḥ (gbm 1693|3)	གི་སྒྲ་མི་སྙན་རྣམས་ཀྱི་ཚེའི་ཚད་ནི་ལོ་སྟོང་སྟེ་།
 pramāṇam, nāsty antareṇa kālakriyā|	བར་མ་དོར་འཆི་བ་ནི་མེད་དོ་༎
 āps 9| kena kāraṇenottarakauravāṇāṃ manuṣyāṇāṃ varṣasahasram āyuṣaḥ pramāṇam,	རྒྱུ་གང་གིས་སྒྲ་མི་སྙན་པ་རྣམས་ཀྱི་ཚེའི་ཚད་ནི་ལོ་སྟོང་ཐུབ་ལ་།
 nāsty antareṇa kālakriyā| āps 10| uttarakauravā bhikṣavo (gbm 1693|4)	བར་མ་དོར་འཆི་བ་ནི་མེད་ཅེ་ན་། དགེ་སློང་དག་།
 manuṣyā amamāś ca parigrahāś ca niyatāyus + + tac cyutā viśeṣagāmina āyatyāṃ svargopagāḥ| anena kāraṇenottarakauravāṇāṃ bhikṣavo manuṣyāṇāṃ varṣasahasram (gbm 1693|5) āyuṣaḥ pramāṇam, nāsty antareṇa kālakriyā|	བྱང་གི་སྒྲ་མི་སྙན་གྱི་མི་རྣམས་ནི་བདག་གི་བ་མེད་ཅིང་ཡོངས་སུ་འཛིན་པ་མེད་ལ་ཚེ་ངེས་པ་ཡོད་ཅིང་འདི་ནས་ཤི་འཕོས་ནས་ཀྱང་ཁྱད་པར་དུ་འགྲོ་བ་སྟེ་། ཕྱི་མ་ལ་མཐོ་རིས་སུ་ཉེ་བར་འགྲོའོ་༎ དགེ་སློང་དག་། རྒྱུ་དེས་ན་བྱང་གི་སྒྲ་མི་སྙན་གྱི་མི་རྣམས་ཀྱི་ཚེའི་ཚད་ནི་ལོ་སྟོང་ཐུབ་ལ་བར་མ་དོར་འཆི་བ་ནི་མེད་དོ་༎
 āps 11| atha bhagavāṃs tasyāṃ velāyāṃ gāthā bhāṣate|	དེ་ནས་བཅོམ་ལྡན་འདས་ཀྱིས་དེའི་ཚེ་ཚིགས་སུ་བཅད་དེ་བཀའ་སྩལ་པ་།
 daridryaduḥkhitā satvā āśaṃsanti dhanaṃ param* | parapreṣya (gbm 1693|6) ^ _ _ X X X X X ^ _ ^ X || 5	དབུལ་བས་སྡུག་བསྔལ་སེམས་ཅན་དག་། གཞན་གྱི་ནོར་ལ་སྨོན་པར་བྱེད་༎ དེ་དག་དམ་པ་མ་བསྟེན་པས་༎ གཞན་གྱི་མངག་གཞུག་ངན་ཅིང་དམན་༎ ལོངས་སྤྱོད་དག་དང་ལྡན་པ་ཡི་༎
 āḍhyā mahādhanā satvā upabhogasamanvitāḥ |	ཕྱུག་ཅིང་ནོར་མང་སེམས་ཅན་ནི་༎
 dhanadānyajanopetās tais tu santa upāsita || 6	ནོར་དང་འབྲུ་དང་སྐྱེ་བོར་ལྡན་༎ དེ་དག་དམ་པ་བསྟེན་པ་ཡིན་༎ བསོད་ནམས་ཕྱུག་པས་ཉེར་འཚོ་བའི་༎
 upajīvanti puṇyāḍhyaṃ karma kṛtveha śobhanam | (gbm 1693|6) X X X X ^ _ _ X X X X X ^ _ ^ X || 7 X X X X ^ _ _ X X X X X ^ _ ^ X | ye loke _ |i _ _ |i pūrvadānasya tat phalam* || 8 manuṣyā hy uttare dvīpe amama (gbm 1692|1) aprigrahāḥ |	དགེ་བའི་ལས་ནི་འདིར་བྱས་པས་༎ འབྱོར་པ་ཆེན་པོ་ཕུན་སུམ་ཚོགས་༎ ལྷ་བཞིན་དུ་ནི་དགའ་བར་བྱེད་༎ ལྐོག་གྱུར་གང་ཡིན་མི་སྣང་སྟེ་༎ མངོན་སུམ་འདི་ལ་བལྟ་བར་བྱོས་༎ གང་ཟག་ཁ་ཅིག་འཇིག་རྟེན་ན་༎ བདེ་ལྡན་སྔོན་བྱིན་འབྲས་བུ་ཡིན་༎ བྱང་ཕྱོགས་གླིང་གི་མི་རྣམས་ནི་༎ བདག་གི་མེད་ཅིང་ཡོངས་འཛིན་༄༢༡༥བ་མེད༏་༏དཔག་བསམ་ལས་བྱུང་གོས་སྟེན་པ་༎
 X X X kalpaduṣyāṇi pūrvadānasya tat phalam* || 9	དེ་ནི་སྔོན་བྱིན་འབྲས་བུ་ཡིན་༎
 na teṣāṃ śītam ūṣṇaṃ ca vyādhis teṣāṃ na vidyate |	དེ་དག་གྲང་དང་ཚ་བ་མེད་༎ དེ་དག་ལ་ནི་ནད་མེད་ཅིང་༎
 varṇarūpeṇasaṃpannāḥ pūrvadānasya tat phalam* || 10 akhaṇḍā vimalā śāli (gbm 1692|2) X X X X ^ _ ^ X |	གཟུགས་དང་ཁ་དོག་ཕུན་སུམ་ཚོགས་༎ དེ་ནི་སྔོན་བྱིན་འབྲས་བུ་ཡིན་༎ བྱང་ཕྱོགས་གླིང་ན་མ་ཉམས་ཤིང་༎ མ་གྲུགས་དག་ཅིང་གཙང་བ་དང་༎ ཤིན་ཏུ་དཀར་བའི་སའ་ལུ་སྐྱེ་༎
 X X te hy uttare dvīpe pūrvadānasya tat phalam* || 11	དེ་ནི་སྔོན་བྱིན་འབྲས་བུ་ཡིན་༎
 maṇijyotiṣkaras teṣāṃ śubhaḥ prajvalate sadā |	ནོར་བུ་འོད་བྱེད་འབར་བ་ཡིས་༎ དེ་རྣམས་རྟག་ཏུ་མཛེས་པ་དང་༎ དེ་དག་ཟས་ནི་འཇུ་བྱེད་གང་༎
 yas teṣāṃ pācayaty annaṃ pūrvadānasya tat phalam* || 12 na teṣāṃ vyaṃjanaṃ (gbm 1692|3) _ X X X X X pavidyate |	དེ་ནི་སྔོན་བྱིན་འབྲས་བུ་ཡིན་༎ དེ་དག་ལ་ནི་ཚོད་མ་དང་༎ སྲན་ཚོད་ཀྱང་ནི་ཅུང་ཟད་མེད་༎
 varṇagandharasopetaṃ śāliṃ te bhuṃjate sadā || 13 ekasmād dīyate hy annaṃ na kṣayo 'sti hi bhājanam* |	ཁ་དོག་དྲི་དང་རོར་ལྡན་པའི་༎ སའ་ལུ་དག་ནི་རྟག་ཏུ་ཟ་༎ ཟས་ནི་ལན་གཅིག་བྱིན་པ་ཡིས་༎
 āsannān notthitā yāvat pūrvadānasya tat (gbm 1692|4) phalam* || 14 alābūnāṃ phalāny eṣāṃ cchinā śākhā prarohate |	སྟན་ལས་མ་ལངས་བར་དུ་ནི་༎ ཟད་མི་ཤེས་པར་སྡེར་ལ་ཡོད་༎ དེ་ནི་སྔོན་བྱིན་འབྲས་བུ་ཡིན༏་༏ཀུ་བའི་འབྲས་བུ་འདྲ་བ་དང་༎ བཅད་ཀྱང་ཡལ་ག་ལས་སྐྱེས་ཏེ་༎ བརྔས་ནས་བཙོ་མི་དགོས་པར་ཟ་༎
 apakṣalūnāṃ bhuṃjate pūrvadānasya tat phalam* || 15	དེ་ནི་སྔོན་བྱིན་འབྲས་བུ་ཡིན་༎
 nadya suśītalās teṣāṃ aṣṭāṃgaṃ ca jalaṃ śubham* | pītaṃ (gbm 1692|5) na bādhate kukṣiṃ pūrvadānasya tat phalam* || 16	དེ་དག་འབབ་ཆུ་བསིལ་བ་དང་༎ འཐུངས་ཀྱང་ལྟོ་ལ་མི་གནོད་པའི་༎ ཡན་ལག་བརྒྱད་ལྡན་ཆུ་ལ་ཡོད་༎ དེ་ནི་སྔོན་བྱིན་འབྲས་བུ་ཡིན་༎ རོལ་མོའི་ལྗོན་ཤིང་གང་དག་གིས་༎ དེ་དག་རྟག་ཏུ་རྩེ་ཞིང་དགའ༎ ཡིད་ནི་རྟག་ཏུ་བདེ་དང་ལྡན་༎ དེ་ནི་སྔོན་བྱིན་འབྲས་བུ་ཡིན་༎
 vādyavṛkṣā śubhās teṣāṃ celavṛkṣā hy ana ^ Xḥ | gandhavṛkṣa ^ _ _ Xḥ pūrvadānasya tat phalam* || 17	དེ་དག་རོལ་མོའི་ལྗོན་ཤིང་བཟང་༎ གོས་ཀྱི་ལྗོན་ཤིང་མང་པོ་དང་༎ སྤོས་ཀྱི་ལྗོན་ཤིང་ཕུན་སུམ་ཚོགས་༎ དེ་ནི་སྔོན་བྱིན་འབྲས་༄༢༡༦ཨ་༌༎ བུ་ཡིན་༎
 vādyaṃ gandhaṃ ca puṣpaṃ ca ni(gbm 1692|6) Xm eva ca cīvaram* | kāṃkṣate yādṛśaṃ yo hi tad bhavaty asya tādṛśam* || 18	སྤོས་དང་མེ་ཏོག་རོལ་མོ་དང་༎ དེ་བཞིན་དུ་ནི་གོས་རྣམས་ཀྱང་༎ གང་དག་ཇི་ལྟར་འདོད་པ་བཞིན་༎ དེ་དག་དེ་བཞིན་འབྱུང་བར་འགྱུར་༎ ནེའུ་གསིང་དག་ནི་སྔོན་པོ་ལ་༎
 haritaḥ śādvalas teṣāṃ sumṛdus tūlasannibhaḥ |	ཤིང་བལ་ལྟ་བུར་རབ་འཇམ་པ་༎
 ramante yatra satataṃ pūrvadānasya tat phalam* || 19 parasparaṃ ca (gbm 1692|7)	གང་དུ་དེ་དག་རྟག་རྩེ་བ་༎ དེ་ནི་སྔོན་བྱིན་འབྲས་བུ་ཡིན་༎
 krīḍanti kroṣas teṣāṃ na vidyate |	དེ་དག་ལ་ནི་ཁྲོ་མེད་ཅིང་༎
 nāsti mātsaryam īrṣyā va pūrvadānasya tat phalam* || 20 rātryās tu prathame yāme kṣaṇamātraṃ hi varṣati |	སེར་སྣ་དང་ནི་ཕྲག་དོག་མེད་༎ ཕན་ཚུན་དག་ཏུ་རྩེ་བྱེད་པ་༎ དེ་ནི་སྔོན་བྱིན་འབྲས་བུ་ཡིན་༎ མཚན་མོ་ཐུན་ཚོད་དང་པོ་ལ་༎ སྐད་ཅིག་ཙམ་ཞིག་ཆར་འབེབས་ཅིང་༎ རྡུལ་རྣམས་མེད་པར་བྱེད་པ་སྟེ་༎
 virajorajo bhavati pūrvadānasya tat phalam* || 21	དེ་ནི་སྔོན་བྱིན་འབྲས་བུ་ཡིན་༎ དེ་དག་ཡོངས་སུ་འཛིན་མེད་པས་༎
 (gbm 1705|1) mātā putraṃ na jānīte nāsti teṣāṃ parigrahaḥ |	མ་དང་བུར་ཡང་མི་ཤེས་ཤིང་༎
 na śocanti priyair nāśaṃ pūrvadānasya tat phalam* || 22 mātā hi svaputraṃ _ X X X X X ^ _ ^ X |	སྡུག་བསྔལ་མེད་པས་མྱ་ངན་མེད་༎ དེ་ནི་སྔོན་བྱིན་འབྲས་བུ་ཡིན་༎ མ་དག་གིས་ཀྱང་རང་གི་བུ་༎ ལམ་སྟོང་དག་ཏུ་བོར་ཏེ་འགྲོ་།
 sravate kṣīraṃ aṅguṣṭhāt pūrvadānasya tat phalam* || 23	མཐེ་བོ་ལས་ནི་འོ་མ་འཛག་། དེ་ནི་སྔོན་བྱིན་འབྲས་བུ་ཡིན་༎ དེ་དག་གང་ཡང་དུ་བ་མེད་༎
 (gbm 1705|2) na teṣāṃ rodate kaścid mṛtaṃ cotsṛjya gacchati |	ཤིན་ཡང་ནི་བོར་ཏེ་འགྲོ་། བྱ་དག་གིས་ནི་གླིང་འཕྱག་པ་༎
 śodhayanti khagā dvīpaṃ pūrvadānasya tat phalam* || 24	དེ་ནི་སྔོན་བྱིན་འབྲས་བུ་ཡིན་༎
 samantāt parikhācchinnaṃ nṛtagītair manoramai |	ཁོར་ཡུག་ཏུ་ནི་འོབས་ཀྱིས་བསྐོར་༎ གླུ་གར་ཡིད་དུ་འོང་བ་ཡིས་༎
 ramante yatra krīḍanti pūrvadānasya tat phalam* || 25	གང་དུ་རྩེ་ཞིང་དགའ་བར་བྱེད་༎ དེ་ནི་སྔོན་བྱིན་འབྲས་བུ་ཡིན་༎
 āyur (gbm 1705|3) varṣasahasraṃ hi kṣapayitvātra mānuṣam* |	མི་ཡི་ཚེ་ནི་ལོ་སྟོང་པོ་༎ ཟད་པ་དག་ཏུ་བྱས་ནས་ནི་༎ བར་མ་དོར་ནི་འཆི་མེད་པ་༎
 mriyante nāntareṇeti pūrvadānasya tat phalam* || 26 hitvā X X ^ _ _ Xṃ kṛtvā ca vipulaṃ śriyam* |	དེ་ནི་སྔོན་བྱིན་འབྲས་བུ་ཡིན་༎ དཔལ་ནི་རྒྱས་པར་སྤྱད་ནས་སུ་༎ མི་ཡི་ལུས་ནི་༄༢༡༦བ་བོར་ནས་ཀྱང་༎
 deveṣu nopapadyante pūrvadānasya (gbm 1705|4) tat phalam* || 27	ལྷ་ཡི་ནང་དུ་སྐྱེ་བར་འགྱུར་༎ དེ་ནི་སྔོན་བྱིན་འབྲས་བུ་ཡིན་༎ དགེ་སློང་དག་།
 āps 12| jāmbūdvīpakānāṃ bhikṣavo manuṣyāṇām utkarṣāpakarṣaṃ prajñāyate| jāmbudvīpakā bhikṣavo manuṣyā amitāyuṣo 'pi,	ཛམབུའི་གླིང་གི་མི་རྣམས་ལ་ནི་ཡར་འཕེལ་བ་དང་། མར་འགྲིབ་པ་ཡོད་དེ་། དགེ་སློང་དག་། ཛམབུའི་གླིང་གི་མི་རྣམས་ནི་ཚེ་ལོ་དཔག་ཏུ་མེད་པར་ཡང་འགྱུར་།
 aśītivarṣasahasrāyuṣo 'pi, (gbm 1705|5) varṣaśatāyuṣo 'pi, daśavarṣāyuṣo 'pi|	ཚེ་ལོ་བརྒྱད་ཁྲི་པ་དང་། ཚེ་ལོ་བརྒྱ་པ་དང་། ཚེ་ལོ་བཅུ་པར་ཡང་འགྱུར་རོ་༎ དགེ་སློང་དག་།
 āps 13| etarhi bhikṣavo jāmbūdvīpakānāṃ manuṣyāṇāṃ varṣaśatam āyuṣaḥ pramāṇaṃ| etarhi bhikṣavo jāmbūdvīpakānāṃ manuṣyāṇāṃ (gbm 1705|6) yaś ciraṃ jīvati sa varṣaśataṃ kiṃcid vā bhūyaḥ samyaksukhena parihṛyamāṇaḥ| āps 14| varṣaśataṃ khalu bhikṣavo jīvaṃ daśāvasthāḥ pratyanubhavati| prathamāyām avasthāyāṃ (gbm 1705|7)	ཛམབུའི་གླིང་གི་མི་རྣམས་ཀྱི་ད་ལྟར་གྱི་ཚེའི་ཚད་ནི་ལོ་བརྒྱ་པ་ཡིན་ནོ་༎ དགེ་སློང་དག་། ད་ལྟར་ནི་ཛམབུའི་གླིང་གི་མི་རྣམས་ལས་རིང་དུ་འཚོ་བ་གང་ཡིན་པས་ལེགས་པར་བདེ་བར་གནས་ན་ལོ་བརྒྱའམ་། ལོ་བརྒྱ་ལས་ཅུང་ཟད་ཅིག་ལྷག་པར་ཐུབ་བོ་༎ དགེ་སློང་དག་། འཚོ་བའི་གནས་སྐབས་ནི་བཅུ་མྱོང་བར་འགྱུར་ཏེ་།
 bālo bhavati manda uttānaśāyī| dvitīyāyām avasthāyāṃ kumāro bhavati krīḍanajātīyaḥ| tṛtīyāyām avasthāyāṃ yuvā bhavati kāmabhogī| caturthyām avasthāyāṃ (gbm 1704|1)	གནས་སྐབས་དང་པོ་ནི་ཞན་ཅིང་གན་རྐྱལ་དུ་ཉལ་པ་སྟེ་བྱིས་པ་ཡིན་ནོ༏་༏གནས་སྐབས་གཉིས་པ་ནི་རྩེ་བའི་རང་བཞིན་ཅན་ཏེ་གཞོན་ནུ་ཡིན་ནོ་༎ གནས་སྐབས་གསུམ་པ་ནི་འདོད་པ་ལ་སྤྱོད་པ་སྟེ་། ལང་ཚོ་ལ་བབ་པ་ཡིན་ནོ་༎ གནས་སྐབས་བཞི་པ་ནི་སྤྲོ་བ་དང་ལྡན་ཞིང་ཉམས་སྟོབས་དང་ལྡན་པ་ཡིན་ནོ་༎
 balavān bhavati utsāhī| paṃcamyām avasthāyāṃ prajño bhavati pratibhānavān*| ṣaṣṭhyām	གནས་སྐབས་ལྔ་པ་ནི་སྟོབས་དང་ལྡན་ཞིང་ཤེས་རབ་དང་ལྡན་པ་ཡིན་ནོ་༎
 avasthāyāṃ smṛtimān bhavati mīmāṃsanajātīyaḥ| saptamyām avasthāyāṃ sthito bhavati manā (gbm 1704|2)	གནས་སྐབས་དྲུག་པ་ནི་དཔྱོད་པའི་རང་བཞིན་ཅན་ཏེ་དྲན་པ་དང་ལྡན་པ་ཡིན་ནོ་༎ གནས་སྐབས་བདུན་པ་ནི་ཆོས་ལུགས་ཁོང་དུ་ཆུད་པ་ཡིན་ནོ་༎
 + + prāptaḥ| aṣṭhamyām avasthāyāṃ sthaviro bhavati rājanyaḥ| navamyām avasthāyāṃ	གནས་སྐབས་བརྒྱད་པ་ནི་རྒྱལ་པོས་བཀུར་ཞིང་རྒན་རབས་སུ་བཀུར་བ་ཡིན་ནོ་༎
 vṛddho bhavati jarājīrṇaḥ| daśamyām avasthāyāṃ gatāyur bhavati maraṇaparāyaṇaḥ| varṣaśataṃ (gbm 1704|3)	༄༢༡༧ཨ་༌༎ གནས་སྐབས་དགུ་པ་ནི་རྒས་ཤིང་འཁོགས་པ་སྟེ་རྒན་པོ་ཡིན་ནོ་༎ གནས་སྐབས་བཅུ་པ་ནི་ཚེའི་མཐར་ཐུག་པ་སྟེ་འཆིར་ཉེ་བ་ཡིན་ནོ་༎ དགེ་སློང་དག་།
 khalu bhikṣavo jīvam iha daśāvasthāḥ pratyanubhavati|	ལོ་བརྒྱར་འཚོ་བས་གནས་སྐབས་བཅུ་པོ་དེ་དག་མྱོང་བར་འགྱུར་རོ་༎
 āps 15| varṣaśataṃ khalu bhikṣavo jīvan trīṇi ṛtuśatāni jīvati, ṛtuśataṃ hemantānāṃ, ṛtuśataṃ grīṣmāṇāṃ (gbm 1704|4)	དགེ་སློང་དག་། ལོ་བརྒྱར་འཚོ་བ་ནི་དུས་ཚིགས་སུམ་བརྒྱར་འཚོ་སྟེ་། དགུན་གྱི་དུས་ཚིགས་བརྒྱ་དང་། དཔྱིད་ཀྱི་དུས་ཚིགས་བརྒྱ་དང་། དབྱར་གྱི་དུས་ཚིགས་བརྒྱ་རྣམས་སོ་༎
 ṛtuśataṃ varṣāṇām*| trīṇi ṛtuśatāni jīvan dvādaśa māsaśatāni jīvati, catvāri hemantānāṃ,	དུས་ཚིགས་སུམ་བརྒྱར་འཚོ་བ་ནི་ཟླ་བ་བཅུ་གཉིས་ཕྲག་བརྒྱར་འཚོ་བ་སྟེ་།
 catvāri grīṣmāṇāṃ,	དགུན་བཞི་དང་། དཔྱིད་བཞི་དང་། དབྱར་བཞི་རྣམས་སོ་༎
 catvāri varṣāṇāṃ| dvādaśa māsaśatāni (gbm 1704|5) jīvaṃ caturviṃśatim ardhamāsaśatāni jīvati, aṣṭau hemantānām,	ཟླ་བ་བཅུ་གཉིས་ཕྲག་བརྒྱར་འཚོ་བ་ནི་ཟླ་བ་ཕྱེད་ཉིས་སྟོང་བཞི་བརྒྱར་འཚོ་སྟེ་།
 aṣṭau grīṣmāṇām,	དགུན་བརྒྱད་དང་། དཔྱིད་བརྒྱད་དང་། དབྱར་བརྒྱད་རྣམས་སོ་༎ ཟླ་བ་ཕྱེད་ཉིས་སྟོང་བཞི་བརྒྱར་འཚོ་བ་ནི་།
 aṣṭau varṣāṇām*| caturviṃśatim ardhamāsaśatāni jīvaṃ ṣaṭtriṃśataṃ rātriṃdivasasahasrāṇi (gbm 1704|6) jīvati dvādaśa hemantānāṃ,	ཉིན་ཞག་སུམ་ཁྲི་དྲུག་སྟོང་དུ་འཚོ་སྟེ་།
 dvādaśa grīṣṃāṇāṃ, dvādaśa varṣāṇāṃ|	དགུན་བཅུ་གཉིས་དང་། དཔྱིད་བཅུ་གཉིས་དང་། དབྱར་བཅུ་གཉིས་རྣམས་སོ་༎
 āps 16| ṣaṭtriṃśataṃ rātriṃdivasasahasrāṇi jīvan dvāsaptatiṃ bhaktasahasrāṇi bhuṃkte sārdhaṃ (gbm 1704|7)	ཉིན་ཞག་སུམ་ཁྲི་དྲུག་སྟོང་དུ་འཚོ་བ་ནི་བར་ཆད་དུ་གྱུར་པ་མ་གཏོགས་པར་ཟན་བདུན་ཁྲི་ཉིས་སྟོང་ཟའོ་༎
 bhaktāntarāyaiḥ| tatreme bhaktāntarāyāḥ, kupito 'pi na bhuṃkte, duḥkhito 'pi na bhuṃkte,	དེ་ལ་འདི་དག་ནི་ཟན་བར་ཆད་དུ་འགྱུར་བ་ཡིན་ཏེ་།
 kṛcchraprāto 'pi na bhuṃkte, + + + + + + + + + + + + pano 'pi na bhuṃkte, labhamāno 'pi na bhuṃkte (gbm 1702|1) alabhamāno 'pi na bhuṃkte, supto 'pi na bhuṃkte, matto 'pi na bhuṃkte, pramatto 'pi na bhuṃkte,	འཁྲུགས་ནས་མ་ཟོས་པ་དང་། སྡུག་བསྔལ་བར་གྱུར་པས་མ་ཟོས་པ་དང་། ཕོངས་པ་བྱུང་ནས་མ་ཟོས་པ་དང་། བསྙུངས་པ་བྱས་ཏེ་མ་ཟོས་པ་དང་། མ་རྙེད་པས་མ་ཟོས་པ་དང་། རྙེད་ཀྱང་མ་ཟོས་པ་དང་། ༄༢༡༧བ་གཉིད་ལོག་ནས་མ་ཟོས་པ་དང་། ར་རོ་སྟེ་མ་ཟོས་པ་དང་། རབ་ཏུ་མྱོས་པས་མ་ཟོས་པ་སྟེ་།
 iti yaś ca bhuṃkte yaś ca na bhuṃkte tad aikadhyam abhisaṃkṣipya dvāsaptatir bhaktasahasrāṇi bhavanti (gbm 1702|2) sārdhaṃ mātu stanyapānena|	ཟོས་པ་གང་ཡིན་པ་དང་། མ་ཟོས་པ་གང་ཡིན་པ་དེ་དག་གཅིག་ཏུ་བསྡོམས་ན་མའི་ནུ་ཞོ་འཐུང་བ་མ་གཏོགས་པར་ཟ་མ་བདུན་ཁྲི་ཉིས་སྟོང་དུ་འགྱུར་རོ་༎
 āps 17| iti hi bhikṣavo mayā jāmbūdvīpakāṇāṃ manuṣyāṇām āyur apy ākhyātam, ṛtavo 'pi, māsā apy, ardhamāsā api, rātriṃdivasāny api, bhaktāny api, (gbm 1702|3) bhaktāntarāyāṇy apy ākhyātā|	དགེ་སློང་། དེ་ལྟར་ངས་ཛམབུའི་གླིང་གི་མི་རྣམས་ཀྱི་ཚེ་འང་བཤད་། དུས་ཚིགས་དང་། ཟླ་བ་དང་། ཟླ་བ་ཕྱེད་པ་དང་། ཉིན་ཞག་དང༏་ཟན་དང་། ཟན་བར་ཆད་དུ་གྱུར་པའང་བཤད་པ་ཡིན་ནོ་༎
 āps 18| yāni bhikṣavo manuṣyāṇāṃ paṃcāśad varṣāṇi tac cāturmahārājikānāṃ devānām ekaṃ rātriṃdivasaṃ,	དགེ་སློང་དག་། མི་རྣམས་ཀྱི་ཚེ་ལོ་ལྔ་བཅུ་གང་ཡིན་པ་དེ་ནི་རྒྱལ་ཆེན་བཞིའི་རིས་ཀྱི་ལྷ་རྣམས་ཀྱི་ཉིན་ཞག་གཅིག་གོ་།
 tena rātriṃdivasena triṃśad rātrakena (gbm 1702|4)	དེ་སུམ་ཅུ་ལ་ཟླ་བ་གཅིག་།
 māsena, dvādaśa māsakena saṃvatsareṇa,	ཟླ་བ་བཅུ་གཉིས་ལ་ལོ་གཅིག་སྟེ་།
 tayā saṃvatsaragaṇanayā divyāni paṃca varṣaśatāni cāturmahārājikānāṃ devānām āyuṣaḥ pramāṇaṃ| (gbm 1702|5) tad bhavati mānuṣikayā gaṇanayā navati varṣaśatasahasrāṇy āyuṣaḥ pramāṇam,	རྒྱལ་ཆེན་བཞིའི་རིས་ཀྱི་ལྷ་རྣམས་ཀྱི་ཚེའི་ཚད་ནི་ལོ་དེ་ལྟ་བུར་བརྩིས་པའི་ལྷའི་ལོ་ལྔ་བརྒྱ་སྟེ་། དེ་མིའི་ལོ་ལྟར་བརྩིས་ན་ལོ་ས་ཡ་ཕྲག་དགུ་ཡོད་དེ་།
 asty antareṇa kālakriyā|	བར་མ་དོར་འཆི་བ་ནི་ཡོད་དོ་༎
 āps 19| tad bhavati saṃjīve mahānarake ekaṃ rātriṃdivasaṃ, (gbm 1702|6)	དེ་ནི་སེམས་ཅན་དམྱལ་བ་ཆེན་པོ་ཡང་སོས་ཀྱི་ཉིན་ཞག་གཅིག་གོ་།
 tena rātriṃdivasena triṃśad rātrakeṇa māsena,	ཉིན་ཞག་དེ་སུམ་ཅུ་ལ་ཟླ་བ་གཅིག་།
 dvādaśa māsakena saṃvatsareṇa,	ཟླ་བ་བཅུ་གཉིས་ལ་ལོ་གཅིག་སྟེ་།
 tayā saṃvatsaragaṇanayā paṃca varṣaśatāni saṃjīve mahānarake nārakāṇāṃ (gbm 1702|7)	སེམས་ཅན་དམྱལ་བ་ཆེན་པོ་ཡང་སོས་ཀྱི་སེམས་ཅན་དམྱལ་བ་རྣམས་ཀྱི་ཚེ་ཆད་ནི་ལོ་དེ་ལྟ་བུ་བརྩིས་པའི་ལོ་ལྔ་བརྒྱ་སྟེ་།
 satvānām āyuṣaḥ pramāṇaṃ| tad bhavati māṇuṣikayā gaṇanayā| ekaṃ varṣakoṭīśatasahasraṃ dvāṣaṣṭīṇi ca varṣakoṭīsahasrāṇy āyuṣaḥ pramāṇam,	དེ་མིའི་ལྟར་བརྩིས་ན་ལོ་བྱེ་བ་ཕྲག་འབུམ་དྲུག་ཁྲི་ཉིས་སྟོང་ཡོད་དེ་།
 asty antareṇa (gbm 1703|1) kālakriyā|	བར་མ་དོར་འཆི་བ་ནི་ཡོད་དོ་༎
 āps 20| atha bhagavāṃs tasyāṃ velāyāṃ gāthā bhāṣate|	དེ་ནས་བཅོམ་ལྡན་འདས་ཀྱིས་དེའི་ཚེ་ཚིགས་སུ་བཅད་དེ་བཀའ་སྩལ་པ་། ལུས་ཀྱིས་ཉེས་པར་སྤྱད་བྱས་ཤིང་༎ ངག་གིས་ཉེས་པར་༄༢༡༨ཨ་༌༎
 kāyaduścaritaṃ kṛtvā vacoduścaritām iva | X X X X ^ _ _ X X X X X ^ _ ^ X || 28 saṃjīva upapadyante (gbm 1703|2)	སྤྱད་པ་དང་༎ ཡིད་ཀྱིས་ཉེས་པར་སྤྱད་བྱས་ཤིང་༎ གང་ཞིག་ཉེས་པ་གཞན་ལྡན་པའི་༎ ལས་དེ་དག་གིས་ཡང་སོས་ཀྱི་༎
 narake tena karmaṇā |	དམྱལ་བ་དག་ཏུ་སྐྱེ་འགྱུར་ཏེ་༎
 varṣakoṭīsahasrāṇi saṃjīvanti hatā hatāḥ || 29	ལོ་ནི་བྱེ་བ་ཕྲག་སྟོང་དུ་༎ གཏགས་ཤིང་བཅོམ་ཡང་ཡང་འཚོའོ་༎
 anyonyavairasaṃsaktā narāḥ puruṣaghātakāḥ |	ཕན་ཚུན་ཁོ་ན་དག་ཆགས་པ་ཡིས་༎ མི་རྣམས་གསོད་པའི་མི་དག་ནི་༎ ལས་དེ་དག་གིས་ཡང་སོས་ཀྱི་༎
 saṃjīva upapadyante narake tena karmaṇā || 30	དམྱལ་བ་དག་ཏུ་སྐྱེ་བར་འགྱུར་༎ དགེ་སློང་དག་།
 āps 21| yad bhikṣavo (gbm 1703|3) manuṣyāṇāṃ varṣaśataṃ tad devāṇāṃ trayastriṃśānām ekaṃ rātriṃdivasaṃ,	མི་རྣམས་ཀྱི་ལོ་བརྒྱ་གང་ཡིན་པ་དེ་ནི་སུམ་ཅུ་རྩ་གསུམ་པའི་ལྷ་རྣམས་ཀྱི་ཉིན་ཞག་གཅིག་གོ་། 
 tena rātriṃdivasena triṃśad rātrakeṇa māsena,	ཉིན་ཞག་དེ་སུམ་ཅུ་ལ་ཟླ་བ་གཅིག་གོ་།
 dvādaśa māsakena saṃvatsareṇa, tayā saṃvatsaragaṇanayā (gbm 1703|4)	ཟླ་བ་བཅུ་གཉིས་ལ་ལོ་གཅིག་སྟེ་།
 divyaṃ varṣasahasraṃ devānām trayastriṃśānām āyuṣaḥ pramāṇaṃ| tad bhavati mānuṣikayā gaṇanayā tisro varṣakoṭyaḥ ṣaṣṭiś ca varṣaśatasahasrāṇy (gbm 1703|5) āyuṣaḥ pramāṇam,	སུམ་ཅུ་རྩ་གསུམ་གྱི་ལྷ་རྣམས་ཀྱི་ཚེའི་ཚད་ནི་ལོ་དེ་ལྟ་བུར་བརྩིས་པའི་ལྷའི་ལོ་སྟོང་ཐུབ་བོ་༎ དེ་མིའི་ལྟར་བརྩིས་ན་ལོ་བྱེ་བ་ཕྲག་གསུམ་དང་། ས་ཡ་ཕྲག་དྲུག་ཡོད་དེ་།
 asty antareṇa kālakriyā|	བར་མ་དོར་འཆི་བ་ནི་ཡོད་དོ་༎
 āps 22| tad bhavati kālasūtre mahānarake ekaṃ rātriṃdivasaṃ,	དེ་ནི་སེམས་ཅན་དམྱལ་བ་ཆེན་པོ་ཐིག་ནག་གི་ཉིན་ཞག་གཅིག་གོ་།
 tena rātriṃdivasena triṃśad rātrakeṇa māsena, (gbm 1703|6)	ཉིན་ཞག་དེ་སུམ་ཅུ་ལ་ཟླ་བ་གཅིག་གོ་།
 dvādaśa māsakena saṃvatsareṇa,	ཟླ་བ་བཅུ་གཉིས་ལ་ལོ་གཅིག་སྟེ་།
 tayā saṃvatsaragaṇanayā varṣasahasraṃ kālasūtre mahānarake nārakāṇāṃ satvānām āyuṣaḥ pramāṇaṃ| tad bhavati mānuṣikayā (gbm 1703|7)	སེམས་ཅན་དམྱལ་བ་ཆེན་པོ་ཐིག་ནག་གི་ཚེའི་ཚད་ནི་ལོ་དེ་ལྟ་བུར་བརྩིས་པའི་ལོ་སྟོང་ཐུབ་བོ་༎ 
 gaṇanayā dvādaśa varṣakoṭīśatasahasrāṇi ṣaṇnavatiś ca varṣakoṭīsahasrāṇy āyuṣaḥ pramāṇam,	དེ་མིའི་ལྟར་བརྩིས་ན་ལོ་བྱེ་བ་ཕྲག་ས་ཡ་ཉིས་འབུམ་དགུ་ཁྲི་དྲུག་སྟོང་རྩ་བཅུ་གཉིས་ཡོད་དེ་།
 asty antareṇa kālakriyā|	དུས་མ་ཡིན་པར་འཆི་བ་ནི་ཡོད་དོ་༎
 āps 23| atha bhagavāṃs tasyāṃ velāyāṃ (gbm 1694|1) gāthe bhāṣate|	དེ་ནས་བཅོམ་ལྡན་འདས་ཀྱིས་དེའི་ཚེ་ཚིགས་སུ་བཅད་དེ་བཀའ་སྩལ་པ་།
 mātāpitṛṣu ye drugdhā buddheṣu śrāvakeṣu ca |	ཕ་མ་དག་དང་སངས་རྒྱས་དང་༎ ཉན་༄༢༡༨བ་ཐོས་རྣམས་ལ་འཁུ་བྱེད་པ་༎
 kālasūtropapannās te duḥkhā vindanti vedanā || 31 adhura X ^ _ _ X puruṣā mitrabhedakāḥ | kālasūtraṃ prapannās (gbm 1694|2) te X cakā nyatikā mṛṣāḥ |	དེ་དག་ཐིག་ནག་སྐྱེ་འགྱུར་ཏེ་༎ སྡུག་བསྔལ་ཚོར་བ་མྱོང་བར་འགྱུར་༎ གང་ཞིག་མི་བརྩོན་འཇོག་པ་དང་༎ མི་རྣམས་མཛའ་བའི་དབྱེན་བྱེད་པ་༎ ཐིག་ནག་ཏུ་ནི་སྐྱེ་བར་འགྱུར་༎ བརྫུན་སྨྲ་བ་ཡང་དེ་བཞིན་ཏེ་༎ ལས་དེ་ཡིས་ནི་ཐིག་ནག་གི་།
 kālasūtraṃ prapannās te narakaṃ tena karmaṇā || 32	དམྱལ་བ་རྣམས་སུ་དེ་དག་སྐྱེ་༎
 āps 24| yad bhikṣavo manuṣyāṇāṃ dve varṣaśate tad yamānāṃ devāṇām ekaṃ rātriṃdivasaṃ, tena rātriṃdivasena (gbm 1694|3)	དགེ་སློང་དག་། མི་རྣམས་ཀྱི་ལོ་ཉིས་བརྒྱ་གང་ཡིན་པ་དེ་ནི་འཐབ་བྲལ་གྱི་ལྷ་རྣམས་ཀྱི་ཉིན་ཞག་གཅིག་གོ་། 
 triṃśad rātrakeṇa māsena,	ཉིན་ཞག་དེ་སུམ་ཅུ་ལ་ཟླ་བ་གཅིག་།
 dvādaśa māsakena saṃvatsareṇa,	ཟླ་བ་བཅུ་གཉིས་ལ་ལོ་གཅིག་སྟེ་།
 tayā saṃvatsaragaṇanayā divye dve varṣasahasre yamānāṃ devānām āyuṣaḥ pramāṇaṃ| tad bhavati mānuṣikayā (gbm 1694|4)	འཐབ་བྲལ་བའི་ལྷ་རྣམས་ཀྱི་ཚེའི་ཚད་ནི་ལོ་དེ་ལྟ་བུར་བརྩིས་པའི་ལྷའི་ལོ་ཉིས་སྟོང་ཐུབ་བོ་༎ 
 gaṇanayā caturdaśa varṣakoṭyaḥ catvāriṃśac ca varṣaśatasahasrāṇy āyuṣaḥ pramāṇam,	དེ་མིའི་ལྟང་བརྩིས་ན་ལོ་བྱེ་བ་ཕྲག་བཅུ་བཞི་དང་། ལོ་ཁྲི་བཞི་སྟོང་ཡོད་དེ་།
 asty antareṇa kālakriyā|	བར་མ་དོར་འཆི་བ་ནི་ཡོད་དོ་༎
 āps 25| tad bhavati saṃghāte mahānarake ekaṃ rātriṃdivasaṃ, (gbm 1694|5)	དེ་ནི་སེམས་ཅན་དམྱལ་བ་ཆེན་པོ་བསྡུས་འཇོམས་ཀྱི་ཉིན་ཞག་གཅིག་གོ་།
 tena rātriṃdivasena triṃśad rātrakeṇa māsena,	ཉིན་ཞག་དེ་སུམ་ཅུ་ལ་ཟླ་བ་གཅིག་།
 dvādaśa māsakena saṃvatsareṇa,	ཟླ་བ་བཅུ་གཉིས་ལ་ལོ་གཅིག་སྟེ་།
 tayā saṃvatsaragaṇanayā dve varṣasahasre saṃghāte mahānarake nārakāṇāṃ (gbm 1694|6)	སེམས་ཅན་དམྱལ་བ་ཆེན་པོ་བསྡུས་འཇོམས་ཀྱི་སེམས་ཅན་དམྱལ་བ་རྣམས་ཀྱི་ཚེའི་ཚད་ནི་ལོ་དེ་ལྟ་བུར་བརྩིས་པའི་ལོ་ཉིས་སྟོང་ཡོད་དེ་།
 satvānām āyuṣaḥ pramāṇaṃ| tad bhavati mānuṣikayā gaṇanayā ekavarṣakoṭīṇāṃ koṭiḥ triṇī ca varṣakoṭīśatasahasrāṇi aṣṭāṣaṣṭīṇi ca varṣakoṭīsahasrāṇy āyuṣaḥ (gbm 1694|7) pramāṇam, asty antareṇa kālakriyā|	དེ་མིའི་ལྟར་བརྩིས་ན་ལོ་བྱེ་བ་ཕྲག་སུམ་འབུམ་དྲུག་ཁྲི་བརྒྱད་སྟོང་རྩ་གཅིག་ཡོད་དེ་། བར་མ་དོར་འཆི་བ་ནི་ཡོད་དོ་༎
 āps 26| atha bhagavāṃs tasyāṃ velāyāṃ gāthe bhāṣate|	དེ་ནས་བཅོམ་ལྡན་འདས་ཀྱིས་དེའི་ཚེ་ཚིགས་སུ་བཅད་དེ་བཀའ་སྩལ་པ་། མི་དགེའི་ལས་རྣམ་གསུམ་བྱས་ཤིང་༎
 trividham akuśalaṃ kṛtvā akṛta X ^ X ^ X |	ལས་དགེ་རྣམ་གསུམ་མ་བྱས་ཏེ་༎ ལས་དེ་དག་གིས་བསྡུས་འཇོམས་ཀྱི་༎
 saṃghāta upapadyante narake tena karmaṇā || 33	དམྱལ་བ་དག་ཏུ་སྐྱེ་༄༢༡༩ཨ་༌༎ བར་འགྱུར་༎
 (gbm 1695|1) balākān ajamahiṣān mṛgān kukuṭasūkarān | tathānyān prāṇino hatvā saṃghāte upapadyate || 34	བ་ལང་ར་ལུག་མ་ཧེ་དང་༎ རི་དབ༹གས་བྱ་གག་ཕག་རྣམས་དང་༎ དེ་བཞིན་སྲོག་ཆགས་གཞན་གསོད་པ་༎ བསྡུས་གཞོམ་དག་ཏུ་སྐྱེ་བར་འགྱུར་༎ དགེ་སློང་དག་།
 āps 27| yāni bhikṣavo manuṣyāṇāṃ catvāri varṣaśatāni tāni tuṣitānāṃ devānām ekaṃ rātriṃdivasaṃ (gbm 1695|2) rātriṃdivasena triṃśad rātrakeṇa māsena,	མི་རྣམས་ཀྱི་ལོ་བཞི་བརྒྱ་གང་ཡིན་པ་དེ་དགའ་ལྡན་གྱི་ལྷ་རྣམས་ཀྱི་ཉིན་ཞག་གཅིག་གོ་། ཉིན་ཞག་དེ་སུམ་ཅུ་ལ་ཟླ་བ་གཅིག་།
 dvādaśa māsakena saṃvatsareṇa,	ཟླ་བ་བཅུ་གཉིས་ལ་ལོ་གཅིག་སྟེ་།
 tayā saṃvatsaragaṇanayā divyāni catvāri varṣasahasrāṇi tuṣitānāṃ devānām āyuṣaḥ (gbm 1695|3)	དགའ་ལྡན་གྱི་ལྷ་རྣམས་ཀྱི་ཚེའི་ཚད་ནི་ལོ་དེ་ལྟ་བུར་བརྩིས་པའི་ལྷའི་ལོ་བཞི་སྟོང་ཐུབ་སྟེ་། 
 pramāṇaṃ| tad bhavati mānuṣikayā gaṇanayā saptapaṃcāśad varṣakoṭyaḥ ṣaṣṭiś ca varṣaśatasahasrāṇy āyuṣaḥ pramāṇam,	དེ་མིའི་ལྟར་བརྩིས་ན་ལོ་བྱེ་བ་ཕྲག་ལྔ་བཅུ་རྩ་བདུན་དང་། ལོ་ས་ཡ་ཕྲག་དྲུག་ཡོད་དེ་།
 asty antareṇa kālakriyā| āps 28| tad bhavati raurave mahānarake (gbm 1695|4) ekaṃ rātriṃdivasaṃ,	བར་མ་དོར་འཆི་བ་ནི་ཡོད་དོ་༎ དེ་ནི་སེམས་ཅན་དམྱལ་བ་ཆེན་པོ་དུ་འབོད་ཀྱི་ཉིན་ཞག་གཅིག་གོ་།
 tena rātriṃdivasena triṃśad rātrakeṇa māsena,	ཉིན་ཞག་དེ་སུམ་ཅུ་ལ་ཟླ་བ་གཅིག་།
 dvādaśa māsakena saṃvatsareṇa, tayā saṃvatsaragaṇanayā catvāri varṣasahasrāṇi raurave (gbm 1695|5)	ཟླ་བ་བཅུ་གཉིས་ལ་ལོ་གཅིག་སྟེ་།
 mahānarake nārakāṇāṃ satvānām āyuṣaḥ pramāṇaṃ| tad bhavati mānuṣikayā gaṇanayā aṣṭau varṣakoṭīnayutāny ekonatriṃśac ca varṣakoṭīśatasahasrāṇi (gbm 1695|6)	སེམས་ཅན་དམྱལ་བ་ཆེན་པོ་དུ་འབོད་ཀྱི་སེམས་ཅན་དམྱལ་བ་རྣམས་ཀྱི་ཚེའི་ཚད་ནི་ལོ་དེ་ལྟ་བུར་བརྩིས་པའི་ལོ་བཞི་སྟོང་ཐུབ་སྟེ་།
 catuścatvāriṃśac ca varṣakoṭīsahasrāṇy āyuṣaḥ pramāṇam,	དེ་མིའི་ལྟར་བརྩིས་ན་ལོ་བྱེ་བ་ཕྲག་ས་ཡ་གཉིས་དང་། བྱེ་བ་ཕྲག་དགུ་འབུམ་བཞི་ཁྲི་བཞི་སྟོང་དང་། བྱེ་བ་ཕྲག་བརྒྱད་ཡོད་དེ་།
 asty antareṇa kālakriyā|	བར་མ་དོར་འཆི་བ་ནི་ཡོད་དོ་༎
 āps 29| atha bhagavāṃs tasyāṃ velāyāṃ gāthe bhāṣate| X |i X |ini _ porā raudrā rudhirapāṇayaḥ |	དེ་ནས་བཅོམ་ལྡན་འདས་ཀྱིས་དེའི་ཚེ་ཚིགས་སུ་བཅད་དེ་བཀའ་སྩལ་པ་། འཇིགས་སུ་རུང་ལ་དྲག་ཤུལ་ཅན་༎ ལག་པ་གཉིས་ནི་ཁྲག་གིས་བསྐུས་༎
 pāpakarmasamācārā (gbm 1695|7) jāyante raurave sadā || 35 vināśayitvā janatāṃ dahyante raurave ciran* | na datto bhairavaṃ nādaṃ tūṭakā vaṭikā narāḥ || 36 āps 30| yāni bhikṣavo manuṣyāṇām aṣṭau (gbm 1696|1)	སྡིག་པའི་ལས་ནི་སྤྱོད་པ་ཡིས་༎ རྟག་ཏུ་དུ་འབོད་འགྲོ་བར་འགྱུར་༎ གཞལ་ལུགས་ག-ཡོ་དང་སྒྱུ་བྱེད་མི་༎ སྐྱེ་བོ་༄༢༡༩བ་དག་ནི་ཡིད་ཕྱུང་བས་༎ འཇིགས་སུ་རུང་བའི་སྒྲ་འབྱིན་ཅིང་༎ ཡུན་རིང་དུ་ནི་སྲེག་འབོད་འགྱུར་༎ དགེ་སློང་དག་།
 varṣaśatāni tāni nirmāṇaratīnāṃ devānām ekaṃ rātriṃdivasaṃ,	མི་རྣམས་ཀྱི་ལོ་བརྒྱད་བརྒྱ་གང་ཡིན་པ་དེ་འཕྲུལ་དགའི་ལྷ་རྣམས་ཀྱི་ཉིན་ཞག་གཅིག་གོ་།
 tena rātriṃdivasena triṃśad rātrakeṇa māsena,	ཉིན་ཞག་དེ་སུམ་ཅུ་ལ་ཟླ་བ་གཅིག་།
 dvādaśa māsakena saṃvatsareṇa, tayā saṃvatsaragaṇanayā divyāni aṣṭau varṣasahasrāṇi (gbm 1696|2)	ཟླ་བ་བཅུ་གཉིས་ལ་ལོ་གཅིག་སྟེ་།
 nirmāṇaratīnāṃ devānām āyuṣaḥ pramāṇaṃ| tad bhavati mānuṣikayā gaṇanayā triṃśad uttare dve varṣakoṭiśate catvāriṃśac ca varṣaśatasahasrāṇy āyuṣaḥ pramāṇam, (gbm 1696|3)	འཕྲུལ་དགའི་ལྷ་རྣམས་ཀྱི་ཚེ་ཚད་ནི་ལོ་དེ་ལྟ་བུར་བརྩིས་པའི་ལོ་བརྒྱད་སྟོང་ཐུབ་སྟེ་། དེ་མིའི་ལྟར་བརྩིས་ན་ལོ་བྱེ་བ་ཕྲག་ཉིས་བརྒྱ་སུམ་ཅུ་དང་། ལོ་ས་ཡ་ཕྲག་བཞི་ཡོད་དེ་།
 asty antareṇa kālakriyā|	བར་མ་དོར་འཆི་བ་ནི་ཡོད་དོ་༎
 āps 31| tad bhavati mahāraurave mahānarake ekaṃ rātriṃdivasaṃ,	དེ་ནི་སེམས་ཅན་དམྱལ་བ་ཆེན་པོ་དུ་འབོད་ཆེན་པོའི་ཉིན་ཞག་གཅིག་གོ་།
 tena rātriṃdivasena triṃśad rātrakeṇa māsena,	ཉིན་ཞག་དེ་སུམ་ཅུ་ལ་ཟླ་བ་གཅིག་།
 dvādaśa māsakena saṃvatsareṇa, tayā (gbm 1696|4)	ཟླ་བ་བཅུ་གཉིས་ལ་ལོ་གཅིག་སྟེ་།
 saṃvatsaragaṇanayā aṣṭau varṣasahasrāṇi mahāraurave mahānarake nārakāṇāṃ satvānām āyuṣaḥ pramāṇaṃ| tad bhavati mānuṣikayā gaṇanayā ṣaṭṣaṣṭi varṣakoṭīkoṭyaḥ (gbm 1696|5) paṃcatriṃśac ca varṣakoṭīśatasahasrāṇi dvāpaṃcāśac ca varṣakoṭīsahasrāṇy āyuṣaḥ pramāṇam, asty antareṇa kālakriyā|	སེམས་ཅན་དམྱལ་བ་ཆེན་པོ་དུ་འབོད་ཆེན་པོའི་སེམས་ཅན་དམྱལ་བ་རྣམས་ཀྱི་ཚེའི་ཚད་ནི་ལོ་དེ་ལྟ་བུར་བརྩིས་པའི་ལོ་བརྒྱད་སྟོང་ཡོད་དོ་༎ དེ་མིའི་ལྟར་བརྩིས་ན་ལོ་བྱེ་བ་ཕྲག་ས་ཡ་གསུམ་དང་། བྱེ་བ་ཕྲག་ལྔ་འབུམ་ཁྲི་ཉིས་སྟོང་དྲུག་ཅུ་རྩ་དྲུག་ཡོད་དེ་།
 āps 32| atha bhagavāṃs tasyāṃ velāyāṃ gāthā bhāṣate|	བར་མ་དོར་འཆི་བ་ནི་ཡོད་དོ་༎ དེ་ནས་བཅོམ་ལྡན་འདས་ཀྱིས་དེའི་ཚེ་ཚིགས་སུ་བཅད་དེ་བཀའ་སྩལ་པ་། ལྟ་བའི་ཐིབས་པོས་ཁེབས་གྱུར་ཅིང་༎
 dṛṣṭīgahanasaṃcchannā tṛṣṇācchandanacchāditā |	སྲེད་པའི་ག-ཡོག་པས་ག-ཡོགས་པ་དག་།
 pāpadharmasamācārā mahārauravagāmina || 37 mahārauravam āsādya jvalanaṃ romaharṣaṇaṃ | dahyante nta (gbm 1696|7)	སྡིག་པའི་ཆོས་ནི་སྤྱོད་པ་ཡིས༏་༏དུ་འབོད་དག་ཏུ་སྐྱེ་བར་འགྱུར་༎
 ^ _ ruddhā narā viśvāsaghātakā || 38	ཡིད་གཅུགས་ཉམས་པའི་མི་དག་ནི་། ཁ་སྤུ་སློང་ཞིང་འབར་བ་ཡིས་༎ བསྐོར་བའི་ཁྱིམ་གྱི་ནང་ཆུང་ནས་༎ དུ་འབོད་ཆེན་པོ་སྲེག་པར་འགྱུར་༎ ༄༢༢༠ཨ་༌༎ གཏམ་པ་བརྣོགས་པའི་མི་དག་ནི་༎
 saṃcchinnagātrā asibhir gṛddhrakākolūkakukurair | viceṣṭhyamānā khādyante X X X X ^ _ ^ X || 39	རལ་གྲི་ཡིས་ནི་ལུས་གཏུབ་ཅིང་༎ བྱ་རྒོད་བྱ་རོག་འུག་པ་ཁྱིས་༎ འགུལ་བཞིན་དུ་ནི་ཟ་བར་འགྱུར་༎ དགེ་སློང་དག་།
 āps 33| yāni bhikṣavo manuṣyāṇāṃ ṣoḍaśa (gbm 1697|1) varṣaśatāni tat paranirmitavaśavartināṃ devānām ekaṃ rātriṃdivasaṃ,	མི་རྣམས་ཀྱི་ལོ་སྟོང་དྲུག་བརྒྱ་གང་ཡིན་པ་དེ་གཞན་འཕྲུལ་དབང་བྱེད་ཀྱི་ལྷ་རྣམས་ཀྱི་ཉིན་ཞག་གཅིག་གོ་། 
 tena rātriṃdivasena triṃśad rātrakeṇa māsena,	ཉིན་ཞག་དེ་སུམ་ཅུ་ལ་ཟླ་བ་གཅིག་།
 dvādaśa māsakena saṃvatsareṇa, tayā saṃvatsaragaṇanayā (gbm 1697|2) ṣoḍaśa varṣasahasrāṇi)	ཟླ་བ་བཅུ་གཉིས་ལ་ལོ་གཅིག་སྟེ་།
 paranirmitavaśavartināṃ devānām āyuṣaḥ pramāṇaṃ| tad bhavati mānuṣikayā gaṇanayā ekaviṃśati varṣakoṭi nava ca varṣakoṭiśatāni ṣaṣtiś ca varṣaśatasahasrāṇy (gbm 1697|3) āyuṣaḥ pramāṇam,	གཞན་འཕྲུལ་དབང་བྱེད་ཀྱི་ལྷ་རྣམས་ཀྱི་ཚེའི་ཚད་ནི་ལོ་དེ་ལྟ་བུར་བརྩིས་པའི་ལྷའི་ལོ་ཁྲི་དྲུག་སྟོང་ཐུབ་བོ་༎ དེ་མིའི་ལྟར་བརྩིས་ན་ལོ་ས་ཡ་ཕྲག་དྲུག་དང་། ལོ་བྱེ་བ་ཕྲག་དགུ་བརྒྱ་ཉི་ཤུ་རྩ་གཅིག་ཡོད་དེ་།
 asty antareṇa kālakriyā|	བར་མ་དོར་འཆི་བ་ནི་ཡོད་དོ་༎
 āps 34| tad bhavati tapane mahānarake ekaṃ rātriṃdivasaṃ,	དེ་ནི་སེམས་ཅན་དམྱལ་བ་ཆེན་པོ་ཚ་བའི་ཉིན་ཞག་གཅིག་གོ་།
 tena rātriṃdivasena triṃśad rātrakeṇa māsena,	ཉིན་ཞག་དེ་སུམ་ཅུ་ལ་ཟླ་བ་གཅིག་།
 dvādaśa māsakena (gbm 1697|4) saṃvatsareṇa,	ཟླ་བ་བཅུ་གཉིས་ལ་ལོ་གཅིག་སྟེ་།
 tayā saṃvatsaragaṇanayā ṣaḍaśa varṣasahasrāṇi tapane mahānarake nārakāṇāṃ satvānām āyuṣaḥ pramāṇaṃ| tad bhavati mānuṣikayā (gbm 1697|5)	སེམས་ཅན་དམྱལ་བ་ཆེན་པོ་ཚ་བའི་སེམས་ཅན་དམྱལ་བ་རྣམས་ཀྱི་ཚེའི་ཚད་ནི་ལོ་དེ་ལྟ་བུར་བརྩིས་པའི་ལོ་ཁྲི་དྲུག་སྟོང་ཡོད་དོ་༎
 gaṇanayā paṃca varṣakoṭīkoṭiśatāni triṃśac ca varṣakoṭikoṭyaś caturaśītiś ca varṣakoṭīśatasahasrāṇi ṣoḍaśa ca varṣakoṭīsahasrāṇy āyuṣaḥ pramāṇam, (gbm 1697|6) asty antareṇa kālakriyā|	དེ་མིའི་ལྟར་བརྩིས་ན་ལོ་བྱེ་བ་ས་ཡ་ཕྲག་བརྒྱད་དང་། བཞི་འབུམ་དང་། ལོ་བྱེ་བ་ཁྲག་ཁྲི་དྲུག་སྟོང་ལྔ་བརྒྱ་སུམ་ཅུ་ཡོད་དེ་།
 āps 35| atha bhagavāṃs tasyāṃ velāyāṃ gāthe bhāṣate|	བར་མ་དོར་འཆི་བ་ནི་ཡོད་དོ་༎ དེ་ནས་བཅོམ་ལྡན་འདས་ཀྱིས་དེའི་ཚེ་ཚིགས་སུ་བཅད་དེ་བཀའ་སྩལ་པ་།
 śramaṇān brāhmaṇān sādhūn mātaraṃ pitaraṃ tathā | santāpayati yo śiṣṭais tapane sa prapadyate || 40	དགེ་སློང་བྲམ་ཟེ་དགེ་བ་དང་༎ དེ་བཞིན་དུ་ནི་ཕ་མ་ལ་༎ གང་ཞིག་རྟག་ཏུ་གདུང་བྱེད་པ་༎ དེ་ནི་ཚ་བར་སྐྱེ་བར་འགྱུར་༎ འདིར་ནི་གང་ཞིག་གདུང་བ་ཡིས་༎
 (gbm 1697|7) X X X yāni kṛtveha tāpayitvā bahujanān* |	༄༢༢༠བ་སྐྱེ་བོ་མང་པོ་གདུང་བྱེད་པ་༎ ལས་དེ་དག་གིས་ཚ་བ་ཡི་༎
 tapane upapadyante narake tena karmaṇā || 41	དམྱལ་བ་རྣམས་སུ་སྐྱེ་བར་འགྱུར་༎
 āps 36| icchatha yūyaṃ bhikṣavaḥ arbudopapannānāṃ satvānām āyuḥparyantaṃ śrotuṃ| etasya (gbm 1698|1)	དགེ་སློང་དག་། ཁྱེད་ཆུ་བུར་ཅན་དུ་སྐྱེས་པའི་སེམས་ཅན་རྣམས་ཀྱི་ཚེའི་མཐའ་ཉན་པར་འདོད་དམ་། བཅོམ་ལྡན་འདས་། དེའི་དུས་ལ་བབ་ལགས་སོ་༎
 bhagavan kāla, etasya sugata samayo,	བདེ་བར་གཤེགས་པ་། དེའི་དུས་ལ་བབ་ལགས་སོ་༎
 yad bhagavān bhikṣūṇāṃ arbudopapannānāṃ satvānām āyuḥparyantaṃ deśayed| bhagavataḥ śrutvā bhikṣavo dhārayiṣyanti| tena hi bhikṣavaḥ śṛṇuvantu (gbm 1698|2)	བཅོམ་ལྡན་འདས་ལས་དགེ་སློང་དག་གིས་གང་ཆུ་བུར་ཅན་དུ་སྐྱེས་པའི་སེམས་ཅན་རྣམས་ཀྱི་ཚེའི་མཐའ་བསྟན་པ་ཐོས་ནས་། དགེ་སློང་དག་། འཛིན་པར་བགྱིད་ལགས་སོ་༎ དགེ་སློང་དག་།
 sādhu ca suṣṭhu ca manasikuruta bhāṣiṣye| āps 37| tadyathā bhikṣavaḥ iha syād viṃśatikhārīkaḥ kosalakas tilavāhaḥ pūrṇas tilānāṃ sacūḍikābaddhaḥ| tataḥ kaścid eva puruṣo (gbm 1698|3)	དེའི་ཕྱིར་ལེགས་པར་རབ་ཏུ་ཉོན་ལ་ཡིད་ལ་ཟུངས་ཤིག་དང་བཤད་དོ་༎ དགེ་སློང་དག་། འདི་ལྟ་སྟེ་།
 varṣaśatasya varṣaśatasyātyayād ekaikaṃ tilam apanayet*| kṣiprataraṃ khalu bhikṣavaḥ saviṃśatikhārīkaḥ kosalakas tilavāhaḥ anenopakrameṇa parikṣayaṃ (gbm 1698|4) paryādānaṃ gacchen,	འདི་ལ་ཏིལ་ཡུལ་ཀོ་ས་ལའི་ཁལ་བཅུ་ཚད་ཉི་ཤུ་ཤོང་བའི་ཁལ་བཅུ་ཚད་ཉི་ཤུ་པ་ཏིལ་གྱིས་བྱུར་བུར་གང་བར་གྱུར་པ་དེ་ལས་མི་ལ་ལ་ཞིག་གིས་ལོ་བརྒྱ་འདས་ཤིང་ཏིལ་འབྲུ་གཅིག་བོར་ཏེ་། ཏིལ་ཁལ་བཅུ་ཚད་ཉི་ཤུ་ཤོང་བའི་ཁལ་བཅུ་ཚད་ཉི་ཤུ་པ་དེ་ཐབས་འདིས་མྱུར་དུ་ཡོངས་སུ་ཟད་ཅིང་གཏུགས་པར་གྱུར་ཀྱང་། དགེ་སློང་དག་།
 na tv evāhaṃ arbudopapannānāṃ satvānām āyuḥparyantaṃ vadāmi|	ཆུ་བུར་ཅན་དུ་སྐྱེས་པའི་སེམས་ཅན་རྣམས་ཀྱི་ཚེའི་ཚད་ནི་དེ་ལྟ་མ་ཡིན་པར་ང་སྨྲའོ་༎ ཆུ་བུར་ཅན་གྱི་ཉི་ཤུ་ཇི་ལྟ་བ་དེ་ལྟར་ཆུ་བུར་རྡོལ་གྱི་གཅིག་ཡིན་ནོ་༎
 āps 38| yathā viṃśatir arbudāny evam ekaṃ nirarbudaṃ| yathā viṃśatir nirarbudāny (gbm 1698|5)	ཆུ་བུར་རྡོལ་གྱི་ཉི་ཤུ་ཇི་ལྟ་བ་དེ་ལྟར་སོ་ཐམས་ཐམས་ཀྱི་གཅིག་ཡིན་ནོ་༎
 evam ekam aṭaṭaṃ| yathā viṃśatir aṭaṭāny evam ekaṃ hahavaṃ| yathā viṃśatir hahavāny evam ekaṃ huhuvaṃ| yathā viṃśatir huhuvāny evam ekam utpalaṃ| (gbm 1698|6)	སོ་ཐམས་ཐམས་ཀྱི་ཉི་ཤུ་ཇི་ལྟ་བ་དེ་ལྟར་ཀྱི་ཧུད་ཟེར་གྱི་གཅིག་ཡིན་ནོ་༎ ཀྱི་ཧུད་ཟེར་གྱི་ཉི་ཤུ་ཇི་ལྟ་བ་དེ་ལྟར་ཨཨ་ཆུ་ཟེར་༄༢༢༡ཨ་༌༎ གྱི་གཅིག་ཡིན་ནོ་༎ ཨཨ་ཆུ་ཟེར་གྱི་ཉི་ཤུ་ཇི་ལྟ་བ་དེ་ལྟར་ཨཽཏཔ་ལ་ལྟར་གས་པའི་གཅིག་ཡིན་ནོ་༎
 yathā viṃśatir utpalāny evam ekaṃ padmaṃ| yathā viṃśatiḥ padmāny evam ekaṃ mahāpadmaṃ,	ཨཽཏཔ་ལ་ལྟར་གས་པའི་ཉི་ཤུ་ཇི་ལྟ་བ་དེ་ལྟར་པདམ་ལྟར་གས་པའི་གཅིག་ཡིན་ནོ་༎
 yatra kokāliko bhikṣavo devadattapakṣaḥ śāriputramaudgalyāyanayor bhikṣor (gbm 1698|7) antike cittaṃ pradūṣya svaśarīreṇaiva mahāpadme mahānarake upapannaḥ|	པདམ་ལྟར་གས་པའི་ཉི་ཤུ་ཇི་ལྟ་བ་དེ་ལྟར་པདམ་ལྟར་གས་པ་ཆེན་པོའི་གཅིག་ཡིན་ནོ་༎ ལྷས་བྱིན་གྱི་ཕྱོགས་དགེ་སློང་ཀོ་ཀ་ལི་ཀས་དགེ་སློང་ཤའ་རིའི་བུ་དང་། མོཨོངགལ་གྱི་བུ་ལ་ཞེ་སྡང་གི་སེམས་བསྐྱེད་པས་རང་གི་ལུས་དེ་ཉིད་ཀྱིས་སེམས་ཅན་དམྱལ་བ་ཆེན་པོ་པདམ་ལྟར་གས་པ་ཆེན་པོར་སྐྱེས་སོ་༎ དགེ་སློང་དག་། དེ་ལྟ་བས་ན་དེའི་ཕྱིར་འདི་ལྟར་བསླབ་པར་བྱ་སྟེ་།
 āps 39| tasmāt tarhi bhikṣava evaṃ śikṣitavya + + + + + + + + pi cittam apradūṣayi (gbm 1699|1) + + ḥ prāg eva savijñānake + + ity evaṃ vo bhikṣavo śikṣitavyaṃ|	སྡོང་དུམ་ཚིག་པ་ལའང་ཞེ་སྡང་གི་སེམས་བསྐྱེད་པར་མི་བྱ་ན་རྣམ་པར་ཤེས་པ་དང་ལྡན་པའི་ལུས་ལ་ལྟ་སྨོས་ཀྱང་ཅི་དགོས་པ་དེ་ལྟར་དགེ་སློང་དག་ཁྱེད་ཀྱིས་བསླབ་པར་བྱའོ་༎
 āps 40| atha bhagavāṃs tasyāṃ velāyāṃ gāthā bhāṣate||| zu 42-46 cf| uv 7|2-6, suvarṇavarṇāvadāna, patnadhp 300-303, sn 127|1-15, sn i 149|17-31 etc| puruṣasya hi jātasya kuṭḥārī jāyate mukhe | cchinatti hi yayātmānaṃ (gbm 1699|2)	དེ་ནས་བཅོམ་ལྡན་འདས་ཀྱིས་དེའི་ཚེ་ཚིགས་སུ་བཅད་དེ་བཀའ་སྩལ་པ་། མི་ཞིག་སྐྱེས་པར་གྱུར་པ་ན་༎ གང་གིས་བདག་ནི་གཅོད་བྱེད་པའི་༎ ཁ་ནས་སྟ་རེའི་ཚིག་འབྱུང་བ་༎
 vācā durbhāṣitaṃ vadan* || 42 yo nindyajanaṃ praśaṃsati praśaṃsyaṃ ca janaṃ vinindati | sa cinoti mukhena taṃ kaliṃ kalinā yena sukhaṃ na vindati || 43	ཉེས་པར་སྨྲ་བས་སྨྲ་བ་ནི་༎ གང་དག་སྨད་བྱ་བསྟོད་བྱེད་ཅིང་༎ སྐྱེ་བོ་བསྟོད་བྱ་སྨོད་བྱེད་པའི་༎ སྡིག་གང་བདེ་བ་མི་མྱོང་བའི་༎ སྡིག་དེ་དེ་ཡི་ཁ་ན་གསོག་།
 alpamātro hy ayaṃ kalir ya ihākṣaiḥ svadhanaṃ (gbm 1699|3) parājayet* |	གང་འདིར་རྒྱན་པོས་བདག་ནོར་ཡལ་༎
 ayam atra mahattaraḥ kalir yaḥ sugateṣu manaḥ pradūṣyet* || 44	འདི་ནི་སྡིག་པ་ཆུང་དུ་སྟེ་༎ གང་ཞིག་བདེ་གཤེགས་སྡང་སེམས་བསྐྱེད་༎ འདིར་ནི་སྡིག་པ་དེ་ཆེའོ་༎ ངག་དང་ཡིད་ཀྱིས་ཀྱང་ནི་སྡིག་བྱས་ཤིང་༎ ༄༢༢༡བ་གང་ཞིག་འཕགས་ལ་སྨོད་པ་དམྱལ་འགྲོ་སྟེ་༎
 śataṃ sahasrāṇi nirarbudānāṃ ṣaṭtriṃśataṃ paṃca caivārbudāni | yān āryagarhī narakān upaiti vācaṃ manaś (gbm 1699|4) ca praṇidhāya pāpakaṃ || 45	སྟོང་ཕྲག་བརྒྱར་ནི་ཆུ་བུར་རྡོལ་ནས་སུ་༎ ཆུ་བུར་ཅན་དུ་སུམ་ཅུ་རྩ་དྲུག་གོ་། སྡིག་པའི་སེམས་ཀྱིས་བདེན་པར་མི་སྨྲ་བ་༎
 asatābhivadanti pāpacittā narakān ātmavadhāya vardhayante |	བདག་ཉིད་བརླག་ཅིང་དམྱལ་བར་འཕེན་པར་བྱེད་༎
 anavadyabalas titikṣate tan manaso 'nāvilatām asau prakurvan* || 46 āps 41| pratāpane (gbm 1699|5)	དེ་ཡིད་དྲི་མས་མ་རྙོགས་པར་བྱེད་དེ་༎ ཁ་ན་མ་ཐོ་མེད་པ་དེ་བཟོད་དོ་༎
 khalu bhikṣavo mahānarake ardhakalpa āyuṣaḥ pramāṇam,	དགེ་སློང་དག་། སེམས་ཅན་དམྱལ་བ་ཆེན་པོ་རབ་ཏུ་ཚ་བའི་ཚེའི་ཚད་ནི་བསྐལ་པ་ཕྱེད་གཅིག་ཡིན་ཏེ་།
 asty antareṇa kālakriyā|	བར་མ་དོར་འཆི་བ་ནི་ཡོད་དོ་༎
 āps 42| atha bhagavāṃs tasyāṃ velāyāṃ gāthe bhāṣate| apahāya phalaṃ (gbm 1699|6) _ X śubhaṃ svargopapattaye | aniṣṭaṃ karma kṛtveha utpadyante pratāpane || 47	དེ་ནས་བཅོམ་ལྡན་འདས་ཀྱིས་དེའི་ཚེ་ཚིགས་སུ་བཅད་དེ་བཀའ་སྩལ་པ་། འབྲས་བུ་ཡིད་འོང་མཐོ་རིས་སུ་༎ སྐྱེ་འགྱུར་དགེ་བ་སྤངས་ནས་ནི་༎ འདིར་ནི་མི་སྡུག་ལས་བྱས་པས་༎ རབ་ཏུ་ཚ་བར་སྐྱེ་བར་འགྱུར་༎
 śramaṇān brāhmaṇān sādhūn mātaraṃ pitaraṃ tathā |	དགེ་སྦྱོང་བྲམ་ཟེ་དགེ་བ་དང་༎ ཕ་དང་མ་ཡང་དེ་ཡིན་ཏེ་༎
 hanti yaś ca gurūn anyān pacyate sa pratāpane (gbm 1699|7) || 48	གང་ཡང་བླ་མ་གཞན་གསོད་པ་༎ རབ་ཏུ་ཚ་བར་དེ་འཚེད་དོ་༎
 āps| 43| avīcau khalu bhikṣavo mahānarake kalpa āyuṣaḥ pramāṇam,	དགེ་སློང་དག་། དམྱལ་བ་ཆེན་པོ་མནར་མེད་པའི་ཚེའི་ཚད་ནི་བསྐལ་པ་གཅིག་སྟེ་། བར་མ་དོར་འཆི་བ་ནི་ཡོད་དོ་༎
 asty antareṇa kālakriyā| yatra devadatto mohapuruṣaḥ samagraṃ saṃghaṃ bhitvā tathāgatasyāntike (gbm 1701|1) duṣṭacitto rudhiram utpādayitvā bhikṣuṇīṃ vārhantīṃ ghātayitvā svaśarīreṇaiva avīcau mahānarake upapannaḥ| āps 42| atha bhagavāṃs tasyāṃ velāyāṃ gāthā bhāṣate|	མི་གཏི་མུག་ཅན་ལྷས་བྱིན་གྱིས་དགེ་འདུན་མཐུན་པ་ཕྱེ་བ་དང་། དེ་བཞིན་གཤེགས་པ་ལ་ངན་སེམས་ཀྱིས་ཁྲག་ཕྱུང་བ་དང་། དགེ་སློང་མ་དགྲ་བཅོམ་པ་བསད་པས་རང་གི་ལུས་དེ་ཉིད་ཀྱིས་དམྱལ་བ་ཆེན་པོ་མནར་མེད་པ་དེར་སྐྱེས་སོ༏་༏དེ་ནས་བཅོམ་ལྡན་འདས་ཀྱིས་དེའི་ཚེ་ཚིགས་སུ་བཅད་དེ་བཀའ་སྩལ་པ་།
 yaḥ (gbm 1701|2) śāsanam āryāṇām arhatāṃ dharmajīvināṃ | pratikrośati durmedhā dṛṣṭiṃ niśṛtya pāpikāṃ |	འཕགས་པ་རྣམས་ཀྱིས་བསྟན་པ་ཡི་༎ ཆོས་ཀྱིས་འོས་པར་འཚོ་རྣམས་ལ་༎ སྡིག་པའི་ལྟ་བ་ལ་༄༢༢༢ཨ་༌༎ བརྟེན་ནས་༎ བློ་ངན་གང་ཞིག་སྨོད་བྱེད་པ་༎ ཚེར་ཅན་འོད་མའི་འབྲས་བུ་ལྟར་༎
 phalaṃ kaṇṭakaveṇur vā phalaty ātmavadhāya saḥ || 49 kalyāṇikām eva muñcen na tu muñceta (gbm 1701|3) pāpikāṃ | muktvā kalyāṇikāṃ śreyo muktvā tapati pāpikān* || 50 saced muñcet pratimuñced muñcamāno hi vadhyate |	དེ་ནི་འབྲས་བུ་རླག་པར་བྱེད་༎ དགེ་བར་འགྱུར་བ་བརྗོད་བྱ་སྟེ་༎ སྡིག་པ་ཅན་དག་མི་བརྗོད་དོ་༎ དགེ་བ་སྨྲས་ན་ལེགས་པར་འགྱུར་༎ སྡིག་པ་སྨྲས་ན་སྲེག་འགྱུར་བས་༎ གལ་ཏེ་སྨྲ་ན་དགེ་བ་སྨྲའི་༎ སྡིག་པ་སྨྲས་ན་རླག་པར་འགྱུར་༎
 na tām āryā vimuñcanti bālā muñcanti pāpikān* || 51 adhī (gbm 1701|4) X X ^ kṛtveha karma durgatigāmikaḥ |	བྱིས་པ་རྣམས་ནི་སྡིག་སྨྲ་སྟེ་༎ འཕགས་པ་རྣམས་ནི་མ་ཡིན་ནོ་༎ འདིར་ནི་ངན་འགྲོར་འགྲོ་བ་ཡི་༎ ལས་ནི་ཤས་ཆེར་བྱས་པས་ན་༎ ལས་དེ་དག་གིས་མནར་མེད་པའི་༎
 avīcāv upapadyante narake tena karmaṇā || 52	དམྱལ་བ་དག་ཏུ་སྐྱེ་བར་འགྱུར་༎
 āps 45| brahmakāyikānāṃ bhikṣavo devānām ardhakalpa āyuṣaḥ pramāṇam, (gbm 1701|5)	དགེ་སློང་དག་། ཚངས་རིས་ཀྱི་ལྷ་རྣམས་ཀྱི་ཚེའི་ཚད་ནི་བསྐལ་པ་ཕྱེད་དེ་།
 asty antareṇa kālakriyā|	བར་མ་དོར་འཆི་བ་ནི་ཡོད་དོ་༎
 āps 46| brahmapurohitānāṃ bhikṣavo devānāṃ kalpa āyuṣaḥ pramāṇam,	དགེ་སློང་དག་། ཚངས་པའི་མདུན་ན་འདོན་གྱི་ལྷ་རྣམས་ཀྱི་ཚེའི་ཚད་ནི་བསྐལ་པའི་བཞི་ཆ་གསུམ་ཐུབ་སྟེ་།
 asty antareṇa kālakriyā|	བར་མ་དོར་འཆི་བ་ནི་ཡོད་དོ་༎ དགེ་སློང་དག་།
 āps 47| mahābrahmāṇāṃ bhikṣavo devānām adhyardhakalpa || addhyardhakalpa|| āyuṣaḥ pramāṇam,	ཚངས་ཆེན་གྱི་ལྷ་རྣམས་ཀྱི་ཚེའི་ཚད་ནི་བསྐལ་པ་གཅིག་ཐུབ་སྟེ་།
 asty antareṇa kālakriyā|	བར་མ་དོར་འཆི་བ་ནི་ཡོད་དོ་༎
 āps 48| parīttābhānāṃ bhikṣavo devānāṃ dvau kalpāv āyuṣaḥ pramāṇam| asty antareṇa kālakriyā|	དགེ་སློང་དག་། འོད་ཆུང་གི་ལྷ་རྣམས་ཀྱི་ཚེའི་ཚད་ནི་བསྐལ་པ་གཉིས་ཐུབ་སྟེ་། བར་མ་དོར་འཆི་བ་ནི་ཡོད་དོ་༎ དགེ་སློང་དག་།
 āps 49| apramāṇābhānāṃ bhikṣavo devānāṃ (gbm 1701|7) catvāraḥ kalpā āyuṣaḥ pramāṇam,	ཚད་མེད་འོད་ཀྱི་ལྷ་རྣམས་ཀྱི་ཚེའི་ཚད་ནི་བསྐལ་པ་བཞི་ཐུབ་སྟེ་།
 asty antareṇa kālakriyā|	བར་མ་དོར་འཆི་བ་ནི་ཡོད་དོ་༎
 āps 50| ābhāsvarāṇāṃ bhikṣavo devānām aṣṭau kalpā āyuṣaḥ pramāṇam,	དགེ་སློང་དག་། འོད་གསལ་གྱི་ལྷ་རྣམས་ཀྱི་ཚེའི་ཚད་ནི་བསྐལ་པ་བརྒྱད་ཐུབ་སྟེ་།
 asty antareṇa kālakriyā| āps 51| parīttāśubhānāṃ (gbm 1700|1)	བར་མ་དོར་འཆི་བ་ནི་ཡོད་དོ་༎
 bhikṣavo devānāṃ ṣoḍaśa kalpā āyuṣaḥ pramāṇam,	དགེ་སློང་༄༢༢༢བ་དག་༏དགེ་ཆུང་གི་ལྷ་རྣམས་ཀྱི་ཚེའི་ཚད་ནི་བསྐལ་པ་བཅུ་དྲུག་ཐུབ་སྟེ་།
 asty antareṇa kālakriyā|	བར་མ་དོར་འཆི་བ་ནི་ཡོད་དོ་༎
 āps 52| apraṃāṇaśubhānāṃ bhikṣavo devānāṃ dvātriṃśat kalpā āyuṣaḥ pramāṇam,	དགེ་སློང་དག་། ཚད་མེད་དགེ་བའི་ལྷ་རྣམས་ཀྱི་ཚེའི་ཚད་ནི་བསྐལ་པ་སུམ་ཅུ་རྩ་གཉིས་ཐུབ་སྟེ་།
 asty antareṇa kālakriyā|	བར་མ་དོར་འཆི་བ་ནི་ཡོད་དོ་༎ དགེ་སློང་དག་།
 āps 53| (gbm 1700|2) śubhakṛtsnānāṃ bhikṣavo devānāṃ catuḥṣaṣṭiḥ kalpā āyuṣaḥ pramāṇam,	དགེ་རྒྱས་ཀྱི་ལྷ་རྣམས་ཀྱི་ཚེའི་ཚད་ནི་བསྐལ་པ་དྲུག་ཅུ་རྩ་བཞི་ཐུབ་སྟེ་།
 asty antareṇa kālakriyā|	བར་མ་དོར་འཆི་བ་ནི་ཡོད་དོ་༎
 āps 54| anabhrakāṇāṃ bhikṣavo devānāṃ paṃcaviṃśaty adhikaṃ kalpaśatam āyuṣaḥ pramāṇam, asty (gbm 1700|3) antareṇa kālakriyā|	དགེ་སློང་དག་། སྤྲིན་མེད་ཀྱི་ལྷ་རྣམས་ཀྱི་ཚེའི་ཚད་ནི་བསྐལ་པ་བརྒྱ་ཉི་ཤུ་རྩ་ལྔ་ཐུབ་སྟེ་། བར་མ་དོར་འཆི་བ་ནི་ཡོད་དོ་༎
 āps 55| puṇyaprasavānāṃ bhikṣavo devānām ardhatritīyāni kalpaśatāny āyuṣaḥ pramāṇam,	དགེ་སློང་དག་། བསོད་ནམས་སྐྱེས་ཀྱི་ལྷ་རྣམས་ཀྱི་ཚེའི་ཚད་ནི་བསྐལ་པ་ཉིས་བརྒྱ་རྩ་ལྔ་བཅུ་ཐུབ་སྟེ་།
 asty antareṇa kālakriyā|	བར་མ་དོར་འཆི་བ་ནི་ཡོད་དོ་༎ དགེ་སློང་དག་།
 āps 56| bṛhatphalānāṃ bhikṣavo devānāṃ (gbm 1700|4) paṃca kalpaśatāny āyuṣaḥ pramāṇam,	འབྲས་བུ་ཆེ་བའི་ལྷ་རྣམས་ཀྱི་ཚེའི་ཚད་ནི་བསྐལ་པ་ལྔ་བརྒྱ་ཐུབ་སྟེ་།
 asty antareṇa kālakriyā|	བར་མ་དོར་འཆི་བ་ནི་ཡོད་དོ་༎ དགེ་སློང་དག་།
 āps 57| tathaivāsaṃjñāsatvānāṃ paṃca kalpaśatāny āyuṣaḥ pramāṇam,	འདུ་ཤེས་མེད་པའི་སེམས་ཅན་དང་། མི་ཆེ་བའི་ལྷ་རྣམས་ཀྱི་ཚེའི་ཚད་ནི་བསྐལ་པ་སྟོང་ཐུབ་སྟེ་།
 asty antareṇa kālakriyā| āps 58| abṛhānāṃ (gbm 1700|5)	བར་མ་དོར་འཆི་བ་ནི་ཡོད་དོ་༎ དགེ་སློང་དག་།
 bhikṣavo devānāṃ kalpasahasram āyuṣaḥ pramāṇam,	མི་གདུང་བའི་ལྷ་རྣམས་ཀྱི་ཚེའི་ཚད་ནི་བསྐལ་པ་ཉིས་སྟོང་ཐུབ་སྟེ་།
 asty antareṇa kālakriyā|	བར་མ་དོར་འཆི་བ་ནི་ཡོད་དོ་༎
 āps 59| atapānāṃ bhikṣavo devānāṃ dve kalpasahasre āyuṣaḥ pramāṇam,	དགེ་སློང་དག་། ཤིན་ཏུ་མཐོང་གི་ལྷ་རྣམས་ཀྱི་ཚེའི་ཚད་ནི་བསྐལ་པ་བཞི་སྟོང་ཐུབ་སྟེ་།
 asty antareṇa (gbm 1700|6) kālakriyā|	བར་མ་དོར་འཆི་བ་ནི་ཡོད་དོ་༎
 āps 60| sudṛśānāṃ bhikṣavo devānāṃ catvāri kalpasahasrāṇy āyuṣaḥ pramāṇam,	དགེ་སློང་དག་། གྱ་ནོམ་སྣང་གི་ལྷ་རྣམས་ཀྱི་ཚེའི་ཚད་ནི་བསྐལ་པ་བརྒྱད་སྟོང་ཐུབ་སྟེ་།
 asty antareṇa kālakriyā| āps 61| sudarśanānāṃ bhikṣavo devānām aṣṭau kalpasahasrāṇy āyuṣaḥ (gbm 1700|7) pramāṇam, asty antareṇa kālakriyā|	བར་མ་དོར་འཆི་བ་ནི་ཡོད་དོ་༎
 āps 62| akaniṣṭhānāṃ bhikṣavo devānāṃ ṣoḍaśa kalpasahasrāṇy āyuṣaḥ pramāṇam,	དགེ་སློང་དག་། འོག་མིན་གྱི་ལྷ་རྣམས་ཀྱི་ཚེའི་ཚད་ནི་བསྐལ་པ་ཁྲི་དྲུག་སྟོང་ཐུབ་སྟེ་། བར་མ་དོར་༄༢༢༣ཨ་༌༎
 asty antareṇa kālakriyā|	འཆི་བ་ནི་ཡོད་དོ་༎
 āps 63| ākāśānantyāyatanopagānāṃ bhikṣavo devānāṃ viṃśatiḥ kalpasahasrāṇy āyuṣaḥ pramāṇam,	དགེ་སློང་དག་། ནམ་མཁའ་མཐའ་ཡས་སྐྱེ་མཆེད་དུ་ཉེ་བར་འགྲོ་བའི་ལྷ་རྣམས་ཀྱི་ཚེའི་ཚད་ནི་བསྐལ་པ་ཉི་ཁྲི་སྟེ་། 
 asty antareṇa kālakriyā|	བར་མ་དོར་འཆི་བ་ནི་ཡོད་དོ་༎
 āps 64| vijñānānantyāyatanānāṃ bhikṣavo devānāṃ catvāriṃśat kalpasahasrāṇy āyuṣaḥ pramāṇam,	དགེ་སློང་དག་། རྣམ་ཤེས་མཐའ་ཡས་སྐྱེ་མཆེད་དུ་ཉེ་བར་འགྲོ་བའི་ལྷ་རྣམས་ཀྱི་ཚེའི་ཚད་ནི་བསྐལ་པ་བཞི་ཁྲི་སྟེ་། 
 asty antareṇa kālakriyā|	བར་མ་དོར་འཆི་བ་ནི་ཡོད་དོ་༎
 āps 65| ākiṃcanyāyatanānāṃ bhikṣavo devānāṃ ṣaṣṭiḥ kalpasahasrāṇy āyuṣaḥ pramāṇam,	དགེ་སློང་དག་། ཅི་ཡང་མེད་པའི་སྐྱེ་མཆེད་དུ་ཉེ་བར་འགྲོ་བའི་ལྷ་རྣམས་ཀྱི་ཚེའི་ཚད་ནི་བསྐལ་པ་དྲུག་ཁྲི་སྟེ་། 
 asty antareṇa kālakriyā|	བར་མ་དོར་འཆི་བ་ནི་ཡོད་དོ་༎
 āps 66| naivasaṃjñānāsaṃjñāyatanānāṃ bhikṣavo devānām aśītiḥ kalpasahasrāṇy āyuṣaḥ pramāṇam,	དགེ་སློང་དག་། འདུ་ཤེས་མེད་འདུ་ཤེས་མེད་མིན་སྐྱེ་མཆེད་དུ་ཉེ་བར་འགྲོ་བའི་ལྷ་རྣམས་ཀྱི་ཚེའི་ཚད་ནི་བསྐལ་པ་བརྒྱད་ཁྲི་སྟེ་།
 asty antareṇa kālakriyā|	བར་མ་དོར་འཆི་བ་ནི་ཡོད་དོ་༎ དགེ་སློང་དག་། དེ་ལྟར་དམྱལ་བ་ཆེན་པོ་མནར་མེད་པ་ནས་འདུ་ཤེས་མེད་འདུ་ཤེས་མེད་མིན་སྐྱེ་མཆེད་ཀྱི་བར་དེ་དག་ནི་། དགེ་སློང་དག་། སྲིད་པའི་རྩེ་མོ་དང་། དེ་དག་ནི་སྲིད་པའི་རྩེ་མོ་ཡིན་ནོ་༎ དེ་དག་ནི་སྲིད་པ་འབྱུང་བ་ཡིན་ཏེ་། དེ་དག་ནི་འགྲོ་བ་ལྔའི་སེམས་ཅན་རྣམས་འོང་བ་དང་། འགྲོ་བ་དང་། གནས་པ་དང་། འཆི་བ་དང་། སྐྱེ་བར་སྣང་ངོ་༎ སྲིད་པའི་འབྱུང་བས་ཆོག་ཤེས་པར་གྱིས་ཤིག་། ང་ནི་སྲིད་པ་མངོན་པར་སྒྲུབ་པ་ཆུང་དུ་ལའང་ཐ་ན་དེའི་སྐད་ཅིག་ཙམ་ཡང་བསྔགས་པ་མི་མཛད་དོ་༎ དེ་ཅིའི་ཕྱིར་ཞེ་ན་། སྲིད་པ་མངོན་པར་སྒྲུབ་པ་ནི་སྡུག་བསྔལ་ཡིན་པའི་ཕྱིར་ཏེ་། དཔེར་ན་། མི་གཙང་བ་ནི་ཉུང་དུའང་༄༢༢༣བ་མི་ཞིམ་ན་མང་པོ་ལྟ་ཅི་སྨོས་། དེ་ལྟར་དེ་བཞིན་དུ་ང་ནི་སྲིད་པ་མངོན་པར་སྒྲུབ་པ་ཆུང་དུ་ལའང་ཐ་ན་དེའི་སྐད་ཅིག་ཙམ་ཡང་བསྔགས་པ་མི་མཛད་དོ་༎ དེ་ཅིའི་ཕྱིར་ཞེ་ན་། དགེ་སློང་དག་། སྲིད་པ་མངོན་པར་སྒྲུབ་པ་ནི་སྡུག་བསྔལ་ཡིན་པའི་ཕྱིར་རོ་༎ སོ་སོའི་སྐྱེ་བོ་བྱིས་པ་ཐོས་པ་དང་མི་ལྡན་པ་དེ་དག་ནི་འགྲོ་བ་ལྔ་པོའི་འཁྲོ་བ་གང་དུ་ཡང་དང་། ཡང་དུ་དམྱལ་བ་རྣམས་དང་། ཡང་དང༏་ཡང་དུ་དུད་འགྲོ་རྣམས་དང་། ཡང་དང་། ཡང་དུ་ངན་སོང་ངན་འགྲོ་ལོག་པར་ལྟུང་བ་རྣམས་སུ་ཀུན་ཏུ་རྒྱུག་། ཀུན་ཏུ་རབ་ཏུ་རྒྱུག་གོ་། དགེ་སློང་དག་། དེ་ལྟ་བས་ན་དེའི་ཕྱིར་འདི་ལྟར་བསླབ་པར་བྱ་སྟེ་། སྲིད་པ་རྒྱུན་ཆད་པར་བྱ་བ་གང་ཡིན་པ་ལ་བརྩོན་པར་བྱ་ཞིང་སྲེད་པ་མངོན་པར་མི་བསྒྲུབ་པར་བྱའོ་༎ དགེ་སློང་དག་། ཁྱེད་ཀྱིས་དེ་ལྟར་བསླབ་པར་བྱའོ་༎ བཅོམ་ལྡན་འདས་ཀྱིས་དེ་སྐད་ཅེས་བཀའ་སྩལ་ནས་། དགེ་སློང་དེ་དག་ཡི་རངས་ཏེ་། བཅོམ་ལྡན་འདས་ཀྱིས་གསུངས་པ་ལ་མངོན་པར་བསྟོད་དོ་༎ ཚེའི་མཐའི་མདོ་རྫོགས་སོ་༎༎ རྒྱ་གར་གྱི་མཁན་པོ་བི་ཤུདདྷ་སིདྷ་དང་། ལོཙཚ་བ་བནདེ་དགེ་བའི་དཔལ་གྱིས་བསྒྱུར་།
