skt	tib
 (vaidya 100) śālistambasūtram |	༄༡༨༠ཨ་། །རྒྱ་གར་སྐད་དུ་། ཨའརྱ་ཤའ་ལི་སྟམབྷ་ནའ་མ་མཧའ་ཡའ་ན་སའུ་ཏྲ་། བོད་སྐད་དུ་། འཕགས་པ་སའ་ལུའི་ལྗང་པ་ཞེས་བྱ་བ་ཐེག་པ་ཆེན་པོའི་མདོ་། སངས་རྒྱས་དང་། བྱང་ཆུབ་སེམས་དཔའ་ཐམས་ཅད་ལ་ཕྱག་འཚལ་ལོ་༎
 evaṃ mayā śrutam |	འདི་སྐད་བདག་གིས་ཐོས་པའི་དུས་གཅིག་ན་།
 ekasmin samaye bhagavān rājagṛhe viharati sma gṛdhrakūṭe parvate mahatā bhikṣusaṃghena sārdhamardhatrayodaśabhirbhikṣusahasraiḥ saṃbahulaiśca bodhisattvamahāsattvaiḥ | athāyuṣmān śāriputro yena maitreyasya bodhisattvasya mahāsattvasya caṃkramaḥ, tenopasamakramīt |	བཅོམ་ལྡན་འདས་རྒྱལ་པོའི་ཁབ་བྱ་རྒོད་ཕུང་པོའི་རི་ལ་དགེ་སློང་སྟོང་ཉིས་བརྒྱ་ལྔ་བཅུའི་དགེ་སློང་གི་དགེ་འདུན་ཆེན་པོ་དང་། བྱང་ཆུབ་སེམས་དཔའ་སེམས་དཔའ་ཆེན་པོ་རབ་ཏུ་མང་པོ་དང་ཐབས་གཅིག་ཏུ་བཞུགས་ཏེ་།
 upasaṃkramya anyonyaṃ saṃmodanīyāṃ kathāṃ bahuvidhāṃ vyatisārayitvā ubhau śilātale upāviśatām || athāyuṣmān śāriputro maitreyaṃ bodhisattvaṃ mahāsattvametadavocat - adyātra śālistambamavalokya	དེའི་ཚེ་ན་ཚེ་དང་ལྡན་པ་ཤའ་རིའི་བུ་བྱང་ཆུབ་སེམས་དཔའ་སེམས་དཔའ་ཆེན་པོ་བྱམས་པའི་བགྲོད་པར་བྱ་བའི་ས་ཕྱོགས་ག་ལ་བ་དེར་སོང་སྟེ་ཕྱིན་ནས་ཕན་ཚུན་ཡང་དག་པར་དགའ་བར་བྱ་བའི་གཏམ་རྣམ་པ་མང་པོ་བྱས་ནས་འདུས་ཏེ་༄༡༨༠བ་གཉིས་ཀ་རྡོ་ལེབ་ལ་འཁོད་དོ་༎ དེ་ནས་ཚེ་དང་ལྡན་པ་ཤའ་རིའི་བུས་བྱང་ཆུབ་སེམས་དཔའ་སེམས་དཔའ་ཆེན་པོ་བྱམས་པ་ལ་འདི་སྐད་ཅེས་སྨྲས་སོ་༎ བྱམས་པ་།
 maitreya bhagavatā bhikṣubhyaḥ sūtramidamuktam - yo bhikṣavaḥ pratītyasamutpādaṃ paśyati,	དེང་འདིར་བཅོམ་ལྡན་འདས་ཀྱིས་སའ་ལུའི་ལྗང་པ་ལ་གཟིགས་ནས་དགེ་སློང་རྣམས་ལ་མདོ་འདི་གསུངས་སོ་༎ 
 sa dharmaṃ paśyati |	དགེ་སློང་དག་། སུས་རྟེན་ཅིང་འབྲེལ་པར་འབྱུང་བ་མཐོང་བ་དེས་ཆོས་མཐོང་ངོ་༎
 yo dharmaṃ paśyati, sa buddhaṃ paśyati |	སུས་ཆོས་མཐོང་བ་དེས་སངས་རྒྱས་མཐོང་ངོ་ཞེས་དེ་སྐད་བཀའ་སྩལ་ནས་།
 ityuktvā bhagavāṃstūṣṇīṃ babhūvaṃ |	བཅོམ་ལྡན་འདས་ཅང་མི་གསུང་བར་གྱུར་ན་།
 atha maitreya sugatoktasūtrāntasya arthaḥ katamaḥ?	བྱམས་པ་། བདེ་བར་གཤེགས་པས་བཀའ་སྩལ་པའི་མདོ་དེའི་དོན་ནི་ཅི་།
 pratītyasamutpādaḥ katamaḥ?	རྟེན་ཅིང་འབྲེལ་བར་འབྱུང་བ་ནི་གང་།
 dharma katamaḥ?	ཆོས་ནི་གང་།
 buddhaḥ katamaḥ?	སངས་རྒྱས་ནི་གང་།
 kathaṃ pratītyasamutpādaṃ paśyan dharmaṃ paśyati?	ཇི་ལྟར་རྟེན་ཅིང་འབྲེལ་བར་འབྱུང་བ་མཐོང་ན་ཆོས་མཐོང་།
 kathaṃ dharmaṃ paśyan buddhaṃ paśyati?	ཇི་ལྟར་ཆོས་མཐོང་ན་སངས་རྒྱས་མཐོང་།
 evamukte maitreyo bodhisattvo mahāsattvaḥ āyuṣmantaṃ śāradvatīputrametadavocat -	དེ་སྐད་ཅེས་སྨྲས་པ་དང་། བྱང་ཆུབ་སེམས་དཔའ་སེམས་དཔའ་ཆེན་པོ་བྱམས་པས་ཚེ་དང་ལྡན་པ་ཤའ་རདབ༹་ཏིའི་བུ་ལ་འདི་སྐད་ཅེས་སྨྲས་སོ་༎ བཙུན་པ་ཤའ་རིའི་བུ་། འདི་ལ་བཅོམ་ལྡན་འདས་ཆོས་ཀྱི་བདགས་པོ་ཐམས་ཅད་མཁྱེན་པས་།
 atra yaduktaṃ bhadanta śāriputra bhagavatā dharmasvāminā sarvajñena - yo bhikṣavaḥ	དགེ་སློང་དག་།
 pratītyasamutpādaṃ paśyati, sa dharmaṃ paśyati |	སུས་རྟེན་ཅིང་འབྲེལ་བར་འབྱུང་བ་མཐོང་བ་དེས་ཆོས་མཐོང་ངོ་༎
 yo dharmaṃ paśyati, sa buddhaṃ paśyati iti, tatra katamaḥ pratītyasamutpādo nāma?	སུས་ཆོས་མཐོང་བ་དེས་སངས་རྒྱས་མཐོང་ངོ་ཞེས་གསུངས་པ་དེ་ལ་རྟེན་ཅིང་འབྲེལ་བར་འབྱུང་བ་གང་ཞེ་ན་། 
 pratītyasamutpādo nāma yadidam - asmin sati idaṃ bhavati,	རྟེན་ཅིང་འབྲེལ་བར་འབྱུང་བ་ཞེས་བྱ་བ་ནི་། འདི་ལྟ་སྟེ་།
 asyotpādādidamutpadyate |	འདི་ཡོད་པས་འདི་འབྱུང་༄༡༨༡ཨ་༌༎ ལ༏་འདི་སྐྱེས་པའི་ཕྱིར་འདི་སྐྱེ་བ་སྟེ་།
 yaduta avidyāpratyayāḥ saṃskārāḥ |	གང་འདི་མ་རིག་པའི་རྐྱེན་གྱིས་འདུ་བྱེད་རྣམས་།
 saṃskārapratyayaṃ vijñānam |	འདུ་བྱེད་ཀྱི་རྐྱེན་གྱིས་རྣམ་པར་ཤེས་པ་།
 vijñānapratyayaṃ nāmarūpam |	རྣམ་པར་ཤེས་པའི་རྐྱེན་གྱིས་མིང་དང་གཟུགས་།
 nāmarūpapratyayaṃ ṣaḍāyatanam |	མིང་དང་། གཟུགས་ཀྱི་རྐྱེན་གྱིས་སྐྱེ་མཆེད་དྲུག་།
 ṣaḍāyatanapratyayaḥ sparśaḥ |	སྐྱེ་མཆེད་དྲུག་གི་རྐྱེན་གྱིས་རེག་པ་།
 sparśapratyayā vedanā |	རེག་པའི་རྐྱེན་གྱིས་ཚོར་བ་།
 vedanāpratyayā tṛṣṇā |	ཚོར་བའི་རྐྱེན་གྱིས་སྲེད་པ་།
 tṛṣṇāpratyayamupādānam |	སྲེད་པའི་རྐྱེན་གྱིས་ལེན་པ་།
 upādānapratyayo bhavaḥ |	ལེན་པའི་རྐྱེན་གྱིས་སྲིད་པ་།
 bhavapratyayā jāti |	སྲིད་པའི་རྐྱེན་གྱིས་སྐྱེ་བ་།
 jātipratyayā jarāmaraṇaśokaparidevaduḥkhadaurmanasyopāyāsāḥ saṃbhavanti |	སྐྱེ་བའི་རྐྱེན་གྱིས་རྒ་ཤི་དང་། མྱ་ངན་དང་། སྨྲེ་སྔགས་འདོན་པ་དང་། སྡུག་བསྔལ་བ་དང་། ཡིད་མི་བདེ་བ་དང་། འཁྲུག་པ་རྣམས་འབྱུང་སྟེ་།
 evamasya kevalasya mahato duḥkhaskandhasya samudayo bhavati |	དེ་ལྟར་སྡུག་བསྔལ་གྱི་ཕུང་པོ་ཆེན་པོ་འབའ་ཞིག་པོ་འདི་འབྱུང་བར་འགྱུར་རོ་༎
 tatra avidyānirodhāt saṃskāranirodhaḥ |	དེ་ལ་མ་རིག་པ་འགགས་པས་འདུ་བྱེད་འགག་།
 saṃskāranirodhādvijñānanirodhaḥ |	འདུ་བྱེད་འགགས་པས་རྣམ་པར་ཤེས་བ་འགག་།
 vijñānanirodhānnāmarūpanirodhaḥ |	རྣམ་པར་ཤེས་པ་འགགས་པས་མིང་དང་། གཟུགས་འགག་།
 nāmarūpanirodhāt ṣaḍāyatananirodhaḥ |	མིང་དང་། གཟུགས་འགགས་པས་སྐྱེ་མཆེད་དྲུག་འགག་།
 ṣaḍāyatananirodhāt sparśanirodhaḥ |	སྐྱེ་མཆེད་དྲུག་འགགས་པས་རེག་པ་འགག་།
 sparśanirodhāt vedanānirodhaḥ |	རེག་པ་འགགས་པས་ཚོར་བ་འགག་།
 vedanānirodhāt tṛṣṇānirodhaḥ |	ཚོར་བ་འགགས་པས་སྲེད་པ་འགག་།
 tṛṣṇānirodhādupādānanirodhaḥ |	སྲེད་པ་འགགས་པས་ལེན་པ་འགག་།
 upādānanirodhādbhavanirodhaḥ |	ལེན་པ་འགགས་པས་སྲིད་པ་འགག་།
 bhavanirodhājjātinirodhaḥ |	སྲིད་པ་འགགས་པས་སྐྱེ་བ་འགག་།
 jātinirodhājjarāmaraṇaśokaparidevaduḥkhadaurmanasyopāyāsā nirudhyante |	སྐྱེ་བ་འགགས་པས་རྒ་ཤི་དང་། མྱ་ངན་དང་། སྨྲེ་སྔགས་འདོན་པ་དང་། སྡུག་བསྔལ་བ་དང་། ཡིད་མི་བདེ་བ་དང་། འཁྲུག་པ་རྣམས་འགག་པར་འགྱུར་ཏེ་།
 evamasya kevalasya mahato duḥkhaskandhasya nirodho bhavati |	དེ་ལྟར་༄༡༨༡བ་སྡུག་བསྔལ་གྱི་ཕུང་པོ་ཆེན་པོ་འབའ་ཞིག་པོ་འདི་འགག་པར་འགྱུར་རོ་༎
 ayamucyate pratītyasamutpādo bhagavatā ||	འདི་ནི་བཅོམ་ལྡན་འདས་ཀྱིས་རྟེན་ཅིང་འབྲེལ་བར་འབྱུང་བ་ཞེས་གསུངས་སོ་༎
 katamo dharmaḥ?	ཆོས་གང་ཞེ་ན་།
 āryāṣṭāṅgiko mārgaḥ |	འཕགས་པའི་ལམ་ཡན་ལག་བརྒྱད་པ་སྟེ་།
 tadyathā - samyagdṛṣṭiḥ samyaksaṃkalpaḥ samyagvāk samyakkarmāntaḥ samyagājīvaḥ samyagvyāyāmaḥ samyaksmṛtiḥ samyaksamādhiḥ |	འདི་ལྟ་སྟེ་། ཡང་དག་པའི་ལྟ་བ་དང་། ཡང་དག་པའི་རྟོག་པ་དང་། ཡང་དག་པའི་ངག་དང་། ཡང་དག་པའི་ལས་ཀྱི་མཐའ་དང་། ཡང་དག་པའི་འཚོ་བ་དང་། ཡང་དག་པའི་རྩོལ་བ་དང་། ཡང་དག་པའི་དྲན་པ་དང་། ཡང་དག་པའི་ཏིང་ངེ་འཛིན་ཏོ་༎
 ayamukto bhagavatā āryāṣṭāṅgiko mārgaḥ phalalābhanirvāṇaikasaṃgṛhīto dharmaḥ ||	འདི་ནི་འཕགས་པའི་ལམ་ཡན་ལག་བརྒྱད་པ་ཞེས་བྱ་སྟེ་། འབྲས་བུ་ཐོབ་པ་དང་། མྱ་ངན་ལས་འདས་པ་གཅིག་ཏུ་བསྡུས་ཏེ་། བཅོམ་ལྡན་འདས་ཀྱིས་ཆོས་སོ་ཞེས་བཀའ་སྩལ་ཏོ་༎
 tatra katamo buddho bhagavān?	དེ་ལ་སངས་རྒྱས་བཅོམ་ལྡན་འདས་གང་ཞེ་ན་།
 yaḥ sarvadharmāvabodhādbuddha ucyate,	སུས་ཆོས་ཐམས་ཅད་ཐུགས་སུ་ཆུད་པའི་ཕྱིར་སངས་རྒྱས་ཞེས་བྱ་སྟེ་།
 sa āryaprajñānetraḥ dharmakāyasamanvitaḥ śaikṣāśaikṣadharmānimān paśyati ||	དེས་འཕགས་པའི་ཤེས་རབ་ཀྱི་སྤྱན་དང་། ཆོས་ཀྱི་སྐུ་དང་ལྡན་པ་དང་། སློབ་པ་དང་། མི་སློབ་པའི་ཆོས་དེ་དག་གཟིགས་པའོ་༎
 tatra kathaṃ pratītyasamutpādaṃ paśyati?	དེ་ལ་རྟེན་ཅིང་འབྲེལ་བར་འབྱུང་བ་མཐོང་བ་ཇི་ལྟ་བུ་ཞེ་ན་།
 ihoktaṃ bhagavatā - ya imaṃ pratītyasamutpādaṃ satatasamitam, ajīvaṃ nirjīvaṃ yathāvadaviparītamajātamabhūtamakṛtamasaṃskṛtamapratighamanālambanaṃ śivamabhayamanāhāryamavyayamavyupaśamasvabhāvaṃ paśyati, (sa dharmaṃ paśyati) | yastu evaṃ dharmaṃ (śālsū, vaidya 101) satatasamitamajīvaṃ nirjīvaṃ yathāvadaviparītamajātamabhūtamakṛtamasaṃskṛtamapratighamanālambanaṃ śivamanāhāryamavyayamavyupaśamasvabhāvaṃ paśyati, so 'nuttaradharmaśarīraṃ buddhaṃ paśyati | āryadharmābhisamaye samyagjñānopanayenaiva || pratītyasamutpāda iti kasmāducyate? sahetukaḥ sapratyayo nāhetuko nāpratyayaḥ, tasmāt pratītyasamutpāda ityucyate | tatra bhagavatā pratītyasamutpādalakṣaṇaṃ saṃkṣepeṇoktamidaṃpratyayatāphalam | utpādādvā tathāgatānāmanutpādādvā sthitaiveṣā dharmāṇāṃ dharmatā yāvadyaiṣā dharmatā dharmasthititā dharmaniyāmatā pratītyasamutpādasamatā tathatā aviparītatathatā ananyatathatā bhūtatā satyatā aviparītatā aviparyayatā iti || atha ca punarayaṃ pratītyasamutpādo dvābhyāṃ kāraṇābhyāmutpadyate | katamābhyāṃ dvābhyām? yadidaṃ hetūpanibandhataḥ pratyayopanibandhataśca | so 'pi dvividho draṣṭavyaḥ - bāhyaśca ādhyātmikaśca | tatra bāhyasya pratītyasamutpādasya hetūpanibandhaḥ katamāḥ? yadidaṃ bījādaṅkuraḥ | aṅkurātpatram | patrātkāṇḍam | kāṇḍānnālam | nālādgaṇḍaḥ | gaṇḍādgarbham | garbhācchūkaḥ | śūkātpuṣpam | puṣpāt phalam | asati bīje aṅkuro na bhavati, yāvadasati puṣpe phalaṃ na bhavati | sati tu bīje aṅkurasyābhinirvṛttirbhavati, evaṃ yāvat sati puṣpe phalasyābhinirvṛttirbhavati | tatra bījasya naivaṃ bhavati - ahamaṅkuramabhinirvartayāmīti | aṅkurasyāpi naivaṃ bhavati - ahaṃ bījenābhinirvartita iti | evaṃ yāvat puṣpasya naivaṃ bhavati - ahaṃ phalamabhinirvartayāmīti | phalasyāpi naivaṃ bhavati - ahaṃ puṣpeṇābhinirvartitamiti | atha punaḥ bīje sati aṅkurasyābhinirvṛttirbhavati prādurbhāvaḥ |	འདི་ལ་བཅོམ་ལྡན་འདས་ཀྱིས་སུས་རྟེན་ཅིང་འབྲེལ་བར་འབྱུང་བ་རྟག་པ་དང་། སྲོག་མེད་པ་དང་། སྲོག་དང་བྲལ་བ་དང་། ཇི་ལྟ་བུ་ཉིད་དང་། མ་ནོར་བ་དང་། མ་སྐྱེས་པ་དང་། མ་བྱུང་བ་དང་། མ་བྱས་པ་དང་། འདུས་མ་བྱས་པ་དང་། ཐོགས་པ་མེད་པ་དང་། དམིགས་པ་མེད་པ་དང་། ཞི་བ་དང་། འཇིགས་པ་མེད་པ་དང་། མི་འཕྲོགས་པ་དང་། རྣམ་པར་ཞི་བ་མ་ཡིན་པའི་རང་༄༡༨༢ཨ་missing page་༄༡༨༢བ་missing page་༄༡༨༣ཨ་༌༎
 evaṃ yāvat puṣpe sati phalasyābhinirvṛttirbhavati prādurbhāvaḥ | evaṃ bāhyasya pratītyasamutpādasya hetūpanibandho draṣṭavyaḥ ||	ནས་དེ་བཞིན་དུ་མེ་ཏོག་ཡོད་ན་འབྲས་བུའི་བར་དུའང་མངོན་པར་འགྲུབ་ཅིང་འབྱུང་བར་འགྱུར་ཏེ་། དེ་ལྟར་ཕྱི་རོལ་གྱི་རྟེན་ཅིང་འབྲེལ་བར་འབྱུང་བརྒྱུ་དང་འབྲེལ་བར་བལྟའ༎
 kathaṃ bāhyasya pratītyasamutpādasya pratyayopanibandho draṣṭavyaḥ?	ཕྱི་རོལ་གྱི་རྟེན་ཅིང་འབྲེལ་བར་འབྱུང་བ་རྐྱེན་དང་འབྲེལ་བ་ཇི་ལྟར་བལྟ་ཞེ་ན་།
 ṣaṇṇāṃ dhātūnā samudāyāt |	ཁམས་དྲུག་འདུས་པའི་ཕྱིར་ཏེ་།
 katameṣāṃ ṣaṇṇāṃ samavāyāt?	ཁམས་དྲུག་པོ་གང་དག་འདུས་པའི་ཕྱིར་ཞེ་ན་།
 yadidaṃ pṛthivyaptejovāyvākāśaṛtudhātusamavāyādbāhyasya pratītyasamutpādasya pratyayopanibandho draṣṭavyaḥ |	འདི་ལྟ་སྟེ་། ས་དང་། ཆུ་དང་། མེ་དང་། རླུང་དང་། ནམ་མཁའ་དང་། དུས་ཀྱི་ཁམས་རྣམས་འདུས་པ་ལས་ཕྱི་རོལ་གྱི་རྟེན་ཅིང་འབྲེལ་བར་འབྱུང་བ་རྐྱེན་དང་འབྲེལ་བར་བལྟའོ་༎ 
 tatra pṛthivīdhāturbījasya saṃdhāraṇakṛtyaṃ karoti |	དེ་ལ་སའི་ཁམས་ནི་ས་བོན་རྟེན་པའི་བྱ་བ་བྱེད་དོ་༎
 abdhāturbījaṃ snehayati |	ཆུའི་ཁམས་ནི་ས་བོན་བརླན་པའི་བྱ་བ་བྱེད་དོ་།
 tejodhāturbījaṃ paripācayati |	མེའི་ཁམས་ནི་ས་བོན་ཡོངས་སུ་དྲོ་བའི་བྱ་བ་བྱེད་དོ་༎
 vāyudhāturbījamabhinirharati |	རླུང་གི་ཁམས་ནི་ས་བོན་འབུ་བའི་བྱ་བ་བྱེད་དོ་༎
 ākāśadhāturbījasyānāvaraṇakṛtyaṃ karotīti |	ནམ་མཁའི་ཁམས་ནི་ས་བོན་ལ་མི་སྒྲིབ་པའི་བྱ་བ་བྱེད་དོ་༎
 ṛturapi bījasya pariṇāmanākṛtyaṃ karoti |	དུས་ནི་ས་བོན་འགྱུར་བའི་བྱ་བ་བྱེད་དོ་༎
 asatsu eṣu pratyayeṣu bījādaṅkurasyābhinirvṛttirna bhavati |	རྐྱེན་འདི་རྣམས་མེད་པར་ས་བོན་ལས་མྱུ་གུ་མངོན་པར་འགྲུབ་པར་མི་འགྱུར་གྱི་།
 yadā bāhyaśca pṛthivīdhāturavikalo bhavati, evamaptejovāyvākāśaṛtudhātavaścāvikalā bhavanti,	ནམ་ཕྱི་རོལ་གྱི་སའི་ཁམས་མ་ཚང་བ་མེད་པར་གྱུར་ལ་དེ་བཞིན་དུ་ཆུ་དང་། མེ་དང་། རླུང་དང་། ནམ་མཁའ་དང་། དུས་ཀྱང་མ་ཚད་བ་མེད་པར་གྱུར་ཏེ་།
 tataḥ savaṣāṃ samavāyādbīje nirudhyamāne aṅkurasyābhinirvṛttirbhavati | tatra pṛthivīdhātornaivaṃ bhavati - ahaṃ bījasya saṃdhāraṇakṛtyaṃ karomḥti |	ཐམས་ཅད་འདུས་པ་ལས་ས་བོན་འགགས་པ་ན་དེ་ལས་མྱུ་གུ་མངོན་པར་འགྲུབ་པར་འགྱུར་རོ་༎ དེ་ལ་སའི་ཁམས་ཀྱང་འདི་སྙམ་དུ་བདག་གིས་ས་བོན་རྟེན་པའི་བྱ་བ་བྱའོ་༄༡༨༣བ་སྙམ་དུ་མི་སེམས་སོ་༎
 evamabdhātorapi naivaṃ bhavati - ahaṃ bḥjaṃ snehayāmḥti |	དེ་བཞིན་དུ་ཆུའི་ཁམས་ཀྱང་འདི་སྙམ་དུ་བདག་གིས་ས་བོན་བརླན་པར་བྱའོ་སྙམ་དུ་མི་སེམས་སོ་༎ 
 tejodhātorapi naivaṃ bhavati - ahaṃ bḥjaṃ paripācayāmḥti |	མེའི་ཁམས་ཀྱང་འདི་སྙམ་དུ་བདག་གིས་ས་བོན་ཡོངས་སུ་དྲོ་བར་བྱའོ་སྙམ་དུ་མི་སོ་༎ སེམས་སོ་༎ 
 vāyudhātorapi naivaṃ bhavati - ahaṃ bḥjamabhinirharāmḥti |	རླུང་གི་ཁམས་ཀྱང་འདི་སྙམ་དུ་བདག་གིས་ས་བོན་འབུ་བར་བྱའོ་སྙམ་དུ་མི་སེམས་སོ་༎
 ākāśadhātorapi naivaṃ bhavati - ahaṃ bḥjasyānāvaraṇakṛtyaṃ karomḥti |	ནམ་མཁའི་ཁམས་ཀྱང་འདི་སྙམ་དུ་བདག་གིས་ས་བོན་ལ་མི་སྒྲིབ་པའི་བྱ་བ་བྱའོ་སྙམ་དུ་མི་སེམས་སོ་༎ 
 ṛtorapi naivaṃ bhavati - ahaṃ bḥjasya pariṇāmanākṛtyaṃ karomḥti |	དུས་ཀྱང་འདི་སྙམ་དུ་བདག་གིས་ས་བོན་བསྒྱུར་བའི་བྱ་བ་བྱའོ་སྙམ་དུ་མི་སེམས་སོ་༎ མི་སེམས་སོ་༎ 
 bḥjasyāpi naivaṃ bhavati - ahaṃ bḥjaṃ (aṅkuraṃ?) abhinirvartayāmḥti |	ས་བོན་ཡང་འདི་སྙམ་དུ་བདག་གིས་མྱུ་གུ་མངོན་པར་བསྒྲུབ་པོ་སྙམ་དུ་མི་སེམས་སོ་༎
 aṅkurasyāpi naivaṃ bhavati - ahamebhiḥ pratyayairabhinirvartita (śālsū, vaidya 102) iti |	མྱུ་གུའང་འདི་སྙམ་དུ་བདག་ནི་རྐྱེན་འདི་དག་གིས་མངོན་པར་བསྒྲུབས་སོ་སྙམ་དུ་མི་སེམས་མོད་ཀྱི་། 
 atha punaḥ satsu eteṣu pratyayeṣu bḥje nirudhyamāne aṅkurasyābhinirvṛttiebhavati |	འོན་ཀྱང་རྐྱེན་འདི་དག་ཡོད་ལ་ས་བོན་འགག་པ་ན་མྱུ་གུ་མངོན་པར་འགྲུབ་པར་ཀྱི་། འགྱུར་རོ་༎ 
 evaṃ yāvat puṣpe sati phalasyābhinirvṛttirbhavati |	དེ་བཞིན་དུ་མེ་ཏོག་ཡོད་ན་འབྲས་བུའི་བར་དུའང་མངོན་པར་འགྲུབ་པར་ཀྱི་། འགྱུར་རོ་༎ འགྱུར་ཏེ་། མྱུ་གུ་དེའང་བདག་གིས་མ་བྱས་། གཞན་གྱིས་མ་བྱས་། གཉིས་ཀས་མ་བྱས་།
 sa ca aṅkuro na svayaṃkṛto na parakṛto nobhayakṛto neśvarakṛto na kālapariṇāmito na prakṛtisaṃbhūto (na caikakāraṇādhḥno)	དབང་ཕྱུག་གིས་མ་བྱས་། དུས་ཀྱིས་མ་བསྒྱུར་། རང་བཞིན་ལས་མ་བྱུང་།
 nāpyahetusamutpannaḥ |	རྒྱུ་མེད་པ་ལས་ཀྱང་མ་སྐྱེས་ཏེ་།
 atha punaḥ pṛthivyaptejovāyvākāśaṛtudhātusamavāyād bḥje nirudhyamāne aṅkurasyābhinirvṛttirbhavati |	འོན་ཀྱང་ས་དང་། ཆུ་དང་། མེ་དང་། རླུང་དང་། ནམ་མཁའ་དང་། དུས་ཀྱི་ཁམས་རྣམས་འདུས་ནས་ས་བོན་འགག་པ་ན་མྱུ་གུ་མངོན་པར་འགྲུབ་པར་འགྱུར་ཏེ་།
 evaṃ bāhyasya pratḥtyasamutpādasya pratyayopanibandho draṣṭavyaḥ ||	དེ་ལྟར་ཕྱི་རོལ་གྱི་རྟེན་ཅིང་འབྲེལ་བར་འབྱུང་བ་རྐྱེན་དང་འབྲེལ་བར་བལྟའོ་།
 tatra bāhyaḥ pratītyasamutpādaḥ pañcabhirākārairdraṣṭavyaḥ |	༄༡༨༤ཨ་༌༎ དེ་ལ་ཕྱི་རོལ་གྱི་རྟེན་ཅིང་འབྲེལ་བར་འབྱུང་བ་རྣམ་པ་ལྔར་བལྟ་སྟེ་།
 katamaiḥ pañcabhiḥ? na śāśvatataḥ, nocchedataḥ, na saṃkrāntitaḥ,	ལྔ་གང་ཞེ་ན་།
 parīttahetuto vipulaphalābhinirvṛttitaḥ, tatsadṛśānuprabandhataśca |	རྟག་པར་མ་ཡིན་པ་དང་། ཆད་པར་མ་ཡིན་པ་དང་། འཕོ་བར་མ་ཡིན་པ་དང་། རྒྱུ་ཆུང་དུ་ལས་འབྲས་བུ་ཆེན་པོ་མངོན་པར་འགྲུབ་པ་དང་། དེ་དང་འདྲ་བའི་རྒྱུད་དུའོ་༎
 kathaṃ na śāśvatata iti?	ཇི་ལྟར་རྟག་པར་མ་ཡིན་ཞེ་ན་།
 yasmādanyo 'ṅkuraḥ anyadbījam |	གང་གི་ཕྱིར་མྱུ་གུའང་གཞན་ལ་ས་བོན་ཡང་གཞན་ཏེ་།
 na ca ya evāṅkuraḥ tadeva bījam |	མྱུ་གུ་གང་ཡིན་པ་དེ་ཉིད་ས་བོན་མ་ཡིན་ལ་།
 na ca niruddhādbījādaṅkura utpadyate nāpyaniruddhāt |	ས་བོན་འགགས་པ་ལས་མྱུ་གུ་འབྱུང་བ་མ་ཡིན་། མ་འགགས་པ་ལས་ཀྱང་མ་ཡིན་གྱི་།
 bījaṃ punarnirudhyate, tadaivāṅkuraścotpadyate |	ས་བོན་ཡང་འགག་ལ་དེ་ཉིད་ཀྱི་ཚེ་མྱུ་གུའང་འབྱུང་སྟེ་།
 tasmānna śāśvatataḥ |	དེའི་ཕྱིར་རྟག་པར་མ་ཡིན་ནོ་༎
 kathaṃ nocchedataḥ?	ཇི་ལྟར་ཆད་པར་མ་ཡིན་ཞེ་ན་།
 na ca pūrvaniruddhād bījādaṅkuro niṣpadyate |	སྔོན་འགགས་པའི་ས་བོན་ལས་མྱུ་གུ་སྐྱེ་བ་མ་ཡིན་།
 nāpyaniruddhāt |	མ་འགགས་པ་ལས་ཀྱང་མ་ཡིན་གྱི་།
 api ca bījaṃ ca nirudhyate, tasminneva samaye aṅkura utpadyate tulādaṇḍonnāmāvanāmavat | ato nocchedataḥ ||	ས་བོན་ཡང་འགག་ལ་དེ་ཉིད་ཀྱི་ཚེ་སྲང་མདའི་མཐོ་དམའ་བཞིན་དུ་མྱུ་གུ་སྐྱེ་བས་དེའི་ཕྱིར་ཆད་པར་མ་ཡིན་ནོ་༎
 kathaṃ na saṃkrāntitaḥ?	ཇི་ལྟར་འཕོ་བར་མ་ཡིན་ཞེ་ན་།
 visadṛśo bījādaṅkura iti |	གང་གི་ཕྱིར་མྱུ་གུའང་གཞན་ལ་ས་བོན་ཡང་གཞན་། མྱུ་གུ་གང་ཡིན་པ་ད་ཉིད་ས་བོན་མ་ཡིན་ཏེ་།
 ato na saṃkrāntitaḥ ||	དེའི་ཕྱིར་འཕོ་བར་མ་ཡིན་ནོ་༎
 kathaṃ parīttahetuto vipulaphalābhinirvṛttitaḥ?	ཇི་ལྟར་རྒྱུ་ཆུང་དུ་ལས་འབྲས་བུ་ཆེན་པོ་མངོན་པར་འགྲུབ་ཅེ་ན་།
 parīttaṃ bījamupyate, vipulaphalamabhinirvartayatīti |	ས་བོན་ཆུང་དུ་བཏབ་པ་ལས་འབྲས་བུ་ཆེན་པོ་མངོན་པར་འགྲུབ་པར་འགྱུར་ཏེ་།
 ataḥ parīttahetuto vipulaphalābhinirvṛttitaḥ ||	དེའི་ཕྱིར་རྒྱུ་ཆུང་དུ་ལས་འབྲས་བུ་ཆེན་པོ་མངོན་པར་འགྲུབ་བོ་༎
 kathaṃ tatsadṛśānuprabandhataḥ? yādṛśaṃ bījamupyate, tādṛśaṃ phalamabhinirvartayatīti | atastatsadṛśānuprabandhataśceti ||	ས་བོན་ཇི་ལྟ་བུ་བཏབ་པ་དེ་ལྟ་བུའི་འབྲས་བུ་མངོན་༄༡༨༤བ་པར་འགྲུབ་པས་དེའི་ཕྱིར་དེ་དང་འདྲ་བའི་རྒྱུད་དུ་སྟེ་།
 evaṃ bāhyaḥ pratītyasamutpādaḥ pañcabhirākārairdraṣṭavyaḥ ||	དེ་ལྟར་ཕྱི་རོལ་གྱི་རྟེན་ཅིང་འབྲེལ་བར་འབྱུང་བ་རྣམ་པ་ལྔར་བལྟའོ་༎
 evamādhyātmiko 'pi pratītyasamutpādo dvābhyāṃ kāraṇābhyāmutpadyate |	དེ་བཞིན་དུ་ནང་གི་རྟེན་ཅིང་འབྲེལ་བར་འབྱུང་བའང་གཉིས་ཀྱི་ཕྱིར་འབྱུང་སྟེ་།
 katamābhyāṃ dvābhyām?	གཉིས་གང་ཞེ་ན་། འདི་ལྟ་སྟེ་།
 yadidaṃ hetūpanibandhataḥ pratyayopanibandhataśca |	རྒྱུ་དང་འབྲེལ་བ་དང་། རྐྱེན་དང་འབྲེལ་བའོ་༎
 tatrādhyātmikasya pratītyasamutpādasya hetūpanibandhaḥ katamaḥ?	དེ་ལ་ནང་གི་རྟེན་ཅིང་འབྲེལ་བར་འབྱུང་བ་རྒྱུ་དང་འབྲེལ་བ་གང་ཞེ་ན་།
 yadidamavidyāpratyayāḥ saṃskārāḥ, yāvajjātipratyayaṃ jarāmaraṇamiti |	གང་འདི་མ་རིག་པའི་རྐྱེན་གྱིས་འདུ་བྱེད་རྣམས་ཞེས་བྱ་བ་ནས་སྐྱེ་བའི་རྐྱེན་གྱིས་རྒ་ཤི་ཞེས་བྱ་བའི་བར་དུའོ་༎
 avidyā cennābhaviṣyat, naiva saṃskārāḥ prajñāsyante |	གལ་ཏེ་མ་རིག་པ་མ་བྱུང་ན་འདུ་བྱེད་རྣམས་ཀྱང་མི་མངོན་པ་ཞིག་།
 evaṃ yāvajjātiścennābhaviṣyat, jarāmaraṇaṃ na prajñāsyate | atha satyāmavidyāyāṃ saṃskārāṇāmabhinirvṛttirbhavati |	དེ་བཞིན་དུ་སྐྱེ་བ་མ་བྱུང་དུ་ཟིན་ན་རྒ་ཤིའི་བར་དུའང་མི་མངོན་པ་ཞིག་ན་།
 evaṃ yāvajjātyāṃ sattyāṃ jarāmaraṇasyābhinirvṛttirbhavati |	འདི་ལྟར་མ་རིག་པ་ཡོད་པ་ལས་འདུ་བྱེད་རྣམས་མངོན་པར་འགྲུབ་པར་འགྱུར་བ་ནས་སྐྱེ་བ་ཡོད་པ་ལས་རྒ་ཤིའི་བར་དུ་མངོན་པར་འགྲུབ་པར་འགྱུར་རོ་༎ 
 tatra avidyāyā naivaṃ bhavati - ahaṃ saṃskārānabhinirvartayāmīti |	དེ་ལ་མ་རིག་པའང་འདི་སྙམ་དུ་བདག་གིས་འདུ་བྱེད་རྣམས་མངོན་པར་བསྒྲུབ་བོ་སྙམ་དུ་མི་སེམས་སོ་༎
 saṃskārāṇāmapi naivaṃ bhavati - vayamavidyayā abhinirvatitā iti | evaṃ yāvajjāterapi naivaṃ bhavati - ahaṃ jarāmaraṇamabhinirvartayāmīti |	འདུ་བྱེད་རྣམས་ཀྱང་འདི་སྙམ་དུ་བདག་ཅག་ནི་མ་རིག་པས་མངོན་པར་བསྒྲུབས་སོ་སྙམ་དུ་མི་སེམས་པ་ནས་དེ་བཞིན་དུ་སྐྱེ་བའང་འདི་སྙམ་དུ་བདག་གིས་རྒ་ཤི་མངོན་པར་བསྒྲུབ་པོ་སྙམ་དུ་མི་སེམས་ཤིང་།
 jarāmaraṇasyāpi naivaṃ bhavati - ahaṃ jātyābhinirvartitamiti |	རྒ་ཤིའང་འདི་སྙམ་དུ་བདག་ནི་སྐྱེ་བས་མངོན་པར་བསྒྲུབས་སོ་སྙམ་དུ་མི་སེམས་པའི་བར་དུ་སྟེ་། 
 atha ca satyāmavidyāyāṃ saṃskārāṇāmabhinirvṛttirbhavati prādurbhāvaḥ |	འོན་ཀྱང་མ་རིག་པ་ཡོད་པ་ལས་འདུ་བྱེད་རྣམས་མངོན་པར་འགྲུབ་ཅིང་འབྱུང་བར་༄༡༨༥ཨ་སྟེ་། ༌༎ འགྱུར་བ་ནས་།
 evaṃ yāvajjātyāṃ satyāṃ jarāmaraṇasyābhinirvṛttirbhavati prādurbhāvaḥ | evamādhyātmikasya pratītyasamutpādasya hetūpanibandho draṣṭavyaḥ ||	དེ་བཞིན་དུ་སྐྱེ་བ་ཡོད་པ་ལས་རྒ་ཤིའི་བར་དུ་མངོན་པར་འགྲུབ་ཅིང་འབྱུང་བར་འགྱུར་ཏེ་། དེ་ལྟར་ནང་གི་རྟེན་ཅིང་འབྲེལ་བར་འབྱུང་བ་རྒྱུ་དང་འབྲེལ་བར་བལྟའོ་༎
 kathamādhyātmikasya pratītyasamutpādasya pratyayopanibandho draṣṭavyaḥ?	ནང་གི་རྟེན་ཅིང་འབྲེལ་བར་འབྱུང་བ་རྐྱེན་དང་འབྲེལ་བར་ཇི་ལྟར་བལྟ་ཞེ་ན་།
 ṣaṇṇāṃ dhātūnāṃ samavāyāt |	ཁམས་དྲུག་འདུས་པའི་ཕྱིར་ཏེ་།
 katameṣāṃ ṣaṇṇāṃ dhātūnāṃ samavāyāt?	ཁམས་དྲུག་པོ་གང་དག་འདུས་པའི་ཕྱིར་ཞེ་ན་།
 yadidaṃ pṛthivyaptejovāyvākāśavijñānadhātūnāṃ samavāyādādhyātmikasya pratītyasamutpādasya pratyayopanibandho draṣṭavyaḥ |	འདི་ལྟ་སྟེ་། ས་དང་། ཆུ་དང་། མེ་དང་། རླུང་དང་། ནམ་མཁའ་དང་། རྣམ་པར་ཤེས་པའི་ཁམས་རྣམས་འདུས་པ་ལས་ནང་གི་རྟེན་ཅིང་འབྲེལ་བར་འབྱུང་བ་རྐྱེན་དང་འབྲེལ་བར་བལྟའོ་༎ 
 tatra ādhyātmikasya pratītyasamutpādasya pṛthivīdhātuḥ katamaḥ?	དེ་ལ་ནང་གི་རྟེན་ཅིང་འབྲེལ་བར་འབྱུང་བའི་སའི་ཁམས་གང་ཞེ་ན་།
 yo 'yaṃ kāyasya saṃśleṣataḥ kaṭhinabhāvamabhinirvartayati, ayamucyate pṛthivīdhātuḥ |	གང་འདི་འདུས་ནས་ལུས་ཀྱི་སྲ་བའི་དངོས་པོ་མངོན་པར་འགྲུབ་པར་བྱེད་པ་འདི་ནི་སའི་ཁམས་ཞེས་བྱའོ་༎ 
 yaḥ kāyasya anuparigrahakṛtyaṃ karoti, ayamucyate 'bdhātuḥ |	གང་ལུས་སྡུད་པའི་བྱ་བ་བྱེད་པ་འདི་ནི་ཆུའི་ཁམས་ཞེས་བྱའོ་༎
 yaṃ kāyasya aśitapītabhakṣitaṃ paripācayati, (śālsū, vaidya 103) ayamucyate tejodhātuḥ | yaṃ kāyasya āśvāsapraśvāsakṛtyaṃ karoti,	གང་ལུས་ཀྱིས་ཟོས་པ་དང་། འཐུངས་པ་དང་། འཆོས་པ་དང་། མྱངས་པ་རྣམས་འཇུ་བར་བྱེད་པ་འདི་ནི་མེའི་ཁམས་ཞེས་བྱའོ་༎
 ayamucyate vāyudhātuḥ | yaṃ kāyasyāntaḥśauṣiryamabhinirvartayati, ayamucyate ākāśadhātuḥ |	གང་ལུས་ཀྱི་དབུགས་ཕྱི་ནང་དུ་རྒྱུ་བའི་བྱ་བ་བྱེད་པ་འདི་ནི་རླུང་གི་ཁམས་ཞེས་བྱའོ་༎ གང་ལུས་ཀྱི་ནང་སྦུབས་ཡོད་པར་བྱེད་པ་འདི་ནི་ནམ་མཁའི་ཁམས་ཞེས་བྱའོ་༎
 ya kāyasya nāmarūpāṅkuramabhinirvartayati, naḍakalāpayogena, pañcavijñānakāyasaṃyuktaṃ sāsravaṃ ca manovijñānam, ayamucyate vijñānadhātuḥ |	གང་མདུང་ཁྱིམ་གྱི་ཚུལ་དུ་ལུས་ཀྱི་མིང་དང་གཟུགས་ཀྱི་མྱུ་གུ་མངོན་པར་འགྲུབ་པར་བྱེད་པ་རྣམ་པར་ཤེས་པའི་ཚོགས་ལྔ་འདུས་པ་དང་། ཟག་པ་དང་བཅས་པའི་༄༡༨༥བ་ཡིད་ཀྱི་རྣམ་པར་ཤེས་པ་གང་ཡིན་པ་འདི་ནི་རྣམ་པར་ཤེས་པའི་ཁམས་ཞེས་བྱའོ་༎
 tatra asatāmeṣāṃ pratyayānāṃ kāyasyotpattirnaṃ bhavati |	རྐྱེན་འདི་དག་མེད་པར་ལུས་སྐྱེ་བར་མི་འགྱུར་གྱི་།
 yadā ādhyātmikaḥ pṛthivīdhāturavikalo bhavati, evamaptejovāyvākāśavijñānadhātavaśca avikalā bhavanti,	ནམ་ནང་གི་སའི་ཁམས་ཚང་ཞིང་དེ་བཞིན་དུ་ཆུ་དང་། མེ་དང་། རླུང་དང་། ནམ་མཁའ་དང་། རྣམ་པར་ཤེས་པའི་ཁམས་རྣམས་ཀྱང་ཚང་བར་གྱུར་ལ་།
 tataḥ sarveṣāṃ samavāyāt kāyasyābhinirvṛttirbhavati |	ཐམས་ཅད་འདུས་པ་དེ་ལས་ལུས་མངོན་པར་འགྲུབ་པར་འགྱུར་རོ་༎
 tatra pṛthivīdhātornaivaṃ bhavati - ahaṃ kāyasya saṃśleṣataḥ kaṭhinabhāvamabhinirvartayāmīti |	དེ་ལ་སའི་ཁམས་ཀྱང་འདི་སྙམ་དུ་བདག་གིས་འདུས་ནས་ལུས་ཀྱི་སྲ་བའི་དངོས་པོ་མངོན་པར་བསྒྲུབ་བོ་སྙམ་དུ་མི་སེམས་སོ་༎
 abdhātornaivaṃ bhavati - ahaṃ kāyasya anuparigrahakṛtyaṃ karomīti | tejodhātorapi naivaṃ bhavati - ahaṃ kāyasya aśitapītabhakṣitaṃ paripācayāmīti |	ཆུའི་ཁམས་ཀྱང་འདི་སྙམ་དུ་བདག་གིས་ལུས་ཀྱི་སྡུད་པའི་བྱ་བ་བྱའོ་སྙམ་དུ་མི་སེམས་སོ་༎ མེའི་ཁམས་ཀྱང་འདི་སྙམ་དུ་བདག་གིས་ལུས་ཀྱི་ཟོས་པ་དང་། འཐུངས་པ་དང་། འཆོས་པ་དང་། མྱངས་པ་རྣམས་འཇུ་བར་བྱའོ་སྙམ་དུ་མི་སེམས་སོ་༎
 vāyudhātornaivaṃ bhavati - ahaṃ kāyasya āśvāsapraśvāsakṛtyaṃ karomīti |	རླུང་གི་ཁམས་ཀྱང་འདི་སྙམ་དུ་བདག་གིས་ལུས་ཀྱི་དབུགས་ཕྱི་ནང་དུ་རྒྱུ་བའི་བྱ་བ་བྱའོ་སྙམ་དུ་མི་སེམས་སོ་༎
 ākāśadhātornaivaṃ bhavati - ahaṃ kāyasyāntaḥśauṣiryamabhinirvartayāmīti |	ནམ་མཁའི་ཁམས་ཀྱང་འདི་སྙམ་དུ་བདག་གིས་ལུས་ཀྱི་ནང་སྦུབས་ཡོད་པར་བྱའོ་སྙམ་དུ་མི་སེམས་སོ་༎ 
 vijñānadhātornaivaṃ bhavati - ahaṃ kāyasya nāmarūpamabhinirvartayāmīti |	རྣམ་པར་ཤེས་པའི་ཁམས་ཀྱང་འདི་སྙམ་དུ་བདག་གིས་ལུས་ཀྱི་མིང་དང་། གཟུགས་མངོན་པར་བསྒྲུབ་བོ་སྙམ་དུ་མི་སེམས་སོ་༎
 kāyasyāpi naivaṃ bhavati - ahamebhiḥ pratyayairjanita iti |	ལུས་ཀྱང་འདི་སྙམ་དུ་བདག་ནི་རྐྱེན་འདི་དག་གིས་བསྐྱེད་དོ་སྙམ་དུ་མི་སེམས་མོད་ཀྱི་།
 atha ca satsu eṣu pratyayeṣu kāyasyotpattirbhavati ||	འོན་ཀྱང་རྐྱེན་འདི་དག་ཡོད་ན་ལུས་སྐྱེ་བར་འགྱུར་རོ་༎ དེ་ལ་སའི་ཁམས་ནི་བདག་མ་ཡིན་། སེམས་ཅན་མ་ཡིན་། སྲོག་མ་ཡིན་། སྐྱེ་བ་པོ་མ་༄༡༨༦ཨ་༌༎ ཡིན་། ཤེད་ལས་སྐྱེས་པ་མ་ཡིན་། ཤེད་བུ་མ་ཡིན་། བུད་མེད་མ་ཡིན་།
 tatra pṛthivīdhāturnātmā na sattvo na jīvo na jantuḥ na manajo na mānavo na strī na pumān na napuṃsakaṃ na cāhaṃ na mama na cānyasya kasyacit	སྐྱེས་པ་མ་ཡིན་། མ་ནིང་མ་ཡིན་། ང་མ་ཡིན་། བདག་གི་མ་ཡིན་ཏེ་། གཞན་སུའི་ཡང་མ་ཡིན་ནོ་༎
 evamabdhātustejodhāturvāyudhāturākāśadhāturvijñānadhātuḥ nātmā na sattvo na jīvo	དེ་བཞིན་དུ་ཆུའི་ཁམས་དང་། མེའི་ཁམས་དང་། རླུང་གི་ཁམས་དང་། ནམ་མཁའི་ཁམས་དང་། རྣམ་པར་ཤེས་པའི་ཁམས་ཀྱང་བདག་མ་ཡིན་། སེམས་ཅན་མ་ཡིན་། སྲོག་མ་ཡིན་། སྐྱེ་བ་པོ་མ་ཡིན་། ཤེད་ལས་སྐྱེས་པ་མ་ཡིན་། ཤེད་བུ་མ་ཡིན་། བུད་མེད་མ་ཡིན་།
 na jantuḥ na manujo na mānavo na strī na pumān na napuṃsakaṃ na cāhaṃ na mama na	སྐྱེས་པ་མ་ཡིན་། མ་ནིང་མ་ཡིན་། ང་མ་ཡིན་། བདག་གི་མ་ཡིན་།
 cānyasya kasyacit ||	གཞན་སུའི་ཡང་མ་ཡིན་ནོ་༎
 tatra avidyā katamā?	དེ་ལ་མ་རིག་པ་གང་ཞེ་ན་།
 yā eṣāmeva ṣaṇṇāṃ dhātūnāmekasaṃjñā piṇḍasaṃjñā nityasaṃjñā dhruvasaṃjñā śāśvatasaṃjñā sukhasaṃjñā ātmasaṃjñā sattvajīvajantupoṣapuruṣapudgalasaṃjñā manujamānavasaṃjñā ahaṃkāramamakārasaṃjñā,	ཁམས་དྲུག་པོ་འདི་དག་ཉིད་ལ་གང་གཅིག་པུར་འདུ་ཤེས་པ་དང་། རིལ་པོར་འདུ་ཤེས་པ་དང་། རྟག་པར་འདུ་ཤེས་པ་དང་། བརྟན་པར་འདུ་ཤེས་པ་དང་། ཐེར་ཟུག་ཏུ་འདུ་ཤེས་པ་དང་། བདེ་བར་འདུ་ཤེས་པ་དང་། བདག་ཏུ་འདུ་ཤེས་པ་དང་། སེམས་ཅན་དང་། སྲོག་དང་། སྐྱེ་བ་པོ་དང་། གསོ་བ་དང་། སྐྱེས་བུ་དང་། གང་ཟག་ཏུ་འདུ་ཤེས་པ་དང་། ཤེད་ལས་སྐྱེས་པ་དང་། ཤེད་བུར་འདུ་ཤེས་པ་དང་། ང་ཞེས་བྱ་བ་དང་། བདག་གི་ཞེས་བྱ་བར་འདུ་ཤེས་པ་སྟེ་།
 evamādi vividhamajñānam | iyamucyate avidyeti | evamavidyāyāṃ satyāṃ viṣayeṣu rāgadveṣamohāḥ pravartante |	འདི་ལྟ་བུ་ལ་སོགས་པ་མི་ཤེས་པ་རྣམ་པ་སྣ་ཚོགས་འདི་ནི་མ་རིག་པ་ཞེས་བྱའོ་༎ དེ་ལྟར་མ་རིག་པ་ཡོད་པས་ཡུལ་རྣམས་ལ་འདོད་ཆགས་དང་། ཞེ་སྡང་དང་། གཏི་མུག་འཇུག་སྟེ་།
 tatra ye rāgadveṣamohā viṣayeṣu, amī(avidyāpratyayāḥ) saṃskārā ityucyante |	དེ་ལ་ཡུལ་རྣམས་ལ་འདོད་ཆགས་དང་། ཞེ་སྡང་དང་། གཏི་མུག་གང་༄༡༨༦བ་ཡིན་པ་འདི་ནི་མ་རིག་པའི་རྐྱེན་གྱིས་འདུ་བྱེད་རྣམས་ཞེས་བྱའོ་༎
 vastuprativijñaptirvijñānam |	དངོས་པོ་སོ་སོར་རྣམ་པར་རིག་པ་ནི་རྣམ་པར་ཤེས་པའོ་༎
 vijñānasahabhuvaścatvāraḥ skandhā arūpiṇaḥ upādānākhyāḥ tannāma | rūpaṃ catvāri mahābhūtāni tāni copādāya rūpam | tacca nāma tacca rūpamaikadhyamabhisaṃkṣipya tannāmarūpam |	རྣམ་པར་ཤེས་པ་དང་ལྷན་ཅིག་བྱུང་བ་ཉེ་བར་ལེན་པའི་ཕུང་པོ་བཞི་པོ་འདི་དག་ནི་མིང་དང་། 
 nāmarūpasaṃniśritāni indriyāṇi ṣaḍāyatanam |	གཟུགས་སོ་༎ མིང་དང་། གཟུགས་ལ་བརྟེན་པའི་དབང་པོ་རྣམས་ནི་སྐྱེ་མཆེད་དྲུག་གོ་།
 trayāṇāṃ dharmāṇāṃ saṃnipātaḥ sparśaḥ |	ཆོས་གསུམ་འདུས་པ་ནི་རེག་པའོ་༎
 sparśānubhavo vedanā |	རེག་པ་མྱོང་བ་ནི་ཚོར་བའོ་༎
 vedanādhyavasānaṃ tṛṣṇā |	ཚོར་བ་ལ་ཞེན་པ་ནི་སྲེད་པའོ་༎
 tṛṣṇāvaipulyamupādānam |	སྲེད་པ་འཕེལ་བ་ནི་ལེན་པའོ་༎
 upādānanirjātaṃ punarbhavajanakaṃ karma bhavaḥ |	ལེན་པ་ལས་སྐྱེས་པའང་བསྐྱེད་པའི་ལས་ནི་སྲིད་པའོ་༎
 bhavahetukaḥ skandhaprādurbhāvo jātiḥ | jātasya skandhaparipāko jarā |	རྒྱུ་དེ་ལས་ཕུང་པོ་བྱུང་བ་ནི་སྐྱེ་པའོ༏་༏སྐྱེས་ནས་ཕུང་པོ་སྨིན་པ་ནི་རྒ་བའོ་༎
 jīrṇasya skandhasya vināśo maraṇam |	རྒས་ནས་ཕུང་པོ་ཞིག་པ་ནི་འཆི་བའོ་༎
 mriyamāṇasya saṃmūḍhasya sābhiṣvaṅgasya antaḥparidāhaḥ śokaḥ |	འཆི་ཞིང་མྱོས་ཏེ་མངོན་པར་ཆགས་པ་དང་བཅས་པའི་ནང་གི་ཡོངས་སུ་གདུང་བ་ནི་མྱ་ངན་ཏོ༏། 
 śokotthamālapanaṃ paridevaḥ |	མྱ་ངན་ལས་བྱུང་བའི་ཚིག་ཏུ་སྨྲ་བ་ནི་སྨྲེ་སྔགས་འདོན་པའོ་༎
 pañcavijñānakāyasaṃyuktamasātamanubhavanaṃ duḥkham |	རྣམ་པར་ཤེས་པ་ལྔའི་ཚོགས་དང་ལྡན་པའི་མི་བདེ་བ་མྱོང་བ་ནི་སྡུག་བསྔལ་ལོ་༎
 manasikārasaṃyuktaṃ mānasaṃ duḥkhaṃ daurmanasyam |	ཡིད་ལ་བྱེད་པ་དང་ལྡན་པའི་ཡིད་ཀྱི་སྡུག་བསྔལ་ནི་ཡིད་མི་བདེ་བའོ་༎ གཞན་ཡང་།
 ye cāpi anye evamādayaḥ kleśāḥ, te upāyāsā iti ||	འདི་ལྟ་བུ་ལ་སོགས་པའི་ཉེ་བའི་ཉོན་མོངས་པ་གང་ཡིན་པ་དེ་དག་ནི་འཁྲུག་པ་ཞེས་བྱའོ་༎ 
 tatra mahāndhakārārthena avidyā |	དེ་ལ་མུན་པ་ཆེན་པོའི་ཕྱིར་མ་རིག་པའོ་༎
 abhisaṃskārārthena saṃskārāḥ |	མངོན་པར་འདུ་བྱེད་པའི་ཕྱིར་འདུ་བྱེད་རྣམས་སོ་༎
 vijñāpanārthena vijñānam |	རྣམ་པར་རིག་པའི་ཕྱིར་རྣམ་པར་ཤེས་པའོ་༎
 anyonyopastambhanārthena nāmarūpam |	རྟེན་པའི་ཕྱིར་མིང་དང་། གཟུགས་སོ་༎
 āyadvārārthena ṣaḍāyatanam |	སྐྱེ་བའི་༄༡༨༧ཨ་༌༎ སྒོའི་ཕྱིར་སྐྱེ་མཆེད་དྲུག་གོ་།
 sparśanārthena sparśaḥ |	རེག་པའི་ཕྱིར་རེག་པའོ་༎
 anubhavanārthena vedanā |	མྱོང་བའི་ཕྱིར་ཚོར་བའོ་༎
 paritarṣaṇārthena tṛṣṇā |	སྐོམ་པའི་ཕྱིར་སྲེད་པའོ་༎
 upādānarthena upādānam | punarbhavajananārthena bhavaḥ |	ཉེ་བར་ལེན་པའི་ཕྱིར་ལེན་པའོ༏་༏ཡང་སྲིད་པ་སྐྱེ་བའི་ཕྱིར་སྲིད་པའོ་༎
 skandhaprādurbhāvārthena jātiḥ |	ཕུང་པོ་འབྱུང་བའི་ཕྱིར་སྐྱེ་བའོ་༎
 skandhaparipākārthena jarā |	ཕུང་པོ་སྨིན་པའི་ཕྱིར་རྒ་བའོ་༎
 vināśārthena (śālsū, vaidya 104) maraṇam |	འཇིག་པའི་ཕྱིར་འཆི་བའོ་༎
 śocanārthena śokaḥ |	མྱ་ངན་བྱེད་པའི་ཕྱིར་མྱ་ངན་ཏོ་༎
 vacanaparidevanārthena paridevaḥ |	ཚིག་གིས་སྨྲེ་བའི་ཕྱིར་སྨྲེ་སྔགས་འདོན་པའོ་༎
 kāyasaṃpīḍanārthena duḥkham |	ལུས་ལ་གནོད་པའི་ཕྱིར་སྡུག་བསྔལ་བའོ་༎
 cittasaṃpīḍanārthena daurmanasyam |	སེམས་ལ་གནོད་པའི་ཕྱིར་ཡིད་མི་བདེ་བའོ་༎
 upakleśārthena upāyāsāḥ ||	ཉོན་མོངས་པའི་ཕྱིར་འཁྲུག་པའོ་༎
 punaraparam - tattve 'pratipattirmithyāpratipattirajñānamavidyā |	གཞན་ཡང་། དེ་ཁོ་ན་མི་རྟོགས་ཤིང་ལོག་པར་ཤེས་ཏེ་མི་ཤེས་པ་ནི་མ་རིག་པའོ་༎
 evamavidyāyāṃ satyāṃ trividhāḥ saṃskārā abhinirvartante - puṇyopagā apuṇyopagā āneñjyopagāḥ |	དེ་ལྟར་མ་རིག་པ་ཡོད་ན་འདུ་བྱེད་རྣམ་གསུམ་མངོན་པར་འགྲུབ་སྟེ༏་བསོད་ནམས་སུ་ཉེ་བར་འགྲོ་བ་དང་། བསོད་ནམས་མ་ཡིན་པར་ཉེ་བར་འགྲོ་བ་དང་། མི་ག-ཡོ་བར་ཉེ་བར་འགྲོའོ་༎ འདི་དག་ནི་མ་རིག་པའི་རྐྱེན་གྱིས་འདུ་བྱེད་རྣམས་ཞེས་བྱའོ་༎
 tatra puṇyopagānāṃ saṃskārāṇāṃ puṇyopagameva vijñānaṃ bhavati | apuṇyopagānāṃ saṃskārāṇāmapuṇyopagameva vijñānaṃ bhavati |	དེ་ལ་བསོད་ནམས་སུ་ཉེ་བར་འགྲོ་བའི་འདུ་བྱེད་རྣམས་ལས་བསོད་ནམས་སུ་ཉེ་བར་འགྲོ་བའི་རྣམ་པར་ཤེས་པ་ཉིད་དུ་འགྱུར་བ་དང་། བསོད་ནམས་མ་ཡིན་པར་ཉེ་བར་འགྲོ་བའི་འདུ་བྱེད་རྣམས་ལས་བསོད་ནམས་མ་ཡིན་པར་ཉེ་བར་འགྲོ་བའི་རྣམ་པར་ཤེས་པ་ཉིད་དུ་འགྱུར་བ་དང་། 
 āneñjyopagānāṃ saṃskārāṇāmāneñjyopagameva vijñānaṃ bhavati | idamucyate saṃskārapratyayaṃ vijñānamiti |	མི་ག-ཡོ་བར་ཉེ་བར་འགྲོ་བའི་འདུ་༄༡༨༧བ་བྱེད་རྣམས་ལས་མི་ག-ཡོ་བར་ཉེ་བར་འགྲོ་བའི་རྣམ་པར་ཤེས་པ་ཉིད་དུ་འགྱུར་བ་འདི་ནི་འདུ་བྱེད་ཀྱི་རྐྱེན་གྱིས་རྣམ་པར་ཤེས་པ་དང་། ཞེས་བྱའོ་༎ 
 vijñānasahabhuvaścatvāro 'rūpiṇaḥ skandhā nāmarūpam |	རྣམ་པར་ཤེས་པ་དང་ལྷན་ཅིག་སྐྱེས་པ་ཕུང་པོ་གཟུགས་ཅན་མ་ཡིན་དང་། ཞེས་བྱའོ་༎ པ་བཞི་དང་། 
 tadvijñānapratyayaṃ nāmarūpamucyate |	གཟུགས་གང་ཡིན་པ་དེ་ནི་རྣམ་པར་ཤེས་པའི་རྐྱེན་དང་། ཞེས་བྱའོ་༎ པ་བཞི་དང་། གྱིས་མིང་དང་། གཟུགས་ཞེས་བྱའོ་༎
 nāmarūpavivṛddhyā ṣaḍbhirāyatanadvāraiḥ kṛtyakriyāḥ pravartante |	མིང་དང་། གཟུགས་རྣམ་པར་འཕེལ་བས་སྐྱེ་མཆེད་དྲུག་གི་སྒོ་ནས་བྱ་བ་བྱེད་པ་རྣམས་འབྱུང་སྟེ་།
 tannāmarūpapratyayaṃ ṣaḍāyatanamityucyate |	དེ་ནི་མིང་དང་། གཟུགས་ཀྱི་རྐྱེན་གྱིས་སྐྱེ་མཆེད་དྲུག་ཅེས་བྱའོ་༎
 ṣaḍbhyaścāyatanebhyaḥ ṣaṭ sparśakāyāḥ pravartante |	སྐྱེ་མཆེད་དྲུག་པོ་དག་ལ་རེག་པའི་ཚོགས་དྲུག་འབྱུང་སྟེ་།
 ayaṃ ṣaḍāyatanapratyayaḥ sparśa ityucyate | yajjātīyaḥ sparśo bhavati,	དེ་ནི་སྐྱེ་མཆེད་དྲུག་གི་རྐྱེན་གྱིས་རེག་པ་ཞེས་བྱའོ་༎
 tajjātīyā vedanā pravartate |	ཇི་ལྟ་བུར་རེག་པ་འབྱུང་བ་དེ་ལྟར་བུར་ཚོར་བ་འབྱུང་སྟེ་།
 iyamucyate sparśapratyayā vedaneti |	དེ་ནི་རེག་པའི་རྐྱེན་གྱིས་ཚོར་བ་ཞེས་བྱའོ་༎
 yastāṃ vedanāṃ viśeṣeṇāsvādayati abhinandati adhyavasyati adhyavasāya tiṣṭhati, sā vedanāpratyayā tṛṣṇetyucyate |	ཚོར་བའི་བྱེ་བྲག་དེ་དག་མྱོང་བ་དང་། མངོན་པར་དགའ་བ་དང་། ལྷག་པར་ཞེན་པ་དང་། ལྷག་པར་ཞེན་ནས་འདུག་པ་དེ་ནི་ཚོར་བའི་རྐྱེན་གྱིས་སྲེད་པ་ཞེས་བྱའོ་༎
 āsvādanābhinandanādhyavasānādhyavasāyasthānādātmapriyarūpasātarūpairviyogo mā bhūditi nityamaparityāgāya yaivaṃ prārthanā,	མྱོང་བ་དང་། མངོན་པར་དགའ་བ་དང་། ལྷག་པར་ཞེན་པ་དང་། ལྷག་པར་ཞེན་ནས་འདུག་པ་ལས་བདག་སྡུག་པའི་ངོ་བོ་དང་། བདེ་བའི་ངོ་བོ་དང་འབྲལ་བར་མ་གྱུར་ཅིག་སྙམ་དུ་ཡོངས་སུ་མི་གཏོང་བར་ཕྱིར་ཞིང་སྨོན་པ་འདི་ནི་སྲེད་པའི་རྐྱེན་གྱིས་ལེན་པ་ཞེས་བྱའོ་༎ 
 idamucyate tṛṣṇāpratyayamupādānam | evaṃ prārthayamānaḥ punarbhavajanakaṃ karma samutthāpayati kāyena vācā manasā ca,	དེ་ལྟར་སྨོན་ཅིང་ཡང་སྲིད་པ་བསྐྱེད་པའི་ལས་ལུས་དང་། ངག་དང་། ཡིད་ཀྱིས་ཀུན་ནས་སློང་བ་དེ་ནི་ལེན་པའི་རྐྱེན་གྱིས་སྲིད་པ་ཞེས་བྱའོ་༎ ལས་དེ་༄༡༨༨ཨ་༌༎
 sa upādānapratyayo bhava ityucyate | tatkarmanirjātānāṃ pañcaskandhānāmabhinirvṛttiryā, sā bhavapratyayā jātirityucyate |	ལས་སྐྱེས་པའི་ཕུང་པོ་ལྔ་རྣམས་འགྲུབ་པ་གང་ཡིན་པ་དེ་ནི་སྲིད་པའི་རྐྱེན་གྱིས་སྐྱེ་བ་ཞེས་བྱའོ་༎ 
 jātyābhinirvṛttānāṃ skandhānāmupacayanaparipākādvināśo bhavati,	སྐྱེས་ནས་མངོན་དུ་འགྲུབ་པའི་ཕུང་པོ་རྣམས་ཀྱི་འཕེལ་བ་ཡོངས་སུ་སྨིན་པ་དང་ཞེས་བྱའོ་༎ 
 tadidaṃ jātipratyayaṃ jarāmaraṇamityucyate ||	། འཇིག་པར་འགྱུར་བ་དེ་ནི་སྐྱེ་བའི་རྐྱེན་གྱིས་རྒ་ཤི་ཞེས་བྱའོ་༎
 evamayaṃ dvādaśāṅgaḥ pratītyasamutpādaḥ anyonyahetukaḥ anyonyapratyayaḥ |	དེ་ལྟར་རྟེན་ཅིང་འབྲེལ་བར་འབྱུང་བའི་ཡན་ལག་བཅུ་གཉིས་པོ་འདི་དག་ནི་རྒྱུ་གཞན་དང་། གཞན་ལས་བྱུང་བ་། རྐྱེན་གཞན་དང་། གཞན་ལས་བྱུང་བ་། རྟག་པ་མ་ཡིན་།
 na nityo nānityo na saṃskṛto nāsaṃskṛto nāhetuko nāpratyayo na vedayitā na kṣayadharmo na vināśadharmo na nirodhadharmo 'nādikālapravṛtto 'nucchinno 'pravartate nadīsrotavat ||	མི་རྟག་པ་མ་ཡིན་། འདུས་བྱས་མ་ཡིན་། འདུས་མ་བྱས་མ་ཡིན་། རྒྱུ་མེད་པ་མ་ཡིན་། རྐྱེན་མེད་པ་མ་ཡིན་། མྱོང་བ་ཡོད་པ་མ་ཡིན་། ཟད་པའི་ཆོས་མ་ཡིན་། འཇིག་པའི་ཆོས་མ་ཡིན་། འགོག་པའི་ཆོས་མ་ཡིན་ཏེ་། ཐོག་མ་མེད་པའི་དུས་ནས་ཞུགས་པ་། རྒྱུན་མ་ཆད་པར་ཀླུང་གི་རྒྱུན་བཞིན་དུ་རྗེས་སུ་ཞུགས་པའོ་༎
 yadyayaṃ dvādaśāṅgaḥ pratītyasamutpādo 'nyonyahetuko 'nyonyapratyayaḥ,	རྟེན་ཅིང་འབྲེལ་བར་འབྱུང་བའི་ཡན་ལག་བཅུ་གཉིས་པོ་འདི་དག་ནི་རྒྱུ་གཞན་དང་། གཞན་ལས་བྱུང་བ་། རྐྱེན་གཞན་དང་། གཞན་ལས་བྱུང་བ་། རྟག་པ་མ་ཡིན་།
 na nityo nānityo na saṃskṛto nāsaṃskṛto nāhetuko nāpratyayo na vedayitā na kṣayadharmo na vināśadharmo na nirodhadharmo 'nādikālapravṛtto 'nucchinno 'nupravartate nadīsrotavat,	མི་རྟག་པ་མ་ཡིན་། འདུས་བྱས་མ་ཡིན་། འདུས་མ་བྱས་མ་ཡིན་། རྒྱུ་མེད་པ་མ་ཡིན་། རྐྱེན་མེད་པ་མ་ཡིན་། མྱོང་བ་ཡོད་པ་མ་ཡིན་། ཟད་པའི་ཆོས་མ་ཡིན་། འཇིག་པའི་ཆོས་མ་ཡིན་། འགོག་པའི་ཆོས་མ་ཡིན་ཏེ་། ཐོག་མ་མེད་པའི་དུས་ནས་ཞུགས་པ་། ༄༡༨༨བ་རྒྱུན་མ་ཆད་པར་ཀླུང་གི་རྒྱུན་བཞིན་དུ་རྗེས་སུ་ཞུགས་མོད་ཀྱི་།
 atha ca imānyasya dvādaśāṅgasya pratītyasamutpādasya catvāri aṅgāni saṃghātakriyāyai hetutvena pravartante |	འོན་ཀྱང་ཡན་ལག་བཞི་པོ་འདི་དག་ནི་རྟེན་ཅིང་འབྲེལ་བར་འབྱུང་བའི་ཡན་ལག་བཅུ་གཉིས་པོ་དེ་དག་བསྡུ་བར་བྱ་བའི་རྒྱུར་འགྱུར་རོ་༎
 katamāni catvāri?	བཞི་གང་ཞེ་ན་།
 yaduta avidyā tṛṣṇā karma vijñānaṃ ca |	འདི་ལྟ་སྟེ་། མ་རིག་པ་དང་། སྲེད་པ་དང་། ལས་དང་། རྣམ་པར་ཤེས་པའོ་༎
 tatra vijñānaṃ bījasvabhāvatvena hetuḥ | karma kṣetrasvabhāvena hetuḥ |	དེ་ལ་རྣམ་པར་ཤེས་པ་ནི་ས་བོན་གྱི་རང་བཞིན་གྱིས་རྒྱུ་བྱེད་དོ༏་༏ལས་ནི་ཞིང་གི་རང་བཞིན་གྱིས་རྒྱུ་བྱེད་དོ་༎
 avidyā tṛṣṇā ca kleśasvabhāvatvena hetuḥ |	མ་རིག་པ་དང་། སྲེད་པ་ནི་ཉོན་མོངས་པའི་རང་བཞིན་གྱིས་རྒྱུ་བྱེད་དོ་༎
 tatra karmakleśā vijñānabījaṃ janayanti |	དེ་ལ་ལས་དང་། ཉོན་མོངས་པ་དག་ནི་ས་བོན་རྣམ་པར་ཤེས་པ་སྐྱེད་དོ་༎
 tatra karma vijñānabījasya kṣetrakāryaṃ karoti |	དེ་ལ་ལས་ནི་ས་བོན་རྣམ་པར་ཤེས་པའི་ཞིང་གི་བྱ་བ་བྱེད་དོ་༎
 tṛṣṇā vijñānabījaṃ snehayati |	སྲེད་པ་ནི་ས་བོན་རྣམ་པར་ཤེས་པ་རླན་པར་བྱེད་དོ་༎
 avidyā vijñānabījamavakirati |	མ་རིག་པ་ནི་ས་བོན་རྣམ་པར་ཤེས་པ་འདེབས་ཏེ་།
 asatāmeṣāṃ pratyayānāṃ vijñānabījasyābhinirvṛttirna bhavati |	རྐྱེན་འདི་དག་མེད་ན་ས་བོན་རྣམ་པར་ཤེས་པ་མངོན་པར་འགྲུབ་པར་མི་འགྱུར་རོ་༎
 tatra karmaṇo naivaṃ bhavati - ahaṃ vijñānabījasya kṣetrakāryaṃ karomīti |	དེ་ལ་ལས་ཀྱང་འདི་སྙམ་དུ་བདག་གིས་ས་བོན་རྣམ་པར་ཤེས་པའི་ཞིང་གི་བྱ་བ་བྱའོ་སྙམ་དུ་མི་སེམས་སོ་༎
 tṛṣṇāyā api naivaṃ bhavati - ahaṃ vijñānabījaṃ snehayāmīti |	སྲེད་པའང་འདི་སྙམ་དུ་བདག་གིས་ས་བོན་རྣམ་པར་ཤེས་པ་བརླན་པར་བྱའོ་སྙམ་དུ་མི་སེམས་སོ་༎ 
 avidyāyā api naivaṃ bhavati - ahaṃ vijñānabījamavakirāmīti |	མ་རིག་པའང་འདི་སྙམ་དུ་བདག་གིས་ས་བོན་རྣམ་པར་ཤེས་པ་གདབ་བོ་སྙམ་དུ་སོ་༎ 
 vijñānabījasyāpi naivaṃ bhavati - ahamebhiḥ pratyayairjanitamiti |	མི་སེམས་སོ་༎ ས་བོན་རྣམ་པར་ཤེས་པའང་འདི་སྙམ་དུ་བདག་ནི་རྐྱེན་འདི་དག་གིས་བསྐྱེད་དོ་སྙམ་དུ་མི་སེམས་ཏེ་།
 atha ca vijñānabījaṃ karmakṣetrapratiṣṭhitaṃ tṛṣṇāsnehābhiṣyanditamavidyayā svavakīrṇaṃ virohati |	༄༡༨༩ཨ་༌༎ འོན་ཀྱང་ས་བོན་རྣམ་པར་ཤེས་པ་ལས་ཀྱི་ཞིང་ལ་བརྟེན་པ་། སྲེད་པའི་རླན་གྱིས་བརླན་པ་། མ་རིག་པའི་ལུད་ཀྱིས་བྲན་པ་།
 tatratatra upapattyāyatanapratisaṃdhau mātuḥkukṣau nāmarūpāṅkuramabhinirvartayati |	སྐྱེ་བ་ན་སྐྱེ་བའི་གནས་ཉིང་མཚམས་སྦྱོར་བ་། མའི་མངལ་དེ་དང་། དེར་མིང་དང་། གཟུགས་ཀྱི་མྱུ་གུ་མངོན་པར་འགྲུབ་སྟེ་། མིང་དང་། གཟུགས་ཀྱི་མྱུ་གུ་དེའང་བདག་གིས་མ་བྱས་།
 sa ca nāmarūpāṅkuro na svayaṃkṛto na parakṛto nobhayakṛto (śālsū, vaidya 105)	གཞན་གྱིས་མ་བྱས་། གཉིས་ཀས་མ་བྱས་། དབང་ཕྱུག་གིས་མ་བྱས་།
 neśvarakṛto na kālapariṇāmito na prakṛtisaṃbhūto na caikakāraṇādhīno nāpyahetusamutpannaḥ |	དུས་ཀྱིས་མ་བསྒྱུར་། རང་བཞིན་ལས་མ་བྱུང་། བྱེད་པ་ལ་རག་ལས་པ་མ་ཡིན་། རྒྱུ་མེད་པ་ལས་ཀྱང་མ་སྐྱེས་ཏེ་། འོན་ཀྱང་ཕ་དང་མ་ཕྲད་པ་དང་། ཟླ་མཚན་དང་ལྡན་པ་དང་། རྐྱེན་གཞན་ཡང་འཚོགས་ན་བདག་པོ་མེད་པའི་ཆོས་། བདག་གི་མེད་པ་། འཛིན་པ་མེད་པ་། ནམ་མཁའ་དང་མཚུངས་པ་།
 atha ca mātāpitṛsaṃyogadṛtusamavāyādanyeṣāṃ ca pratyayānāṃ samavāyāt tatra tatra āsvādaviddhaṃ vijñānabījamupapattyāyatanapratisaṃghau mātuḥ kukṣau nāmarūpāṅkuramabhinirvartayati, asvāmikeṣu dharmeṣu amameṣu aparigraheṣu ākāśasameṣu māyālakṣaṇasvabhāveṣu hetupratyayānāmavaikalyāt |	སྒྱུ་མའི་མཚན་ཉིད་ཀྱི་རང་བཞིན་དག་ལ་རྒྱུ་དང་། རྐྱེན་མ་ཚང་བ་མེད་པའི་ཕྱིར་སྐྱེ་བའི་གནས་ཉིང་མཚམས་སྦྱོར་བ་མའི་མངལ་དེ་དང་། དེར་མྱོང་བ་དང་ལྡན་པའི་ས་བོན་རྣམ་པར་ཤེས་པ་མིང་དང་། གཟུགས་ཀྱི་མྱུ་གུ་མངོན་པར་འགྲུབ་བོ་༎
 tadyathā - pañcabhiḥ kāraṇaiḥ cakṣurvijñānamutpadyate |	འདི་ལྟ་སྟེ་། མིག་གི་རྣམ་པར་ཤེས་པ་ནི་རྒྱུ་ལྔས་འབྱུང་སྟེ་།
 katamaiḥ pañcabhiḥ?	ལྔ་གང་ཞེ་ན་།
 yaduta cakṣuḥ pratītya rūpaṃ ca ālokaṃ ca ākāśaṃ ca tajjamanasikāraṃ ca pratītya utpadyate cakṣurvijñānam |	མིག་ལ་བརྟེན་པ་དང་། གཟུགས་དང་། སྣང་བ་དང་། ནམ་མཁའ་དང་། དེ་སྐྱེད་པའི་ཡིད་ལ་བྱེད་པ་ལའང་བརྟེན་ནས་མིག་གི་རྣམ་པར་ཤེས་པ་འབྱུང་ངོ་༎
 tatra cakṣurvijñānasya cakṣurāśrayakṛtyaṃ karoti |	དེ་ལ་མིག་ནི་མིག་གི་རྣམ་པར་༄༡༨༩བ་ཤེས་པའི་རྟེན་གྱི་བྱ་བ་བྱེད་དོ་༎
 rūpaṃ cakṣurvijñānasya ālambanakṛtyaṃ karoti |	གཟུགས་ནི་མིག་གི་རྣམ་པར་ཤེས་པའི་དམིགས་པའི་བྱ་བ་བྱེད་དོ་༎
 ālokaḥ avabhāsakṛtyaṃ karoti |	སྣང་བ་ནི་མངོན་པའི་བྱ་བ་བྱེད་དོ་༎
 ākāśamanāvaraṇakṛtyaṃ karoti | tajjamanasikāraḥ samanvāhārakṛtyaṃ	ནམ་མཁའ་ནི་མི་སྒྲིབ་པའི་བྱ་བ་བྱེད་དོ༏་༏དེ་དང་འབྱུང་བ་ཡིད་ལ་བྱེད་པ་ནི་བསམ་པའི་བྱ་བ་བྱེད་དོ་༎
 karoti | asatāmeṣāṃ pratyayānāṃ cakṣurvijñānaṃ notpadyate |	རྐྱེན་དེ་དག་མེད་ན་མིག་གི་རྣམ་པར་ཤེས་པ་འབྱུང་བར་མི་འགྱུར་གྱི་།
 yadā tu cakṣurādhyātmikamāyatanamavikalaṃ bhavati,	གང་གི་ཚེ་ནང་གི་སྐྱེ་མཆེད་མིག་མ་ཚང་བར་མ་གྱུར་ལ་།
 evaṃ rūpālokākāśatajjamanasikārāśca avikalā bhavanti,	དེ་བཞིན་དུ་གཟུགས་དང་། སྣང་བ་དང་། ནམ་མཁའ་དང་། དེ་དང་། འབྱུང་བ་ཡིད་ལ་བྱེད་པ་དག་མ་ཚང་བར་མ་གྱུར་ཏེ་།
 tataḥ sarveṣāṃ samavāyāccakṣurvijñānamutpadyate |	ཐམས་ཅད་འདུས་པ་དེ་ལས་མིག་གི་རྣམ་པར་ཤེས་པ་འབྱུང་བར་འགྱུར་རོ་༎
 tatra cakṣuṣo naivaṃ bhavati - ahaṃ cakṣurvijñānasyāśrayakṛtyaṃ karomīti |	དེ་ལ་མིག་ནི་འདི་སྙམ་དུ་བདག་གིས་མིག་གི་རྣམ་པར་ཤེས་པའི་རྟེན་གྱི་བྱ་བ་བྱའོ་སྙམ་དུ་མི་སེམས་སོ་༎
 rūpasyāpi naivaṃ bhavati - ahaṃ cakṣurvijñānasya ālambanakṛtyaṃ karomīti |	གཟུགས་ཀྱང་འདི་སྙམ་དུ་བདག་གིས་མིག་གི་རྣམ་པར་ཤེས་པའི་དམིགས་པའི་བྱ་བ་བྱའོ་སྙམ་དུ་མི་སེམས་སོ་༎ 
 ālokasyāpi naivaṃ bhavati - ahaṃ cakṣurvijñānasya avabhāsakṛtyaṃ karomīti |	སྣང་བའང་འདི་སྙམ་དུ་བདག་གིས་མིག་གི་རྣམ་པར་ཤེས་པའི་མངོན་པའི་བྱ་བ་བྱའོ་སྙམ་དུ་མི་སེམས་སོ་༎
 ākāśasyāpi naivaṃ bhavati - ahaṃ cakṣurvijñānasya anāvaraṇakṛtyaṃ karomīti |	ནམ་མཁའ་ཡང་འདི་སྙམ་དུ་བདག་གིས་མིག་གི་རྣམ་པར་ཤེས་པའི་མི་སྒྲིབ་པའི་བྱ་བ་བྱའོ་སྙམ་དུ་མི་སེམས་སོ་༎
 tajjamanasikārasyāpi naivaṃ bhavati - ahaṃ cakṣurvijñānasya samanvāhārakṛtyaṃ karomīti |	དེ་དང་། འབྱུང་བའི་ཡིད་ལ་བྱེད་པའང་འདི་སྙམ་དུ་བདག་གིས་མིག་གི་རྣམ་པར་ཤེས་པའི་བསམ་པའི་བྱ་བ་བྱའོ་སྙམ་དུ་མི་སེམས་སོ་༎
 cakṣurvijñānasyāpi naivaṃ bhavati - ahamebhiḥ pratyayairjanitamiti |	མིག་གི་རྣམ་པར་ཤེས་པའང་འདི་སྙམ་དུ་བདག་ནི་རྐྱེན་འདི་དག་གིས་བསྐྱེད་དོ་སྙམ་དུ་༄༡༩༠ཨ་༌༎ མི་སེམས་ཏེ་།
 atha ca punaḥ satsu eṣu pratyayeṣu cakṣurvijñānasyotpattirbhavati |	འོན་ཀྱང་རྐྱེན་འདི་དག་ཡོད་པ་ལས་མིག་གི་རྣམ་པར་ཤེས་པ་སྐྱེ་བར་འགྱུར་རོ་༎
 evaṃ śeṣāṇāmindriyāṇāṃ yathāyogaṃ yojyam ||	དེ་བཞིན་དུ་དབང་པོ་ལྷག་མ་རྣམས་ཀྱང་ཅི་རིགས་སུ་སྦྱར་རོ་༎
 tatra na kaściddharmo 'smāllokāt paralokaṃ saṃkrāmati |	དེ་ལ་ཆོས་གང་ཡང་འཇིག་རྟེན་འདི་ནས་འཇིག་རྟེན་ཕ་རོལ་ཏུ་མི་འཕོ་མོད་ཀྱི་།
 asti ca karmaphalaprativijñaptiḥ, hetupratyayānāmavaikalyāt |	རྒྱུ་དང་། རྐྱེན་མ་ཚང་བ་མེད་པའི་ཕྱིར་ལས་ཀྱི་འབྲས་བུར་མངོན་པའང་ཡོད་དོ་༎
 tadyathā supariśuddhe ādarśamaṇḍale mukhapratibimbakaṃ dṛśyate | na ca tatra ādarśamaṇḍale mukhaṃ saṃkrāmati | asti ca mukhaprativijñaptiḥ,	འདི་ལྟ་སྟེ་། དཔེར་ན་། རབ་ཏུ་ཕྱིས་པའི་མེ་ལོང་གི་དཀྱིལ་འཁོར་ལ་བཞིན་གྱི་གཟུགས་བརྙན་སྣང་བའང་བཞིན་མེ་ལོང་གི་དཀྱིལ་འཁོར་དུ་མ་འཕོས་མོད་ཀྱི་།
 hetupratyayānāmavaikalyāt |	རྒྱུ་དང་། རྐྱེན་མ་ཚང་བ་མེད་པའི་ཕྱིར་བཞིན་དུ་མངོན་པའང་ཡོད་དོ་༎
 evamasmāllokāt na kaścit cyutaḥ, nāpyanyatropapannaḥ |	དེ་བཞིན་དུ་འདི་ནས་ཀྱང་སུའང་ཤི་འཕོས་པ་མེད་ལ་གཞན་དུའང་མ་སྐྱེས་ཏེ་།
 asti ca karmaphalaprativijñaptiḥ, hetupratyayānāmavaikalyāt |	རྒྱུ་དང་། རྐྱེན་རྣམས་མ་ཚང་བ་མེད་པའི་ཕྱིར་ལས་ཀྱི་འབྲས་བུ་མངོན་པའང་ཡོད་དོ་༎
 tadyathā candramaṇḍalaṃ catvāriṃśadyojanaśatamūrdhvaṃ vrajati |	འདི་ལྟ་སྟེ་། དཔེར་ན་། ཟླ་བའི་དཀྱིལ་འཁོར་ནི་དཔག་ཚད་བཞི་ཁྲི་ཉིས་སྟོང་ནས་འགྲོ་སྟེ་།
 atha ca punaḥ parītte 'bhyudakabhājane candrasya pratibimbaṃ dṛśyate | na ca candramaṇḍalaṃ tasmātsthānāccyutam,	འོན་ཀྱང་སྣོད་ཆུང་ངུ་ཆུས་གང་བར་ཟླ་བའི་དཀྱིལ་འཁོར་གྱི་གཟུགས་བརྙན་སྣང་བའང་ཟླ་བའི་དཀྱིལ་འཁོར་ནི་གནས་དེ་ནས་མ་འཕོས་ཏེ་།
 parītte udakasya bhājane saṃkrāntaṃ bhavati |	སྣོད་ཆུང་ངུ་ཆུས་གང་བའི་ནང་དུ་སོང་བའང་མེད་མོད་ཀྱི་།
 asti ca candramaṇḍalaprativijñaptiḥ, hetupratyayānāmavaikalyāt |	རྒྱུ་དང་། རྐྱེན་མ་ཚང་བ་མེད་པའི་ཕྱིར་ཟླ་བའི་དཀྱིལ་འཁོར་དུ་མངོན་པའང་ཡོད་དོ་༎
 evamasmāllokānna kaścit cyutaḥ, nāpyanyatropapannaḥ |	དེ་བཞིན་དུ་འདི་ནས་ཀྱང་སུའང་ཤི་འཕོས་པ་མེད་ལ་གཞན་དུའང་མ་སྐྱེས་མོད་ཀྱི་།
 asti ca karmaphalaprativijñaptiḥ, hetupratyayānāmavaikalyāt ||	རྒྱུ་དང་། རྐྱེན་༄༡༩༠བ་རྣམས་མ་ཚང་བ་མེད་པའི་ཕྱིར་ལས་ཀྱི་འབྲས་བུ་མངོན་པའང་ཡོད་དོ་༎ འདི་ལྟ་སྟེ་།
 tadyathā agnirupādānapratyaye sati jvalati,	དཔེར་ན་། མེ་ནི་རྒྱུ་དང་། རྐྱེན་མ་ཚང་ན་མི་འབར་གྱི་།
 upādānavaikalyānna jvalati,	རྒྱུ་དང་། རྐྱེན་འཚོགས་པ་ལས་འབར་རོ་༎ དེ་བཞིན་དུ་བདག་པོ་མེད་པའི་ཆོས་། བདག་གི་མེད་པ་། འཛིན་པ་མེད་པ་། ནམ་མཁའ་དང་མཚུངས་པ་།
 evameva karmakleśajanitaṃ vijñānabījaṃ tatra tatra upapattyāyatanapratisaṃghau mātuḥ kukṣau nāmarūpāṅkuramabhinirvartayati, asvāmikeṣu dharmeṣu amameṣu aparigraheṣu ākāśasameṣu māyālakṣaṇasvabhāveṣu hetupratyayānāmavaikalyāt |	སྒྱུ་མའི་མཚན་ཉིད་ཀྱི་རང་བཞིན་དག་ལ་རྒྱུ་དང་། རྐྱེན་རྣམས་མ་ཚང་བ་མེད་པའི་ཕྱིར་སྐྱེ་བའི་གནས་ཉིང་མཚམས་སྦྱོར་བ་མའི་མངལ་དེ་དང་། དེར་ས་བོན་རྣམ་པར་ཤེས་པ་ལས་དང་། ཉོན་མོངས་པ་རྣམས་ཀྱིས་བསྐྱེད་པ་མིང་དང་། གཟུགས་ཀྱི་མྱུ་གུ་མངོན་པར་འགྲུབ་སྟེ་།
 evaṃ ādhyātmikasya pratītyasamutpādasya pratyayopanibandho draṣṭavyaḥ ||	དེ་ལྟར་ནང་གི་རྟེན་ཅིང་འབྲེལ་བར་འབྱུང་བ་རྐྱེན་དང་འབྲེལ་བར་བལྟའོ་༎
 tatra ādhyātmikaḥ pratītyasamutpādaḥ pañcabhirākārairdraṣṭavyaḥ |	དེ་ལ་ནང་གི་རྟེན་ཅིང་འབྲེལ་བར་འབྱུང་བ་རྣམ་པ་ལྔར་བལྟ་སྟེ་།
 katamaiḥ pañcabhiḥ? na śāśvatataḥ, nocchedataḥ,	ལྔ་གང་ཞེ་ན་།
 na saṃkrāntitaḥ, parīttahetuto vipulaphalābhinirvṛttataḥ, tatsadṛśānuprabandhataśceti |	རྟག་པར་མ་ཡིན་པ་དང་། ཆད་པར་མ་ཡིན་པ་དང་། འཕོ་བར་མ་ཡིན་པ་དང་། རྒྱུ་ཆུང་ངུ་ལས་འབྲས་བུ་ཆེན་པོ་འབྱུང་བ་དང་། དེ་དང་འདྲ་བའི་རྒྱུད་དུའོ་༎
 kathaṃ na śāśvatataḥ? yasmādanye māraṇāntikāḥ skandhāḥ,	ཇི་ལྟར་རྟག་པར་མ་ཡིན་ཞེ་ན༏་གང་གི་ཕྱིར་ཐ་མའི་འཆི་བའི་ཕུང་པོ་རྣམས་ཀྱང་གཞན་ལ་། 
 anye aupapattyaṃśikāḥ (śālsū, vaidya 106) skandhāḥ, na tu ya evaṃ māraṇāntikāḥ skandhāḥ, ta eva aupapattyaṃśikāḥ |	སྐྱེ་བའི་ཆར་གཏོགས་པ་རྣམས་ཀྱང་གཞན་ཏེ་།
 api tu māraṇāntikāḥ skandhā nirudhyante, tasminneva ca samaye aupapattyaṃśikāḥ skandhāḥ prādurbhavanti | ato na śāśvatataḥ ||	ཐ་མ་འཆི་བའི་ཕུང་པོ་གང་ཡིན་པ་དེ་ཉིད་སྐྱེ་བའི་ཆར་གཏོགས་པ་རྣམས་མ་ཡིན་གྱི་། ཐ་མའི་འཆི་བའི་ཕུང་པོ་རྣམས་ཀྱང་འགག་ལ་སྐྱེ་བའི་ཆར་གཏོགས་པའི་ཕུང་པོ་རྣམས་ཀྱང་འབྱུང་བས་དེའི་ཕྱིར་རྟག་པར་མ་ཡིན་ནོ་༎
 kathaṃ nocchedataḥ?	ཇི་ལྟར་ཆད་པར་༄༡༩༡ཨ་༌༎ མ་ཡིན་ཞེ་ན་།
 na ca pūrvaniruddheṣu māraṇāntikeṣu skandheṣu aupapattyaṃśikāḥ skandhāḥ prādurbhavanti,	ཐ་མའི་འཆི་བའི་ཕུང་པོ་རྣམས་སྔོན་འགགས་པ་ལས་སྐྱེ་བའི་ཆར་གཏོགས་པའི་ཕུང་པོ་རྣམས་འབྱུང་བ་མ་ཡིན་། 
 nāpyaniruddheṣu |	མ་འགགས་པ་ལས་ཀྱང་མ་ཡིན་གྱི་།
 api tu māraṇāntikāḥ skandhā nirudhyante,	ཐ་མའི་འཆི་བའི་ཕུང་པོ་རྣམས་ཀྱང་འགགས་ལ་།
 tasminneva ca samaye aupapattyaṃśikāḥ skandhāḥ prādurbhavanti tulādaṇḍonnāmāvanāmavat |	དེ་ཉིད་ཀྱི་ཚེ་སྐྱེ་བའི་ཆར་གཏོགས་པའི་ཕུང་པོ་རྣམས་སྲད་མདའི་མཐོ་དམའ་བཞིན་འབྱུང་བར་འགྱུར་ཏེ་། 
 ato nocchedataḥ ||	དེའི་ཕྱིར་ཆད་པར་མ་ཡིན་ནོ་༎
 kathaṃ na saṃkrāntitaḥ?	ཇི་ལྟར་འཕོ་བར་མ་ཡིན་ཞེ་ན་།
 visadṛśāḥ sattvanikāyāḥ sabhāgāyāṃ jātyāṃ jātimabhinirvartayanti | ato na saṃkrāntitaḥ |	སེམས་ཅན་གྱི་རིས་མི་འདྲ་བ་ནས་སྐལ་བ་མཉམ་པའི་སྐྱེ་བར་སྐྱེ་བ་མངོན་པར་སྒྲུབ་པས་དེའི་ཕྱིར་འཕོ་བར་མ་ཡིན་ནོ་༎
 kathaṃ parīttahetuto vipulaphalābhinirvṛttitaḥ?	ཇི་ལྟར་རྒྱུ་ཆུང་ངུ་ལས་འབྲས་བུ་ཆེན་པོ་འབྱུང་ཞེ་ན་།
 parīttaṃ karma kriyate, vipulaḥ phalavipāko 'nubhūyate |	ལས་ཆུང་ངུ་བྱས་པ་ལས་འབྲས་བུ་ཆེན་པོའི་རྣམ་པར་སྨིན་པ་མྱོང་སྟེ་།
 ataḥ parīttahetuto vipulaphalābhinirvṛttitaḥ ||	དེའི་ཕྱིར་རྒྱུ་ཆུང་ངུ་ལས་འབྲས་བུ་ཆེན་པོ་མངོན་པར་འགྲུབ་བོ་༎
 kathaṃ tatsadṛśānuprabandhataḥ? yathāvedanīyaṃ karma kriyate, tathāvedanīyo vipāko 'nubhūyate | atastatsadṛśānuprabandhataśca || evamādhyātmikaḥ pratītyasamutpādaḥ pañcabhirākārairdraṣṭavyaḥ ||	ཇི་ལྟར་མྱོང་བར་འགྱུར་བའི་ལས་བྱས་པ་དེ་ལྟར་མྱོང་བར་འགྱུར་བའི་རྣམ་པར་སྨིན་པ་མྱོང་བས་དེའི་ཕྱིར་དེ་དང་འདྲ་བའི་རྒྱུད་དུའོ་༎ བཙུན་པ་ཤའ་རིའི་བུ་།
 yaḥ kaścid bhadanta śāriputra imaṃ pratītyasamutpādaṃ bhagavatā samyakpraṇītamevaṃ yathābhūtaṃ samyakprajñayā satatasamitamajīvaṃ nirjīvaṃ yathāvadaviparītamajātamabhūtamakṛtamasaṃskṛtamapratighamanālambaṃ śivamabhayamanāhāryamavyayamavyupaśamasvabhāvaṃ paśyati, asataḥ tucchataḥ riktataḥ asārataḥ rogataḥ gaṇḍataḥ śalyataḥ aghataḥ anityataḥ duḥkhataḥ śūnyataḥ anātmataḥ samanupaśyati,	རྟེན་ཅིང་འབྲེལ་པར་འབྱུང་བ་བཅོམ་ལྡན་འདས་ཀྱིས་ཡང་དག་པར་གསུངས་པ་འདི་གང་ལ་ལ་ཞིག་གིས་ཡང་དག་པའི་ཤེས་རབ་ཀྱིས་དེ་ལྟར་ཡང་དག་པ་ཇི་ལྟ་བ་བཞིན་དུ་རྟག་པར་རྒྱུན་དུ་སྲོག་མེད་པ་དང་། སྲོག་དང་བྲལ་བ་དང་། ཇི་ལྟ་བུ་ཉིད་དང་། མ་ནོར་བ་དང་། མ་སྐྱེས་པ་དང་། མ་བྱུང་༄༡༩༡བ་བ་དང་། མ་བྱས་པ་དང་། འདུས་མ་བྱས་པ་དང་། ཐོགས་པ་མེད་པ་དང་། དམིགས་པ་མེད་པ་དང་། ཞི་བ་དང་། འཇིགས་པ་མེད་པ་དང་། མི་འཕྲོགས་པ་དང་། ཟད་པ་མེད་པ་དང༏་རྣམ་པར་ཞི་བ་མ་ཡིན་པའི་རང་བཞིན་དུ་མཐོང་བ་དང་། མེད་པ་དང་། གསོག་དང་། གསོབ་དང་། སྙིང་པོ་མེད་པ་དང་། ནད་དང་། འབྲས་དང་། ཟུག་རྔུ་དང་། སྡིག་པ་དང་། མི་རྟག་པ་དང་། སྡུག་བསྔལ་བ་དང་། སྟོང་པ་དང་། བདག་མེད་པར་ཡང་དག་པར་རྗེས་སུ་མཐོང་བ་དེ་ནི་ཅི་བདག་འདས་པའི་དུས་ན་བྱུང་བ་ཞིག་གམ་། 
 na sa pūrvāntaṃ pratisarati - kiṃ nvahamabhūvamatīte 'dhvani,	འོན་ཏེ་བདག་འདས་པའི་དུས་ན་མ་བྱུང་བ་ཞིག་།
 kathaṃ nvahamabhūvamatīte 'dhvani iti |	བདག་འདས་པའི་དུས་ན་ཅིར་གྱུར་པ་ཞིག་།
 aparāntaṃ vā na punaḥ pratisarati - kiṃ nvahaṃ bhaviṣyāmyanāgate 'dhvani,	བདག་འདས་པའི་དུས་ན་ཇི་ལྟ་བུར་གྱུར་པ་ཞིག་གུ་སྙམ་དུ་སྔོན་གྱི་མཐའ་ལ་མི་རྟོག་གོ་། 
 āhosvinna bhaviṣyāmyanāgate 'dhvani,	ཅི་མ་འོངས་པའི་དུས་ན་འབྱུང་བར་འགྱུར་རམ་། འོན་ཏེ་མ་འོངས་པའི་དུས་ན་འབྱུང་བར་མི་འགྱུར་།
 ko nu bhaviṣyāmyanāgate 'dhvani,	མ་འོངས་པའི་དུས་ན་ཅིར་འགྱུར་།
 kathaṃ nu bhaviṣyāmyanāgate 'dhvani iti | pratyutpannaṃ vā punarnaṃ pratisarati - kiṃ nvidam,	མ་འོངས་པའི་དུས་ན་ཇི་ལྟ་བུ་ཞིག་ཏུ་འགྱུར་སྙམ་དུ་ཕྱི་མའི་མཐའ་ལ་མི་རྟོག་གོ་། འདི་ཅི་ཞིག་།
 kathaṃ nvidam,	འདི་ཇི་ལྟ་བུ་ཞིག་།
 ke santaḥ ke bhaviṣyāmaḥ,	ཅི་ཞིག་ཡོད་།
 ime sattvāḥ kuta āgatāḥ,	ཅིར་འགྱུར་། སེམས་ཅན་འདི་དག་གང་ནས་འོངས་།
 itaścyutāḥ kutra gamiṣyantīti |	འདི་ནས་ཤི་འཕོས་ནས་གང་དུ་འགྲོ་བར་འགྱུར་ཞེས་ད་ལྟར་བྱུང་བ་ལའང་མི་རྟོག་གོ་།
 yāni ekeṣāṃ śramaṇabrāhmaṇānāṃ pṛthag loke dṛṣṭigatāni bhaviṣyanti,	འཇིག་རྟེན་ན་དགེ་སྦྱོང་ངམ་། བྲམ་ཟེ་དག་གི་ལྟ་བར་སོང་བ་ཐ་དད་པ་གང་དག་ཡོད་པ་། འདི་ལྟ་སྟེ་། བདག་ཏུ་སྨྲ་བ་དང་ལྡན་པའམ་། སེམས་ཅན་དུ་སྨྲ་བ་དང་༄༡༩༢ཨ་༌༎ ལྡན་པའམ་། སྲོག་ཏུ་སྨྲ་བ་དང་ལྡན་པའམ་། གང་ཟག་ཏུ་སྨྲ་བ་དང་ལྡན་པའམ་།
 tadyathā - ātmavādapratisaṃyuktāni sattvavādapratisaṃyuktāni jīvavādapratisaṃyuktāni pudgalavādapratisaṃyuktāni kautukamaṅgalavādapratisaṃyuktāni unmiñjitāni nimiñjitāni ca,	དགེ་མཚན་དང་། བཀྲ་ཤིས་སུ་སྨྲ་བ་དང་ལྡན་པ་དག་ཀྱང་རུང་སྟེ་།
 tānyasya tasmin samaye prahīṇāni bhavanti parijñātāni samucchinnamūlāni tālamastakavadanābhāsagatāni āyatyāmanutpādānirodhadharmāṇi ||	ལྷག་པར་ག-ཡོ་བ་དང་བྲལ་བར་ག-ཡོ་བ་དེ་དག་དེའི་ཚེ་ན་དེས་སྤངས་པར་འགྱུར་ཏེ་། ཡོངས་སུ་ཤེས་ནས་རྩ་བ་ནས་བཅད་དེ་། ཏ་ལའི་མགོ་བཞིན་མི་སྣང་བའི་རང་བཞིན་དུ་ཕྱིས་མི་སྐྱེ་མི་འགག་པའི་ཆོས་ཅན་དུ་འགྱུར་རོ་༎ 
 yo bhadanta śāriputra evaṃvidhadharmakṣāntisamanvitaḥ pratītyasamutpādaṃ samyagavagacchati,	བཙུན་པ་ཤའ་རིའི་བུ་། གང་ལ་ལ་ཆོས་ལ་བཟོད་པ་འདི་ལྟ་བུ་དང་ལྡན་ཏེ་། རྟེན་ཅིང་འབྲེལ་བར་འབྱུང་བའང་ཡང་དག་པར་ཁོང་དུ་ཆུད་ན་དེ་ལ་དེ་བཞིན་གཤེགས་པ་། དགྲ་བཅོམ་པ་། ཡང་དག་པར་རྫོགས་པའི་སངས་རྒྱས་། རིག་པ་དང་། ཞབས་སུ་ལྡན་པ་།
 tasya tathāgato 'rhan samyaksaṃbuddho vidyācaraṇasaṃpannaḥ sugato lokavit puruṣadamyasārathiranattaraḥ	བདེ་བར་གཤེགས་པ་། འཇིག་རྟེན་མཁྱེན་པ་། སྐྱེས་བུ་འདུལ་བའི་ཁ་ལོ་སྒྱུར་བ་།
 śāstā devamanuṣyāṇāṃ buddho bhagavān samyaksaṃbodhiṃ vyākaroti - samyaksaṃbuddho	བླ་ན་མེད་པ་། ལྷ་དང་མི་རྣམས་ཀྱི་སྟོན་པ་། སངས་རྒྱས་བཅོམ་ལྡན་འདས་ཀྱིས་ཡང་དག་པར་རྫོགས་པའི་སངས་རྒྱས་སུ་འགྱུར་རོ་ཞེས་བླ་ན་མེད་པ་ཡང་དག་པར་རྫོགས་པའི་བྱང་ཆུབ་ཏུ་ལུང་བསྟན་ཏོ་༎ 
 buddho bhaviṣyasīti | maitreyeṇa bodhisattvena mahāsattvena evamuktam ||	བྱང་ཆུབ་སེམས་དཔའ་སེམས་དཔའ་ཆེན་པོ་བྱམས་པས་དེ་སྐད་ཅེས་སྨྲས་ནས་། ཚེ་དང་ལྡན་པ་ཤའ་རིའི་བུ་དང་། ལྷ་དང་། མི་དང༏་ལྷ་མ་ཡིན་དང་། དྲི་ཟར་བཅས་པའི་འཇིག་རྟེན་ཡི་རངས་ཏེ་།
 atha khalvāyuṣmān śāriputro maitreyasya bodhisattvasya mahāsattvasya bhāṣitamabhinandya anupramodya utthāyāsanāt prakrāntaḥ | prakrāntāste ca bhikṣavaḥ ||	བྱང་ཆུབ་སེམས་དཔའ་སེམས་དཔའ་ཆེན་པོ་བྱམས་པས་བཤད་པ་ལ་མངོན་པར་བསྟོད་དོ་༎
