skt	tib
 ārya maitreyavyākaraṇaṃ namaḥ āryamaitreyāya |	༄༤༨༩བ་། །༌༎ རྒྱ་གར་སྐད་དུ་། ཨའརྱ་མེཨེ་ཏྲི་ཡ་བཡའ་ཀ་ར་ན་། བོད་སྐད་དུ་། འཕགས་པ་བྱམས་པ་ལུང་བསྟན་པ་། འཕགས་པ་༄༤༩༠ཨ་༌༎ བྱམས་པ་ལ་ཕྱག་འཚལ་ལོ་༎
 śāriputro mahāprajñaḥ dharmasenāpatibibhuḥ |	ཆོས་ཀྱི་སྡེ་དཔོན་ཁྱབ་བདག་དཔལ་༎ ཤེས་རབ་ཆེན་པོ་ཤའ་རིའི་བུས་༎
 lokānāmanukampāya śāstāraṃ paryapṛcchata || mvyā_1 ||	འཇིག་རྟེན་རྣམས་ལ་སྙིང་བརྩེའི་ཕྱིར་༎ སྟོན་པ་ལ་ནི་ཡོངས་ཞུས་པ་༎
 sūtrāntare purā 'khyātaṃ yaṃ lokanāyakasya ca |	སྔོན་དང་ཕྱི་མཐའི་མདོ་ལས་ནི་༎
 buddhasyānāgatasya hi maitreyanāma śāsanaṃ || mvyā_2 ||	མ་འོངས་པ་ཡི་སངས་རྒྱས་གང་༎ འཇིག་རྟེན་འདྲེན་པར་མཛད་པ་པོ་༎ བྱམས་པ་ཞེས་བྱ་བསྟན་པ་དེ་༎
 vyākhyāhi tadvalaṃ cāpi ṛddhiṃ sarvārthavardhanaṃ |	འདྲེན་པ་བདག་ནི་དེའི་མཐུ་དང་༎ རྫུ་འཕྲུལ་དང་ནི་དོན་ཐམས་ཅད་༎ རྒྱས་པར་རབ་ཏུ་ཉན་འཚལ་ནི་༎
 śrotumicchāma eva ca nāyakasya narottama || mvyā_3 ||	དེ་ནི་མི་མཆོག་བདག་ལ་གསུངས་༎
 tacchrutvā bhagavānāha śṛṇu naravarasya tvaṃ |	དེ་ལ་སྟོན་པས་བཀའ་སྩལ་པ་༎ སངས་རྒྱས་བྱམས་པའི་མཆོག་དེའི་༎ འབྱོར་པ་རྒྱས་པར་ཁྱོད་ལ་ངས་༎
 tasya maitreyabuddhasya vibhavaṃ vyākṛtaṃ mayā || mvyā_4 ||	ལུང་བསྟན་བྱ་ཡི་ང་ལ་ཉོན་༎ དེ་ཡི་ཚེ་ན་རྒྱ་མཚོ་ནི་༎
 śukṣyanti ca tadārnavāḥ samantāt bahuyojanāḥ |	ཁོར་ཡུག་ཏུ་ནི་དཔག་ཚད་བརྒྱ་༎
 pratipādyā bhaviṣyanti mārgāśca cakravartinaḥ || mvyā_5 ||	སྐམ་པར་འགྱུར་ཏེ་དེ་ཡང་ནི༏་༏འཁོར་ལོས་བསྒྱུར་བའི་ལམ་བཟང་ཡིན་༎
 jambudvīpaṃ samantataḥ āyatanaṃ tadāhi ca |	དེ་ཚེ་ཛམབུའི་གླིང་འདི་ཡང་༎ ཆུ་ཞེང་ཐ་གྲུ་མཉམ་པར་ནི་༎
 āvāsaṃ sarvabhūtānāṃ daśasahasrayojanam || mvyā_6 ||	དཔག་ཚད་སྟོང་ཕྲག་བཅུ་པ་སྟེ་༎ འབྱུང་པོ་ཀུན་གྱི་གནས་སུ་འགྱུར༏་༏དེ་ཡི་ཚེ་ན་ཡུལ་གྱི་མི་༎ དར་ཅིང་འབྱོར་ལ་ཆད་པ་མེད་༎
 narāstaddeśikāśca hi bhaviṣyanti śubhaṅkarāḥ | ahiṃsakāśca nirdaṇḍyāḥ susamṛddhāśca subhagāḥ || mvyā_7 ||	འཚེ་མེད་མི་ནི་དེ་དག་ཀྱང་༎ དགེ་བ་བྱེད་པ་དག་ཏུ་འགྱུར་༎
 niṣkaṇṭakaśca bhūsthalaṃ samatalaṃ hi śyāmalaṃ |	ས་གཞི་ཚེར་མ་མེད་པ་དང་༎ མཉམ་ཞིང་ནེའུ་གསིང་སྔོ་དང་ལྡན་༎ འཕར་ཞིང་ནེམ་ཞེས་བྱེད་པ་སྟེ་༎
 unnamāvanamaśritaṃ mṛdutūla 'picopamaṃ || mvyā_8 ||	ཤིང་བལ་འདབ་མ་བཞིན་དུ་འཇམ་༎
 gandhaśāli janiṣyate kṛṣṭimṛte ca madhuraṃ |	མངར་ཞིང་དྲི་ནི་ཞིམ་པ་ཡི་༎ སའ་ལུ་མ་རྨོས་པར་སྐྱེའོ་༎
 nānāvarṇābhilaṅkṛtā bhaviṣyanti cailadrumāḥ || mvyā_9 ||	སྣ་ཚོགས་ཚོན་གྱིས་མཛེས་བྱས་༄༤༩༠བ་པའི༏་༏གོས་ཀྱི་ལྗོན་ཤིང་འབྱུང་བར་འགྱུར་༎
 drumāśca krośavistṛtā patrapuṣpaphalānatāḥ |	མེ་ཏོག་ལོ་མ་འབྲས་ལྡན་པའི་༎ ལྗོན་ཤིང་འཕང་དུ་རྒྱང་གྲགས་འབྱུང་༎
 sahasrāśītimātraśca āyustadā bhaviṣyati || mvyā_10 || varṇavantaḥ bhaviṣyanti balavanto mahākāyāḥ |	དེ་དག་རྣམས་ཀྱི་ཚེ་ལོ་ནི་༎ བརྒྱད་ཁྲི་ཁོ་ན་ཐུབ་པར་འགྱུར་༎
 sattvāḥ dakṣāśca niṣkleśā nirdoṣā dirghajīvinaḥ || mvyā_11 ||	སེམས་ཅན་དེ་དག་སྐྱོན་མེད་ཅིང་༎ ཉེས་བྲལ་སྤྲོ་བ་ཚེ་དང་ལྡན་པ་༎ ལུས་ཆེན་ཁ་དོག་ལྡན་པ་སྟེ་༎ ཚན་པོ་ཆོ་ཡི་སྟོབས་དང་ལྡན་༎ ནད་ནི་གསུམ་ཞིག་འབྱུང་བར་འགྱུར་༎
 rogatrayaṃ bhaviṣyati kāmojarā 'gnimāndyañca | pañcaśatatame varṣe pariṇītā ca dārikā || mvyā_12 ||	འདོད་དང་མི་ཟ་རྒ་བའོ༏་༏བུ་མོ་ལ་ནི་ལྔ་བརྒྱ་དག་། ལོན་ནས་ཁྱོ་ལ་བག་མར་འགྲོ་།
 tadā ketumatī nāma purī tatra bhaviṣyati |	དེ་ཚེ་ཏོག་ལྡན་ཞེས་བྱ་བའི་༎ རྒྱལ་པོའི་ཕོ་བྲང་འབྱུང་འགྱུར་ཏེ་༎
 sattvānāñca nivāsanaṃ prāṇināṃ hitakāriṇāṃ || mvyā_13 ||	སྲོག་ཆགས་དགེ་བའི་ལས་བྱེད་པའི་༎ སེམས་ཅན་རྣམས་ཀྱི་གནས་ཡིན་ནོ་༎
 dīrghā dvādaśayaujana sapta vistāraśo hyasau |	ཆུར་ནི་དཔག་ཚད་བཅུ་གཉིས་ཏེ་༎ རྒྱར་ནི་དཔག་ཚད་བདུན་ཡོད་པའི་༎
 nagaraṃ puṇyavacca tat viśuddhañca manoramaṃ || mvyā_14 ||	བསོད་ནམས་བྱས་པ་རྣམ་དག་གི་། གྲོང་ཁྱེར་ཡིད་འོང་འབྱུང་བར་འགྱུར་༎
 saptaratnamayāḥ prāṃśuprākārāḥ krośavistṛtāḥ |	རིན་ཆེན་བདུན་ལས་བྱས་མཐོ་བའི་༎ ར་བ་འཕང་དུ་རྒྱང་གྲགས་འབྱུང་༎ ཤིང་ཐགས་དང་ནི་སྒོ་ཁང་རྣམས་༎
 nānāratnavibhūṣitagopuratoraṇānyapi || mvyā_15 || iṣṭakairnimitāśca te ratnamayairbhaviṣyanti |	རིན་ཆེན་སྣ་ཚོགས་དག་གིས་བརྒྱན་༎
 padmotpalasamācchanāḥ parikhā haṃsaśobhitā || mvyā_16 ||	རིན་ཆེན་སོ་ཕག་གིས་བརྩེགས་ཤིང་༎ པདམ་ཨཽཏཔལ་གཅལ་དུ་བཀྲམ་༎ དུར་པས་མཛེས་པར་བྱས་པ་ཡི་༎ འོབས་ཀྱང་འབྱུང་བ་ཁོ་ནར་འགྱུར་༎
 mālairhi pariveṣṭitaṃ saptatālaismamantataḥ |	ཁོར་ཡུག་ཏུ་ནི་ཏ་ལ་ཡི་༎ ཕྲེང་བ་བདུན་གྱིས་ཡོངས་སུ་བསྐོར་༎
 catūratnamayāstālāḥ kiṅkinījālaśobhitāḥ || mvyā_17 ||	དྲིལ་བུའི་དྲ་བས་མཛེས་བྱས་པ་༎ རིན་ཆེན་བཞི་རྒྱུའི་ཏ་ལ་དག་།
 tattālebhyonilājjātaḥ śabdaścaiva manoramaḥ |	རླུང་བསྐྱོད་ཏ་ལ་དེ་དག་ལས་༎ སྙན་པའི་སྒྲ་ནི་འདི་ལྟར་དཔེར་༎
 sumadhuro yathā tūryaṃ tacca pañcāṅgasaṃyutaṃ || mvyā_18 ||	སིལ་སྙན་ཡན་ལག་ལྔ་ལྡན་བཞིན་༎ དེ་ལས་ཡིད་འོང་༄༤༩༡ཨ་༌༎ སྒྲ་གྲག་འགྱུར་༎
 nagare 'smin narāśca ye viśrāmasukhakāminaḥ |	མི་རྣམས་གང་དག་གྲོང་ཁྱེར་དེར་༎ རྩེ་དགའ་བདེ་དོན་གཉེར་བ་རྣམས་༎
 prahṛṣṭābhirabhiṣyante tālaśabdaiśca te tadā || mvyā_19 ||	དེ་དག་ཏ་ལའི་སྒྲ་དེ་ཡིས་༎
 nagaramapi tatkṛtamutpalakumudākīrṇaṃ |	རབ་ཏུ་མགུ་ཞིང་རྩེན་པར་བྱེད༏་༏ཨཽཏཔལ་ཀུ་མུ་དས་གང་བའི་༎ རྫིང་བུ་དག་ཀྱང་འབྱུང་བར་འགྱུར་༎
 taḍāgopavanodyānaṃ trayametadbhaviṣyati || mvyā_20 ||	གྲོང་དེ་སྐྱེད་མོས་ཚལ་དང་ནི་༎ ནགས་ཚལ་ཕུན་སུམ་ཚོགས་པར་འགྱུར་༎
 śaṅkhonāma nṛpastatra mahātejā bhaviṣyati |	དེར་ནི་དུང་ཞེས་བྱ་བ་ཡི་༎ རྒྱལ་པོ་གཟི་བརྗིད་ཆེ་ལྡན་ཞིང་༎
 caturdvīrpādhipeśvaraścakravarttī mahābalaḥ || mvyā_21 ||	སྟོབས་ཆེ་གླིང་བཞིའི་དབང་ཕྱུག་པ་༎ མངའ་བདག་འཁོར་ལོས་བསྒྱུར་བ་འབྱུང་༎ དཔུང་གི་ཡན་ལག་བཞི་འབྱོར་ཅིང་༎
 saptaratnasamanvitaścaturaṅgabalādhipaḥ |	རིན་ཆེན་བདུན་དང་ཡང་དག་ལྡན་༎
 sahasraṃ hi janiṣyante putrāstadāsya bhūpateḥ || mvyā_22 ||	རྒྱལ་པོ་དེ་ཡི་སྲས་རྣམས་ནི་༎ སྟོང་དུ་ཚང་བར་འབྱུང་བར་འགྱུར་༎ མི་ཡི་དབང་པོ་དེ་ཡང་ནི་༎
 pṛthivīṃ sāgarāntāñca sa paripālayiṣyati |	ས་འདི་རྒྱ་མཚོའི་མཐའ་ཀླས་པར་༎ ཆད་པ་མེད་ཅིང་ཆོས་དང་ནི་༎ མཐུན་པས་ཡོངས་སུ་སྐྱོང་བར་འགྱུར་༎ དེ་ཚེ་དུང་ཞེས་བྱ་བ་ཡི་༎
 yathādharmadaṇḍeṇa narādhipo hi tadyathā || mvyā_23 ||	ས་བདག་རྒྱལ་པོ་དེ་ལ་ནི་༎ རིན་ཆེན་ཁྲག་ཁྲིག་བརྒྱས་མཚོན་པའི་༎
 caturmahānidhistadā śaṅkhākhyasya ca bhūpateḥ | ratnānāṃ śatakoṭīnāṃ rājñastadā hi lokyate || mvyā_24 ||	གཏེར་ཆེན་བཞི་ནི་འབྱུང་བར་འགྱུར་༎ སུ་ཡི་མཚན་ནི་སེར་སྐྱ་སྟ་༎
 piṅgalaśca kaliṅgeṣu mithilāyām ca pāṇḍukaḥ |	བཅོམ་བརླག་ན་ནི་དཀར་པོ་ཡིན་༎ ས་འཛིན་ན་ནི་ཨཨེ་ལའི་འདབ་༎
 elapatraśca gāndhāre śaṃkho vārāṇasīpure || mvyā_25 ||	ཝའ་ར་ནའ་སིའི་གྲོང་ཁྱེར་དུང་༎
 caturbhirebhinidhibhissa rājā susamanvitaḥ |	གཏེར་ནི་བཞི་པོ་ཁོ་ན་དང་༎ རྒྱལ་པོ་ཡང་དག་ལྡན་པར་ནི༏་༏འབྱུང་འགྱུར་དཔའ་པོ་ཆེན་པོ་དེ་༎
 bhaviṣyati mahāvīraḥ śatapuṇyabaloditaḥ || mvyā_26 ||	བསོད་ནམས་བརྒྱ་ལོ་སྟོབས་ལས་སྐྱེས་༎ དེ་ཚེ་རྒྱལ་དེའི་མདུན་ན་འདོན་༎
 brāhmaṇastasya rājñāśca subrahmaṇaḥ purohitaḥ |	བྲམ་ཟེ་ཚངས་རབ་ཅེས་བྱ་བ་༎ ཐོས་མང་རིག་བྱེད་བཞི་འདོན་པའི་༎
 bahuśrutaścaturvedastasyopādhyāyo bhaviṣyati || mvyā_27 ||	༄༤༩༡བ་མཁན་པོ་ཞིག་ནི་འབྱུང་བར་འགྱུར་༎ འདོན་དུ་འཇུག་དང་གསང་ཚིག་འཛིན་༎
 adhyāpako mantradharaḥ smṛtimān vedapāragaḥ |	དྲན་ལྡན་རིག་བྱེད་གཞུང་འགྲེལ་དང་༎ སྒྲ་ངེས་སྦྱོར་བཅས་ཕ་རོལ་ཕྱིན་༎
 kaiṭabhe sanighaṇṭe ca padavyākaraṇe tathā || mvyā_28 ||	བརྡ་སྤྲོད་པ་དང་ཚིག་དང་ལྡན་༎
 tadā brahmāvatī nāma tasya bhāryā bhaviṣyati |	དེ་ཚེ་དེ་ཡི་ཆུང་མ་ནི་༎ ཚངས་ལྡན་མ་ཞེས་བྱ་བ་སྟེ་༎
 darśanīyā prāsādikā abhirūpā yaśasvinī || mvyā_29 ||	མཛེས་ཤིང་བལྟ་ན་སྡུག་པ་དང་༎ གཟུགས་མཐོང་གྲགས་དང་ལྡན་པ་འབྱུང་༎
 tuṣitebhyaścayavitvā tu maitreyo hyagrapugdalaḥ |	བྱམས་པ་གང་ཟག་མཆོག་གྱུར་པ་༎ དགའ་ལྡན་གནས་ནས་ཤི་འཕོས་ནས་༎ དེ་ཚེ་དེ་ཡི་ལྷུམས་སུ་ནི་༎
 tasyāḥ kukṣau sa niyataṃ pratisandhiṃ grahīṣyati || mvyā_30 ||	ངེས་པར་ཉིང་མཚམས་སྦྱོར་བར་འགྱུར་༎
 daśamāsāṃśca nikhilāṃ dhārayitvā mahādyūtiṃ |	གཟི་བརྗིད་ཆེན་པོ་ཟླ་བ་བཅུ་༎ ཚངས་པར་ལྷུམས་སུ་ཞུགས་ནས་ཀྱང་༎
 supuṣpitesminnudyāne maitreyajananī tataḥ || mvyā_31 ||	བྱམས་པའི་ཡུམ་ནི་སྐྱེད་མོས་ཚལ་༎ མེ་ཏོག་བཟང་རྒྱས་ནང་གཤེགས་ནས་༎
 na niṣaṇṇā nipannā vā sthitā sā dharmacāriṇī | drumasya śākhāmālamvya maitreyaṃ janayiṣyati || mvyā_32 ||	ཆོས་སྟོན་མ་དེ་མི་འདུག་ཅིང་༎ མི་ཉལ་འགྲེང་བཞིན་དག་ཏུ་ནི་༎ ཤིང་གི་ཡལ་ག་ལ་བཟུང་ནས་༎ བྱམས་པ་བལྟམས་པ་ཉིད་དུ་འགྱུར་༎ མི་ཡི་མཆོག་ཏུ་གྱུར་པ་དེ་༎
 niṣkramiṣyati pārśvena dakṣiṇena narottamaḥ |	གློ་ག-ཡས་ནས་ནི་འབྱུང་འགྱུར་ཏེ་༎
 abhrakūṭādyathā sūryo nirgataśca prabhāvyate || mvyā_32* ||	དཔེར་ན་སྤྲིན་གྱི་ཕུང་པོ་ནས་༎ ཉི་མ་བྱུང་བ་བཞིན་དུ་གསལ་༎
 alipto garbhapaṅkena kuśeśayamivāmvunā |	ཇི་ལྟར་ཆུ་ཡི་པདམ་བཞིན་༎ མངལ་གྱི་འདམ་གྱིས་མི་གོས་སོ་༎
 traidhātukamidaṃ sarvaṃ prabhayā pūrayiṣyati || mvyā_33 ||	ཁམས་གསུམ་འདི་ནི་ཐམས་ཅད་དུ་༎ འོད་ཀྱིས་རྒྱས་པར་འགེངས་པར་འགྱུར་༎
 prīto 'tha taṃ sahasrākṣo devarājā śacīpatiḥ |	དེ་ནས་བརྒྱ་བྱིན་ལྷ་དབང་པོ་༎ བདེ་སོགས་མངའ་བདག་དགའ་གྱུར་ནས་༎
 jāyamānaṃ grahītā ca maitreyaṃ dvipadottamam || mvyā_34 ||	བྱམས་པ་རྐང་གཉིས་མཆོག་གྱུར་པ་༎ བལྟམས་པའི་ཚེ་ན་ལོན་པར་འགྱུར་༎ དེ་ནི་བལྟམས་མ་ཐག་ཏུ་ཡང་༎
 padāni jātamātraśca saptāsau prakamiṣyati |	གོམ་པ་བདུན་དག་༄༤༩༢ཨ་༌༎ འདོར་བར་འགྱུར་༎ གོམ་པ་རེ་རེར་གཏེར་དང་ནི་༎
 pade pade nidhānañca padmaṃ padmaṃ bhaviṣyati || mvyā_35 ||	པདམ་རེ་རེ་འབྱུང་བར་འགྱུར་༎
 diśaścatasraścodvīkṣya vācaṃ pravyāhariṣyati |	ཕྱོགས་བཞི་དག་ཏུ་གཟིགས་ནས་ནི་༎
 iyaṃ me paścimā jāti nāsti bhūyaḥ punarbhavaḥ |	བདག་གི་སྐྱེ་བ་ཐ་མས་ནི༏་༏འདི་ཡིན་ཡང་སྲིད་ཡོད་མ་ཡིན་༎ ཡང་དང་ཡང་དུ་ཕྱིར་མི་འོང་༎
 na punarabhā gamiṣyāmi nirvāsyāmi nirāsravaḥ || mvyā_36 || saṃsārārṇavamagnānāṃ sattvānāṃ duḥkhabhāgināṃ | tṛṣṇābandhanabaddhānāṃ kariṣyāmi vimocanam || mvyā_37 || śvetaṃ cāsya surāśchatraṃ dhārayiṣyanti mūrdhani |	ཟག་མད་མྱ་ངན་འདས་འགྲོ་ཞེས་༎ གསུང་ཡང་རབ་ཏུ་བཀའ་སྩལ་ཏོ་༎
 śītoṣṇavāridhārābhyāṃ nāgendrau snāpayiṣyataḥ || mvyā_38 ||	ཀླུ་རྣམས་ཀྱིས་ནི་ཆུ་ཡི་རྒྱུན༏་༏བསིལ་དང་འཇམ་པས་སྐུ་བསིལ་འགྱུར་༎ ནམ་མཁའི་ངོས་ནས་ལྷ་རྫས་ཀྱི་༎ གོས་དང་མེ་ཏོག་འབབ་པར་འགྱུར་༎ དེ་ཡི་དབུ་ལ་གདུགས་དཀར་པོ་༎ ལྷ་རྣམས་ཀྱིས་ནི་འཛིན་པར་འགྱུར་༎
 pratigṛhya ca taṃ dhātrī dvātriṃśadvaralakṣaṇam |	མཚན་མཆོག་སུམ་ཅུ་གཉིས་མངའ་བ་༎ བྱམས་པ་དཔལ་གྱིས་འབར་བ་དེ་༎
 śriyā jvalantaṃ maitreyaṃ mātre samupaneṣyati || mvyā_39 ||	མ་མས་ཡང་དག་བླངས་ནས་སུ་༎ ཡུམ་གྱི་ཕྱག་ཏུ་འབུལ་བར་འགྱུར་༎
 manoramāṃ ca śivikāṃ nānāratnavibhūṣitāṃ | ārūḍhāṃ putrasahitāṃ vahiṣyanti ca devatā || mvyā_40 ||	རིན་ཆེན་སྣ་ཚོགས་ཀྱིས་བརྒྱན་པའི་༎ ཁྱོགས་ནི་ཡིད་དུ་འོང་བ་ལ་༎ སྲས་དང་བཅས་པར་བཞུགས་གསོལ་ནས་༎ ལྷ་རྣམས་ཀྱིས་ནི་ཁྱེར་བར་འགྱུར་༎
 tatastūrya sahasreṣu vādyamāneṣu tatpuraṃ |	སིལ་སྙན་སྟོང་ཕྲག་དུ་མ་དག་། སྒྲ་འབྱིན་འཁྲོལ་བའི་གྲོང་ཁྱེར་དེར་༎ བྱམས་པ་གཤེགས་པ་ཙམ་གྱིས་ནི་༎
 praviṣṭamātre maitreye puṣpavarṣaṃ patiṣyati || mvyā_41 ||	མེ་ཏོག་ཆར་བ་འབབ་པ་འགྱུར་༎ དེ་ཡི་ཉིན་པར་སྦྲུམ་པ་ཡི་༎ བུད་མེད་རྣམས་ཀྱང་བཙའ་བར་འགྱུར་༎ དེ་དག་ཐམས་ཅད་ཉམས་བདེ་ཞིང་༎ བདེ་ལེགས་སུ་ནི་བཙའ་བར་འགྱུར་༎
 dṛṣṭaivaṃ putraṃ subrahmā dvātriṃśadvaralakṣaṇam |	ཚངས་རབ་ཚེན་?་༄༤༩༢བ་མཆོག་སུམ་ཅུ་གཉིས་༎ ལྡན་པའི་སྲས་དེ་མཐོང་ནས་ནི་༎
 pratyavīkṣātha mantreṣu tadā prīto bhaviṣyati || mvyā_42 ||	གསང་ཚིག་དགལ་རབ་བརྟགས་ནས་༎ དེ་ཡི་འོག་ཏུ་དགའ་བར་འགྱུར་༎
 gatidvayaṃ kumārasya yathā mantreṣu dṛśyate |	ཇི་ལྟར་གསང་ཚིག་ལས་འབྱུང་བཞིན༏་༏གཞོན་ནུའི་འགྲོ་བ་གཉིས་ཡིན་ཏེ་༎
 narādhipaścakravarttī buddho vā dvipadottamaḥ || mvyā_43 ||	མི་དབང་འཁོར་ལོས་བསྒྱུར་བའམ་༎ སངས་རྒྱས་རྐང་གཉིས་མཆོག་ཏུ་འགྱུར་༎
 sa ca yauvanasaṃprāpto maitreyaḥ puruṣottamaḥ |	བྱམས་པ་རྐང་གཉིས་མཆོག་གྱུར་པ༏་༏དཔལ་དེ་ན་ཚོད་རྫོགས་ནས་ནི་༎
 cintayiṣyati dharmātmā duḥkhitā khalviyaṃ prajāḥ || mvyā_44 ||	སྐྱེ་རྒུ་འདི་ནི་སྡུག་བསྔལ་སྙམ་༎ ཆོས་ཀྱི་བདག་ཉིད་དགོངས་པར་མཛད་༎
 brahmakharo mahāghoṣo hemavarṇo mahādyutiḥ |	དབྱངས་ཆེ་ཚངས་པའི་དབྱངས་དང་ལྡན་༎ འོད་ཆེ་གསེར་གྱི་མདོག་དང་ལྡན་༎ སྟེང་ཕེལ་ཆེ་ཞིང་ཐལ་གོང་རྒྱས་༎
 viśālavakṣaḥ pīnāṃsaḥ padmapatranibhekṣaṇaḥ || mvyā_45 ||	པདམའི་འདབ་མ་འདྲ་བའི་སྤྱན་༎ དེ་ཡི་སྐུ་ཡི་ཁྲུན་དུ་ནི་༎
 hastaḥ pañcāśaducchrāya tasya kāyo bhaviṣyati | visṛtaśca tato 'rddheṇa śubhavarṇasamucchrayaḥ || mvyā_46 ||	ཁྲུ་ནི་བརྒྱད་ཅུ་དག་ཏུ་འགྱུར་༎ ཞེང་ནི་ཁྲུ་རྣམས་ཉི་ཤུ་སྟེ༏་༏ཞལ་གྱི་དཀྱིལ་འཁོར་དེ་ཡི་ཕྱེད་༎ བྱམས་པ་དེ་ནི་བྲམ་ཟེའི་བུ་༎
 aśītibhiścaturbhiśca sahasraiḥ saṃpuraskṛtaḥ |	སྟོང་ཕྲག་བཞི་པོ་དག་དང་ནི་༎ བརྒྱད་ཅུས་མདུན་དུ་བདར་ནས་ནི་༎
 mānavānāṃ sa maitreyo mantrānadhyāpayiṣyati || mvyā_47 ||	གསང་ཚིག་དག་ཀྱང་འདོན་དུ་འཇུག་།
 atha śaṃkho narapatiḥ yūpamucchrāpayiṣyati |	དེ་ནས་རྒྱལ་པོ་ཆེན་པོ་དུང་༎
 tiryañca ṣoḍaśavyāmaṃ ūrddhva vyāmasahasrakam || mvyā_48 ||	སྤོམས་སུ་འདོམ་ནི་དྲུག་ཅུ་བཞི་༎ འཕང་དུ་འདོམ་ནི་སྟོང་ཡོད་པའི་༎ མཆོད་སྡོང་ཞིག་ནི་འཛུགས་པར་འགྱུར་༎
 sa taṃ yūpaṃ narapatirnānāratnavibhūṣitaṃ |	མི་དབང་དེ་ཡིས་མཆོད་སྡོང་དེ་༎ རིན་ཆེན་སྣ་ཚོགས་ཀྱིས་བརྒྱན་ནས་༎
 pradāsyati dvijātibhyo yajñaṃ kṛtvā puraḥsaraṃ || mvyā_49 ||	མཆོད་སྦྱིན་གྱིས་ནི་སྤྱན་དྲངས་ཏེ་༎ བྲམ་ཟེ་དག་ལ་རབ་ཏུ་འབུལ་༎
 tañca ratnamayaṃ yūpaṃ dattamātraṃ manoramaṃ |	མཆོད་སྡོང་ཡིད་འོང་རིན་ཆེན་རྒྱུ་༎ དེ་ནི་༄༤༩༣ཨ་༌༎ ཕུལ་མ་ཐག་ཏུ་ཡང་༎
 brāhmaṇāṇāṃ sahasrāṇi vikiriṣyanti tatkṣaṇāt || mvyā_50 ||	བྲམ་ཟེ་སྟོང་པོ་རྣམས་ཀྱིས་ནི་༎ དེ་མི་མོད་ལ་བགེད་པར་གྱུར་༎ བྱམས་པས་མཆོད་སྡོང་དེ་ཡི་ནི་༎
 yūpasyatasya maitreyo dṛṣṭvā caitāmanityatāṃ |	མི་རྟག་ཉིད་དེ་མཐོང་ནས་ཀྱང་༎
 kṛtasraṃ vicintya saṃsāraṃ pravrajyāṃ rocayiṣyati || mvyā_51 ||	འཁོར་བ་མཐའ་དག་རྣམས་བསམ་སྟེ་༎ རབ་ཏུ་འབྱུང་བར་འདོད་པར་འགྱུར་༎
 yatvahaṃ pravrajitveha spṛśeyamamṛtaṃ padaṃ |	འདིར་བདག་རབ་ཏུ་བྱུང་ནས་ནི་༎ བདུད་རྩིའི་གོ་འཕང་རེག་འགྱུར་དང་༎ སྐྱེ་བོ་འཆི་བདག་ནད་རྒ་བའི་༎
 vimocayeyaṃ janatāṃ vyādhimṛtyujarābhayāt || mvyā_52 ||	འཇིགས་ལས་འགྲོལ་བར་འགྱུར་སྙམ་ཞེས་༎ སྐྱེ་བོ་རབ་དང་གཟིགས་ནས་ནི་༎ སྡུག་བསྔལ་སྡུག་བསྔལ་ཀུན་འབྱུང་དང་༎ སྡུག་བསྔལ་ཡང་དག་འགོག་པ་དང་༎ བདེ་བ་མྱ་ངན་ལས་འདས་འགྲོ་༎ འཕགས་ལམ་ཡན་ལག་བརྒྱད་པ་ཡི་༎ བདེན་པ་དག་ཀྱང་སྟོན་པར་འགྱུར་༎ དེ་ཡི་ཆོས་དེ་ཐོས་ནས་ཀྱང་༎ བསྟན་པ་ལ་ནི་ནན་ཏན་སྒྲུབ་༎ བྱམས་པ་གང་ཟག་མཆོག་གྱུར་དེ་༎
 aśītibhiḥ sahasraissa caturbhiśca puraskṛtaḥ |	སྟོང་ཕྲག་བཞི་པོ་དག་དང་ནི་༎ བརྒྱད་ཅུ་དག་གིས་མདུན་བདར་ནས་༎
 niṣkramiṣyati maitreyaḥ pravrajyāmagrapugdalaḥ || mvyā_53 ||	རབ་ཏུ་འབྱུང་བར་ངེས་འབྱུང་འགྱུར༏་༏དེ་ཚེ་དེ་ཡི་བྱང་ཆུབ་ཤིང་༎
 nāgavṛkṣastadā tasya bodhivṛkṣo bhaviṣyati |	ཀླུ་ཤིང་ཞེས་བྱ་འབྱུང་འགྱུར་ཏེ་༎ དེ་ཡི་ཡལ་ག་གནམ་འཕང་དུ་༎ དཔག་ཚད་ཙམ་དུ་ཡང་དག་འཕགས་༎ དེ་ནི་བྱང་ཆུབ་ཤིང་དེ་ཡི༏་༏ཡལ་ག་གེལ་པ་ཐམས་ཅད་དུ་༎
 pañcāśadyojanānyasya śākhā ūrddhaṃ samucchritāḥ || mvyā_54 ||	ཁོ་ར་ཁོར་ཡུག་རྒྱང་གྲགས་དྲུག་། ཁེབས་པ་ཁོ་ན་དག་ཏུ་འགྱུར་༎
 niṣadya tasya cādhastānmaitreyaḥ puruṣottamaḥ |	བྱམས་པ་རྐང་གཉིས་མཆོག་གྱུར་དེ་༎
 anuttarāṃ śivāṃ bodhiṃ samavāpsyati nāyakaḥ || mvyā_55 ||	དེ་ཡི་དྲུང་དུ་གཤེགས་ནས་༄༤༩༣བ་སུ༏་༏བླ་མེད་བྱང་ཆུབ་ཞི་བ་ནི་༎ ཐོབ་འགྱུར་འདི་ལ་ཐེ་ཚོམ་མེད་༎
 yasyāmeva ca rātrau sa pravrajyāṃ niṣkramiṣyati |	གང་གི་ནུབ་མོ་ཁོ་ན་ལ་༎ རབ་ཏུ་འབྱུང་བར་མངོན་འབྱུང་བ་༎
 tasyāṃ eva ca rātrau hi parāṃ bodhimavāpsyati || mvyā_56 || aṣṭāṅgopetayā vācā tataḥ sa puruṣottamaḥ |	དེ་ཡི་ནུབ་མོ་ཁོ་ན་ལ་༎ བྱང་ཆུབ་དམ་པ་འཐོབ་པར་འགྱུར༏་༏དེ་ཡི་འོག་ཏུ་ཐུབ་མཆོག་གོ་།
 deśayiṣyati saddharmaṃ sarvaduḥkhāpahaṃ śivam || mvyā_57 || prasannāṃ janatāṃ dṛṣṭvā satyāni kathayiṣyati | duḥkhaṃ duḥkhasamutpādaṃ duḥkhasya samatikramaṃ || mvyā_58 ||	དམ་ཆོས་སྡུག་བསྔལ་ཀུན་སྤོང་ཞིང་༎
 āryaṃ cāṣṭāṅgikaṃ mārgaṃ kṣemaṃ nirvāṇagāminaṃ |	ཞི་བ་ཡན་ལག་བརྒྱད་ལྡན་པའི་༎
 taṃ cāpi dharmaṃ saṃśrutya pratipatsyanti śāsane || mvyā_59 ||	གསུང་གིས་སྟོན་པར་མཛད་པར་འགྱུར་༎
 udyāne puṣpasaṃcchanne sannipāto bhaviṣyati |	མེ་ཏོག་མཛེས་པ་བརྒྱུས་པ་ཡི༏་༏སྐྱེད་མོས་ཚལ་དུ་དེ་ཡི་འཁོར་༎
 pūrṇaṃ ca yojanaśataṃ parṣattasya bhaviṣyati || mvyā_60 ||	དཔག་ཚད་བརྒྱ་ཁྱོན་གང་བ་དག་། ཡང་དག་འདུ་བ་ཁོ་ནར་འགྱུར་༎
 śrutvā narapati rājā śaṅkho nāma mahāyaśāḥ |	དེ་ནས་མི་དབང་རྒྱལ་པོ་དུང་༎ གྲགས་པ་ཆེན་པོས་ཐོས་ནས་ནི་༎
 datvā dānamasaṃkhyeyaṃ pravrajyāṃ niṣkramiṣyati || mvyā_61 ||	སྦྱིན་པ་གྲངས་མེད་བྱས་ནས་ཀྱང་༎ རབ་ཏུ་འབྱུང་བར་འདོད་པར་འགྱུར་༎
 aśītibhiścaturbhiśca sahasraiḥ parivāritaḥ |	རྒྱལ་པོ་སྟོང་ཕྲག་བཞི་དང་ནི་༎ བརྒྱད་ཅུ་དག་གིས་མདུན་བདར་ཏེ་༎ ཁྱིམ་ནས་དེས་པར་བྱུང་ནས་ནི་༎
 narādhipo viniṣkramya pravrajyāmupayāsyati || mvyā_62 ||	རབ་ཏུ་འབྱུང་བར་འགྲོ་བར་འགྱུར་༎ བྱམས་པའི་ཡབ་ཀྱང་དེ་བཞིན་དུ་༎
 anenaiva pramāṇena mānavānāṃ puraskṛtaḥ |	དེ་ཡི་ཚད་དང་མཉམ་པ་ཡི་༎ བྲམ་ཟེ་རྣམས་ཀྱིས་མདུན་བདར་ནས་༎
 maitreyasya pitā tatra pravrajyāṃ niṣkramiṣyati || mvyā_63 ||	རབ་ཏུ་འབྱུང་བར་འགྲོ་བར་འགྱུར་༎
 tato gṛhapatistatra sudhano nāma viśrutaḥ |	དེ་ནས་དེ་ཚེ་ཁྱིམ་བདག་ནི་༎ ནོར་བཟང་ཚོགས་ནི་རྣམ་གྲགས་པ་༎ ཆོས་ཀྱི་བདག་ཉིད་སྟོང་དག་གིས་༎
 pravrajiṣyati śuddhātmā maitreyasyānuśāsane || mvyā_64 ||	བསྐོར་ནས་རབ་ཏུ་འབྱུང་བར་འགྱུར་༎
 strīratnamatha śaṅkhasya viśākhā nāma viśrutā |	དུང་གི་བུད་མེད་རིན་པོ་ཆེ་༎ ས་ག་ཞེས་ནི་རྣམ་གྲགས་པ་༎
 aśītibhiścaturbhiśca sahasraiḥ saṃpuraṣkṛtā ||	བུད་མེད་སྟོང་ཕྲག་བཞི་དང་ནི་༎ བརྒྱད་ཅུ་དག་གིས་མདུན་བདར་ཏེ་༎ དེ་ཡི་འོག་ཏུ་མངོན་བྱུང་ནས་༎
 nārīṇāmabhiniṣkramya pravrajyāṃ rocayiṣyati || mvyā_65 ||	རབ་ཏུ་འབྱུང་བར་འགྲོ་བར་འགྱུར་༎ དེ་ཡི་ཚེ་ན་བྱམས་པ་ཡི་༎ བསྟན་པ་ལ་ནི་སྲོག་ཆགས་༄༤༩༤ཨ་༌༎ དག་།
 prāṇinaḥ tatra samaye sahasrāṇi śatāni ca |	སྟོང་ཕྲག་དང་ནི་བརྒྱ་ཕྲག་རྣམས་༎
 pravrajyāmupayāsyanti maitreyasyānuśāsane || mvyā_66 || supuṣpite 'sminnudyāne sannipāto bhaviṣyati | samantato yojanaśataṃ parṣat tasya bhaviṣyati || mvyā_67 ||	རབ་ཏུ་འབྱུང་བར་འགྲོ་བར་འགྱུར་༎ དེ་ཡི་འོག་ཏུ་ཐུགས་རྗེ་ཅན་༎
 tataḥ kāruṇikaḥ śāstā maitreyaḥ puruṣottamaḥ |	སྟོན་པ་བྱམས་པ་རྐང་གཉིས་མཆོག་།
 samitiṃ vyavalokyātha imamarthaṃ pravakṣayati || mvyā_68 ||	འཁོར་ལོ་རྣམ་པར་གཟིགས་ནས་ནི་༎ ཤའཀྱ་སེངགེ་ཐུབ་པ་སྟེ་༎ གཙོ་བོ་སྐྱོབ་པར་མཛད་པ་པོ་༎ དམ་པའི་ཆོས་དབྱིངས་གཟིགས་གྱུར་པ་༎
 sarvete śākyasiṃhena guṇiśreṣṭheṇa trāyinā | arthato lokanāthena dṛṣṭvā saddharmadhātunā |	འཇིག་རྟེན་མགོན་པོས་འདི་དག་ཀུན་༎ ཐར་པའི་ལམ་དེ་བསྐྱེད་ནས་ཀྱང་༎
 ropitā mokṣamārgeṇa vikṣiptā mama śāsane || mvyā_69 ||	དོན་གྱིས་ང་ཡི་བསྟན་ལ་བཏང་༎
 chatradhvajapatākābhirgandhamālyavilepanaiḥ |	གདུགས་དང་རྒྱལ་མཚན་པ་དན་དང་༎ དྲི་དང་ཕྲེང་བ་བྱུག་པ་ཡིས་༎ ཤའཀྱ་ཐུབ་ལ་མཆོད་ནས་ནི་༎ ང་ཡི་བསྟན་ལ་ལྷགས་པ་ཡིན་༎ གུར་གུམ་ཆུ་ཡིས་གདབ་པ་དང་༎ ཙནདན་གྱི་ནི་བྱུག་པ་ཡིས་༎ ཤའཀྱ་ཐུབ་པའི་མཆོད་རྟེན་ལ་༎
 kṛtvā stūpeṣu satkāraṃ āgatā hi mamāntikam || mvyā_70 ||	མཆོད་ནས་ང་ཡི་བསྟན་ལ་ལྷགས་༎ དེ་ཚེ་སངས་རྒྱས་ཆོས་དང་ནི་༎ དགེ་འདུན་ལ་ཡང་སྐྱབས་སོང་ཞིང་༎ དགེ་བའི་ལས་ཀྱང་བྱས་ནས་ནི་༎ ང་ཡི་བསྟན་ལ་ལྷགས་པ་ཡིན་༎ ཤའཀྱ་སེངགེའི་བསྟན་པ་ལ་༎ བསླབ་གཞི་ཡང་དག་བླངས་ནས་སུ་༎ ཇི་ལྟར་གསུང་བཞིན་བསྒྲུབས་ནས་ནི་༎ ང་ཡི་བསྟན་ལ་ལྷགས་པ་ཡིན་༎
 saṃghe datvā ca dānāni cīvaraṃ pānabhojanaṃ | vividhaṃ glānabhaiṣajyaṃ āgatā hi mamāntikam || mvyā_71 || kuṃkumodakasekaṃ ca candanenānulepanaṃ |	དགེ་འདུན་ལ་ཡང་ཆོས་གོས་དང་༎ ཞལ་ཟས་དང་ནི་བཏུང་བ་དང་། སྙུན་གསོས་སྣ་ཚོགས་སྦྱིན་པ་རྣམས་༎
 datvā śākyamuneḥ stūpeṣvāgatā hi mamāntikam || mvyā_72 || śikṣāpadāni cādhāya śākyasiṃhasya śāsane | paripālaya yathābhūtaṃ āgatā hi mamāntikam || mvyā_73 || upoṣadhaṃ upoṣyeha āryamaṣṭāṅgikaṃ śubhaṃ |	ཕུལ་ནས་ང་ཡི་བསྟན་ལ་ལྷགས་༎
 caturdaśīṃ pañcadaśīṃ pakṣasyehāṣṭamīṃ tathā |	བཅུ་བཞི་དང་ནི་བཅོ་ལྔ་དང་༎ དེ་བཞིན་ཟླ་གཅིག་ཚེས་བརྒྱད་དང་༎ ཆོ་འཕྲུལ་ཝ་ཡི་ཟླ་བ་ལ་༎
 prātihārikapakṣaṃ cāṣyaṣṭāṅgaṃ susamāhitaṃ || mvyā_74 || śīlāni ca samādāya saṃprāptāni ca śāsanam | buddhaṃ dharmeṃ ca saṃghaṃ ca sattvāste śāsanaṃ gatāḥ ||	༄༤༩༤བ་ཡན་ལག་བརྒྱད་ལེགས་མཉམ་བཞག་ཅིང་༎ བསྙེན་གནས་གསོ་སྦྱོང་བྱས་ནས་ནི་༎
 kṛtvā ca kuśalaṃ karma macchāsanamupāgatāḥ || mvyā_75 || tenaite preṣitāḥ sattvā pratiṣṭāśca mayāpyamī | gaṇiśreṣṭheṇa muninā parītā bhūrimedhasā || mvyā_76 || prasannāṃ janatāṃ dṛṣṭvā satyāni kathayiṣyati |	ང་ཡི་བསྟན་ལ་ལྷགས་སོ་ཞེས་༎ དོན་འདི་རབ་ཏུ་གསུང་བར་འགྱུར་༎
 śrutvā ca te tato dharmaṃ prāpsyanti padamuttamam || mvyā_77 ||	དེ་ཡི་ཉན་ཐོས་རྣམས་ཀྱང་ནི་༎
 prātihāryatrayeṇāsau śrāvakānvinayiṣyati |	ཆོ་འཕྲུལ་གསུམ་གྱིས་འདུལ་བར་འགྱུར་༎
 sarvete āsravāstatra kṣipayiṣyanti suratāḥ || mvyā_78 || prathamaḥ sannipātosya śrāvakāṇāṃ bhaviṣyati |	དེ་ཚེ་དེ་དག་ཐམས་ཅད་ནི་༎ ཟག་ཟད་འགྲོགས་ན་བདེ་བར་འགྱུར་༎ དེ་ཡི་འདུས་པ་དང་པོ་ནི་༎
 pūrṇāḥ ṣaṇṇavatikoṭyaḥ śrāvakāṇāṃ bhavacchidāṃ || mvyā_79 ||	ཉན་ཐོས་སྲིད་པ་བཅད་གྱུར་པ་༎ དུང་ཕྱུར་ཕྲག་དགུ་བྱེ་ཕྲག་དྲུག་།
 dvitīyaḥ sannipātosya śrāvakāṇāṃ bhaviṣyati |	ཚང་བའི་ཉན་ཐོས་འབྱུང་བར་འགྱུར་༎ དེ་ཡི་འདུས་པ་གཉིས་པ་ནི་༎ ཉོན་མོངས་འཆིང་བ་ལས་གྲོལ་བའི་༎
 pūrṇāścaturnavati koṭyaḥ śāntānāṃ bhūrimedhasāṃ || mvyā_80 ||	དུང་ཕྱུར་ཕྲག་དགུ་བྱེ་ཕྲག་བཞི་༎ ཚང་བའི་ཉན་ཐོས་འབྱུང་པར་འགྱུར་༎
 tṛtīyaḥ sannipātosya śrāvakāṇāṃ bhaviṣyati |	དེ་ཡི་འདུས་པ་གསུམ་པ་ནི་༎
 pūrṇāḥ dvāviṃśati koṭyaḥ śāntānāṃ śāntacetasāṃ || mvyā_81 ||	སེམས་ཞི་རྣམ་པར་གྲོལ་གྱུར་པ་༎ དུང་ཕྱུར་ཕྲག་དགུ་བྱེ་ཕྲག་གཉིས་༎ ཚང་བའི་ཉན་ཐོས་འབྱུང་བར་འགྱུར་༎
 dharmacakraṃ pravartyātha vinīya suramānuṣān |	ཆོས་ཀྱི་འཁོར་ལོ་རབ་བསྐོར་ནས་༎ ལྷ་དང་མི་རྣམས་རྣམ་བཏུལ་ཏེ་༎
 sārdhaṃ śrāvakasaṃgheṇa pure piṇḍaṃ cariṣyati || mvyā_82 ||	ཉན་ཐོས་དགེ་འདུན་ཐབས་ཅིག་ཏུ་༎ གྲོང་དུ་བསོད་སྙོམས་སྤྱོད་ལ་རྒྱུ་༎ དེ་ནས་རྟོག་ལྡན་དགའ་ལྟ་ཡི་༎
 tataḥ praviśatastasyāṃ ramyāṃ ketumatīṃ purīṃ |	གྲོང་ཁྱེར་དེར་ནི་གཤེགས་པ་ན་༎ གྲོང་ཁྱེར་མཆོག་ཏུ་མནདའ་རའི་༎
 māndārakāṇi puṣpāṇi patiṣyanti purottame ||	མེ་ཏོག་ཆར་ཆེན་འབབ་པར་འགྱུར་༎
 devatāḥ prakiriṣyanti tasmin puragate munau || mvyā_83 ||	ཐུབ་པ་གྲོང་དེར་གཤེགས་པ་ལ་༎ ལྷ་ཡིས་མེ་ཏོག་འཐོར་བར་འགྱུར་༎
 catvāraśca mahārājā śakraśca tridaśādhipaḥ |	རྒྱལ་པོ་ཆེན་པོ་བཞི་དག་དང་༎ བརྒྱ་བྱིན་སུམ་ཅུ་རྩ་གསུམ་དབང་༎ ཚངས་པ་ལྷ་སོགས་ཐབས་ཅིག་ཏུ་༎
 brahmā devagaṇaiḥ sārdhaṃ pūjāṃ tasya kariṣyati || mvyā_84 ||	དེ་ལ་མཆོད་པ་བྱེད་པར་འགྱུར་༎ ལྷ་ཡི་བུ་ནི་མཐུ་ཆེན་གྱིས་༎
 utpalaṃ kumudaṃ padmaṃ puṇḍarīkaṃ sugandhikaṃ |	ཨཽཏཔལ་པདམ་ཀུ་མུ་ཏ་༎ པདམ་དཀར་པོ་དྲི་ཞིམ་དང་༎ ཨཨ་ག་རུ་དང་༄༤༩༥ཨ་༌༎
 aguruṃ candanaṃ cāpi divyaṃ mālyaṃ patiṣyati || mvyā_85 || cailakṣepaṃ kariṣyanti devaputrā maharddhikāḥ |	ཙནདན་དང་༎ དེ་བཞིན་ལྷ་རྫས་ཕྲེང་བ་དང་༎ ལྷ་རྫས་གོས་ཀྱང་འཐོར་པར་འགྱུར་༎
 taṃ lokanāthamudvīkṣapa praviśantaṃ purottamam || mvyā_86 || divyaśca tūryanirghoṣo divyaṃ mālyaṃ patiṣyati |	འཇིག་རྟེན་མགོན་དེ་གྲོང་ཁྱེར་གྱི་༎ མཆོག་ཏུ་གཤེགས་པ་མཐོང་ནས་ནི༏་༏ཤིང་བལ་འདབ་ལྟར་འཇམ་པ་ཡི་༎
 devatā prakiriṣyanti tasmin puragate munau || mvyā_87 ||	ས་དེར་གདིང་བརྒྱ་ཆེར་འདིང་༎
 ye tu ketumatīṃ kecit vāsayaṣyanti mānuṣāḥ | tepi taṃ pūjayiṣyanti praviśantaṃ purottamam || mvyā_88 || pathi bhūmyāstaraṃ tatra mṛdutūlapicopamam |	དེ་དག་ལམ་གར་ཕྲེང་བ་ནི་༎
 vicitrañca śubhaṃ mālyaṃ vikiriṣyanti te tadā || mvyā_89 ||	སྣ་ཚོགས་མཛེས་པ་རྣམ་པར་འགྲེམ་༎ ལྷ་ཡི་བུ་ནི་མཐུ་ཆེན་དང་༎ མི་རྣམས་ཡིད་ནི་རབ་དང་བ་༎
 chatradhvajapatākabhirarcayiṣyanti mānuṣāḥ | śubhaiśca tūryanirghoṣaiḥ prasannamanaso narāḥ || mvyā_90 ||	གདུགས་དང་རྒྱལ་མཚན་བ་དན་དང་༎ སྤོས་དང་ཕྲེང་བ་བྱུག་པ་དང་༎ རོལ་མོ་སྒྲ་སྙན་བསྒྲགས་པ་ཡིས་༎ སྟོན་པ་ལ་ནི་མཆོད་པར་འགྱུར་༎
 taṃ ca śakraḥ sahasrākṣo devarājaḥ śacīpatiḥ |	བརྒྱ་བྱིན་མིག་སྟོང་ལྷ་རྣམས་ཀྱི་༎ རྒྱལ་པོ་བདེ་སོགས་བདག་པོ་དེ་༎
 prahṛṣṭaḥ prāñjalirbhūtvā maitreyaṃ stoṣyate jinam || mvyā_91 ||	རབ་མགུ་ཐལ་མོ་སྦྱར་ནས་ནི་༎ འཇིག་རྟེན་མགོན་ལ་བསྟོད་པར་བྱེད་༎
 namaste puruṣājanya namaste puruṣottama |	སྐྱེས་བུ་ཅང་ཤེས་ཁྱོད་ལ་འདུད་༎ སྐྱེས་མཆོག་ཁྱེད་ལ་ཕྱག་འཚལ་ལོ་༎ གང་ཟག་མཆོག་གྱུར་བཅོམ་ལྡན་འདས་༎
 anukampasva janatāṃ bhagavannagrapugdala || mvyā_92 ||	སྐྱེ་རྒུ་ལ་ནི་ཐུགས་བརྩེར་མཛོད་༎
 maharddhiko devaputrastasya māro bhaviṣyati |	དེ་ཡི་ཚེ་ན་ལྷ་ཡི་བུ་༎ མཐུ་ཆེན་བདུད་ཅེས་བྱ་བ་འབྱུང་༎
 sa cāpi prāñjalirbhūtvā stoṣyate lokanāyakam || mvyā_93 || śuddhāvāsa sahasraiśca bahubhiḥ parivāritaḥ | pravekṣyate ca maitreyo lokanātho vināyakaḥ || mvyā_94 ||	དེ་ཡང་ཐལ་མོ་རབ་སྦྱར་ནས་༎ འཇིག་རྟེན་མགོན་ལ་བསྟོད་པར་བྱེད་༎ ཚངས་པའི་འཁོར་གྱིས་ཡོངས་བསྐོར་ཅིང་༎
 brāhmaṇaparivāreṇa brahmā cāpi girāsphuṭam |	ཚངས་པས་ཀྱང་ནི་མདུན་བདར་ཏེ་༎ ཚངས་པའི་དབྱངས་ནི་སྒྲོག་བཞིན་དུ་༎
 kathayiṣyati saddharmaṃ brāhmaṃ ghoṣamudīrayan || mvyā_95 || ākīrṇā pṛthivī sarvā arhadbhiśca bhaviṣyati |	དམ་པའི་ཆོས་ནི་གསུང་བར་འགྱུར་༎
 kṣīṇāśravairvāntadoṣaiḥ prahīṇabhavabandhanaiḥ || mvyā_96 ||	ཟག་ཟད་ཉེས་པ་རྣམས་བྲལ་ཞིང་༎ སྲིད་པའི་འཆིང་བ་རབ་སྤངས་པའི་༎ དགྲ་བཅོམ་རྣམས་ཀྱིས་ས་འདི་ནི་༎
 hṛṣṭā devamanuṣyāśca gandharvā yakṣarākṣasāḥ |	ཐམས་ཅད་ཀུན་ཏུ་གང་བར་༄༤༩༥བ་འགྱུར༏་༏ལྷ་དང་མི་དང་དྲི་ཟ་དང་༎ གནོད་སྦྱིན་དང་ནི་སྲིན་པོ་ཀླུ་༎ མཐུ་ཆེན་རྣམས་ནི་མགུ་གྱུར་ནས་༎
 śāstuḥ pūjāṃ kariṣyanti nāgāścāpi maharddhikāḥ || mvyā_97 ||	སྟོན་ལ་མཆོད་པ་བྱེད་པར་འགྱུར་༎ གང་དག་བྱམས་པའི་བསྟན་པ་ལ་༎ ཚངས་པར་སྤྱད་པ་སྤྱོད་གྱུར་པ་༎
 te vai nūnaṃ bhaviṣyanti cyānaghācchinnasaṃśayāḥ | utkṣiptaparikhāḥ dhīrā anādānā nirutsakāḥ ||	དེ་དག་གདོན་མི་ཟ་བར་ནི་༎ ཉོན་མོངས་མེད་ཅིང་ཐེ་ཚོམ་མེད་༎ གང་དག་བྱམས་པའི་བསྟན་པ་ལ་༎
 brahmacaryañcariṣyanti maitreyasyānuśāsane || mvyā_98 ||	ཚངས་པར་སྤྱོད་པ་སྤྱོད་གྱུར་པ་༎
 te 'pi nūnaṃ bhaviṣyanti amamā aparigrahāḥ | ajātarūparajatā aniketā asaṃstavāḥ |	དེ་དག་གདོན་མི་ཟ་བར་ནི༏་༏ང་ཡི་མེད་ཅིང་ཡོངས་འཛིན་མེད་༎ གསེར་དང་དངུལ་ལ་འཛིན་མེད་ཅིང་༎ གནས་མེད་ཆགས་པའང་ཡོད་པ་མིན་༎ གང་དག་བྱམས་པའི་བསྟན་པ་ལ་༎
 brahmacaryañcariṣyanti ye maitreyānuśāsane || mvyā_99 || te vai pāraṃ gamiṣyanti chitvā jālameva bhujāt |	ཚངས་པར་སྤྱད་པ་སྤྱོད་གྱུར་པ༏་༏དེ་དག་གདོན་མི་ཟ་བར་ནི་༎ སྲེད་པའི་དྲ་བ་བཅད་པ་དང་༎ བསམ་གཏན་རྫོགས་པར་བྱས་ནས་ནི་༎
 dhyānāni copasaṃpadya prītisaukhyasamanvitāḥ | brahmacaryañcariṣyanti maitreyasyānuśāsane || mvyā_100 ||	དགའ་དང་བདེ་དང་ཡང་དག་ལྡན་༎ འབྱུང་པོ་ཀུན་ལ་ཐུགས་བརྩེ་བ་༎
 ṣaṣṭhiṃ varṣa sahasrāṇi maitreyo dvipadottamaḥ |	བྱམས་པ་རྐང་གཉིས་རྣམས་ཀྱི་མཆོག་། ལོ་ནི་དྲུག་ཁྲི་དག་ཏུ་ཡང་༎
 deśayiṣyati saddharmaṃ śāstā lokānukampayā || mvyā_101 ||	དམ་པའི་ཆོས་ནི་སྟོན་པར་འགྱུར་༎
 śatāni ca sahasrāṇi prāṇiṇāṃ sa vināyakaḥ |	དེ་ན་སྲོག་ཆགས་བརྒྱ་སྟོང་དང་༎ འབུམ་ཕྲག་རྣམ་པར་འདྲེན་པ་སྟེ་༎ དམ་པའི་ཆོས་ལ་བཏུལ་ནས་ནི་༎
 vinīya dharmakāyena tato nirvāṇameṣyati || mvyā_102 || tasmiṃśca nirvṛte dhīre maitreye dvipadottame |	དེ་ནས་མྱ་ངན་འདའ་བར་འགྱུར་༎ ཐུབ་པ་ཆེན་པོས་གསུངས་པ་དེ་༎ ཡོངས་སུ་མྱ་ངན་འདས་ནས་ཀྱང་༎
 daśavarṣasahasrāṇi saddharmaṃ sthāsyati kṣitau || mvyā_103 ||	དེ་ཚེ་དེ་ཡི་དམ་ཆོས་ནི་༎ ལོ་ཁྲི་དག་ཏུ་གནས་པར་འགྱུར༏་༏རྒྱལ་བ་ཤའཀྱ་ཐུབ་དེ་ལ་༎
 prasādayati cittāni tasmācchākyamunau jine |	སེམས་ནི་རབ་ཏུ་དད་པར་གྱིས་༎
 tatodṛkṣatha maitreyaṃ saṃbuddhaṃ dvipadottamam || mvyā_104 ||	དེས་ན་བྱམས་པ་རྐང་གཉིས་མཆོག་། རྫོགས་པའི་སངས་རྒྱས་མཐོང་བར་འགྱུར་༎
 tasmāddharme ca buddhe ca saṃghe cāpi gaṇottame |	དེ་ཕྱིར་སངས་རྒྱས་ཆོས་དག་༄༤༩༦ཨ་༌༎ དང་༎ དགེ་འདུན་ཚོགས་ཀྱི་མཆོག་ལ་ནི་༎
 prasādayati cittāni bhaviṣyati maharddhikaṃ || mvyā_105 ||	སེམས་ནི་རབ་ཏུ་དད་གྱིས་དང་༎ དོན་ཆེན་རབ་ཏུ་འགྲུབ་པར་འགྱུར་༎ ཐུགས་རྗེ་ཆེ་ལྡན་དེ་ལྟ་བུའི་༎
 taṃ tādṛśaṃ kāruṇikaṃ maitreyaṃ dvipadottamaṃ |	བྱམས་པ་རྐང་གཉིས་མཆོག་གྱུར་པ་༎ དེ་ཚེ་མཉེས་པར་བྱས་ནས་ནི་༎
 ārādhayitvā kālena tato nirvāṇameṣyatha || mvyā_106 ||	དེ་ནས་མྱ་ངན་འདའ་བར་འགྱུར་༎
 idamāścaryakaṃ śrutvā dṛṣṭvā ca vibhavānalpikāṃ |	ཡ་མཚན་འདི་དག་ཐོས་གྱུར་ཅིང་༎ འབྱོར་པ་མི་ཉུང་མཐོང་མཛད་དེ་༎ ནག་པོའི་རིགས་ཀྱང་དད་འགྱུར་ན་༎
 ko vidvānna prasīdeta api kṛṣṇāsu jātiṣu || mvyā_107 ||	མཁས་པ་སུ་ཞིག་དད་མི་འགྱུར་༎
 tasmādihātmakāmena māhātmayamabhikāṃkṣatāḥ |	དེ་ཕྱིར་འདི་ན་བདག་ཉིད་ཆེ་༎ འདོད་ཅིང་བདག་ལ་ལེགས་འདོད་པས་༎
 saddharmo gurukarttavyaḥ smaratā buddhaśāsanam || mvyā_108 ||	སངས་རྒྱས་བསྟན་པ་དྲན་བཞིན་དུ་༎ དམ་པའི་ཆོས་ལ་གུས་པར་བྱ་༎
