skt	tib
 sarvatathāgatādhiṣṭhāna-vyūham sūtram	༄༤༡༦ཨ་རྒྱ་གར་སྐད་དུ་། ཨའརྱ་སརྦ་ཏ་ཐའ་ག་ཏའ་དྷཤཐའི་ན་སཏབ༹འ་བ་ལོ་ཀེ་ན་བུདདྷ་ཀཤེ་ཏྲེ་ནི་རྡེ་ཤ་ན་བཡའུ་ཧ་ནའ་མ་མ་ཧའ་ཡའ་ན་སའུ་ཏྲ་། བོད་སྐད་དུ་། འཕགས་པ་དེ་བཞིན་གཤེགས་པ་ཐམས་ཅད་ཀྱི་བྱིན་གྱི་རླབས་སེམས་ཅན་ལ་གཟིགས་ཤིང་སངས་རྒྱས་ཀྱི་ཞིང་གི་བཀོད་པ་ཀུན་ཏུ་སྟོན་པ་ཞེས་བྱ་བ་ཐེག་པ་ཆེན་པོའི་མདོ་། སངས་རྒྱས་དང་བྱང་ཆུབ་སེམས་དཔའ་ཐམས་ཅད་ལ་ཕྱག་འཚལ་ལོ་༎ འདི་སྐད་བདག་གིས་ཐོས་པ་དུས་གཅིག་ན་།
 evaṃ mayā śrutamekasmin samaye potalakaparvate āryāvalokiteśvarāyatane divyamaṇiratnaśrīindranīlamaye puṣpasaṃstṛte devasiṃhāsane bhagavān sārdhaṃ mahatā bhikṣusaṅghena pañcamātrairbhikṣuśataiḥ sarvairarhadbhiḥ kṣīṇāsravaiścetovaśitāprāptaiḥ saddharmapāraṃgataiśca sārdhaṃ bodhisattvaiḥ	བཅོམ་ལྡན་འདས་རི་གྲུ་འཛིན་ན་འཕགས་པ་སྤྱན་རས་གཟིགས་དབང་ཕྱུག་གི་གནས་ལྷའི་ནོར་བུ་རིན་པོ་ཆེ་དཔལ་གྱི་སྙིང་པོ་དང་། མེ་ཏོག་རྒྱས་པ་དང་། ལྷའི་སེངགེའི་ཁྲི་བཀོད་པ་ན་དགེ་སློང་ལྔ་བརྒྱ་ཙམ་གྱི་དགེ་སློང་གི་དགེ་འདུན་ཆེན་པོ་ཐམས་ཅད་ཀྱང་དགྲ་བཅོམ་པ་། ཟག་པ་ཟད་པ་།
 sarvaiḥ mahākaruṇājñānaprāptaiḥ sarvaiḥ ekajātipratibaddhairdvijātibhyāṃ ca trijātibhirdaśajātibhirviśatijātibhistriṃśajjātibhiḥ	སེམས་ཐམས་ཅད་ཀྱི་དབང་གི་དམ་པའི་ཕ་རོལ་ཏུ་སོན་པ་ཤ་སྟག་དང་། བྱང་ཆུབ་སེམས་དཔའ་ཐམས་ཅད་ཀྱང་སྙིང་རྗེ་ཆེན་པོའི་ཤེས་པ་ལ་གནས་པ་། ཐམས་ཅད་ཀྱང་སྐྱེ་བ་གཅིག་གིས་ཐོགས་པ་དང་། སྐྱེ་བ་གཉིས་དང་། སྐྱེ་བ་གསུམ་དང་། སྐྱེ་བ་བཅུ་དང་། སྐྱེ་བ་ཉི་ཤུ་དང་། སྐྱེ་བ་སུམ་ཅུ་དང་། སྐྱེ་བ་བརྒྱའི་བར་དག་གིས་༄༤༡༦བ་ཐོགས་པ་།
 śatajātibhirvā pratibaddhaiḥ sarvaiḥ aṣṭaphalaprāptairdaśabhūmisthitaiḥ tad yathā	ཐམས་ཅད་ཀྱང་ས་བརྒྱད་པ་དང་། ས་བཅུ་པ་ལ་གནས་པ་ཤ་སྟག་སྟེ་།
 āryāvalokiteśvareṇa maṃjuśriyāvimalaketunā ratnaśriyā vajraketunā vimalaprabheṇa candanena amṛtaketunā evaṃpramukhaiḥ saptaśataiḥ bodhisattvaiḥ sārdham upāsakopāsikābhiḥ sarvaiśca vyākṛtaiḥ samādhiprāptaiḥ nānālokadhātubhiḥ sannipatitaiḥ pañcasahasraiḥ	འཕགས་པ་སྤྱན་རས་གཟིགས་དབང་ཕྱུག་དང་། འཇམ་དཔལ་དང་། དྲི་མེད་ཏོག་དང་། ནོར་དཔལ་དང་། གློག་གི་ཏོག་དང་། དྲི་མེད་འོད་དང་། ཙནདན་དང་། བདུད་རྩིའི་ཏོག་ལ་སོགས་པ་བྱང་ཆུབ་སེམས་དཔའ་སེམས་དཔའ་ཆེན་པོ་བདུན་བརྒྱ་དང་། དགེ་བསྙེན་དང་། དགེ་བསྙེན་མ་ཐམས་ཅད་ཀྱང་ལུང་བསྟན་པ་དང་ལྡན་པ་། ཏིང་ངེ་འཛིན་ཐོབ་པ་།
 sarvaiḥ gandharvaśatasahasraiḥ pūrvabuddhaparyupāsitaiḥ	འཇིག་རྟེན་གྱི་ཁམས་ཐ་དད་པ་ནས་འདུས་པ་ལྔ་སྟོང་དང་། ལྷ་དང་། ཀླུ་དང་། གནོད་སྦྱིན་དང་། དྲི་ཟ་ཐམས་ཅད་ཀྱང་སྔོན་གྱི་སངས་རྒྱས་ལ་བསྙེན་བཀུར་བྱས་པ་།
 tathāgataprātihāryadṛṣṭaiḥ sārdhaṃ sarvābhiḥ mahāyakṣiṇībhiḥ bodhisattvajñānaprāptābhiḥ	དེ་བཞིན་གཤེགས་པའི་ཆོ་འཕྲུལ་མཐོང་བ་བརྒྱ་སྟོང་དང་། གནོད་སྦྱིན་མོ་ཆེན་མོ་ཐམས་ཅད་ཀྱང་བྱང་ཆུབ་སེམས་དཔའི་ཡེ་ཤེས་ཐོབ་པ་ལུང་བསྟན་པ་ཐོབ་པ་། 
 vyākaraṇaprāptābhiravaivartikābhiḥ anaupamyayā vimalaprabhayā ca prabhāvatyā bhīmaśriyā yakṣiṇyā ca evaṃpramukhābhiraśītyā mahāyakṣiṇībhiḥ | śatakratubrahmavaiśravaṇa dhṛtarāṣṭravirūḍhakavirūpākṣamaṇibhadraputrapūrṇabhadrāḥ etaiśca lokapālaiḥ sārdhaṃ niṣaṇṇo 'bhūt |	ཕྱིར་མི་ལྡོག་པ་དཔེ་མེད་མ་དང་། དྲི་མེད་འོད་དང་། འོད་ཅན་མ་དང་། འཇིགས་བྱེད་མ་དང་། དཔལ་ལྡན་མ་དང་། འཕྲོག་མ་དང་། དུང་ཅན་མ་ལ་སོགས་པ་གནོད་སྦྱིན་མོ་ཆེན་མོ་བརྒྱད་ཅུ་དང་། བརྒྱ་བྱིན་དང་། ཚངས་པ་དང་། རྣམ་ཐོས་ཀྱི་བུ་དང་། ཡུལ་འཁོར་སྲུང་དང་། འཕགས་སྐྱེས་པོ་དང་། མིག་མི་བཟང་དང་། ནོར་བུ་བཟང་པོའི་བུ་དང་། གང་པ་བཟང་པོ་ལ་སོགས་པ་འཇིག་རྟེན་སྐྱོང་བ་ཐམས་ཅད་ཀྱི་བར་དག་དང་ཐབས་ཅིག་ཏུ་བཞུགས་སོ་༎ 
 atha taiḥ sarvaistathāgataṃ siṃhāsananiṣaṇṇaṃ jñātvā svakasvakaiḥ kuśalamūlaistathāgataṃ	དེ་ནས་དེ་དག་ཐམས་ཅད་ཀྱིས་དེ་བཞིན་གཤེགས་པ་སེངགེའི་ཁྲི་ལ་༄༤༡༧ཨ་༌༎ བཞུགས་པར་རིག་ནས་རང་རང་གི་དགེ་བའི་རྩ་བ་དག་གིས་དེ་བཞིན་གཤེགས་པ་ལ་ལྷའི་རྒྱན་དང་། 
 divyālaṃkāravastrapuṣpamālyadhūpavilepanavādyaśabdena mānitaḥ pūjitaḥ śatasahasrakoṭiśaḥ	ན་བཟའ་དང་། མེ་ཏོག་དང་། མེ་ཏོག་ཕྲེང་དང་། སྤོས་དང་། བྱུག་པ་དང་། རོལ་མོའི་སྒྲ་རྣམས་ཀྱིས་མཆོད་པར་བྱས་། རི་མོར་བྱས་སོ་༎ ཁ་ཅིག་གིས་ལན་འབུམ་ཕྲག་དུ་མར་བསྐོར་བ་བྱས་ཏེ་བསྟོད་དོ་༎
 pradakṣiṇīkṛtya arcitaśca | tena khalu punaḥ samayena bhagavān sarvasattvamahākaruṇājñānasthitaṃ nāma samādhiṃ samāpanno 'bhūt |	དེ་ནས་དེའི་ཚེ་བཅོམ་ལྡན་འདས་སེམས་ཅན་ཐམས་ཅད་ལ་དམིགས་པ་སྙིང་རྗེ་ཆེན་པོའི་ཤེས་པ་ལ་གནས་པ་ཞེས་བྱ་བའི་ཏིང་ངེ་འཛིན་ལ་སྙོམས་པར་ཞུགས་སོ་༎
 tena samādhidhāraṇabalena trisāhasramahāsāhasralokadhātavaḥ ābhayā avabhāsitā abhūvan | sarvarūpāṇi sphuṭitāni |	ཏིང་ངེ་འཛིན་དེའི་མཐུས་སྟོང་གསུམ་གྱི་སྟོང་ཆེན་པོའི་འཇིག་རྟེན་གྱི་ཁམས་འདི་འོད་ཀྱིས་སྣང་བར་གྱུར་ཅིང་། གཟུགས་ཐམས་ཅད་སྣང་བས་ཁྱབ་པར་གྱུར་ནས་སེམས་ཅན་དམུས་ལོང་གང་ཡིན་པ་དེ་གྱུར་ཅིང་། དག་གིས་ནི་། 
 ye ca sattvā jātyandhāḥ cakṣuṣā rūpāṇi paśyanti sma |	མིག་གིས་གཟུགས་མཐོང་བར་གྱུར་ཏོ་༎
 vadhirāḥ śrotreṇa śabdān śṛṇvanti sma |	འོན་པ་རྣམས་ཀྱིས་ནི་རྣ་བས་སྒྲ་དག་ཐོས་པར་གྱུར་ཏོ་༎
 rogaspṛṣṭā vigatarogā bhavanti sma |	ནད་ཀྱིས་བཏབ་པ་རྣམས་ནི་ནད་དག་དང་བྲལ་བར་གྱུར་ཏོ་༎
 nagnāśca vastrāvṛtā vabhūvuḥ |	གོས་མེད་པ་རྣམས་ནི་གོས་དག་ཐོབ་པར་གྱུར་ཏོ་༎
 unmattāḥ smṛtiṃ pratilabhante sma |	སྨྱོན་པ་རྣམས་ནི་དྲན་པ་ཐོབ་པར་གྱུར་ཏོ་༎
 hīnakāyāḥ paripūrṇendriyā babhūvuḥ |	ལུས་ཉམས་པ་དང་དབང་པོ་མ་ཚང་བ་རྣམས་ནི་ལུས་དང་དབང་པོ་ཡོངས་སུ་རྫོགས་པར་གྱུར་ཏོ༏་༏དབུལ་པོ་རྣམས་ཀྱིས་ནི་ནོར་དག་ཐོབ་པར་གྱུར་ཏོ་༎ 
 daridra dhanāni pratilabhante sma | sattvānāṃ yaḥ khalu dhanavastubhogavihīna āsīt sa dhanavastubhogasampanno 'bhūt |	སེམས་ཅན་གང་དག་ནོར་དང་། ཡོ་བྱད་དང་། ལོངས་སྤྱོད་མེད་པ་དེ་དག་ནོར་དང་། ཡོ་བྱད་དང་། ལོངས་སྤྱོད་དག་དང་༄༤༡༧བ་ལྡན་པར་གྱུར་ཏོ་༎
 sarvasattvāḥ sarvasukhasamarpitāḥ sarvāśāparipūrṇā abhūvan |	སེམས་ཅན་ཐམས་ཅད་ཀྱང་བདེ་བ་ཐམས་ཅད་དང་ལྡན་ཞིང་བསམ་པ་ཐམས་ཅད་ཡོངས་སུ་རྫོགས་པར་གྱུར་ཏོ་༎ 
 trisāhasramahāsāhasralokadhātau ye kecit sattvā anuśāsanadharmaśravaṇāya yena bhagavān tenāṃjaliṃ praṇamya upasaṃkrāntāḥ | ye sattvāḥ (dutt 50)	སྟོང་གསུམ་གྱི་སྟོང་ཆེན་པོའི་འཇིག་རྟེན་གྱི་ཁམས་ཀྱི་སེམས་ཅན་གང་ཡིན་པ་དེ་དག་ཐམས་ཅད་ལའང་བསྐུལ་ནས་ཐམས་ཅད་ཆོས་མཉན་པའི་ཕྱིར་བཅོམ་ལྡན་འདས་ག་ལ་བ་དེར་ལྷགས་གྱུར་ཏོ་༎ 
 devabhūtāste sarvadevasukhaṃ saṃprahāya buddhānusmṛtiṃ kṛtvā dharmaśravaṇāya yena bhagavān tena upasaṃkrāntāḥ |	ཏེ་། སེམས་ཅན་གང་དག་ལྷ་རྣམས་ཀྱི་ནང་དུ་སྐྱེས་པ་དེ་དག་ཐམས་ཅད་ཀྱིས་ནི་ལྷའི་བདེ་བ་ཡོངས་སུ་སྤངས་ནས་སངས་རྒྱས་རྗེས་སུ་དྲན་པར་བྱས་ཏེ་ཆོས་མཉན་པའི་ཕྱིར་བཅོམ་ལྡན་འདས་ག་ལ་བ་དེར་ལྷགས་སོ་གྱུར་ཏོ་༎ ཏེ་། 
 ye sattvā manuṣyabhūtāste ca manuṣyasukhaṃ parityajya dharmaśravaṇakāmāya yena bhagavāṃstena upasaṃkrāntāḥ |	༎ སེམས་ཅན་གང་དག་མི་རྣམས་ཀྱི་ནང་དུ་སྐྱེས་པ་དེ་དག་གིས་ཀྱང་མིའི་བདེ་བ་ཡོངས་སུ་སྤངས་ནས་ཆོས་མཉན་པའི་ཕྱིར་བཅོམ་ལྡན་འདས་ག་ལ་བ་དེར་ལྷགས་གྱུར་ཏོ་༎ ཏེ་། ༎ སོ་༎ 
 ye sattvā nāgayakṣarākṣasapretapiśācabhūtāste buddhānusmṛtiṃ prāpya sarvasattveṣu maitracittā bhūtvā kāyacittasukhaṃ labdhvā dharmaśravaṇāya yena bhagavān tenopasaṃkrāntāḥ |	སེམས་ཅན་གང་དག་ཀླུ་དང་། གནོད་སྦྱིན་དང་། སྲིན་པོ་དང་། ཡི་དབ༹གས་དང་། ཤ་ཟ་རྣམས་ཀྱི་ནང་དུ་སྐྱེས་པ་དེ་དག་གིས་ཀྱང་སངས་རྒྱས་རྗེས་སུ་དྲན་པ་སོ་སོར་ཐོབ་ནས་སེམས་ཅན་ཐམས་ཅད་ལ་བྱམས་པར་གནས་པ་དང་། ལུས་དང་སེམས་བདེ་བར་གྱུར་ནས་ཆོས་མཉན་པའི་ཕྱིར་བཅོམ་ལྡན་འདས་ག་ལ་བ་པ་དང་། དེར་ལྷགས་སོ་༎ 
 ye sattvā yamaloke andhatamisrāyāṃ jātāste 'pi buddhānubhāvena ekakṣaṇaṃ smṛtiṃ labdhvā parasparaṃ saṃjānate sma |	སེམས་ཅན་གང་དག་གཤིན་རྗེའི་འཇིག་རྟེན་རྣམས་སུ་མུན་པ་མུན་ནག་གི་ནང་དུ་སྐྱེས་པ་དེ་དག་ཀྱང་སངས་རྒྱས་ཀྱི་མཐུས་ཡུད་ཙམ་ཞིག་དྲན་པ་སོ་སོར་ཐོབ་ནས་གཅིག་གིས་གཅིག་ཀུན་ཏུ་ཤེས་པར་གྱུར་པ་དང་། དེར་ལྷགས་སོ་༎ ཏེ་། 
 te mahātamisrābhyaḥ parimuktā babhūvuḥ |	དེ་དག་མུན་པ་༄༤༡༨ཨ་༌༎ ཆེན་པོ་དེ་ནས་ཡོངས་སུ་ཐར་པར་གྱུར་ཏོ་༎
 sarve satvāḥ parasparaṃ maitracittā babhūvuḥ | teṣāmupakleśāḥ kṣīṇā abhūvan |	སེམས་ཅན་ཐམས་ཅད་གཅིག་ལ་གཅིག་བྱམས་པར་གནས་ཤིང་ཉེ་བའི་ཉོན་མོངས་པ་རྣམས་དང་བྲལ་བར་གྱུར་ཏོ་༎ 
 tena khalu samayena mahāpṛthivī ṣaḍ vikāraṃ prakampate unnamati avanamati sma |	དེ་ནས་དེའི་ཚེ་ས་ཆེན་པོ་འདི་རྣམ་པ་དྲུག་ཏུ་རབ་ཏུ་ག-ཡོས་ཏེ་མཐོ་གྱུར་ཏོ་༎ 
 atha tasyāṃ parṣadi maṃjuśrīkumārabhūtaḥ sanniṣaṇṇaḥ san bodhisattvaṃ mahāsattvamāryāvalokiteśvarametadavocat |	བ་དང་། དམའ་བར་གྱུར་ཏོ་༎ དེ་ནས་འཁོར་འདུས་པ་དེར་འཇམ་དཔལ་གཞོན་ནུར་གྱུར་པ་འདུས་ཏེ་འདུག་པར་གྱུར་ནས་དེས་བྱང་ཆུབ་སེམས་དཔའ་སེམས་དཔའ་ཆེན་པོ་འཕགས་པ་སྤྱན་རས་གཟིགས་དབང་ཕྱུག་ལ་འདི་སྐད་ཅེས་སྨྲས་སོ་༎ རིགས་ཀྱི་བུ་།
 kulaputra mahābodhisattvaparṣadi avabhāsitāyāṃ mahāparṣadaḥ pūrvanimittaṃ parisphuṭam |	བྱང་ཆུབ་སེམས་དཔའི་འདུས་པ་ཆེན་པོ་ཀུན་ཏུ་སྣང་ཞིང་འདུས་པ་ཆེན་པོའི་སྔ་ལྟས་ཀྱང་ཀུན་ཏུ་སྣང་ལ་། རིགས་ཀྱི་བུ་།
 anekabodhisattvakoṭiniyutaśatasahasrāṇāṃ ca vyākaraṇaṃ prakaṭitam | dharmamahāvākyasya pūrvanimittaṃ saṃdṛśyate |	བྱང་ཆུབ་སེམས་དཔའ་བྱེ་བ་ཁྲག་ཁྲིག་འབུམ་ཕྲག་མང་པོ་དག་ལུང་སྟོན་པའང་ཀུན་ཏུ་སྣང་ཞིང་ཆོས་ཀྱི་འབྲེལ་བའི་གཏམ་ཆེན་པོའི་སྔ་ལྟས་ཀྱང་ཀུན་ཏུ་སྣང་བ་ལས་ན་།
 kulaputra anekānāṃ ca bodhisattvakoṭiniyutaśatasahasrāṇāṃ sarvāśāparipūri mahājñānapratilambho bhaviṣyati |	རིགས་ཀྱི་བུ་། བྱང་ཆུབ་སེམས་དཔའ་བྱེ་བ་ཁྲག་ཁྲིག་འབུམ་ཕྲག་དུ་མ་དག་གི་རེ་བ་ཐམས་ཅད་ཡོངས་སུ་རྫོགས་པར་འགྱུར་ཞིང་ཡེ་ཤེས་ཆེན་པོའང་འཐོབ་པར་འགྱུར་གྱི་། རིགས་ཀྱི་བུ་།
 tat kulaputra sattvānāṃ kāruṇyamutpādya hitāya sukhāya yāvadanuttarasyāṃ samyaksaṃbodhau pratiṣṭhāpanāya tathāgataṃ paripṛccha |	དེའི་ཕྱིར་ཁྱེད་ཀྱིས་སེམས་ཅན་ཐམས་ཅད་ལ་སྙིང་རྗེ་སྐྱེད་ལ་། ཕན་པ་དང་། བདེ་བ་དང་། བླ་ན་མེད་པ་ཡང་དག་པར་རྫོགས་པའི་བྱང་ཆུབ་ལ་དགོད་པར་བྱ་བའི་བར་གྱི་ཕྱིར་དེ་བཞིན་གཤེགས་པ་ལ་ཡོངས་སུ་ཞུས་༄༤༡༨བ་ཤིག་། རིགས་ཀྱི་བུ་།
 santi kulaputra sattvāḥ paścime kāle paścime samaye bhaviṣyanti pāpakāriṇo daridrāḥ	ཕྱི་མའི་དུས་ཕྱི་མའི་ཚེ་ན་སེམས་ཅན་སྡིག་པ་བྱེད་པ་། དབུལ་བ་། ཉམ་ཆུང་བ་།
 kṛśā durvarṇaśarīrā jarāvyādhiparipīḍitāḥ parīttabhogā aparibhāvitakāyā alpāyuṣkā	ལུས་མདོག་ངན་པ་། རྒ་བ་དང་ན་བས་ཡོངས་སུ་གཟིར་བ་། ལོངས་སྤྱོད་ཆུང་བ་། ལུས་ཡོངས་སུ་མ་བསྒོམས་པ་། ཚེ་ཐུང་བ་།
 alpabuddhayo rāgadveṣamohaparipīḍitāḥ |	བློ་ཆུང་བ་། འདོད་ཆགས་དང་། ཞེ་སྡང་དང་། གཏི་མུག་གིས་ཡོངས་སུ་གཟིར་བ་དག་འབྱུང་བ་ཡོད་དེ་།
 teṣāmarthāya kulaputra tathāgatamadhyeṣaya dharmadeśanāyai tat te kṛtaṃ bhaviṣyati	རིགས་ཀྱི་བུ་། དེ་དག་གི་དོན་དུ་ཆོས་བསྟན་པར་བྱ་བའི་ཕྱིར་དེ་བཞིན་གཤེགས་པ་ལ་གསོལ་བ་ཐོབ་ཅིག་དང་། རིགས་ཀྱི་བུ་།
 dīrgharātraṃ sattvānā[marthāya] hitāya sukhāya sarvāvyādhipraśamanāya sarvapāpanivāraṇāya sarvapāpapraśamanāya sarvaśāparipūraṇārthaṃ yāvadanuttaraparinirvāṇārtham | (dutt 51) i	དེའི་ཕྱིར་ཁྱོད་ཀྱིས་ཡུན་རིང་པོར་སེམས་ཅན་རྣམས་ཀྱི་དོན་དང་། ཕན་པ་དང་། བདེ་བ་དང་། ནད་ཐམས་ཅད་རབ་ཏུ་ཞི་བར་བྱ་བ་དང་། སྡིག་པ་ཐམས་ཅད་བཟློག་པར་བྱ་བ་དང་། སྡིག་པ་ཐམས་ཅད་རབ་ཏུ་ཞི་བར་བྱ་བ་དང་། རེ་བ་ཐམས་ཅད་ཡོངས་སུ་རྫོགས་པར་བྱ་བ་དང་། བླ་ན་མེད་པའི་ཡོངས་སུ་མྱ་ངན་ལས་འདའ་བ་དག་བྱས་པར་འགྱུར་རོ་༎
 atha āryāvalokiśvaro bodhisattvo mahāsattvo daśadiśamavalokya gaṅgānadīvālukāsamāstathāgatakoṭīrmamanasi	དེ་ནས་བྱང་ཆུབ་སེམས་དཔའ་སེམས་དཔའ་ཆེན་པོ་འཕགས་པ་སྤྱན་རས་གཟིགས་དབང་ཕྱུག་གིས་ཕྱོགས་བཅུར་རྣམ་པར་བལྟས་ཏེ་།
 kurvan yena bhagavāṃstenāṃjaliṃ praṇamya triḥpradakṣiṇīkṛtya paṃcamaṇḍalena praṇipatya bhagavantametadavocat |	དེ་བཞིན་གཤེགས་པ་བྱེ་བ་ཕྲག་གངགའའི་ཀླུང་གི་བྱེ་མ་སྙེད་དག་ཡིད་ལ་བྱས་ནས་བཅོམ་ལྡན་འདས་ག་ལ་བ་དེ་ལོགས་སུ་ཐལ་མོ་སྦྱར་བ་བཏུད་དེ་ལན་གསུམ་བསྐོར་བ་བྱས་ནས་ཡན་ལག་ལྔས་ཕྱག་འཚལ་ཏེ་བཅོམ་ལྡན་འདས་ལ་འདི་སྐད་ཅེས་གསོལ་ཏོ་༎ བཅོམ་ལྡན་འདས་།
 santi bhagavan sattvāḥ paścime kāle bhaviṣyanti jarāvyādhiśokamṛtyu[duḥkha]kālamṛtyuparipīḍitāḥ	སླད་མའི་དུས་སླད་མའི་ཚེ་ན་སེམས་༄༤༡༩ཨ་༌༎ ཅན་རྒ་བ་དང་། ན་བ་དང་། འཆི་བ་དང་། མྱ་ངན་གྱིས་ནོན་པར་གྱུར་པ་། དུས་མ་ལགས་པར་འགུམ་པས་ཡོངས་སུ་གཟིར་བ་། ཉམ་ཆུང་བ་། མདོག་ངན་པ་།
 kṛśā durvarṇā alpāyuṣkāḥ parīttabhogā aparibhāvitakāyāste parasparāṇi mātsaryadauḥśīlyacittatayā	ཚེ་ཐུང་བ་། ལོངས་སྤྱོད་ཆུང་བ་། ལུས་ཡོངས་སུ་མ་བསྒོམས་པ་དག་འབྱུང་བ་མཆིས་ཏེ་། དེ་དག་ནི་། སེར་སྣ་དང་། འཆལ་བའི་ཚུལ་ཁྲིམས་ཀྱི་སེམས་ཀྱིས་གཅིག་ལ་གཅིག་འགུམ་པར་འགྱུར་ལ་། གཅིག་གིས་གཅིག་གི་ནོར་དང་། ལོངས་སྤྱོད་དང་། དབང་ཕྱུག་དག་འཕྲོག་པར་འགྱུར་ཞིང་།
 ghātayiṣyanti parasparāṇi dhanabhogaiśvaryāṇyāpahariṣyanti hāsyalāsyanāṭyakrīḍābhiratāḥ anitye nityasaṃjñinaḥ aśubhe śubhasaṃjñinaḥ |	གད་མོ་དང་། འཇོ་སྒེག་དང་། བྲོ་གར་དང་། རྩེད་མོ་དག་གིས་མངོན་པར་རྩེ་བ་དང་། མི་རྟག་པ་ལ་རྟག་པར་འདུ་ཤེས་པ་དང་། མི་སྡུག་པ་ལ་སྡུག་པར་འདུ་ཤེས་པར་བགྱིད་ལགས་སོ་༎ དེ་ཅིའི་སླད་དུ་ཞེ་ན་།
 te taddhetau tannidānā sattvā nānāprakārairviha[ga]narakatiryagyoniyamalokeṣu copapatsyante |	དེ་དག་རྒྱུ་དེ་དང་། གཞི་དེས་སེམས་ཅན་རྣམས་ལ་མི་དགེ་བ་རྣམ་པ་སྣ་ཚོགས་དག་གིས་གཙེས་ནས་སེམས་ཅན་དམྱལ་བ་དང་། དུད་འགྲོའི་སྐྱེ་གནས་དང་། གཤིན་རྗེའི་འཇིག་རྟེན་དག་ཏུའང་སྐྱེ་བར་འགྱུར་ལགས་པས་། བཅོམ་ལྡན་འདས་།
 tat teṣāmahaṃ bhagavan arthāya hitāya sarvāśāparipūrarṇārthaṃ yāvat tathāgatajñānāharaṇārthaṃ buddhakṣetropapattaye sarvapāpanivāraṇārthaṃ tathāgatamadhyeṣyāmi	དེའི་སླད་དུ་བདག་དེ་དག་གི་དོན་དང་། སྨན་པ་དང་། བདེ་བ་དང་། རེ་བ་ཐམས་ཅད་ཡོངས་སུ་རྫོགས་པར་བགྱི་བ་དང་། དེ་བཞིན་གཤེགས་པའི་ཡེ་ཤེས་ཐོབ་པར་བགྱི་བ་དང་། སངས་རྒྱས་ཀྱི་ཞིང་དུ་སྐྱེ་བར་བགྱི་བ་དང་། སྡིག་པ་ཐམས་ཅད་བཟློག་པར་བགྱི་བའི་སླད་དུ་དེ་བཞིན་༄༤༡༩བ་གཤེགས་པ་ལ་གསོལ་བ་འདེབས་པར་འཚལ་གྱི་། བཅོམ་ལྡན་འདས་།
 bhāṣasva bhagavan bhāṣasva sugato nāsti tathāgatasya tajjñānaṃ yadaviditam adṛṣṭam aśrutam avijñātameva | bahavo bhagavan bodhisattvabhikṣubhikṣuṇyupāsakopāsikā devanāgā yakṣagandharvāsurakinnarāśca samāgatā dharmasāṃkathyaṃ śrotukāmāḥ pūrvabuddhaparyupāsitāḥ saprajñā jātāḥ te nirāśībhūtā prakramiṣyanti |	དེ་བཞིན་གཤེགས་པ་ལ་ནི་མི་མཁྱེན་པ་དང་། མ་རྟོགས་པ་དང་། མ་གཟིགས་པ་དང་། མ་གསན་པ་དང་། རྣམ་པར་མི་མཁྱེན་པ་ཅིའང་མི་མངའ་བས་ཆོས་ཀྱི་འབེལ་བའི་གཏམ་ཉན་པར་འཚལ་བ་དང་། སྔོན་གྱི་སངས་རྒྱས་ལ་བསྙེན་བཀུར་བགྱིས་པ་དང་། ཤེས་རབ་དང་ལྡན་པའི་རང་བཞིན་ཅན་གྱི་བྱང་ཆུབ་སེམས་དཔའ་དང་། དགེ་སློང་དང་། དགེ་སློང་མ་དང་། དགེ་བསྙེན་དང་། དགེ་བསྙེན་མ་དང་། ལྷ་དང་། ཀླུ་དང་། གནོད་སྦྱིན་དང་། དྲི་ཟ་དང་། ལྷ་མ་ཡིན་དང་། ནམ་མཁའ་ལྡིང་དང་། མི་འམ་ཅི་དང་། ལྟོ་འཕྱེ་ཆེན་པོ་མང་པོ་ལྷགས་པ་འདི་དག་རེ་བ་མ་མཆིས་པར་གྱུར་ཅིང་། སླར་མཆི་བར་མི་འགྱུར་བར་བཅོམ་ལྡན་འདས་། བཤད་དུ་གསོལ་།
 atha te sarve yathā samāgatāḥ parṣat paṃcamaṇḍalena praṇipatya ekakaṇṭhena evamāhuḥ |	བདེ་བར་གཤེགས་པ་། བཤད་དུ་གསོལ་། དེ་ནས་ཐམས་ཅད་དང་ལྡན་པའི་འཁོར་ཇི་ལྟར་ལྷགས་པ་དེ་དག་གིས་ཀྱང་ཡན་ལག་ལྔས་ཕྱག་བྱས་ཏེ་ཚིག་མཐུན་པར་འདི་སྐད་ཅེས་གསོལ་ཏོ་༎ བཅོམ་ལྡན་འདས་།
 sādhu bhagavan bhāṣasva bhagavan bhāṣasva sugataḥ |	ལེགས་པར་བཤད་དུ་གསོལ་། བདེ་བར་གཤེགས་པ་། ལེགས་པར་བཤད་དུ་གསོལ་།
 (dutt 52) atha bhagavān dvirapi trirapi adhyeṣaṇāṃ viditvā daśadiśamavalokya valgumaṇojñasvareṇāryāvalokiteśvaraṃ bodhisattvaṃ mahāsattvametadavocat	དེ་ནས་བཅོམ་ལྡན་འདས་ཀྱིས་ལན་གཉིས་ལན་གསུམ་དུ་གསོལ་བ་བཏབ་པར་ཐུགས་སུ་ཆུད་ནས་ཕྱོགས་བཅུར་རྣམ་པར་གཟིགས་ཏེ་། སྙན་ཅིང་འཇེབས་ལ་ཡིད་དུ་འོང་བའི་གསུང་དབྱངས་ཀྱིས་བྱང་ཆུབ་སེམས་༄༤༢༠ཨ་༌༎ དཔའ་སེམས་དཔའ་ཆེན་པོ་འཕགས་པ་སྤྱན་རས་གཟིགས་དབང་ཕྱུག་ལ་འདི་སྐད་ཅེས་བཀའ་སྩལ་ཏོ་༎
 asti kulaputra sarvatathāgatādhiṣṭhānsattvāvalokanabuddhakṣetrasandarśanavyūho nāma samādhiḥ yo mayā pūrvaṃ prathamacittotpādamupādāya śrutaḥ	རིགས་ཀྱི་བུ་། དེ་བཞིན་གཤེགས་པ་ཐམས་ཅད་ཀྱི་བྱིན་གྱི་རླབས་སེམས་ཅན་ལ་གཟིགས་ཤིང་སངས་རྒྱས་ཀྱི་ཞིང་གི་བཀོད་པ་ཀུན་ཏུ་སྟོན་པ་ཞེས་བྱ་བའི་ཏིང་ངེ་འཛིན་ཡོད་དེ་། ངས་སྔོན་དང་པོ་སེམས་བསྐྱེད་པ་ནས་བཟུང་སྟེ་།
 sukusumajyotiḥsandarśanasya tathāgatasyāntikāt śrutaḥ |	དེ་བཞིན་གཤེགས་པ་མེ་ཏོག་སྣང་བ་ཀུན་ཏུ་སྟོན་པ་ཞེས་བྱ་བའི་སྤྱན་སྔར་དེ་ཐོས་སོ་༎ རིགས་ཀྱི་བུ་།
 tat sahaśravaṇādeva tasya samādhernāmadheyasya navatīnāṃ sattvakoṭīnāṃ tathāgatajñānapratilambho 'bhūt | te sarve ca vyākṛtāstathāgatairnānābyuddhakṣetreṣu |	ཏིང་ངེ་འཛིན་དེའི་མིང་ཐོས་མ་ཐག་ཏུ་སེམས་ཅན་བྱེ་བ་ཕྲག་དགུ་བཅུས་དེ་བཞིན་གཤེགས་པའི་ཡེ་ཤེས་ཐོབ་པར་གྱུར་ནས་ཐམས་ཅད་ཀྱང་དེ་བཞིན་གཤེགས་པས་སངས་རྒྱས་ཀྱི་ཞིང་ཐ་དད་པ་དག་ཏུ་ལུང་བསྟན་ཏེ་།
 mayā ca kulaputra vyākaraṇamanuprāptam |	ངས་ཀྱང་ལུང་བསྟན་པ་ཐོབ་བོ་༎ རིགས་ཀྱི་བུ་།
 tat smarāmyahaṃ kulaputra divyena tathāgatajñānena triṃśatyā tathāgatasahasrairayaṃ dharmaparyāyo bhāṣitaḥ sattvānāmarthāya |	ངས་དེ་བཞིན་གཤེགས་པའི་ལྷའི་མཁྱེན་པས་སྔོན་དེ་བཞིན་གཤེགས་པ་སུམ་ཁྲིས་སེམས་ཅན་ཐམས་ཅད་ཀྱི་དོན་དུ་ཆོས་ཀྱི་རྣམ་གྲངས་འདི་བཤད་དེ་།
 sarvatra tvamevāryāvalokiteśvara tathagatādhyeṣakaḥ maṃjuśriyaśca kumārabhūtaḥ |	ཐམས་ཅད་དུའང་དེ་བཞིན་གཤེགས་པ་ལ་གསོལ་བ་འདེབས་པ་ནི་འཕགས་པ་སྤྱན་རས་གཟིགས་དབང་ཕྱུག་ཁྱོད་ཉིད་དང་། འཇམ་དཔལ་གཞོན་ནུར་གྱུར་པ་ཡིན་ལ་། བྱང་ཆུབ་སེམས་།
 ayaṃ ca yathā samāgatā sarvabodhisattvānāṃ parṣad bhikṣubhikṣuṇyupāsakopāsikā parṣad[ete sarve]śrutvā mānanāṃ pūjanāṃ kurvanti sma |	དཔའ་སེམས་དཔའ་ཆེན་པོའི་འཁོར་རྣམས་དང་། དགེ་སློང་དང་། དགེ་སློང་མ་དང་། དགེ་བསྙེན་དང་། དགེ་བསྙེན་མ་འཁོར་ཇི་ལྟར་ལྷགས་པ་འདི་དག་གིས་ཀྱང་ཐོས་ནས་རི་༄༤༢༠བ་མོ་དང་། མཆོད་པ་དག་བྱས་ཏེ་།
 tataścānekāni sattvakoṭīniyutaśatasahasrāṇi vyākaraṇaṃ pratilabhante sma | bodhisattvasamādhīnāṃ ca lābhino bhavanti | sarvakāmaṃ gatāḥ kṛtasarvāśāḥ samṛdhyante vigatavyādhayaḥ saṃvṛttā paripakvakuśalamūlāḥ	དེའི་འོག་ཏུ་སེམས་ཅན་བྱེ་བ་ཁྲག་ཁྲིག་འབུམ་ཕྲག་དུ་མ་ངག་གིས་ལུང་བསྟན་པ་ཐོབ་ཅིང་བྱང་ཆུབ་སེམས་དཔའི་ཏིང་ངེ་འཛིན་དག་ཐོབ་པར་གྱུར་ནས་འདོད་པ་ཐམས་ཅད་དུ་འགྲོ་བ་དང་། རེ་བ་ཐམས་ཅད་གྲུབ་པ་དང་། ནད་རྣམས་དང་བྲལ་བར་ཡང་གྱུར་ལ་།
 sarvāvaraṇaprahīṇā abhirūpaprāsādikadarśanīyā dhanadhānyakośakoṣṭhāgārasamṛddhāḥ sarvarājarājaputrāmatyābhinandanīyāḥ sarvasattvairvandanīyāḥ (dutt 53) smṛtimantaḥ prajñāvantaḥ buddhe dhama saṃghe abhedyaprasādena samanvāgatā dhṛtimantaḥ āyurvarṇatejobalarathāmavantaḥ sarvākāravaropetāḥ samanvāgatāḥ	དགེ་བའི་རྩ་བ་རྣམས་ཡོངས་སུ་སྨིན་པ་དང་། སྒྲིབ་པ་ཐམས་ཅད་སྤངས་པ་དང་། གཟུགས་བཟང་ཞིང་མཛེས་ལ་བལྟ་ན་སྡུག་པ་དང་། ནོར་དང་། འབྲུ་དང་། མཛོད་དང་། བང་བ་རྣམས་འབྱོར་བ་དང་། རྒྱལ་པོ་དང་། རྒྱལ་བུ་དང་། བློན་པོ་རྣམས་ཀྱིས་མངོན་པར་བསྟོད་པར་འོས་པ་དང་། སེམས་ཅན་ཐམས་ཅད་ཀྱིས་ཕྱག་བྱ་བར་འོས་པ་དང་། དྲན་པ་དང་ལྡན་པ་དང་། ཤེས་རབ་དང་ལྡན་པ་དང་། སངས་རྒྱས་དང་། ཆོས་དང་། དགེ་འདུན་ལ་དད་པ་མི་ཕྱེད་པ་དང་ལྡན་པ་དང་། རྫུ་འཕྲུལ་དང་ལྡན་པ་དང་། ཚེ་དང་། ཁ་དོག་དང་། གཟི་བརྗིད་དང་། མཐུ་སྟོབས་དང་ལྡན་ཞིང་རྣམ་པ་ཐམས་ཅད་ཀྱི་མཆོག་དང་ལྡན་པར་གྱུར་ཏེ་།
 na ca kadācit priyaviprayogaṃ na priyavyasanaṃ saṃvṛttam |	ནམ་ཡང་སྡུག་པ་དང་བྲལ་བར་མ་གྱུར་ཅིང་། སྡུག་པའི་སྡུག་བསྔལ་མེད་པར་གྱུར་པ་དེ་དྲན་ཏེ་། རིགས་ཀྱི་བུ་།
 evaṃ kulaputra bahuguṇasasanvāgatāste kulaputrā vā kuladuhitaraśca bhaviṣyanti |	དེ་ལྟར་ན་། རིགས་ཀྱི་བུའམ་། རིགས་ཀྱི་བུ་མོ་དག་ཆོས་སྨྲ་བ་དེ་ལ་མཆོག་ཏུ་གུས་པའི་སེམས་བསྐྱེད་དེ་།
 yadā saddharmaparyāyaṃ paṃcamaṇḍalena praṇipatya puṣpadhūpagandhamālyavilepanacchatradhvajapatākaiḥ	ཆོས་ཀྱི་རྣམ་གྲངས་འདི་ལ་ཡན་ལག་ལྔས་ཕྱག་བྱས་ཤིང་། མེ་ཏོག་དང་། བདུག་སྤོས་དང་། མེ་ཏོག་ཕྲེང་དང་། ༄༤༢༡ཨ་༌༎ བྱུག་པ་དང་། གདུགས་དང་། རྒྱལ་མཚན་དང་། བ་དན་དག་གིས་ལེགས་པར་བརྒྱན་ནས་སངས་རྒྱས་ལ་ཕྱག་འཚལ་ལོ་༎ ཞེས་བརྗོད་ཅིང་ཕྱག་འཚལ་བར་བྱེད་པ་དང་། ལགས་སོ་༎
 samalaṃkṛtya namo buddhāyeti kṛtvā namaskariṣyanti sādhukāraṃ dāsyanti dhārayiṣyanti vācayiṣyanti vācāpayiṣyanti likhiṣyanti likhāpayiṣyanti paramagauravaṃ cittamutpādya	ཞེས་བྱ་བ་སྦྱིན་པར་བྱེད་པ་དང་། འཛིན་པ་དང་། འཆང་བ་དང་། ཀློག་པ་དང་། ཡི་གེར་འབྲིར་འཇུག་པ་དེ་དག་ནི་ཡོན་ཏན་མང་པོ་དང་ལྡན་པར་འགྱུར་རོ་༎
 tasya dharmabhāṇakasyāntike te dṛṣṭa eva dharme sarvasaguṇasamanvāgatā bhaviṣyanti	དེ་དག་ནི་ཚེ་འདི་ཉིད་ལའང་ཡོན་ཏན་མང་པོ་དང་ལྡན་པར་འགྱུར་ཏེ་།
 abhirūpāḥ prāsādikā darśanīyā vigatavyādhayo dīrghāyuṣkāḥ sthirabuddhayaḥ smṛtimantaḥ dhṛtimantaḥ sarvarājānāṃ sarvarājñīnāṃ rājaputrāmātyānāṃ sarvaśatrūṇāṃ sarvasattvānāṃ cābhinandanīyā bhaviṣyanti vandanīyāḥ satkaraṇīyāḥ |	གཟུགས་བཟང་ཞིང་མཛེས་ལ་བལྟ་ན་སྡུག་པ་དང་། ནད་རྣམས་དང་བྲལ་བ་དང་། ཚེ་རིང་བ་དང་། བློ་བརྟན་པ་དང་། དྲན་པ་དང་ལྡན་པ་དང་། བརྟན་པ་དང་ལྡན་པ་དང་། རྒྱལ་པོ་ཐམས་ཅད་དང་། རྒྱལ་པོའི་བཙུན་མོ་ཐམས་ཅད་དང་། རྒྱལ་བུ་ཐམས་ཅད་དང་། བློན་པོ་ཐམས་ཅད་དང་། དགྲ་ཐམས་ཅད་དང་། སེམས་ཅན་གྱིས་མངོན་པར་བསྟོད་པར་འོས་པ་དང་། ཕྱག་བྱ་བར་འོས་པ་དང་། བསྙེན་བཀུར་བྱ་བར་འོས་པར་འགྱུར་རོ་༎
 prabhūtavittopakaraṇā bhaviṣyanti |	ནོར་དང་ཡོ་བྱད་མང་པོར་ཡང་འགྱུར་རོ་༎
 candanagandhaḥ cāsya mukhāt pravāsyati |	དེ་དག་གི་ཁ་ནས་ཙནདན་གྱི་དྲིའི་ངད་འབྱུང་བར་ཡང་འགྱུར་རོ་༎
 nīlotpalasadṛśanetro bhaviṣyati |	མིག་ཨཽཏཔ་ལ་སྔོན་པོའི་འདབ་མ་འདྲ་བར་ཡང་འགྱུར་རོ་༎
 rātrindivaṃ cāsya buddhabodhisattvadarśanaṃ bhaviṣyati |	དེ་དག་གིས་ཉིན་མཚན་དུ་སངས་རྒྱས་དང་བྱང་ཆུབ་སེམས་དཔའ་དག་མཐོང་བར་ཡང་འགྱུར་རོ་༎
 sarvāvaraṇaṃ cāsya kṣayaṃ cāsyanti paṃcānantaryaprabhṛtayaḥ kṛtvā | devatāśāsya (dutt 54)	མཚམས་མེད་པ་ལ་སོགས་པའི་སྒྲིབ་པ་ཐམས་ཅད་ཟད་པར་ཡང་འགྱུར་རོ་༎ དེ་དག་ལ་ལྷ་རྣམས་སྲུང་བར་ཡང་༄༤༢༡བ་འགྱུར་རོ་༎
 rakṣiṣyanti | maraṇakāle cāsya buddhadarśanaṃ bodhisattvadarśana bhaviṣyati |	དེ་དག་འཆི་བའི་དུས་ན་སངས་རྒྱས་དང་བྱང་ཆུབ་སེམས་དཔའ་དག་མཐོང་བར་ཡང་འགྱུར་རོ་༎
 na īrṣyāluko na vikṣepacittaṃ kālaṃ kariṣyati |	ཕྲག་དོག་མེད་པ་དང་། སེམས་རྣམ་པར་ག-ཡེང་བ་མེད་པར་འཆི་བའི་དུས་བྱེད་པར་ཡང་འགྱུར་རོ་༎
 yāvaccyutaḥ sukhāvatyāṃ lokadhātāvupapadyate vyākṛtāste mayā kulaputra saṃmukhavyākaraṇena |	ཤི་འཕོས་ནས་ཀྱང་འཇིག་རྟེན་གྱི་ཁམས་བདེ་བ་ཅན་དུ་སྐྱེ་བའི་བར་དུ་འགྱུར་རོ་༎ རིགས་ཀྱི་བུ་།
 dṛṣṭo 'haṃ taiḥ satkṛto mānitaḥ | na taiḥ saṃśayamutpādayitavyam | bodhau ya imaṃ dharmaparyāyaṃ dhārayiṣyanti satkṛtya likhiṣyanti likhāpayiṣyanti vācayiṣyanti pūjayiṣyanti udgrahīṣyanti nāmadheyaṃ ca	གང་དག་ཆོས་ཀྱི་རྣམ་གྲངས་འདི་འཛིན་པ་དང་། བསྙེན་བཀུར་བྱས་ཏེ་ཡི་གེར་འབྲི་བ་དང་། ཡི་གེར་འབྲིར་འཇུག་པ་དང་། ཀློག་པ་དང་། མཆོད་པར་བྱེད་པ་དང་། འཆང་བ་དང་། མིང་ཙམ་ཐོས་པར་འགྱུར་བ་དེ་དག་ནི་ངས་མངོན་སུམ་དུ་ལུང་བསྟན་པས་ལུང་བསྟན་པ་ཡིན་ཏེ་། དེ་དག་གིས་ང་མཐོང་ཞིང་བསྙེན་བཀུར་བྱས་། རི་མོར་བྱས་། མཆོད་པ་བྱས་པའང་ཡིན་པས་། དེ་དག་གིས་ནི་སངས་རྒྱས་ཀྱི་བྱང་ཆུབ་ལ་ཐེ་ཚོམ་བསྐྱེད་པར་མི་བྱའོ་༎
 śroṣyanti | bodhisattva iti sa manasi kṛtvā satkartavyaḥ |	གང་དག་གི་རྣ་ལམ་དུ་གྲག་པར་གྱུར་པ་དེ་དག་ཀྱང་བྱང་ཆུབ་སེམས་དཔའ་ཡིན་པར་ཡིད་ལ་བྱས་ལ་བསྙེན་བཀུར་བྱའོ་༎
 yenāsya pūvakarmavipākenāsya rūpavaikalyaṃ bhogavaikalyaṃ buddhivaikalyaṃ paribhāṣyaṃ ca priyaviprayogaṃ ca rājyakṣobhaṃ ca te asya samādheranubhāvena śravaṇena kecicchīrṣarogeṇa kecidbhaktacchedena kecit kucelābhidhāraṇena kecit kāyacittapīḍena kecit duḥkhasaṃsparśaśayyākalpanena	དེའི་སྔོན་གྱི་ལས་ཀྱི་རྣམ་པར་སྨིན་པས་གཟུགས་མི་མཛེས་པ་དང་། ལོངས་སྤྱོད་མེད་པ་དང་། བློ་མེད་པ་དང་། སྲེད་པ་ཆེ་བ་དང་། སྡུག་པ་དང་བྲལ་བ་དང་། རྒྱལ་སྲིད་འཁྲུགས་པར་གྱུར་པ་གང་ཡིན་པ་དེ་དག་དང་། ཀླད་པ་ན་བ་གང་ཡིན་པ་དང་། ཟན་ཆད་པ་གང་ཡིན་པ་དང་། གོས་ངན་པར་གྱུར་པ་གང་ཡིན་པ་དང་། ལུས་དང་སེམས་ལ་གནོད་པ་གང་ཡིན་པ་དང་། རེག་ན་མི་བདེ་བའི་མལ་བཅས་༄༤༢༢ཨ་༌༎
 kecit paribhāṣyeṇa sarvaṃ tat karmāvaraṇaṃ kṣayaṃ yāsyanti |	པ་གང་ཡིན་པ་དང་། སྤྱོ་བ་གང་ཡིན་པའི་ལས་ཀྱི་སྒྲིབ་པ་དེ་དག་ཐམས་ཅད་ཀྱང་ཏིང་ངེ་འཛིན་འདི་ཐོས་པའི་མཐུས་ཡོངས་སུ་ཟད་པར་འགྱུར་རོ་༎
 tena cavaṃ cittamutpādayitavyaṃ pūrvaṃ mayā saṃsāre saṃsaradbhiḥ pāpamakuśalaṃ sattveṣu nānāprakāramupacitaṃ taṃ pratideśayāmi āviṣkaromi na praticchādayāmi |	དེས་ཀྱང་འདི་ལྟར་སེམས་བསྐྱེད་པར་བྱ་སྟེ་། བདག་གིས་སྔོན་འཁོར་བ་ན་འཁོར་བའི་ཚེ་སེམས་ཅན་རྣམས་ལ་སྡིག་པ་མེ་དགེ་བ་རྣམ་པ་སྣ་ཚོགས་བསགས་པ་དེ་དག་སོ་སོར་བཤགས་པར་བྱའོ་༎ བསལ་བར་བྱའོ་༎
 buddhe dharme saṃghe abhedyaprasādacittamutpādayitavyam |	མི་བཅབ་པར་བྱའོ་༎ སངས་རྒྱས་དང་། ཆོས་དང་། དགེ་འདུན་ལ་དད་པ་མི་ཕྱེད་པ་དང་ལྡན་པའི་སེམས་བསྐྱེད་པར་བྱ་སྟེ་།
 yeca tasya kulaputrasya kuluduhiturvā chedabhogaphalaṃ saṃvartanīyaṃ (dutt 55)	རིགས་ཀྱི་བུའམ་རིགས་ཀྱི་བུ་མོ་དེའི་ལོངས་སྤྱོད་ཀྱི་འབྲས་བུ་མེད་པར་འགྱུར་བའི་ལས་ཀྱི་སྒྲིབ་པ་དང་། 
 karmāvaraṇaṃ bhaviṣyati buddhe vā dharme vā saṃghe vā śrāvakapratyekabuddhe vā mātāpitṛbhirvā [pāpa]karmakṛtamupacittaṃ bhaviṣyati tat sarva parikṣayaṃ yāsyati |	སངས་རྒྱས་དང་། ཆོས་དང་། དགེ་འདུན་དང་། ཉན་ཐོས་དང་། རང་སངས་རྒྱས་དག་དང་། ཕ་མ་དག་ལ་སྡིག་པའི་ལས་བྱས་ཤིང་བསགས་པར་གྱུར་པ་གང་ཡིན་པ་དེ་དག་ཐམས་ཅད་ཡོངས་སུ་ཟད་པར་འགྱུར་ཞིང་དབང་ཕྱུག་ཆེན་པོ་དག་ཀྱང་ཡང་དག་པར་འགྲུབ་པར་འགྱུར་རོ་༎
 mahaiśvaryasamṛddho bhaviṣyati | ye ca tasya kulaputrasya ca kuladuhiturvā duḥkhanārakavedanīyaṃ karmāvaraṇaṃ bhaviṣyati priyaviprayogasaṃvartanīyaṃ jātyandhasaṃvartanīyaṃ strīsaṃvartanīyaṃ dvivyaṃjanasaṃvartanīyaṃ	རིགས་ཀྱི་བུའམ་རིགས་ཀྱི་བུ་མོ་དེའི་སེམས་ཅན་དམྱལ་བའི་སྡུག་བསྔལ་མྱོང་བར་འགྱུར་བའི་ལས་ཀྱི་སྒྲིབ་པ་དང་། 
 īrṣyāmānakrodhavaśena yamalokapretatiryagyonisaṃvartanīyaṃ tat sarvaṃ parikṣayaṃ yāsyati |	སྡུག་པ་དང་བྲལ་བར་འགྱུར་བ་དང་། དམུས་ལོང་དུ་འགྱུར་བ་དང་། བུད་མེད་ཀྱི་དངོས་པོར་འགྱུར་བ་དང་། མཚན་གཉིས་པར་འགྱུར་བ་དང་། ཕྲག་དོག་དང་། ང་རྒྱལ་དང་། ཁྲོ་བའི་དབང་གིས་གཤིན་རྗེའི་འཇིག་རྟེན་༄༤༢༢བ་དང་། ཡི་དབ༹གས་དང་། དུད་འགྲོའི་སྐྱེ་གནས་སུ་འགྱུར་བ་གང་ཡིན་པ་དེ་དག་ཐམས་ཅད་ཀྱང་ཡོངས་སུ་ཟད་པར་འགྱུར་ཏེ་། 
 evaṃ kulaputra sarvaguṇākaro 'yaṃ samādheḥ |	རིགས་ཀྱི་བུ་། དེ་ལྟར་ན་། ཏིང་ངེ་འཛིན་འདི་ནི་ཡོན་ཏན་ཐམས་ཅད་ཀྱི་འབྱུང་གནས་ཡིན་ནོ་༎
 asti kulaputrāsya dharmaparyāyasya cirasthitikarāḥ |	རིགས་ཀྱི་བུ་།
 teṣāṃ ca kulaputrāṇāṃ kuladuhitṛṇāṃ rakṣāvaraṇaguptāni | sarveṣāṃ guṇānāṃ sarvaśāparipūrakarāṇi mahābhogaiśvaryasukhakarāṇi sarvacintitaprārthitasamṛddhikarāṇi sarvakarmakṣayaṃkarāṇi sarvākālamṛtyuduḥsvapnasarvavyādhipraśamanakarāṇī sarvayuddhajayaṃkarāṇi āyurvarṇabalavīryasthāmakarāṇi sarvayakṣabhūtamanuṣyavaśaṃkarāṇi sarvajvarāviṣādakapraśamanakarāṇi	ཆོས་ཀྱི་རྣམ་གྲངས་འདི་ཡུན་རིང་དུ་གནས་པར་བྱེད་པ་དང་། རིགས་ཀྱི་བུ་དང་། རིགས་ཀྱི་བུ་མོ་དེ་དག་ལ་སྲུང་བ་དང་། སྐྱོབ་པ་དང་། སྦེད་བར་བྱེད་པ་དང་། དེ་དག་ཐམས་ཅད་ཀྱི་ཡོན་ཏན་དང་། རེ་བ་ཐམས་ཅད་ཡོངས་སུ་རྫོགས་པར་ལོངས་སྤྱོད་པ་དང་། དབང་ཕྱུག་དང་། བདེ་བ་ཆེན་པོར་བྱེད་པ་དང་། བསམ་པ་དང་འདོད་པ་ཐམས་ཅད་ཡང་དག་པར་འགྲུབ་པར་བྱེད་པ་དང་། ལས་ཐམས་ཅད་ཟད་པར་བྱེད་པ་དང་། དུས་མ་ཡིན་པར་འཆི་བ་དང་། རྨི་ལམ་ངན་པ་ཐམས་ཅད་རབ་ཏུ་ཞི་བར་བྱེད་པ་དང་། ག-ཡུལ་ཐམས་ཅད་ལས་རྒྱལ་བར་བྱེད་པ་དང་། ཚེ་དང་། མདོག་དང་། སྟོབས་དང་། བརྩོན་འགྲུས་དང་། མཐུ་ཆེ་བར་བྱེད་པ་དང་། གནོད་སྦྱིན་དང་། འབྱུང་པོ་དང་། མི་དང་། མི་མ་ཡིན་པ་ཐམས་ཅད་དབང་དུ་བྱེད་པ་དང་། རིམས་དང་། དུག་དང་། མེ་དང་། ཆུ་ཐམས་ཅད་རབ་ཏུ་ཞི་བར་བྱེད་པ་དང་། ལུང་བསྟན་པའི་བར་དག་ཐོབ་པར་བྱེད་པའི་གཟུངས་ཀྱི་གསང་སྔགས་ཀྱི་གཞི་དག་ཡོད་དེ་།
 yāvadvyākaraṇapratilaṃbhakarāṇi dhāraṇīmantrapadāni yāni śrutvā dhāritvā vācitvā satkaritvā likhitvā likhapayitvā guptaye | sa te kulaputrā vā kuladuhitaraśca sarvānetān guṇān pratilabhante |	དེ་དག་མཉན་ཅིང་བཟུང་སྟེ་བསྙེན་བཀུར་བྱེད་པ་དང་། ཀློག་པ་དང་། ཡི་གེར་འབྲི་བ་དང་། ཡི་གེར་འབྲིར་འཇུག་པའི་རིགས་ཀྱི་བུ་དང་། རིགས་ཀྱི་བུ་༄༤༢༣ཨ་༌༎ མོ་དག་ནི་ཡོན་ཏན་དེ་དག་ཐམས་ཅད་འཐོབ་པར་འགྱུར་རོ་༎
 atha tasmin samaye iyaṃ mahāpṛthivī ṣaḍvikāramakaṃpata | sā ca yathā samāgatā parṣat tathāgataṃ puṣpadhūpagandhamālyaduṣyayugaiḥ saṃcchādya sādhukāramadāt |	དེ་ནས་དེའི་ཚེ་ས་ཆེན་པོ་འདི་རྣམ་པ་དྲུག་ཏུ་རབ་ཏུ་ག-ཡོས་པ་དང་། ཇི་ལྟར་ལྷགས་པའི་འཁོར་དེ་དག་གིས་ཀྱང་དེ་བཞིན་གཤེགས་པའི་སྐུ་ལ་མེ་ཏོག་དང་། བདུག་སྤོས་དང་། སྤོས་དང་། མེ་ཏོག་ཕྲེང་དང་། ཕྱེ་མ་དང་། བྱུག་པ་དང་། རས་བཅོས་བུ་ཟུང་དག་གསོལ་ཏེ་། ལེགས་སོ་ཞེས་བྱ་བ་གསོལ་ནས་བཅོམ་ལྡན་འདས་། ལེགས་སོ་༎
 sādhu sādhu bhagavan katamāni tāni mantrapadāni |	ལེགས་སོ་༎ གཟུངས་ཀྱི་གསང་སྔགས་ཀྱི་གཞི་དེ་དག་གང་ལགས་། བཅོམ་ལྡན་འདས་ཀྱིས་བཀའ་སྩལ་པ་།
 (dutt 56) namaḥ sarvatathāgatānām tadyathābuddhe subuddhe śuddhamate |	ན་མ༔་སརྦ་ཏ་ཐའ་ག་ཏའ་ནའམ། ཏདྱ་ཐའ་། བུདདྷེ་། སུ་བུདདྷེ་། བུདདྷ་མ་ཏེ་།
 loke viloke lokātikrānte |	ལོ་ཀ་བི་ལོ་ཀེ་ལོ་ཨཨ་ཏི་ཀརའནཏེ་། སཏབ༹་ཨཨ་བ་ལོ་ཀེ་ནི་།
 sattvāvalokane sarvatathāgatādhiṣṭhānādhiṣṭhite |	སརྦ་ཏ་ཐའ་ག་ཏ་ཨཨ་དྷིཤའ་ཏེ་། སརྦ་ཨཨ་ཤ་པ་རི་པའུ་ར་ནི་། དྱུ་ཏི་ནདྷ་རེ་།
 sarvaśāparipūraṇe dyutindhare narake ca pūjite tathāgatajñānadade tathāgatādhiṣṭhāne ca |	ན་ར་དེ་བ་པའུ་ཛི་ཏེ་ཏ་ཐའ་ག་ཏ་ཛཉའ་ན་ད་དེ་། ཏ་ཐའ་ག་ཏ་ཨཨ་དྷིཤཤའ་ནེ་ན་།
 sarvalokaḥ sukhī bhavatu | pūrvakarma kṣapaya | mama	སརྦ་ལོ་ཀ་མ་སུ་ཁའ་བྷ་བ་ཏུ་།
 “nātsehaṃ mārapatiśukṣiṇasya āyaṣadika	བའུརྦ་ཀཤརྨ་ཀཤ་པ་ཡ་ཏུ་།
 mahāśrādvopāsaka śulivajrasya“	རཀཤ་བྷ་བ་ཏུ་།
 rakṣā bhavatu sarvabhayebhyaḥ tathāgatādhiṣṭhānena svāhā ||	སརྦ་ཡེ་བྷྱ་ཏ་ཐའ་ག་ཏ་ཨཨ་དྷི་ཤའ་ནེ་ན་སབ༹འཧའ་།
 imāni tāni kulaputrāho mantrapadāni triṃśatyā tathāgatasahasrairbhāṣitāni adhiṣṭhitāni	ཀྱེ་རིགས་ཀྱི་བུ་དག་། གཟུངས་ཀྱི་གསང་སྔགས་ཀྱི་གཞི་འདི་དག་ནི་། དེ་བཞིན་གཤེགས་པ་སུམ་ཁྲིས་གསུངས་ཤིང་བྱིན་གྱིས་བརླབས་པ་ཡིན་ནོ་༎
 mayāpyetarhi bhāṣitā[ni] sarvasattvānāmarthāya hitāya sukhāya rakṣāvaraṇaguptaye sarvavyādhipraśamanakarāṇi buddhakṣetropapattaye |	ངས་ཀྱང་ད་ལྟར་སེམས་ཅན་ཐམས་ཅད་ཀྱི་དོན་དང་། ཕན་པ་དང་། བདེ་བ་དང་། སྲུང་བ་དང་། སྐྱོབ་པ་དང་། སྦ་བ་དང་། ནད་ཐམས་ཅད་རབ་ཏུ་ཞི་བར་བྱ་བ་དང་། སངས་རྒྱས་ཀྱི་༄༤༢༣བ་ཞིང་དུ་སྐྱེ་བར་བྱ་བའི་ཕྱིར་བཤད་དེ་། གྲོགས་པོ་དག་།
 yaḥ kaścit parṣa evaṃ jānīyuḥ kathaṃ nu vayaṃ sarvānetān tathāgatabhāṣitān guṇān	གང་ལ་ལ་ཞིག་འདི་སྙམ་དུ་བདག་གིས་ཇི་ལྟར་ན་།
 pratilabheya tena kalyamevotthāya sarvasattvānāṃ dayācittena karūṇācittena maitracittena īrṣyāmānamrakṣakrodhaparivarjitena ekāgracittena buddhasyodāratarāṃ pūjāṃ kṛtvā daśadiśaṃ sarvatathāgatānāṃ namaskṛtvā yathākāmaṃ guṇān manasikṛtya aṣṭaśataṃ japya puṣpamekaikaṃ tathāgate deyam |	དེ་བཞིན་གཤེགས་པས་གསུངས་པའི་ཡོན་ཏན་དེ་དག་ཐམས་ཅད་འཐོབ་པར་འགྱུར་སྙམ་དུ་སེམས་པ་དེས་ནང་པར་སྔར་ལངས་ཏེ་སེམས་ཅན་ཐམས་ཅད་ལ་སྙིང་བརྩེ་བའི་སེམས་དང་། སྙིང་རྗེའི་སེམས་དང་། བྱམས་པའི་སེམས་དང་། ཕྲག་དོག་དང་། ང་རྒྱལ་དང་། འཆབ་པ་དང་། ཁྲོ་བ་ཡོངས་སུ་སྤངས་པའི་སེམས་དང་། རྩེ་གཅིག་པའི་སེམས་ཀྱིས་སངས་རྒྱས་དང་བྱང་ཆུབ་སེམས་དཔའ་རྣམས་ལ་མཆོད་པ་ཤིན་ཏུ་རྒྱ་ཆེར་བྱས་ལ་ཕྱོགས་བཅུའི་དེ་བཞིན་གཤེགས་པ་ཐམས་ཅད་ལ་ཕྱག་བྱས་ཏེ་གང་འདོད་པ་ཡིད་ལ་བྱས་ནས་མེ་ཏོག་ལ་བཟླས་བརྗོད་ལན་བརྒྱ་རྩ་བརྒྱད་བྱ་ཞིང་། དེ་བཞིན་གཤེགས་པ་ལ་རེ་རེ་ནས་དབུལ་བར་བྱའོ་༎
 tatastasya sarvāśāsamṛddhirbhaviṣyati |	དེས་ན་དེའི་རེ་བ་ཐམས་ཅད་ཡང་དག་པར་འགྲུབ་པར་འགྱུར་རོ་༎
 svapne ca tathāgatadarśanaṃ bhaviṣyati |	རྨི་ལམ་ན་དེ་བཞིན་གཤེགས་པ་མཐོང་བར་ཡང་འགྱུར་རོ་༎
 yaṃ varam icchati taṃ labhate |	དམ་པ་གང་འདོད་པ་དེ་ཐོབ་པར་ཡང་འགྱུར་རོ་༎
 maraṇakāle ca tathāgatadarśanaṃ bhaviṣyati |	འཆི་བའི་ཚེ་ན་དེ་བཞིན་གཤེགས་པ་མཐོང་བར་ཡང་འགྱུར་རོ་༎
 cyutvā sukhāvatyāṃ ca lokadhātau upapatsyate |	ཤི་འཕོས་ཀྱང་འཇིག་རྟེན་གྱི་ཁམས་བདེ་བ་ཅན་དུ་སྐྱེ་བར་འགྱུར་རོ་༎
 āyurbalavarṇaviryasamanvāgataḥ |	ཚེ་དང་། སྟོབས་དང་། མདོག་དང་། བརྩོན་འགྲུས་དང་ལྡན་པར་ཡང་འགྱུར་རོ་༎
 sarvaśatravaścāsya vaśagāmino bhaviṣyanti |	དགྲ་ཐམས་ཅད་ཀྱང་དེའི་དབང་དུ་འགྱུར་རོ་༎
 (dutt 57) asyāṃ khalu punardhāraṇyāṃ bhāṣyamāṇāyāṃ ṣaṣṭīnāṃ ca prāṇisahasrāṇāmanutpattikeṣu dharmeṣu kṣāntipratilaṃbho 'bhūt |	གཟུངས་འདི་བཤད་པ་ན་སྲོག་ཆགས་དྲུག་ཁྲི་མི་སྐྱེ་བའི་ཆོས་ལ་བཟོད་པ་ཐོབ་༄༤༢༤ཨ་༌༎
 sarve ca sarva[karmā] varaṇavinirmuktāḥ sarvābhiprāyaparipūrṇāḥ saṃvṛttāḥ | ii	པར་གྱུར་ནས་དེ་དག་ཐམས་ཅད་ལས་ཀྱི་སྒྲིབ་པ་ཐམས་ཅད་ལས་རྣམ་པར་གྲོལ་ཞིང་བསམ་པ་ཐམས་ཅད་ཡོངས་སུ་རྫོགས་པར་གྱུར་ཏོ་༎
 atha khalu vajrapāṇirbodhisattvo daśadiśaṃ vyavalokya bhagavantametadavocat |	དེ་ནས་བྱང་ཆུབ་སེམས་དཔའ་སེམས་དཔའ་ཆེན་པོ་ལག་ན་རྡོ་རྗེས་ཕྱོགས་བཅུར་རྣམ་པར་བལྟས་ཏེ་བཅོམ་ལྡན་འདས་ལ་འདི་སྐད་ཅེས་གསོལ་ཏོ་༎ བཅོམ་ལྡན་འདས་།
 asti bhagavan abhayatejaṃ nāma dhāraṇī bodhisattvānāṃ pratijñā yā mayā abhayavyūharājasya tathāgatasyāntikādudgṛhītā |	བྱང་ཆུབ་སེམས་དཔའ་རྣམས་ཀྱི་དམ་འཆའ་བ་མི་འཇིགས་པའི་གཟི་བརྗིད་ཅེས་བགྱི་བའི་གཟུངས་མཆིས་ཏེ་། བདག་གིས་དེ་བཞིན་གཤེགས་པ་འཇིགས་མེད་བཀོད་པ་གཟི་བརྗིད་རྒྱལ་པོའི་སྤྱན་སྔར་དེ་བཟུང་ལགས་། སོ་༎ 
 udgṛhya sarvasattvebhyaḥ prakāśitā |	བཟུང་ནས་ཀྱང་སེམས་ཅན་ཐམས་ཅད་ལ་བཤད་ལགས་སོ་༎ བཅོམ་ལྡན་འདས་། དེང་སླན་ཆད་བདག་གིས་མངོན་འཚལ་ཏེ་།
 tataḥ punaḥ bhagavan nābhijānābhi yasya svapne 'pi sā dhāraṇī karṇapuṭe nipatitāntargatā	གང་གི་རྣ་ལམ་དུ་གཟུངས་དེ་གྲགས་པར་གྱུར་ཏམ་། གློ་བུར་ཆུད་པར་གྱུར་པ་དེའི་ལུས་ཉམ་ང་བའམ་། ཉོན་མོངས་པ་སྣ་ཚོགས་སམ་། བྲོ་ནད་དམ་།
 tasya syāccharīre daurbalyaṃ vā kleśo vā vyādhirvā jvaro vā kāyaśūlaṃ vā cittapīḍā	རིམས་སམ་། ལུས་བྲོ་འཚལ་བའམ་། སེམས་གདུང་བའམ་། དུས་མ་ལགས་པར་འགྲུམ་པའམ་། ཆབ་ཀྱིས་འཇིགས་པའམ་། མཚོན་གྱིས་འཇིགས་པའམ་། དུག་གིས་འཇིགས་པའམ་།
 vā akālamṛtyurvā udakaṃ vā śastraṃ vā viṣaṃ vā garaṃ vā ḍākinī vā bhūto vā yakṣo	དུག་སྦྱར་མས་འཇིགས་པའམ་། མཁའ་འགྲོ་མ་དང་། འབྱུང་པོའི་འཇིགས་པའམ་། གནོད་སྦྱིན་ནམ་། དགྲ་རྣམས་སམ་།
 vā śatravo vā manuṣyā vāmanuṣyā vā viheṭhaṃ vā kartuṃ hiṃsāṃ vā vidhātuṃ vā nedaṃ sthānaṃ vidyate |	མི་དང་། མི་མ་ལགས་པ་དག་གིས་མཐོ་འཚམ་པའམ་། རྣམ་པར་གཙེ་བའམ་། གནོད་པ་བགྱིད་པར་འགྱུར་བ་དེ་ནི་༄༤༢༤བ་གནས་མ་མཆིས་ལགས་སོ་༎
 tadanujānātu bhagavan yadahaṃ bodhisattvapratijñāmudrāṃ dāsyāmi |	དེའི་སླད་དུ་བཅོམ་ལྡན་འདས་ཀྱིས་བདག་ལ་རྗེས་སུ་གནང་བ་སྩོལ་ཅིག་།
 teṣāṃ dharmabhāṇakānāṃ dharmaśrāvaṇikānāmarthāya śrotṝṇāṃ mānayitṝṇāṃ pūjayitṝṇāṃ dhārayitṝṇāṃ vācayitṝṇāṃ sarvāśāparipūrakarāṇi |	བདག་གིས་ཆོས་སྨྲ་བ་དང་། ཆོས་ཉན་པ་དེ་དག་གི་དོན་དུ་ཉན་པ་རྣམས་དང་། རི་མོར་བགྱིད་པ་རྣམས་དང་། མཆོད་པར་བགྱིད་པ་རྣམས་དང་། འཛིན་པར་བགྱིད་པ་རྣམས་ཀྱི་རེ་བ་ཐམས་ཅད་ཡོངས་སུ་རྫོགས་པར་བགྱིད་པ་། བྱང་ཆུབ་སེམས་དཔའ་རྣམས་ཀྱི་དམ་བཅའ་བའི་ཕྱག་རྒྱ་དག་སྩལ་བར་བགྱིའོ་༎
 namaḥ sarvabuddhānām |	ན་མ༔་སརྦ་ཏ་ཐའ་ག་ཏའ་ནའམ།
 sarvabodhisattvānāmarhantānām |	སརྦ་བེ་དྷི་སཏབ༹་ནའམ། ཨཨ་རི་ཧ་ཧའ་ན་། ཏད་ཐའ་།
 tadyathā oṃ vajradhara vajradhara vajrakāya vajrabala vajrateja |	ཨཨོམ་བཛྲ་དྷ་ར་། བཛྲ་ཀའ་ཡམ། བཛྲ་བ་ལ་། བཛྲ་ཏེ་ཛ་།
 hum hum |	ཧའུམ་ཧའུམ།
 vajrapāṇe (dutt 58)	བཛྲ་པའ་ནི་།
 tathāgatājñāṃ pālaya |	ཏ་ཐའ་ག་ཏ་ཨའ་ཛཉའ་པ་ལའ་ཡ་།
 smara pratijñām |	སྨ་ར་པྲ་ཏི་ཛཉའམ།
 sarvavyādhiṃ sarvapāpāni nāśaya | dehi me yathepsitaṃ varam | mama	སརྦ་བྱ་དྷི་ན་སརྦ་པའ་པམ་ནའ་ཤ་ཡ་། དེ་ཧི་མེ་། ཡི་ཐེ་བ་སི་ཏམ་ཕ་ར་མ་།
 “nātsehaṃ mārapati śulkṣiṇasya āyaṣādika śulivajrasya“ yaṃ yamevābhiyācāma staṃ tameva samṛdhyatu |	ཡན་ཡ་མེ་བ་ཨཨ་བྷི་པརའ་ཡན་ཙ་མི་ཏནཏ་མེ་བ་ས་མྲམ་དྷྱ་ཏུ་།
 he he |	ཧེ་ཧེ་།
 turu turu |	ཏུ་རུ་ཏུ་རུ་། ཨའ་གཙཚ་།
 āgaccha āgaccha |	ཨའ་གཙཙ་།
 mā vilamba |	མ་བི་ལམབ་ད་རི་ཤ་ཡ་།
 darśaya vajrakāyaṃ darśaya vajrakāyam |	བཛྲ་ཀའ་ཡ་། ད་རི་ཤ་ཡ་། བཛྲ་ཀརའ་ཡམ།
 buddhādhiṣṭhānena svāhā |	བུདདྷ་ཨཨ་དྷི་ཤཤའ་ནེ་ན་སབ༹འཧའ་།
 asyāṃ dhāraṇyāṃ bhāṣyamāṇāyām iyaṃ mahāpṛthivī unmajjanimajjanaṃ karotu |	གཟུངས་འདི་བརྗོད་པ་ན་ས་ཆེན་པོ་མཐོ་བ་དང་དམའ་བར་གྱུར་ཏོ་༎
 sarve ca yakṣarākṣasāḥ saṃbhrāntāḥ sarve ca devā yāvad manuṣyāmanuṣyā vismayamāpannāḥ sādhukāraṃ pradadati |	གནོད་སྦྱིན་དང་སྲིན་པོ་ཐམས་ཅད་ཀྱང་རབ་ཏུ་དངངས་སོ་༎
 sādhu sādhu mahāsattvāḥ paramasiddhāni imāni dhāraṇīmantrapadāni bhāṣitāni |	ལྷ་ཐམས་ཅད་དང་། མི་དང་། མི་མ་ཡིན་པའི་བར་དག་ཀྱང་ངོ་མཚར་དུ་གྱུར་ནས་སེམས་ཅན་ཆེན་པོ་རབ་ཏུ་གྲུབ་པར་བྱེད་པའི་གཟུངས་ཀྱི་གསང་སྔགས་ཀྱི་གཞི་འདི་དག་བཤད་པ་ནི་ལེགས་སོ་༎
 atha vajrapāṇibodhisattvo bhagavantametadavocat |	ལེགས་སོ་ཞེས་བྱ་བ་བྱིན་ནོ་༎ དེ་ནས་བཅོམ་ལྡན་འདས་ལ་བྱང་ཆུབ་སེམས་དཔའ་སེམས་དཔའ་ཆེན་པོ་ལག་ན་རྡོ་རྗེས་འདི་སྐད་ཅེས་གསོལ་ཏོ་༎ ༄༤༢༥ཨ་༌༎ བཙུན་པ་བཅོམ་ལྡན་འདས་།
 yaḥ kaścid bhadanta bhagavan bodhisattvabhūmimabhiprārthayate dhanadhānyabhogaiśvaryaṃ	གང་ལ་ལ་ཞིག་བྱང་ཆུབ་སེམས་དཔའི་སའམ་། ནོར་དང་། འབྲུ་དང་། ལོངས་སྤྱོད་ཀྱི་དབང་ཕྱུག་གམ་། རྒྱལ་སྲིད་ཀྱི་དབང་ཕྱུག་གམ༏་རིག་སྔགས་འཆང་བ་ཉིད་དམ་།
 rājyaṃ vidyādharatvam āyurbalavīryadīrghāyuṣkatvaṃ tena śuklāṣṭamyāṃ śvetacandanamayo	ཚེ་དང་། སྟོབས་དང་། མདོག་དང་། བརྩོན་འགྲུས་དང་། ཚེ་རིང་པོ་ཉིད་འཚལ་བ་དེས་སྔ་ནས་བསྙེན་པར་བགྱིས་ལ་དགུང་ཟླ་ཡར་གྱི་ངོ་ཚེས་བརྒྱད་ལ་ཙནདན་དཀར་པོ་ལས་རྡོ་རྗེ་འཛིན་པ་རྟ་གང་དུ་དགོད་ཅིང་རྒྱན་ཐམས་ཅད་ཀྱིས་བརྒྱན་པ་། སྙིང་གར་སྐུ་གདུང་སྩལ་པ་།
 vajradharaḥ kāryaḥ aṭṭahāsaḥ sarvālaṃkāravibhūṣitaḥ | sadhātukahṛdayaṃ kartavyam | sadhātukaṃ vajra[dharaṃ] samāśvāsakaṃ vidyādharaṃ dhūpadahyamānaṃ śucinā ahorātroṣitena kāryam | tato 'ṣṭamyāṃ pūrvasecaṃ (dutt 59)	སྐུ་གདུང་དང་བཅས་པའི་རྡོ་རྗེ་འཛིན་པ་།
 kṛtvā śuce satathāgatasthāne mahatā dhūpapuṣpagandhadīpaiḥ pūjāṃ kṛtvā triskṛtvā aṣṭaśatiko jāpo dātavyaḥ tathāgatasya pūjā kartavyā |	རིག་སྔགས་འཆང་ཡང་དག་པར་དབུགས་འབྱིན་པར་བགྱིད་པ་བགྱིས་ལ་། གཙང་མས་བདུག་སྤོས་ཀྱིས་བདུག་ཅིང་གདུགས་མཚན་གཅིག་ཏུ་སྨྱུང་བ་བགྱིས་ལ་།
 sarvatathāgatānāṃ namaskṛtya catvāri pūrṇakumbhā[ni]sthāpya raktacandanamayaṃ maṇḍalaṃ kṛtvā śvetavastrāprāvṛtena ekāgramānasena caturdiśe ca rasagandhamadyapāyasavaliṃ	དེ་ནས་ཚེས་བརྒྱད་ནས་ཚེས་བཅོ་ལྔའི་བར་དུ་དེ་བཞིན་གཤེགས་པའི་སྐུ་གཟུགས་བཞུགས་པའི་གནས་གཙང་མར་ཙནདན་དཀར་པོའི་དཀྱིལ་འཁོར་བགྱིས་ལ་བུམ་པ་གང་བ་བཞིའང་གཞག་པར་བགྱི༏་ཕྱོགས་བཞིར་ཡང་རོ་དང་ལྡན་པ་དང་། དྲི་དང་ལྡན་པ་དང་། སྐྱེམས་དང་། འོ་ཐུག་གི་གཏོར་མ་དག་སྩལ་ལ་རད་པ་དཀར་པོ་བགོས་ཏེ་སེམས་རྩེ་གཅིག་ཏུ་བགྱིས་ནས་དུས་གསུམ་དུ་བདུག་སྤོས་དང་། མེ་ཏོག་དང་། སྤོས་དང་། མར་མེ་དག་གིས་མཆོད་པ་ཆེན་པོ་བགྱི་ཞིང་དེ་བཞིན་གཤེགས་པའང་མཆོད་པ་བགྱིས་ཏེ་།
 dattvā aṣṭaśatasumanaḥpuṣpaiḥ vajrapāṇirāhartavyaḥ |	དེ་བཞིན་གཤེགས་པ་ལ་ཕྱག་༄༤༢༥བ་བགྱིས་ནས་སྣ་མའི་མེ་ཏོག་བརྒྱ་རྩ་བརྒྱད་ལ་བཟླས་བརྗོད་བརྒྱ་རྩ་བརྒྱད་བཟླས་ཤིང་། རེ་རེ་ནས་ལག་ན་རྡོ་རྗེ་ལ་བསྣུན་པར་བགྱིའོ་༎
 yāvat pañcadaśī tato mahānirghoṣo bhaviṣyati pṛthivīkampaśca raśmayo niścariṣyanti |	དེས་ན་སྒྲ་སྐད་ཆེན་པོ་འབྱུང་བར་འགྱུར་ཞིང་། དོག་ས་ག-ཡོ་བ་དང་། འོད་ཟེར་ཀྱང་འབྱུང་བར་འགྱུར་ཏེ་།
 tato yathepsitaṃ varaṃ dāsyāmi |	དེ་ནས་དམ་པ་ཅི་འཚལ་བའང་སྩལ་བར་བགྱིའོ་༎
 sarvakarmāṇi sarvakāryāṇi japitamātreṇa samṛddhiṣyanti |	བཟླས་བརྗོད་བགྱིས་པ་ཙམ་གྱིས་ལས་ཐམས་ཅད་དང་། དགོས་པ་ཐམས་ཅད་ཀྱང་ཡང་དག་པར་འགྲུབ་པར་འགྱུར་ལགས་སོ་༎
 vigatavyādhayo cirajīvī sarvapāpavivarjito bhaviṣyati | guṇasahasraṃ pratilapsyate |	བྲོ་ནད་མ་མཆིས་པ་དང་། ཚེ་རིང་པ་དང་། སྡིག་པ་ཐམས་ཅད་བྲལ་བར་འགྱུར་ཞིང་ཡོན་ཏན་སྟོང་ཡང་འབྱུང་བར་འགྱུར་ལགས་སོ་༎
 maraṇakāle ca buddhaṃ paśyati |	འགུམ་པའི་ཚེ་ནའང་སངས་རྒྱས་བཅོམ་ལྡན་འདས་སྟོང་མཐོང་བར་འགྱུར་ལགས་སོ་༎
 ahaṃ ca darśanaṃ dāsyāmi |	བདག་མཐོང་བར་ཡང་སྩལ་བར་བགྱི་ལགས་སོ་༎
 atha bhagavān sādhukāramadāt |	དེ་ནས་བཅོམ་ལྡན་འདས་ཀྱིས་ལག་ན་རྡོ་རྗེ་ལ་ལེགས་སོ་ཞེས་བྱ་བ་བྱིན་ཏེ་།
 sādhu sādhu vajrapāṇe anatikramaṇīyā iyaṃ mudrā |	ལག་ན་རྡོ་རྗེ་ལེགས་སོ་༎ ལེགས་སོ་༎ ཕྱག་རྒྱ་འདི་ནི་ལྷ་དང་བཅས་པའི་འཇིག་རྟེན་གྱིས་འདའ་བར་བྱ་བ་མ་ཡིན་ཏེ་།
 nātra kāṃkṣā na vimatirna vicikitsā kartavyā sadevakena lokena | iii	འདི་ལ་སོམ་ཉི་མེད་པ་དང་། ཡིད་གཉིས་མེད་པ་དང་། ཐེ་ཚོམ་མེད་པར་བྱའོ་༎
 atha maṃjuśrīḥ kumārabhūto bhagavantametadavocat |	དེ་ནས་བཅོམ་ལྡན་འདས་ལ་འཇམ་དཔལ་གཞོན་ནུར་གྱུར་པས་འདི་སྐད་ཅེས་གསོལ་ཏོ་༎ བཅོམ་ལྡན་འདས་།
 kenārthenāyaṃ bhagavan sarvatathāgatādhiṣṭhānasattvāvalokanabuddhakṣetrasandarśanavyūho nāma samādhirucyate |	ཅིའི་སླད་དུ་ཏིང་ངེ་འཛིན་འདི་དེ་བཞིན་གཤེགས་པ་ཐམས་ཅད་ཀྱི་བྱིན་གྱི་རླབས་སེམས་ཅན་ལ་གཟིགས་ཤིང་སངས་རྒྱས་ཀྱི་ཞིང་གི་བཀོད་པ་ཀུན་ཏུ་སྟོན་པ་ཞེས་བགྱི་།
 bhagavānāha | sarvatathāgatānāmadhiṣṭhānaṃ (dutt 60)	བཅོམ་ལྡན་འདས་ཀྱིས་བཀའ་སྩལ་པ་། དེ་བཞིན་གཤེགས་༄༤༢༦ཨ་༌༎
 sarvabodhisattvānām adhiṣṭhitaśca sarvasamādhiṃ sarvadhāraṇīmukhāni pratilabhate | sarvasattvānāṃ cittacaitasikasamiṃjitaprasāritāni prajānāti | devānāṃ nāgānāṃ manuṣyāṇāṃ yakṣāṇāṃ gandharvāṇāṃ pretānāṃ tiryagyonigatānāṃ yāmalaukikānām amī sattvāḥ puṇyopagāḥ sukṛtakarā buddhadharmasaṃgheṣu prasādaṃ pratilabhante |	པ་ཐམས་ཅད་ཀྱི་བྱིན་གྱི་རླབས་དང་། བྱང་ཆུབ་སེམས་དཔའ་ཐམས་ཅད་ཀྱི་བྱིན་གྱི་རླབས་དེ་ལས་ཏིང་ངེ་འཛིན་ཐམས་ཅད་དང་། གཟུངས་ཀྱི་སྒོ་ཐམས་ཅད་འཐོབ་པར་འགྱུར་བ་དང་། ལྷ་རྣམས་དང་། ཀླུ་རྣམས་དང་། མི་རྣམས་དང་། གནོད་སྦྱིན་རྣམས་དང་། དྲི་ཟ་རྣམས་དང་། ཡི་དབ༹གས་རྣམས་དང་། དུད་འགྲོའི་སྐྱེ་གནས་སུ་སྐྱེས་པ་རྣམས་དང་། གཤིན་རྗེའི་འཇིག་རྟེན་པའི་སེམས་ཅན་ཐམས་ཅད་ཀྱི་སེམས་དང་སེམས་ལས་བྱུང་བ་ལྷག་པར་ག-ཡོ་བ་དང་བྲལ་བར་ག-ཡོ་བ་དག་རབ་ཏུ་ཤེས་ཤིང་སེམས་ཅན་འདི་དག་ནི་བསོད་ནམས་སུ་ཉེ་བར་འགྲོ་བ་སྟེ་། ལེགས་པར་སྤྱོད་པའི་ལས་བྱེད་ལ་། སངས་རྒྱས་དང་། ཆོས་དང་། དགེ་འདུན་དག་ལ་དད་པ་འཐོབ་པར་འགྱུར་པའོ་༎
 amī narakagāmiduṣkṛtagāmipāpakāriṇaḥ |	འདི་དག་ནི་སེམས་ཅན་དམྱལ་བར་འགྲོ་བ་སྟེ་། ཉེས་པར་སྤྱོད་པའི་ལས་བྱེད་པ་།
 teṣāṃ sattvānāṃ pāpadṛṣṭigatānāṃ dharmaṃ deśayati sarvapāpebhyo nivārayati |	སྡིག་པ་སྤྱོད་པར་བྱེད་པ་། ཤེས་ནས་སྡིག་པའི་ལྟ་བར་གྱུར་པའི་སེམས་ཅན་དེ་དག་ལ་ཆོས་སྟོན་པར་བྱེད་ཅིང་།
 buddhabodhau pratiṣṭhāpayati sarvābhiprāyaṃ paripūrayati | īrṣyāmānakrodhamātsaryaṃ vinodayati | te ca sattvā buddhadharmasaṃgheṣu prasādaṃ pratilabhya buddhakṣetreṣupapadyante | na jātu duḥkhamanubhavanti na daurmanasyam |	སྡིག་པ་ཐམས་ཅད་ལས་ཟློག་བར་བྱེད་པ་དང་། སངས་རྒྱས་ཀྱི་བྱང་ཆུབ་ལ་འགོད་པར་བྱེད་པ་དང་། བསམ་པ་ཐམས་ཅད་ཡོངས་སུ་རྫོགས་པར་བྱེད་པ་དང་། ཕྲག་དོག་དང་། ང་རྒྱལ་དང་། ཁྲོ་བ་དང་། སེར་སྣ་དག་སེལ་བར་བྱེད་པ་དང་། སེམས་ཅན་དེ་དག་ཀྱང་སངས་རྒྱས་དང་། ཆོས་དང་། དགེ་འདུན་༄༤༢༦བ་དག་ལ་དད་པ་རབ་ཏུ་ཐོབ་ནས་སངས་རྒྱས་ཀྱི་ཞིང་རྣམས་སུ་སྐྱེ་ཞིང་ནམ་དུའང་སྡུག་བསྔལ་ཉམས་སུ་མྱོང་བར་མི་འགྱུར་ལ་། ཡིད་མི་བདེ་བར་མི་འགྱུར་བས་ན་།
 tenāyaṃ kulaputra sarvatathāgatādhiṣṭhānasattvāvalokanabuddhakṣetrasandarśanavyūho nāma samādhirucyate |	རིགས་ཀྱི་བུ་། དེའི་ཕྱིར་ཏིང་ངེ་འཛིན་འདི་ནི་དེ་བཞིན་གཤེགས་པ་ཐམས་ཅད་ཀྱི་བྱིན་གྱི་རླབས་སེམས་ཅན་ལ་གཟིགས་ཤིང་སངས་རྒྱས་ཀྱི་ཞིང་གི་བཀོད་པ་ཀུན་ཏུ་སྟོན་པ་ཞེས་བྱ་སྟེ་།
 yaṃ śrutvā niyatāvaivarthikabhūmiṃ pratilabhante |	འདི་ཐོས་པའི་སེམས་ཅན་རྣམས་ནི་ཕྱིར་མི་ལྡོག་པར་ངེས་པའི་ས་འཐོབ་པར་འགྱུར་རོ་༎
 [sa]āha | kenārthena bhagavaṃsteṣāṃ kulaputrāṇāṃ vyākaraṇaṃ bhavati | kiyatteṣāṃ puṇyaskandhaṃ bhavati | kiṃ duṣkaracaryā |	གསོལ་པ་། བཅོམ་ལྡན་འདས་། ཅིའི་སླད་དུ་རིགས་ཀྱི་བུ་དང་། རིགས་ཀྱི་བུ་མོ་དེ་དག་ལུང་བསྟན་པར་འགྱུར་ལགས་།
 duṣkaraṃ ca bhagavan arhattvaṃ prāgevānuttarā samyaksaṃbodhiḥ |	བཅོམ་ལྡན་འདས་། དགྲ་བཅོམ་པ་ཉིད་ཀྱང་དཀའ་བ་ལགས་ཏེ་། བླ་ན་མེད་པ་ཡང་དག་པར་རྫོགས་པའི་བྱང་ཆུབ་ལྟ་ཅི་སྨོས་ཀྱང་མི་འཚོལ་ལགས་ན་། དེ་དག་གི་བསོད་ནམས་ཀྱི་ཕུང་པོ་དང་། དཀའ་བ་སྤྱོད་པ་ཇི་ཙམ་ཞིག་ཏུ་འགྱུར་ལགས་།
 bhagavānāha |	བཅོམ་ལྡན་འདས་ཀྱིས་བཀའ་སྩལ་པ་། རིགས་ཀྱི་བུ་།
 yaśca mayā kulaputra prathamacittotpādamupādāya dānaśīlakṣāntivīryadhyānaprajñāpāramitā paripūritā yaśca śiraḥkara caraṇanayanottamāṃgapriyaputrabhāryāduhitṛdāsadāsīparityāga kṛtaḥ yaścāsya dharmaparyāyasya (dutt 61)	ངས་དང་པོ་སེམས་བསྐྱེད་པ་ནས་ཉེ་བར་བཟུང་སྟེ་སྦྱིན་པའི་ཕ་རོལ་ཏུ་ཕྱིན་པ་དང་། ཚུལ་ཁྲིམས་ཀྱི་ཕ་རོལ་ཏུ་ཕྱིན་པ་དང་། བཟོད་པའི་ཕ་རོལ་ཏུ་ཕྱིན་པ་དང་། བརྩོན་འགྲུས་ཀྱི་ཕ་རོལ་ཏུ་ཕྱིན་པ་དང་། བསམ་གཏན་གྱི་ཕ་རོལ་ཏུ་ཕྱིན་པ་དང་། ཤེས་རབ་ཀྱི་ཕ་རོལ་ཏུ་ཕྱིན་པ་ཡོངས་སུ་རྫོགས་པར་བྱས་པ་གང་ཡིན་པ་དང་། མགོ་དང་། ལག་པ་དང་། རྐང་པ་དང་། མིག་དང་། ལུས་དང་། སྡུག་པའི་བུ་དང་། བུ་མོ་དང་། ༄༤༢༧ཨ་༌༎ ཆུང་མ་དང་། བྲན་དང་། བྲན་མོ་དག་ཡོངས་སུ་བཏང་བར་གྱུར་པ་གང་ཡིན་པའི་བསོད་ནམས་མངོན་པར་འདུ་བྱ་བ་དང་། དགེ་བའི་རྩ་བ་མངོན་པར་འདུ་བྱ་བ་སྔ་མ་འདི་ནི་ཆོས་ཀྱི་རྣམ་གྲངས་འདི་ལ་མཆོད་པ་བྱེད་པ་དང་། བསྙེན་བཀུར་བྱེད་པ་དང་། ཡི་གེར་འབྲི་བ་དང་། ཡི་གེར་འབྲིར་འཇུག་པ་དང་། ཀློག་པ་དང་། འཛིན་པའི་བསོད་ནམས་མངོན་པར་འདུ་བྱ་བ་དང་། གཞན་དག་ལའང་ཡང་དག་པར་སྟོན་པར་བྱེད་པའི་བསོད་ནམས་མངོན་པར་འདུ་བྱ་བ་གང་ཡིན་པ་དང་། 
 pūjanasatkaraṇalikhanalekhāpanavācanodgrahaṇīyaḥ puṇyābhisaṃskāraḥ parebhyaḥ saṃprakāśanīyaḥ puṇyābhisaṃskāraḥ teṣāṃ ca dharmabhāṇakānāṃ pūjanasatkaraṇapuṇyābhisaṃskāraḥ tasyāyaṃ pūrvimakaḥ puṇyābhisaṃskāraḥ śatatamāmapi kalāṃ nopaiti |	ཆོས་སྨྲ་བ་དེ་དག་ལའང་མཆོད་པ་བྱེད་པ་དང་། བསྙེན་བཀུར་བྱེད་པའི་བསོད་ནམས་མངོན་པར་འདུ་བྱ་བ་གང་ཡིན་པ་དེའི་བརྒྱའི་ཆར་ཡང་ཉེ་བར་མི་འགྲོའོ་༎ རིགས་ཀྱི་བུ་།
 yaśca mayā kulaputra dharmo bhāṣitaḥ paryāvāptaḥ taṃ sarvaṃ satkare gurukare mānaye pūjaye satkṛtya likhaye likhāpaye |	ངེས་ཀུན་ཆུབ་པར་བྱས་ཤིང་བཤད་པའི་ཆོས་དེ་དག་ཐམས་ཅད་ལ་བསྙེན་བཀུར་བྱེད་པ་དང་། བླ་མར་བྱེད་པ་དང་། རི་མོར་བྱེད་པ་དང་། མཆོད་པ་བྱེད་པ་དང་། བསྙེན་བཀུར་བྱས་ཏེ་ཡི་གེར་འབྲི་པ་དང་། ཡི་གེར་འབྲིར་འཇུག་པ་གང་ཡིན་པ་དེ་བས་ནི་གང་ཞིག་ཆོས་ཀྱི་རྣམ་གྲངས་འདི་ཡི་གེར་འབྲི་བ་དང་། 
 yaścāyaṃ dharmaparyāyaḥ likhe vācaye pūjaye saṃprakāśaye bahutaram itaḥ puṇyābhisaṃskāraṃ parigrahīṣyati |	ཡི་གེར་འབྲིར་འཇུག་པ་དང་། ཀློག་པ་དང་། མཆོད་པ་བྱེད་པ་དང་། ཡང་དག་པར་སྟོན་པར་བྱེད་པ་དང་། ཉན་པར་བྱེད་ན་། དེ་ལས་བསོད་ནམས་མངོན་པར་འདུ་བྱ་བ་ཆེས་མང་དུ་ཡོངས་སུ་སྡུད་པར་འགྱུར་ཏེ་། དེས་ན་།
 tatastathāgato vyākarotyanuttarāyāṃ samyaksaṃbodhau | tat kasya hetoḥ |	དེ་བཞིན་གཤེགས་པས་བླ་ན་མེད་པ་ཡང་༄༤༢༧བ་དག་པར་རྫོགས་པའི་བྱང་ཆུབ་ཏུ་ལུང་སྟོན་ཏོ་༎ དེ་ཅིའི་ཕྱིར་ཞེ་ན་།
 evaṃrūpasya duṣkaraṃ dharmaparyāyasya śravaṇodgrahaṇadhāraṇapūjanalikhanam |	ཆོས་ཀྱི་རྣམ་གྲངས་འདི་ཉན་པ་དང་། འཛིན་པ་དང་། འཆང་བ་དང་། ཀློག་པ་དང་། མཆོད་པ་དང་། ཡི་གེར་འབྲི་བ་དང་། ཡི་གེར་འབྲིར་འཇུག་པའི་བསོད་ནམས་ནི་། དེ་ལྟར་དཀའ་བ་ཡིན་པའི་ཕྱིར་རོ་༎ རིགས་ཀྱི་བུ་།
 te ca sattvāḥ pāpasamācārāḥ khādyapeyahāsyanāṭyābhiratā aśubhe śubhasaṃjñinaḥ kāmakrodhavyāpādabahulā asukhe sukhasaṃjñinaḥ prahārākrośatarjanatāḍanābhiratā na jñāsyanti na manasi kariṣyanti | te tataḥ pāpakarmanidānājñānā akalyāṇamitraparigṛhītā jarāvyādhiśokamṛtyuparipīḍitā maraṇakāle paritarpyante |	སེམས་ཅན་གང་དག་སྡིག་པ་ཀུན་ཏུ་སྤྱོད་པ་དང་། བཟའ་བ་དང་། བཏུང་བ་དང་། བྲོ་གར་ལ་མངོན་པར་དགའ་བ་དང་། མི་སྡུག་པ་ལ་སྡུག་པར་འདུ་ཤེས་པ་དང་། འདོད་པ་དང་། ཁྲོ་བ་དང་། གནོད་སེམས་མང་བ་དང་། མི་བདེ་བ་ལ་བདེ་བར་འདུ་ཤེས་པ་དང་། མཚོན་ཆ་དང་། སྤྱོ་བ་དང་། བསྡིགས་པ་དང་། རྡེག་པ་ལ་མངོན་པར་དགའ་བ་དང་། ཤེས་པར་མི་འགྱུར་བ་དང་། ཡིད་ལ་བྱེད་པར་མི་འགྱུར་བ་དེ་དག་ནི་སྡིག་པའི་ལས་ཀྱི་གཞི་དེ་དང་། མི་ཤེས་པ་དེས་མི་དགེ་བའི་བཤེས་གཉེན་གྱིས་ཡོངས་སུ་ཟིན་ཅིང་རྒ་བ་དང་། ན་བ་དང་། མྱ་ངན་དང་། འཆི་བས་ཡོངས་སུ་ཟིན་པས་འཆི་བའི་ཚེ་ན་ཡོངས་སུ་གདུང་བར་འགྱུར་ཏེ་།
 śmaśānasadṛśamaṃcāvalaṃvyamānaṃ parasparaṃ paśyanti na ca kuśalacittamutpādayiṣyanti nābhedyaprasādam |	དམིགས་པ་ན་སོ་སོ་ནས་དུར་ཁྲོད་དང་འདྲ་འཁོ་ནར་མཐོང་ཞིང་། དགེ་བའི་སེམས་བསྐྱེད་པར་ཡང་མི་འགྱུར་ལ་། དད་པ་མི་ཕྱེད་པ་ཐོབ་པར་ཡང་མི་འགྱུར་ཏེ་།
 te tataścyavitvā punarapi duḥkhāni pratyanubhaviṣyanti |	དེ་དག་དེ་ནས་ཤི་འཕོས་ནས་ཀྱང་སྡུག་བསྔལ་དག་ཉམས་སུ་མྱོང་བར་འགྱུར་བས་ན་།
 nāyaṃ kulaputrākṛtakuśalamūlaistathāgatādarśāvino (dutt 62)	ལུང་བསྟན་པའི་དགེ་བའི་རྩ་བ་མེད་པ་དང་། དེ་བཞིན་གཤེགས་པ་མ་མཐོང་བ་དང་། ལུང་བསྟན་པ་མ་ཐོབ་༄༤༢༨ཨ་༌༎
 avyākaraṇaprāptaiḥ śrotuṃ mānayituṃ pūjayitum udgrahītuṃ na likhituṃ na likhāpayituṃ na śraddhadhātuṃ na ca tān dharmabhāṇakān satkartuṃ mānayituṃ pūjayitum [api na śakyate |	པ་དག་གིས་ནི་ཆོས་ཀྱི་རྣམ་གྲངས་འདི་མཉན་པ་དང་། རི་མོར་བྱ་བ་དང་། མཆོད་པར་བྱ་བ་དང་། གཟུང་བ་དང་། ཡི་གེར་འབྲི་བ་དང་། ཡི་གེར་འབྲིར་གཞུག་པ་དང་། དད་པར་ཡང་མི་ནུས་ལ་། ཆོས་སྨྲ་བ་དེ་ལའང་བསྙེན་བཀུར་བྱ་བ་དང་། བླ་མར་བྱ་བ་དང་། རི་མོར་བྱ་བ་དང་། མཆོད་པ་བྱ་བར་ཡང་མི་ནུས་སོ་༎
 ] tathāgatakṛtyaṃ kulaputra tatra viṣaye bhaviṣyati yatrāyaṃ dharmaparyāyaḥ pracariṣyati |	རིགས་ཀྱི་བུ༏་གང་དུ་ཆོས་ཀྱི་རྣམ་གྲངས་འདི་རབ་ཏུ་སྤྱོད་པར་འགྱུར་བའི་ཡུལ་དེར་ནི་དེ་བཞིན་གཤེགས་པའི་མཛད་པ་འབྱུང་བར་འགྱུར་རོ་༎
 atha sā yathā samāgatā parṣat sādhukāramadāt |	དེ་ནས་ཇི་ལྟར་ལྷགས་པའི་འཁོར་དེ་དག་གིས་བཅོམ་ལྡན་འདས་ལ་ལེགས་སོ་ཞེས་བྱ་བ་གསོལ་ཏོ་༎ 
 sādhu sādhu bhagavan |	བཅོམ་ལྡན་འདས་། ལེགས་སོ་། ལེགས་སོ་༎ བཅོམ་ལྡན་འདས་།
 vayamapi bhagavan dharmabhāṇakaṃ dharmaśrāvaṇikaṃ tathāgatakṛtyena satkariṣyāmaḥ gurūkariṣyāmaḥ mānayiṣyāmaḥ sarvasukhopadhānaṃ cāsyopasaṃhariṣyāmaḥ	བདག་ཅག་གིས་ཀྱང་ཆོས་སྨྲ་བ་དེ་དང་། ཆོས་ཉན་པ་དེ་དག་ལ་དེ་བཞིན་གཤེགས་པའི་མཛད་པས་བསྙེན་བཀུར་བགྱི་། བླ་མར་བགྱི་། རི་མོར་བགྱི་། མཆོད་པར་བགྱི་ཞིང་། བདེ་བའི་ཡོ་བྱད་ཐམས་ཅད་ཀྱང་ཉེ་བར་བསྒྲུབ་པར་བགྱི་ལགས་སོ་༎
 ayaṃ ca dharmaparyāyaṃ vaistarikīkariṣyāmaḥ rakṣiṣyāmaḥ yenāyaṃ dharmaparyāyaściraśtitiko bhaviṣyati |	ཆོས་ཀྱི་རྣམ་གྲངས་འདིའང་རྒྱས་པར་བགྱི་བསྲུང་བར་བགྱི་སྟེ་། དེས་ན་ཆོས་ཀྱི་རྣམ་གྲངས་འདི་ཡུན་རིང་དུ་གནས་པར་ཡང་འགྱུར་ལགས་སོ་༎
 atha bhagavāṃstasyāṃ velāyāṃ yathā samāgatāṃ parṣadamavalokyaivamāhuḥ |	དེ་ནས་དེའི་ཚེ་བཅོམ་ལྡན་འདས་ཀྱིས་ཇི་ལྟར་ལྷགས་པའི་འཁོར་རྣམས་ལ་རྣམ་པར་གཟིགས་ཏེ་བཀའ་སྩལ་པ་། 
 sādhu sādhu kulaputra |	ཀྱེ་རིགས་ཀྱི་བུ་དག་། ལེགས་སོ་༎
 aho evamapi yuṣmākaṃ karaṇīyam |	ལེགས་༄༤༢༨བ་སོ༏་༏ཁྱེད་ཅག་གིས་དེ་བཞིན་དུ་གྱིས་ཤིག་།
 kāyacittanirapekṣairbhūtvā sarvopaplavanaparibhavanaparibhāṣaṇatarjanaprahārākrośalabhyamānam [api] imaṃ dharmaparyāyaḥ śrāvayitavyo likhitavyo vācayitavyaḥ |	གནོད་པ་བྱེད་པ་དང་། བརྙས་པ་དང་། གཤེ་བ་དང་། བསྡིགས་པ་དང་། མཚོན་འབྱིན་པ་དང་། རྒྱ་འགལ་བར་བྱེད་ནའང་ལུས་དང་། སྲོག་ལ་མི་ཏ་བར་བྱས་ལ་ཆོས་ཀྱི་རྣམ་གྲངས་འདི་མཉན་པར་བྱ་། ཡི་གེར་འབྲི་བར་བྱ་། ཡི་གེར་འབྲིར་གཞུག་པར་བྱ་། བཀླག་པར་བྱའོ་༎
 taṃ ca dharmabhāṇakaṃ dharmaśrāvaṇikaṃ sarvasukhopadhānena copasthātavyaḥ |	ཆོས་སྨྲ་བ་དེ་ལའང་བདེ་བའི་ཡོ་བྱད་ཐམས་ཅད་ཀྱིས་རིམ་གྲོར་བྱའོ་༎
 sa ca viṣayaḥ sa ca dvīpaḥ sa ca nagaro rakṣitavyaḥ sarvabhayopadravopasargopāyāsebhyaḥ |	ཡུལ་ཕྱོགས་དེ་དང་། གླིང་དེ་དང་། གྲོང་ཁྱེར་དེ་དག་ཀྱང་འཇིགས་པ་དང་། གནོད་པ་དང་། འགོ་བའི་ནད་དང་། འཁྲུག་པ་དག་ལས་བསྲུང་བར་བྱའོ་༎
 tasya ca kulaputrasya kuladuhiturvā satatasamitaṃ samanvāhartavyam |	རིགས་ཀྱི་བུ་དང་། རིགས་ཀྱི་བུ་མོ་དེ་དག་ལའང་རྟག་པར་རྒྱུན་དུ་བསམ་པར་བྱའོ་༎
 atha bhagavāṃstasyāṃ velāyāmimā gāthā abhāṣata | śṛṇuta kulaputra apramattā mā paścakāle parittāpyu bheṣyatha |	དེ་ནས་དེའི་ཚེ་བཅོམ་ལྡན་འདས་ཀྱིས་ཚིགས་སུ་བཅད་པ་འདི་དག་བཀའ་སྩལ་ཏོ་༎
 buddhasya utpādyu kadāci labhyate kalpānakoṭībhi śataiḥ sahasraiḥ ||	བསྐལ་པ་གྲངས་མེད་སྟོང་ཕྲག་བྱེ་སྙེད་དུ་༎ སངས་རྒྱས་འབྱུང་བ་ལན་འགའ་རྙེད་པ་ལ་༎ ཕྱི་མའི་དུས་ན་འགྱོད་པར་མི་འགྱུར་བར་༎ རིགས་ཀྱི་བུ་རྣམས་བག་ཡོད་ཆོས་ཉོན་ཅིག་།
 guṇāśca śṛṇvatvabhiśraddadheta na durlabhā teṣu samādhi bheṣyati |	ཡོན་ཏན་ཉན་ཅིང་མངོན་པར་དད་བྱེད་པ་༎ དེ་དག་གིས་ནི་ཏིང་འཛིན་རྙེད་མི་དཀའ༎
 kalpānakoṭīn yatha gaṅgavālikā yo dānu dadyā dvipadottameṣu ||	གང་གིས་རྐང་གཉིས་གཙོ་བོ་རྣམས་ལ་ནི་༎ བསྐལ་པ་བྱེ་བ་གངགའའི་བྱེ་སྙེད་དུ་༎ ནོར་དང་འབྲུ་དང་དེ་བཞིན་གོས་དང་རྒྱན་༎
 dhanaṃ cā dhānyaṃ tatha vastrabhūṣaṇaṃ gandhaṃ ca mālyaṃ ca vilepanaṃ ca |	སྤོས་དང་ཕྲེང་བ་བྱུག་པ་ཕུལ་བ་བས་༎
 yaścaiva sutramabhiśraddadhitvā śruṇeya vāceya likhāpayeta |	གང་གིས་མདོ་སྡེ་འདི་ལ་དད་བྱས་ཏེ་༎ ཉན་ཅིང་ཀློག་ལ་ཡི་གེར་འབྲི་བྱེད་པ་༎
 na tasya puṇyasya pramāṇu vidyate tā cāpramāṇaṃ sugatena deśitam ||	དེ་ལ་བསོད་ནམས་ཚད་ནི་ཡོད་མིན་ཏེ་༎ བདེ་བར་༄༤༢༩ཨ་༌༎ གཤེགས་པས་དེ་སྙེད་ཚད་མ་གསུངས་༎
 raṇyaṃ ca seveta sadāpramatto dhyānaṃ ca dhyāyetu sadānyacittaḥ |	རྟག་ཏུ་བག་ཡོད་དགོན་པར་རྟེན་བྱེད་ཅིང་༎
 dānaṃ ca dadyā priyaputradhītarā hastau ca pādau ca parityajeta || (dutt 64)	སེམས་གཞན་མེད་པར་བསམ་གཏན་དག་སྒོམ་དང་༎ སྡུག་པའི་བུ་དང་བུ་མོ་སྦྱིན་བྱེད་ཅིང་༎ ལག་པ་རྐང་པ་ཡོངས་སུ་གཏོང་བ་བས་༎
 yathaiva sūtrasya dhareti kaści ayaṃ tato puṇyaviśeṣyu prāpnuyā |	གང་སུ་མདོ་སྡེ་འདི་ནི་འཛིན་བྱེད་པ་༎ དེ་ནི་དེ་བས་བསོད་ནམས་མང་པོ་འཐོབ་༎ མདོ་མཆོག་འདི་ནི་ནོར་སྦྱིན་བྱེད་པ་སྟེ་༎ དེ་ཡི་ངན་སོང་ཀུན་ཀྱང་རྟག་ཏུ་སྤངས་༎
 arthasya dātā varasūtrametat sarvasyāpāyā sadā varjitāsya ||	འདི་ནི་ནོར་དང་འབྲུ་སྦྱིན་བྱེད་པ་སྟེ་༎ གང་ཞིག་མདོ་སྡེ་རྣམ་དག་འདི་འཛིན་པ་༎
 dhanasya dhānyasya ca dāyako hyayaṃ guṇāśca sarve 'pi na tasya durlabhāḥ |	དེ་ལ་ཡོན་ཏན་ཀུན་ཀྱང་མི་དཀོན་ཞིང་༎
 āyurbalaṃ vīryu na tasya durlabhaṃ dhāreti sūtraṃ ya imaṃ viśuddham ||	དེ་ལ་ཚེ་སྟོབས་བརྩོན་འགྲུས་མོད་པ་ཡིན་༎
 drakṣyanti buddhamamitābhu nāyakaṃ mayāpi sa vyākṛtu buddhabodhau |	འདྲེན་པ་སངས་རྒྱས་འོད་དཔག་མེད་མཐོང་ཞིང་༎ ངས་དེ་སངས་རྒྱས་བྱང་ཆུབ་ལུང་ཡང་བསྟན་༎
 na tasya pāpaṃ pi kadāci vidyate sukhāvatīṃ drakṣyati lokadhātum ||	དེ་ལ་ནམ་ཡང་སྡིག་པ་ཡོད་མིན་ཅིང་༎ བདེ་བ་ཅན་གྱི་འཇིག་རྟེན་ཁམས་ཀྱང་མཐོང་༎
 yaṃ cāpi tasya sada karmu bheṣyati sarvaṃ kṣayaṃ yāsyati cittanīḍe |	དེ་ལ་རྟག་ཏུ་ལས་གང་འབྱུང་འགྱུར་བ་༎ སེམས་གདུང་ལུས་ལན་བའང་དེ་བཞིན་དུ་༎
 kāyasya śūle tatha śīrṣatāpe na tasya jātu vinipātu bheṣyati |	ཀླད་པ་ན་བས་ཐམས་ཅད་ཟད་འགྱུར་ཞིང་༎ དེ་ནི་ནམ་ཡང་རྣམ་པར་ལྟུང་མི་འགྱུར་༎ དེས་ནི་མཐོང་བའི་ཆོས་ལའང་ཡོན་ཏན་ཀུན་༎
 sāṃdṛṣṭikāṃścāpi guṇāṃ sa lapsyate sarvaṃ yathā cintitu prārthitaṃ ca ||	ཇི་ལྟར་བསམ་ཞིང་འདོད་པས་འཐོབ་པར་འགྱུར་༎
 tasmābhi tebhi sada bhikṣubhikṣuṇī upāsakopāsika rājabhiḥ sadā |	དེ་ལྟར་རྟག་ཏུ་དགེ་སློང་ཕོ་མོ་དང་༎ དགེ་བསྙེན་རྣམས་དང་རྒྱལ་པོས་རྟག་ཏུ་ནི་༎
 gurugauravaṃ kṛtvā ca dharmabhāṇake yathā narendrasya tathāgatasya || (dutt 65)	མི་ཡི་དབང་པོ་དེ་བཞིན་གཤེགས་པ་ལྟར་༎ ཆོས་སྨྲ་བ་ལ་རྗེས་སུ་གུས་བྱས་ཏེ་༎
 idaṃ ca sūtraṃ sada dhāritavyaṃ satkāru nityaṃ ca kartavyadhārake |	མདོ་སྡེ་འདི་ནི་༄༤༢༩བ་རྟག་ཏུ་གཟུང་བྱ་ཞིང་༎ འཛིན་པ་ལ་ཡང་རྟག་ཏུ་བསྙེན་བཀུར་བྱ་༎
 gandhaiśca mālyaiśca vilepanaiśca satkāru kṛtvā ca likhāpayeta ||	སྤོས་དང་ཕྲེང་བ་བྱུག་པ་རྣམས་ཀྱིས་ནི་༎ བསྙེན་བཀུར་བྱས་ཏེ་ཡི་གེར་འབྲིར་ཡང་གཞུག་།
 mā paścakāle jaravyādhipīḍitā aneka-āyāsasahasravyākulāḥ |	ཕྱི་མའི་དུས་ལ་རྒ་ནས་གདུངས་གྱུར་ལ་༎ འཁྲུག་པ་སྟོང་ཕྲག་དུ་མས་ག-ཡེན་སྤྱོ་ཞིང་༎
 narakeṣu tiryakṣu paribhramāṇāḥ ṣaṇḍhāśca paṇḍāśca jugupsanīyāḥ |	སེམས་དམྱལ་ཡི་དབ༹གས་རྣམས་སུ་ཡོངས་འཁྱམས་དང་༎ ཟ་མ་མ་ནིང་སྨད་པར་བྱ་བ་དང་༎ དམུས་ལོང་ཉིད་དང་རོ་དང་ཁྱི་ཡི་དྲི་༎
 jātyandhabhūtāḥ kuṇapāśca gandhinaḥ saṃjāsyate nīcakuleṣu strīṣu ||	རིགས་དམའ་བུད་མེད་རྣམས་སུ་སྐྱེ་བར་བྱེད་༎ ཕྲག་དོག་ཆེ་ཞིང་རྟག་ཏུ་སྡིག་བྱེད་ལ་༎
 īrṣyālukasya sada pāpacāriṇaḥ krodhābhibhūtasya ca matsariṣya |	ཁྲོ་བས་ཟིལ་ནོན་རྟག་ཏུ་སེར་སྣ་ཅན་༎
 buddheṣu dharmeṣu karitva gauravam imeṣu jātīṣūpapadyate 'sau |	སངས་རྒྱས་ཆོས་ལ་གུས་པར་མ་བྱས་པས་༎ དེ་ནི་དེ་འདྲའི་རིགས་སུ་སྐྱེ་འགྱུར་ལ་༎
 tatraiva duḥkhāni ca vedamānā mā paścakāle paritāpyu bheṣyatha ||	དེར་ཡང་སྡུག་བསྔལ་ཚོར་བ་མྱོང་འགྱུར་ཞིང་༎
 tasmābhi tehi sada pūjitasya yaścaiva dhāreta prakāśayeta |	དེ་ནི་ཕྱི་མའི་དུས་ལའང་གདུང་བར་འགྱུར་༎ དེ་ཕྱིར་གང་དག་འཛིན་ཅིང་སྟོན་བྱེད་པ༏་༏དེ་དག་གིས་ནི་རྟག་ཏུ་མཆོད་པར་བྱ་༎
 yaścaiva paribhāṣaṇu tasya kurvate jugupsanāṃ tāḍanabandhanañca ||	གང་གིས་དེ་ལ་ཡོངས་སུ་སྤྱོ་བ་དང་༎ སྨད་ཅིང་བརྡེགས་ལ་བཅིང་བ་བྱས་གྱུར་པ་༎
 (dutt 66) mamaiva tena paribhāṣaṇā kṛtā mamaiva satkāru karitva dhārake |	དེ་ནི་ང་ཡང་ཡོངས་སུ་སྤྱོས་པ་ཡིན་༎ འཛིན་ལ་ཕུ་དུད་བྱས་ན་ང་ལའང་བྱས་༎
 tasmācca tairhi sada dharmabhāṇake yaścaiva dhāreta likheta vācaye |	དེ་ཕྱིར་དེ་དག་གིས་ནི་ཆོས་སྨྲ་དང་༎ གང་ཞིག་འདི་འཛིན་འབྲི་ཞིང་ཀློག་བྱེད་པ་༎
 satkāru taiśca sad anityu kuryā srigdhāśca vāco madhurā bhaṇeta || iv	དེ་དག་ལ་ནི་རྟག་ཏུ་བསྙེན་བཀུར་ཞིང་༎
 āryāvalokiteśvaro bodhisattvo bhagavataścaraṇayornipatya bhagavantametadavocat |	ཚིག་འཇམ་སྙན་པ་རྒྱུན་དུ་བརྗོད་པར་བྱ༏་༏དེ་ནས་བྱང་ཆུབ་སེམས་དཔའ་སེམས་དཔའ་ཆེན་པོ་འཕགས་པ་སྤྱན་རས་གཟིགས་དབང་ཕྱུག་གིས་བཅོམ་ལྡན་འདས་ཀྱི་ཞབས་གཉིས་ལ་གཏུགས་ཏེ་བཅོམ་ལྡན་༄༤༣༠ཨ་༌༎ འདས་ལ་འདི་སྐད་ཅེས་གསོལ་ཏོ་༎ བཅོམ་ལྡན་འདས་།
 anusmarāmyahaṃ bhagavan asti vyavalokanaprātihāryā nāma dhāraṇī yā mayā pūrvaṃ jñānaketuprabhākarasya tathāgatasyāntikādudgṛhītā śrutā[ca] |	བདག་གིས་རྣམ་པར་ལྟ་བའི་ཆོ་འཕྲུལ་ཞེས་བགྱི་བའི་གཟུངས་མཆིས་པར་རྗེས་སུ་དྲན་ཏེ་། བདག་གིས་སྔོན་དེ་བཞིན་གཤེགས་པ་འོད་མཛད་ཡེ་ཤེས་ཏོག་ཅེས་བགྱི་བའི་སྤྱན་སྔར་དེ་ཐོས་ཤིང་བཟུང་ལགས་སོ་༎ 
 yāṃ śrutvā matvā udgṛhya dhārayitvā vācayitvā satkaritvā likhitvā likhāpayitvā avaivartikabhūmiṃ pratilabhante |	དེ་ཉན་ཅིང་བཟུང་ལ་བཅངས་ཤིང་བཀླགས་ཏེ་གཞན་དག་ལའང་བསྒྲགས་ཤིང་བསྙེན་བཀུར་བགྱིས་ནས་ཡི་གེར་བྲིས་སམ་། ཡི་གེར་འབྲིར་སྩལ་ན་། ཕྱིར་མི་ལྡོག་པའི་ས་འཐོབ་པར་འགྱུར་ཞིང་།
 sarvānetāṃstathāgatabhāṣitān guṇān pratilabhante |	དེ་བཞིན་གཤེགས་པས་གསུངས་པའི་ཡོན་ཏན་དེ་དག་ཐམས་ཅད་ཀྱང་འཐོབ་པར་འགྱུར་།
 sarvaṃ cāsya yathābhiprāyāṃ samṛdhyate |	དེས་ཇི་ལྟར་བསམ་པ་ཐམས་ཅད་ཡང་དག་པར་འགྲུབ་པར་འགྱུར་།
 sarvakarmāva[ra]ṇaṃ cāsya kṣayaṃ gacchati |	དེའི་ལས་ཀྱི་སྒྲིབ་པ་ཐམས་ཅད་ཀྱང་བྱང་བར་འགྱུར་།
 samādhiṃ ca pratilabhate |	ཏིང་ངེ་འཛིན་ཀྱང་འཐོབ་པར་འགྱུར་།
 vigatā vyādhayo bhavanti |	བྲོ་ནད་རྣམས་དང་བྲལ་བར་ཡང་འགྱུར་།
 buddhadarśanaṃ bodhisattvadarśanaṃ bhavati | tad bhagavān sādhukāramadāt |	སངས་རྒྱས་མཐོང་བ་དང་། བྱང་ཆུབ་སེམས་དཔའ་ཡང་མཐོང་བར་འགྱུར་ལགས་སོ་༎ དེ་ནས་བཅོམ་ལྡན་འདས་ཀྱིས་བྱང་ཆུབ་སེམས་དཔའ་སེམས་དཔའ་ཆེན་པོ་འཕགས་པ་སྤྱན་རས་གཟིགས་དབང་ཕྱུག་ལ་ལེགས་སོ་༎
 sādhu sādhu kulaputra pravartaya adhiṣṭhitaṃ tathāgatena |	ཞེས་བྱ་བ་བྱིན་ཏེ༏་རིགས་ཀྱི་བུ་། ལེགས་སོ་༎ ལེགས་སོ་༎ རིགས་ཀྱི་བུ་། ཁྱོད་ལ་དེ་བཞིན་གཤེགས་པས་བྱིན་གྱིས་བརླབས་ཟིན་གྱི་ཤོད་ཅིག་།
 athāryāvalokiteśvaro bodhisattvo daśadiśaṃ sarvatathāgatebhyo namaskṛtya imāni mantrapadāni bhāṣate sma | (dutt 67)	དེ་ནས་བྱང་ཆུབ་སེམས་དཔའ་༄༤༣༠བ་སེམས་དཔའ་ཆེན་པོ་འཕགས་པ་སྤྱན་རས་གཟིགས་དབང་ཕྱུག་གིས་ཕྱོགས་བཅུའི་དེ་བཞིན་གཤེགས་པ་ཐམས་ཅད་ལ་ཕྱག་བྱས་ཏེ་གསང་སྔགས་ཀྱི་གཞི་འདི་དག་སྨྲས་སོ་༎
 namaḥ sarvatathāgatānāṃ sarvāśāparipūrakarāṇām | nama āryāvalokiteśvarasya bodhisattvasya mahākāruṇikasya | tadyathā	ན་མ༔་སརྦ་ཏ་ཐའ་ག་ཏའ་ནའམ། སརྦ་ཨའ་ཤའ་པ་རི་པའུ་ར་ཀའ་ནའམ། ན་མ་ཨའརྱ་བ་ལོ་ཀི་ཏེ་ཤབ༹་རའ་ཡ་། བོ་དྷི་སཏབ༹འ་ཡ་། མ་ཧའ་སཏབ༹འ་ཡ་། མ་ཧའ་ཀའ་རུ་ནི་ཀའ་ཡ་། ཏདྱ་ཐའ་།
 ha ha ha ha | mama mama |	ཧ་ཧ་ཧ་། མ་མ་མ་།
 dhiri dhiri |	དྷི་རི་དྷི་རི་དྷི་རི་། ཤའནཏེ་། པྲ་ཤའནཏེ་།
 śānte praśānte sarvapāpakṣayaṃkare |	སརྦ་པའ་པ་ཀཤ་ཡམ་ཀ་རི་། ཨཨ་བ་ལོ་ཀའ་ཡ་། ཀའ་རུ་ཅི་ཀ་༎ བོ་དྷི་ཙིཏཏ་མ་མ་ན་སི་ཀུ་རུ་།
 avalokaya kāruṇika bodhicittaṃ manasi kuru | vyavalokaya māṃ smara smara yat tvayā pūrvaṃ satyādhiṣṭhānaṃ kṛtam |	བྱ་བ་ལོ་ཀའ་ཡ་། མའ་མ་། སྨ་ར་སྨ་ར་། ཡནཏ་ཡའ་བའུརྦ་། སད་ཏྱ་ཨཨ་དྷིཤཐ་ནམ་ཀྲི་ཏམ། ཏེ་ན་སན་ཏྱེ་ན་པ་ཙ་ནེ་ན་།
 tena satyena sarvāśāṃ me paripūraya |	སརྦ་ཨའ་ཤའ་མེ་པ་རི་པའུ་ར་ཡ་།
 buddhakṣetraṃ pariśodhaya |	བུདདྷ་ཀཤེ་ཏ་མ་པ་རི་ཤོ་དྷ་ཡའ་།
 mā me kaścid viheṭhaṃ karotu |	མ་མེ་ཀཤཙི་དེ་བ་ཧེ་ཐམ་ཀ་རོ་ཏུ་།
 buddhādhiṣṭhānena svāhā | tadyathā	བུདདྷ་ཨཨ་དྷིཤཐའ་ནེ་ན་སབ༹འཧའ་། ཏདྱ་ཐའ་།
 teje teje mahāteje | yanmama kāyaduścaritaṃ vāgduścaritaṃ manoduścaritaṃ dāridrayaṃ vā tanme kṣapaya |	ཏེ་ཛེ་ཏེ་ཛེ་། མ་ཧའ་ཏེ་ཛེ་། ཡ་ན་མ་མ་ཀའ་ཡ་དུ་ཤཙ་རི་ཏ་མ་བའ་། ཝའག་དུ་ཤཙ་རི་ཏ་མ་བའ་། མ་ནོ་དུ་ཤཙ་རི་ཏ་མ་བའ་། དའ་རའི་དྲྱ་མ་བའ་། ཏད་སརྦ་དཀཤའ་པའ་ཡ་།
 ālokaya vilokaya | tathāgatadarśanaṃ cāhamabhikāṃkṣāmi bodhisattvadarśanam |	ཨཨ་ལོ་ཀའ་ཡ་། བི་ལོ་ཀའ་ཡ་། ཏ་ཐའ་ག་ཏ་ད་རི་ཤ་ནན་ཙ་། ཨཨ་ཧ་མ་དྷི་ཀ་དཀཤ་མི་བོ་དྷི་ས་ཏྱ་ད་རི་ཤ་ན་མ་། དྷ་དྷུ་མ་།
 dhudhupa dadasva me darśanam |	དད་ས་སབ༹་མེ་ད་རི་ཤ་ན་མ་།
 sarve me kuśalā abhivardhantu |	སརྦ་མེ་ཀུ་ཤ་ལའ་ཨཨ་བྷི་བརདྷནཏུ་།
 namaḥ sarvatathāgatānām |	ན་མ༔་སརྦ་ཏ་ཐའ་ག་ཏའ་ནན་།
 namaḥ avalokiteśvarasya |	ན་མ་ཨའརྱ་བ་ལོ་ཀི་ཏེ་ཤབ༹་ར་ཡ་། བོ་དྷི་སཏབ༹འ་ཡ་།
 smara pratijñā mahāsattvāḥ |	སྨ་ར་པྲ་ཏི་ཛཉའ་མ་མ་སཏབ༹་།
 sidhyantu mantrapadāḥ svāhā |	སིདདྷྱིནཏུ་མནཏྲ་པ་དེ་སབ༹འཧའ་།
 asyāṃ dhāraṇyāṃ bhāṣyamāṇāyāṃ mahāpṛthivīkaṃpo 'bhūt mahākilakilāśabdaḥ | divyaṃ ca puṣpavarṣamabhipravarṣan[sarvaḥ saparṣat] sādhukārasmadāt |	གཟུངས་འདི་བརྗོད་པ་ན་ས་ཆེན་པོ་འདི་རབ་ཏུ་ག-ཡོས་ཤིང་གཞའི་སྒྲ་ཆེན་པོ་དང་། ལྷའི་མེ་ཏོག་གི་ཆར་དག་ཀྱང་མངོན་པར་རབ་ཏུ་བབ་པར་གྱུར་ཏོ་༎ ༄༤༣༡ཨ་༌༎ ཐམས་ཅད་དང་ལྡན་པའི་འཁོར་དེས་ལེགས་སོ་ཞེས་བྱ་བ་བྱིན་ཏེ་། རིགས་ཀྱི་བུ་།
 sādhu sādhu subhāṣitamidaṃ mahāsattvena sarvasattvānāṃ trāṇārthaṃ sarvāśāparipūrakaram |	ལེགས་སོ་༎ ལེགས་སོ་༎ སེམས་ཅན་ཆེན་པོ་ཁྱོད་སེམས་ཅན་ཐམས་ཅད་བསྐྱབ་པའི་ཕྱིར་རེ་བ་ཐམས་ཅད་ཡོངས་སུ་རྫོགས་པར་བྱེད་པ་། 
 rakṣa sarvabhayebhyaḥ sarvakarmakṣayaṃkara maraṇaduḥsvapnakāntārapraśamana |	འཇིགས་པ་ཐམས་ཅད་ལས་སྲུང་བར་བྱེད་པ་། ལས་ཐམས་ཅད་ཕྱང་བར་ཕྱེད་པ་། སྡང་བ་དང་རྨི་ལམ་ངན་པའི་གནོད་པ་ཐམས་ཅད་རབ་ཏུ་ཞི་བར་བྱེད་པའི་གཟུགས་འདི་ལེགས་པར་སྨྲས་སོ་༎ 
 vayamapi sarve bhūtvā dhārayiṣyāmaḥ satkariṣyāmaḥ |	བདག་ཅག་ཐམས་ཅད་ཀྱིས་ཀྱང་གཟུང་བར་བྱ་། བསྙེན་བཀུར་བྱའོ་༎
 avalokiteśvara āha | yaḥ kaścit kulaputra imān guṇānabhikāṃkṣa[te] |	སྤྱན་རས་གཟིགས་དབང་ཕྱུག་གིས་སྨྲས་པ་། རིགས་ཀྱི་བུ་དག་།
 yathā tathāgatena parikirtitaṃ vyākaraṇaṃ mama kāṃkṣa[te] | mamāpi sammukhadarśanaṃ samādhilambhaṃ buddhabodhisattvadarśanaṃ (dutt 68) bhogaiśvaryalambhaṃ buddhakṣetropapattiṃ tena śuklapakṣe śucinā susnātagātreṇa bhūtvā	གང་ལ་ལ་ཇི་ལྟར་དེ་བཞིན་གཤེགས་པས་ཡོངས་སུ་བསྒྲགས་པའི་ཡོན་ཏན་དེ་དག་མངོན་པར་འདོད་ཅིང་ལུང་བསྟན་པ་དང་། ཁོ་བོའང་མངོན་སུམ་དུ་མཐོང་བ་དང་། ཏིང་ངེ་འཛིན་འཐོབ་པ་དང་། སངས་རྒྱས་དང་བྱང་ཆུབ་སེམས་དཔའ་མཐོང་བ་དང་། ལོངས་སྤྱོད་དང་དབང་ཕྱུག་འཐོབ་པ་དང་། སངས་རྒྱས་ཀྱི་ཞིང་དུ་སྐྱེ་བར་འདོད་པ་དེས་ཟླ་བ་ཡར་གྱི་ངོ་ལ་ལུས་ལེགས་པར་ཁྲུས་བྱས་ཤིང་གཙང་ལ་བསྙེན་ཏེ་གནས་པ་འཕགས་པ་ཡན་ལག་བརྒྱད་པ་ལ་གནས་པར་བྱས་ལ་ཚེས་བརྒྱད་ནས་བརྩམས་ཏེ་།
 āryāṣṭāṃgopavāsopavasitairaṣṭamyāmārabhya śucau pradeśe buddhādhiṣṭhite gandhapuṣpairdhvajapatākaiḥ pūrṇakumbhairabhyarcya sa pṛthivīpradeśaḥ sa ca dharmabhāṇakaḥ śuciḥ susnātagātraḥ śvetavastraprāvṛto nānāpuṣpamālyagandhairabhyarcya likhāpayitavyaḥ sarvasattvāsādhāraṇāni	དེ་བཞིན་གཤེགས་པས་བྱིན་གྱིས་བརླབས་པའི་ཕྱོགས་སུ་སྤོས་དང་། མེ་ཏོག་དང་། རྒྱལ་མཚན་དང་། བ་དན་དག་དང་། བུམ་པ་གང་བ་༄༤༣༡བ་དག་གིས་ཕྱོགས་དེ་དང་། ཆོས་སྨྲ་བ་དེའང་མཆོད་པ་བྱས་ནས་ལུས་ལེགས་པར་ཁྲུས་བྱས་པ་གཙང་མས་གོས་དཀར་པོ་བགོས་ཏེ་མེ་ཏོག་དང་། བདུག་སྤོས་དང་། སྤོས་དང་། མེ་ཏོག་ཕྲེང་དང་། བྱུག་པ་སྣ་ཚོགས་དག་གིས་མཆོད་ནས་ཡི་གེར་བྲི་བར་བྱའོ་༎ འབྲི་བའི་ཚེ་ན་ཉིན་གཅིག་བཞིན་དུ་དགེ་བའི་རྩ་བ་རྣམས་སེམས་ཅན་ཐམས་ཅད་དང་ཐུན་མོང་དུ་བྱས་ལ་། 
 kuśalamūlāni kṛtvā sarvasattvamaitracittena dayācittena karuṇācittena tathāgatagurugauravaṃ cittamupasthāpya tena dine dine likhatā tāva likhe yāvadardhadivasam |	དེ་བཞིན་གཤེགས་པ་ལ་བླ་མ་དང་། གུས་པའི་སེམས་ཉེ་བར་བཞག་ནས་སེམས་ཅན་ཐམས་ཅད་ལ་བྱམས་པའི་སེམས་དང་། སྙིང་བརྩེ་བའི་སེམས་དང་། སྙིང་རྗེའི་སེམས་ཀྱིས་ཉི་མ་ཕྱེད་ཚུན་ཆད་ཀྱི་བར་དེ་ཙམ་དུ་བྲི་བར་བྱའོ་༎
 aṣṭamyāmārabhya yāvat pañcadaśīṃ dine dine saiva pūjā kartavyā |	ཚེས་བརྒྱད་ནས་བརྩམས་ཏེ་ཚེས་བཅོ་ལྔའི་བར་དུ་ཉིན་གཅིག་བཞིན་དུ་མཆོད་པའང་དེ་བཞིན་བྱའོ་༎
 tato 'nenaiva vidhinā likhitamātreṇa pañcānantaryāṇi karmāṇi sarvapāpāni cāsya kṣayaṃ yāsyanti | kuśalairdharmairvivardhiṣyate |	ཆོ་ག་འདི་ཁོ་ན་བཞིན་དུ་བྱས་ཏེ་བྲིས་ན་། དེ་མ་ཐག་ཏུ་མཚམས་མེད་པ་ལྔ་ལ་སོགས་པ་ལས་ཀྱི་སྒྲིབ་པ་ཐམས་ཅད་དང་། སྡིག་པ་ཐམས་ཅད་བྱང་བར་འགྱུར་ཞིང་དགེ་བའི་རྩ་བ་རྣམས་ཀྱང་འཕེལ་བར་འགྱུར་།
 uttaptavīryo bhaviṣyati |	བརྩོན་འགྲུས་འབར་བར་འགྱུར་རོ་༎
 sarvadharmeṣu kāyasukhamanuprāpsyati |	ཚེ་དེ་ཉིད་ལའང་ལུས་བདེ་པ་འཐོབ་པར་འགྱུར་།
 tanūbhaviṣyanti rāgadveṣamohamānakrodhāḥ |	འདོད་ཆགས་དང་། ཞེ་སྡང་དང་། གཏི་མུག་དང་། ང་རྒྱལ་དང་། ཁྲོ་བ་དང་། ཕྲག་དོག་དང་། སེར་སྣ་དག་སྲབ་མོར་འགྱུར་རོ་༎
 tena likhāpayitvā pūrvamukhīṃ sadhātukāṃ tathāgatapratimāmavalokiteśvarapratimāṃ ca sadhātukāṃ sthāpya sadhātukeai caitāyatane puṣpadhūpagandhairdīpaiśca udāratarā pūjā kartavyā |	དེས་ཡི་གེར་འབྲིར་བཅུག་ནས་ཀྱང་སྐུ་གདུང་དང་བཅས་པའི་མཆོད་རྟེན་གྱི་གནས་སུ་དེ་བཞིན་༄༤༣༢ཨ་༌༎ གཤེགས་པའི་སྐུ་གཟུགས་སྐུ་གདུང་དང་བཅས་པ་དང་། སྤྱན་རས་གཟིགས་དབང་ཕྱུག་གི་གཟུགས་སྐུ་གདུང་དང་བཅས་པ་ཞལ་ཤར་ཕྱོགས་སུ་བསྟན་ཏེ་བཞག་ལ་། མེ་ཏོག་དང་། བདུག་སྤོས་དང་། སྤོས་དང་། མར་མེ་དག་གིས་མཆོད་པ་ཤིན་ཏུ་རྒྱ་ཆེར་བྱས་ལ་།
 aṣṭamyāmārabhya yāvat pañcadaśīṃ sarvasattvamahākaruṇācittena bhavitavyam |	ཚེས་བརྒྱད་ནས་བརྩམས་ཏེ་ཚེས་བཅོ་ལྔའི་བར་དུ་སེམས་ཅན་ཐམས་ཅད་ལ་སྙིང་རྗེ་ཆེན་པོའི་སེམས་བསྐྱེད་པར་བྱ་ཞིང་།
 śuciśuklabhojinā āryāṣṭāṃgopavāsopavasitena suhṛtsahāyakena mānakrodhamātsaryaparivarjitena dine dine udāratarāṃ pūjāṃ kṛtvā trisandhyaṃ jāpaḥ aṣṭaśatiko dātavyaḥ |	གཙང་མ་ཁ་ཟས་དཀར་པོ་ཟ་བ་། བསྙེན་ཏེ་གནས་པ་འཕགས་པ་ཡན་ལག་བརྒྱད་པ་ལ་གནས་པ་གྲོགས་པོ་ཡིད་གཅུགས་པ་དང་ལྡན་པ་། ང་རྒྱལ་དང་། ཁྲོ་བ་དང་། ཕྲག་དོག་དང་། སེར་སྣ་ཡོངས་སུ་སྤངས་པས་ཉིན་གཅིག་བཞིན་དུ་མཆོད་པ་རྒྱ་ཆེན་པོ་བྱས་ཏེ་དུས་གསུམ་དུ་བཟླས་བརྗོད་ལན་བརྒྱ་རྩ་བརྒྱད་རྩ་བརྒྱད་བྱའོ་༎
 dīpadhūpapuṣpagandhādi dattvā sumanaḥpuṣpāṣṭaśataiśca āryāvalokiteśvarapratimā trisandhyamāhartavyā |	མེ་ཏོག་དང་། བདུག་སྤོས་དང་། སྤོས་དང་། མར་མེ་དག་ཀྱང་ཕུལ་ལ་། དུས་གསུམ་དུ་སྣ་མའི་མེ་ཏོག་བརྒྱ་རྩ་བརྒྱད་རྩ་བརྒྱད་འཕགས་པ་སྤྱན་རས་གཟིགས་དབང་ཕྱུག་གི་གཟུགས་ལ་གཏོར་བར་བྱའོ་༎
 (dutt 69) vajrapāṇeśca dhūpo dātavyaḥ |	ལག་ན་རྡོ་རྗེ་ལའང་བདུག་སྤོས་ཀྱིས་བདུག་པར་བྱའོ་༎
 daśadiśamabhinamaskṛtya paścimena bhīmāyā devyāḥ pūrveṇānopamāyāḥ ūrdhvena śaṃkhinyā balirnānārasapāyasadadhyodanaścaturdiśaṃ kṣeptavyaḥ |	ཕྱོགས་བཅུར་ཕྱག་བྱས་ལ་ནུབ་ཕྱོགས་ཀྱི་ལྷ་མོ་འཇིགས་བྱེད་མ་དང་། ཤར་ཕྱོགས་ཀྱི་དཔེ་མེད་མ་དང་། སྟེང་གི་ཕྱོགས་ཀྱི་དུང་ཅན་མ་ལ་སོགས་པ་ལ་ཕྱོགས་བཞིར་གཏོར་མ་རོ་སྣ་༄༤༣༢བ་ཚོགས་དང་ལྡན་པ་དང་། འོ་ཐུག་དང་། ཞོ་དང་། འབྲས་ཆན་དག་ཀྱང་གཏོར་བར་བྱའོ་༎
 tatastasya na kaścid vikṣepaṃ kariṣyati | saṃtrāso ['pi notpadyate | ] nānyathātvaṃ cittasya |	དེས་ན་དེ་ལ་རྣམ་པར་ག-ཡེང་བ་དང་། འཇིགས་པ་འགའ་ཡང་འབྱུང་བར་མི་འགྱུར་ཞིང་སེམས་འཁྲུལ་བར་མི་འགྱུར་རོ་༎
 sarveṣāṃ cāṣṭaśatiko jāpaḥ aṣṭaśatasumanaḥpuṣpaiśca saṃcodanam |	སྣ་མའི་མེ་ཏོག་བརྒྱ་རྩ་བརྒྱད་པོ་ཐམས་ཅད་ལ་བཟླས་བརྗོད་བརྒྱ་རྩ་བརྒྱད་བྱས་ལ་བསྐུལ་བར་བྱའོ་༎ 
 [ane]naiva vidhinā pūrvasecaṃ kṛtvā tataḥ pūrṇapañcadaśyāṃ catvāri pūrṇakuṃbhā[ni]sthāpya	ཆོ་ག་འདི་ཁོ་ན་བཞིན་དུ་སྔར་བསྙེན་པ་བྱས་ལ་དེ་ནས་ཚེས་བཅོ་ལྔའི་ནང་པར་ས་ཕྱོགས་དེར་བུམ་པ་གང་བ་བཞི་བཞག་ལ་བདུག་སྤོས་དང་། ཙནདན་དང་། པོག་དཀར་པོ་དང་། ག་བུར་དག་ཀྱང་གཞག་མར་མེ་ཁ་བཞི་།
 dhūpacandanakundurukakarpūraṃ dattvā dīpa[mukhāni] catvāri nānāgandhadhvajapaṭapatākāsuvarṇarūpyabhāṇḍaiḥ taṃ pṛthivīpradeśaṃ samalaṃkṛtya dadhimadhupāyasadadhyodanamanyāni ca yathālambhena	མེ་ཏོག་དང་། བདུག་སྤོས་དང་། གདུགས་དང་། རྒྱལ་མཚན་དང་། དར་དང་། བ་དན་སྣ་ཚོགས་དག་དང་། གསེར་དངུལ་གྱི་སྣོད་དག་གིས་ལེགས་པར་བརྒྱན་ལ་སྦྲང་རྩི་དང་སྦྱར་བའི་འོ་ཐུག་དང་། ཞོ་དང་། འབྲས་ཆེན་དང་། གཞན་ཡང་ཅི་འབྱོར་པའི་ལྷ་བཤོས་དང་། གཏོར་མ་དག་ཀྱང་ཕྱོགས་བཞིར་གཞག་གོ་།
 baliṃ caturdiśe dattvā nivedya sumanaḥpuṣpāṣṭakaśatairekaikaṃ japya caturdiśe kṣeptavyam |	སྣ་མའི་མེ་ཏོག་བརྒྱ་རྩ་བརྒྱད་ལ་སྔ་མ་བཞིན་དུ་བཟླས་བརྗོད་ལན་རེ་བྱས་ལ་ཕྱོགས་བཞིར་གཏོར་རོ་༎ 
 pūrvavat tryaṣṭaśataiḥ sumanojātipuṣpairekaikaṃ japya āryāvalokiteśvarapratimā āhartavyā |	དེ་ནས་སྣ་མའི་མེ་ཏོག་བརྒྱ་རྩ་བརྒྱད་ཕྲག་གསུམ་ལ་བཟླས་བརྗོད་ལན་རེ་བྱས་ལ༏་རེ་རེ་ནས་འཕགས་པ་སྤྱན་རས་གཟིགས་དབང་ཕྱུག་གི་གཟུགས་ལ་བསྣུན་པར་བྱའོ་༎
 tataḥ satpratimā kaṃpiṣyati |	དེ་ནས་གཟུགས་དེ་འགུལ་བར་འགྱུར་ཞིང་སྒྲ་སྐད་ཆེན་པོའང་འབྱུང་བར་འགྱུར་།
 mahānirghoṣo bhaviṣyati | raśmayo niścariṣyanti |	༄༤༣༣ཨ་༌༎ འོད་ཟེར་དག་ཀྱང་འབྱུང་བར་འགྱུར་།
 pṛthivīkampaḥ [bhaviṣyati |	སའང་ག-ཡོ་བར་འགྱུར་རོ་༎
 ] tataḥ sarvakarmāṇi sarvakāryāṇi cāsya samṛddhiṣyanti | tathāgatadarśanaṃ bodhisattvabhūmipratilambhaḥ sarvasattvavandanīyo bhaviṣyati |	དེ་ནས་ལས་ཐམས་ཅད་དང་། དགོས་པ་ཐམས་ཅད་ཀྱང་འགྲུབ་པར་འགྱུར་ཞིང་དེ་བཞིན་གཤེགས་པ་མཐོང་བ་དང་། བྱང་ཆུབ་སེམས་དཔའི་ས་ཐོབ་པར་ཡང་འགྱུར་། སེམས་ཅན་ཐམས་ཅད་ཀྱིས་ཕྱག་བྱ་བའི་འོས་སུའང་འགྱུར་།
 dhanadhānyakośakoṣṭhāgārasamṛddhaḥ sarvavyādhiparivarjitaścirajīvi (dutt 70) [bhaviṣyati] |	ནོར་དང་། འབྲུ་དང་། མཛོད་དང་། བང་བ་རྣམས་འབྱོར་པར་ཡང་འགྱུར་།
 sarvaśatravaḥ sarvarājarājaputrāmātyadarśanābhikāṃkṣiṇo bhaviṣyanti priyaṃkarāḥ sarvakleśarāgadveṣamohaprahīṇāḥ |	ནད་ཐམས་ཅད་ཡོངས་སུ་སྤངས་པ་དང་། ཚེ་རིང་བར་ཡང་འགྱུར་། དགྲ་ཐམས་ཅད་དང་། རྒྱལ་པོ་དང་། རྒྱལ་བུ་དང་། བློན་པོ་རྣམས་ཀྱང་དེ་ལ་ལྟ་འདོད་ཅིང་གཅེས་སྤྲས་བྱེད་པར་ཡང་འགྱུར་། ཉོན་མོངས་པ་ཐམས་ཅད་དང་། འདོད་ཆགས་དང་། ཞེ་སྡང་དང་། གཏི་མུག་སྤངས་པར་འགྱུར་།
 na ca jātu priyaviprayogo bhaviṣyati |	ནམ་དུའང་སྡུག་པ་དང་མི་འབྲལ་བར་འགྱུར་རོ་༎
 mahādṛḍhabalavīryasaṃpannastejavāṃstīkṣṇendriyo buddhimān sarvasattvadayācitto dharmajño yāvaccyavanakāle buddhaṃ bhagavantamāryāvalokiteśvaraṃ paśyati | maitravihārī kālaṃ karoti |	བརྟན་པ་དང་། སྟོབས་དང་། བརྩོན་འགྲུས་ཆེན་པོ་དང་ལྡན་པ་དང་། གཟི་བརྗིད་དང་ལྡན་པ་དང་། དབང་པོ་རྣོ་བ་དང་། བློ་དང་ལྡན་པ་དང་། སེམས་ཅན་ཐམས་ཅད་ལ་སྙིང་བརྩེ་བའི་སེམས་དང་ལྡན་པ་དང་། ཆོ་ག་ཤེས་པ་དང་། འཆི་བའི་ཚེ་ན་སངས་རྒྱས་བཅོམ་ལྡན་འདས་རྣམས་མཐོང་བ་དང་། འཕགས་པ་སྤྱན་རས་གཟིགས་དབང་ཕྱུག་ཀྱང་མཐོང་བ་དང་། བྱམས་པ་ལ་གནས་ཤིང་ཆོས་སྟོན་བཞིན་དུ་འཆི་བའི་དུས་བྱེད་པའི་བར་དུའང་འགྱུར་རོ་༎
 dharmaṃ deśayamānaṃ yathepsiteṣu buddhakṣetreṣu mahācakravartikuleṣu yatrānusmṛtiṃ karoti tatropapadyate |	སངས་རྒྱས་ཀྱི་ཞིང་ཇི་ལྟ་བུ་༄༤༣༣བ་འདོད་པ་དག་གམ་། འཁོར་ལོས་བསྒྱུར་བའི་རིགས་ཆེན་པོའམ་།
 anyāni cānekāni guṇasahasrāṇi pratilapsyate |	གང་དུ་རྗེས་སུ་དྲན་པར་བྱེད་པ་དེར་སྐྱེ་བ་དང་། གཞན་ཡང་ཡོན་ཏན་སྟོང་ཕྲག་དུ་མ་དག་ཀྱང་འཐོབ་པར་འགྱུར་རོ་༎ གསོལ་པ་། བཅོམ་ལྡན་འདས་། དེ་ལྟར་ན་། ཆོས་ཀྱི་རྣམ་གྲངས་འདི་དང་། གཟུངས་ཀྱི་གསང་སྔགས་ཀྱི་གཞི་འདི་དག་ནི་།
 evaṃ bhagavan bahuguṇakaro 'yaṃ dharmaparyāyaḥ |	ཡོན་ཏན་མང་པོའི་འབྱུང་གནས་ལགས་ཏེ་། ཆོས་ཀྱི་རྣམ་གྲངས་འདི་ནི་།
 imāni te dhāraṇīmantrapadāni na vinā tathāgatādhiṣṭhānasyāyaṃ dharmaparyāyaṃ śakyaṃ śrotuṃ na dhārayituṃ na pūjayituṃ na likhituṃ na likhāyituṃ na śraddadhātum | sace darśanaṃ bhave na śravaṃ bhaviṣyati |	དེ་བཞིན་གཤེགས་པའི་བྱིན་གྱི་རླབས་མ་མཆིས་པར་མཉན་པར་ཡང་རྔོ་མི་ཐོགས་ལ་གཟུང་བར་ཡང་རྔོ་མི་ཐོགས་། ཀློག་པར་ཡང་རྡོ་མི་ཐོགས་། མཆོད་པར་ཡང་རྔོ་མི་ཐོགས་། ཡི་གེ་བྲི་བར་ཡང་རྔོ་མི་ཐོགས་། ཡི་གེར་འབྲིར་སྩལ་བར་ཡང་རྔོ་མི་ཐོགས་།
 sace śravaṇaṃ tadvikṣiptacittaḥ śroṣyati na śraddhāsyati na satkariṣyati |	དད་པར་ཡང་རྔོ་མི་ཐོགས་ལགས་སོ་༎ གལ་ཏེ་མཐོང་བར་གྱུར་ནའང་ཉན་པར་མི་འགྱུར་ལ་། གལ་ཏེ་ཉན་པར་གྱུར་ནའང་དེ་སེམས་རྣམ་པར་ག-ཡེངས་པས་ཉན་པར་འགྱུར་ཞིང་དད་པར་མི་འགྱུར་། བསྙེན་བཀུར་བགྱིད་པར་མི་འགྱུར་ལགས་སོ་༎
 sace satkare kleśavyāpādacittaḥ[satkariṣyati] sace likhe likhāpayeta vyākṣiptacittaḥ |	གལ་ཏེ་བསྙེན་བཀུར་བགྱིད་པར་འགྱུར་ནའང་ཉོན་མོངས་པ་དང་། གནོད་སེམས་དང་བཅས་པའི་སེམས་ཀྱིས་བསྙེན་བཀུར་བགྱིད་པར་འགྱུར་ལགས་སོ་༎ གལ་ཏེ་ཡི་གེར་འབྲིའམ་། ཡི་གེར་འབྲིར་སྩལ་བར་གྱུར་ནའང་དེ་གཞན་དག་ཡིད་ལ་བགྱིད་པར་འགྱུར་ལགས་སོ་༎
 [tat kasya hetoḥ] |	དེ་ཅིའི་སླད་དུ་ཞེ་ན་།
 tathā hi tasya pūrvapāpakarmaphalahetutvāt karmānubhavitavyam |	འདི་ལྟར་དེའི་སྔོན་གྱི་ལས་ཀྱི་འབྲས་བུ་ལགས་པའི་སླད་དུ་སྟེ་། དེ་ནི་ལས་དེ་ཉམས་སུ་མྱོང་བར་བགྱིད་༄༤༣༤ཨ་༌༎
 sa vicikitsāprāpto bhaviṣyati |	ཅིང་ཐེ་ཚོམ་སྐྱེ་བར་འགྱུར་ལགས་སོ་༎
 paṃcānantaryaṃ kariṣyati |	མཚམས་མ་མཆིས་པ་ལྔ་བགྱིད་པས་ཀྱང་ལན་གསུམ་བསྒྲུབས་ན་།
 tribhiḥ sādhanaiḥ sarvāśāsamṛddhirbhaviṣyati |	རེ་བ་ཐམས་ཅད་ཡང་དག་པར་འགྲུབ་པར་འགྱུར་ལགས་ཏེ་།
 nātra kāṃkṣā na vimatirna vicikitsotpādayitavyā |	དེ་ལ་ནེམ་ནུར་མ་མཆིས་པ་དང་། ཡིད་གཉིས་མ་མཆིས་པ་དང་། ཐེ་ཚོམ་མི་བསྐྱེད་པར་བགྱི་ལགས་སོ་༎
 atha bhagavān[avalokiteśvarāya bodhisattvāya mahāsattvāya] sādhukāramadāt |	དེ་ནས་བཅོམ་ལྡན་འདས་ཀྱིས་བྱང་ཆུབ་སེམས་དཔའ་སེམས་དཔའ་ཆེན་པོ་འཕགས་པ་སྤྱན་རས་གཟིགས་དབང་ཕྱུག་ལ་ལེགས་སོ་ཞེས་བྱ་བ་བྱིན་ཏེ་།
 sādhu sādhu kulaputra |	རིགས་ཀྱི་བུ་། ལེགས་སོ་༎ ལེགས་སོ་༎
 tathāgatakṛtyamayaṃ dharmaparyāyaḥ kariṣyati sarvasattvānām |	ཆོས་ཀྱི་རྣམ་གྲངས་འདི་ནི་སེམས་ཅན་ཐམས་ཅད་ལ་དེ་བཞིན་གཤེགས་པའི་མཛད་པ་བྱེད་པར་འགྱུར་རོ་༎ 
 (dutt 71) v atha khalvanopamā mahāyakṣiṇī yena bhagavāṃstenopasamakrāmat |	དེ་ནས་གནོད་སྦྱིན་མོ་ཆེན་མོ་དཔེ་མེད་མ་བཅོམ་ལྡན་འདས་ག་ལ་བ་དེར་སོང་སྟེ་ཕྱིན་ནས་བཅོམ་ལྡན་འདས་ལ་མེ་ཏོག་དང་རོ་༎ 
 bhagavantaṃ nānāpuṣpaduṣyayugairācchādya bhagavataḥ pādayornipatya bhagavantametadavocat |	། སྤོས་དང་། བདུག་སྤོས་སྣ་ཚོགས་དང་། རས་བཅོས་བུ་ཟུང་དག་གིས་མཆོད་པར་བྱས་ཏེ་བཅོམ་ལྡན་འདས་ཀྱི་ཞབས་གཉིས་ལ་གཏུགས་ནས་བཅོམ་ལྡན་འདས་ལ་འདི་སྐད་ཅེས་གསོལ་ཏོ་༎ བཅོམ་ལྡན་འདས་།
 evaṃ smarāmyahaṃ bhagavanmayā bhagavataḥ kauśāmbyāṃ ghoṣilasyārāme viharataḥ purataḥ pratijñā samudāhṛtā sarvasattvānāmarthāya |	བདག་གིས་འདི་ལྟར་བཅོམ་ལྡན་འདས་ཡུལ་ཀོའུ་ཤ་མབྷི་ན་དབྱངས་ཅན་གྱི་ཀུན་དགའ་ར་བ་ན་བཞུགས་པའི་སྤྱན་སྔར་སེམས་ཅན་ཐམས་ཅད་ཀྱི་དོན་དང་། སྨན་པ་དང་། བདེ་བའི་སླད་དུ་དམ་བཅས་པ་བརྗོད་པར་རྗེས་སུ་དྲན་ལགས་ཏེ་།
 ahamapi bhagavan sarvavidyādharāṇāṃ hṛdayaṃ jānāmi |	བཅོམ་ལྡན་འདས་། བདག་༄༤༣༤བ་ཅག་གིས་ཀྱང་རིག་སྔགས་འཆང་བ་ཐམས་ཅད་ཀྱི་སྙིང་པོ་དག་འཚལ་ལགས་སོ་༎
 tanme bhagavānanujānātu bahujanahitāya bahujanasukhāya sarvāśāparipūraṇārthāya bhikṣubhikṣuṇyupāsakopāsikānāṃ ca |	དེའི་སླད་དུ་བཅོམ་ལྡན་འདས་ཀྱིས་སྐྱེ་བོ་མང་པོ་ལ་སྨན་པ་དང་། སྐྱེ་བོ་མང་པོ་ལ་བདེ་བ་དང་། རེ་བ་ཐམས་ཅད་ཡོངས་སུ་རྫོགས་པར་འགྱུར་བ་དང་། དགེ་སློང་དང་། དགེ་སློང་མ་དང་། དགེ་བསྙེན་དང་། དགེ་བསྙེན་མ་རྣམས་ཀྱི་དོན་དུ་བདག་རྗེས་སུ་གཟུང་དུ་གསོལ་།
 namaḥ sarvatathāgatānāṃ saṃyyathīd ha ha |	ན་མ༔་སརྦ་ཏ་ཐའ་ག་ཏའ་ནའམ། སཡའད་ཡ་ཐེ་དན་།
 hī hī |	ཧ་ཧ་།
 hu hu |	ཧི་ཧི་། ཧུ་ཧུ་།
 sara sara |	ས་ར་ས་ར་།
 lahuṃ lahuṃ |	ལ་ཧའུམ་ལ་ཧའུམ།
 śīghraṃ śīghraṃ |	ཤའ་གྷརའིམ།
 mahāvidye sarvavidyādharanamaskṛte | hasaḥ hasaḥ |	མ་ཧའ་བིདཡའ་། སརྦ་བིདཡའ་དྷ་ར་ན་མ་སྐྲི་ཏེ་། ཧ་ས་ཧ་ས་ཀིམ་ཏིཤཐ་སི་།
 kiṃ tiṣṭhasi kiṃ tiṣṭhasi |	ཀིམ་ཀིམ་ཏིཤཐ་སི་། ཀན་ཀ་བི་ཙི་ཏྲ་།
 kanakavicitrābharaṇavibhūṣitāṃgi paṭa paṭa |	ཨཨ་བ་ར་ན་བི་བྷའུ་ཤི་ཏའངགེ་། པ་ཏ་པ་ཏ་།
 bhara bhara |	བྷ་ར་བྷ་ར་།
 bhiri bhiri |	བྷི་རི་བྷི་རི་།
 bhūru bhūru |	བྷུ་རུ་བྷུ་རུ་།
 sarvārthaṃ me sādhaya |	སརྦ་ཨཨརཐན་མེ་སའ་དྷ་ཡ་།
 turu turu |	ཏུ་རུ་ཏུ་རུ་།
 arthaṃ sādhaya |	ཨཨརཐན་སའ་དྷ་ཡ་།
 arthaṃ dehi me	ཨཨརཐན་དེ་ཧི་མེ་། སརྦ་སཏརའ་ནའམ་སིདདྷིམ།
 nātsahaṃ mārapati śūlkṣiṇasya |	ཧའ་ཧའ་།
 [sarvasaṅghānāḥ]siddhiṃ hā hā | padme padme mahāpadme |	པདམེ་པདམེ༏་མ་ཧའ་པདམེ་།
 viśade viśade mahāviśade |	བི་ཤ་དེ་བི་ཤ་དེ་། མ་ཧའ་བི་ཤ་དེ་།
 bhava bhava bhavodbhavāya | tamahaṃ ghore tamahaṃ ghore | (dutt 72) tanme vidyāṃ prayojaya |	བྷ་བ་བྷ་བ་། བྷ་བོ་བྷ་བའ་ཡ་། ཏ་མ་ཧམ་གྷོ་རེ་། ཏན་མེ་བིདྱ་མ་པྲ་ཡོ་ཛ་ན་ཡ་།
 siddhiṃ kuru |	སིདདྷིམ་ཀུ་རུ་།
 sarvaśāṃ me paripūraya buddhādhiṣṭhānena svāhā |	སརྦ་ཨའ་ཤའ་མེ་པ་རི་པའུ་ར་ཡ་། བུདདྷ་ཨཨ་དྷིཤཐའ་ནེ་ན་སབ༹འཧའ༏་བཅོམ་ལྡན་འདས་།
 yaḥ kaścidbhagavadguṇārthī dhanadhānyārthī sarvasattvavaśīkaraṇārthī bhave mahaiśvaryaṃ rājatvaṃ vidyādharatvamabhikāṃkṣa[te]mamāpi saṃmukhadarśanaṃ tena aṣṭamyāṃ śuklapakṣe	གང་ལ་ལ་ཡོན་ཏན་འཚལ་བ་དང་། ནོར་དང་འབྲུ་འཚལ་བ་དང་། སེམས་ཅན་ཐམས་ཅད་དབང་དུ་བགྱིད་པར་འཚལ་བ་དང་། ནོར་གྱི་དབང་ཕྱུག་ཆེན་པོ་དང་། རྒྱལ་སྲིད་དང་། རིག་སྔགས་འཆང་ཆེན་པོ་ཉིད་དང་། བདག་ཀྱང་མངོན་སུམ་དུ་མཐོང་བར་འཚལ་བ་དེས་ཆོས་བརྒྱད་ཀྱི་གདུགས་ལ་རས་དཀར་པོ་གསར་པ་ཁ་ཚར་མ་༄༤༣༥ཨ་༌༎
 nave paṭake acchinnadaśe keśāpagate śucinā citrakareṇa āryāṣṭāṅgopavāsopavasitena	བཀུམ་པ་སྐྲ་བསལ་བ་ལ་རི་མོ་མཁན་གཙང་མ་བསྙེན་ཏེ་གནས་པ་།
 aśleṣairaṅgairnavabhājanasthaiścitrāpayitavyam |	འཕགས་པ་ཡན་ལག་བརྒྱད་པ་ལ་གནས་པས་། ཚོན་རྩི་སྤྱིན་དང་མ་འབགས་པ་སྣོད་གསར་པའི་ནང་དུ་སྩལ་བས་དབུས་སུ་དེ་བཞིན་གཤེགས་བའི་སྐུ་གཟུགས་ཆོས་སྟོན་པའི་ཚུལ་དུ་བཞུགས་པ་བྲི་བར་བགྱིའོ་༎ 
 madhye tathāgatapratimā dharmaṃ deśayamānā dakṣiṇenāryavajrakrodho vajraṃ bhrāmayamānaḥ	ག-ཡས་ཕྱོགས་སུ་འཕགས་པ་རྡོ་རྗེ་ཁྲོ་བོ་རད་པ་དཀར་པོ་འཚལ་བ་།
 sarvālaṅkāravibhūṣitaḥ[puṣpa]mālyārdhacandrahāraḥ śvetavastraprāvṛtaḥ vāmapārśve	རྒྱན་ཐམས་ཅད་དང་། མེ་ཏོག་ཕྲེང་བ་དང་། ཟླ་གམ་དང་། སེ་མོ་དོས་བརྒྱན་པ་རྡོ་རྗེ་གསོར་ཞིང་མཆིས་པ་བྲི་བར་བགྱིའོ་༎
 anopamā śarakāṇḍagaurī sarvālaṃkāravibhūṣitā śvetavastrā padmahastā samāśvāsayaṃtī |	ག-ཡོན་ཕྱོགས་སུ་ནི་གནོད་སྦྱིན་མོ་ཆེན་མོ་དཔེ་མེད་མ་འདམ་བུ་མདའ་རྒྱུའི་མདོག་ལྟར་དཀར་ཤམ་དུ་མཆིས་ལ་། རད་པ་དཀར་པོ་འཚལ་བ་། རྒྱན་ཐམས་ཅད་ཀྱིས་བརྒྱན་པ་། སུག་པ་ན་པདམ་ཐོགས་ཤིང་ཡང་དག་པར་དབུགས་འབྱིན་པའི་ཚུལ་དུ་མཆིས་པ་བྲི་བར་བགྱིའོ་༎
 tataḥ śucinā vidyādhareṇa āryāṣṭāṅgopavasitena śucau sadhātuke tathāgatasthāne kṣīrayāvakāhāreṇa	དེ་ནས་རིག་སྔགས་འཆང་གཙང་མ་བསྙེན་ཏེ་གནས་པ་། འཕགས་པ་ཡན་ལག་བརྒྱད་པ་ལ་གནས་པ་། རད་པ་དཀར་པོ་འཚལ་བ་། གྲོགས་དང་ལྡན་པ་།
 śvetavastraprāvṛtenātmadvitīyena aṣṭamyāṃ pūrvasecaṃ kṛtvā nānāpuṣpagandhadhūpadīpaiḥ pūjāṃ kṛtvā triskṛtvā tryaṣṭaśatiko jāpo dātavyaḥ |	ནས་ཆན་འོ་མ་དང་སྦྱར་བ་འཚལ་བས་སྔར་བསྙེན་པ་བགྱི་ལ་། ཚེས་བརྒྱད་ཀྱི་གདུགས་ལ་དེ་བཞིན་གཤེགས་པའི་སྐུ་གདུང་དང་བཅས་པའི་གནས་གཙང་མར་དང་པོར་ཁོ་ནར་དེ་བཞིན་གཤེགས་པ་དང་། ལག་ན་རྡོ་རྗེ་ལ་མེ་ཏོག་དང་། བདུག་སྤོས་དང་། སྤོས་དག་གསོལ་བར་བགྱི་ཞིང་། ཕྱོགས་བཞིར་༄༤༣༥བ་ཡང་འོ་ཐུག་དང་། ཞོ་དང་། འབྲས་ཆན་དང་། རོ་སྣ་ཚོགས་དང་ལྡན་པ་དང་། ཆན་སྣ་ཚོགས་ཀྱི་གཏོར་མ་དག་གཏོར་ལ་།
 ekaikaṃ sumanaḥpuṣpaṃ jāpya tryaṣṭaśataiḥ sā pratimā āhartavyā tathāgatasya vajrapāṇeśca pūrvataraṃ puṣpadhūpagandhaṃ dātavyam |	མེ་ཏོག་དང་། བདུག་སྤོས་དང་། སྤོས་དང་། མར་མེ་སྣ་ཚོགས་དག་གིས་མཆོད་པ་བགྱིས་ནས་དུས་གསུམ་དུ་སྣ་མའི་མེ་ཏོག་བརྒྱ་རྩ་བརྒྱད་ཕྲག་གསུམ་ལ་བཟླས་བརྗོད་བརྒྱ་རྩ་བརྒྱད་ཕྲག་གསུམ་བགྱི་ཞིང་། རེ་རེ་ནས་གནོད་སྦྱིན་མོ་ཆེན་མོ་དཔེ་མེད་མའི་གཟུགས་དེ་ལ་བསྣུན་པར་བགྱིའོ་བགྱི་ཞིང་། 
 balipāyasadadhyodanaṃ nānārasaṃ nānāmadyaṃ (dutt 73) caturdiśe kṣeptavyam | pūrṇapañcadaśyāmanenaiva vidhinā baliḥ anyā[ni] ca yathālābhena dhūpakarpūrakundurukacandanamrakṣaṃ dātavyam |	༎ དེ་ནས་ཟླ་བ་ཉའི་ཚེས་བཅོ་ལྔའི་གདུགས་ལའང་ཆོག་འདི་ཉིད་དང་། གཞན་ཡང་ཅི་འབྱོར་བ་དག་དང་། བདུག་སྤོས་དང་། ག་པུར་དང་། པོག་དཀར་པོ་དང་། ཙནདན་དང་། ཤིང་མུ་ས་དག་ཀྱང་དབུལ་།
 sugandhatailena dvau dipau dātavyau |	འབྲུ་མར་དྲི་བདའ་བའི་ཞུགས་མར་ཁ་གཉིས་ཀྱང་དབུལ་བར་བགྱིའོ་༎
 tatrāhaṃ svarūpeṇopatiṣṭhāmi |	དེ་ནས་བདག་དེར་རང་གི་གཟུགས་ཀྱིས་གནས་པར་བགྱི་ཞིང་དམ་པ་ཅི་འཚལ་བའང་སྩལ་བར་བགྱི་སྟེ་། 
 yathepsitaṃ varaṃ dāsyāmi samādhilābhamākāśagamanamantardhānaṃ rājatvaṃ balacakravartitvaṃ vidyādharatvaṃ nidhivādaṃ dhātuvādaṃ paracittajñānaṃ dīrghāyuṣkatvam |	ཏིང་ངེ་འཛིན་ཐོབ་པ་དང་། ནམ་མཁའ་ལ་མཆིས་པ་དང་། ལུས་མི་སྣང་བར་བགྱི་བ་དང་། རྒྱལ་སྲིད་དང་། སྟོབས་ཀྱི་འཁོར་ལོས་བསྒྱུར་བ་ཉིད་དང་། རིག་སྔགས་འཆང་ཉིད་དང་། གཏེར་ལྟ་འཚལ་བ་དང་། ནོར་སྒྱུར་འཚལ་བ་དང་། ཕ་རོལ་གྱི་སེམས་འཚལ་བ་དང་། ཚེ་རིང་བ་དང་། དམ་པ་ཅི་འཚལ་བའང་སྩལ་བར་བགྱི་ལགས་སོ་༎ དེས་ཀྱང་སེམས་ཅན་ཐམས་ཅད་ལ་བྱམས་པའི་སེམས་དང་། ང་རྒྱལ་དང་། ཁྲོ་བ་དང་། ཕྲག་དོག་དང་། སེར་སྣ་ཡོངས་སུ་༄༤༣༦ཨ་༌༎
 sarvasattvānāṃ maitracittena bhavitavyam |	སྤངས་པའི་སེམས་སུ་བགྱིའོ་༎
 mānakrodhadherṣyāmātsaryaparivarjitena staupikadhārmikasāṃghikārthāpahāraparivarjitena bhavitavyam | tathāgatānāmabhedyaprasādena[bhavitavyam] |	མཆོད་རྟེན་དང་། ཆོས་དང་། དགེ་འདུན་གྱི་ནོར་འཕྲོག་པ་ཡོངས་སུ་སྤང་བ་དང་། དེ་བཞིན་གཤེགས་པ་རྣམས་ལ་དང་བ་མི་ཕྱེད་པར་བགྱིའོ་༎
 yadi cāhaṃ bhagavan pañcānantaryaṃ kariṣyāmi tribhiḥ sādhanairna samanvāherayaṃ mā	བཅོམ་ལྡན་འདས་། གལ་ཏེ་མཚམས་མ་མཆིས་པ་བགྱིད་བ་ཞིག་གིས་ཀྱང་ལན་གསུམ་བསྒྲུབས་ཏེ་བདག་གིས་མ་སྩལ་བར་གྱུར་ན་། 
 cāhaṃ bhagavannanuttarāṃ samyaksaṃbodhimabhisaṃbudhyeyaṃ sace buddhe aprasādalabdho	བཅོམ་ལྡན་འདས་། བདག་བླ་ན་མེད་པ་ཡང་དག་པར་རྫོགས་པའི་བྱང་ཆུབ་མངོན་པར་རྫོགས་པར་འཚང་རྒྱ་བར་མ་གྱུར་ཅིག་། 
 bhave yaśca vimatiprāpto yaścaṃ pāpamakuśalaṃ kṛtvā na viratimanugṛṇhāti kleśopakleśacittastasyāhaṃ cāpi darśanaṃ dāsyāmi lābhamapi kariṣyāmi |	གལ་ཏེ་སངས་རྒྱས་ལ་མ་དད་པར་གྱུར་པ་དང་། ཡིད་གཉིས་སུ་གྱུར་པ་གང་ལགས་པ་དང་། སྡིག་པ་མི་དགེ་བའི་ཆོས་བགྱིས་ནས་འགྱོད་པར་མི་བགྱིད་པ་དང་། ཉོན་མོངས་པ་དང་། ཉེ་བའི་ཉོན་མོངས་པའི་སེམས་དང་ལྡན་པ་གང་ལགས་པ་དེ་དག་ལའང་བདག་མཐོང་བ་སྩལ་བར་བགྱི་ཞིང་ཐོབ་པར་ཡང་བགྱི་ལགས་སོ་༎
 atha bhagavān sādhukāramadāt |	དེ་ནས་བཅོམ་ལྡན་འདས་ཀྱིས་གནོད་སྦྱིན་མོ་ཆེན་མོ་དཔེ་མེད་མ་ལེ་ལེགས་སོ་ཞེས་བྱ་བ་བྱིན་ཏེ་། 
 sādhu sādhu bhagini |	སྲིང་མོ་། ལེགས་སོ་༎ ལེགས་སོ་༎
 sādhu khalu punastvaṃ bhagini yattvayā sarvasattvānāmarthāya pāpasamācāreṣu (dutt 74) sattveṣu imā evaṃrūpā mantrapadā bhāṣitāḥ pratijñā kṛtā |	སྲིང་མོ་ཁྱོད་ཀྱིས་སེམས་ཅན་ཐམས་ཅད་ཀྱི་དོན་དུ་སྡིག་པ་ཀུན་ཏུ་སྤྱོད་པའི་སེམས་ཅན་རྣམས་ལ་གསང་སྔགས་ཀྱི་གཞི་འདི་ལྟ་བུ་འདི་དག་སྨྲས་ཞིང་དམ་བཅའ་བའང་བྱས་པ་ནི་།
 śakṣyasi tvamanayā evaṃrūpayā mahākaruṇayā sarvasattvānanuttarāyāṃ samyaksaṃbodhau prati[ṣṭhā]payitum |	ཡང་ཁྱོད་ལེགས་སོ་༎ ཁྱོད་སྙིང་རྗེ་ཆེན་པོ་འདི་ལྟ་བུ་འདིས་སེམས་ཅན་ཐམས་ཅད་བླ་ན་མེད་པ་ཡང་དག་པར་རྫོགས་༄༤༣༦བ་པའི་བྱང་ཆུབ་ལ་རབ་ཏུ་འགོད་ནུས་པར་འགྱུར་གྱི་། 
 evameva tvayāpi karaṇīyam |	ཁྱོད་ཀྱིས་དེ་བཞིན་དུ་གྱིས་ཤིག་།
 atha śaṃkhini mahādevī bhagavantaṃ nānāpuṣpairnānāgandhairabhyarcya pradakṣiṇīkṛtya pādaryonipatya bhagavantametadavocat |	དེ་ནས་ལྷ་མོ་ཆེན་མོ་དུང་ཅན་མས་བཅོམ་ལྡན་འདས་ལ་མེ་ཏོག་སྣ་ཚོགས་དང་། སྤོས་སྣ་ཚོགས་དག་གིས་མཆོད་པ་བྱས་ཏེ་བསྐོར་བ་བྱས་ནས་བཅོམ་ལྡན་འདས་ཀྱི་ཞབས་གཉིས་ལ་གཏུགས་ཏེ་བཅོམ་ལྡན་འདས་ལ་འདི་སྐད་ཅེས་གསོལ་ཏོ་༎ བཅོམ་ལྡན་འདས་།
 ahamapi bhagavaṃstathāgatādhiṣṭhānena pratijñāṃ kariṣyāmi tathāgataśāsanacirasthityartham | teṣāṃ ca dharmabhāṇakānāṃ dharmaśrāvaṇikānāṃ sarvāśāparipūrakarāṇi mantrapadāni dāsyāmi | rakṣāyai tanme bhagavān anujānātu |	བདག་གིས་དེ་བཞིན་གཤེགས་པའི་བྱིན་གྱི་རླབས་ཀྱིས་དེ་བཞིན་གཤེགས་པའི་བསྟན་པ་ཡུན་རིང་དུ་གནས་པར་བགྱི་བ་དང་། ཆོས་སྨྲ་བ་དེ་དག་ཀྱང་བསྲུང་བའི་སླད་དུ་དམ་བཅའ་བར་བགྱི་ཞིང་། རེ་བ་ཐམས་ཅད་ཡོངས་སུ་རྫོགས་པར་བགྱིད་པའི་གསང་སྔགས་ཀྱི་གཞི་རྣམས་སྩལ་བར་བགྱི་ལགས་ཀྱི་། དེའི་སླད་དུ་བཅོམ་ལྡན་འདས་ཀྱིས་བདག་ལ་རྗེས་སུ་གནང་བར་མཛད་དུ་གསོལ་།
 namo namaḥ sarvatathāgatānām |	ན་མ༔་སརྦ་ཏ་ཐའ་ག་ཏ་ནའི་།
 oṃ śaṃkhini devi āgaccha āgaccha |	ཏདྱ་ཐའ་། ཨཨོམ་ཤམ་ཁི་ནི་དེ་བི་། ཨའ་གཙཚ་ཨའ་གཙཚ་། ཏིཤཐའ་དྷ་ནེ་།
 tiṣṭha dhane dhanajaye |	དྷའ་ན་ཛ་ཡེ་། བྲི་བྲི་།
 vṛ vṛ vṛddhikari |	བྲི་དྷའ་ཀ་རི་།
 dhṛ dhṛ dhṛtikari |	དྷྲི་དྷྲི་། དྷྲི་ཏི་ཀ་རི་།
 nānāvividhaveśavastrāyudhadhāriṇi |	ནའ་ནའ་བི་བི་དྷ་། པ་ཤ་བསྟ་།
 yu yu āyuṣpālani |	ཨའ་ཡུ་དྷ་དྷ་ར་ནི་། ཡུ་ཡུ་ཨའ་ཡུཤཔ་ལ་ན་།
 tathāgatānāṃ smara bodhicittaṃ mā vilamba |	ཏ་ཐའ་ག་ཏ་ནའམ། སྨ་ར་བོ་དྷ་ཙིཏཏམ། མ་བི་ལམབ་།
 dehi me varam |	དེ་ཧི་མེ་བ་ར་ན་།
 śaṃkhini svāhā | imairmantrapadaiḥ sa bhagavan kāyagatairyaśovṛddhimanuprāpsyati |	ཤམ་ཁི་ནི་སབ༹འཧའ་། བཅོམ་ལྡན་འདས་། གསང་སྔགས་ཀྱི་གཞི་འདི་དག་ལུས་ལ་གནས་པར་བགྱིས་ན་། དེའི་སྙན་པ་འཕེལ་བར་འགྱུར་ཞིང་།
 tejovṛddhiṃ bhogavṛddhim aiśvaryavṛddhiṃ dīrghāyuṣkatāṃ śatruvaśīkaraṇavṛddhimanuprāpsyati |	གཟི་བརྗིད་འཕེལ་བ་དང་། ལོངས་སྤྱོད་འཕེལ་པ་དང་། དབང་ཕྱུག་འཕེལ་བ་དང་། ཚེ་རིང་བ་དང་། དགྲ་རྣམས་དབང་༄༤༣༧ཨ་༌༎ དུ་བགྱི་བའང་འཕེལ་བར་འགྱུར་ལགས་སོ་༎ ས་ཕྱོགས་གཙང་མའམ་།
 aṣṭaśatajaptena yathālābhena baliṃ dattvā caturdiśe dhūpaṃ kundurukaṃ tathāgatasyodāratarapūjā kartavyā | dīpo (dutt 75) dātavyaḥ |	ལྷའི་གནས་སུ་ཅི་འབྱོར་བའི་གཏོར་མ་ཕྱོགས་བཞིར་སྩལ་ལ་། དེ་བཞིན་གཤེགས་པ་ལ་བདུག་སྤོས་དང་། པོག་དཀར་པོ་དག་གིས་མཆོད་པ་རྒྱ་ཆེར་བགྱི་ཞིང་ཞུགས་མར་དག་ཀྱང་ཕུལ་ལ་།
 ekaviṃśatidivasāni maitravihāriṇā niyamasthena bhavitavyam | tataḥ sarvābhiprāyaṃ paripūrayiṣyāmi saddharmapratikṣepakaṃ sthāpya | śucau pradeśe kartavyaṃ devāyatane vā |	དགུང་ཉི་ཤུ་རྩ་གཅིག་ཏུ་བྱམས་པ་ལ་གནས་པ་དང་། དེས་པར་གནས་ཤིང་བཟླས་བརྗོད་ལན་བརྒྱ་རྩ་བརྒྱད་བགྱིས་ན་།
 atha bhagavān sā ca yathāsamāgatā parṣa sādhukāramadāt |	དམ་པའི་ཆོས་སྤོང་བ་མ་གཏོགས་པ་རྣམས་ཀྱི་བསམ་པ་ཐམས་ཅད་ཡོངས་སུ་རྫོགས་པར་བགྱི་ལགས་སོ༏་༏དེ་ནས་བཅོམ་ལྡན་འདས་དང་། ཇི་ལྟར་ལྷགས་པའི་འཁོར་དེ་དག་གིས་ལྷ་མོ་ཆེན་མོ་དུང་ཅན་མ་ལ་ལགས་སོ་ཞེས་བྱ་བ་བྱིན་ཏེ་། 
 sādhu sādhu bhagini |	སྲིང་མོ་། ལེགས་སོ་༎
 subhāṣitamidam | pratijñā bahuguṇasamanvāgatā |	ལེགས་སོ༏་༏ཡོན་ཏན་མང་པོ་དང་ལྡན་པའི་དམ་བཅའ་བ་འདི་ནི་ལེགས་པར་སྨྲས་སོ་༎
 evameva tvamapi karaṇīyamanāgate 'dhvani | vi	སྲིང་མོ་། ཁྱོད་ཀྱིས་མ་འོངས་པའི་དུས་ན་དེ་བཞིན་དུ་གྱིས་ཤིག་།
 atha khalu bhīmā mahādevī suvarṇapuṣpairbhagavantamabhyarcya bhagavataścaraṇayornipatya bhagavantametadavocat |	དེ་ནས་ལྷ་མོ་ཆེན་མོ་འཇིགས་བྱེད་མས་བཅོམ་ལྡན་འདས་ལ་གསེར་གྱི་མེ་ཏོག་དག་གིས་མཆོད་པ་བྱས་ནས་བཅོམ་ལྡན་འདས་ཀྱི་ཞབས་གཉིས་ལ་གཏུགས་ཏེ་བཅོམ་ལྡན་འདས་ལ་འདི་སྐད་ཅེས་གསོལ་ཏོ་༎ བཅོམ་ལྡན་འདས་།
 ahamapi bhagavaṃsteṣāṃ dharmabhāṇakānāṃ dharmaśrāvaṇikānāṃ teṣāṃ ca lekhakānāṃ teṣāṃ ca dhārakāṇāṃ vācakānāṃ pūjakānāmarthāya sarvāśāparipūrakarāṇi hiraṇyamaṇimuktā bhogaiśvaryarājatvadīrghāyuṣkarāṇi śatruvaśīkaraṇāni mantrapadāni dāsyāmi |	བདག་གིས་ཀྱང་ཆོས་སྨྲ་བ་དེ་དག་དང་། ཆོས་ཉན་པ་དེ་དག་དང་། ཡི་གེར་འབྲི་བ་དེ་དག་དང་། འཛིན་པ་དང་། ཀློག་པ་དང་། མཆོད་པ་བགྱིད་༄༤༣༧བ་པ་དེ་དག་གི་དོན་དུ་རེ་བ་ཐམས་ཅད་ཡོངས་སུ་རྫོགས་པར་བགྱིད་པ་། དབྱིག་དང་། ནོར་བུ་དང་། མུ་ཏིག་དང་། ལོངས་སྤྱོད་དང་། དབང་ཕྱུག་དང་། རྒྱལ་སྲིད་དང་། ཚེ་རིང་བར་བགྱིད་པ༏་དགྲ་ཐམས་ཅད་དབང་དུ་བགྱིད་པའི་གསང་སྔགས་ཀྱི་གཞི་རྣམས་སྩལ་བར་བགྱི་སྟེ་། རྒྱལ་པོའམ་། རྒྱལ་པོའི་བཙུན་མོའམ་། དགེ་སློང་ངམ་།
 yaḥ kaści rājā vā rājñī vā bhikṣubhikṣuṇyupāsakopāsikā vā dhārayiṣyanti satkariṣyanti	དགེ་སློང་མའམ་། དགེ་བསྙོན་ནམ༏་དགེ་བསྙེན་མ་གང་ལ་ལ་ཞིག་འཛིན་ཏམ་། ཀློག་གམ་། བསྙེན་བཀུར་བགྱིད་དམ་། ཡི་གེར་འབྲིའམ་། ཡི་གེར་འབྲིར་སྩོལ་ཏམ་།
 likhiṣyanti likhāpayiṣyanti tathāgatagurugauraveṇa pratiprattyā yathopadiṣṭāḥ pratipatsyante	མཆོག་ཏུ་གུས་པས་ཇི་སྐད་གསུངས་བའི་སྒྲུབ་པ་ལ་སྒྲུབ་པར་བགྱིད་ན་། བཅོམ་ལྡན་འདས་།
 tasyāhaṃ bhagavan rakṣiṣyāmi paripālanaṃ kariṣyāmi yathocitaṃ varaṃ dāsyāmi bhogaiśvaryairavaikalyaṃ	བདག་གིས་དེ་བསྲུང་བར་བྱ་། ཡོངས་སུ་བསྐྱང་བར་བགྱི་ཞིང་དམ་པ་ཅི་འཚལ་བའང་སྩལ་བར་བགྱི་སྟེ་། ལོངས་སྤྱོད་དང་། དབང་ཕྱུག་དག་གིས་མི་བྲེལ་བར་བགྱི་།
 kariṣyāmi vivādayuddhaḍimbaḍamare jayaṃ kariṣyāmi |	འཐབ་མོ་དང་། འགྱེད་པ་དང་། ཁྲག་ཁྲུག་དང་། འཁྲུག་སློང་དག་ལུས་རྒྱལ་བར་བགྱི་།
 āyuḥsaṃpadamupasaṃhariṣyāmi |	ཚེ་ཕུན་སུམ་ཚོགས་པ་ཉེ་བར་བསྒྲུབ་པར་བགྱི་།
 (dutt 76) tasya ca viṣayasya nagarasya paripālanaṃ kariṣyāmi |	དེའི་ཡུལ་དང་གྲོང་ཁྱེར་དག་ཀྱང་ཡོངས་སུ་བསྐྱང་བར་བགྱི་ལགས་ཀྱི་།
 tanme bhagavānanujānātu |	དེའི་སླང་དུ་བཅོམ་ལྡན་འདས་ཀྱིས་བདག་ལ་རྗེས་སུ་གནང་བར་མཛད་དུ་གསོལ་།
 namaḥ sarvatathāgatānāṃ sarvabodhisattvānām āryāvalokiteśvaravajrapāṇiprabhṛtīnām |	ན་མ༔་སརྦ་ཏ་ཐའ་ག་ཏ་ནའམ། ཏདྱ་ཐའ་།
 oṃ mahādevi bhīme bhīmamate |	ཨཨོམ་ཤམ་ཁི་ནི་དེ་བི་། ཨའ་གཙཚ་ཨའ་གཙཚ་། ཏིཤཐའདྷ་ནེ་།
 jaye jayāvahe |	དྷའ་ན་ཛ་ཡེ་། བྲི་བྲི་། བྲི་དྷའ་ཀ་རི་། དྷྲི་དྷྲི་། དྷྲི་ཏ་ཀ་རི་། ནའ་ནའ་བི་བི་དྷ་། བ་ཤ་བསྟ་དྷ་དྷ་རི་ནི་།
 yaśajave tejajave | vyākaraṇaprāpte sarvasattvāvalokane kṛpatejabahule tathāgatānujñātaṃ pālaya |	ཡུ་ཡུ་ཨཨ་ཡུཤཔརའ་ལ་ལེ་། ཏ་ཐའ་ག་ཏ་ནའམ། སྨ་ར་བོ་དྷི་༄༤༣༨ཨ་༌༎
 smara pratijñām |	།
 buddhādhiṣṭhānena dehi me varam | siddhiṃ kuru |	དེ་ཧི་མེ་པ་ར་ན་།
 devi mahādevi satyavacanadevi bhīme satyavacanapratiṣṭhite guhyanivāsini svāhā |	ཤམ་ཁི་ནི་སབ༹འཧའ་།
 imāni tāni bhagavan mantrapadāni tathāgatādhiṣṭhitāni tathāgatānujñātāni mayā bhāṣitāni sattvānāmarthāya |	བཅོམ་ལྡན་འདས་། བདག་གིས་སེམས་ཅན་ཐམས་ཅད་ཀྱི་དོན་དུ་དེ་བཞིན་གཤེགས་པས་བྱིན་གྱིས་བརླབས་ཤིང་དེ་བཞིན་གཤེགས་པས་རྗེས་སུ་གནང་བའི་གསང་སྔགས་ཀྱི་གཞི་འདི་དག་སྨྲས་ལགས་ཏེ་། དེ་བཞིན་གཤེགས་པའི་སྤྱན་སྔར་མེ་ཏོག་དང་། བདུག་སྤོས་དང་། སྤོས་དང་། མར་མེ་དག་གིས་མཆོད་པ་བགྱིས་ལ་།
 yaṃ yameva kāmaṃ manasikṛtvā japiṣyate tathāgatasya purataḥ puṣpadhūpagandhadīpaiḥ pūjāṃ kṛtvā pāyasarasabaliṃ caturdiśe dattvā taṃ tameva aṣṭaśatajāpena sarvāśāṃ paripūrayiṣyāmi |	ཕྱོགས་བཞིར་ཡང་འོ་ཐུག་དང་། རོ་སྣ་ཚོགས་དང་ལྡན་པའི་གཏོར་མ་དག་སྩལ་ཏེ་། ཅི་དང་ཅི་འཚལ་བ་ཡིད་ལ་བགྱིས་ཤིང་བཟླས་བརྗོད་ལན་བརྒྱ་རྩ་བརྒྱད་ཀྱིས་མཆོད་པ་བགྱིས་ན་། རེ་བ་དེ་དང་དེ་དག་ཐམས་ཅད་ཡོངས་སུ་རྫོགས་པར་བགྱིད་ལགས་སོ་༎
 yaḥ kaści māṃ svarūpeṇābhikāṃkṣī bhave tena acchinnadaśe keśāpagate aśleṣairaṅgairnavabhājanasthairaṣṭasyām	གང་ལ་ལ་བདག་རང་གི་གཟུགས་མཐོང་བར་འཚལ་བ་དེས་ཚེས་བརྒྱད་ཀྱི་གདུགས་ལ་རས་དཀར་པོ་གསར་པ་ཁ་ཚར་མ་བཀུམ་པ་སྐྲ་མ་མཆིས་པ་ལ་རི་མོ་མཁན་གཙང་མ་འཕགས་པའི་ཡན་ལག་བརྒྱད་ཡོངས་སུ་བཟུང་བས་ཚོན་རྩི་སྤྱིན་དང་མ་འབགས་པ་སྣོད་གསར་པའི་ནང་དུ་སྩལ་བས་། དབུས་སུ་དེ་བཞིན་གཤེགས་པའི་སྐུ་གཟུགས་ཆོས་སྟོན་པའི་ཚུལ་དུ་བཞུགས་པ་བྲི་བར་བགྱིའོ་༎
 āryāṣṭāṃgaparigṛhītena citrakareṇa citrāpayitavyā śarakāṇḍagaurī sarvālaṃkāravibhūṣitāṃgī śvetavastrā madhye tathāgatapratimā dha[rma deśa]yamānā dakṣiṇenāryāvalokiteśvaraḥ sāṃkathyaṃ kurvan vāmapārśve bhīmā mahādevī (dutt 77)	ག-ཡས་ཕྱོགས་སུ་འཕགས་པ་སྤྱན་རས་གཟིགས་དབང་ཕྱུག་ཆོས་ཀྱི་འབེལ་བའི་གཏམ་སྟོན་པ་བྲི་བར་བགྱིའོ་༎ ག-ཡོན་ཕྱོགས་སུ་ནི་ལྷ་མོ་ཆེན་མོ་འཇིགས་བྱེད་མ་འདམ་བུ་༄༤༣༨བ་མདའ་རྒྱུའི་མདོག་ལྟར་དཀར་ཤམ་དུ་མཆིས་ལ་། རད་པ་དཀར་པོ་འཆལ་བ་། རྒྱན་ཐམས་ཅད་ཀྱིས་བརྒྱན་པ་།
 kuṇḍiganetṛkaparigṛhītā samāśvāsayantī |	རིལ་བ་དང་། བགྲང་ཕྲེང་ཐོགས་ཤིང་ཡང་དག་པར་དབུགས་འབྱིན་པའི་ཚུལ་དུ་མཆིས་པ་བྲི་བར་བགྱིའོ་༎
 tato 'ṣṭamyāṃ pūrvasecaṃ kṛtvā puṣpadhūpagandhamālyavilepanaiḥ sadhātuke caityasthāne balipāyasadadhyodanaṃ caturdiśe yāvat pūrṇapañcadarśīṃ śūcinā vidyādhareṇa udāratarāṃ	དེ་ནས་རིག་སྔགས་འཆང་གཅང་མས་སྔར་བསྙེན་པ་བགྱི་ལ་ཚེས་བརྒྱད་ནས་ཚེས་བཅོ་ལྔའི་བར་དུ་མཆོད་རྟེན་སྐུ་གདུད་དང་བཅས་པའི་གནས་སུ་མེ་ཏོག་དང་། བདུག་སྤོས་དང་། སྤོས་དང་། མེ་ཏོག་ཕྲེང་དག་གིས་མཆོད་པ་བགྱི་ཞིང་། ཕྱོགས་བཞིར་ཡང་འོ་ཐུག་དང་། ཞོ་དང་། འབྲས་ཆན་གྱི་གཏོར་མ་དག་གཏོར་ལ་།
 puṣpadhūpagandhadīpaiḥ pūjāṃ kṛtva baliṃ dattvā nānārasairanyāni ca yathālābhena śuklabaliṃ dattvā sarvasattvānāṃ maitracittena dayācittena bhūtvā jātīpuṣpā[ṇāma]ṣṭabhiḥ śataiḥ sā pratimā āhartavyā |	མེ་ཏོག་དང་། བདུག་སྤོས་དང་། མར་མེ་སྣ་ཚོགས་དག་གིས་མཆོང་པ་རྒྱ་ཆེར་བགྱི་ཞིང་ལྷ་བཤོས་དཀར་པོ་དག་ཀྱང་ཕུལ་ལ་། གཏོར་མ་རོ་སྣ་ཚོགས་དང་ལྡན་པ་དང་། གཞན་ཡང་ཅི་འབྱོར་པ་དག་སྩལ་ནས་སེམས་ཅན་ཐམས་ཅད་ལ་བྱམས་པའི་སེམས་དང་། སྙིང་རྗེའི་སེམས་ཀྱིས་སྣ་མའི་མེ་ཏོག་བརྒྱ་རྩ་བརྒྱད་ལ་བཟླས་བརྗོད་ལན་བརྒྱ་རྩ་བརྒྱད་བགྱི་ཞིང་། རེ་རེ་ནས་ལྷ་མོ་ཆེན་མོ་འཇིགས་བྱེད་མའི་གཟུངས་དེ་ལ་འཕང་བར་བགྱིའོ་༎
 ekaikaṃ japya tatrāhaṃ svarūpeṇopatiṣṭhiṣyāmi yathepsitaṃ varaṃ dāsyāmi rājyaiśvaryam	དེ་ནས་བདག་དེར་རང་གི་གཟུགས་ཀྱིས་གནས་པར་བགྱི་། དམ་པ་ཅི་འཚལ་བའང་སྩལ་བར་བགྱི་སྟེ་།
 ākāśagamanaṃ nidhivādaṃ dhātuvādaṃ vidyādharatvam anyāni ca yathepsitāni karmāṇi	རྒྱལ་སྲིད་ཀྱི་དབང་ཕྱུག་དང་། ནམ་མཁའ་ལ་མཆི་བ་དང་། གཏེར་ལྟ་འཚལ་བ་དང་། ནོར་སྒྱུར་འཚལ་བ་དང་། རིག་སྔགས་འཆང་ཉིད་དང་། དུས་མ་ལགས་པར་༄༤༣༩ཨ་༌༎
 kariṣyāmi akālamṛtyupratiṣedhanaṃ sarvarogapraśamanaṃ paracakrapramardanaṃ putralambham arthāgamanaṃ prītiṃ sarvasattveṣu |	འགུམ་པ་བཟློག་པ་དང་། བྲོ་ནད་ཐམས་ཅད་རབ་ཏུ་ཞི་བར་བགྱི་བ་དང་། ཕ་རོལ་གྱི་དམག་ཚོགས་རབ་ཏུ་གཞོམ་པ་དང་། སེམས་ཅན་ཐམས་ཅད་ལ་བྱམས་པ་སྐྱེ་བ་དང་། གཞན་ཡང་ཅི་འཚལ་པའི་ལས་དག་ཀྱང་བགྱི་ལགས་སོ་༎ བཅོམ་ལྡན་འདས་།
 yadi cāhaṃ bhagavan pañcānantaryaṃ kariṣyāmi na sarvāśāṃ paripūrayeyaṃ mā cāhaṃ bhagavannanuttarāṃ samyaksaṃbodhimabhisaṃbudhyeyaṃ saddharmapratikṣepakaṃ sthāpya yaśca vicikitsāprāpto buddhadharmasaṃghe |	གལ་ཏེ་དམ་པའི་ཆོས་སྤོང་བ་དང་། སངས་རྒྱས་དང་། ཆོས་དང་། དགེ་འདུན་དག་ལ་ཐེ་ཚོམ་དུ་གྱུར་པ་གང་ལགས་པ་མ་གཏོགས་པར་མཚམས་མ་མཆིས་པ་ལྔ་བགྱིད་པ་ཞིག་ལགས་ནའང་བདག་གི་རེ་བ་ཐམས་ཅད་ཡོངས་སུ་རྫོགས་པར་མ་བགྱིས་པར་གྱུར་ན་། བཅོམ་ལྡན་འདས་། བདག་བླ་ན་མེད་པ་ཡང་དག་པར་རྫོགས་པའི་བྱང་ཆུབ་མངོན་པར་རྫོགས་པར་འཚང་རྒྱ་བར་མ་གྱུར་ཅིག་། 
 bhagavānāha |	བཅོམ་ལྡན་འདས་ཀྱིས་བཀའ་སྩལ་པ༏་སྲིང་མོ་། ལེགས་སོ་༎
 sādhu sādhu bhagini sādhu khalu punastvaṃ bhagini yattvaṃ sarvasattvānāṃ hitāya sukhāya pratipannā asyaiva ca dharmaparyāyasya cirasthityarthaṃ (dutt 78) pratipannā |	ལེགས་སོ་༎ སྲིང་མོ་ཁྱོད་སེམས་ཅན་ཐམས་ཅད་ཀྱི་དོན་དང་། ཕན་པ་དང་། བདེ་བའི་ཕྱིར་ཞུགས་ཤིང་། ཆོས་ཀྱི་རྣམ་གྲངས་འདིའང་ཡུན་རིང་དུ་གནས་པར་བྱ་བའི་ཕྱིར་ཞུགས་པ་ནི་། ཡང་ཁྱོད་ལེགས་སོ་༎ སྲིང་མོ་།
 tena hi bhagini nityameva imāḥ pratijñāstvayā nityameva samanvāhartavyāḥ |	དེའི་ཕྱིར་ཁྱོད་ཀྱིས་རྟག་ཏུ་དམ་བཅས་པ་འདི་དྲན་པར་གྱིས་ཤིག་།
 atheyaṃ mahāpṛthivī tasmin samaye pracacāla divyañca kusumavarṣamabhiprāvarṣat | sā ca sarvāvatī parṣat sādhukāramadāt |	དེ་ནས་དེའི་ཚེ་ས་ཆེན་པོ་འདི་རབ་ཏུ་ག-ཡོས་ཤིང་ལྷའི་མེ་ཏོག་གི་ཆར་དག་ཀྱང་མངོན་པར་རབ་ཏུ་བབ་པ་དང་། ཐམས་ཅད་དང་ལྡན་པའི་འཁོར་དེ་དག་གིས་ཀྱང་ལེགས་སོ་༎ ཞེས་བྱ་བ་བྱིན་ཏེ་།
 sādhu sādhu subhāṣitamidam |	སྲིང་མོ་། ལེགས་༄༤༣༩བ་སོ༏་༏ལེགས་སོ་༎
 pratijñā sarvasattvānāṃ sarvāśāparipūrikā bhaviṣyati | vii	ཁྱོད་ཀྱིས་སེམས་ཅན་ཐམས་ཅད་ཀྱི་རེ་བ་ཐམས་ཅད་ཡོངས་སུ་རྫོགས་པར་འགྱུར་བའི་དམ་བཅའ་བ་འདི་ནི་ལེགས་པར་སྨྲས་སོ་༎
 athāryāvalokiteśvaro bodhisattvo mahāsattvaḥ punarbhagavantametadavocat kiṃ punarbhagavan	དེ་ནས་བཅོམ་ལྡན་འདས་ལ་བྱང་ཆུབ་སེམས་དཔའ་སེམས་དཔའ་ཆེན་པོ་འཕགས་པ་སྤྱན་རས་གཟིགས་དབང་ཕྱུག་གིས་འདི་སྐད་ཅེས་གསོལ་ཏོ་༎ བཅོམ་ལྡན་འདས་། ཅི་རིགས་ཀྱི་བུའམ་།
 sa kulaputro vā kuladuhitā vā likhanavācanalikhāpanasaṃprakāśanapaṭhanasvādhyayanapūjanasaṃprakāśanayā puṇyamanuprāpsyati imasya dharmaparyāyasya |	རིགས་ཀྱི་བུ་མོ་ད་ཆོས་ཀྱི་རྣམ་གྲངས་འདི་ཡི་གེར་འབྲི་བ་དང་། ཡི་གེར་འབྲིར་སྩོལ་བ་དང་། ཀློག་པ་དང་། མཆོད་པ་དང་། ཡང་དག་པར་སྟོན་པ་དང་། འདོན་པ་དང་། མཆིད་ཏོན་དུ་བགྱིད་པ་དེས་བསོད་ནམས་འཐོབ་པར་འགྱུར་ལགས་སམ་།
 bhagavānāha |	བཅོམ་ལྡན་འདས་ཀྱིས་བཀའ་སྩལ་པ་།
 tena hi tvāmevāryāvalokiteśvara pariprakṣyāmi yathe te kṣamaṃ tathā vyākuru |	འཕགས་པ་སྤྱན་རས་གཟིགས་དབང་ཕྱུག་། དེའི་ཕྱིར་དེ་ཁྱོད་ཉིད་ལ་དྲི་ཡི་། ཁྱོད་ཀྱིས་ཇི་ལྟར་བཟོད་པ་དེ་བཞིན་དུ་ལན་ཐོབ་ཅིག་།
 avalokiteśvara āha |	སྤྱན་རས་གཟིགས་དབང་ཕྱུག་གིས་གསོལ་པ་། བཅོམ་ལྡན་འདས་།
 bhagavāneva vyākurutāṃ nāsti tathāgatasya adṛṣṭaṃ vā aśrutaṃ vā avijñātaṃ vā |	དེ་བཞིན་གཤེགས་པ་ལ་ནི་མ་གཟིགས་པའམ་། མ་གསན་པའམ་། མ་དགོངས་པ་དང་། རྣམ་པར་མི་མཁྱེན་པ་མི་མངའ་བས་བཅོམ་ལྡན་འདས་ཉིད་ཀྱིས་བཀའ་སྩལ་དུ་གསོལ་།
 bhagavānāha |	བཅོམ་ལྡན་འདས་ཀྱིས་བཀའ་སྩལ་པ་། རིགས་ཀྱི་བུ་།
 yaśca kulaputra asya dharmaparyāyasya likhanalikhāpanavācanapūjanasaṃprakāśanapaṭhanasvādhyayanāt puṇyamanuprāpsyati sa upamenāpi na śakyaṃ varṇayitum |	ཆོས་ཀྱི་རྣམ་གྲངས་འདི་ཡི་གེར་འབྲི་བ་དང་། ཡི་གེར་འབྲིར་འཇུག་པ་དང་། ཀློག་པ་དང་། མཆོད་པ་དང་། ཡང་དག་པར་སྟོན་པ་དང་། འདོན་པ་ནདང་། ཁ་ཏོན་དུ་བྱེད་པ་ལས་བསོད་༄༤༤༠ཨ་༌༎ ནམས་འཐོབ་པར་འགྱུར་བ་གང་ཡིན་པ་དེ་ནི་དཔེས་བརྗོད་པར་ཡང་མི་ནུས་སོ་༎
 tat kasya hetoḥ |	དེ་ཅིའི་ཕྱིར་ཞེ་ན་། གོས་དང་། རྒྱན་དང་། དབྱིག་དང་། གསེར་དང་། ནོར་བུ་དང་། མུ་ཏིག་དག་གིས་སེམས་ཅན་ཐམས་ཅད་ཀྱི་བསམ་པ་ཇི་ལྟ་བ་བཞིན་དུ་ཡོངས་སུ་རྫོགས་པར་བྱས་ཏེ་རྩེར་བཅུག་ཀྱང་སེམས་ཅན་དེ་དག་སྐྱེ་བ་དང་། 
 sarvasattvānāṃ yathābhiprāyaparipūrakam | dānaṃ dattvā te sattvā aparimuktā eva bhavanti jarāvyādhimaraṇaśokaparidevaduḥkhadauramanasyopāyāsebhyaḥ |	རྒ་བ་དང་། ན་བ་དང་། འཆི་བ་དང་། མྱ་ངན་དང་། སྨྲེ་སྔགས་འདོན་པ་དང་། སྡུག་བསྔལ་བ་དང་། ཡིད་མི་བདེ་བ་དང་། འཁྲུག་པ་དག་ལས་ཡོངས་སུ་ཐར་པར་མི་འགྱུར་བ་ཉིད་ཡིན་ཞིང་།
 varṣatasahasraṃ pañcabhiḥ kāmaguṇaiḥ kriḍāpayitvā aparimuktā eva te sattvā bhavanti narakatiryagyoniyamalokapretaviṣayeṣu punarapi duḥkhānyanubhavanti	ལོ་འབུམ་དུ་འདོད་པའི་ཡོན་ཏན་ལྔ་པོ་དག་གིས་རྩེར་བཅུག་ཀྱང་སེམས་ཅན་དེ་དག་སེམས་ཅན་དམྱལ་བ་དང་། དུད་འགྲོའི་སྐྱེ་གནས་དང་། གཤིན་རྗེའི་འཇིག་རྟེན་དང་། ཡི་དབ༹གས་ཀྱི་ཡུལ་དག་ལས་ཡོངས་སུ་ཐར་པར་མི་འགྱུར་བ་ཉིད་དེ་།
 asya dharmaparyāyasya śravaṇaṃ sattvebhyaḥ kṛtvā pūjanaṃ saṃprakāśanaṃ[ca]kṛtvā arthaṃ cāsyāvaśrutya (dutt 79)	སེམས་ཅན་རྣམས་ཀྱི་ཕྱིར་ཆོས་ཀྱི་རྣམ་གྲངས་འདི་ཉན་ཅིང་མཆོད་པ་བྱེད་པ་དང་། ཡང་དག་པར་བསྟན་ཏེ་།
 pratipattyā pratipadya parimuktā eva bhavanti jātijarāvyādhimaraṇaśokaparidevaduḥkhadaurmanasyopāyāsebhya sarvanarakatiryagyoniyamalokebhyaḥ tasmāt tathāgata ayaṃ puṇyaskandha upamenāpi pramāṇaṃ na kurvanti |	དེའི་དོན་ཀྱང་མཉན་ཅིང་ནན་ཏན་གྱིས་སྒྲུབ་པར་བྱེད་པ་ནི་སྐྱེ་བ་དང་། རྒ་བ་དང་། ན་བ་དང་། འཆི་བ་དང་། མྱ་ངན་དང་། སྨྲེ་སྔགས་འདོན་པ་དང་། སྡུག་བསྔལ་བ་དང་། ཡིད་མི་བདེ་བ་དང་། འཁྲུག་པ་དག་དང་། སེམས་ཅན་དམྱལ་བ་དང་། དུད་འགྲོའི་སྐྱེ་གནས་དང་། གཤིན་རྗེའི་འཇིག་རྟེན་ཐམས་༄༤༤༠བ་ཅད་ལས་ཡོངས་སུ་ཐར་བར་ཁོ་ནར་འགྱུར་བས་དེའི་ཕྱིར་དེ་བཞིན་གཤེགས་པས་འདིའི་བསོད་ནམས་ཀྱི་ཆེད་ཀྱི་དཔེ་མི་མཛད་དོ་༎ རིགས་ཀྱི་བུ་།
 yaśca kulaputra asya ca dharmaparyāyasyoddiśya sarṣapaphalamātrakaṃ ca hiraṇyasya	གང་གིས་ཆོས་ཀྱི་རྣམ་གྲངས་འདི་དང་། ཆོས་སྨྲ་བ་དང་། འཛིན་པ་དང་། ཀློག་པ་དང་། ཡི་གེར་འབྲི་བ་དང་། མཆོད་པ་བྱེད་པ་དང་། གང་གི་ཕྱིར་དབྱིག་ཡུངས་འབྲུ་ཙམ་ཡོངས་སུ་གཏོང་བར་བྱེད་དམ་།
 ekapuṣpaṃ vā ekaphalaṃ vā ekapatākāṃ vā vādyaṃ vā gandhaṃ vā vastraṃ vā āsanaṃ vā	མེ་ཏོག་གཅིག་གམ་། འབྲས་བུ་གཅིག་གམ་། བ་དན་ནམ་། རོལ་མོའི་སྒྲ་འམ་། སྤོས་སམ་། གོས་སམ་། རྒྱན་གཅིག་ཙམ་ཞིག་ཡོངས་སུ་གཏོང་བར་བྱེད་དམ་།
 ābharaṇaṃ vā parityaje likhe likhāpaye dhāraye vācaye pūjaye satkare parebhyaśca	ཡི་གེར་འབྲི་བའམ༏་ཡི་གེར་འབྲིར་འཇུག་གམ་།
 viastareṇa saṃprakāśaye taṃ ca dharmabhāṇakaṃ vācaye pūjaye yaśca tiṣṭhate tathāgate	འཆང་ངམ་། ཀློག་གམ་།
 saṃmukhapūjayā saparṣa pūjaye mānaye sarvasukhopadhānena varṣaśatasahasramupatiṣṭhe	མཆོད་པ་བྱེད་དམ་། ཡང་དག་པར་སྟོན་ཏམ་། བསྙེན་བཀུར་བྱེད་དམ་། གཞན་དག་ལའང་རྒྱ་ཆེར་ཡང་དག་པར་རབ་ཏུ་སྟོན་པར་བྱེད་པ་གང་ཡིན་པ་དང་། གང་གིས་དེ་བཞིན་གཤེགས་པ་འཁོར་དང་བཅས་པ་མངོན་སུམ་དུ་བཞུགས་པ་ལ་ལོ་འབུམ་དུ་མེ་ཏོག་དང་། 
 gandhamālyavilepanairdhvajapatākābhirvihāracaṃkramodyānaṃ kārāpaye ardhayojanocchritaṃ	བདུག་སྤོས་དང་། སྤོས་དང༏་མེ་ཏོག་ཕྲེང་དང་། བྱུག་པ་དང་། གདུགས་དང་། རྒྱལ་མཚན་དང་། བ་དན་དག་གིས་མཆོད་པས་མཆོད་པར་བྱེད་། རྗེ་པར་བྱེད་ཅིང་། བདེ་བའི་ཡོ་བྱད་ཐམས་ཅད་ཀྱིས་བསྙེན་བཀུར་བྱེད་པ་དང་། གཙུག་ལག་ཁང་དང་། འཆགས་དང་། སྐྱེད་མོས་ཚལ་དག་བྱེད་དུ་བཅུག་གམ་།
 saptaratnamayaṃ stūpaṃ kāraye śataṃ vā sahasraṃ vā tathāgata[muddiśya]tāṃśca divyapūjayā	དེ་བཞིན་གཤེགས་པའི་ཕྱིར་རིན་པོ་ཆེ་སྣ་བདུན་གྱི་མཆོད་རྟེན་༄༤༤༡ཨ་༌༎ འཕང་དུ་དཔག་ཚད་ཕྱེད་པ་བརྒྱའམ་སྟོང་བྱེད་དུ་བཅུག་སྟེ་། དེ་དག་ལ་ལོ་འབུམ་དུ་མཆོད་པ་དག་གིས་མཆོད་པར་བྱེད་པ་བས་། གང་ཆོས་ཀྱི་རྣམ་གྲངས་འདི་ཡི་གེར་འབྲི་བ་དང་། ཡི་གེར་འབྲིར་འཇུག་པ་དང་། འཆང་བ་དང་། ཀློག་པ་དང་། འདོན་པ་དང་། མཆོད་པ་བྱེད་པ་དང་། ཡང་དག་པར་སྟོན་པ་དེ་ནི་།
 pūjaye varṣaśatasahasram ayaṃ ca tato bahutarapuṇyasaṃskāraṃ syā | asya dharmaparyāyasya likhanalikhāpanadhāraṇapaṭhanapūjanasaṃprakāśanayā na imāṃ	དེ་པས་ཆོས་བསོད་ནམས་མངོན་པར་འདུ་བྱ་བ་ཆེས་མང་དུ་སྐྱེ་བར་འགྱུར་གྱི་། དེ་བཞིན་གཤེགས་པ་ལ་མངོན་སུམ་དུ་མཆོད་པ་བྱེད་པ་དེ་ནི་དེ་ལྟ་མ་ཡིན་ལ་།
 tathāgatasaṃmukhapūjāṃ na tveva sattvebhyo dānaṃ dattvā pañcabhiḥ kāmaguṇaḥ krīḍāpayitvā |	སེམས་ཅན་ཐམས་ཅད་ལ་སྦྱིན་པ་བྱིན་ཞིང་འདོད་པའི་ཡོན་ཏན་ལྔ་པོ་དག་གིས་རྩེར་བཅུག་པའང་དེ་ལྟ་མ་ཡིན་ནོ་༎
 tasmāttarhi taiśca kulaputraiḥ kuladuhitṛbhirvā rājarājaputramahāmātrāmātyairvā satatasmitamayaṃ dharmaparyāyaḥ pūjayitavyaḥ |	དེ་ལྟ་བས་ན་། རིགས་ཀྱི་བུ་དང་། རིགས་ཀྱི་བུ་མོ་དང་། རྒྱལ་པོ་དང་། རྒྱལ་བུ་དང་། བློན་པོ་ཆེན་པོ་དང་། བློན་པོ་དེ་དག་གིས་རྟག་པར་རྒྱུན་དུ་ཆོས་ཀྱི་རྣམ་གྲངས་འདི་མཆོད་པར་བྱའོ་༎
 tathāgatasaṃjñā evotpādayitavyā | teṣāṃ kalyāṇamitrāṇāṃ ya imaṃ dharmaparyāyaṃ śrāvayati kathayati arthaṃ cāsyopasaṃharati	གང་ཆོས་ཀྱི་རྣམ་གྲངས་འདི་སྒྲོག་པར་བྱེད་པ་དང་། རྗོད་པར་བྱེད་པ་དང་། དོན་ཀྱང་ཉེ་བར་སྒྲུབ་པར་བྱེད་པའི་དགེ་བའི་བཤེས་གཉེན་དེ་དག་ལའང་དེ་བཞིན་གཤེགས་པ་ཉིད་དུ་འདུ་ཤེས་བསྐྱེད་པར་བྱ་ཞིང་།
 taḥ satkṛtya ayaṃ dharmaparyāyaḥ śrotavya udagrahītavyo dhārayitavyo vācayitavyo manasi kartavyaḥ |	དེ་དག་གིས་བསྙེན་བཀུར་བྱས་ཏེ་ཆོས་ཀྱི་རྣམ་གྲངས་འདི་མཉན་པར་བྱ་། གཟུང་བར་བྱ་། བཅང་བར་བྱ་།
 evaṃ cittamutpādayitavyam | (dutt 80) lābhā asmābhiḥ sulabdhāḥ | yo 'smābhiḥ śrutam apathagāmināṃ pathamupadarśayati anarthe arthasaṃjñinām anitye	བཀླག་པར་བྱ་། ཡིད་ལ་བྱ་ཞིང་འདི་ལྟར་སེམས་བསྐྱེད་པར་བྱ་སྟེ་།
 nityasaṃjñinām asukhe sukhasaṃjñināṃ yadasmābhirnarakatiryogyoniyamalokaparimokṣaṇārthaṃ tathāgatakṛtyaṃ kṛtam |	བདག་ཅག་དོན་མེད་པ་ལ་དོན་༄༤༤༡བ་འདུ་ཤེས་པ་དང་། མི་རྟག་པ་ལ་རྟག་པར་འདུ་ཤེས་པ་དང་། སྡུག་བསྔལ་བ་ལ་བདེ་བར་འདུ་ཤེས་ཤིང་། ལམ་མ་ཡིན་པར་ཞུགས་པ་ལ་ལམ་ཉེ་བར་སྟོན་པ་གང་ཡིན་པ་དང་། བདག་ཅག་སེམས་ཅན་དམྱལ་བ་དང་། དུད་འགྲོའི་སྐྱེ་གནས་དང་། གཤིན་རྗེའི་འཇིག་རྟེན་ལས་ཡོངས་སུ་ཐར་པར་བྱ་བའི་ཕྱིར་དེ་བཞིན་གཤེགས་པའི་མཛད་པ་གང་ཡིན་པ་དེ་ནི་བདག་ཅག་གིས་རྙེད་པ་ལེགས་པར་རྙེད་དོ་སྙམ་དུ་སེམས་བསྐྱེད་པར་ཡང་བྱའོ་༎
 avalokiteśvara āha |	སྤྱན་རས་གཟིགས་དབང་ཕྱུག་གིས་གསོལ་པ་།
 mahākṛtyena tathāgatakṛtyena imaṃ dharmaparyāyaṃ sarvasattvānāṃ prakāśitam |	བཅོམ་ལྡན་འདས་། ཆོས་ཀྱི་རྣམ་གྲངས་འདི་ནི་སེམས་ཅན་ཐམས་ཅད་ལ་དེ་བཞིན་གཤེགས་པའི་མཛད་པ་མཛད་པ་ཆེན་པོས་ཡང་དག་པར་བཤད་ལགས་སོ་༎
 bhagavānāha |	བཅོམ་ལྡན་འདས་ཀྱིས་བཀའ་སྩལ་པ་།
 ayaṃ ca kulaputra dharmaparyāyaḥ paścime kāle paścime samaye dakṣiṇāpathe pracariṣyati	རིགས་ཀྱི་བུ་། ཆོས་ཀྱི་རྣམ་གྲངས་འདི་ནི་ཕྱི་མའི་དུས་ཕྱི་མའི་ཚེན་ལྷོ་ཕྱོགས་ཀྱི་རྒྱུད་ན་སྤྱོད་པར་འགྱུར་ཏེ་། 
 tatrāpi bhikṣubhikṣuṇyupāsakopāsikārājarājaputramahāmātrāmātyā bhājanībhūtāḥ pūjakā	དེར་ཡང་དགེ་སློང་དང་། དགེ་སློང་མ་དང་། དགེ་བསྙེན་དང་། དགེ་བསྙེན་མ་དང་། རྒྱལ་པོ་དང་། རྒྱལ་བུ་དང་། བློན་པོ་ཆེན་པོ་དང་། བློན་པོ་སྣོད་དུ་གྱུར་པ་། མཆོད་པ་བྱེད་པ་།
 dhārakā vācakā bhaviṣyanti śraddhāsyanti pattīṣyanti |	འཛིན་པར་བྱེད་པ་། ཀློག་པར་བྱེད་པ་དག་འབྱུང་བར་འགྱུར་ཞིང་། དང་པར་འགྱུར་། ཡིད་ཆེས་པར་འགྱུར་རོ་༎
 sa ce uttarapūrvapaścimāyāṃ pracare tat parakarmābhiyuktāste sattvā bhaviṣyanti na	གལ་ཏེ་བྱང་དང་། ཤར་དང་། ནུབ་ཕྱོགས་ཀྱི་རྒྱུད་དག་ན་སྤྱོད་པར་འགྱུར་ནའང་དེ་ན་གང་དག་ཉན་པར་མི་བྱེད་པ་དང་། དད་པར་མི་བྱེད་པ་དང་། ཡིད་༄༤༤༢ཨ་༌༎
 śroṣyanti śraddhāsyanti na pattīṣyanti na pūjayiṣyanti hīnavīryanaṣṭasmṛtayo nānāvyākṣepakuṭambadāsadāsībhogaiśvaryahāsyalāsyanāṭyanṛtyagīterṣyāmātsaryasmṛtayo	ཆེས་པར་མི་བྱེད་པ་དང་། མཆོད་པར་མི་བྱེད་པ་དང་། བརྩོན་འགྲུས་ཞན་པ་དང་། བརྗེད་ངེས་པ་དང་། བུ་སྨད་དང་། བྲན་མོ་དང་། ལོངས་སྤྱོད་དང་། དབང་ཕྱུག་དང་། བཞད་གད་དང་། འཇོ་སྒེག་དང་། བྲོ་དང་། གར་དང་། གླུ་སྣ་ཚོགས་ཀྱིས་རྣམ་པར་ག-ཡེངས་ཤིང་། ཕྲག་དོག་དང་། སེར་སྣའི་དྲན་པས་ཉན་པར་མི་བྱེད་པའི་སེམས་ཅན་དེ་དག་ནི་བདུད་ཀྱི་ལས་ལ་མངོན་པར་བརྩོན་པ་ཡིན་ཏེ་།
 na śroṣyanti na pattīṣyanti napūjayiṣyanti te aparimuktā eva jarāvyādhimaraṇaśokaparidevaduḥkhadaurmanasyopāyāsebhya pretayamalokaviṣayebhyo bhaviṣyanti |	དེ་དག་ནི་སྐྱེ་བ་དང་། རྒ་བ་དང་། ན་བ་དང་། འཆི་བ་དང་། མྱ་ངན་དང་། སྨྲེ་སྔགས་འདོན་པ་དང་། སྡུག་བསྔལ་བ་དང་། ཡིད་མི་བདེ་བ་དང་། འཁྲུག་པ་དག་དང་། སེམས་ཅན་དམྱལ་བ་དང་། དུད་འགྲོའི་སྐྱེ་གནས་དང་། གཤིན་རྗེའི་འཇིག་རྟེན་དང་། ཡི་དབ༹གས་ཀྱི་ཡུལ་རྣམས་ལས་ཡོངས་སུ་མི་ཐར་པ་ཁོ་ནར་འགྱུར་རོ་༎ དེ་ལྟ་བས་ན་།
 tasmāttarhi taiḥ kulaputraiḥ kuladuhitṛbhirvā sarvāpāyairātmānaṃ parimoktukāmena satkṛtya ayaṃ dharmaparyāyaḥ pūjayitavyo dhārayitavyaḥ satkartavyaḥ parebhyaḥ saṃprakāśatitavyo	རིགས་ཀྱི་བུ་དང་། རིགས་ཀྱི་བུ་མོ་བདག་ཉིད་ངན་སོང་ཐམས་ཅད་ལས་ཡོངས་སུ་ཐར་པར་འདོད་པ་དེ་དག་གིས་བསྙེན་བཀུར་བྱས་ཏེ་ཆོས་ཀྱི་རྣམ་གྲངས་འདི་མཆོད་པར་བྱ་ཞིང་། གཞན་དག་ལ་ཡང་དག་པར་བསྟན་པར་བྱ་།
 manasā dhārayitavyaḥ |	ཡིད་ལའང་གཟུང་བར་བྱའོ་༎
 ḍimbaḍumaraduḥsvapnadurnimitteṣu akālamṛtyugomarapaśumaramānuṣamarebhyo nānāvyādhibhayopadravebhya imaṃ dharmaparyāyaṃ pūjayitvā vācayitavyaḥ dhvaje vā ucchrapitaṃ kṛtvā pūjayitvā	ཁྲག་ཁྲུག་དང་། འཁྲུག་ཀློག་དང་། རྨི་ལམ་ངན་པ་དང་། ལྟས་ངན་པ་དག་དང་། དུས་མ་ཡིན་པར་འཆི་བ་དང་། གནག་ནད་དང་། ཕྱུགས་ན་དང་། མི་ནད་དག་དང་། ནད་དང་། འཇིགས་པ་དང་། ༄༤༤༢བ་གནོད་པ་སྣ་ཚོགས་དག་ལའང་ཆོས་ཀྱི་རྣམ་གྲངས་འདི་མཆོད་པ་བྱས་ཏེ་བཀླག་པར་བྱའོ་༎
 nānāgandhapuṣpadhūpavādyaiḥ praceṣṭavyaḥ | caturdiśe baliṃ īttvābhinamaskṛtya puṣpadhūpagandhaiḥ sarva ityupadravāḥ praśamaṃ yāsyanti |	རྒྱལ་མཚན་བཙུགས་པ་མེ་ཏོག་དང་། བདུག་སྤོས་དང་། སྤོས་དང་། རོལ་མོའི་སྒྲ་སྣ་ཚོགས་དག་གིས་མཆོད་ཅིང་ཕྱོགས་བཞིར་གཏོར་མ་གཏོར་ལ་མེ་ཏོག་དང་། བདུག་སྤོས་དང་། སྤོས་དག་གིས་ཕྱག་བྱས་ཏེ་འཇུག་པར་བྱས་ན་། དེར་ཡམས་ཀྱི་ནད་དང་། གནོད་པ་དང་། འགོ་བའི་ནད་ཐམས་ཅད་ཀྱང་རབ་ཏུ་ཞི་བར་འགྱུར་རོ་༎
 (dutt 81) atha bhagavān tasyāṃ velāyāmimā gāthā abhāṣata |	དེ་ནས་དེའི་ཚེ་བཅོམ་ལྡན་འདས་ཀྱིས་ཚིགས་སུ་བཅད་པ་འདི་དག་བཀའ་སྩལ་ལ་ཏོ་༎
 [sarvasya sattvasya anugrahārthaṃ] yā bhāṣitā pūrvabhaveṣu nāyakaiḥ |	སྔོན་གྱི་སྲིད་པར་འདྲེན་པས་གང་གསུངས་ཤིང་༎ སེམས་ཅན་ཐམས་ཅད་རྗེས་སུ་གཟུང་བའི་ཕྱིར་༎
 [ahaṃ tathā tvāmapi deśayiṣye] gṛṇhāhi ānanda imaṃ samādhim || stav_1 ||	ད་ལྟར་ངས་ཀྱང་ཁྱོད་ལ་བཤད་པ་ཡི་༎ ཏིང་འཛིན་འདི་ནི་གཟུང་ཞིག་ཀུན་དགའ་པོ་༎ སངས་རྒྱས་ཆོས་དང་དགེ་འདུན་དཀོན་མཆོག་ལ་༎
 yaścaiva traidhātukadānu dadyā saptāna ratnāna ca pūrayitvā |	གང་གིས་ཁམས་གསུམ་སྦྱིན་པར་བྱིན་པ་བས་༎ མདོ་སྡེ་འདི་ལ་མཆོད་པ་བྱས་ན་ནི་༎ སྦྱིན་པས་དེ་ཡིད་དཔེར་ཡང་མི་ཕོད་དོ་༎
 (dutt 82) buddheṣu dharmeṣu sadāpramattaḥ upamāpi tasya na sa bhonti dānam || stav_2 || yaścaiva buddheṣvabhiśraddadhitvā vihārakārāpayi caityakāni |	གང་གིས་སངས་རྒྱས་ལ་ནི་དད་བྱས་ཏེ་༎ ཚད་མེད་གཙུག་ལག་ཁང་དག་བརྩིགས་པ་བས་༎
 yaścaiva sūtraṃ[ca] dhareti kaści ayaṃ tato bahutaru puṇyu bheṣyate || stav_3 ||	གང་ཞིག་མདོ་འདི་འཛིན་པ་གང་ཡིན་པ་༎ དེ་ནི་དེ་བས་བསོད་ནམས་མང་པོར་འགྱུར་༎ གང་ཞིག་མེ་ཏོག་གཅིག་ཙམ་འཐོར་བྱེད་ཅིང་༎
 yaścāpi ekaṃ kṣipayeta puṣpaṃ vastraṃ ca mālyaṃ ca vilepanaṃ tathā |	གོས་དང་ཕྲེང་བ་བྱུག་པ་དེ་བཞིན་ཏེ་༎
 imaṃ samādhiṃ ca[ya] satkareta nāyaṃ tato bahutaru puṇyu bhoti || stav_4 || (dutt 83)	ཏིང་འཛིན་འདི་ལ་བསྙེན་བཀུར་བྱེད་གྱུར་ན་༎ བསོད་ནམས་ཚོགས་ཆར་སྔ་མ་དེ་མི་འགྱུར་༎
 yaścāpi kārṣāpaṇu dānu dadyā imasya sūtrasya ca pūjanārtham |	གང་གིས་མདོ་སྡེ་འདི་ལ་༄༤༤༣ཨ་༌༎ མཆོད་པའི་ཕྱིར་༎ ཀརཤ་པ་ནིའི་སྦྱིན་པ་སྦྱིན་བྱེད་ཅིང་༎
 janitvā bodhāya ca maitracitte ayaṃ tato bahutaru puṇyu prāpnuyā || stav_5 ||	བྱང་ཆུབ་ཕྱིར་ནི་བྱམས་པའི་སེམས་བསྐྱེད་ན་༎ དེ་ནི་དེ་བས་བསོད་ནམས་མང་པོ་འཐོབ་༎ བྱང་ཆུབ་སེམས་དཔའ་གང་གིས་སེམས་ཅན་ལ་༎
 yaścāpi sattveṣu imaṃ samādhiṃ prakāśaye deśayi bodhisattvaḥ | pratipādaye bodhimanuttare tathā upamāpi puṇyaṃpi na tasya bhoti || stav_6 ||	ཏིང་འཛིན་འདི་བཤད་ལུང་ཕོག་དེ་བཞིན་དུ་༎
 imaṃ ca śrutvā tatha ānuśaṃsāḥ kṛtvā ca maitraṃ tatha sarvasattvaiḥ |	བླ་མེད་བྱང་ཆུབ་ཕྱིར་ནི་བཀོད་གྱུར་ན་༎ དེ་ཡི་བསོད་ནམས་དཔེར་ཡང་མི་བཟོད་འགྱུར༏་༏དེ་ལྟས་ཕན་ཡོན་འདི་དག་ཐོས་ནས་ཀྱང་༎ སེམས་ཅན་ཀུན་ལ་དེ་བཞིན་བྱམས་བྱས་ཏེ་༎
 (dutt 84) tasmāpi sūtram imu dhārayeta likheta vāceta tathā prakāśaye || stav_7 ||	མདོ་འདི་གཟུང་ཞིང་ཡི་གེར་བྲི་བར་བྱ་༎ བཀླག་པར་བྱ་ཞིང་དེ་བཞིན་བཤད་པར་བྱ༏་༏རྒ་དང་དེ་བཞིན་ན་འཆིས་གནོད་གྱུར་ཅིང་༎
 jarāvyādhimṛtyu[bhistathātitīvraiḥ śataiścaduḥkhaiḥ] paripīḍitāśca |	སྡུག་བསྔལ་རབ་དྲག་བརྒྱ་ཡིས་ཡོངས་གདུངས་ལ་༎
 upapadyamānā narakeṣu pretayo mā paścakāle parītāpyu bheṣyatha || stav_8 ||	སེམས་དམྱལ་ཡི་དབ༹གས་རྣམས་སུ་སྐྱེ་བ་ན་༎ ཕྱི་མའི་དུས་ན་འགྱོད་པར་གྱུར་ཏ་རེ་༎
 sa mṛtyukāle bhayabhītamānasaḥ abhīkṣṇamucchvāsanamucchvasantaḥ |	འཆི་བའི་དུས་ན་ཡིད་སྐྲག་འཇིགས་གྱུར་ལ་༎
 kosmābhi trāṇaṃ bhavate parāyaṇaṃ mukhe mukhaṃ prekṣati bālabuddhiḥ || stav_9 || (dutt 85)	ཡང་དང་ཡང་དུ་སྔམ་པ་འདོད་བྱེད་ཅིང་༎ བདག་གི་དཔུང་གཉེན་སྐྱབས་སུ་འགྱུར་བ་ཞེས་༎ བྱིས་པའི་བློ་ཅན་ཕན་ཚུན་རྟོག་ག་རེ་༎
 [yasmā tathāgatamabhipūjayitvā] bauddhaṃ ca dharmaṃ tatha sāṃghikañca |	གང་ཕྱིར་དེ་བཞིན་གཤེགས་པ་མ་མཆོད་ཅིང་༎ སངས་རྒྱས་ཆོས་དང་དགེ་འདུན་ནོར་འཕྲོག་པ་༎
 hariṣya neṣye yamaloki dāruṇe na tasya trāṇaṃ sada kaści bheṣyati || stav_10 ||	མི་ཟད་གཤིན་རྗེའི་འཇིག་རྟེན་ཁྲིད་འགྱུར་ཞིང་༎ ཕྱིན་ཆད་རྟག་ཏུ་སྐྱབས་འགྱུར་འགའ་ཡང་མེད་༎
 na putradāraṃ na ca mitrabāndhavān na cāpi rāṣṭraṃ na ca hāsyalāsyam |	བུ་སྨད་ཡོད་མིན་ཉེ་དུ་རྩ་ལག་མེད་༎ ཡུལ་འཁོར་ཡོད་མིན་བཞད་གད་འཇོ་སྒེག་མེད་༎
 dhanaṃ na dhānyaṃ na ca vastrabhūṣaṇaṃ sarvaṃ jahitvā puna duḥkhadāruṇam || stav_11 ||	ནོར་དང་འབྲུ་དང་དེ་བཞིན་གོས་དང་རྒྱན་༎ ༄༤༤༣བ་ཀུན་སྤངས་སྡུག་བསྔལ་ཡང་དང་ཡང་མི་ཟད་༎ ཏིང་འཛིན་འདི་ལ་དད་པར་མ་བྱས་པས་༎
 imaṃ samādhiṃ na ca śraddadhitvā tathā[ca duḥkhaṃ]dāruṇaṃ vedayate |	དེ་འདྲའི་སྡུག་བསྔལ་མི་ཟད་མྱོང་འགྱུར་བས་༎
 (dutt 86) ima duḥkhu śrutvā imu ānuśaṃsāḥ ko bālabuddhirna jane prasādam || stav_12 ||	སྡུག་བསྔལ་འདི་དང་ཕན་ཡོན་དེ་ཐོས་ན་༎ བྱིས་པའི་བློ་ཡང་སུ་ཞིག་དད་མི་སྐྱེད་༎
 tasmācca tairhi sada bhikṣubhikṣuṇī upāsakopāsikarājabhiḥ sadā |	དེ་ཕྱིར་རྟག་ཏུ་དགེ་སློང་ཕ་མ་དང་༎ དགེ་བསྙེན་རྣམས་དང་རྒྱལ་པོས་ཁོར་ཟུག་དང་༎ མདོ་སྡེ་འདི་ནི་རྟག་ཏུ་གཟུང་བྱ་ཞིང་༎
 imaṃ ca sūtraṃ sada dhārayitvā satkāru nityaṃ ca kartavyadhārake || stav_13 ||	འཛིན་པ་ལ་ཡང་རྟག་ཏུ་བསྙེན་བཀུར་བྱ་༎
 athāyuṣmānānando bhagavantametadavocat |	དེ་ནས་བཅོམ་ལྡན་འདས་ལ་ཚེ་དང་ལྡན་པ་ཀུན་དགའ་བོས་འདི་སྐད་ཅེས་གསོལ་ཏོ་༎ བཅོམ་ལྡན་འདས་།
 udgṛhītaṃ mayā bhagavan imaṃ dharmaparyāyaṃ śāstṛsaṃjñayā dhārayiṣyāmi pūjayiṣyāmi sarvasattvebhyaḥ saṃprakāśayiṣyāmi |	བདག་གིས་ཆོས་ཀྱི་རྣམ་གྲངས་འདི་གཟུང་ལགས་ཏེ་། སྟོན་པའི་འདུ་ཤེས་ཀྱིས་བཅང་བར་བགྱི་ཞིང་སེམས་ཅན་ཐམས་ཅད་ལ་ཡང་དག་པར་བསྟན་པར་བགྱི་ལགས་སོ་༎ 
 bhagavānāha |	བཅོམ་ལྡན་འདས་ཀྱིས་བཀའ་སྩལ་པ་།
 yadi tvamānanda yanmayā dharmo bhāṣitaḥ śruto dhārayituṃ tat sarvaṃ na dhāraye na	ཀུན་དགའ་བོ༏་གལ་ཏེ་ཁྱོད་ཀྱིས་ངས་ཆོས་གང་བསྟན་པ་མཉན་ཏེ་ཀུན་བཟུང་བ་དེ་དག་ཐམས་ཅད་འཕང་བར་མི་བྱེད་། ཀློག་པར་མི་བྱེད་། རྒྱས་པར་མི་བྱེད་ཀྱང་།
 vācaye na pūjaye na vaistārikīkuryā tvayā mama nāparādhye na cāśuśrūṣā kṛtā bhave na cāśrāvakatvam |	དེས་ནི་ཁྱོད་ཀྱིས་ང་ལ་ཉེས་པ་བྱས་པར་མི་འགྱུར་ཞིང་གུས་པར་མ་མཉན་པར་ཡང་མི་འགྱུར་ལ་། ཉན་ཐོས་ཉིད་མ་ཡིན་པར་ཡང་མི་འགྱུར་གྱི་།
 yaśca imaṃ dharmaparyāya na dhāraye (dutt 87)	ཆོས་ཀྱི་རྣམ་གྲངས་འདི་འཆང་པར་མི་བྱེད་། ཀློག་པར་མི་བྱེད་།
 na vācaye na pūjaye na saṃprakāśaye na manasikuryā sa mām aparādhye aśuśrūṣā kṛtā bhave aśrāvakatvaṃ bhave |	མཆོད་པར་མི་བྱེད་། ཡང་དག་པར་སྟོན་པར་མི་བྱེད་། ཡིད་ལ་མི་བྱེད་ན་ནི་དེས་ན་ཁྱོད་ཀྱིས་ང་ལ་ཉེས་པ་བྱས་པར་འགྱུར་ཞིང་གུས་པར་མ་མཉན་པར་ཡང་འགྱུར་ལ་། ཉན་ཐོས་༄༤༤༤ཨ་༌༎ ཉིད་ཡིན་པར་ཡང་མི་འགྱུར་རོ་༎
 tasmāttarhi tvamānanda satkṛtya ayaṃ dharmaparyāyo dhārayitavyaḥ |	ཀུན་དགའ་བོ་། དེ་ལྟ་བས་ན་། ཁྱོད་ཀྱིས་ཕུ་དུད་བྱས་ཏེ་ཆོས་ཀྱི་རྣམ་གྲངས་འདི་བཅང་བར་བྱའོ་༎
 ayaṃ te tathāgatasyānuttarasamyaksaṃbodhatathāgatakṛtyaṃ kariṣyati paścime kāle paścime samaye sarvasattvānām | asmin khalu punardharmaparyāye bhagavatā bhāṣyamāṇe ṣaṣṭīnāṃ prāṇisahasrāṇāmanupādāyāsravebhyaścittāni vimuktāni saptānāṃ śatānāṃ bodhisattvasamādhipratilaṃbho 'bhūt |	དའི་ནི་ཕྱི་མའི་དུས་ཕྱི་མའི་ཚེ་ན་སེམས་ཅན་ཐམས་ཅད་ལ་དེ་བཞིན་གཤེགས་པའི་བླ་ན་མེད་པ་ཡང་དག་པར་རྫོགས་པའི་བྱང་ཆུབ་ཀྱིས་དེ་བཞིན་གཤེགས་པའི་མཛད་པ་བྱེད་པར་འགྱུར་རོ་༎ བཅོམ་ལྡན་འདས་ཀྱིས་ཆོས་ཀྱི་རྣམ་གྲངས་འདི་བཤད་པ་ན་སྲོག་ཆགས་དྲུག་ཁྲི་ལན་པ་མེད་པར་ཟག་པ་རྣམས་ལས་སེམས་རྣམ་པར་གྲོལ་ལོ་༎ ༎ བྱང་ཆུབ་སེམས་དཔའ་བདུན་བརྒྱས་ནི་ཏིང་ངེ་འཛིན་ཐོབ་པར་འགྱུར་ཏོ་༎
 pañcānāṃ śatānāṃ nānābuddhakṣetravyākaraṇapratilaṃbho 'bhūt |	ལྔ་བརྒྱས་ནི་། སངས་རྒྱས་ཀྱི་ཞིང་ཐ་དད་པར་སྐྱེ་བར་ལུང་བསྟན་པ་ཐོབ་པར་གྱུར་ཏོ་༎
 navatīnāṃ prāṇisahasrāṇāṃ sarvakleśavinirmuktāḥ sarvākṣaṇāpāyadurgatayaḥ prahīṇāḥ |	སྲོག་ཆགས་དགུ་ཁྲི་ནི་། ཉོན་མོངས་པ་ཐམས་ཅད་ལས་རྣམ་པར་གྲོལ་ཏེ་མི་ཁོམ་པ་དང་། ངན་སོང་དང་། ངན་འགྲོ་ཐམས་ཅད་སྤངས་སོ་༎
 athāryāvalokiteśvaro bodhisattvo mahāsattvaḥ punarbhagavantametadavocat |	དེ་ནས་བཅོམ་ལྡན་འདས་ལ་བྱང་ཆུབ་སེམས་དཔའ་སེམས་དཔའ་ཆེན་པོ་འཕགས་པ་སྤྱན་རས་གཟིགས་དབང་ཕྱུག་གིས་ཡང་འདི་སྐད་ཅེས་གསོལ་ཏོ་༎ བཅོམ་ལྡན་འདས་། ཆོས་ཀྱི་རྣམ་གྲངས་འདི་ནི་།
 ayaṃ bhagavan dharmaparyāyaḥ paścimakāle paścimasamaye teṣāṃ kulaputrāṇāṃ śrotṝṇāṃ dhārayitṝṇāṃ mānayitṝṇāṃ teṣāṃ ca lekhakānāṃ tathāgatakṛtyaṃ kariṣyati | vyākṛtāste yathepsiteṣu nānābuddhakṣetreṣu |	སླད་མའི་དུས་སླད་མའི་ཚེ་ན་རིགས་ཀྱི་བུ་དང་། རིགས་ཀྱི་བུ་མོ་ཉན་པར་བགྱིད་པ་དང་། འཛིན་པར་བགྱིད་པ་དང་། རི་མོར་བགྱིད་པ་དང་། མཆོད་པར་བགྱིད་པ་དེ་དག་དང་། ཡི་གེར་འབྲི་བར་བགྱིད་པ་དེ་དག་༄༤༤༤བ་ལ་དེ་བཞིན་གཤེགས་པའི་མཛད་པ་བགྱིད་པར་འགྱུར་ཏེ་། དེ་དག་ཀྱང་ཇི་ལྟ་བུ་འཚལ་བའི་སངས་རྒྱས་ཀྱི་ཞིང་ཐ་དད་པ་དག་ཏུ་ལུང་བསྟན་། པ་ལགས་སོ་༎ 
 ye ca sattvāḥ paścime kāle paścime[sama]ye hāsyanāṭyagītavāditeṣu nānāvyākṣepabahulā	སླད་མའི་དུས་སླད་མའི་ཚེ་ན་སེམས་ཅན་གང་བཞད་གད་དང་། འཇོ་སྒེག་དང་། གར་དང་། བྲོ་དང་། གླུ་དང་། རོལ་མོའི་སྒྲ་དག་ལ་སྣ་ཚོགས་སུ་ག-ཡང་བ་།
 rāgadveṣamohāndhā ratikrīḍāsaṃjñinaḥ anitye nityasaṃjñinaḥ īrṣyāmātsaryadauḥśīlyaparigṛhītā	འདོད་ཆགས་དང་། ཞེ་སྡང་དང་། གཏི་མུག་གི་མུན་པ་ཆེ་བ་། རྩེད་མོ་ལ་དགའ་བར་འདུ་ཤེས་པ་། མི་རྟག་པ་ལ་རྟག་པར་འདུ་ཤེས་པ་། ཕྲག་དོག་དང་། སེར་སྣས་ཡོངས་སུ་ཟིན་ཅིང་། མཆོད་པར་མི་བགྱིད་། རི་མོར་མི་བགྱིད་། དད་པར་མི་བགྱིད་།
 na pūjayiṣyanti na mānayiṣyanti na śraddhāsyanti na pattīyiṣyanti na dhārayiṣyanti	གློ་བ་ཆོས་པར་མི་བགྱིད་། འཆང་བར་མི་བགྱིད་། ཀློག་པར་མི་བགྱིད་།
 na śroṣyanti na pratipattyā pratipatsyante |	ཉན་པར་མི་བགྱིད་། ནན་ཏན་གྱིས་སྒྲུབ་པར་མི་བགྱིད་པ་དེ་དག་ནི་ངལ་བ་འདི་ཡིད་བྱུང་བར་བགྱིས་ཤིང་།
 te taṃ pūrvakarmaśubhaphalaṃ parikṣepaṃ kṛtvā nānāduḥkhadaurmanasyaṃ (dutt 88) nārakaṃ duḥkhamanubhaviṣyanti |	སྔོན་གྱི་ལས་ཀྱི་འབྲས་བུ་དེ་ཡོངས་སུ་བས་པར་བགྱིས་ནས་སྡུག་བསྔལ་བ་ཡིད་མི་བདེ་བ་སྣ་ཚོགས་དང་། 
 tataste anekāni kalpakoṭīśatāniduḥkhamanubhavitvā narakatiryagyoniyamalokeṣu vopapatsyante |	སེམས་ཅན་དམྱལ་བའི་སྡུག་བསྔལ་དག་ཉམས་སུ་མྱོང་བར་འགྱུར་ཞིང་། དེའང་བསྐལ་པ་བྱེ་བ་བརྒྱ་ཕྲག་དུ་མར་སྡུག་བསྔལ་ཉམས་སུ་མྱོང་ནས་ཡང་སླར་སེམས་ཅན་དམྱལ་བ་དང་། དུད་འགྲོའི་སྐྱེ་གནས་དང་། གཤིན་རྗེའི་འཇིག་རྟེན་རྣམས་སུ་སྐྱེ་བར་འགྱུར་ལགས་ཏེ་།
 dīrgharātramakalyāṇamitravaśāḥ paścānutāpino bhaviṣyanti imaṃ kṣaṇaṃ virāgayitvā |	མི་དགེ་བའི་བཤེས་གཉེན་གྱི་དབང་གིས་ཡུན་རིང་པོར་རྗེས་སུ་འགྱོད་པར་འགྱུར་ལགས་སོ་༎
 tasmāttarhi kāya[vāṅma]naḥsaṃvareṇa bhavitavyam |	དེ་ལྟ་ལགས་པས་ན་། ལུས་དང་། ༄༤༤༥ཨ་༌༎ ངག་དང་། ཡིད་ལེགས་པར་བསྡམ་པར་བགྱི་ཞིང་། སངས་རྒྱས་དང་། ཆོས་དང་། དགེ་འདུན་དག་ལའང་དད་པ་མི་ཕྱེད་པར་བགྱི་།
 buddhadharmasaṃghe[a]bhedyaprasādena sarvasattveṣu maitracittena īrṣyāmātsaryadauḥśīlyacittaparivarjitena krodhaparivarjitena bhavitavyam | atha sā yathāsamāgatā parṣa taistaiḥ puṇyābhisaṃskāraiḥ tathāgataṃ pūjayati sma |	སེམས་ཅན་ཐམས་ཅད་ལའང་བྱམས་པའི་སེམས་དང་། ཕྲག་དོག་དང་། སེར་སྣ་དང་། འཆལ་བའི་ཚུལ་ཁྲིམས་ཡོངས་སུ་སྤངས་པའི་སེམས་དང་། ཁྲོ་བ་ཡོངས་སུ་སྤངས་པའི་སེམས་སུ་བགྱི་ལགས་སོ༏་༏དེ་ནས་ཇི་ལྟར་ལྷགས་པའི་འཁོར་དེ་དག་གིས་རང་རང་གི་བསོད་ནམས་མངོན་པར་འདུ་བྱ་བ་དག་གིས་དེ་བཞིན་གཤེགས་པ་ལ་ལྷའི་མེ་ཏོག་དང་། 
 divyapuṣpagandhamālyavilepanavastrābharaṇaiḥ kilikili prakṣveḍitaśabdaiśca divyatūryatāḍāvacarasaṃgīteḥ sādhukāraṃ pradadau |	བདུག་སྤོས་དང་། སྤོས་དང་། མེ་ཏོག་ཕྲེང་དང་། བྱུག་པ་དང་། ན་བཟའ་དང་། རྒྱན་དག་དང་། ཨཨ་ལ་ལ་ཞེས་ཅ་ཅོ་དང་། གཞའི་སྒྲ་དག་དང་། ལྷའི་སིལ་སྙན་དང་། ཕེག་རྡོབ་པ་དང་། གླུ་དབྱངས་དག་གི་མཆོད་པ་བྱས་ནས་། ལགས་སོ་ཞེས་བྱ་བ་གསོལ་ཏེ་། བཅོམ་ལྡན་འདས་།
 tad yathā sādhu sādhu bhagavan subhāṣitamidaṃ mahādharmaparyāyaṃ sarvasattvānāmarthāya tathāgataśāsanacirasthityartham | athāyuṣmānānando bhagavantametadavocat |	ལེགས་སོ་༎ ལེགས་སོ་༎ སེམས་ཅན་ཐམས་ཅད་ཀྱི་དོན་དང་། དེ་བཞིན་གཤེགས་པའི་བསྟན་པ་ཡུན་རིང་དུ་གནས་པར་བགྱི་པའི་སླད་དུ་ཆོས་ཀྱི་རྣམ་གྲངས་ཆེན་པོ་འདི་ཤིན་ཏུ་ལེགས་པར་བཀའ་སྩལ་ལགས་སོ་༎ དེ་ནས་བཅོམ་ལྡན་འདས་ལ་ཚེ་དང་ལྡན་པ་ཀུན་དགའ་བོས་འདི་སྐད་ཅེས་གསོལ་ཏོ་༎
 kiṃnāmāyaṃ bhagavan dharmaparyāyaḥ kathaṃ ca vayaṃ bhagavan dhārayāmaḥ |	བཅོམ་ལྡན་འདས་། ཆོས་ཀྱི་རྣམ་གྲངས་འདིའི་མིང་ཅི་ལགས་། འདི་ཇི་ལྟར་གཟུང་བར་བགྱི་།
 bhagavānāha |	བཅོམ་ལྡན་འདས་ཀྱིས་བཀའ་སྩལ་པ་། ཀུན་དགའ་པོ་།
 tasmāttarhi tvamānanda imaṃ dharmaparyāyaṃ sarvatathāgatajñānabodhisattvabhūmikramaṇamityapi nāma dhāraya |	དེའི་ཕྱིར་ཁྱོད་༄༤༤༥བ་ཀྱིས་ཆོས་ཀྱི་རྣམ་གྲངས་འདི་དེ་བཞིན་གཤེགས་པ་ཐམས་ཅད་ཀྱིས་རྗེས་སུ་གནང་བ་དང་། བྱང་ཆུབ་སེམས་དཔའི་ས་གནོན་པ་ཞེས་བྱ་བར་ཡང་ཟུངས་ཤིག་།
 ṛddhivikurvāṇamahātmasannipātamityapi nāma dhāraya |	རྫུ་འཕྲུལ་གྱི་རྣམ་པར་འཕྲུལ་པ་འདུས་པ་ཆེན་པོ་ཞེས་བྱ་བར་ཡང་ཟུངས་ཤིག་།
 sarvatathāgatādhiṣṭhānasattvāvalokanabuddhakṣetrasandarśanavyūhamityapi nāma dhāraya |	དེ་བཞིན་གཤེགས་པ་ཐམས་ཅད་ཀྱི་བྱིན་གྱི་རླབས་སེམས་ཅན་ལ་གཟིགས་ཤིང་སངས་རྒྱས་ཀྱི་ཞིང་གི་བཀོད་པ་ཀུན་ཏུ་སྟོན་པ་ཞེས་བྱ་བར་ཡང་ཟུངས་ཤིག་། བཅོམ་ལྡན་འདས་ཀྱིས་དེ་སྐད་ཅེས་བཀའ་སྩལ་ནས་འཕགས་པ་སྤྱན་རས་གཟིགས་དབང་ཕྱུག་ཟུངས་ཤིག་། དང་། 
 idamavocad bhagavān | āttamānāḥ āryāvalokiteśvaramaṃjuśrīvajrapāṇiprabhṛtayaḥ sarve bodhisattvā mahāsattvāḥ sarve ca mahāśrāvakāḥ sarve ca śakrabrahmalokapālāścatvāraśca (dutt 89) mahārājā mahāyakṣiṇyaḥ anaupamyā vimalaprabhā[prabhāvatībhīmāśrīśaṃkhinīharitāmahādevī]prabhṛtayo devanāgayakṣagandharvāsura[garuḍakinnaramahoragāḥ]	འཇམ་དཔལ་དང་། ལག་ན་རྡོ་རྗེ་ལ་སོགས་པ་བྱང་ཆུབ་སེམས་དཔའ་སེམས་དཔའ་ཆེན་པོ་དེ་དག་ཐམས་ཅད་དང་། ཉན་ཐོས་ཆེན་པོ་དེ་དག་ཐམས་ཅད་དང་། བརྒྱ་བྱིན་དང་། ཚངས་པ་དང་། འཇིག་རྟེན་སྐྱོང་བ་དེ་དག་ཐམས་ཅད་དང་། རྒྱལ་པོ་ཆེན་པོ་བཞི་དང་། གནོད་སྦྱིན་ཆེན་མོ་དཔེ་མེད་མ་དང་། དྲི་མེད་འོད་དང་། འོད་ཅན་མ་དང་། འཇིགས་བྱེད་མ་དང་། དཔལ་ལྡན་མ་དང་། དུང་ཅན་མ་དང་། འཕྲོག་མ་ལ་སོགས་པ་དེ་དག་དང་། ལྷ་དང་། ཀླུ་དང་། གནོད་སྦྱིན་དང་། དྲི་ཟ་དང་། ལྷ་མ་ཡིན་དང་། ནམ་མཁའ་ལྡིང་དང་། མི་འམ་ཅི་དང་། ལྟོ་འཕྱེ་ཆེན་པོ་དེ་དག་ཐམས་ཅད་དང་། ཐམས་ཅད་དང་ལྡན་པའི་འཁོར་ཇི་ལྟར་ལྷགས་པ་དེ་དག་དང་། དགེ་སློང་དང་། དགེ་སློང་མ་དང་། དགེ་བསྙེན་དང་། དགེ་བསྙེན་མའི་འཁོར་རྣམས་ཡི་རང་སྟེ་བཅོམ་ལྡན་འདས་ཀྱིས་༄༤༤༦ཨ་༌༎
 sā ca sarvāvatī parṣayathāsamāgatā bhagavato bhāṣitamabhinandya[sādhukāramadāt | sādhu sādhu bhagavan] |	གསུངས་པ་ལ་མངོན་པར་བསྟོད་དོ་༎
