skt	tib
 namo buddhāya ||	༄༤༨༣ཨ་རྒྱ་གར་སྐད་དུ་། ཨའརྱ་སརྦ་བུདདྷ་བི་ཤ་ཡ་ཨཨ་བ་ཏའ་ར་ཛཉའ་ན་ཨའ་ལོ་ཀ་ཨཨ་ལམ་ཀ་ར་ནའ་མ་མ་ཧའ་ཡའ་ན་སའུ་ཏྲ་། བོད་སྐད་དུ་། འཕགས་པ་སངས་རྒྱས་ཐམས་ཅད་ཀྱི་ཡུལ་ལ་འཇུག་པའི་ཡེ་ཤེས་སྣང་བའི་རྒྱན་ཅེས་བྱ་བ་ཐེག་པ་ཆེན་པོའི་མདོ་། བམ་པོ་དང་པོ་། སངས་རྒྱས་དང་བྱང་ཆུབ་སེམས་དཔའ་ཐམས་ཅད་ལ་ཕྱག་འཚལ་ལོ་༎
 evaṃ mayā śrutam ekasmin samaye bhagavān rājagṛhe viharati sma |	འདི་སྐད་བདག་གིས་ཐོས་པ་དུས་གཅིག་ན་།
 gṛdhrakūṭe parvate 'nantaratnaśikhare dharmadhātugarbhe prāsāde mahatā bhikṣusaṃghena sārdhaṃ pañcaviṃśatibhir bhikṣusahasraiḥ |	བཅོམ་ལྡན་འདས་རྒྱལ་པོའི་ཁབ་ན་བྱ་རྒོད་ཕུང་པོའི་རིའི་རྩེ་མོ་བཞིའི་ཤིང་དྲུང་ཆོས་ཀྱི་དབྱིངས་ཀྱི་སྙིང་པོའི་ཁང་བཟང་ན་འདི་ལྟ་སྟེ་། ཉན་ཐོས་ཆེན་པོ་བརྒྱད་དང་། ཀུན་ཤེས་ཀོཨོནདི་ནྱ་ལ་སོགས་པ་དགེ་སློང་ཉི་ཁྲི་ལྔ་སྟོང་གི་དགེ་སློང་གི་དགེ་འདུན་ཆེན་པོ་༄༤༨༣བ་ཐམས་ཅད་ཀྱང་དགྲ་བཅོམ་པ་ཟག་པ་ཟད་པ་། ཉོན་མོངས་པ་མེད་པ་། དབང་དང་ལྡན་པར་གྱུར་པ་།
 sarvair arhadbhiḥ kṣīṇāsravair niḥkleśair vaśībhūtaiḥ suvimuktacittaiḥ suvimuktaprajñair	སེམས་ཤིན་ཏུ་རྣམ་པར་གྲོལ་བ་། ཤེས་རབ་ཤིན་ཏུ་རྣམ་པར་གྲོལ་བ་། ཅང་ཤེས་པ་། གླང་པོ་ཆེན་པོ་། བྱ་བ་བྱས་པ་།
 ājāneyair mahānāgaiḥ kṛtakṛtyaiḥ kṛtakaraṇīyair apahṛtabhārair anuprāptasvakārthaiḥ	བྱེད་པ་བྱས་པ་། ཁུར་བོར་བ་། བདག་གི་དོན་རྗེས་སུ་ཐོབ་པ་།
 parikṣīṇabhavasaṃyojanaiḥ samyagājñāsuvimuktacittaiḥ sarvacetovaśiparamapāramiprāptaiḥ | ājñātakauṇḍinyapramukhaiś cāṣṭaṣaṣṭibhir mahāśrāvakaiḥ, dvāsaptatibhir bodhisattvakoṭīniyutaśatasahasraiḥ |	སྲིད་པ་ཀུན་ཏུ་སྦྱོར་བ་ཡོངས་སུ་ཟད་པ༏་ཡང་དག་པའི་ཤེས་པས་སེམས་ཤིན་ཏུ་རྣམ་པར་གྲོལ་བ་། སེམས་ཅན་ཐམས་ཅད་ཀྱི་དབང་དམ་པའི་ཕ་རོལ་ཏུ་སོན་པ་ཤ་སྟག་དང་འདི་གྲོལ་བ་། ལྟ་སྟེ་། 
 tadyathā mañjuśriyā kumārabhūtena,	བྱང་ཆུབ་སེམས་དཔའ་སེམས་དཔའ་ཆེན་པོ་འཇམ་དཔལ་གཞོན་ནུར་གྱུར་པ་གྲོལ་བ་། ལྟ་སྟེ་། དང་། 
 dhanaśriyā ca buddhiśriyā ca bhaiṣajyarājena ca bhaiṣajyasamudgatena ca bodhisattvena mahāsattvena | sarvair avaivartikadharmacakrapravartakaiḥ, sarvai ratnakūṭavaipulyasūtraparipṛcchākuśalaiḥ,	ནོར་དཔལ་དང་། སངས་རྒྱས་དཔལ་དང་། སྨན་གྱི་རྒྱལ་པོ་དང་། སྨན་ཡང་དག་འཕགས་ལ་སོགས་པ་འཇིག་རྟེན་གྱི་ཁམས་གཞན་དང་གཞན་དག་གི་དེ་བཞིན་གཤེགས་པ་བྱེ་བ་ཁྲག་ཁྲིག་བརྒྱ་སྟོང་དག་གིས་ཀུན་ནས་བཀྱེ་བའི་བྱང་ཆུབ་སེམས་དཔའ་བྱེ་བ་ཁྲག་ཁྲིག་ཕྲག་བདུན་ཅུ་རྩ་གཉིས་ཐམས་ཅད་ཀྱང་ཕྱིར་མི་ལྡོག་པའི་ཆོས་ཀྱི་འཁོར་ལོ་རབ་ཏུ་བསྐོར་བ་། ཐམས་ཅད་ཀྱང་ཤིན་ཏུ་རྒྱས་པའི་སྡེ་དཀོན་མཆོག་བརྩེགས་པའི་མདོ་ཡོངས་སུ་ཞུ་བ་ལ་མཁས་། པ་། 
 dharmameghabhūmipratilabdhaiḥ,	ཐམས་ཅད་ཀྱང་ས་བཅུ་པ་ཆོས་ཀྱི་སྤྲིན་ཐོབ་པ་།
 sumerubhūtaiḥ prajñayā,	ཐམས་ཅད་ཀྱང་ཤེས་རབ་ཀྱིས་རི་རབ་ལྟར་གྱུར་པ་།
 sarvaiḥ śūnyatānimittāpraṇihitānutpādājātābhāvadharmaparibhāvitaiḥ,	ཐམས་ཅད་ཀྱང་སྟོང་པ་ཉིད་༄༤༨༤ཨ་༌༎ དང་། མཚན་མ་མེད་པ་དང་། སྨོན་པ་མེད་པ་དང་། སྐྱེ་བ་མེད་པ་དང་། འབྱུང་བ་མེད་པ་དང་། དངོས་པོ་མེད་པའི་སེམས་སུ་བསྒོམས་པའི་སེམས་དང་ལྡན་པ་།
 mahāgaṃbhīradharmanirbhāsaiḥ, (jāa 20)	ཐམས་ཅད་ཀྱང་ཆོས་ཟབ་མོའི་སྣང་བ་ཆེན་པོ་ཐོབ་པ་།
 tathāgateryāpathaiḥ, anyonyalokadhātuṣu tathāgatakoṭīniyutaśatasahasrasaṃpreṣitaiḥ,	ཐམས་ཅད་ཀྱང་དེ་བཞིན་གཤེགས་པའི་སྤྱོད་ལམ་དང་ལྡན་པ་།
 sarvair abhijñāparikarmanirjātaiḥ sarvadharmasvabhāvaprakṛtipratiṣṭhitaiḥ || §2 ms| 2a1-7, p| 302b1-302b8, d| 276b1-276b7,	ཐམས་ཅད་ཀྱང་མངོན་པར་ཤེས་པ་ཡོངས་སུ་སྦྱངས་པས་ངེས་པར་འབྱུང་བ་ཐམས་ཅད་ཀྱི་ངོ་བོ་ཉིད་ཀྱི་རང་བཞིན་ལ་གནས་པ་ཤ་སྟག་དང་ཐབས་ཅིག་ཏུ་བཞུགས་སོ་༎
 t| 357 239b1-239b15, t| 358 250b4-250b13, t| 359(d) 254a15-254a26| tena khalu punaḥ samayena bhagavata etad abhūt | yan nv ahaṃ bodhisattvānāṃ mahāsattvānāṃ mahājavabalavegasthāmasaṃjananārthaṃ dhārmīṃ kathāṃ kathayeyam,	དེའི་ཚེ་ན་བཅོམ་ལྡན་འདས་འདི་སྙམ་དུ་བདག་གིས་བྱང་ཆུབ་སེམས་དཔའ་སེམས་དཔའ་ཆེན་པོ་རྣམས་ཀྱི་མྱུར་བ་དང་། སྟོབས་དང་། ཤུགས་ཆེན་པོ་ཡང་དག་པར་བསྐྱེད་པར་བྱ་བའི་ཕྱིར་ཆོས་ཀྱི་གཏམ་བརྗོད་པར་བྱ་ཞིང་།
 yad gaṅgānadīvālikāsamebhyo lokadhātubhyo mahaujaskamahaujaskān bodhisattvān mahāsattvān saṃnipāteyam |	འཇིག་རྟེན་གྱི་ཁམས་གངགའའི་ཀླུང་གི་བྱེ་མ་སྙེད་དག་ནས་བྱང་ཆུབ་སེམས་དཔའ་སེམས་དཔའ་ཆེན་པོ་གཟི་བརྗིད་ཆེ་བ་གཟི་བརྗིད་ཆེ་བ་དག་བསྡུ་བར་ཡང་བྱ་། 
 yan nv ahaṃ mahādharmanirdeśasya paridīpanāyai nimittam ādarśayeyam,	བདག་གིས་ཆོས་བསྟན་པ་ཆེན་པོའི་ཆོས་ཀྱི་རྣམ་གྲངས་བཤད་པའི་ལྟས་སྣང་བ་ཆེན་པོའང་བསྟན་པར་བྱ་།
 mahāntam avabhāsaṃ kuryām | yan me bodhisattvā mahāsattvā āgatya mahādharmanirdeśaṃ paripṛccheyur iti |	བདག་གིས་བྱང་ཆུབ་སེམས་དཔའ་སེམས་དཔའ་ཆེན་པོ་རྣམས་ལྷགས་ནས་བདག་ལ་ཆོས་བསྟན་པ་ཆེན་པོ་ཡོངས་སུ་ཞུ་བར་འགྱུར་བར་ཡང་༄༤༨༤བ་བྱའོ༏་༏སྙམ་དུ་དགོངས་སོ་༎ 
 atha khalu bhagavāṃs tasyāṃ velāyāṃ daśasu dikṣv asaṃkhyeyācintyatrisāhasramahāsāhasralokadhātuparamāṇurajaḥsamaṃ lokadhātuṃ mahāraśmimeghair avabhāsayati sma |	དེ་ནས་བཅོམ་ལྡན་འདས་ཀྱིས་དེའི་ཚེ་ཕྱོགས་བཅུའི་འཇིག་རྟེན་གྱི་ཁམས་སྟོང་གསུམ་གྱི་སྟོང་ཆེན་པོའི་འཇིག་རྟེན་གྱི་ཁམས་གྲངས་མེད་ཅིང་བསམ་གྱི་མི་ཁྱབ་པ་དག་གི་རྡུལ་ཕྲ་རབ་ཀྱི་རྡུལ་སྙེད་དག་འོད་ཟེར་ཆེན་པོའི་སྤྲིན་དག་གིས་སྣང་བར་མཛད་དོ་༎
 tena khalu punaḥ samayena daśabhyo digbhya ekaikasmād digbhāgād daśabuddhakṣetrānabhilāpyakoṭīniyutaśatasahasraparamāṇurajaḥsamā bodhisattvā mahāsattvā āgacchanti sma |	དེའི་ཚེ་ན་ཕྱོགས་བཅུའི་ཕྱོགས་རེ་རེ་ནས་ཀྱང་བྱང་ཆུབ་སེམས་དཔའ་སེམས་དཔའ་ཆེན་པོ་སངས་རྒྱས་ཀྱི་ཞིང་བྱེ་བ་ཁྲག་ཁྲིག་ཕྲག་འབུམ་བྲག་བརྗོད་དུ་མེད་པ་བཅུའི་རྡུལ་ཕྲ་རབ་ཀྱི་རྡུལ་སྙེད་དག་ལྷགས་སོ་༎ 
 (jāa 21) teṣām ekaiko bodhisattvo mahāsattvo 'cintyābhir bodhisattvavikurvaṇābhir āgatya bhagavato 'nurūpām acintyāṃ pūjāṃ kṛtvā svakasvakapraṇidhānabalanirjāteṣu padmāsaneṣu bhagavataḥ purato nyaṣīdan |	དེ་དག་ལ་བྱང་ཆུབ་སེམས་དཔའ་རེ་རེའང་བྱང་ཆུབ་སེམས་དཔའི་རྣམ་པར་འཕྲུལ་པ་བསམ་གྱིས་མི་ཁྱབ་པ་དག་གིས་འོངས་ཏེ་ལྷགས་ནས་ཀྱང་བཅོམ་ལྡན་འདས་ལ་ཚུལ་དང་མཐུན་པའི་མཆོད་པ་བསམ་གྱིས་མི་ཁྱབ་པ་དག་བྱས་ནས་བཅོམ་ལྡན་འདས་ཀྱི་སྤྱན་སྔར་རང་རང་གི་སྨོན་ལམ་གྱི་སྟོབས་ལས་བྱུང་བའི་པདམའི་སྟན་དག་དག་ལྷགས་སོ་༎ ལ་འཁོད་དེ་༎ 
 bhagavantam animiṣaṃ nirīkṣamāṇā sthitā abhūvan || §3 ms| 2a7-3a5, p| 302b8-303b8, d| 276b7-277b6,	བཅོམ་ལྡན་འདས་ལ་མིག་མི་འཛུམ་པར་ལྟ་ཞིང་སྡོད་པར་དག་ལྷགས་སོ་༎ ལ་འཁོད་དེ་༎ 
 t| 357 239b16-240a1, t| 358 250b14-250c9, t| 359(d) 254a26-254b28| tena khalu punaḥ samayena dharmadhātugarbhe prāsādamadhye mahāratnapadmagarbhasiṃhāsanaṃ prādurabhūt | asaṃkhyeyayojanakoṭīvistāram,	གྱུར་ཏོ་༎ དེའི་ཚེ་ན་ཆོས་ཀྱི་དབྱིངས་ཀྱི་སྙིང་པོའི་ཁང་བཟང་དེའི་དབུས་སུ་སེངགེའི་ཁྲི་ནོར་བུ་རིན་པོ་ཆེ་ཆེན་པོའི་པདམའི་སྙིང་པོ་ཅན་རྒྱར་དཔག་ཚད་བྱེ་བ་ཕྲག་གྲངས་མེད་པ་ཡོད་པ་།
 anupūrvasamucchritam,	རིམ་གྱིས་མཐོ་བ་།
 sarvaprabhāsamaṇiratnamayam,	ནོར་བུ་རིན་པོ་ཆེ་ཀུན་ཏུ་སྣང་བ་ལས་གྲུབ་བ་། ནོར་བུ་༄༤༨༥ཨ་༌༎
 vidyutpradīpam, maṇiratnavedikāparivṛtam,	རིན་པོ་ཆེ་གློག་གི་སྒྲོན་མའི་ཁ་ཁྱེར་གྱིས་ཡོངས་སུ་བསྐོར་བ་།
 acintyaprabhāsamaṇiratnadaṇḍam, anupamamaṇiratnaparivāram,	ནོར་བུ་རིན་པོ་ཆེ་འོད་བསམ་གྱིས་མི་ཁྱབ་པའི་ལན་ཀན་གྱིས་ཡོངས་སུ་བསྐོར་བ་།
 anupamātikrāntaprabhāvamaṇiratnadāmakṛtaśobham,	ནོར་བུ་རིན་པོ་ཆེ་དཔེ་མེད་པས་ཡོངས་སུ་བསྐོར་བ་། ནོར་བུ་རིན་པོ་ཆེ་སྣང་བ་དཔེ་ལས་འདས་པའི་ཕྲེང་བས་མཛེས་པར་བྱས་པ་།
 vaśirājamaṇiratnajālasaṃchannam,	ནོར་བུ་རིན་པོ་ཆེ་དབང་གི་རྒྱལ་པོའི་དྲ་བས་ཀུན་ནས་ག-ཡོགས་པ་།
 nānāmaṇiratnapratyuptam,	ནོར་བུ་རིན་པོ་ཆེ་རྣམ་པ་སྣ་ཚོགས་སྤྲས་པ་།
 samucchritacchatradhvajapatākam | tasya ca mahāmaṇiratnapadmagarbhasiṃhāsanasyopari samantād daśāsaṃkhyeyāni raśmikoṭīniyutaśatasahasrāṇi niścaranti sma |	གདུགས་དང་། རྒྱལ་མཚན་དང་། བ་དན་བསྒྲེད་པ་དང་ལྡན་པ་ཞིག་བྱུང་བར་གྱུར་ཏོ་༎ སེངགེའི་ཁྲོ་ནོར་བུ་རིན་པོ་ཆེ་ཆེན་པོའི་སྙིང་པོ་ཅན་དེའི་ཁོར་ཁོར་ཡུག་ནས་འོད་ཟེར་གྲངས་མེད་པ་བྱེ་བ་ཁྲག་ཁྲིག་འབུམ་ཕྲག་བཅུ་བྱུང་སྟེ་། 
 te ca raśmayo daśasu dikṣv anyonyān lokadhātūn mahatāvabhāsena spharanti sma |	འོད་ཟེར་དེ་དག་གིས་ཕྱོགས་བཅུའི་འཇིག་རྟེན་གྱི་ཁམས་གཞན་དང་གཞན་དག་སྣང་བ་ཆེན་པོས་ཁྱབ་པར་གྱུར་ཏོ་༎
 tena khalu punaḥ samayena daśadiśy ekaikasmād digbhāgād daśabuddhakṣetrānabhilāpyakoṭīniyutaśatasahasraparamāṇurajaḥsamā devanāgayakṣagandharvāsuragaruḍakinnaramahoragaśakrabrahmalokapālā āgacchanti sma |	ཡང་དེའི་ཚེ་ན་ཕྱོགས་བཅུའི་ཕྱོགས་རེ་རེ་ནས་ལྷ་དང་། ཀླུ་དང་། གནོད་སྦྱིན་དང་། དྲི་ཟ་དང་། ལྷ་མ་ཡིན་དང་། ནམ་མཁའ་ལྡིང་དང་། མི་འམ་ཅི་དང་། ལྟོ་འཕྱེ་ཆེན་པོ་དང་། བརྒྱ་བྱིན་དང་། ཚངས་པ་དང་། འཇིག་རྟེན་སྐྱོང་བ་སངས་རྒྱས་ཀྱི་ཞིང་བྱེ་བ་ཁྲག་ཁྲིག་འབུམ་ཕྲག་བརྗོད་དུ་མེད་པ་བཅུའི་རྡུལ་ཕྲ་རབ་ཀྱི་རྡུལ་སྙེད་དག་ཀྱང་ལྷགས་པར་༄༤༨༥བ་གྱུར་ཏེ༏་དེ་དག་ལས་ཁ་ཅིག་ནི་།
 tatra kecid ratnakūṭāgāraniṣaṇṇāsaṃkhyeyācintyāpsaraḥkoṭīniyutaśatasahasrasaṃgītisaṃpravāditair (jāa 22) āgacchanti sma |	རིན་པོ་ཆེའི་ཁང་པ་བརྩེགས་པ་དག་ན་འཁོད་ལ་། ལྷའི་བུ་མོ་བྱེ་བ་ཁྲག་ཁྲིག་འབུམ་ཕྲག་གྲངས་མེད་ཅིང་བསམ་གྱིས་མི་ཁྱབ་བ་གླུ་དབྱངས་དང་། རོལ་མོའི་སྒྲ་འབྱིན་པ་དག་དང་ལྷགས་སོ་༎
 kecit puṣpamayaiḥ,	ཁ་ཅིག་ནི་། མེ་ཏོག་ལས་བྱས་པ་དག་དང་། ཁ་ཅིག་ནི་།
 kecid uragasāracandanamayaiḥ,	ཙནདན་སྤྲུལ་གྱི་སྙིང་པོ་དག་པས་བྱས་པ་དག་དང་། ཁ་ཅིག་ནི་།
 kecid muktāmayaiḥ,	མུ་ཏིག་ལས་བྱས་པ་དག་དང་། ཁ་ཅིག་ནི་།
 kecid vajramayaiḥ,	རྡོ་རྗེ་ལས་བྱས་པ་དག་དང་། ཁ་ཅིག་ནི་།
 kecid vajraprabhāsamaṇiratnamayaiḥ,	ནོར་བུ་རིན་པོ་ཆེ་རྡོ་རྗེ་ལྟར་སྣང་བ་ལས་བྱས་པ་དག་དང་། ཁ་ཅིག་ནི་།
 kecij jāmbūnadasuvarṇamayaiḥ,	ཛམབུའི་ཆུ་བོའི་གསེར་ལས་བྱས་པ་དག་དང་། ཁ་ཅིག་ནི་།
 kecit sarvaprabhāsasamuccayamaṇiratnarājamayaiḥ,	ནོར་བུ་རིན་པོ་ཆེ་འོད་ཐམས་ཅད་ཡང་དག་པར་འདུས་པ་ལས་བྱས་པ་དག་དང་། ཁ་ཅིག་ནི་།
 kecid vaśirājamaṇiratnamayaiḥ,	ནོར་བུ་རིན་པོ་ཆེ་དབང་གི་རྒྱལ་པོ་ལས་བྱས་པ་དག་དང་། ཁ་ཅིག་ནི་།
 kecic cintāmaṇiratnamayaiḥ,	ནོར་བུ་རིན་པོ་ཆེ་ཡིད་བཞིན་གྱི་ནོར་བུ་ལས་བྱས་པ་དག་དང་། ཁ་ཅིག་ནི་།
 kecic chakrābhilagnamaṇiratnamayaiḥ,	ནོར་བུ་རིན་པོ་ཆེ་བརྒྱ་བྱིན་ཐོགས་པ་ལས་བྱས་པ་དག་དང་། ཁ་ཅིག་ནི་།
 kecit sāgarapratiṣṭhānaviśuddharatnavyūhasamantaraśmiprabhāmaṇimahāratnamayakūṭāgāraniṣaṇṇāsaṃkhyeyācintyāpsaraḥkoṭīniyutaśatasahasrasaṃgītisaṃpravāditair āgacchanti sma |	རྒྱ་མཚོའི་རྟེན་རྣམ་པར་དག་པའི་རིན་པོ་ཆེའི་བཀོད་པ་སྟོང་ལྟ་བུ་རིན་པོ་ཆེ་ཆེན་པོ་ཀུན་ནས་འོད་ཟེར་སྣང་བ་ལས་བྱས་པའི་ཁང་པ་བརྩེགས་པ་དག་ལ་ཁོད་ལ་། ལྷའི་བུ་མོ་བྱེ་བ་ཁྲག་ཁྲིག་འབུམ་ཕྲག་གྲངས་མེད་ཅིང་བསམ་གྱིས་མི་༄༤༨༦ཨ་༌༎ ཁྱབ་པའི་གླུ་དབྱངས་དང་རོལ་མོའི་སྒྲ་འབྱིན་པ་དག་ལྷགས་སོ་༎
 āgatya ca bhagavato 'cintyātulyāmāpyāṃ parimāṇābhikrāntāṃ pūjāṃ kṛtvā,	ལྷགས་ནས་ཀྱང་བཅོམ་ལྡན་འདས་ལ་བསམ་གྱིས་མི་ཁྱབ་པ་དང་། མཚུངས་པ་མེད་པ་དང་། གཞལ་དུ་མེད་པ་དང་། དཔག་ཏུ་མེད་པ་ལས་ཀྱང་ཤིན་ཏུ་འདས་པའི་མཆོད་པ་བྱས་ཏེ་།
 ekānte svapraṇidhānanirjāteṣv āsaneṣu niṣīdanti sma | niṣīdya bhagavantam animiṣaṃ nirīkṣantaḥ sthitā abhūvan |	བཅོམ་ལྡན་འདས་ཀྱི་སྤྱན་སྔར་རང་རང་གི་སྨོན་ལམ་གྱི་སྟོབས་ལས་བྱུང་བའི་སྟན་དག་ལ་འཁོད་ནས་བཅོམ་ལྡན་འདས་ལ་མིག་མི་འཛུམ་པས་ལྟ་ཞིང་སྡོད་པར་གྱུར་ཏོ་༎
 tena khalu punaḥ samayenāyaṃ trisāhasramahāsāhasro lokadhātur jāmbūnadasuvarṇamayaḥ saṃsthito 'bhūt |	དེའི་ཚེ་ན་སྟོང་གསུམ་གྱི་སྟོང་ཆེན་པོའི་འཇིག་རྟེན་གྱི་ཁམས་འདི་ཛམབུའི་ཆུ་བོའི་གསེར་ལས་གྲུབ་པར་ཀུན་ཏུ་གནས་པར་གྱུར་ཅིང་།
 nānāmahāmaṇiratnavṛkṣair divyaiḥ puṣpavṛkṣair vastravṛkṣair uragasāracandanagandhavṛkṣair alaṃkṛtaḥ,	ནོར་བུ་རིན་པོ་ཆེ་ཆེན་པོ་སྣ་ཚོགས་ཀྱི་ཤིང་ལྗོན་པ་དག་གིས་ལེགས་པར་བརྒྱན་པ་དང་། ལྷའི་མེ་ཏོག་གི་ཤིང་ལྗོན་པ་དག་དང་། གོས་ཀྱི་ཤིང་ལྗོན་པ་དག་དང་། ཙནདན་སྤྲུལ་གྱི་སྙིང་པོའི་ཤིང་ལྗོན་པ་དག་དང་། སྤོས་ཀྱི་ཤིང་ལྗོན་པ་དག་དང་། ཨཨ་ག་རུའི་ཤིང་ལྗོན་པ་དག་གིས་ཀྱང་ལེགས་པར་བརྒྱན་ཅིང་།
 candrasūryavidyutpradīpamaṇiratnajālasaṃcchannaḥ, ucchritacchatradhvajapatākaḥ |	ནོར་བུ་རིན་པོ་ཆེ་ཉི་མ་དང་། ཟླ་བ་དང་། གློག་གི་སྒྲོན་མའི་དྲ་བས་ཀུན་ནས་ཁེབས་བ་དང་། གདུགས་དང་། རྒྱལ་མཚན་དང་། བ་དན་བསྒྲེང་བ་དང་ལྡན་ལ་།
 sarvavṛkṣāś cāsaṃkhyeyāpsaraḥkoṭīniyutaśatasahasrārdhakāyikā muktāhāraparigṛhītā mahāmaṇiratnadāmaparigṛhītāḥ sthitā abhūvan || (jāa 23) ii §4 ms| 3a5-3b3, p| 303b8-304a5, d| 277b6-278a3,	ཤིང་ལྗོན་པ་ཐམས་༄༤༨༦བ་ཅད་ལའང་ལྷའི་བུ་མོ་བྱེ་བ་ཁྲག་ཁྲིག་འབུམ་ཕྲག་གྲངས་མེད་པ་མུ་ཏིག་གི་དོ་ཤལ་ལུས་ཕྱེད་ལ་ཐོགས་པ་དང་། རིན་པོ་ཆེའི་ཕྲེང་བ་ཐོགས་པ་དག་འཁོད་པར་གྱུར་ཏོ་༎
 t| 357 240a2-240a13, t| 358 250c9-250c22, t| 359(d) 254b29-254c11| tena khalu punaḥ samayena tato mahāmaṇiratnapadmagarbhāt siṃhāsanād imā gāthā niścaranti sma |	དེའི་ཚེ་ན་སེངགེའི་ཁྲི་ནོར་བུ་རིན་པོ་ཆེ་ཆེན་པོའི་སྙིང་པོ་ཅན་དེ་ལས་ཚིགས་སུ་བཅད་པ་འདི་དག་བྱུང་ངོ་༎
 āgaccha niṣīda narendrarājā ahaṃ hi te puṇyabalena udgataḥ |	ཁྱོད་ཀྱི་བསོད་ནམས་སྟོབས་ཀྱིས་བདག་བྱུང་སྟེ་༎ མི་དབང་རྒྱལ་པོ་ཚུར་གཤེགས་བཞུགས་སུ་གསོལ་༎ རྒྱལ་བ་རྐང་གཉིས་དམ་པ་འདེགས་བགྱི་སྟེ་༎
 saṃpūrṇasaṃkalpa ahaṃ tvam adya saṃdhārayiṣye dvipadottamaṃ jinam || 1 ||	དེ་རིང་བདག་གིས་བྲང་པ་འདི་རྫོགས་འགྱུར་༎
 mamātmabhāvo ratanāmayo hy ayaṃ ratnaikapadmaṃ mama madhyasaṃsthitam |	བདག་གི་ལུས་འདི་རིན་ཆེན་རྒྱུས་གྲུབ་སྟེ་༎
 manoramaṃ tubhya kṛtena nāyakāḥ saṃkalpa pūrehi mamādya tāyinaḥ || 2 ||	འདྲེན་པ་ཁྱོད་ཕྱིར་བདག་གི་དཀྱིལ་ན་ནི་༎ རིན་ཆེན་པདམ་ཡིད་འོད་གཅིག་མཆིས་ཏེ་༎ སྐྱོབ་པ་བདག་གི་བྲང་པ་དེ་རྫོགས་མཛོད་༎
 niṣadya ratnāmayi padmi asmiṃ śobhehi māṃ sarvam imaṃ ca lokam |	རིན་ཆེན་པདམ་འདི་ལ་བཞུགས་ནས་ནི་༎ བདག་དང་འཇིག་རྟེན་འདི་ཀུན་མཛེས་པར་མཛོད་༎
 deśehi dharmaṃ bahuprāṇikoṭināṃ yaṃ śruta siṃhāsana īdṛśaṃ labhet || 3 ||	གང་ཐོས་སེངགེའི་ཁྲི་འདི་འདྲ་ཐོབ་པ་༎ ཆོས་དེ་སྲོག་ཆགས་བྱེ་མང་བསྟན་དུ་གསོལ་༎
 raśmī sahasrā tava gātrasaṃbhavāḥ prabhāsayanto bahulokadhātum |	ཁྱོད་ཀྱི་སྐུ་ལས་འོད་ཟེར་སྟོང་བྱུང་སྟེ་༎ འཇིག་རྟེན་ཁམས་མང་རབ་ཏུ་སྣང་བྱེད་པ་༎
 prāmodyajātasya hi lakṣaṇaṃ imaṃ samākramā mahya kṛtena nāyakāḥ || 4 ||	དེ་ནི་བདག་གིས་དགའ་མཆོག་སྐྱེས་པའི་མཚན་༎
 (jāa 24) kṣipraṃ niṣīdasva kuruṣva 'nugrahaṃ pūrvaṃ mayā dhārita aṣṭakoṭiyaḥ |	འདྲེན་པ་བདག་གི་སླད་དུ་བཞུགས་སུ་གསོལ་༎
 asmin pradeśe munināṃ svayaṃbhuvāṃ bhagavan pīhādya karotv anugraham || 5 ||	སྔོན་ཡང་བདག་གིས་ཕྱོགས་འདིར་རང་བྱུང་བའི་༎ ཐུབ་པ་བྱེ་བ་ཕྲག་བརྒྱད་བ་བཏེགས་གྱུར་བས་༎ མྱུར་དུ་བཞུགས་ཏེ་ཕན་གདགས་མཛད་དུ་༄༤༨༧ཨ་༌༎
 §5 ms| 3b3-4a2, p| 304a5-304b5, d| 278a3-278b3, t| 357 240a14-240a26, t| 358 250c23-251a5, t| 359(d) 254c12-254c27|	གསོལ་༎
 atha khalu bhagavān utthāya pūrvakād āsanāt tatra mahāratnapadmagarbhe siṃhāsane niṣadya paryaṅkaṃbaddhī sarvāvantaṃ bodhisattvagaṇaṃ svavalokayati sma |	བཅོམ་ལྡན་དེང་འདིར་ཕན་གདགས་མཛད་དུ་གསོལ་༎ དེ་ནས་བཅོམ་ལྡན་འདས་གདན་སྔ་མ་ལས་བཞེངས་ཏེ་། སེངགེའི་ཁྲི་ནོར་བུ་རིན་པོ་ཆེ་ཆེན་པོའི་སྙིང་པོ་ཅན་དེ་ལ་སྐྱིལ་མོ་ཀྲུང་བཅས་ཏེ་བཞུགས་ནས་ཐམས་ཅད་དང་ལྡན་པའི་བྱང་ཆུབ་སེམས་དཔའི་ཚོགས་པ་རྣམ་པར་གཟིགས་ཏེ་།
 sāmutkarṣikāyāś ca dharmadeśanāyās teṣāṃ bodhisattvānāṃ mahāsattvānāṃ nimittam akārṣīt |	བྱང་ཆུབ་སེམས་དཔའ་སེམས་དཔའ་ཆེན་པོ་དེ་དག་ལ་ཡང་དག་ཕུལ་གྱི་ཆོས་བསྟན་པའི་ལྟས་མཛད་དོ་༎ 
 tena khalu punaḥ samayena sarvāvān bodhisattvagaṇa evaṃ cintayati sma |	དེའི་ཚེ་ན་ཐམས་ཅད་དང་ལྡན་པའི་བྱང་ཆུབ་སེམས་དཔའི་ཚོགས་རྣམས་འདི་སྙམ་དུ་སེམས་དོ་༎ ཏེ་། 
 yan nv ayaṃ mañjuśrīḥ kumārabhūto 'nutpādānirodhaṃ tathāgatam arhantaṃ samyaksaṃbuddhaṃ paripṛcchet,	འཇམ་དཔལ་གཞོན་ནུར་གྱུར་པ་འདིས་དེ་བཞིན་གཤེགས་པ་དགྲ་བཅོམ་པ་ཡང་དག་པར་རྫོགས་པའི་སངས་རྒྱས་ལ་བདག་ཅག་གིས་ཐོས་ནས་ཡུན་རིང་དུ་ལོན་པ་སྐྱེ་བ་མེད་པ་དོ་༎ ཏེ་། དང་། 
 ciraśruto 'yam asmābhir dharmaparyāya iti |	འགག་པ་མེད་པའི་ཆོས་ཀྱི་རྣམ་གྲངས་དེ་ཡོངས་སུ་ཞུས་ན་ཅི་མ་རུང་སྙམ་མོ་༎
 atha khalu mañjuśrīḥ kumārabhūto bhagavato 'ntikān nimittaṃ viditvā teṣāṃ ca bodhisattvānāṃ mahāsattvānāṃ cetasaiva cetaḥparivitarkam ājñāya bhagavantam etad avocat |	དེ་ནས་འཇམ་དཔལ་གཞོན་ནུར་གྱུར་པས་བཅོམ་ལྡན་འདས་ཀྱིས་ལྟས་མཛད་པའང་རིག་། བྱང་ཆུབ་སེམས་དཔའ་སེམས་དཔའ་ཆེན་པོ་དེ་དག་གི་སེམས་ཀྱི་ཡོངས་སུ་རྟོག་པའང་སེམས་ཀྱིས་ཤེས་ནས་སྟན་ལས་ལངས་ནས་བླ་གོས་ཕྲག་པ་གཅིག་ཏུ་གཟར་ནས་པུས་མོ་ག-ཡས་པའི་ལྷ་ང་པདམའི་སྙིང་པོ་ལ་བཙུགས་ཏེ་བཅོམ་ལྡན་འདས་ག་། ༄༤༨༧བ་ལ་བ་དེ་ལོགས་སུ་ཐལ་མོ་སྦྱར་བ་བཏུད་ནས་བཅོམ་ལྡན་འདས་ལ་འདི་སྐད་ཅེས་གསོལ་ཏོ་༎ 
 anutpādo 'nirodha iti bhagavann ucyate,	བཅོམ་ལྡན་འདས་། སྐྱེ་བ་མ་མཆིས་པ་དང་། འགག་པ་མ་མཆིས་པ་ཞེས་བགྱི་ན་།
 katamasyaitad bhagavan dharmasyādhivacanam anutpādo 'nirodha iti |	བཅོམ་ལྡན་འདས་། སྐྱེ་བ་མ་མཆིས་པ་དང་། འགག་པ་མ་མཆིས་པ་ཞེས་བགྱི་བ་དེ་ཆོས་གང་གི་ཚིག་བླ་དབ༹གས་ལགས་།
 imāś ca gāthā abhāṣat |	དེའི་ཚེ་ཚིགས་སུ་བཅད་པ་འདི་དག་གསོལ་ཏོ་༎
 anirodham anutpādaṃ bravīṣi tvaṃ vināyaka | (jāa 25)	མི་སྐྱེ་འགག་པ་མ་མཆིས་པ་༎ རྣམ་འདྲེན་ཁྱོད་ཀྱིས་བཤད་དུ་གསོལ་༎
 tat kīdṛśaṃ mahāprājña tasya niruktilakṣaṇam || 1 ||	དེ་ཡི་ངེས་ཚིག་མཚན་ཉིད་དེ་༎ ཅི་འདྲ་ཤེས་རབ་ཆེན་པོ་པ་༎
 anirodham anutpādaṃ katham eṣa nigadyate |	མི་སྐྱེ་འགག་པ་མ་མཆིས་པ་༎ དེ་ནི་ཇི་ལྟར་བརྗོད་པར་བགྱི་༎
 dṛṣṭāntair hetubhiś caiva kathayasva mahāmune || 2 ||	དཔེ་རྣམས་དང་ནི་གཏན་ཚིགས་ཀྱིས་༎ ཐུབ་ཆེན་བཤད་པ་མཛད་དུ་གསོལ་༎
 samāgateme bahubodhisattvā jñānārthinaḥ tvāṃ ca vibho 'bhivanditum |	བྱང་ཆུབ་སེམས་དཔའ་མང་པོ་འདི་དག་ནི་༎
 saṃpreṣitā lokavināyakebhir deśehi saddharmam udāram uttamam || 3 || §6 ms| 4a2-5b5, p| 304b5-306b4, d| 278b3-280b1,	འཇིག་རྟེན་རྣམ་པར་འདྲེན་པ་རྣམས་ཀྱིས་བཀྱེ་ལགས་ཏེ་༎ ཡེ་ཤེས་འཚལ་ཞིང་ཁྱོད་ལ་ཕྱག་འཚལ་མཆིས་ལགས་ན་༎ དམ་ཆོས་རྒྱ་ཆེན་དམ་པ་བཤད་པ་མཛད་དུ་གསོལ་༎
 t| 357 240a27-241a3, t| 358 251a6-251a23, t| 359(d) 254c28-255b23| evam ukte bhagavān mañjuśriyaṃ kumārabhūtam etad avocat |	དེ་སྐད་ཅེས་གསོལ་བ་དང་། བཅོམ་ལྡན་འདས་ཀྱིས་འཇམ་དཔལ་གཞོན་ནུར་གྱུར་པ་ལ་འདི་སྐད་ཅེས་བཀའ་སྩལ་ཏོ་༎
 sādhu sādhu mañjuśrīḥ,	འཇམ་དཔལ་། ལེགས་སོ་༎
 sādhu khalu punas tvaṃ mañjuśrīs tathāgatam etam arthaṃ paripraṣṭavyaṃ manyase |	ལེགས་སོ་༎ འཇམ་དཔལ་།
 bahujanahitāya tvaṃ mañjuśrīḥ pratipanno bahujanasukhāya lokānukampāyai mahato janakāyasyārthāya	སྐྱེ་བོ་མང་པོ་ལ་ཕན་པ་དང་། སྐྱེ་བོ་མང་པོ་ལ་བདེ་བ་དང་། འཇིག་རྟེན་ལ་སྙིང་བརྩེ་བ་དང་། ལྷ་དང་མི་༄༤༨༨ཨ་༌༎
 hitāya sukhāya devānāṃ ca manuṣyāṇāṃ caitarhy āgatānāṃ ca bodhisattvānāṃ mahāsattvānāṃ buddhabhūmiprāpaṇārtham |	རྣམས་ཀྱི་སྐྱེ་བོ་ཕལ་པོ་ཆེའི་དོན་དང་། ཕན་པ་དང་། བདེ་བ་དང་། བྱང་ཆུབ་སེམས་དཔའ་སེམས་དཔའ་ཆེན་པོ་རྣམས་ཀྱིས་ཐོབ་པར་བྱ་བའི་ཕྱིར་ཞུགས་ཏེ་། ཁྱོད་དེ་བཞིན་གཤེགས་པ་ལ་དོན་དེ་ལྟ་བུ་ཡོངས་སུ་ཞུ་བར་སེམས་པ་ནི་འཇམ་དཔལ་ཡང་ཁྱོད་ལེགས་སོ་༎ 
 anuttrāsas te mañjuśrīr asmin sthāne yogaḥ karaṇīyo na (jāa 26)	འཇམ་དཔལ་དེ་བཞིན་གཤེགས་པ་དོན་དེ་བསྟན་པ་ན་གནས་དེ་ལ་ཁྱོད་སྐྲག་ཁྱོད་ལེགས་སོ་༎ པ་དང་། 
 bhayaṃ na stambhitatvam |	འཇིགས་པ་དང་། སྡང་བར་མི་བྱ་ཞིང་།
 jñānapratisaraṇena ca te mañjuśrīr bhavitavyam |	འཇམ་དཔལ་ཁྱོད་ཀྱིས་ཡེ་ཤེས་ལ་བསྟེན་པར་ཡང་བྱའོ་༎
 tathāgatasyaitam arthaṃ nirdeśataḥ | anutpādo 'nirodha iti mañjuśrīs tathāgatasyaitad adhivacanam |	འཇམ་དཔལ་སྐྱེ་བ་མེད་པ་དང་། འགག་པ་མེད་པ་ཞེས་བྱ་བ་འདི་ནི་དེ་བཞིན་གཤེགས་པ་དགྲ་བཅོམ་པ་ཡང་དག་པར་རྫོགས་པའི་སངས་རྒྱས་ཀྱི་ཚིག་བླ་དབ༹གས་ཡིན་ཏེ་།
 tadyathā mañjuśrīr iyaṃ mahāpṛthivī mahāvaiḍūryamayī saṃsthitā bhavet |	འཇམ་དཔལ་འདི་ལྟ་སྟེ་དཔེར་ན་། ས་གཞི་ཆེན་པོ་འདི་བེཨེ་དའུརྱ་རིན་པོ་ཆེའི་རང་བཞིན་དུ་ཀུན་ནས་གནས་པར་གྱུར་ཅིང་།
 evaṃ ca saṃsthitā bhaved yathā tasyāṃ vaiḍūryamayāṃ mahāpṛthivyāṃ trayastriṃśadbhavanasya,	དེའང་ཇི་ལྟར་བེཨེ་དའུརྱ་ཆེན་པོའི་རང་བཞིན་གྱིས་གཞི་ཆེན་པོ་དེ་ལ་སུམ་ཅུ་རྩ་གསུམ་པའི་གནས་དང་། 
 śakrasya devānām indrasya, vaijayantasya ca prāsādasya pratibhāsaḥ saṃdṛśyet |	ལྷའི་དབང་པོ་བརྒྱ་བྱིན་པ་དང་། ཁང་བསང་རྣམ་པར་རྒྱལ་བ་བྱེད་ཀྱི་གཟུགས་བརྙན་ཀུན་ཏུ་སྣང་བར་འགྱུར་བ་དེ་ལྟར་ཀུན་ནས་གནས་པར་གྱུར་ལ་།
 śakraś ca devānām indras tatra divyaiḥ pañcabhiḥ kāmaguṇaiḥ krīḍan ramamāṇaḥ paricārayan saṃdṛśyet |	དེ་ན་ལྷའི་དབང་པོ་བརྒྱ་བྱིན་ལྷའི་འདོད་པའི་ཡོན་ཏན་ལྔ་པོ་དག་གིས་རྩེ་བ་དང་། དགའ་བ་དང་། དགའ་མགུར་སྤྱོད་པའང་ཀུན་ཏུ་༄༤༨༨བ་སྣང་བར་གྱུར་ཅིང་༎
 atha tasmin samaye devāḥ sarvajambūdvīpakāḥ strīpuruṣadārakadārikāḥ saṃcodayeyuḥ |	དེ་ནས་དེའི་ཚེ་ལྷ་རྣམས་ཀྱིས་ཛམབུའི་གླིང་གི་སྐྱེས་པ་དང་། བུད་མེད་དང་། ཁྱེའུ་དང་། བུ་མོ་ཐམས་ཅད་ལ་ཚིག་འདི་སྐད་ཅེས་།
 āgacchatha bho naranāryaḥ |	ཀྱེ་སྐྱེས་པ་དང་བུད་མེད་དག་ཚུར་ཤོག་།
 paśyatemaṃ śakraṃ devānām indraṃ vaijayante prāsāde divyaiḥ pañcabhiḥ kāmaguṇaiḥ krīḍantaṃ ramantaṃ paricārayantam |	ལྷའི་དང་པོ་བརྒྱ་བྱིན་འདི་ཁ་གང་བཟང་རྣམ་པར་རྒྱས་བྱེད་ཀྱི་ནང་ན་། ལྷའི་འདོད་པའི་ཡོན་ཏན་ལྔ་པོ་དག་གིས་བརྩེ་བ་དང་དགའ་བ་དང་དགའ་མགུར་སྤྱོད་པར་བྱེད་པ་ལྟོས་། 
 āgacchatha bho naranārigaṇāḥ |	ཀྱེ་སྐྱེས་པ་དང་བུད་མེད་ཀྱི་ཚོགས་དག་ཚུར་ཤོག་།
 dānāni dadata puṇyāni kuruta |	སྦྱིན་པ་དག་བྱིན་ཅིག་། བསོད་ནམས་དག་གྱིས་ཤིག་།
 śīlaṃ ca samādāya vartayata |	ཚུལ་ཁྲིམས་ཡང་དག་པར་བླངས་ཏེ་འདུག་ཅིག་དང་། ཁང་བཟང་རྣམ་པར་རྒྱལ་བྱེད་འདི་ལྟ་བུ་དག་གི་ནང་ན་བརྩེ་བར་འགྱུར་། དགའ་བར་འགྱུར་།
 īdṛśeṣu vaijayanteṣu prāsādeṣu krīḍiṣyatha ramiṣyatha paricārayiṣyatha śakratvāni ca kariṣyatha |	དགའ་མགུར་སྤྱད་པར་འགྱུར་ཞིང་། བརྒྱ་བྱིན་ཉིད་ཐོབ་པར་ཡང་འགྱུར་ལ་།
 īdṛśyā ca riddhyā samanvāgatā bhaviṣyatha | yādṛśyā ca śakro devānām indro divyaiḥ paribhogaiḥ samarpitaḥ samanvaṅgībhūta iti |	ལྷའི་དབང་པོ་བརྒྱ་བྱིན་ལྷའི་ལོངས་སྤྱོད་དག་གིས་འབྱོར་ཅིང་ལྡན་པར་གྱུར་པ་ཅི་འདྲ་བ་དེ་འདྲ་བའི་འབྱོར་པ་དག་དང་ལྡན་པ་འགྱུར་རོ་༎ ཞེས་ཡང་དག་པར་སྐུལ་བར་ཡང་བྱེད་ལ་།
 atha mañjuśrīs te strīpuruṣadārakadārikās tasyāṃ vaiḍūryamayāṃ mahāpṛthivyāṃ trayastriṃśadbhavanasya, vaijayantasya prāsādasya, śakrasya devānām indrasya pratibhāsaṃ dṛṣṭvāñjalipragṛhaṃ kuryuḥ |	འཇམ་དཔལ་དེ་ནས་སྐྱེས་པ་དང་། བུད་མེད་དང་། ཁྱེའུ་དང་། བུ་མོ་དེ་དག་གིས་བེཨེ་དའུརྱ་ཆེན་པོའི་རང་བཞིན་གྱིས་གཞི་ཆེན་པོ་དེ་ལ་སུམ་ཅུ་རྩ་གསུམ་པའི་གནས་དང་། ཁང་བཟང་རྣམ་པར་རྒྱལ་བྱེད་དང་། ལྷའི་དབང་པོ་བརྒྱ་བྱིན་གྱི་གཟུགས་བརྙན་མཐོང་ནས་ཐལ་མོ་སྦྱོར་ཞིང་མེ་ཏོག་དག་ཀྱང་འཐོར་བར་བྱེད་། 
 puṣpāṇi ca kṣiperan (jāa 27)	སྤོས་དག་ཀྱང་འཐོར་བར་བྱེད་ལ་།
 gandhāṃś ca kṣiperann evaṃ vācaṃ bhāṣante | vayam apy evaṃrūpā bhavema yādṛśaḥ śakro devānām indraḥ,	ཚིག་འདི་སྐད་ཅེས་བདག་ཅག་ཀྱང་ལྷའི་དབང་པོ་བརྒྱ་བྱིན་ཅི་འདྲ་བ་དེ་འདྲ་བའི་༄༤༨༩ཨ་༌༎
 vayam apy evaṃ vaijayante prāsāde krīḍema ramema parivārayema yathāyaṃ śakro devānām indra iti |	ལུས་ཐོབ་པར་གྱུར་ཅིག་། བདག་ཅག་ཀྱང་ཇི་ལྟར་ལྷའི་དབང་པོ་བརྒྱ་བྱིན་འདི་ཁང་བཟང་རྣམ་པར་རྒྱལ་བྱེད་ཀྱི་ངན་ན་ལྷའི་འདོད་པའི་ཡོན་ཏན་ལྔ་པོ་དག་གིས་རྩེ་བ་དང་། དགའ་བ་དང་། དགའ་མགུར་སྤྱོད་པར་བྱེད་པ་དེ་ལྟར་གྱུར་ཅིག་།
 na ca te sattvā evaṃ saṃjānanti sma | pratibhāso 'yaṃ vaiḍūryamayāṃ mahāpṛthivyāṃ yatra trayastriṃśadbhavanam, vaijayantaś ca prāsādaḥ,	ཅེས་བརྗོད་པར་བྱེད་ཀྱང་སེམས་ཅན་དེ་དག་གིས་ནི༏་འདི་ལྟར་བེཨེ་དའུརྱ་ཆེན་པོའི་རང་བཞིན་གྱིས་གཞི་ཆེན་པོ་ལ་སུམ་ཅུ་རྩ་གསུམ་པའི་གནས་དང་། 
 śakraś ca devānām indraḥ pariśuddhatvād mahāvaiḍūryasya pratibhāsaḥ saṃdṛśyata iti |	ཁང་བཟང་རྣམ་པར་རྒྱལ་བྱེད་དང་། ལྷའི་དབང་པོ་བརྒྱ་བྱིན་སྣང་བ་འདི་ནི་། བེཨེ་དའུརྱ་ཆེན་པོའི་རང་བཞིན་ཡོངས་སུ་དག་པའི་ཕྱིར་གཟུགས་བརྙན་ཀུན་ཏུ་སྣང་བ་ཡིན་ནོ་༎ ཞེས་དེ་ལྟར་ཡོངས་སུ་མི་ཤེས་ཏེ་།
 te śakratvam abhinandanto dānāni ca dadati,	དེ་དག་བརྒྱ་བྱིན་ཉིད་འདོད་པས་སྦྱིན་པ་དག་ཀྱང་སྦྱིན་།
 puṇyāni ca kurvanti,	བསོད་ནམས་ཀྱང་བྱེད་།
 śīlaṃ ca samādāya vartante | tatra ca trayastriṃśadbhavane pratibhāsa upapattaye kuśalamūlāni ca pariṇāmayanti |	ཚུལ་ཁྲིམས་ཡང་དག་བར་བླངས་ཏེ་གནས་ཤིང་དགེ་བའི་རྩ་བ་དག་ཀྱང་སུམ་ཅུ་རྩ་གསུམ་པའི་གནས་སྣང་བ་དེར་སྐྱེ་བར་བྱ་བའི་ཕྱིར་ཡོངས་སུ་བསྔོ་བར་བྱེད་ན་།
 yathā mañjuśrīḥ tatra ca vaiḍūryamayāṃ mahāpṛthivyāṃ nāsti tatra trayastriṃśadbhavanam,	འཇམ་དཔལ་། ཇི་ལྟར་བེཨེ་དའུརྱ་ཆེན་པོའི་རང་བཞིན་གྱིས་གཞི་ཆེན་པོ་དེ་ལ་སུམ་ཅུ་རྩ་གསུམ་པའི་གནས་ཀྱང་མེད་། 
 na vaijayantaś ca prāsādaḥ,	ཁང་བཟང་རྣམ་པར་རྒྱལ་བྱེད་ཀྱང་མེད་།
 na ca śakro devānām indraḥ |	ལྷའི་དབང་པོ་བརྒྱ་བྱིན་ཡང་མེད་མོད་ཀྱི་།
 api tu pariśuddhatvād mahāvaiḍūryasya saṃdṛśyate trayastriṃśadbhavanam,	འོན་ཀྱང་བེཨེ་དའུརྱ་ཆེན་པོ་ཡོངས་སུ་དག་༄༤༨༩བ་པའི་ཕྱིར་དེ་ལ་སུམ་ཅུ་རྩ་གསུམ་པའི་གནས་དང་། 
 vaijayantaś ca prāsādaḥ, śakrasya devānām indraḥ |	ཁང་བཟང་རྣམ་པར་རྒྱལ་བྱེད་དང་། ལྷའི་དབང་པོ་བརྒྱ་བྱིན་གྱི་གཟུགས་བརྙན་ཀུན་ཏུ་སྣང་སྟེ་།
 sa cāsan notpanno na niruddhaḥ pariśuddhatvād mahāvaiḍūryasya pratibhāsaḥ saṃdṛśyate |	དེ་དག་ཀྱང་ཡོད་པ་མ་ཡིན་ཞིང་སྐྱེ་བ་མེད་པ་དང་། འགག་པ་མ་ཡིན་བཞིན་དུ་བེཨེ་དའུརྱ་ཆེན་པོ་ཡོངས་སུ་དག་པའི་ཕྱིར་གཟུགས་བརྙན་ཀྱང་ཀུན་ཏུ་སྣང་བ་དེ་བཞིན་པུ་འཇམ་དཔལ་།
 evam eva mañjuśrīḥ pariśuddhatvāc cittasya subhāvitatvād bhāvanāyāḥ sattvānāṃ tathāgatātmabhāvadarśanaṃ bhavati |	སེམས་ཡོངས་སུ་དག་པ་དང་། སྒོམ་པ་ཤིན་ཏུ་གོམས་པར་བྱས་པའི་སེམས་ཅན་ལ་དེ་བཞིན་གཤེགས་པའི་སྐུ་སྣང་བར་གྱུར་། འཇམ་དཔལ་།
 tathāgatānubhāvena mañjuśrīḥ sattvās tathāgataṃ paśyanti |	དེ་བཞིན་གཤེགས་པའི་མཐུས་སེམས་ཅན་རྣམས་ཀྱིས་དེ་བཞིན་གཤེགས་པའི་སྐུ་མཐོང་བ་དེའང་མ་བྱུང་བ་། མ་སྐྱེས་པ་། མ་འགག་པ་། དངོས་པོ་མ་ཡིན་། དངོས་པོ་མེད་པ་མ་ཡིན་། བལྟར་སྣང་བ་མ་ཡིན་།
 sa cābhūto 'nutpanno 'niruddho na bhāvo nābhāvo na dṛśyo nādṛśyo na lokyo nālokyo na caityo nācaityo na san nāsan |	བལྟར་མི་སྣང་བ་མ་ཡིན་། འཇིག་རྟེན་མ་ཡིན་། འཇིག་རྟེན་མེད་པ་མ་ཡིན་། སེམས་པ་ཡོད་པ་མ་ཡིན་། སེམས་པ་མེད་པ་མ་ཡིན་། བསམ་དུ་ཡོད་པ་མ་ཡིན་། བསམ་དུ་མེད་པ་མ་ཡིན་། ཡོད་པ་མ་ཡིན་། མེད་པ་མ་ཡིན་མོད་ཀྱི་།
 atha ca mañjuśrīḥ sattvās tathāgatapratibhāsam ārambaṇīkṛtvā puṣpāṇi kṣipanti,	འཇམ་དཔལ་། འོན་ཀྱང་སེམས་ཅན་རྣམས་ནི་། དེ་བཞིན་གཤེགས་པའི་གཟུགས་བརྙན་ལ་དམིགས་ནས་མེ་ཏོག་ཀྱང་འཐོར་བར་བྱེད་།
 gandhān vastrāṇi ratnāni ca kṣipanti |	སྤོས་དང་། ན་བཟའ་དང་། རིན་པོ་ཆེ་དག་ཀྱང་དབུལ་བར་བྱེད་།
 evaṃ ca vācaṃ bhāṣante |	ཚིག་འདི་སྐད་ཅེས་བདག་ཅག་ཀྱང་དེ་༄༤༩༠ཨ་༌༎
 vayam apy evaṃrūpā bhavema yādṛśas tathāgato 'rhan samyaksaṃbuddha iti |	བཞིན་གཤེགས་པ་དགྲ་བཅོམ་པ་ཡང་དག་པར་རྫོགས་པའི་སངས་རྒྱས་ཅི་འདྲ་བ་དེ་འདྲ་བར་གྱུར་ཅིག་། ཅེས་བརྗོད་པར་བྱེད་དེ་།
 te buddhajñānābhilāṣiṇo dānāni ca dadati,	སངས་རྒྱས་ཀྱི་ཡེ་ཤེས་འདོད་པ་དེ་དག་བདག་ཀྱང་སྦྱིན་པ་དག་ཀྱང་སྦྱིན་།
 puṇyāni ca kurvanti,	བསོད་ནམས་དག་ཀྱང་བྱེད་།
 śīlaṃ ca samādāya vartante | tac ca kuśalamūlaṃ tathāgatajñānapratilambhāya (jāa 28) pariṇāmayanti |	ཚུལ་ཁྲིམས་ཡང་དག་པར་བླངས་ཏེ་གནས་ཤིང་དེ་དག་ཀྱང་དེ་བཞིན་གཤེགས་པའི་ཡེ་ཤེས་ཐོབ་པར་བྱ་བའི་ཕྱིར་ཡོངས་སུ་བསྔོ་བར་བྱེད་དོ་༎ འཇམ་དཔལ་།
 tadyathā mañjuśrīs tatra mahāvaiḍūryamayāṃ mahāpṛthivyāṃ śakrasya devānām indrasya pratibhāso neñjati,	འདི་ལྟ་སྟེ་། དཔེར་ན་། བེཨེ་དའུརྱ་ཆེན་པོའི་རང་བཞིན་གྱིས་གཞི་ཆེན་པོ་དེ་ལ་ལྷའི་དབང་པོ་བརྒྱ་བྱིན་གྱི་གཟུགས་བརྙན་སྣང་བ་དེ་ག-ཡོ་བར་མི་བྱེད་།
 na manyate,	སེམས་པར་མི་བྱེད་།
 na prapañcayati,	སྤྲོ་བར་མི་བྱེད་།
 na kalpayati,	རྟོག་པར་མི་བྱེད་།
 na vikalpayati |	རྣམ་པར་རྟོག་པར་མི་བྱེད་ཅིང་། རྟོག་པ་མེད་པ་། རྣམ་པར་རྟོག་པ་མེད་པ་། སེམས་པ་མེད་པ་། ཡིད་ལ་བྱེད་པ་མེད་པ་། ཞི་བ་། བསིལ་བར་གྱུར་པ་། སྐྱེ་པ་མེད་པ་། འགག་པ་མེད་པ་།
 akalpo 'vikalpo 'cintyo 'manasikāraḥ śāntaḥ śītībhūto 'nutpādo 'nirodho 'dṛṣṭo 'śruto 'nāghrāto 'nāsvādito 'spṛṣṭo 'nimitto 'vijñaptiko 'vijñāpanīyaḥ	མཐོང་བ་མེད་པ༏་ཐོས་པ་མེད་པ་། བསྣམས་པ་མེད་པ་། མྱངས་པ་མེད་པ་། རེག་པ་མེད་པ་། མཚན་མ་མེད་པ་། རྣམ་པར་རིག་པ་མེད་པ་།
 evam eva mañjuśrīs tathāgato 'rhan samyaksambuddho neñjati,	རྣམ་པར་རིག་པར་བྱ་བ་མ་ཡིན་པ་། དེ་བཞིན་དུ་འཇམ་དཔལ་། དེ་བཞིན་གཤེགས་པ་དགྲ་བཅོམ་པ་ཡང་དག་པར་རྫོགས་པའི་སངས་རྒྱས་ཀྱང་ག-ཡོ་བར་མི་བྱེད་།
 na manyate,	སེམས་པར་མི་བྱེད་།
 na prapañcayati,	སྤྲོ་བར་མི་བྱེད་།
 na kalpayati,	༄༤༩༠བ་རྟོག་པར་མི་བྱེད་།
 na vikalpayati |	རྣམ་པར་རྟོག་པར་མི་བྱེད་ཅིང་། རྟོག་པ་མེད་པ་། རྣམ་པར་རྟོག་པ་མེད་པ་། སེམས་པ་མེད་པ་། ཡིད་ལ་བྱེད་པ་མེད་པ་། ཞི་བ་། བསིལ་བར་གྱུར་པ་། སྐྱེ་བ་མེད་པ་། འགག་པ་མེད་པ་། མཐོང་བ་མེད་པ་། ཐོས་པ་མེད་པ་། བསྣམས་པ་མེད་པ་། མྱངས་པ་མེད་པ་།
 akalpo 'vikalpo 'cintyo 'manasikāraḥ śāntaḥ śītībhūto 'nutpādo 'nirodho 'dṛṣṭo 'śruto 'nāghrāto 'nāsvādito 'spṛṣṭo 'nimitto 'vijñaptiko 'vijñāpanīyaḥ	རེག་པ་མེད་པ་། མཚན་མ་མེད་པ་། རྣམ་པར་རིག་པ་མེད་པ་། རྣམ་པར་རིག་པར་བྱ་བ་མ་ཡིན་པ་སྟེ་།
 anutpādagatiko hi mañjuśrīs tathāgataḥ |	འཇམ་དཔལ་། དེ་བཞིན་གཤེགས་པ་ནི་། སྐྱེ་བ་མེད་པའི་གནས་ཡིན་མོད་ཀྱི་།
 atha ca pratibimba iva lokeṣu dṛśyate | yathādhimuktikānāṃ ca sattvānāṃ darśanavaimātratayā, āyuḥpramāṇavaimātratāṃ darśayati |	འོན་ཀྱང་འཇིག་རྟེན་ན་གཟུགས་བརྙན་བཞིན་དུ་སྣང་ཞིང་སེམས་ཅན་རྣམས་ཀྱི་མོས་པ་ཇི་ལྟ་བ་བཞིན་དུ་མཐོང་བའི་བྱེ་བྲག་གིས་ཚེའི་བྱེ་བྲག་སྟོན་པར་ཡང་བྱེད་ལ་།
 paripācanādhimuktibalādhānatayā bodhibhājaneṣu sattveṣu pratibhāsaprāpto bhavati |	ཡོངས་སུ་སྨིན་པ་དང་མོས་པའི་སྟོབས་བསྐྱེད་པས་བྱང་ཆུབ་ཀྱི་སྣོད་དུ་གྱུར་པའི་སེམས་ཅན་རྣམས་ལ་གཟུགས་བརྙན་སྣང་བར་ཡང་འགྱུར་ཏེ་།
 yathāśayādhimuktyā ca sattvā dharmaṃ śṛṇvanti |	སེམས་ཅན་རྣམས་ཀྱི་བསམ་པ་དང་མོས་པ་ཇི་ལྟ་བ་བཞིན་དུ་ཐོས་པར་ཡང་འགྱུར་།
 yathāśayena triyānam iti saṃjānanti,	བསམ་པ་ཇི་ལྟ་བ་བཞིན་དུ་ཐེག་པ་གསུམ་དུ་ཤེས་པར་ཡང་འགྱུར་།
 yathāśayena cādhimucyante || §7 ms| 5b5-7b2, p| 306b4-308b1, d| 280b1-282a4, t| 357 241a4-241b21, t| 358 ö, t| 359(d) 255b23-256a9	བསམ་པ་ཇི་ལྟ་བ་བཞིན་དུ་རྣམ་པར་གྲོལ་བར་ཡང་འགྱུར་རོ་༎ འཇམ་དཔལ་།
 tadyathā mañjuśrīr devānāṃ trayastriṃśānāṃ puṇyabalapariniṣpannānāṃ dharmaśabdānāṃ mahādharmadundubhir upari vaijayantasya prasādasyāntarīkṣagatā adṛśyā,	འདི་ལྟ་སྟེ་། དཔེར་ན་། སུམ་ཅུ་རྩ་གསུམ་པའི་ལྷ་རྣམས་ཀྱི་བསོད་ནམས་ཀྱི་སྟོབས་ཀྱིས་གྲུབ་པའི་ཆོས་ཀྱི་རྔ་བོ་ཆེ་ཆོས་ཀྱི་སྒྲ་ཞེས་བྱ་བ་ཞིག་ཁང་བཟང་རྣམ་པར་རྒྱལ་བྱེད་ཀྱི་སྟེང་གི་བར་སྣང་ལ་འདུག་ཅིང་༄༤༩༡ཨ་༌༎ ལྷའི་བུ་ཐམས་ཅད་ཀྱི་མིག་ལམ་ལས་ཡང་དག་པར་འདས་ཏེ་བལྟར་མི་སྣང་ཞིང་མི་མཐོང་མོད་ཀྱི་། འཇམ་དཔལ་།
 anālokyā sarvadevaputraiḥ | atha ca punar mañjuśrīḥ sā mahādharmadundubhiḥ | yasmin (jāa 29) samaye devās trayastriṃśatkāyikā tīvrasatatasamitaṃ divyaiḥ kāmakrīḍāratiparibhogaiḥ pramattā bhavanti,	འོན་ཀྱང་ཆོས་ཀྱི་རྔ་བོ་ཆེ་དེ་གང་གི་ཚེ་སུམ་ཅུ་རྩ་གསུམ་པའི་རིས་ཀྱི་ལྷ་རྣམས་ལྷའི་འདོད་པའི་རྩེད་མོ་དང་། དགའ་བ་དང་། ལོངས་སྤྱོད་དག་གིས་རྟག་པར་རྒྱུན་དུ་ཤེས་ཆེར་བག་མེད་པར་གྱུར་ཅིང་།
 na bhūyaḥ sudharmāyāṃ devasabhāyāṃ praviśya dharmaṃ saṃgāyanti,	ཡང་དང་ཡང་དུ་ལྷའི་འདུན་ས་ཆོས་བཟང་གི་ནང་དུ་ཞུགས་ཏེ་། ཆོས་ཡང་དག་པར་བགྲོ་བར་མི་བྱེད་པ་དང་། འཇམ་དཔལ་།
 śakraś ca yadā devānām indro divyaiḥ kāmakrīḍaratiparibhogaiḥ pramatto bhavati,	གང་གི་ཚེ་ལྷའི་དབང་པོ་བརྒྱ་བྱིན་ཡང་ལྷའི་འདོད་པའི་རྩེད་མོ་དང་། དགའ་བ་དང་། ལོངས་སྤྱོད་དག་གིས་རྟག་པར་རྒྱུན་དུ་ཤས་ཆེར་བག་མེད་པར་གྱུར་ཅིང་།
 na dharmāsane niṣadya dharmaṃ bhāṣate | tasmin samaye mañjuśrīḥ sā mahādharmadundubhir adṛṣyā cānālokyā cakṣuḥpathasamatikrāntāntarīkṣagatā tādṛśaṃ dharmaśabdaṃ niścārayati |	ཡང་དང་ཡང་དུ་ལྷའི་འདུན་ས་ཆོས་བཟང་གི་ནང་དུ་ཞུགས་ཏེ་ཆོས་ཀྱི་ཁྲི་སྟན་ལ་འདུག་ནས་ཆོས་སྨྲ་བར་མི་བྱེད་པ་དེའི་ཚེ་ཆོས་ཀྱི་རྔ་བོ་ཆེ་བར་སྣང་ལ་འདུག་ཅིང་། མིག་གི་ལམ་ལས་ཡང་དག་པར་འདས་ཏེ་། བལྟར་མི་སྣང་ཞིང་མི་མཐོང་བ་དེ་ལས་ཆོས་ཀྱི་སྒྲ་འདི་ལྟ་བུ་འབྱུང་བར་འགྱུར་ཏེ་།
 yena ca dharmaśabdena sarvān trayastriṃśatkāyikān devān svareṇa vijñapayati |	ཆོས་ཀྱི་སྒྲ་དེས་སུམ་ཅུ་རྩ་གསུམ་པའི་རིས་ཀྱི་ལྷ་ཐམས་ཅད་ལ་འདི་སྐད་དུ་།
 anityā mārṣā rūpaśabdagandharasasparśā mā pramattacāriṇo bhavatha |	གྲོགས་པོ་དག་། གཟུགས་དང་། སྒྲ་དང་། དྲི་དང་། རོ་དང་། རེག་བྱ་དག་ནི་། མི་རྟག་པ་ཡིན་གྱི་།
 mā kṣipram asmād bhavanāc cyaviṣyatha |	བག་མེད་པར་མ་སྤྱོད་ཅིག་། གནས་འདི་༄༤༩༡བ་ནས་མྱུར་དུ་ཤི་འཕོས་པར་གྱུར་ཏ་རེ་།
 duḥkhā mārṣāḥ sarvasaṃskārāḥ,	གྲོགས་པོ་དག་། འདུ་བྱེད་ཐམས་ཅད་ནི་། སྡུག་བསྔལ་བ་ཡིན་ནོ་༎ གྲོགས་པོ་དག་།
 anātmano mārṣāḥ sarvasaṃskārāḥ,	འདུ་བྱེད་ཐམས་ཅད་ནི་། སྟོང་པ་ཡིན་ནོ་༎
 śūnyā mārṣāḥ sarvasaṃskārā mā pramādam āpadyatha |	གྲོགས་པོ་དག་། འདུ་བྱེད་ཐམས་ཅད་ནི་། བདག་མེད་པ་ཡིན་ནོ་༎ གྲོགས་པོ་དག་།
 duḥkham itaś cyavitānāṃ punar atropapattir bhaviṣyati |	འདི་ནས་ཤི་འཕོས་པ་རྣམས་ནི་། ཡང་འདིར་སྐྱེ་བར་འགྱུར་བ་དཀའ་བ་ཡིན་གྱི་། བག་མེད་པར་མ་བྱེད་པར་གྲོགས་པོ་དག་།
 saṃgāyata mārṣā dharmam,	ཆོས་ཡང་དག་པར་བགྲོ་བར་གྱིས་ཤིག་།
 dharmārāmaratiratā bhavatha dharmasārāḥ, dharmanimnāḥ,	ཆོས་ཀྱི་ཀུན་དགའ་ལ་དགའ་བས་དགའ་བར་གྱིས་ཤིག་།
 dharmapravaṇāḥ, dharmānusmṛtimanasikārāḥ |	ཆོས་གཅེས་པར་བྱ་བ་དང་། ཆོས་ལ་གཞོལ་བ་དང་། ཆོས་རྗེས་སུ་དྲན་པ་ཡིད་ལ་བྱེད་པ་ལ་གནས་པར་གྱིས་ཤིག་།
 mārṣā viharatha yūyaṃ punar ebhir evaṃ divyaiḥ kāmakrīḍāratiparibhogaiḥ,	ལྷའི་འདོད་པའི་རྩེད་མོ་དང་། དགའ་བ་དང་། ལོངས་སྤྱོད་འདི་དག་དང་ཡང་མི་འབྲལ་བར་གྱིས་ཤིག་། ཅེས་སྒྲས་གོ་བར་བྱེད་དོ་༎ འཇམ་དཔལ་། དེའི་ཚེ་ན་ཆོས་ཀྱི་རྔ་བོ་ཆེ་དེ་བལྟར་མི་སྣང་བ་། གཟུགས་མེད་པ་། རྟོག་པ་མེད་པ་། རྣམ་པར་རྟོག་པ་མེད་པ་། མིག་གི་ལམ་ལས་ཡང་དག་པར་འདས་པ་།
 avirahitā bhaviṣyatheti | tena khalu punar mañjuśrīḥ samayena tasyā adṛśyā arūpiṇyā akalpyāyā avikalpāyāś cakṣuḥpathasamatikrāntāyā	མ་སྐྱེས་པ་། མ་འགགས་པ་། ཚིག་གི་ལམ་ལས་ཡང་དག་པར་འདས་པ་།
 anutpannāniruddhāyā vākpathasamatikrāntāyāś cittamanovijñānāpagatāyā mahādharmadundubheḥ śabdena sarve trayastriṃśatkāyikā devāḥ saṃcoditā bhītās trastā udvignodvignāḥ (jāa 30)	སེམས་དང་། ཡིད་དང་། རྣམ་པར་ཤེས་པ་དང་བྲལ་བ་དེ་ལྟ་བུ་དེའི་སྒྲ་དེས་སུམ་ཅུ་རྩ་གསུམ་པའི་རིས་ཀྱི་ལྷ་ཐམས་ཅད་ལ་ཡང་དག་པར་བསྐུལ་བས་དེ་དག་འཇིགས་པ་དང་། སྐྲག་པ་དང་། སྐྱོ་བ་དང་། ཡིད་བྱུང་བར་གྱུར་ནས་༄༤༩༢ཨ་༌༎
 sudharmāyāṃ devasabhāyāṃ praviśya dharmārāmaratiratā viharanti | dharmasārāḥ, dharmanimnāḥ,	ལྷའི་འདུན་ས་ཆོས་བཟང་གི་ནང་དུ་ཞུགས་ཏེ་ཆོས་ཀྱི་ཀུན་དགའ་ལ་དགའ་བས་དགའ་བར་གནས་ཤིང་། 
 dharmapravaṇāḥ, dharmānusmṛtimanasikārā bhavanti |	ཆོས་གཅེས་པར་བྱ་བ་དང་། ཆོས་ལ་གཞོལ་བར་བྱ་བ་དང་། ཆོས་རྗེས་སུ་དྲན་པ་ཡིད་ལ་བྱེད་པ་ལ་གནས་པར་ཡང་བྱེད་དེ་།
 te tataś cyutā viśeṣagāmino bhavanti | śakraś ca devānām indras tasmin samaye sudharmāyāṃ devasabhāyāṃ praviśya dharmāsane niṣadya dharmaṃ deśayati |	དེ་དག་དེ་ནས་ཤི་འཕོས་ནས་ཁྱད་པར་དུ་འགྲོ་བར་ཡང་ཤེས་སོ༏་༏དེའི་ཚེ་ན་ལྷའི་དབང་པོ་བརྒྱ་བྱིན་ཡང་ལྷའི་འདུན་ས་ཆོས་བཟང་གི་ནང་དུ་ཞུགས་ཏེ་ཆོས་ཀྱི་ཁྲི་སྟན་ལ་འདུག་ནས་ཆོས་སྟོན་པར་བྱེད་དོ་༎
 yadā ca mañjuśrīr asurā devaiḥ sārdhaṃ saṃgrāmayanti |	འཇམ་དཔལ་། གང་གི་ཚེ་ལྷ་མ་ཡིན་རྣམས་ལྷ་རྣམས་དང་ལྷན་ཅིག་ག-ཡུལ་སྤྲོད་པར་བྱེད་ཅིང་།
 tatra yadā trayastriṃśā devāḥ parābhavaṃ gacchanti | tadā sā dharmadundubhī tādṛśaśabdaṃ niścārayati |	དེར་ཡང་གང་གི་ཚེ་སུམ་ཅུ་རྩ་གསུམ་པའི་ལྷ་རྣམས་ཕམ་པར་གྱུར་པ་དེའི་ཚེ་ན་ཆོས་ཀྱི་རྔ་བོ་ཆེ་དེ་སྒྲ་འདི་ལྟ་བུ་འབྱིན་པར་བྱེད་དེ་། 
 yena śabdenāsurā bhītās trastā udvignodvignāḥ palāyanti |	སྒྲ་དེས་ལྷ་མ་ཡིན་རྣམས་འཇིགས་པ་དང་། སྐྲག་པ་དང་། སྐྱོ་བ་དང་། ཡིད་བྱུང་བར་གྱུར་ནས་འབྲོས་པར་བྱེད་དོ་༎
 na ca mañjuśrīs tasyā mahādharmadundubheḥ kaścit saṃpādayitā vātmabhāvo vā saṃvidyate | adṛśyā mañjuśrīḥ sā mahādharmadundubhir anālokyāsatyābhūtācittācetanānimittārūpiṇyarutānātmabhāvādvayā cakṣuḥpathasamatikrāntā |	འཇམ་དཔལ་། ཆོས་ཀྱི་རྔ་བོ་ཆེ་དེ་ལ་ནི་། སྒྲུབ་པར་བྱེད་པ་དང་། ལུས་གཟུགས་ཅུང་ཟད་ཀྱང་མེད་དེ་། འཇམ་དཔལ་། ཆོས་ཀྱི་རྔ་བོ་ཆེ་དེ་ནི་། བལྟར་མི་མཐོང་བ་། མི་སྣང་བ༏་ཡོད་པ་མ་ཡིན་པ་། མ་བྱུང་བ་། བསམ་དུ་མེད་པ་། སེམས་པ་མེད་པ་། མཚན་མ་མེད་པ་། གཟུགས་ཅན་མ་ཡིན་པ་། སྒྲ་མེད་པ་། དངོས་པོ་མེད་པ་། གཉིས་༄༤༩༢བ་སུ་མེད་པ་སྟེ་། མིག་གི་ལམ་ལས་ཡང་དག་པར་འདས་པ་ཡིན་མོད་ཀྱི་།
 atha ca mañjuśrīs trayastriṃśatkāyikānāṃ devaputrāṇāṃ pūrvaparikarmakṛtānāṃ mahādharmadundubheḥ śabdo niścarati | trāyastriṃśānāṃ devaputrāṇāṃ sarvopadravopāyāsopakleśopaśāntaye saṃvartate |	འཇམ་དཔལ་། འོན་ཀྱང་སུམ་ཅུ་རྩ་གསུམ་གྱི་རིས་ཀྱི་ལྷའི་བུ་སྔོན་ཡོངས་སུ་སྦྱངས་པ་བྱས་པ་རྣམས་ལ་ཆོས་ཀྱི་རྔ་བོ་ཆེ་དེ་སྒྲ་དེ་ལྟ་བུ་འབྱིན་ཅིང་སུམ་ཅུ་རྩ་གསུམ་པའི་རིས་ཀྱི་ལྷའི་བུ་རྣམས་ཀྱི་གནོད་པ་དང་། འཁྲུག་པ་དང་། ཉེ་བའི་ཉོན་མོངས་པ་ཐམས་ཅད་ཉེ་བར་ཞི་བར་བྱེད་དོ་༎ འཇམ་དཔལ་།
 yathā mañjuśrīs tasyā mahādundubher adṛśyo 'nātmabhāvo 'nālokyo 'sann abhūto 'cinto 'cetano 'nimitto (jāa 31)	ཇི་ལྟར་ཆོས་ཀྱི་རྔ་བོ་ཆེ་དེ་བལྟར་མི་སྣང་བ་། མི་མཐོང་བ་། ཡོད་པ་མ་ཡིན་པ་། མ་བྱུང་བ་། བསམ་དུ་མེད་པ་། སེམས་པ་མེད་པ༏་མཚན་མ་མེད་པ་། གཟུགས་ཅན་མ་ཡིན་པ་། སྒྲ་མེད་པ་། དངོས་པོ་མེད་པ་།
 'rūpy aruto 'bhāvo 'dvayaś cakṣuḥpathasamatikrāntaḥ,	གཉིས་སུ་མེད་པ་སྟེ་། མིག་གི་ལམ་ལས་ཡང་དག་པར་འདས་པ་ཡིན་མོད་ཀྱི་། འཇམ་དཔལ་།
 pūrvakarmavipākena trayastriṃśatkāyikānāṃ devaputrāṇāṃ sarvopadravopāyāsopakleśopaśāntaye śabdo niścarati | pramattāṃś ca devaputrān dharmaśabdena saṃcodayati |	འོན་ཀྱང་སུམ་ཅུ་རྩ་གསུམ་པའི་རིས་ཀྱི་ལྷའི་བུ་སྔོན་ཡོངས་སུ་སྦྱངས་པ་བྱས་པ་རྣམས་ལ་ཆོས་ཀྱི་རྔ་བོ་ཆེ་དེ་སྒྲ་དེ་ལྟ་བུ་འབྱིན་ཅིང་སུམ་ཅུ་རྩ་གསུམ་པའི་རིས་ཀྱི་ལྷའི་བུ་རྣམས་ཀྱི་གནོད་པ་དང་། འཁྲུག་པ་དང་། ཉེ་བའི་ཉོན་མོངས་པ་ཐམས་ཅད་ཉེ་བར་ཞི་བར་བྱ་བའི་ཕྱིར་སྒྲ་འབྱིན་པར་བྱེད་ཅིང་ལྷའི་བུ་བག་མེད་པ་རྣམས་ལའང་ཆོས་ཀྱི་སྒྲས་ཡང་དག་པར་སྐུལ་བར་བྱེད་ལ་།
 sa ca dharmaśabdas trayastriṃśatkāyikānāṃ devaputrāṇāṃ sarvopadravopāyāsopakleśopaśāntaye saṃvartate |	ཆོས་ཀྱི་སྒྲ་དེའང་སུམ་ཅུ་རྩ་གསུམ་པའི་རིས་ཀྱི་ལྷའི་བུ་རྣམས་ཀྱི་གནོད་པ་དང་། འཁྲུག་པ་དང་། ཉེ་བའི་ཉོན་མོངས་༄༤༩༣ཨ་༌༎ པ་ཐམས་ཅད་ཉེ་བར་ཞི་བར་བྱེད་དོ་༎ འཇམ་དཔལ་།
 evam eva mañjuśrīs tathāgato 'rhan samyaksaṃbuddho 'dṛśyo 'nālokyo 'nātmabhāvo 'sann abhūto 'citto 'cetano 'nimitto 'rūpy aruto 'dvayo 'bhāvaś cakṣuḥpathasamatikrāntaḥ |	དེ་བཞིན་གཤེགས་པ་དགྲ་བཅོམ་པ་ཡང་དག་པར་རྫོགས་པའི་སངས་རྒྱས་ཀྱང་བལྟར་མི་སྣང་བ་། མི་མཐོང་བ་། ཡོད་པ་མ་ཡིན་པ་། མ་བྱུང་བ་། བསམ་དུ་མེད་པ་། སེམས་པ་མེད་པ་། མཚན་མ་མེད་པ་། གཟུགས་ཅན་མ་ཡིན་པ་། སྒྲ་མེད་པ༏་དངོས་པོ་མེད་པ་། གཉིས་སུ་མེད་པ་སྟེ་། མིག་གི་ལམ་ལས་ཡང་དག་པར་འདས་པ་ཡིན་མོད་ཀྱི་།
 atha ca mañjuśrīḥ sattvāḥ pūrvakarmavipākena yathāśayādhimuktyā dharmaśabdaṃ niścarantaṃ saṃjānanti |	འཇམ་དཔལ་། འོན་ཀྱང་སེམས་ཅན་རྣམས་སྔོན་གྱི་ལས་ཀྱི་རྣམ་པར་སྨིན་པས་བསམ་པ་དང་། མོས་པ་ཇི་ལྟ་བ་བཞིན་དུ་ཆོས་ཀྱི་སྒྲ་འབྱུང་བར་ཀུན་ཏུ་ཤེས་ཤིང་།
 sa ca dharmaśabdaḥ sarvasattvānāṃ sarvopadravopāyāsopakleśopaśāntaye saṃvartate |	ཆོས་ཀྱི་སྒྲ་དེའང་སེམས་ཅན་ཐམས་ཅད་ཀྱི་གནོད་པ་དང་། འཁྲུག་པ་དང་། ཉེ་བའི་ཉོན་མོངས་པ་ཐམས་ཅད་ཉེ་བར་ཞི་བར་བྱ་བའི་ཕྱིར་འཇུག་པར་འགྱུར་ཏེ་།
 dharmasvaranirghoṣeṇa tathāgataghoṣasvara iti loke saṃkhyāṃ gacchati |	ཆོས་ཀྱི་སྒྲ་སྐད་ཀྱིས་འཇིག་རྟེན་ན་དེ་བཞིན་གཤེགས་པའི་གསུང་ཞེས་བྱ་བའི་གྲངས་སུ་འགྲོའོ་༎
 nāsti ca mañjuśrīs tathāgataḥ,	འཇམ་དཔལ་། དེ་བཞིན་གཤེགས་པ་ནི་། ཡོད་པ་མ་ཡིན་མོད་ཀྱི་།
 atha ca dharmasvaraghoṣeṇa tathāgata iti prajñaptir loke saṃbhavati |	འོན་ཀྱང་འཇིག་རྟེན་ན་ཆོས་ཀྱི་སྒྲ་སྐད་ཀྱིས་དེ་བཞིན་གཤེགས་པ་ཞེས་བྱ་བར་གདགས་པ་འབྱུང་སྟེ་། 
 sattvānām eva pūrvakuśalakarmavipākena tathāgataśabdaṃ niścarantaṃ sattvāḥ saṃjānanti |	སེམས་ཅན་རྣམས་ཁོ་ནའི་སྔོན་གྱི་དགེ་བའི་རྩ་བའི་ལས་ཀྱི་རྣམ་པར་སྨིན་པས་སེམས་ཅན་ཐམས་ཅད་ཀྱིས་༄༤༩༣བ་དེ་བཞིན་གཤེགས་པ་ལས་སྒྲ་འབྱུང་བར་ཀུན་ཏུ་ཤེས་སོ་༎
 sarvasattvānāṃ sarvasukhajananārthaṃ pramattānāṃ ca saṃcodanārthaṃ śabdo niścarati |	སྒྲ་དེའང་སེམས་ཅན་ཐམས་ཅད་ཀྱི་བདེ་བ་ཐམས་ཅད་ཡང་དག་པར་བསྐྱེད་པར་བྱ་བ་དང་། བག་མེད་པ་རྣམས་ལ་ཡང་དག་པར་བསྐུལ་བར་བྱ་བའི་ཕྱིར་བྱུང་སྟེ་།
 te mañjuśrīḥ sattvāḥ śabdaṃ śrutvā tathāgataṃ saṃkalpayanti |	འཇམ་དཔལ་། སེམས་ཅན་དེ་དག་གིས་སྒྲ་དེ་ཐོས་ནས་འདི་ནི་།
 ayaṃ tathāgatasyātmabhāva iti |	དེ་བཞིན་གཤེགས་པའི་སྐུ་ཡིན་ནོ་༎
 ādikarmikāṇāṃ ca bodhisattvānāṃ sarvabālapṛthagjanānāṃ ca tathāgatārambaṇakuśalamūlasaṃjananārthaṃ tathāgatavāk śrūyate |	སྙམ་དུ་དེ་བཞིན་གཤེགས་པ་ལ་རྟོག་པར་ཡང་བྱེད་དོ་༎ བྱང་ཆུབ་སེམས་དཔའ་ལས་དང་པོ་པ་རྣམས་དང་། བྱིས་པ་སོ་སོའི་སྐྱེ་བོ་ཐམས་ཅད་དེ་བཞིན་གཤེགས་པ་ལ་དམིགས་པའི་དགེ་བའི་རྩ་བ་ཡང་དག་པར་བསྐྱེད་པར་བྱ་བའི་ཕྱིར་དེ་བཞིན་གཤེགས་པའི་གསུང་ཡང་ཐོས་མོད་ཀྱི་། འཇམ་དཔལ་།
 api tv anutpanno 'niruddho mañjuśrīs tathāgato veditavyaḥ || (jāa 32)	འོན་ཀྱང་དེ་བཞིན་གཤེགས་པ་དགྲ་བཅོམ་པ་ཡང་དག་པར་རྫོགས་པའི་སངས་རྒྱས་ནི་། སྐྱེ་བ་མེད་པ་དང་། འགག་པ་མེད་པ་ཡིན་པར་རིག་པར་བྱའོ་༎ འཇམ་དཔལ་།
 §8 ms| 7b2-8b4, p| 308b2-309b6, d| 282a4-283a5, t| 357 241b21-242a2, t| 358 ö, t| 359(d) 256a18-b21|	འདི་ལྟ་སྟེ་། དཔེར་ན་།
 tadyathā mañjuśrīr nidāghakālāvasāne varṣāṇāṃ prathame māsy āgate sattvānāṃ pūrvakarmavipākena pṛthivīgatānāṃ bījagrāmabhūtagrāmasya sarvatṛṇagulmauṣadhivanaspatīnāṃ saṃjananārtham upari vaihāyasy āntarīkṣa ākāśe tādṛśā vāyavo vānti | yenodakaṃ saṃbhavati |	སོས་ཀའི་དུས་ཀྱི་མཐར་ཐུག་ནས་དབྱར་ཟླ་ར་བ་བྱུང་བར་གྱུར་ཕན་སེམས་ཅན་རྣམས་ཀྱི་སྔོན་གྱི་ལས་ཀྱི་རྣམ་པར་སྨིན་པས་ས་ལ་གནས་པའི་ས་བོན་གྱི་ཚོགས་དང་། ལོ་ཏོག་གི་ཚོགས་དང་། རཙབ༹་དང་། ཤིང་གེལ་པ་དང་། རྩི་དང་། ནགས་ཚལ་ཐམས་ཅད་ཀུན་ཏུ་བསྐྱེད་པར་བྱ་བའི་ཕྱིར་སྟེང་གི་ནམ་མཁའ་བར་སྣང་གི་གནས་ལ་འདི་འདྲ་བའི་རླུང་དག་༄༤༩༤ཨ་༌༎
 saṃbhūtaṃ ca mahāpṛthivyāṃ prapatati |	ལྡང་སྟེ༏་དེས་ཆར་བ་སྡུད་པར་བྱེད་ཅིང་བསྡུས་ནས་ཀྱང་ས་གཞི་ཆེན་པོ་ལ་འབབ་པར་བྱེད་དོ་༎ 
 tena ca sarvī mahāpṛthivī saṃtarpitā bhavati |	དེས་ས་གཞི་ཆེན་པོ་ཐམས་ཅད་ཀུན་ཏུ་ཚིམ་པར་བྱེད་ཅིང་།
 sarve jambūdvīpakāś ca sattvās tasmin samaye pramuditā bhavanti | saumanasyajātās tasya megha iti | saṃjñā loke saṃbhavati |	དེའི་ཚེ་ན་ཛམབུ་གླིང་བའི་མི་ཐམས་ཅད་ཀྱང་རབ་ཏུ་དགའ་བ་དང་། ཡིད་བདེ་བ་སྐྱེ་བར་བྱེད་དེ་། དེ་ལ་འཇིག་རྟེན་ན་སྤྲིན་ཅེས་བྱ་བའི་མིང་དུ་འགྱུར་རོ་༎ འཇམ་དཔལ་།
 yasmin khalu punar mañjuśrīḥ samaya upary antarīkṣād mahān udakaskandho na nipatati, tasmin samaye sarvajambūdvīpakāḥ sattvā evaṃ cintayanti | nātra meghaḥ saṃbhavati |	གང་གི་ཚེ་སྟེང་གི་བར་སྣང་ལས་ཆར་བའི་ཚོགས་ཆེན་པོ་མི་འབབ་པ་དེའི་ཚེ་ན་ཛམབུ་གླིང་པའི་མི་ཐམས་ཅད་འདི་སྐད་ཅེས་འདིར་སྤྲིན་མི་འཁོར་རོ་༎ ཞེས་རྗོད་པར་བྱེད་དོ་༎
 yadā tu mañjuśrīr upary antarīkṣād mahān vāriskandho mahāpṛthivyāṃ nipatati,	འཇམ་དཔལ་། གང་གི་ཚེ་སྟེང་གི་བར་སྣང་ལས་ཆར་བའི་ཚོགས་ཆེན་པོ་ས་གཞི་ལ་འབབ་པ་དེའི་ཚེ་ན་ནི་། 
 sattvā evaṃ vadanti |	ཛམབུ་གླིང་པའི་མི་ཐམས་ཅད་འདི་སྐད་ཅེས་ཨཨ་ལ་ལ་སྤྲིན་ཆེན་པོ་ནི་།
 aho mahāmegho vāri pramuñcati saṃtarpayati mahāpṛthivīm iti |	ཆར་གྱི་རྒྱུན་འབེབས་པར་བྱེད་ཅིང་། ས་གཞི་ཆེན་པོའང་ཀུན་ཏུ་ཚིམ་པར་བྱེད་དོ་༎
 na punar atra mañjuśrīr megho vā meghaprajñaptir vā vidyate |	འཇམ་དཔལ་། དེ་ན་ནི༏་སྤྲིན་ཡང་མེད་ལ་སྤྲིན་དུ་གདགས་པའང་མེད་དེ་། འཇམ་དཔལ་། སེམས་ཅན་རྣམས་ཀྱི་སྔོན་གྱི་ལས་ཀྱི་རྣམ་པར་སྨིན་པས་ཆར་པའི་ཚོགས་ཆེན་པོ་རླུང་གིས་ཀུན་ནས་བསྐྱོད་ན་ནི་། སྟེང་གི་བར་སྣང་ལས་འབབ་པར་ཡང་འགྱུར་། འཇམ་དཔལ་།
 vātasaṃjanito mañjuśrīr upary antarīkṣād mahān udakaskandho nipatati |	ཆར་བའི་ཚོགས་ཆེན་པོ་དེ་རླུང་གིས་ཀུན་ནས་དཀྲུགས་པ་ནི་།
 so 'pskandho mañjuśrīs tatraivāntarīkṣe 'ntardhīyate |	སྟེང་གི་༄༤༩༤བ་བར་སྣང་དེ་ཉིད་དུ་བག་ལ་ཞ་བར་ཡང་འགྱུར་རོ་༎ འཇམ་དཔལ་།
 sattvānāṃ pūrvakarmavipākena | yathā mañjuśrīs tasya vāriskandhasyopary antarīkṣe vātasaṃkṣobheṇa saṃvāryamāṇasya muñcato vāri megha iti prajñaptir bhavati | sattvānāṃ pūrvakarmavipākena |	དེ་ལྟར་སེམས་ཅན་རྣམས་ཀྱི་སྔོན་གྱི་ལས་ཀྱི་རྣམ་པར་སྨིན་པས་སྟེང་གི་བར་སྣང་ལ་ཆར་བའི་ཚོགས་ཆེན་པོ་དེ་ཀུན་ནས་འདུས་པ་དང་། རླུང་ཀུན་ཏུ་འཁྲུག་པ་དག་གི་ཆར་བའི་རྒྱུན་ཀུན་ཏུ་འཛིན་པའམ་། འབེབས་པར་བྱེད་པ་དེ་ལ་སྤྲིན་ཅེས་འདོགས་པ་འབྱུང་མོད་ཀྱི་།
 na punar atra mañjuśrīr meghaḥ saṃvidyate,	འཇམ་དཔལ༏་དེ་ལ་ནི་། སྤྲིན་ཡང་མེད་།
 na meghaprajñaptiḥ |	སྤྲིན་དུ་གདགས་པའང་མེད་དེ་། འཇམ་དཔལ་། སྤྲིན་དེ་ནི་། མ་སྐྱེས་པ་།
 (jāa 33) anutpanno 'niruddho mañjuśrīr meghaś cittagatyanavatāra āgatigativinirmuktaḥ |	མ་འགགས་པ་། སེམས་ཀྱི་ཡུལ་དུ་མི་འཇུག་པ་། འོང་བ་དང་འགྲོ་བ་དང་བྲལ་བ་ཡིན་ནོ་༎
 evam eva mañjuśrīḥ pūrvakuśalamūlasaṃbhāropacitānāṃ bodhisattvānāṃ mahāsattvānāṃ	འཇམ་དཔལ་། དེ་བཞིན་དུ་བྱང་ཆུབ་སེམས་དཔའ་སེམས་དཔའ་ཆེན་པོ་སྔོན་དགེ་བའི་རྩ་བའི་ཚོགས་བསགས་པ་དག་དང་། 
 cānyeṣāṃ ca sattvānāṃ śrāvakapratyekabuddhajñānābhiprāyāṇām avaropitakuśalamūlānāṃ	སེམས་ཅན་ཉན་ཐོས་དང་། རང་སངས་རྒྱས་ཀྱི་ཤེས་པ་འདོད་པ་གཞན་དག་དང་། སེམས་ཅན་དགེ་བའི་རྩ་བ་བསྐྱེད་པ་།
 ca sattvānāṃ nirvāṇamārgasaṃdarśanahetukānām āsaṃgapratibhānas tathāgato 'rhan samyaksaṃbuddho	མྱ་ངན་ལས་འདས་པ་ཡང་དག་པར་བསྟན་པའི་རྒྱུ་ཅན་རྣམས་ལ་དེ་བཞིན་གཤེགས་པ་དགྲ་བཅོམ་པ་ཡང་དག་པར་རྫོགས་པའི་སངས་རྒྱས་སྤོབས་པ་ཐོགས་པ་མི་མངའ་བ་དང་ལྡན་པ་འཇིག་རྟེན་དུ་བྱུང་ངོ་༎ 
 loka utpanna iti saṃkhyāṃ gacchati |	འཇིག་རྟེན་དུ་བྱུང་ངོ་ཞེས་བྱ་བའི་གྲངས་སུ་འགྲོ་སྟེ་།
 sa yad bhāṣate tat sarvaṃ tathāvitathānanyathā,	དེ་གང་ཅི་གསུང་བ་དེ་དག་ཐམས་ཅད་ཀྱང་དེ་བཞིན་པ་། མ་ནོར་བ་དེ་བཞིན་པ་། གཞན་མ་ཡིན་པ་དེ་བཞིན་པ་༄༤༩༥ཨ་༌༎
 tasya devamanuṣyeṣu tathāgata iti nāma kṛtam |	ཡིན་པས་། དེ་ལ་ལྷ་དང་མི་རྣམས་ཀྱི་ནང་ན་དེ་བཞིན་གཤེགས་པ་ཞེས་བྱ་བའི་མཚན་དུ་བཏགས་པ་ཡིན་ཏེ་། 
 atha ca mañjuśrīḥ śabdo niścarati devamanuṣyeṣu yaduta tathāgata iti |	འཇམ་དཔལ་། དེ་ལས་ལྷ་དང་མི་རྣམས་ཀྱི་ནང་དུ་དེ་བཞིན་གཤེགས་པ་ཞེས་བྱ་བའི་སྒྲ་འབྱུང་བར་ཡང་འགྱུར་རོ་༎ འཇམ་དཔལ་།
 na punar mañjuśrīs tathāgataḥ saṃvidyate |	དེ་བཞིན་གཤེགས་པ་ནི་། ཡོད་པ་མ་ཡིན་པ་སྟེ༏་འཇམ་དཔལ་། དེ་བཞིན་གཤེགས་པ་ནི་། མཚན་མ་མེད་པ་།
 animitto mañjuśrīs tathāgato nimittāpagato na deśastho na videśasthaḥ,	མཚན་མ་དང་བྲལ་བ་། ཡུལ་ན་མི་གནས་པ་། ཕྱོགས་ན་མི་གནས་པ་།
 abhūto 'nutpanno 'niruddhaḥ |	མ་བྱུང་བ་། མ་སྐྱེས་པ་། མ་འགགས་པ་ཡིན་ནོ་༎
 tat khalu punar mañjuśrīs tathāgatapratibhāsaḥ sadevakaṃ lokaṃ dharmeṇa saṃtarpayitvā saṃpravārayitvā,	འཇམ་དཔལ་། དེ་བཞིན་གཤེགས་པའི་སྤོབས་པ་དེས་ལྷ་དང་བཅས་པའི་འཇིག་རྟེན་ཆོས་ཀྱིས་ཡང་དག་པར་ཚིམ་པར་མཛད་ཅིང་། ཡང་དག་པར་འཛིན་དུ་བཙུད་ནས་བྱང་ཆུབ་སེམས་དཔའ་ལས་དང་པོ་བ་རྣམས་དང་མཛད་ཅིང་། 
 ādikarmikāṇāṃ ca bodhisattvānāṃ cānyeṣāṃ ca sarvabālapṛthagjanānāṃ nirvāṇavainayikānāṃ pūrvakarmavipākenādarśanābhāso bhavati | teṣām evaṃ bhavati | parinirvṛtas tathāgata iti |	། བྱིས་པ་སོ་སོའི་སྐྱེ་བོ་ཡོངས་སུ་མྱ་ངན་ལས་འདའ་བས་འདུལ་བ་གཞན་དག་གི་སྔོན་གྱི་ལས་ཀྱི་རྣམ་པར་སྨིན་པས་མི་སྣང་བར་གྱུར་པ་ན་བདག་འདི་སྙམ་དུ་དེ་བཞིན་གཤེགས་པ་ཡོངས་སུ་མྱ་ངན་ལས་འདས་མཛད་ཅིང་། ། སོ་༎ སྙམ་དུའང་སེམས་ཏེ་། འཇམ་དཔལ་།
 na mañjuśrīs tathāgata utpadyate vā nirudhyate vā |	དེ་བཞིན་གཤེགས་པ་ནི་། སྐྱེ་བའང་མེད་། འགག་པའང་མེད་དོ་༎ འཇམ་དཔལ་།
 anutpanno 'niruddho mañjuśrīs tathāgataḥ |	དེ་བཞིན་གཤེགས་པ་ནི་། མ་སྐྱེས་པ་། ༄༤༩༥བ་མ་འགགས་པ་སྟེ་། འཇམ་དཔལ་། དེ་བཞིན་གཤེགས་པ་ནི་།
 ādiparinirvṛto mañjuśrīs tathāgato 'rhan samyaksaṃbuddhaḥ |	གཟོད་མ་ནས་ཡོངས་སུ་མྱ་ངན་ལས་འདས་པ་ཡིན་ནོ་༎ འཇམ་དཔལ་། དེ་བཞིན་གཤེགས་པ་དགྲ་བཅོམ་པ་ཡང་དག་པར་རྫོགས་པའི་སངས་རྒྱས་ནི་། ཡོད་པ་མ་ཡིན་པ་སྟེ་།
 yathā mañjuśrīr (jāa 34)	འཇམ་དཔལ་།
 udakārambaṇenābhūtasya meghasyānutpannāniruddhasyāsato meghaprajñaptiḥ sthitā loke megha iti |	ཇི་ལྟར་ཆར་བ་དམིགས་པ་ལས་སྤྲིན་མ་བྱུང་བ་། མ་སྐྱེས་པ་། མ་འགགས་པ་། ཡོད་པ་མ་ཡིན་པ་། དེ་ལ་འཇིག་རྟེན་ན་སྤྲིན་སྤྲིན་ཅེས་བྱ་བར་འདོགས་པ་བྱུང་བ་དེ་བཞིན་དུ་། འཇམ་དཔལ་། ཆོས་སྟོན་པར་དམིགས་པ་ལས་དེ་བཞིན་གཤེགས་པ་མ་བྱུང་བ་། མ་སྐྱེས་པ་།
 evam eva mañjuśrīr dharmadeśanārambaṇenābhūtasya tathāgatasyānutpannāniruddhasyāsata ādita evājātasya nāmaprajñaptiḥ sthitā loke tathāgato 'rhan samyaksaṃbuddha iti || §9 ms| 8b4-10a4 p| 309b6-311a6, d| 283a5-284b3, t| 357 242a3-b15, t| 358 ö, t| 359(d) 256b21-257a2|	མ་འགགས་པ་། ཡོད་པ་མ་ཡིན་པ་། གཟོད་མ་ཉིད་ནས་མ་སྐྱེས་པ་དེ་ལ་འཇིག་རྟེན་ན་དེ་བཞིན་གཤེགས་པ་དགྲ་བཅོམ་པ་ཡང་དག་པར་རྫོགས་པའི་སངས་རྒྱས་ཞེས་བྱ་བར་འདོགས་པ་འབྱུང་ངོ་༎ འཇམ་དཔལ་།
 tadyathāpi mañjuśrīr mahābrahmānabhibhūr daśatrisāhasramahāsāhasravaśavartī divase divase sarvadevanikāyān vyavalokayati,	འདི་ལྟ་སྟེ་། དཔེར་ན་། སྟོང་གསུམ་འབུམ་ཕྲག་བཅུ་ལ་དབང་སྒྱུར་བའི་ཚངས་པ་ཆེན་པོ་ཟིལ་གྱིས་མི་ནོན་ཅིང་ཟིལ་གྱིས་གནོན་པར་བྱེད་པ་ནི་།
 yāvac cāturmahārājikadevanikāyaparyantān | tena khalu punar mañjuśrīḥ samayena tasya mahābrahmaṇo daśatrisāhasramahāsāhasravaśavartinaḥ sarvadevanikāyān vyavalokayataḥ,	ཉིན་གཅིག་བཞིན་དུ་རྒྱལ་ཆེན་བཞིའི་ལྷའི་རིས་ཀྱི་མཐར་ཐུག་པའི་བར་གྱི་ལྷའི་རིས་ཐམས་ཅད་ལ་རྣམ་པར་ལྟ་བར་བྱེད་དེ་།
 sarvadevanikāyeṣu sarvadevaputrāḥ svakasvakān kāmakrīḍāratiparibhogāṃs tyaktvā sarvatūryatāḍāvacarasaṃgītiṃ śamayitvā,	འཇམ་དཔལ་། སྟོང་གསུམ་འབུམ་ཕྲག་བཅུ་ལ་དབང་སྒྱུར་བའི་ཚངས་པ་ཆེན་པོ་ཟིལ་གྱིས་མི་ནོན་ཅིང་ཟིལ་གྱིས་༄༤༩༦ཨ་༌༎ ། དགའ་བ་དང་། ལོངས་སྤྱོད་དག་སྤངས་ཏེ་སིལ་སྙན་དང་། ཕེག་རྡོབ་དང་། གླུ་དབྱངས་ཀྱི་སྒྲ་ཐམས་ཅད་ཞི་བར་བྱས་ནས་འདོད་པའི་རྩེད་མོ་དང་། ༄༤༩༦ཨ་༌༎ ། དགའ་བ་དང་། ལོངས་སྤྱོད་དག་སྤངས་ཏེ་སིལ་སྙན་དང་། ཕེག་རྡོབ་དང་། གླུ་དབྱངས་ཀྱི་སྒྲ་ཐམས་ཅད་ཞི་བར་བྱས་ནས་འདོད་པའི་རྩེད་མོ་དང་། དགའ་བ་དང་། ལོངས་སྤྱོད་ཡིད་ལ་བྱེད་པ་བཏང་སྟེ་གུས་པ་དང་བཅས་པས་ཐལ་མོ་སྦྱར་ནས་།
 kāmakrīḍāratimanasikārotsṛṣṭāḥ sagauravā añjaliṃ pragṛhya mahābrahmāṇam animiṣaṃ vyavalokayanti |	ཚངས་པ་ཆེན་པོ་དེ་ལ་མིག་མི་འཛུམ་པར་ལྟ་བར་བྱེད་དོ་༎
 sa ca mahābrahmā sarvadevanikāyeṣu muhūrtaṃ darśanaṃ dadāti |	ཚངས་པ་ཆེན་པོ་དེའང་གནས་ནས་མི་ག-ཡོ་བར་ལྷའི་བུ་ཐམས་ཅད་ཡུད་ཙམ་ཞིག་བདག་བལྟར་འཇུག་པར་བྱེད་དེ་། 
 te ca devaputrās tasmin samaye mahābrahmalokopapattim ākāṅkṣanti,	དེའི་ཚེ་ན་ལྷའི་བུ་དེ་དག་ཚངས་པའི་འཇིག་རྟེན་དུ་སྐྱེ་བར་འདོད་ཅིང་པར་བྱེད་དེ་། 
 mahābrahmalokopapattaye ca kuśalamūlāni pariṇāmayanti |	། དགེ་བའི་རྩ་བ་རྣམས་ཀྱང་ཚངས་པའི་འཇིག་རྟེན་དུ་སྐྱེ་བར་བྱ་བའི་ཕྱིར་ཡོངས་སུ་བསྔོ་བར་བྱེད་དོ་༎ འཇམ་དཔལ་།
 sa ca mañjuśrīr mahābrahmācyavamānas tato brahmavimānād anyam adhitiṣṭhati mahābrahmāṇaṃ	ཚངས་པ་ཆེན་པོ་དེའང་ཚངས་པའི་གཞལ་མེད་ཁང་དེ་ནས་འཆི་འཕོ་བར་མི་བྱེད་བཞིན་དུ་།
 daśatrisāhasramahāsāhasravaśavartinaṃ pūrvapraṇidhānādhiṣṭhānena teṣāṃ ca devaputrāṇāṃ pūrvakuśalamūlopacayena | (jāa 35)	སྔོན་གྱི་སྨོན་ལམ་གྱི་བྱིན་གྱི་རླབས་དང་། ལྷའི་བུ་དེ་དག་གི་སྔོན་གྱི་དགེ་བའི་རྩ་བ་བསགས་པའི་མཐུས་སྟོང་གསུམ་འབུམ་ཕྲག་བཅུ་ལ་དབང་སྒྱུར་བའི་ཚངས་པ་ཆེན་པོ་ཟིལ་གྱིས་མི་ནོན་ཅིང་ཟིལ་གྱིས་གནོན་པར་བྱེད་པ་གཞན་ཞིག་བྱིན་གྱིས་རློབ་༄༤༩༦བ་པར་བྱེད་དོ་༎
 sa ca mañjuśrīr nirmito mahābrahmā divase divase sarvadevanikāyān vyavalokayati, yāvac cāturmahārājakāyikadevanikāyān |	འཇམ་དཔལ་། སྤྲུལ་བའི་ཚངས་པ་ཆེན་པོ་དེའང་ཉིན་གཅིག་བཞིན་དུ་རྒྱལ་ཆེན་བཞིའི་རིས་ཀྱི་མཐར་ཐུག་པའི་བར་གྱི་ལྷའི་རིས་ཐམས་ཅད་ལ་རྣམ་པར་ལྟ་པར་བྱེད་དེ་། 
 tena khalu punar mañjuśrīḥ samayena sarveṣu devanikāyeṣu sarvadevaputrāḥ svakasvakān kāmakrīḍāratiparibhogāṃs tyaktvā sarvatūryatāḍāvacarasaṃgītiṃ	འཇམ་དཔལ་། དེའི་ཚེ་ན་ལྷའི་རིས་ཐམས་ཅད་ཀྱི་ནང་ན་ལྷའི་བུ་ཐམས་ཅད་རང་རང་གི་འདོད་པའི་རྩེད་མོ་དང་། དགའ་བ་དང་། ལོངས་སྤྱོད་དག་སྤངས་ཏེ་།
 kāmakrīḍāratimanasikārotsṛṣṭāḥ sagauravā añjaliṃ pragṛhya mahābrahmāṇam animiṣaṃ vyavalokayanti sma |	སིལ་སྙན་དང་། ཕེག་རྡོབ་པ་དང་། གླུ་དབྱངས་ཀྱི་སྒྲ་ཐམས་ཅད་ཞི་བར་བྱས་ནས་འདོད་པའི་རྩེད་མོ་དང་། དགའ་བ་དང་། ལོངས་སྤྱོད་ཡིད་ལ་བྱེད་པ་བཏང་སྟེ་། གུས་པ་དང་བཅས་པས་ཐལ་མོ་སྦྱར་ནས་ཚངས་པ་ཆེན་པོ་དེ་ལ་མིག་མི་འཛུམ་པར་ལྟ་བར་བྱེད་དོ་༎ 
 sa ca mahābrahmā sarvadevanikāyeṣu muhūrtaṃ darśanaṃ dadāti, na ca sthānāc calati |	སྤྲུལ་པའི་ཚངས་པ་ཆེན་པོ་དེའང་གནས་ནས་མི་ག-ཡོ་བར་ལྷའི་བུ་ཐམས་ཅད་ཡུད་ཙམ་ཞིག་བདག་ལ་བལྟར་འཇུག་པར་ཡང་བྱེད་བར་བྱེད་དོ་༎ 
 te ca devaputrās tasmin samaye mahābrahmalokopapattim ākāṅkṣanti, brahmalokopapattaye ca kuśalamūlāni pariṇāmayanti |	དེ་། དེའི་ཚེ་ན་ལྷའི་བུ་དེ་དག་ཀྱང་ཚངས་པའི་འཇིག་རྟེན་དུ་སྐྱེ་བར་འདོད་ཅིང་དགེ་བའི་རྩ་བ་རྣམས་ཀྱང་ཚངས་པའི་འཇིག་རྟེན་དུ་སྐྱེ་བར་བྱ་བའི་ཕྱིར་ཡོངས་སུ་བསྔོ་བར་ཡང་བྱེད་དོ་༎
 na cātra mañjuśrīr brahmā saṃvidyate |	འཇམ་དཔལ་། དེ་ལ་ནི་། ཚངས་པ་ཡོད་པ་མ་ཡིན་ཏེ་། འཇམ་དཔལ་། ཚངས་པ་དེ་ནི་། སྟོང་པ༏་ཡ་མ་བརླ་། མ་བྱུང་བ་། ཡི་གེ་མེད་པ་། སྒྲ་མེད་པ་། ཡུལ་མེད་པ་། དངོས་པོ་མེད་པ་། བསམ་དུ་མེད་པ་། མཚན་མ་མེད་པ་།
 śūnyo 'yaṃ mañjuśrīr brahmā vaśiko 'bhūto 'nakṣaro 'ghoṣo 'deśo 'bhāvo 'cintyo 'nimittaś cittamanovijñānāpagato 'nutpanno 'niruddhaḥ |	སེམས་དང་། ཡིད་དང་། རྣམ་པར་ཤེས་༄༤༩༧ཨ་༌༎ པ་དང་བྲལ་བ་། མ་སྐྱེས་པ་། མ་འགགས་པ་ཡིན་མོད་ཀྱི་།
 atha ca mañjuśrīḥ sarvadevanikāyeṣu darśanābhāso bhavati, tasyaiva mahābrahmaṇaḥ pūrvakuśalamūlapraṇidhānādhiṣṭhānena teṣāṃ ca devaputrāṇāṃ pūrvakuśalamūlopacayena |	འཇམ་དཔལ་། འོན་ཀྱང་ཚངས་པ་ཆེན་པོ་དེ་ཉིད་ཀྱི་སྔོན་གྱི་དགེ་བའི་རྩ་བ་དང་། སྨོན་ལམ་གྱི་བྱིན་གྱི་རླབས་དང་། ལྷའི་བུ་དེ་དག་གི་སྔོན་གྱི་དགེ་བའི་རྩ་བ་བསགས་པའི་མཐུས་ལྷའི་རིས་ཐམས་ཅད་ལ་བལྟར་སྣང་བར་ཡང་འགྱུར་རོ་༎
 na ca mañjuśrīs teṣāṃ devaputrāṇām evaṃ bhavati |	འཇམ་དཔལ༏་འོན་ཀྱང་ལྷའི་བུ་དེ་དག་འདི་སྙམ་དུ་ཚངས་པ་ཆེན་པོ་དེ་ནི་།
 nirmito 'yaṃ brahmā,	སྤྲུལ་པ་། སྟོང་པ་། ཡ་མ་བརླ་། མ་བྱུང་བ་། ཡི་གེ་མེད་པ་། སྒྲ་མེད་པ་། ཡུལ་མེད་པ་། དངོས་པོ་མེད་པ་། བསམ་དུ་མེད་པ་། མཚན་མ་མེད་པ་།
 śūnyo vaśiko 'bhūto 'nakṣaro 'ghoṣo 'deśo 'bhāvo 'cintyo 'nimittaś cittamanovijñānāpagato 'nutpanno 'niruddho veti |	སེམས་དང་། ཡིད་དང་། རྣམ་པར་ཤེས་པ་དང་བྲལ་བ་། སྐྱེ་བ་མེད་པ་། འགག་པ་མེད་པ་ཡིན་ནོ་༎ སྙམ་དུ་མི་སེམས་སོ་༎ འཇམ་དཔལ་།
 evam eva mañjuśrīs tathāgato 'py arhan samyaksaṃbuddhaḥ śūnyo vaśiko 'bhūto 'nakṣaro 'ghoṣo 'deśo 'bhāvo 'cintyo 'nimittaś cittamanovijñānāpagato 'nutpanno 'niruddhaḥ |	དེ་བཞིན་དུ་དེ་བཞིན་གཤེགས་པ་དགྲ་བཅོམ་པ་ཡང་དག་པར་རྫོགས་པའི་སངས་རྒྱས་ཀྱང་སྟོང་པ་། ཡ་མ་བརླ་། མ་བྱུང་བ་། ཡི་གེ་མེད་པ་། སྒྲ་མེད་པ་། ཡུལ་མེད་པ་། དངོས་པོ་མེད་པ་། བསམ་དུ་མེད་པ་། མཚན་མ་མེད་པ་། སེམས་དང་། ཡིད་དང་། རྣམ་པར་ཤེས་པ་དང་བྲལ་བ་། མ་སྐྱེས་པ༏་མ་འགགས་པ་ཡིན་མོད་ཀྱི་། འཇམ་དཔལ་།
 atha ca punar mañjuśrīs tathāgato 'rhan samyaksaṃbuddhaḥ pūrvabodhisattvacaryāpraṇidhānādhiṣṭhānena, (jāa 36) ādikarmiṇāṃ ca bodhisattvānāṃ sarvaśrāvakapratyekabuddhayānasaṃprasthitānāṃ ca sarvabālapṛthagjanānāṃ sarvakuśalamūlādhiṣṭhānena lakṣaṇaśatasahasrālaṃkṛtas tathāgataḥ pratibimbam iva loke saṃdṛśyate, na ca sthānāc calati |	འོན་ཀྱང་དེ་བཞིན་གཤེགས་པ་དགྲ་བཅོམ་པ་ཡང་དག་པར་རྫོགས་པའི་སངས་རྒྱས་ཀྱི་སྔོན་བྱང་ཆུབ་སེམས་༄༤༩༧བ་དཔའི་སྤྱད་པ་སྤྱོད་པའི་སྨོན་ལམ་གྱི་བྱིན་གྱི་རླབས་དང་། བྱང་ཆུབ་སེམས་དཔའ་ལས་དང་པོ་བ་རྣམས་དང་། ཉན་ཐོས་དང་རང་སངས་རྒྱས་ཀྱི་ཐེག་པ་ལ་ཡང་དག་པར་ཞུགས་པ་རྣམས་དང་། བྱིས་པ་སོ་སོའི་སྐྱེ་བོ་ཐམས་ཅད་ཀྱི་དགེ་བའི་རྩ་བ་བསགས་པའི་མཐུས་དེ་བཞིན་གཤེགས་པ་གནས་ནས་མི་ག-ཡོ་བ་བཞིན་དུ་མཚན་བརྒྱ་སྟོང་གིས་ལེགས་པར་བརྒྱན་པ་། འཇིག་རྟེན་ན་གཟུགས་བརྙན་བཞིན་དུ་ཀུན་ཏུ་སྣང་ངོ་༎
 na ca mañjuśrīr ādikarmikāṇāṃ ca bodhisattvānāṃ sarvaśrāvakapratyekabuddhayānikānāṃ sarvabālapṛthagjanānāṃ caivaṃ bhavati |	འཇམ་དཔལ་། བྱང་ཆུབ་སེམས་དཔའ་ལས་དང་པོ་བ་རྣམས་དང་། ཉན་ཐོས་དང་རང་སངས་རྒྱས་ཀྱི་ཐེག་པ་པ་ཐམས་ཅད་དང་། བྱིས་པ་སོ་སོའི་སྐྱེ་བོ་ཐམས་ཅད་ནི་། འདི་སྙམ་དུ་དེ་བཞིན་གཤེགས་པ་ནི་། སྟོང་པ་། ཡ་མ་བརླ་། མ་བྱུང་བ་། ཡི་གེ་མེད་པ་། སྒྲ་མེད་པ་། ཡུལ་མེད་པ༏་དངོས་པོ་མེད་པ་། བསམ་དུ་མེད་པ་། མཚན་མ་མེད་པ་།
 śūnyas tathāgato vaśiko 'bhūto 'nakṣaro 'ghoṣo 'deśo 'bhāvo 'cintyo 'nimittaś cittamanovijñānāpagato 'nutpanno 'niruddho ceti |	སེམས་དང་། ཡིད་དང་། རྣམ་པར་ཤེས་པ་དང་བྲལ་བ་། མ་སྐྱེས་པ་། མ་འགགས་པ་ཡིན་པའི་མི་སེམས་མེད་ཀྱི༏་འཇམ་དཔལ་།
 atha ca mañjuśrīs tathāgatātmabhāvāl lakṣaṇaśatasahasrālaṃkṛtāt sarvatathāgateryāpatheṣu śūnyeṣu nānāvidhivicitrāṇāṃ nānādhimuktānāṃ sattvānāṃ mahādharmadeśanā niścarati |	འོན་ཀྱང་དེ་བཞིན་གཤེགས་པ་ནི་། སྤྱོད་ལམ་ཐམས་ཅད་དུ་དེ་བཞིན་གཤེགས་པའི་སྐུ་མཚན་བརྒྱ་སྟོང་གིས་ལེགས་པར་བརྒྱུན་པ་ལས་སེམས་ཅན་མོས་པ་སྣ་ཚོགས་ཐ་དད་པ་རྣམས་ལ་ཆོས་སྟོན་པ་ཆེན་པོ་འབྱུང་བར་ཡང་བྱེད་དོ་༎ ཆོས་བསྟན་པ་དེའང་སེམས་ཅན་ཐམས་ཅད་ཀྱི་གནོད་པ་དང་། འཁྲུག་པ་དང་། ཉེ་༄༤༩༨ཨ་༌༎
 sā ca dharmadeśanā sarvasattvānāṃ sarvopadravopāyāsopakleśopaśāntaye saṃvartate |	བའི་ཉོན་མོངས་པ་ཐམས་ཅད་ཉེ་བར་ཞི་བར་བྱེད་པར་འགྱུར་ཏེ་།
 tatra ca tathāgataḥ samayaḥ sarvatropekṣako nirvikalpo nirviśeṣaḥ |	དེ་བཞིན་གཤེགས་པ་ནི་། དེ་ལའང་ཐམས་ཅད་དུ་མཉམ་ཞིང་བཏང་སྙོམས་ལ་རྣམ་པར་མི་རྟོག་ཅིང་བྱེ་བྲག་མི་འབྱེད་དེ་། འཇམ་དཔལ་།
 tad anenāpi te mañjuśrīḥ paryāyeṇaivaṃ veditavyam, anutpādo 'nirodha iti tathāgatasyaitad adhivacanam iti || §10 ms| 10a4-6, p| 311a6-b1, d| 284b3-5, t| 357 242b15-19, t| 358 251a24-28, t| 359(d) 257a3-7|	རྣམ་གྲངས་དེས་ཀྱང་འདི་ལྟར་སྐྱེ་བ་མེད་པ་དང་། འགག་པ་མེད་པ་ཞེས་བྱ་བ་དེ་ནི་། དེ་བཞིན་གཤེགས་པའི་ཚིག་བླ་དབ༹གས་ཡིན་པར་རིག་པར་བྱའོ་༎
 atha khalu bhagavāṃs tasyāṃ velāyām ime gāthe abhāṣat | (jāa 37)	དེ་ནས་བཅོམ་ལྡན་འདས་ཀྱིས་དེའི་ཚེ་ཚིགས་སུ་བཅད་པ་འདི་དག་བཀའ་སྩལ་ཏོ་༎
 anutpādadharmaḥ satataṃ tathāgataḥ sarve ca dharmāḥ sugatena sādṛśāḥ |	དེ་བཞིན་གཤེགས་པ་རྟག་ཏུ་སྐྱེ་མེད་ཆོས་༎ ཆོས་རྣམས་ཀུན་ཀྱང་བདེ་བར་གཤེགས་དང་འདྲ་༎
 nimittagrāheṇa tu bālabuddhayo asatsu dharmeṣu caranti loke || 1 ||	བྱིས་པའི་བློ་ཅན་མཚན་མར་འཛིན་པ་རྣམས་༎ འཇིག་རྟེན་དག་ན་མེད་པའི་ཆོས་ལ་སྤྱོད་༎
 tathāgato hi pratibimbabhūtaḥ kuśalasya dharmasya anāsravasya |	དེ་བཞིན་གཤེགས་པ་ཟག་མེད་དགེ་བ་ཡི་༎
 na cātra tathatā na tathāgato 'sti bimbaṃ ca saṃdṛśyati sarvaloke || 2 ||	ཆོས་ཀྱི་གཟུགས་བརྙན་ཡིན་ཏེ་འདི་ལ་ནི་༎ དེ་བཞིན་ཉིད་མེད་དེ་བཞིན་གཤེགས་པའང་མེད་༎ འཇིག་རྟེན་ཀུན་ཏུ་གཟུགས་བརྙན་ཀུན་ཏུ་སྣང་༎ འཇམ་དཔལ་།
 §11 ms| 10a6-11b7, p| 311b1-313a8, d| 284b5-286a7, t| 357 242b20-243a11, t| 358 251a29-b20, t| 359(d) 257a8-b25|	འདི་ལྟ་སྟེ་།
 tadyathā mañjuśrīḥ sūryaraśmayo jambūdvīpe pūrvataram eva tāvad mahāśailendrarājānam avabhāsayanti |	དཔེར་ན་། ཉི་མའི་དཀྱིལ་འཁོར་གྱི་འོད་ཟེར་དག་ནི་། ཛམབུའི་གླིང་དུ་དང་པོ་ཁོ་ནར་རིའི་དབང་པོ་ཆེན་པོ་རྣམས་སྣང་བར་བྱེད་དོ་༎
 tataḥ paścāc cakravāḍān mahācakravāḍān avabhāsayanti |	དེའི་འོག་ཏུ་རིའི་ཁོར་ཡུག་དང་། ཁོར་ཡུག་ཆེན་པོ་རྣམས་སྣང་བར་བྱེད་དོ་༎
 tataḥ paścād uccoccān pṛthivīpradeśān avabhāsayanti |	དེའི་འོག་ཏུ་རི་ཆེན་པོ་གཞན་དག་ཀྱང་སྣང་བར་བྱེད་དོ་༎
 tataḥ paścād iha jambūdvīpe nimnān pṛthivīpradeśān avabhāsayanti |	དེའི་འོག་ཏུ་༄༤༩༨བ་རི་ནག་པོ་རྣམས་སྣང་བར་བྱེད་དོ་༎ དེའི་འོག་ཏུ་ས་ཕྱོགས་མཐོན་པོ་མཐོན་པོ་དག་སྣང་བར་བྱེད་དོ་༎ དེའི་འོག་ཏུ་ཛམབུའི་གླིང་འདིའི་ས་ཕྱོགས་དམའ་བ་དམའ་བ་དག་ཀྱང་སྣང་བར་བྱེད་དོ་༎
 te ca mañjuśrīḥ sūryaraśmayo na kalpayanti,	འཇམ་དཔལ་། འོན་ཀྱང་ཉི་མའི་འོད་ཟེར་དེ་དག་ནི་། རྟོག་པར་མི་བྱེད་།
 na vikalpayanti,	རྣམ་པར་རྟོག་པར་མི་བྱེད་།
 na cintayanti,	སེམས་པར་མི་བྱེད་།
 na vicintayanti |	རྣམ་པར་སེམས་པར་མི་བྱེད་དེ་།
 cittamanovijñānāpagatā mañjuśrīḥ sūryaraśmayaḥ,	འཇམ་དཔལ་། ཉི་མའི་འོད་ཟེར་རྣམས་ནི་། སེམས་དང་། ཡིད་དང་། རྣམ་པར་ཤེས་པ་དང་བྲལ་བ་།
 anutpannā aniruddhāḥ,	མ་སྐྱེས་པ་། མ་འགགས་པ་། མཚན་ཉིད་མེད་པ་།
 alakṣaṇā lakṣaṇāpagatāḥ,	མཚན་ཉིད་དང་བྲལ་བ༏་ཡིད་ལ་བྱེད་པ་མེད་པ་།
 amanaskārā manaskārāpagatāḥ,	ཡིད་ལ་བྱེད་པ་དང་བྲལ་བ་།
 aprapañcāḥ prapañcāpagatāḥ, (jāa 38)	སྤྲོས་པ་མེད་པ་། སྤྲོས་པ་དང་བྲལ་བ་། ཡོངས་སུ་གདུང་བ་མེད་པ་།
 aparidāhā niṣparidāhāḥ,	ཡོངས་སུ་གདུང་བ་དང་བྲལ་བ་།
 naurasthā na parasthāḥ,	ཚུ་རོལ་ན་གནས་པ་མ་ཡིན་པ་། ཕ་རོལ་ན་གནས་པ་མ་ཡིན་།
 noccā na nīcāḥ,	མཐོ་བ་མ་ཡིན་།
 na baddhā na muktāḥ,	དམའ་བ་མ་ཡིན་། བཅིངས་པ་མ་ཡིན་།
 na jñānavanto nājñānavantaḥ,	ཤེས་པ་དང་ལྡན་པ་མ་ཡིན་། ཤེས་པ་དང་མི་ལྡན་པ་མ་ཡིན་།
 na saṃkleśā na niḥkleśāḥ,	ཉོན་མོངས་པ་དང་བཅས་པ་མ་ཡིན་། ཉོན་མོངས་པ་མེད་པ་མ་ཡིན་།
 na satyavādino na mṛṣāvādinaḥ,	བདེན་པར་སྨྲ་བ་མ་ཡིན་། བརྫུན་དུ་སྨྲ་བ་མ་ཡིན་། ཕ་རོལ་མ་ཡིན་།
 na tīre na nimne,	ཚུ་རོལ་མ་ཡིན་། འགྲམ་ན་མ་ཡིན་། གཤོང་ན་མ་ཡིན་།
 na sthale naughe,	ཐང་ལ་མ་ཡིན་། ཆུ་བོ་ན་མ་ཡིན་། རྟོག་གེའི་སྤྱོད་ཡུལ་མ་ཡིན་།
 na tarkāvacarā nātarkāvacarāḥ,	རྟོག་གེ་མ་ཡིན་པའི་སྤྱོད་ཡུལ་མ་ཡིན་།
 na rūpiṇo nārūpiṇaḥ |	གཟུགས་ཅན་མ་ཡིན་། གཟུགས་མེད་༄༤༩༩ཨ་༌༎ པ་མ་ཡིན་མོད་ཀྱི་།
 atha ca punar mañjuśrīḥ pṛthivyām uccanīcamadhyaviśeṣeṇa hīnamadhyotkṛṣṭāvabhāsasya cchāyā vaicitryaṃ bhavati |	འཇམ་དཔལ་། འོན་ཀྱང་ས་གཞི་མཐོ་བ་དང་། དམའ་བ་དང་། བར་མའི་བྱེ་བྲག་གིས་སྣང་བ་ཆེན་པོ་དང་། ཆུང་དུ་དང་། བར་མའི་འོད་ཟེར་སྣ་ཚོགས་སྣང་བར་འགྱུར་རོ་༎
 evam eva mañjuśrīs tathāgato 'py arhan samyaksaṃbuddho na kalpayati,	འཇམ་དཔལ་། དེ་བཞིན་དུ་དེ་བཞིན་གཤེགས་པ་དགྲ་བཅོམ་པ་ཡང་དག་པར་རྫོགས་པའི་སངས་རྒྱས་ཀྱང་རྟོག་པར་མི་བྱེད་། 
 na vikalpayati,	རྣམ་པར་རྟོག་པར་མི་བྱེད་།
 na cintayati,	སེམས་པར་མི་བྱེད་།
 na vicintayati |	རྣམ་པར་སེམས་པར་མི་བྱེད་དེ་།
 cittamanovijñānāpagato mañjuśrīs tathāgataḥ,	འཇམ་དཔལ་། དེ་བཞིན་གཤེགས་པ་ནི་། སེམས་དང་། ཡིད་དང་། རྣམ་པར་ཤེས་པ་དང་བྲལ་བ་།
 anutpanno 'niruddhaḥ,	མ་སྐྱེས་པ་། མ་འགགས་པ་། མཚན་ཉིད་མེད་པ་།
 alakṣaṇo lakṣaṇāpagataḥ,	མཚན་ཉིད་དང་བྲལ་བ་།
 amanaskāro manaskārāpagataḥ,	ཡིད་ལ་བྱེད་པ་མེད་པ་། ཡིད་ལ་བྱེད་པ་དང་བྲལ་བ་།
 aprapañcaḥ prapañcāpagataḥ,	སྤྲོས་པ་མེད་པ་། སྤྲོས་པ་དང་བྲལ་བ༏་ཡོངས་སུ་གདུང་བ་མེད་པ་།
 aparidāho niṣparidāhaḥ |	ཡོངས་སུ་གདུང་བ་དང་བྲལ་བ་།
 naurastho na pārasthaḥ,	ཚུ་རོལ་ན་གནས་པ་མ་ཡིན་། ཕ་རོལ་ན་གནས་པ་མ་ཡིན་།
 nocco na nīcaḥ,	མཐོ་བ་མ་ཡིན་།
 na baddho na muktaḥ,	དམའ་བ་མ་ཡིན་། བཅིངས་པ་མ་ཡིན་། གྲོལ་བ་མ་ཡིན་།
 na jñānavān nājñānavān,	ཤེས་པ་དང་ལྡན་པ་མ་ཡིན་། ཤེས་པ་དང་མི་ལྡན་པ་མ་ཡིན་།
 na saṃkleśo na niḥkleśaḥ,	ཉོན་མོངས་པ་དང་བཅས་པ་མ་ཡིན་། ཉོན་མོངས་པ་མེད་པ་མ་ཡིན་།
 na satyavādī na mṛṣāvādī,	བདེན་པར་གསུང་བ་མ་ཡིན་། བརྫུན་པར་གསུང་བ་མ་ཡིན་། ཚུ་རོལ་མ་ཡིན་།
 nāvāre na pāre,	ཕ་རོལ་མ་ཡིན་།
 na tīre nātīre,	འགྲམ་ན་མ་ཡིན་།
 na nimne nānimne,	གཤོང་ན་མ་ཡིན་།
 na sthale nāsthale,	ཐང་ལ་མ་ཡིན་།
 naughe nānoghe,	ཆུ་བོ་ན་མ་ཡིན་།
 na sarvajño nāsarvajñaḥ,	༄༤༩༩བ་ཐམས་ཅད་མཁྱེན་པ་མ་ཡིན་། ཐམས་ཅད་མི་མཁྱེན་པ་མ་ཡིན་། རྟོག་གེ་མ་ཡིན་།
 na tarko nātarkaḥ, na pracāro (jāa 39)	རྟོག་གེ་མེད་པ་མ་ཡིན་།
 nāpracāraḥ,	སྤྱོད་པ་མ་ཡིན་།
 na samudācāro nāsamudācāraḥ,	སྤྱོད་པ་མེད་པ་མ་ཡིན་། ཀུན་ཏུ་འབྱུང་བ་མ་ཡིན་། ཀུན་ཏུ་མི་འབྱུང་བ་མ་ཡིན་།
 na smṛtimān nāsmṛtimān,	དྲན་པ་དང་ལྡན་པ་མ་ཡིན་། དྲན་པ་དང་མི་ལྡན་པ་མ་ཡིན་།
 na cetano na niścetanaḥ,	སེམས་པ་མ་ཡིན་། སེམས་པ་མེད་པ་མ་ཡིན་།
 na mano nāmanaḥ, na nirjāto nānirjātaḥ,	ཡིད་མ་ཡིན་། ཡིད་མེད་པ་མ་ཡིན་། སྒྲ་སྐད་མ་ཡིན་། སྒྲ་སྐད་མེད་པ་མ་ཡིན་།
 na nāmo nānāmaḥ,	མིང་མ་ཡིན་།
 na rūpo nārūpaḥ,	མིང་མེད་པ་མ་ཡིན་། གཟུགས་མ་ཡིན་། གཟུགས་མེད་པ་མ་ཡིན་།
 na vyāhāro nāvyāhāraḥ,	བརྗོད་པ་མ་ཡིན་། བརྗོད་དུ་མེད་པ་མ་ཡིན་།
 na prajñapyo nāprajñapyaḥ,	གདགས་པ་མ་ཡིན་། གདགས་སུ་མེད་པ་མ་ཡིན་།
 na dṛśyo nādṛśyaḥ,	བལྟར་སྣང་བ་མ་ཡིན་། བལྟར་མི་སྣང་བ་མ་ཡིན་། ཚུལ་མ་ཡིན་།
 na netrī nānetrī,	ཚུལ་མེད་པ་མ་ཡིན་།
 na mārgapraṇetā nāmārgapraṇetā,	ལམ་སྟོན་པ་མ་ཡིན་། ལམ་མི་སྟོན་པ་མ་ཡིན་།
 na prāptaphalo nāprāptaphalaḥ,	འབྲས་བུ་ཐོབ་པ་མ་ཡིན་། འབྲས་བུ་མ་ཐོབ་པ་མ་ཡིན་།
 na kalpo nākalpaḥ,	རྟོག་པ་མ་ཡིན་། རྟོག་པ་མེད་པ་མ་ཡིན་།
 na kalpāpagato nākalpāpagataḥ |	རྟོག་པ་དང་བྲལ་བ་མ་ཡིན་། རྟོག་པ་དང་མ་བྲལ་བ་མ་ཡིན་མོད་ཀྱི་།
 atha ca punar mañjuśrīs tathāgatasūryamaṇḍalajñānaraśmayas traidhātuke 'nantamadhyadharmadhātvapratihataraśmyavabhāsapramuktāḥ |	འཇམ་དཔལ་། འོན་ཀྱང་དེ་བཞིན་གཤེགས་པ་ཉི་མའི་དཀྱིལ་འཁོར་གྱི་ཡེ་ཤེས་ཀྱི་འོད་ཟེར་དག་ནི་། ཁམས་གསུམ་པོ་དེ་དག་ཏུ་ཆོས་ཀྱི་དབྱིངས་མཐའ་དང་དབུས་མེད་པ་དག་ལ་ཐོགས་པ་མེད་པའི་འོད་ཟེར་གྱི་སྣང་བ་དག་གཏོང་བར་མཛད་ཅིང་། ཡེ་ཤེས་ཀྱི་འོད་ཟེར་བཏང་བ་དག་གིས་ཀྱང་དང་པོ་ཁོ་ནར་བྱང་ཆུབ་སེམས་དཔའ་ལྷག་། པའི་བསམ་༄༥༠༠ཨ་༌༎ 
 prasṛtāś ca raśmayaḥ pūrvataram eva mahāśailendrakalpādhyāśayānāṃ bodhisattvānāṃ kāye nipatanti |	པའི་རིའི་དབང་པོའི་རྒྱལ་པོ་ཆེན་པོ་ལྟ་བུ་དང་ལྡན་པ་རྣམས་ཀྱི་ལུས་ལ་འབབ་པར་འགྱུར་རོ་༎
 tataḥ paścāt pratyekabuddhayānasaṃprasthitānāṃ kāye nipatanti |	དེའི་འོག་ཏུ་རང་སངས་རྒྱས་ཀྱི་ཐེག་པ་ལ་ཡང་དག་བར་ཞུགས་པ་རྣམས་ཀྱི་ལུས་ལ་འབབ་པར་འགྱུར་རོ་༎ 
 tataḥ paścāc chrāvakayānasaṃprasthitānāṃ kāye nipatanti |	དེའི་འོག་ཏུ་ཉན་ཐོས་ཀྱི་ཐེག་པ་ལ་ཡང་དག་པར་ཞུགས་པ་རྣམས་ཀྱི་ལུས་ལ་འབབ་པར་འགྱུར་རོ་༎
 tataḥ paścāt kuśalādhyāśayānāṃ yathādhimuktīnāṃ sattvānāṃ kāye nipatanti |	དེའི་འོག་ཏུ་སེམས་ཅན་ལྷག་པའི་བསམ་པ་དགེ་བ་དང་། མོས་པ་ཇི་ལྟ་བ་དང་ལྡན་པ་རྣམས་ཀྱི་ལུས་ལ་འབབ་པར་འགྱུར་རོ་༎
 tataḥ paścād antaśo mithyātvaniyateṣu sattvasaṃtāneṣu kāye tathāgatasūryamaṇḍalaraśmayo nipatanti |	དེའི་འོག་ཏུ་དེ་བཞིན་གཤེགས་པ་ཉི་མའི་དཀྱིལ་འཁོར་གྱི་ཡེ་ཤེས་ཀྱི་འོད་ཟེར་དག་ཐན་སེམས་ཅན་ལོག་པ་ཉིད་དུ་ངེས་པའི་སེམས་ཀྱི་རྒྱུད་དང་ལྡན་པ་རྣམས་ཀྱི་ལུས་ལ་འབབ་པར་འགྱུར་ཞིང་། 
 teṣāṃ copakārībhūtā bhavanty anāgatahetusaṃjananatayā, saṃvardhayanti ca kuśalair dharmaiḥ |	དེ་དག་ལ་མ་འོངས་པའི་རྒྱུ་ཡང་དག་པར་སྐྱེད་པས་ཕན་འདོགས་པ་དང་། དགེ་བའི་ཆོས་རྣམས་ཀྱིས་ཡང་དག་པར་འཕེལ་བར་ཡང་བྱེད་དོ་༎
 tatra ca tathāgato mañjuśrīḥ samaḥ sarvatropekṣako nirvikalpo nirviśeṣaḥ |	འཇམ་དཔལ་། དེ་བཞིན་གཤེགས་པ་ནི་། དེ་དག་ལ་འང་ཐམས་ཅད་དུ་མཉམ་ཞིང་བཏང་སྙོམས་ལ་རྣམ་པར་མི་རྟོག་ཅིད་བྱེ་བྲག་མི་འབྱེད་དེ་། 
 na punar mañjuśrīs tathāgatajñānasūryamaṇḍalasyaivaṃ bhavati | asyāhaṃ sattvasyodāraṃ (jāa 40)	འཇམ་དཔལ་། དེ་བཞིན་གཤེགས་པ་ཉི་མའི་དཀྱིལ་འཁོར་གྱི་ཡེ་ཤེས་ཀྱི་འོད་ཟེར་ནི་། འདི་སྙམ་དུ་བདག་གིས་སེམས་ཅན་འདི་ལ་ནི་།
 dharmaṃ deśayiṣyāmi,	ཆོས་རྒྱ་ཆེན་པོ་བསྟན་པར་བྱའོ་༎
 asya na deśayiṣyāmīti |	འདི་ལ་ནི་། བསྟན་པར་མི་བྱའོ་༎ སྙམ་དུའང་མི་སེམས་ལ་།
 na tasyaivaṃ vikalpo bhavati,	འདི་༄༥༠༠བ་སྙམ་དུ་སེམས་ཅན་འདི་ནི་།
 ayam udārādhimuktikaḥ sattvaḥ,	རྒྱ་ཆེན་པོ་ལ་མོས་པ་ཡིན་ནོ་༎
 ayaṃ madhyādhimuktikaḥ,	འདི་ནི་། བར་མ་ལ་མོས་པ་ཡིན་ནོ་༎
 ayaṃ śrāvakayānādhimuktikaḥ |	འདི་ནི་། ཉན་ཐོས་ཀྱི་ཐེག་པ་ལ་མོས་པ་ཡིན་ནོ་༎
 ayaṃ kuśalāśayaḥ,	འདི་ནི་། བསམ་པ་དགེ་བ་ཡིན་ནོ་༎ འདི་ནི་།
 ayaṃ hīno mithyāśaya iti |	དམན་པ་དང་ལོག་པ་ལ་མོས་པ་ཡིན་ནོ་༎ སྙམ་དུ་རྣམ་པར་རྟོག་པར་ཡང་མི་བྱེད་དོ་༎
 na mañjuśrīs tathāgatajñānasūryamaṇḍalasyaivaṃ bhavati |	འཇམ་དཔལ་། དེ་བཞིན་གཤེགས་པ་ནི་། འདི་སྙམ་དུ༏་སེམས་ཅན་འདི་ནི་།
 ayam udārāśayādhimuktikaḥ sattvo 'sya mahāyānaṃ deśayiṣyāmi,	རྒྱ་ཆེན་པོ་ལ་མོས་པ་ཡིན་གྱི་། འདི་ལ་ནི་། ཐེག་པ་ཆེན་པོ་བསྟན་པར་བྱའོ་༎
 ayaṃ madhyāśayādhimukto 'sya pratyekabuddhayānaṃ deśayiṣyāmi,	འདི་ནི་། ལྷག་པའི་བསམ་པ་བར་མ་ལ་མོས་པ་ཡིན་གྱི་། འདི་ལ་ནི༏་རང་སངས་རྒྱས་ཀྱི་ཐེག་པ་བསྟན་པར་བྱའོ་༎ འདི་ནི་།
 ayaṃ śrāvakayānādhimuktiko 'sya śrāvakayānaṃ deśayiṣyāmi |	ཉན་ཐོས་ཀྱི་ཐེག་པ་ལ་མོས་པ་ཡིན་གྱི་། འདི་ལ་ནི་། ཉན་ཐོས་ཀྱི་ཐེག་པ་བསྟན་པར་བྱའོ་༎
 kuśalākuśalāśayānāṃ ca sattvānām āśayaṃ viditvā viśodhayiṣyāmi,	སེམས་ཅན་བསམ་པ་དགེ་བ་རྣམས་ཀྱི་བསམ་པ་རྟོགས་པར་བྱས་ནས་བསམ་པ་རྣམ་པར་སྦྱང་བར་བྱའོ་༎ སེམས་ཅན་ལོག་པ་ཉིད་དུ་མོས་པའི་བར་དག་ནི་།
 ṛjukāṃ dṛṣṭiṃ kariṣyāmi |	ལྟ་བ་དྲང་པོ་བྱ་ཞིང་།
 yāvad mithyātvaniyatānām api sattvānāṃ yathānurūpaṃ dharmaṃ deśayiṣyāmi |	ཇི་ལྟར་རྗེས་སུ་མཐུན་པའི་ཆོས་བསྟན་པར་བྱའོ་༎
 na tathāgatajñānasūryamaṇḍalaraśmyavabhāsasyaivaṃ vikalpo bhavati |	སྙམ་དུའང་མི་སེམས་ཏེ་། དེ་བཞིན་གཤེགས་པ་ཉི་མའི་དཀྱིལ་འཁོར་གྱི་ཡེ་ཤེས་ཀྱི་འོད་ཟེར་སྣང་བ་ནི་། དེ་ལྟར་རྣམ་པར་རྟོག་པར་མི་བྱེད་དོ་།
 tat kasya hetoḥ |	དེ་ཅིའི་ཕྱིར་ཞེ་ན་།
 sarvakalpavikalpaprapañcasamucchinnatvāt tathāgatajñānasūryamaṇḍalaraśmyavabhāsasya |	དེ་བཞིན་གཤེགས་པ་ཉི་མའི་དཀྱིལ་འཁོར་གྱི་ཡེ་ཤེས་ཀྱི་འོད་ཟེར་སྣང་བ་ནི་། རྟོག་པ་དང་། རྣམ་པར་རྟོག་པ་དང་། ༄༥༠༡ཨ་༌༎ ཡོངས་སུ་རྟོག་པ་དང་། སྤྲོས་པ་ཐམས་ཅད་ཡང་དག་པར་རྒྱུན་ཆད་པ་ཡིན་པའི་ཕྱིར་རོ་༎ འཇམ་དཔལ་།
 atha ca mañjuśrīḥ sattvānāṃ kuśalāśayasaṃtānavaicitryāt tathāgatajñānasūryamaṇḍalaraśmyavabhāsasya vaicitryaṃ bhavati || §12 ms| 11b7-12b4, p| 313a8-314a6, d| 286a7-287a4, t| 357 243a12-b4, t| 358 251b20-c5, t| 359(d) 257b26-c19|	འོན་ཀྱང་སེམས་ཅན་རྣམས་ཀྱི་དགེ་བའི་བསམ་པའི་རྒྱུད་སྣ་ཚོགས་དག་ལ་དེ་བཞིན་གཤེགས་པ་ཉི་མའི་དཀྱིལ་འཁོར་གྱི་ཡེ་ཤེས་ཀྱི་འོད་ཟེར་གྱི་སྣང་བ་སྣ་ཚོགས་དག་འབྱུང་བར་ཡང་འགྱུར་རོ༏་༏བམ་པོ་གཉིས་པ་། འཇམ་དཔལ་། འདི་ལྟ་སྟེ་།
 tadyathā mañjuśrīr asti mahāsāgare sarvābhiprāyaparipūraṇaṃ nāma mahāmaṇiratnaṃ tad dhvajāgrāvabaddham |	དཔེར་ན་། རྒྱ་མཚོ་ཆེན་པོའི་ནང་ན་ནོར་བུ་ཆེན་པོ་བསམ་པ་ཐམས་ཅད་ཡོངས་སུ་རྫོགས་པར་བྱེད་པ་ཞེས་བྱ་བ་ཞིག་ཡོད་དེ་།
 yasya sattvasya yādṛśo 'bhiprāyo bhavati, tādṛśaṃ tataḥ (jāa 41) śabdaṃ niścarantaṃ sattvāḥ saṃjānanti |	དེ་རྒྱལ་མཚན་གྱི་རྩེ་མོ་ལ་བཏགས་ན་དེ་ལས་སེམས་ཅན་གང་གིས་བསམ་པ་ཅི་འདྲ་བ་དེ་ལྟ་བུའི་སྒྲ་འབྱུང་བར་སེམས་ཅན་རྣམས་ཀྱིས་ཀུན་ཏུ་ཤེས་ཀྱང་ནོར་བུ་རིན་པོ་ཆེ་ཆེན་པོ་དེ་ནི་། 
 tac ca mahāmaṇiratnaṃ na kalpayati na vikalpayati na cintayati na vicintayati,	རྟོག་པར་མི་བྱེད་། རྣམ་པར་རྟོག་པར་མི་བྱེད་། སེམས་པར་མི་བྱེད་། རྣམ་པར་སེམས་པར་མི་བྱེད་ཅིང་།
 acintyaṃ niścintyaṃ cittamanovijñānāpagatam |	སེམས་པ་མེད་པ་། སེམས་མེད་པ་། སེམས་དང་། ཡིད་དང་། རྣམ་པར་ཤེས་པ་དང་བྲལ་བ་ཡིན་ནོ་༎ འཇམ་དཔལ་། དེ་བཞིན་དུ་དེ་བཞིན་གཤེགས་པ་དགྲ་བཅོམ་པ་ཡང་དག་པར་རྫོགས་པའི་སངས་རྒྱས་ཀྱང་རྟོག་པར་མི་བྱེད་། 
 evam eva mañjuśrīs tathāgato na kalpayati na vikalpayati na cintayati na vicintayati,	རྣམ་པར་རྟོག་པར་མི་བྱེད་། སེམས་པར་མི་བྱེད་། རྣམ་པར་སེམས་པར་མི་བྱེད་ཅིང་།
 na cintyo niścintyaś cittamanovijñānāpagataḥ |	༄༥༠༡བ་སེམས་པ་མེད་པ་། སེམས་དང་། ཡིད་དང་། རྣམ་པར་ཤེས་པ་དང་བྲལ་བ་། མ་བཟུང་བ་།
 agrāho 'paryavagrāhaḥ,	ཡོངས་སུ་གཟུང་བར་བྱ་བ་མ་ཡིན་པ་།
 aprāpto 'prāptavyaḥ,	མ་ཐོབ་པ་།
 praṇunnapratyekasatyaḥ,	ཐོབ་པར་བྱ་བ་མ་ཡིན༏་སོ་སོའི་བདེན་པ་གསལ་བ་། འདོད་ཆགས་བསལ་བ་། ཞེ་སྡང་བསལ་བ་།
 praṇunnarāgaḥ praṇunnadoṣaḥ praṇunnamohaḥ,	གཏི་མུག་བསལ་བ་།
 na satyo na mṛṣā,	བདེན་པ་མ་ཡིན་། རྫུན་པ་མ་ཡིན་།
 na nityo nānityaḥ,	རྟག་པ་མ་ཡིན་། མི་རྟག་པ་མ་ཡིན་།
 na prabho nāprabhaḥ,	འོད་མ་ཡིན་།
 na loko nālokaḥ,	འོད་མེད་པ་མ་ཡིན་། འཇིག་རྟེན་མ་ཡིན་། འཇིག་རྟེན་མེད་པ་མ་ཡིན་།
 avitarko 'vicāraḥ,	རྟོག་པ་མེད་པ་། དཔྱོད་པ་མེད་པ་།
 anutpanno 'niruddhaḥ |	མ་སྐྱེས་པ་། མ་འགགས་པ་།
 acintyo 'pracintyaḥ,	བསམ་དུ་མེད་པ་། རབ་ཏུ་བསམ་དུ་མེད་པ་།
 asvabhāvo 'svābhāvyaḥ,	རང་བཞིན་མེད་པ་། རང་བཞིན་གྱི་གཞི་མེད་པ་།
 abhāvaśūnyaḥ,	རང་བཞིན་སྟོང་པ་།
 anāyūho 'niryūhaḥ,	བླང་བ་མེད་པ་། དོར་བ་མེད་པ་།
 anabhiniveśyaḥ,	མངོན་པར་ཞེན་པར་བྱ་བ་མེད་པ་། བརྗོད་དུ་མེད་པ་།
 avyavahāro vyavahārasamucchedaḥ,	བརྗོད་པ་ཡང་དག་པར་རྒྱུན་ཆད་པ་།
 anānando nirānando nandīsamudghātaḥ,	ཀུན་ཏུ་དགའ་བ་མེད་པ་། ཀུན་ཏུ་དགའ་བ་དང་བྲལ་བ་།
 asaṃkhyātaḥ saṃkhyāpagataḥ,	ཀུན་ཏུ་དགའ་བས་ངེས་པར་བཅོམ་པ༏་གྲངས་སུ་བགྲང་བ་མ་ཡིན་པ་དང་། གྲངས་སུ་བགྲང་བ་དང་། འགྲོ་བ་མེད་པ་།
 agatir agatigāmī sarvagatisamucchinnaḥ,	འགྲོ་བར་འགྲོ་བ་མེད་པ་། འགྲོ་བ་ཐམས་ཅད་ཡང་དག་པར་རྒྱུན་ཆད་པ་།
 sarvavyāhārasamucchinnaḥ, adṛśyo 'nālokyo 'grāhyaḥ,	བརྗོད་པ་ཐམས་ཅད་ཡང་དག་པར་རྒྱུན་ཆད་པ་། བལྟར་མི་སྣང་བ་། མི་མཐོང་བ་། གཟུང་དུ་མེད་པ་། ཐ་སྙད་མེད་པ་།
 nāvakāśo nānavakāśaḥ,	ནམ་མཁའ་མ་ཡིན་། བླ་གབ་མེད་པ་མ་ཡིན་། གཟུང་༄༥༠༢ཨ་༌༎ བར་མི་བྱ་བ་མ་ཡིན་། བལྟར་སྣང་བ་མ་ཡིན་།
 na paśyo na nirdeśyaḥ,	བསྟན་པར་བྱ་བ་མ་ཡིན་།
 na sāmagrī na visāmagrī,	ཚོགས་པ་མེད་པ་མ་ཡིན་།
 na vikalpito nāvikalpitaḥ,	བརྟགས་པ་མ་ཡིན་། རྣམ་པར་བརྟགས་པ་མ་ཡིན་། རྣམ་པར་བསྒྲུབས་པ་མ་ཡིན་།
 aviṭhāpito 'saṃdarśitaḥ,	ཀུན་ཏུ་བསྟན་པ་མ་ཡིན་།
 asaṃkliṣṭo 'pariśodhanārhaḥ, na nāma na rūpaṃ na nimittam,	ཀུན་ནས་ཉོན་མོངས་པ་ཅན་མ་ཡིན་། ཡོངས་སུ་སྦྱང་བར་འོས་པ་མ་ཡིན་། མིང་མེད་པ༏་གཟུགས་མེད་པ་། མཚན་མ་མེད་པ་།
 na karma na karmavipākaḥ, nātīto (jāa 42)	ལས་མེད་པ་། ལས་ཀྱི་རྣམ་པར་སྨིན་པ་མེད་པ་། འདས་པ་མ་ཡིན་།
 nānāgato na pratyutpannaḥ,	མ་འོངས་པ་མ་ཡིན་། ད་ལྟར་བྱུང་བ་མ་ཡིན༏་ཅིའང་མ་ཡིན་།
 niṣkiñcanaḥ, araṇaḥ,	ཉོན་མོངས་པ་མེད་པ་།
 anakṣaraḥ,	ཡི་གེ་མེད་པ་།
 aghoṣo ghoṣasamatikrānto 'rutaḥ,	སྒྲ་སྐད་ཐམས་ཅད་ལས་ཡང་དག་པར་འདས་པ་།
 alakṣaṇaḥ sarvalakṣaṇāpagataḥ,	སྒྲ་མེད་པ་། མཚན་ཉིད་མེད་པ་། མཚན་ཉིད་ཐམས་ཅད་དང་བྲལ་བ་།
 nādhyātmyaṃ na bahirddhā nobhayam antareṇopalabhyate |	ནང་ན་མི་དམིགས་། ཕྱི་རོལ་ན་མི་དམིགས་། གཉི་ག་མེད་པར་ཡང་མི་དམིགས་མོད་ཀྱི་།
 atha ca mañjuśrīs tathāgatajñānaratnam adhyāśayapariśuddhaṃ mahākaruṇādhvajāgrāvabaddham,	འཇམ་དཔལ་། འོན་ཀྱང་དེ་བཞིན་གཤེགས་པའི་ལྷག་པའི་བསམ་པ་ཡོངས་སུ་དག་པའི་ཡེ་ཤེས་རིན་པོ་ཆེ་སྙིང་རྗེ་ཆེན་པོའི་རྒྱལ་མཚན་གྱི་རྩེ་མོ་ལ་བཏགས་ན་། 
 tato yo yathāśayādhimuktaḥ sattvaḥ sa tathā dharmadeśanāṃ niścarantīṃ saṃjānāti |	དེ་ལས་སེམས་ཅན་གང་ཡིན་པ་དེའི་བསམ་པ་དང་མོས་པ་ཇི་ལྟ་བ་དེ་ལྟ་བུའི་ཆོས་བསྟན་པ་འབྱུང་བར་སེམས་ཅན་རྣམས་ཀྱིས་ཀུན་ཏུ་ཤེས་ཀྱང་དེ་བཞིན་གཤེགས་པ་ནི་།
 tatra ca tathāgataḥ samaḥ sarvatropekṣako nirvikalpo nirviśeṣaḥ ||	དེ་དག་ལའང་ཐམས་ཅད་དུ་མཉམ་༄༥༠༢བ་ཞིང་བཏང་སྙོམས་ལ་རྣམ་པར་མི་རྟོག་ཅིང་བྱེ་བྲག་མི་འབྱེད་དོ་༎ འཇམ་དཔལ་། འདི་ལྟ་སྟེ་། དཔེར་ན་།
 §13 ms| 12b4-13b3, p| 314a6-315a7, d| 287a4-288a5, t| 357 243b5-c4, t| 358 251c5-8, t| 359(d) 257c20-258a19|	བྲག་ཅ་ནི་།
 tadyathā mañjuśrīḥ pratiśrutkām anyarutavijñaptito niścarantīṃ sattvāḥ saṃjānanti |	གཞན་གྱི་རྣམ་པར་རིག་པ་ལས་འབྱུང་བར་སེམས་ཅན་རྣམས་ཀྱིས་ཀུན་ཏུ་ཤེས་ཀྱང་དེ་ནི་།
 sā ca nātītā nānāgatā na pratyutpannā,	འདས་པ་མ་ཡིན་། མ་འོངས་པ་མ་ཡིན་། ད་ལྟར་བྱུང་བ་མ་ཡིན་།
 nādhyātmaṃ na bahirdhā nobhayam antareṇopalabhyate,	ནང་ན་མ་ཡིན་། ཕྱི་རོལ་ན་མ་ཡིན་། གཉི་ག་མེད་པར་ཡང་མི་དམིགས་ཏེ༏་མ་སྐྱེས་པ་།
 notpannā na niruddhā,	མ་འགགས་པ་།
 nocchinnā na śāśvatā,	ཆད་པ་མ་ཡིན་། རྟག་པ་མ་ཡིན་།
 na jñānavatī nājñānavatī,	ཤེས་པ་དང་ལྡན་པ་མ་ཡིན་།
 na prajñā nāprajñā,	ཤེས་པ་དང་མི་ལྡན་པ་མ་ཡིན་། ཤེས་རབ་མ་ཡིན་། ཤེས་རབ་མེད་པ་མ་ཡིན་།
 na vidyā nāvidyā,	རིག་པ་མ་ཡིན་། རིག་པ་མེད་པ་མ་ཡིན་།
 na vimuktir nāvimuktiḥ,	རྣམ་པར་གྲོལ་བ་མ་ཡིན་། རྣམ་པར་གྲོལ་བ་མེད་པ་མ་ཡིན་།
 na sāvadyā na niravadyā,	ཁ་ན་མ་ཐོ་བ་དང་བཅས་པ་མ་ཡིན་།
 na smṛtir nāsmṛtiḥ,	ཁ་ན་མ་ཐོ་བ་མེད་པ་མ་ཡིན་། དྲན་པ་དང་ལྡན་པ་མ་ཡིན་། དྲན་པ་དང་མི་ལྡན་པ་མ་ཡིན་།
 na sthānavatī nāsthānavatī,	གནས་པ་དང་ལྡན་པ་མ་ཡིན་། གནས་པ་དང་མི་ལྡན་པ་མ་ཡིན༏་འདུག་པ་མ་ཡིན་།
 na niṣadyā nāniṣadyā,	མི་འདུག་པ་མ་ཡིན་།
 na pṛthivīdhātur nābdhātur na tejodhātur na vāyudhātuḥ,	སའི་ཁམས་མ་ཡིན་། ཆུའི་ཁམས་མ་ཡིན་། མེའི་ཁམས་མ་ཡིན་། རླུང་གི་ཁམས་མ་ཡིན་།
 na saṃskṛtā nāsaṃskṛtā,	འདུས་བྱས་མ་ཡིན་། འདུས་མ་བྱས་མ་ཡིན་།
 na niṣprapañcā na saprapañcā, na (jāa 43)	སྤྲོས་པ་ཡོད་པ་མ་ཡིན་། སྤྲོས་པ་མེད་པ་མ་ཡིན་། སྒྲ་མ་ཡིན་།
 rutā nārutā,	སྒྲ་མེད་པ་མ་ཡིན་། བལྟར་སྣང་བ་མ་ཡིན་།
 na dṛśyā nādṛśyā,	བལྟར་མི་སྣང་བ་མ་ཡིན་།
 anakṣarā,	ཡི་གེ་མེད་པ་།
 anakṣarāpagatā,	སྒྲ་མེད་པ་།
 aghoṣā ghoṣasamatikrāntā,	སྒྲ་༄༥༠༣ཨ་༌༎ ལས་ཡང་དག་པར་འདས་པ་། གཞལ་དུ་མེད་པ་།
 atulā tulanāsamatikrāntā,	གཞལ་བ་ལས་ཡང་དག་པར་འདས་པ་།
 alakṣaṇā lakṣaṇāpagatā,	མཚན་ཉིད་མེད་པ་། མཚན་ཉིད་དང་བྲལ་བ༏་ཞི་བ་མ་ཡིན་།
 na śāntir nāśāntiḥ,	མ་ཞི་བ་མ་ཡིན་།
 na dīrghā na hrasvā,	རིང་པོ་མ་ཡིན་། ཐུང་ངུ་མ་ཡིན་།
 na cetanā nācetanā,	སེམས་པ་ཡོད་པ་མ་ཡིན་། སེམས་པ་མེད་པ་མ་ཡིན་།
 na caityā nācaityā,	སྣང་བ་མ་ཡིན་། མི་སྣང་བ་མ་ཡིན༏་བསྟན་དུ་ཡོད་པ་མ་ཡིན་།
 na lokyā nālokyā,	བསྟན་དུ་མེད་པ་མ་ཡིན་།
 darśanasvabhāvena śūnyāsmṛtir amanasikārā,	རང་བཞིན་སྟོང་པ་མ་ཡིན་། དྲན་པ་མེད་པ་། ཡིད་ལ་བྱེད་པ་མེད་པ་།
 avitarkā,	རྟོག་པ་མེད་པ་།
 avicārā, cittamanovijñānāpagatā,	དཔྱོད་པ་མེད་པ༏་སེམས་དང་། ཡིད་དང་། རྣམ་པར་ཤེས་པ་དང་བྲལ་བ་།
 sarvatra samā nirvikalpā,	ཐམས་ཅད་དུ་མཉམ་ཞིང་བཏང་སྙོམས་ལ་རྣམ་པར་མི་རྟོག་ཅིང་བྱེ་བྲག་མི་འབྱེད་པ་།
 nirviśeṣā tryadhvasamatikrāntā |	དུས་གསུམ་ལས་ཡང་དག་པར་འདས་པ་ཡིན་མོད་ཀྱི་།
 atha ca mañjuśrīḥ pratiśrutkā nānārutaghoṣā nānādhyāśayānāṃ sattvānāṃ nānārutaghoṣavijñaptito niścarati |	འཇམ་དཔལ་། འོན་ཀྱང་སེམས་ཅན་ལྷག་པའི་བསམ་པ་ཐ་དད་པ་རྣམས་ཀྱི་སྒྲ་སྐད་དང་། རྣམ་པར་རིག་པ་སྣ་ཚོགས་དག་ལས་བྲག་ཅའི་སྒྲ་སྐད་སྣ་ཚོགས་དག་འབྱུང་བར་འགྱུར་ཞིང་།
 tāṃś ca sattvās tathaiva saṃjānanti |	དེ་དག་ནི་། བྱང་ཆུབ་སེམས་དཔའ་རྣམས་ཀྱིས་དེ་ཁོ་ན་བཞིན་དུ་ཀུན་ཏུ་ཤེས་པར་འགྱུར་རོ་༎ འཇམ་དཔལ་།
 evam eva mañjuśrīs tathāgato 'rhan samyaksaṃbuddho nātīto nānāgato na pratyutpannaḥ,	དེ་བཞིན་དུ་དེ་བཞིན་གཤེགས་པ་དགྲ་བཅོམ་པ་ཡང་དག་པར་རྫོགས་པའི་སངས་རྒྱས་ཀྱང་འདས་པ་མ་ཡིན་། མ་འོངས་པ་མ་ཡིན་། ད་ལྟར་༄༥༠༣བ་བྱུང་བ་མ་ཡིན་།
 nādhyātmaṃ na bahirdhā nobhayam antareṇopalabhyate,	ནང་ན་མ་ཡིན་། ཕྱི་རོལ་ན་མ་ཡིན་ཞིང་། གཉི་ག་མེད་པར་ཡང་མི་དམིགས་ཏེ་།
 notpanno na niruddhaḥ,	མ་སྐྱེས་པ་། མ་འགགས་པ་། ཆད་པ་མ་ཡིན་།
 nocchinno na śāsvataḥ,	རྟག་པ་མ་ཡིན་།
 na jñānavān nājñānavān,	ཤེས་པ་དང་ལྡན་པ་མ་ཡིན་། ཤེས་པ་དང་མི་ལྡན་པ་མ་ཡིན་།
 aprajñāvān nāprajñāvān,	ཤེས་རབ་མ་ཡིན་། ཤེས་རབ་མེད་པ་མ་ཡིན་།
 na vidyā nāvidyā,	རིག་པ་མ་ཡིན་། རིག་པ་མེད་པ་མ་ཡིན་།
 na vimuktir nāvimuktiḥ,	རྣམ་པར་གྲོལ་བ་མ་ཡིན་། རྣམ་པར་གྲོལ་བ་མེད་པ་མ་ཡིན་།
 na sāvadyo na niravadyaḥ,	ཁ་ན་མ་ཐོ་བ་དང་བཅས་པ་མ་ཡིན་། ཁ་ན་མ་ཐོ་བ་མེད་པ་མ་ཡིན་།
 na smṛtimān nāsmṛtimān,	དྲན་པ་དང་ལྡན་པ་མ་ཡིན་། དྲན་པ་དང་མི་ལྡན་པ་མ་ཡིན་།
 na sthānavān nāsthānavān,	གནས་དང་ལྡན་པ་མ་ཡིན་། གནས་དང་མི་ལྡན་པ་མ་ཡིན་། འདུག་པ་མ་ཡིན་།
 na niṣadyo nāniṣadyaḥ,	མི་འདུག་པ་མ་ཡིན་།
 na pṛthivīdhātur nābdhātur na tejodhātur na vāyudhātuḥ,	སའི་ཁམས་མ་ཡིན་། ཆུའི་ཁམས་མ་ཡིན་། མེའི་ཁམས་མ་ཡིན་།
 na saṃskṛto nāsaṃskṛtaḥ, na (jāa 44)	རླུང་གི་ཁམས་མ་ཡིན་། འདུས་བྱས་མ་ཡིན་། འདུས་མ་བྱས་མ་ཡིན་།
 prapañco nāprapañcaḥ,	སྤྲོས་པ་ཡོད་པ་མ་ཡིན་། སྤྲོས་པ་མེད་པ་མ་ཡིན་། སྒྲ་མ་ཡིན་།
 na ruto nārutaḥ,	སྒྲ་མེད་པ་མ་ཡིན་།
 na dṛśyo nādṛśyaḥ,	བལྟར་སྣང་བ་མ་ཡིན་། བལྟར་མི་སྣང་བ་མ་ཡིན༏་ཡི་གེ་མེད་པ་།
 anakṣaraḥ,	སྒྲ་མེད་པ་།
 aghoṣo ghoṣasamatikrāntaḥ,	སྒྲ་ལས་ཡང་དག་པར་འདས་པ་། གཞལ་དུ་མེད་པ་།
 atulas tulāsamatikrāntaḥ,	གཞལ་བ་ལས་ཡང་དག་པར་འདས་པ་།
 alakṣaṇo lakṣaṇāpagataḥ,	མཚན་ཉིད་མེད་པ་། མཚན་ཉིད་དང་བྲལ་བ༏་ཞི་བ་མ་ཡིན་།
 na śānto nāśāntaḥ,	མ་ཞི་བ་མ་ཡིན་།
 na dīrgho na hrasvaḥ,	རིང་པོ་མ་ཡིན་། ཐུང་ངུ་མ་ཡིན་།
 na cetano nācetanaḥ,	སེམས་པ་ཡོད་པ་མ་ཡིན་།
 na caityo nācaityaḥ,	སེམས་པ་མེད་པ་མ་ཡིན་། སྣང་བ་མ་ཡིན་། མི་སྣང་བ་མ་ཡིན་། བསྟན་༄༥༠༤ཨ་༌༎ དུ་ཡོད་པ་མ་ཡིན་།
 na lokyo nālokyaḥ,	བསྟན་དུ་མེད་པ་མ་ཡིན་།
 darśanasvabhāvena śūnyaḥ,	རང་བཞིན་སྟོང་པ་།
 asmṛtī,	དྲན་པ་མེད་པ་།
 amanasikāraḥ,	ཡིད་ལ་བྱེད་པ་མེད་པ་།
 avitarkaḥ,	རྟོག་པ་མེད་པ་།
 avicāraḥ, cittamanovijñānāpagataḥ,	དཔྱོད་པ་མེད་པ༏་སེམས་དང་། ཡིད་དང་། རྣམ་པར་ཤེས་པ་དང་བྲལ་བ་།
 sarvatra samo nirvikalpaḥ,	ཐམས་ཅད་དུ་མཉམ་ཞིང་བཏང་སྙོམས་ལ་རྣམ་པར་མི་རྟོག་ཅིང་བྱེ་བྲག་མི་འབྱེད་ལ་།
 nirviśeṣas tryadhvasamatikramaḥ |	དུས་གསུམ་ལས་ཡང་དག་པར་འདས་པ་ཡིན་མོད་ཀྱི་། འཇམ་དཔལ་།
 atha ca mañjuśrīr nānāvimuktāḥ sattvā nānādhyāśayavijñaptitas tathāgatavācaṃ niścarantīṃ saṃjānanti || §14 ms| 13b3-14a2, p| 315a7-b7, d| 288a5-b4, t| 357 243c4-19, t| 358 251c8-12, t| 359(d) 258a19-b2|	འོན་ཀྱང་སེམས་ཅན་མོས་པ་ཐ་དད་པ་རྣམས་ཀྱི་ལྷག་པའི་བསམ་པ་དང་། རྣམ་པར་རིག་པ་སྣ་ཚོགས་དག་ལས་དེ་བཞིན་གཤེགས་པའི་གསུང་འབྱུང་བར་ཀུན་ཏུ་ཤེས་པར་འགྱུར་རོ་༎ འཇམ་དཔལ་།
 tadyathāpi mañjuśrīḥ pṛthivīṃ niśritya pṛthivīṃ pratiṣṭhāya sarvatṛṇagulmauṣadhivanaspatayo vṛddhiṃ virūḍhiṃ vaipulyatām āpadyante |	འདི་ལྟ་སྟེ་། དཔེར་ན་། ས་ལ་བརྟེན་ཅིང་ས་ལ་གནས་ནས་རཙབ༹་དང་། ཤིང་གེལ་པ་དང་། རྩི་དང་། ནགས་ཚལ་ཐམས་ཅད་འཕེལ་ཞིང་རྒྱས་པ་དང་། ཡངས་པར་འགྱུར་ཡང་འཇམ་དཔལ་།
 na mañjuśrīḥ pṛthivī kalpayati,	ས་ནི་། རྟོག་པར་མི་བྱེད་།
 na vikalpayati,	རྣམ་པར་རྟོག་པར་མི་བྱེད་དེ་།
 sarvatra samā nirvikalpā,	ཐམས་ཅད་དུ་མཉམ་ཞིང་རྣམ་པར་མི་རྟོག་པ་། བྱེ་བྲག་མི་འབྱེད་ཅིང་སེམས་པར་མི་བྱེད་དེ་།
 nirviśeṣā niścintā cittamanovijñānāpagatā |	སེམས་དང་། ཡིད་དང་། རྣམ་པར་ཤེས་པ་དང་བྲལ་བ་ཡིན་། འཇམ་དཔལ་།
 evam eva mañjuśrīs tathāgataṃ niśritya tathāgataṃ pratiṣṭhāya sarvasattvānāṃ sarvakuśalamūlāni vṛddhiṃ virūḍhiṃ vaipulyatām āpadyante |	དེ་བཞིན་དུ་དེ་བཞིན་གཤེགས་པ་ལ་བརྟེན་ཅིང་དེ་བཞིན་གཤེགས་པ་ལ་གནས་ནས་སེམས་ཅན་ཉན་ཐོས་ཀྱི་ཐེག་པའམ་།
 śrāvakayānikānāṃ vā pratyekabuddhayānikānāṃ vā mahāyānikānāṃ vā, anyeṣāṃ (jāa 45)	རང་སངས་རྒྱས་ཀྱི་ཐེག་པའམ་། ཐེག་པ་༄༥༠༤བ་ཆེན་པོ་པ་ཐམས་ཅད་ཀྱི་དགེ་བའི་རྩ་བ་ཐམས་ཅད་ཀྱང་འཕེལ་ཞིང་རྒྱས་པ་དང་། ཡངས་པར་འགྱུར་ལ་།
 vā carakaparivrājakanirgranthaprabhṛtīnāṃ sarvatīrthyāyatanānāṃ kuśalamūlāni,	དེ་བཞིན་གཤེགས་པ་ལ་བརྟེན་ཅིང་དེ་བཞིན་གཤེགས་པ་ལ་གནས་ནས་སྤྱོད་པ་པ་དང་། ཀུན་ཏུ་རྒྱུ་དང་། གཅེར་བུ་པ་ལ་སོགས་པ་མུ་སྟེགས་ཀྱི་གནས་གཞན་ཐམས་ཅད་ཀྱི་དགེ་བའི་རྩ་བ་ཐམས་ཅད་དང་། 
 yāni cānyāny antaśo mithyātvaniyatānāṃ kuśalamūlāni sarvāṇi tāni tathāgataṃ niśritya tathāgataṃ pratiṣṭhāya vṛddhiṃ virūḍhiṃ vaipulyatām āpadyante	ཐ་ན་ལོག་པ་ཉིད་དུ་ངེས་པ་རྣམས་ཀྱི་དགེ་བའི་རྩ་བ་གཞན་གང་དག་ཡིན་པ་དེ་དག་ཐམས་ཅད་ཀྱང་འཕེལ་ཞིང་རྒྱས་པ་དང་། དང་། ཡངས་པར་འགྱུར་མོད་ཀྱི་། འཇམ་དཔལ་།
 na ca mañjuśrīs tathāgataḥ kalpayati,	འོན་ཀྱང་དེ་བཞིན་གཤེགས་པ་ནི་།
 na vikalpayati |	རྟོག་པར་མི་བྱེད༏་རྣམ་པར་རྟོག་པར་མི་བྱེད་དེ་། འཇམ་དཔལ་།
 sarvakalpavikalpārambaṇamanasikārocchinno mañjuśrīs tathāgato 'rhan samyaksaṃbuddhaḥ,	དེ་བཞིན་གཤེགས་པ་དགྲ་བཅོམ་པ་ཡང་དག་པར་རྫོགས་པའི་སངས་རྒྱས་ནི་། རྟོག་པ་དང་། རྣམ་པར་རྟོག་པ་དང་། དམིགས་པ་དང་ཡིད་ལ་བྱེད་པ་ཐམས་ཅད་རྒྱུན་ཆད་པ་།
 cittamanovijñānāpagataḥ,	སེམས་དང་ཡིད་དང་རྣམ་པར་ཤེས་པ་དང་བྲལ་བ་།
 atarkaḥ,	རྟོག་གེ་མ་ཡིན་།
 atarkāvacaraḥ,	རྟོག་གེའི་སྤྱོད་ཡུལ་མ་ཡིན་།
 adṛśyaḥ,	མི་སྣང་བ་།
 anālokyaḥ,	མི་མཐོང་བ་།
 acintyaḥ,	བསམ་དུ་མེད་པ་།
 acintanīyaḥ,	བསམ་པར་བྱ་བ་མ་ཡིན་པ་།
 amanasikāraḥ,	ཡིད་ལ་བྱེད་པ་མེད་པ་།
 niścintaḥ,	སེམས་པ་མེད་པ་།
 cittamanovijñānāpagataḥ,	སེམས་དང་། ཡིད་དང་། རྣམ་པར་ཤེས་པ་དང་བྲལ་བ་།
 samaḥ sarvatropekṣako nirvikalpo nirviśeṣaḥ ||	ཐམས་ཅད་དུ་མཉམ་ཞིང་བཏང་སྙོམས་ལ་རྣམ་པར་མི་རྟོག་ཅིང་བྱེ་བྲག་མི་འབྱེད་དོ་༎ འཇམ་དཔལ་།
 §15 ms| 14a2-15a2, p| 315b7-317a1, d| 288b4-289b4, t| 357 243c20-224a29, t| 358 251c12-20, t| 359(d) 258b2-c7|	འདི་ལྟ་སྟེ་། དཔེར་ན་།
 tadyathā mañjuśrīr ākāśaṃ sarvatra samaṃ nirvikalpaṃ nirviśeṣam,	ནམ་མཁའ་ནི་། ཐམས་ཅད་དུ་མཉམ་ཞིང་༄༥༠༥ཨ་༌༎ རྣམ་པར་མི་རྟོག་ལ་། བྱེ་བྲག་མི་འབྱེད་དེ་།
 anutpannam aniruddham,	མ་སྐྱེས་པ་། མ་འགགས་པ་།
 nātītaṃ nānāgataṃ na pratyutpannam, alakṣyam,	འདས་པ་མ་ཡིན་། མ་འོངས་པ་མ་ཡིན་། ད་ལྟར་བྱུང་བ་མ་ཡིན༏་མཚན་གཞི་མེད་པ་།
 aprapañcam,	སྤྲོས་པ་མེད་པ་།
 anirūpi,	གཟུགས་མེད་པ་།
 anidarśanam,	བསྟན་དུ་མེད་པ་།
 avijñapanīyam,	རྣམ་པར་རིག་པ་མེད་པ་།
 asaṃsparśam,	རེག་པ་མེད་པ་།
 aniketam,	གནས་མེད་པ་།
 atulyaṃ tulāsamatikrāntam,	གཞལ་དུ་མེད་པ༏་གཞལ་བ་ལས་ཡང་དག་པར་འདས་པ་།
 anupamam upamāsamatikrāntam,	དཔེ་མེད་པ་། དཔེ་ལས་ཡང་དག་པར་འདས་པ་།
 apratiṣṭham,	མི་གནས་པ་།
 agrāhyam,	གཟུང་བ་མེད་པ་།
 cakṣuḥpathasamatikrāntam,	མིག་གི་ལམ་ལས་ཡང་དག་པར་འདས་པ་།
 cittamanovijñānāpagatam,	སེམས་དང་ཡིད་དང་རྣམ་པར་ཤེས་པ་དང་བྲལ་བ་།
 alakṣaṇam,	མཚན་ཉིད་མེད་པ་།
 anakṣaram,	ཡི་གེ་མེད་པ་།
 aghoṣam,	སྒྲ་མེད་པ་།
 amanasikāram, anāyūham (jāa 46)	ཡིད་ལ་བྱེད་པ་མེད་པ་། བླང་བ་མེད་པ་།
 aniryūham, anikṣepam aprakṣepam,	དོར་པ་མེད་པ་། གདེག་པ་མེད་པ་། གཞག་པ་མེད་པ་།
 vākpathasamatikrāntam,	ཚིག་གི་ལམ་ལས་ཡང་དག་པར་འདས་པ་།
 sarvatrānugatam apratiṣṭhitam |	ཐམས་ཅད་ཀྱི་རྗེས་སུ་སོང་ཞིང་རྗེས་སུ་ཞུགས་པ་ཡིན་མོད་ཀྱི་།
 atha mañjuśrīḥ sattvāḥ saṃsthānasya hīnamadhyotkṛṣṭatayākāśaṃ hīnotkṛṣṭaṃ saṃjānanti |	འཇམ་དཔལ༏་འོན་ཀྱང་སེམས་ཅན་རྣམས་ཀྱིས་དབྱིབས་ཆུང་དུ་དང་། འབྲིང་དང་། ཆེན་པོ་དག་གིས་ནམ་མཁའ་ཡང་ཆུང་དུ་དང་། འབྲིང་དང་། ཆེན་པོར་ཀུན་ཏུ་ཤེས་པར་འགྱུར་རོ་༎
 evam eva mañjuśrīs tathāgato 'py arhan samyaksaṃbuddhaḥ sarvatra samo nirviśeṣaḥ,	འཇམ་དཔལ་། དེ་བཞིན་དུ་དེ་བཞིན་གཤེགས་པ་དགྲ་བཅོམ་པ་ཡང་དག་པར་རྫོགས་པའི་སངས་རྒྱས་ཀྱང་ཐམས་ཅད་དུ་མཉམ་ཞིང་རྣམ་པར་མི་རྟོག་ལ་། བྱེ་༄༥༠༥བ་བྲག་མི་འབྱེད་དེ་།
 anutpanno 'niruddhaḥ,	མ་སྐྱེས་པ་། མ་འགགས་པ་།
 nātīto nānāgato na pratyutpannaḥ,	འདས་པ་མ་ཡིན་། མ་འོངས་པ་མ་ཡིན་། ད་ལྟར་བྱུང་བ་མ་ཡིན་། མཚན་གཞི་མེད་པ་།
 alakṣyo 'prapañcaḥ,	སྤྲོས་པ་མེད་པ་།
 arūpy anidarśano 'vijñaptikaḥ,	གཟུགས་མེད་པ༏་བསྟན་དུ་མེད་པ་། རྣམ་པར་རིག་པ་མེད་པ་།
 asparśo 'niketaḥ,	རེག་པ་མེད་པ་། གནས་མེད་པ་། གཞལ་དུ་མེད་པ་།
 atulas tulāsamatikrāntaḥ,	གཞལ་བ་ལས་ཡང་དག་པར་འདས་པ་།
 anupama upamāsamatikrāntaḥ,	དཔེ་མེད་པ་། དཔེ་ལས་ཡང་དག་པར་འདས་པ་།
 apratiṣṭhitaḥ,	མི་གནས་པ་།
 agrāhyaḥ,	གཟུང་བ་མེད་པ་།
 cakṣuḥpathasamatikrāntaḥ,	མིག་གི་ལམ་ལས་ཡང་དག་པར་འདས་པ་།
 cittamanovijñānāpagataḥ,	སེམས་དང་ཡིད་དང་རྣམ་པར་ཤེས་པ་དང་བྲལ་བ་། མཚན་ཉིད་མེད་པ་།
 alakṣaṇaḥ,	ཡི་གེ་མེད་པ་།
 anakṣaraḥ,	སྒྲ་མེད་པ་།
 aghoṣo 'manasikāraḥ,	ཡིད་ལ་བྱེད་པ་མེད་པ་།
 anāyūhāniryūhaḥ,	བླང་བ་མེད་པ་།
 anikṣepo 'prakṣepaḥ,	དོར་བ་མེད་པ་། གདེག་པ་མེད་པ་། གཞག་པ་མེད་པ་།
 vākpathasamatikrāntaḥ,	ཚིག་གི་ལམ་ལས་ཡང་དག་པར་འདས་པ་།
 sarvatrānugato 'nupraviṣṭaḥ |	ཐམས་ཅད་ཀྱི་རྗེས་སུ་སོང་ཞིང་རྗེས་སུ་ཞུགས་པ་ཡིན་མོད་ཀྱི་།
 atha ca mañjuśrīr ye hīnamadhyotkṛṣṭāśayāḥ sattvās te hīnamadhyotkṛṣṭaṃ tathāgataṃ paśyanti ||	འཇམ་དཔལ་། འོན་ཀྱང་སེམས་ཅན་དམན་པ་དང་། འབྲིང་དང་། མཆོག་གང་དག་ཡིན་པ་དེ་དག་གིས་དེ་བཞིན་གཤེགས་པ་ཡང་དག་པ་དང་། འབྲིང་དང་། མཆོག་ཏུ་མཐོང་ངོ་༎
 na ca mañjuśrīs tathāgatasyaivaṃ bhavati |	འཇམ་དཔལ་། དེ་བཞིན་གཤེགས་པ་ནི་། འདི་སྙམ་དུ་སེམས་ཅན་འདི་ནི་།
 ayaṃ hīnādhyāśayādhimuktaḥ sattvaḥ,	བསམ་པ་དང་། མོས་པ་དམན་པ་ཡིན་གྱི་།
 asya sattvasya hīnāṃ rūpakāyavarṇapariniṣpattiṃ darśayiṣyāmi |	སེམས་ཅན་འདི་ལ་ནི་། གཟུགས་ཀྱི་སྐུའི་ཁ་དོག་ཡོངས་སུ་འགྲུབ་པ་དམན་པ་བསྟན་པར་བྱའོ་༎
 ayaṃ madhyāśayādhimuktaḥ sattvaḥ,	སེམས་ཅན་འདི་ནི་། བསམ་པ་༄༥༠༦ཨ་༌༎ དང་། མོས་པ་འབྲིང་ཡིན་གྱི་།
 asya madhyamāṃ rūpakāyavarṇapariniṣpattiṃ darśayiṣyāmi |	སེམས་ཅན་འདི་ལ་ནི་། གཟུགས་ཀྱི་སྐུའི་ཁ་དོག་ཡོངས་སུ་འགྲུབ་པ་འབྲིང་བསྟན་པར་བྱའོ་༎
 ayam udārāśayādhimuktaḥ sattvaḥ,	སེམས་ཅན་འདི་ནི་། བསམ་པ་དང་མོས་པ་རྒྱ་ཆེ་བ་ཡིན་གྱི་། སེམས་ཅན་འདི་ལ་ནི་།
 asyodārāṃ rūpakāyavarṇapariniṣpattiṃ darśayiṣyāmi ||	གཟུགས་ཀྱི་སྐུའི་ཁ་དོག་ཡོངས་སུ་འགྲུབ་པ་རྒྱ་ཆེན་པོ་བསྟན་པར་བྱའོ་༎ སྙམ་དུ་མི་སེམས་སོ་༎
 evam eva mañjuśrīr dharmadeśanāyām anugantavyam |	འཇམ་དཔལ་། ཆོས་སྟོན་པའང་དེ་བཞིན་དུ་རྟོགས་པར་བྱ་སྟེ་།
 na ca mañjuśrīs tathāgatasyaivaṃ bhavati |	འཇམ་དཔལ་། དེ་བཞིན་གཤེགས་པ་ནི་། འདི་སྙམ་དུ་སེམས་ཅན་འདི་ནི་།
 ayaṃ hīnādhimuktaḥ (jāa 47)	དམན་པ་ལ་མོས་པ་ཡིན་གྱི་།
 sattvaḥ, asya sattvasya hīnāṃ śrāvakayānakathāṃ kariṣye |	སེམས་ཅན་འདི་ལ་ནི་། ཉན་ཐོས་ཀྱི་ཐེག་པའི་གཏམ་དམན་པ་བརྗོད་པར་བྱའོ་༎
 ayaṃ madhyāśayādhimuktaḥ sattvaḥ,	སེམས་ཅན་འདི་ནི་། བར་མ་ལ་མོས་པ་ཡིན་གྱི་། སེམས་ཅན་འདི་ལ་ནི་།
 asya sattvasya pratyekabuddhayānakathāṃ kariṣye |	རང་སངས་རྒྱས་ཀྱི་ཐེག་པའི་གཏམ་བར་མ་བརྗོད་པར་བྱའོ་༎
 ayam udārāśayādhimuktaḥ sattvaḥ,	སེམས་ཅན་འདི་ནི་། རྒྱ་ཆེན་པོ་ལ་མོས་པ་ཡིན་གྱི་། སེམས་ཅན་འདི་ལ་ནི་།
 asya sattvasya mahāyānakathāṃ kariṣye ||	ཐེག་པ་ཆེན་པོའི་གཏམ་རྒྱ་ཆེན་པོ་བརྗོད་པར་བྱའོ་༎ སྙམ་དུ་མི་སེམས་སོ་༎
 na mañjuśrīs tathāgatasyaivaṃ bhavati |	འཇམ་དཔལ་། དེ་བཞིན་གཤེགས་པ་ནི་། འདི་སྙམ་དུ་སེམས་ཅན་འདི་ནི་།
 ayam udārādhimuktaḥ sattvaḥ,	སྦྱིན་པ་ལ་མོས་པ་ཡིན་གྱི༏་སེམས་ཅན་འདི་ལ་ནི་།
 asya sattvasya dānakathāṃ kariṣye ||	སྦྱིན་པའི་གཏམ་བརྗོད་པར་བྱའོ་༎ སེམས་ཅན་འདི་ནི་།
 evaṃ śīlaṃ kṣāntiṃ vīryaṃ dhyānaṃ ca |	ཚུལ་ཁྲིམས་དང་། བཟོད་པ་དང་། བརྩོན་འགྲུས་དང་། བསམ་གཏན་ལ་མོས་༄༥༠༦བ་པ་ཡིན་གྱི་། སེམས་ཅན་འདི་ལ་ནི་། བསམ་གཏན་གྱི་གཏམ་བརྗོད་པར་བྱའོ་༎ སྙམ་དུའང་མི་སེམས་སོ་༎
 na mañjuśrīs tathāgatasyaivaṃ bhavati |	འཇམ་དཔལ་། དེ་བཞིན་དུ་དེ་བཞིན་གཤེགས་པ་ནི་། འདི་སྙམ་དུ་སེམས་ཅན་འདི་ནི་།
 ayaṃ prajñāpāramitādhimuktaḥ sattvaḥ,	ཤེས་རབ་ཀྱི་ཕ་རོལ་ཏུ་ཕྱིན་པ་ལ་མོས་པ་ཡིན་གྱི་།
 asya sattvasya prajñāpāramitāṃ kathāṃ kathayiṣye |	སེམས་ཅན་འདི་ལ་ནི་། ཤེས་རབ་ཀྱི་ཕ་རོལ་ཏུ་ཕྱིན་པའི་གཏམ་བརྗོད་པར་བྱའོ་༎
 naivaṃ mañjuśrīs tathāgatasyaivaṃ bhavati |	སྙམ་དུའང་མི་སེམས་ཏེ་། འཇམ་དཔལ་། དེ་བཞིན་གཤེགས་པ་ལ་ནི་། རྣམ་པར་རྟོག་པ་དེ་ལྟ་བུ་དག་མེད་དོ་༎
 tat kasmād dhetoḥ |	དེ་ཅིའི་ཕྱིར་ཞེ་ན་།
 dharmakāyo mañjuśrīs tathāgataḥ |	འཇམ་དཔལ་། དེ་བཞིན་གཤེགས་པ་ནི་། ཆོས་ཀྱི་སྐུ་ཡིན་པའི་ཕྱིར་ཏེ་།
 atyantānutpanno mañjuśrīs tathāgataḥ || (jāa 48) iii	འཇམ་དཔལ་།
 §16 ms| 15a2-16a4, p| 317a1-318a4, d| 289b4-290b6, t| 357 224a29-c13, t| 358 251c20-29, t| 359(d) 258c7-259a15|	དེ་བཞིན་གཤེགས་པ་ནི་། ཤིན་ཏུ་མ་སྐྱེས་པ་དང་། མ་འགགས་པ་ཡིན་ནོ་༎
 na mañjuśrīs tathāgatasya nāmarūpaniruktyānusāri vijñānaṃ pravartate |	འཇམ་དཔལ་། དེ་བཞིན་གཤེགས་པའི་རྣམ་པར་ཤེས་པ་ནི་། མིང་དང་། གཟུགས་དང་། ངེས་པའི་ཚིག་གི་རྗེས་སུ་འབྲང་ཞིང་འབྱུང་བ་མ་ཡིན་ཏེ་།
 na mañjuśrīs tathāgataḥ kalpayati,	འཇམ་དཔལ་། དེ་བཞིན་གཤེགས་པ་ནི་། རྟོག་པར་མི་བྱེད་།
 na vikalpayati |	རྣམ་པར་རྟོག་པར་མི་བྱེད་པ་ཡིན་ནོ་༎ འཇམ་དཔལ་།
 kṣaṇiko hi mañjuśrīs tathāgato 'kṣayalakṣaṇo 'kṣayakoṭībhūtakoṭīniyataḥ ||	དེ་བཞིན་གཤེགས་པ་ནི་། སྐད་ཅིག་པ་ཡིན་ཏེ་། མི་ཟད་པའི་མཚན་ཉིད་དང་། མི་ཟད་པའི་མཐའ་དང་། ཡང་དག་པའི་མཐར་ངེས་པ་ཡིན་ནོ་༎ འཇམ་དཔལ་།
 sarvadharmasamatākoṭī mañjuśrīs tathāgato 'rhan samyaksambuddhaḥ samaḥ sarvatra nirvikalpo nirviśeṣaḥ,	དེ་བཞིན་གཤེགས་པ་དགྲ་བཅོམ་པ་ཡང་དག་པར་རྫོགས་པའི་སངས་རྒྱས་ནི་། ཆོས་ཐམས་ཅད་ཀྱི་མཉམ་པ་ཉིད་ཀྱི་༄༥༠༧ཨ་༌༎ མཐའ་དང་། གཉིས་སུ་མེད་པའི་མཐའ་དང་། ཤིན་ཏུ་འབྱུང་བ་མེད་པའི་མཐའ་ཡིན་ཏེ་། ཐམས་ཅད་དུ་མཉམ་ཞིང་རྣམ་པར་མི་རྟོག་ལ་བྱེ་བྲག་མི་འབྱེད་དེ་།
 na hīno na madhyo notkṛṣṭaḥ |	དམན་པ་མ་ཡིན་། བར་མ་མ་ཡིན་། མཆོག་མ་ཡིན་ནོ་༎
 evam eva mañjuśrīḥ samāḥ sarvadharmāḥ, nirvikalpā nirviśeṣāḥ,	འཇམ་དཔལ་། དེ་བཞིན་དུ་ཆོས་ཐམས་ཅད་ཀྱང་མཉམ་ཞིང་རྣམ་པར་མི་རྟོག་ལ་བྱེ་བྲག་མི་འབྱེད་དེ་།
 na hīnā na madhyā notkṛṣṭāḥ |	དམན་པ་མ་ཡིན་། བར་མ་མ་ཡིན་། མཆོག་མ་ཡིན་ནོ་༎
 tat kasmād dhetoḥ |	དེ་ཅིའི་ཕྱིར་ཞེ་ན་། འཇམ་དཔལ་།
 anupalabdhitvāt sarvadharmāṇām |	ཆོས་ཐམས་ཅད་ནི་། དམིགས་སུ་མེད་པའི་ཕྱིར་ཏེ་། འཇམ་དཔལ་།
 yā mañjuśrīr anupalabdhiḥ sarvadharmāṇāṃ sā samatā,	ཆོས་ཐམས་ཅད་ནི་། དམིགས་སུ་མེད་པ་གང་ཡིན་པ་དེ་ནི་། མཉམ་པ་ཉིད་ཡིན་ནོ་༎
 yā samatā sā sthitā,	མཉམ་པ་ཉིད་གང་ཡིན་པ་དེ་ནི་། གནས་པ་ཉིད་ཡིན་ནོ་༎
 yā sthitā sācalanatā,	གནས་པ་ཉིད་གང་ཡིན་པ་དེ་ནི་། མི་ག-ཡོ་བ་ཉིད་ཡིན་ནོ་༎ མི་ག-ཡོ་བ་ཉིད་གང་ཡིན་པ་དེ་ནི་།
 yācalanatā sāniśrayatā ||	མི་རྟེན་པ་ཉིད་ཡིན་ནོ་༎
 aniśritasya sarvadharmeṣu nāsti cittapratiṣṭhānam |	ཆོས་ཐམས་ཅད་ལ་། མི་རྟེན་པའི་སེམས་ཀྱི་གནས་མེད་དོ་༎
 apratiṣṭhitacittasyānutpattir ājāyate |	སེམས་མི་གནས་པ་ནི་།
 evaṃ darśinaś ca viparyastāc cittacaitasikā na pravartante |	སྐྱེ་བ་མེད་པར་གྱུར་ཏེ་། དེ་ལྟར་མཐོང་བའི་སེམས་དང་། སེམས་ལས་བྱུང་བ་རྣམས་ནི་། ཕྱིན་ཅི་མ་ལོག་པར་འཇུག་པར་འགྱུར་རོ་༎
 yaś cāviparyastacittaḥ sa yathāvatprāpto bhavati |	གང་གིས་སེམས་ཕྱིན་ཅི་མ་ལོག་པ་དེས་ནི་། ཇི་ལྟ་བ་བཞིན་ཐོབ་པར་འགྱུར་རོ་༎
 yathāvatprāpto na prapañcayati |	ཇི་ལྟ་བ་བཞིན་ཐོབ་པ་ནི་། འཕྲོ་བར་མི་བྱེད་དོ་༎
 aprapañcayataḥ pracāro nāsti |	སྤྲོས་པ་མེད་པ་ལ་ནི་།
 yadā na pracarati tadā na saṃcarati |	སྤྱོད་པའང་༄༥༠༧བ་མེད་དོ༏་༏གང་གི་ཚེ་སྤྱོད་པར་མི་བྱེད་པ་དེའི་ཚེ་མི་འཁོར་རོ་༎
 yadā na saṃcarati tadā na visarati |	གང་གི་ཚེ་མི་འཁོར་བ་དེའི་ཚེ་རྣམ་པར་མི་འཕྲོ་སྟེ་།
 avisaraṃ dharmatāṃ na virodhayati |	རྣམ་པར་འཕྲོ་བ་མེད་པ་ནི་། ཆོས་ཉིད་དང་འགལ་བར་མི་བྱེད་དོ་༎ ཆོས་ཉིད་དང་མི་འགལ་བ་ནི་།
 dharmatām avirodhayan sarvatrānulomo bhavati |	ཐམས་ཅད་དང་རྗེས་སུ་མཐུན་པར་འགྱུར་རོ་༎
 sarvatrānulomo dharmaprakṛter na calati |	ཐམས་ཅད་དང་རྗེས་སུ་མཐུན་པ་ནི་། ཆོས་ཀྱི་རང་བཞིན་ལས་མི་ག-ཡོའོ་༎ ཆོས་ཀྱི་རང་བཞིན་བས་ནི་།
 dharmaprakṛter acalaṃ dharmaprakṛtiprāpto bhavati |	ཆོས་ཀྱི་རང་བཞིན་ཐོབ་པར་འགྱུར་རོ་༎
 dharmaprakṛtiprāpto na kiṃcit prapañcayati |	ཆོས་ཀྱི་རང་བཞིན་ཐོབ་པ་ནི་། ཅུང་ཟད་ཀྱང་འཕྲོ་བར་མི་བྱེད་དོ་༎
 tat kasya hetoḥ |	དེ་ཅིའི་ཕྱིར་ཞེ་ན་། འཇམ་དཔལ་།
 pratyayahetujanitatvāt ||	རྒྱུ་དང་རྐྱེན་གྱིས་བསྐྱེད་པའི་ཕྱིར་ཏེ་།
 yaḥ pratyayahetujanitaḥ so 'tyantājātaḥ |	རྒྱུ་དང་རྐྱེན་གྱིས་བསྐྱེད་པ་གང་ཡིན་པ་དེ་ནི་། ཤིན་ཏུ་མ་སྐྱེས་པ་ཡིན་ནོ་༎
 yaś cātyantājātaḥ (jāa 49)	ཤིན་ཏུ་མ་སྐྱེས་པ་གང་ཡིན་པ་དེས་ནི་།
 sa niyāmaprāptaḥ |	ངེས་པ་འཐོབ་བོ་༎
 yaś ca niyāmaprāptaḥ sa sarvadharmamanasikāraiḥ sārdhaṃ na saṃvasati |	ངེས་པ་ཐོབ་པ་གང་ཡིན་པ་དེ་ནི་། ཆོས་ཐམས་ཅད་ཡིད་ལ་བྱེད་པ་དང་ལྷན་ཅིག་མི་གནས་ཏེ་།
 yadā sarvadharmamanasikāraiḥ sārdhaṃ na saṃvasati tadā saṃvāśyo na bhavati |	གང་གི་ཚེ་ཆོས་ཐམས་ཅད་ཡིད་ལ་བྱེད་པ་དང་ལྷན་ཅིག་མི་གནས་པ་དེའི་ཚེ་གནས་པར་བྱ་བ་མེད་པ་ཡིན་ནོ་༎
 yadā saṃvāśyo na bhavati tadā na bhavati na vibhavati |	གང་གི་ཚེ་གནས་པར་བྱ་བ་མེད་པ་དེའི་ཚེ་མི་འབྱུང་མི་འཇིག་གོ་།
 yadā na bhavati na vibhavati tadā sthito dharmaprāpto bhavati |	གང་གི་ཚེ་མི་འབྱུང་མི་འཇིག་པ་དེའི་ཚེ་གནས་ཤིང་ཆོས་ཐོབ་པར་འགྱུར་རོ་༎
 yadā sthito dharmaprāpto bhavati tadā yoniśodharmaprayukto bhavati |	གང་གི་ཚེ་གནས་ཤིང་ཆོས་ཐོབ་པ་དེའི་ཚེ་ཚུལ་བཞིན་གྱི་ཆོས་ལ་ཞུགས་པར་འགྱུར་རོ་༎
 yoniśodharmaprayuktasya na kaścid dharmo 'sti yo na buddhadharmaḥ |	ཚུལ་བཞིན་གྱི་ཆོས་ལ་ཞུགས་པ་ལ་ནི་། གང་སངས་རྒྱས་ཀྱི་ཆོས་མ་ཡིན་པའི་ཆོས་དེ་འགའ་ཡང་མེད་དོ་༎
 tat kasya hetoḥ | śūnyatānubodhatvāt |	དེ་ཅིའི་ཕྱིར་ཞེ་ན་། འཇམ་དཔལ་།
 yaś ca śūnyatānubodhaḥ sa bodhiḥ ||	༄༥༠༨ཨ་༌༎ སྟོང་པ་ཉིད་རྗེས་སུ་རྟོགས་པ་གང་ཡིན་པ་དེ་ནི་།
 sa evaṃ śūnyatānimittāpraṇihitānabhisaṃskārāniketāsaṃbhavāgrāhyānālayāvabodhād bodhiḥ |	བྱང་ཆུབ་བོ་༎ དེས་དེ་ལྟར་སྟོང་བ་ཉིད་དང་། མཚན་མ་མེད་པ་དང་། སྨོན་པ་མེད་པ་དང་། མངོན་པར་འདུ་བྱ་བ་མེད་པ་དང་། གནས་མེད་པ་དང་། འབྱུང་བ་མེད་པ་དང་། གཟུང་བ་མེད་པ་དང་། གཞི་མེད་པ་རྗེས་སུ་རྟོགས་པའི་ཕྱིར་བྱང་ཆུབ་སྟེ་།
 bodhiś ca yoniśoprayogaḥ ||	བྱང་ཆུབ་ནི་། ཚུལ་བཞིན་ལ་སྦྱོར་བའོ་༎
 yoniśaḥprayogaḥ, yoniśaḥ prayogenāmocyate | anupekṣāprakṣepaḥ,	ཚུལ་བཞིན་དུ་སྦྱོར་བ་ནི་།
 akāravikāraprayogaḥ, asaṃbaddhaḥ, apramuktaprayogaḥ, anekatvānānātvaprayogaḥ,	འདེག་པ་མེད་པ་དང་། གཞག་པ་མེད་པ་དང་། བྱ་བ་མེད་པ་དང་། རྣམ་པར་བྱང་བ་མེད་པ་ལ་སྦྱོར་བ་དང་། ཆགས་པ་མེད་པ་དང་། གྲོལ་བ་མེད་པ་ལ་སྦྱོར་བ་དང་། གཅིག་པ་ཉིད་མ་ཡིན་པ་དང་། ཐ་དད་པ་ཉིད་མ་ཡིན་པ་ལ་སྦྱོར་བ་དང་། འོངས་པ་མ་ཡིན་པ་ལ་སྦྱོར་བ་དང་། ཚུལ་བཞིན་ལ་སྦྱོར་བ་ཡིན་ནོ་༎
 anāgataprayogo yoniśaḥ prayogaḥ ||	ཚུལ་བཞིན་གང་ཡིན་པ་དེ་ལ་ནི་།
 na tatra prayogo na pramāṇaṃ na phalasākṣātkriyā |	སྦྱོར་བའང་མེད་། སྤངས་པའང་མེད་། འབྲས་བུ་མངོན་སུམ་དུ་བྱ་བའང་མེད་དོ་།
 tat kasya hetoḥ |	དེ་ཅིའི་ཕྱིར་ཞེ་ན༏་འཇམ་དཔལ་། སེམས་ནི་། རང་བཞིན་གྱིས་འོད་གསལ་བའི་ཕྱིར་ཏེ་།
 prakṛtiprabhāsvaraṃ cittaṃ tac cāgantukair upakleśair upakliśyate na ca prakṛtiḥ saṃkliśyate |	དེ་ནི་། གློ་བུར་གྱི་ཉེ་བའི་ཉོན་མོངས་པ་ཐམས་ཅད་ཀྱིས་ཉེ་བར་ཉོན་མོངས་པར་ཟད་ཀྱི་། རང་བཞིན་གྱིས་ཀུན་ནས་ཉོན་མོངས་པ་ཉིད་མ་ཡིན་ནོ་༎
 yā ca prakṛtiprabhāsvaratā sāsaṃkleśatā |	རང་བཞིན་གྱིས་འོད་གསལ་བ་ཉིད་གང་ཡིན་པ་དེ་ནི་། ཀུན་ནས་ཉོན་མོངས་པ་མེད་པ་ཉིད་མ་ཡིན་ནོ་༎
 yā cāsaṃkleśatā tatra pratipakṣo nāsti yena pratipakṣeṇa kleśaprahāṇaṃ syāt |	ཀུན་ནས་༄༥༠༨བ་ཉོན་མོངས་པ་མེད་པ་གང་ཡིན་པ་དེ་ལ་ནི་། གཉེན་པོ་གང་གིས་ཉོན་མོངས་པ་སྤོང་བར་འགྱུར་བའི་གཉེན་པོ་མེད་དོ་༎
 tat (jāa 50) kasya hetoḥ |	དེ་ཅིའི་ཕྱིར་ཞེ་ན་། འཇམ་དཔལ་། དེ་ནི་།
 na śuddhaḥ śudhyati śuddha eva saḥ |	དག་པ་ཉིད་ཡིན་པས་དག་པ་ནི་། དག་པར་མི་འགྱུར་བའི་ཕྱིར་ཏེ་། དག་པ་གང་ཡིན་པ་དེ་ནི་། སྐྱེ་བ་མེད་པའོ་༎
 yaś ca śuddhaḥ so 'nutpādaḥ |	སྐྱེ་བ་མེད་པ་གང་ཡིན་པ་དེ་ནི་། མ་སྨད་པའོ་༎
 yaś cānutpādaḥ so 'ninditaḥ |	མ་སྨད་པ་གང་ཡིན་པ་དེ་ནི་། འདོད་པ་སྤངས་པའོ་༎
 yaś cāninditaḥ sa nandīprahāṇaṃ tatra sarvasnehā nirudhyante |	འདོད་པ་སྤངས་པ་གང་ཡིན་པ་དེ་ལ་ནི་། སྲེད་པ་ཐམས་ཅད་འགག་གོ་།
 yatra sarvasnehā nirudhyante so 'nutpādaḥ |	གང་ལ་སྲེད་པ་ཐམས་ཅད་འགགས་པ་དེ་ནི་། མི་སྐྱེའོ་༎
 yaś cānutpādaḥ sa bodhiḥ ||	མི་སྐྱེ་བ་གང་ཡིན་པ་དེ་ནི་།
 §17 ms| 16a4-17a2, p| 318a4-319a4, d| 290b6-291b4, t| 357 244c13-245a12, t| 358 ö, t| 359(d) 259a15-b18|	བྱང་ཆུབ་བོ་༎
 yā bodhiḥ sā samatā |	བྱང་ཆུབ་གང་ཡིན་པ་དེ་ནི་། མཉམ་པ་ཉིད་དོ་༎
 yā samatā sā tathatā |	མཉམ་པ་ཉིད་གང་ཡིན་པ་དེ་ནི་། དེ་བཞིན་ཉིད་དོ་༎ དེ་བཞིན་ཉིད་ལ་ནི་།
 tathatāpratiṣṭhitāś ca sarvadharmāḥ saṃskṛtā asaṃskṛtāś ca |	འདུས་བྱས་དང་། འདུས་མ་བྱས་ཀྱི་ཆོས་ཐམས་ཅད་གནས་སོ་༎
 yā ca tathatā na tatra saṃskṛtaṃ nāsaṃskṛtaṃ na dvayaprajñaptiḥ |	དེ་བཞིན་ཉིད་གང་ཡིན་པ་དེ་ལ་ནི་། འདུས་བྱས་ཀྱང་མེད་། འདུས་མ་བྱས་ཀྱང་མེད་། གཉིས་སུ་གདགས་པའང་མེད་དོ་༎
 yatra na saṃskṛtaṃ nāsaṃskṛtaṃ na dvayaprajñaptiḥ sā tathatā |	གང་ལ་འདུས་བྱས་ཀྱང་མེད་། འདུས་མ་བྱས་ཀྱང་མེད་། གཉིས་སུ་གདགས་པའང་མེད་པ་དེ་ནི་།
 yā tathatā sānanyatathatā |	དེ་བཞིན་ཉིད་དོ་༎ དེ་བཞིན་ཉིད་གང་ཡིན་པ་དེ་ནི་། གཞན་མ་ཡིན་པ་དེ་བཞིན་ཉིད་དོ་༎
 yānanyatathatā sāvikāratathatā |	གཞན་མ་ཡིན་པ་དེ་བཞིན་ཉིད་གང་ཡིན་པ་དེ་ནི་། འགྱུར་བ་མེད་པ་དེ་བཞིན་ཉིད་དོ་༎
 yā cāvikāratathatā sānāgatatathatā |	འགྱུར་བ་མེད་པ་དེ་བཞིན་ཉིད་གང་ཡིན་པ་དེ་ནི་། འོང་བ་མེད་པ་དེ་བཞིན་ཉིད་དོ་༎
 yā cānāgatatathatā sāvitathatā |	འོང་བ་མེད་པ་༄༥༠༩ཨ་༌༎ དེ་བཞིན་ཉིད་གང་ཡིན་པ་དེ་ནི་། འགྲོ་བ་མེད་པ་དེ་བཞིན་ཉིད་དོ་༎
 yā cāvitathatā sā yathāvattathatā |	འགྲོ་བ་མེད་པ་དེ་བཞིན་ཉིད་གང་ཡིན་པ་དེ་ནི་། ཇི་ལྟ་བ་བཞིན་དེ་བཞིན་ཉིད་དོ་༎
 yā yathāvattathatā sā najātutathatā |	ཇི་ལྟ་བ་དེ་བཞིན་ཉིད་གང་ཡིན་པ་དེ་ནི་། ནམ་ཡང་དེ་བཞིན་ཉིད་མ་ཡིན་པ་མ་ཡིན་ནོ་༎
 yā najātutathatā sā na saṃkliśyate na viśudhyate |	ནམ་ཡང་དེ་བཞིན་ཉིད་མ་ཡིན་པ་མ་ཡིན་པ་གང་ཡིན་པ་དེ་ནི་། ཀུན་ནས་ཉོན་མོངས་པར་མི་འགྱུར་། རྣམ་པར་བྱང་བར་མི་འགྱུར་རོ་༎
 yā na saṃkliśyate na viśudhyate sā notpadyate na nirudhyate |	གང་ཀུན་ནས་ཉོན་མོངས་པར་མི་འགྱུར་། རྣམ་པར་བྱང་བར་མི་འགྱུར་བ་དེ་ནི་། སྐྱེ་བར་མི་འགྱུར་། འགག་པར་མི་འགྱུར་རོ་༎
 yā notpadyate na nirudhyate sā nirvāṇena samā |	གང་སྐྱེ་བར་མི་འགྱུར་། འགག་པར་མི་འགྱུར་བ་དེ་ནི་། མྱ་ངན་ལས་འདས་པ་དང་མཉམ་མོ་༎ གང་མྱ་ངན་ལས་འདས་པ་དང་མཉམ་པ་དེ་ནི་།
 yā nirvāṇena samā sā na saṃsarati na parinirvāti |	འཁོར་བར་མི་འགྱུར་། ཡོངས་སུ་མྱ་ངན་ལས་འདའ་བར་མི་འགྱུར་རོ་༎ གང་འཁོར་བར་མི་འགྱུར་ཡོངས་སུ་མྱ་ངན་ལས་འདའ་བར་མི་འགྱུར་བ་དེ་ནི་།
 yā na saṃsarati na parinirvāti sā nātītā nānāgatā na pratyutpannā |	འདས་པ་མ་ཡིན་། མ་འོངས་པ་མ་ཡིན་། ད་ལྟར་བྱུང་བ་མ་ཡིན་ནོ་༎
 yā nātītā nānāgatā na pratyutpannā sā na hīnā na madhyā notkṛṣṭā |	གང་འདས་པ་མ་ཡིན་། མ་འོངས་པ་མ་ཡིན་། ད་ལྟར་བྱུང་བ་མ་ཡིན་པ་དེ་ནི་།
 yā na hīnā na madhyā notkṛṣṭā sā tathatā ||	དམན་པ་མ་ཡིན་། བར་མ་མ་ཡིན་། མཆོག་མ་ཡིན་ནོ་༎ གང་དམན་པ་མ་ཡིན་། བར་མ་མ་ཡིན་། མཆོག་མ་ཡིན་པ་དེ་ནི་།
 tathatā nāmocyate |	དེ་བཞིན་ཉིད་དེ་།
 tattvārthādhivacanam etat tattvam (jāa 51) ucyate |	དེ་བཞིན་ཉིད་ཅེས་བྱ་བ་དེ་ནི་། དེ་ཁོ་ནའི་དོན་གྱི་ཚིག་བླ་དབ༹གས་ཡིན་ནོ་༎ དེ་ཁོ་ན་ཞེས་བྱ་བ་ནི་།
 tathātvaṃ tathatvam ucyate |	དེ་བཞིན་ཉིད་ཁོ་ནའོ་༎ དེ་བཞིན་༄༥༠༩བ་ཉིད་དེ་ཁོ་ན་ནི་།
 tathaiva tathatā cātmā cādvayam etad advaidhīkāram |	དེ་བཞིན་ཉིད་དོ་༎ དེ་བཞིན་ཉིད་དང་། བདག་དེ་ནི་། གཉིས་སུ་མེད་དེ་གཉིས་སུ་བྱར་མེད་དོ་༎
 yaś cādvayārthaḥ sa bodhiś cāvabodhārthaḥ||	གཉིས་སུ་བྱར་མེད་པའི་དོན་གང་ཡིན་པ་དེ་ནི་། བྱང་ཆུབ་སྟེ༏་བྱང་ཆུབ་ནི་། དོན་རྟོགས་པའོ་༎
 artha ucyate |	དོན་ཅེས་བྱ་བ་ནི་།
 trivimokṣamukhapraveśaṃ jñānaṃ sarvadharmanirdeśeṣu |	ཆོས་བསྟན་པ་ཐམས་ཅད་ལ་རྣམ་པར་ཐར་པའི་སྒོ་གསུམ་དུ་འཇུག་པ་ཤེས་པའོ་༎
 jñānam ucyate |	ཤེས་པ་ཞེས་བྱ་བ་ནི་།
 tryadhvasamatāvatāraḥ sarvadharmeṣu |	ཆོས་ཐམས་ཅད་ལ་དུས་གསུམ་མཉམ་པ་ཉིད་དུ་འཇུག་པའོ་༎
 asaṃbhedārthaś ca sarvadharmāṇām ayam ucyate 'rthaḥ |	ཆོས་ཐམས་ཅད་ཀྱི་དབྱེར་མེད་པའི་དོན་དེ་ནི་། དོན་ཅེས་བྱ་སྟེ་། དོན་ནི་། སྒྲ་མེད་པ་། བརྗོད་དུ་མེད་པ་།
 aruto 'nabhilāpyo 'vyāhāro vyāhārasamucchinnaḥ ||	ཐ་སྙད་མེད་པ༏་ཐ་སྙད་ཡང་དག་པར་ཆད་པ་ཡིན་ནོ་༎
 jñānam ucyate |	ཤེས་པ་ཞེས་བྱ་བ་ནི་།
 yad arthānugamajñānaṃ vijñānānugamaṃ cedam ucyate jñānam |	དོན་རྗེས་སུ་རྟོགས་པའི་ཤེས་པ་དང་། རྣམ་པར་ཤེས་པ་རྗེས་སུ་རྟོགས་པའི་ཤེས་པ་གང་ཡིན་པ་སྟེ་། དེ་ནི༏་ཤེས་པ་ཞེས་བྱའོ་༎
 artha ucyate |	དོན་ཅེས་བྱ་བ་ནི་།
 yat tattvārthajñānena vijñānānugamajñānena ca nītārthatā |	དེ་ཁོ་ནའི་དོན་ཤེས་པ་དང་། རྣམ་པར་ཤེས་པ་རྗེས་སུ་རྟོགས་པའི་ཤེས་པས་ངེས་པར་རྟོགས་པ་གང་ཡིན་པ་སྟེ་།
 saiva dharmatā yā |	དེ་ཉིད་ཆོས་ཉིད་ཡིན་ནོ་༎
 yā ca dharmatā so 'rthaḥ ||	ཆོས་ཉིད་གང་ཡིན་པ་དེ་ནི་། དོན་ཡིན་ནོ་༎
 yārthānugamajñānena vijñānānugamajñānena nītārthānugamajñānena ca sā dharmatā |	དོན་རྗེས་སུ་རྟོགས་པའི་ཤེས་པ་དང་། རྣམ་པར་ཤེས་པ་རྗེས་སུ་རྟོགས་པའི་ཤེས་པ་དང་། ངེས་པའི་དོན་རྗེས་སུ་རྟོགས་པའི་ཤེས་པས་རྗེས་སུ་རྟོགས་པ་གང་ཡིན་པ་དེ་ནི་། ཆོས་ཉིད་དོ་༎
 yā dharmatā so 'rthaḥ |	ཆོས་ཉིད་གང་ཡིན་པ་དེ་ནི་། དོན་ཡིན་ནོ་༎ དོན་གང་ཡིན་པ་དེ་ནི་།
 sā ca dharmatā dharmasthititā dharmaniyāmatā,	ཆོས་ཉིད་དང་། ཆོས་༄༥༡༠ཨ་༌༎ གནས་པ་ཉིད་དང་། ཆོས་ངེས་པ་ཉིད་དེ་། དེ་ནི་།
 sā dharme na pravartate |	ཆོས་ལ་འཇུག་པར་མི་འགྱུར་རོ་༎
 yā dharmasyāpravṛttiḥ, yā cārthavyaṃjanasamatā sādvayārthe samā | yā ca samatā so 'rthaḥ,	ཆོས་ལ་མ་ཞུགས་པ་གང་ཡིན་པ་དང་། དོན་དང་ཚིག་འབྲུ་མཉམ་པ་ཉིད་གང་ཡིན་པ་དེ་ནི་།
 sā cārthajñānena samatā,	གཉིས་སུ་མེད་པའི་དོན་གྱིས་མཉམ་པ་ཉིད་ཡིན་ཏེ་། མཉམ་པ་ཉིད་གང་ཡིན་པ་དེ་ནི་། དོན་ཡིན་ནོ་༎
 sādvayamukhapraveśena jñānasamatā ||	དོན་ཤེས་པ་དང་། རྣམ་པར་ཤེས་པ་ལ་མཉམ་པ་ཉིད་གང་ཡིན་པ་དེ་ནི་། གཉིས་སུ་མེད་པའི་སྒོར་འཇུག་པས་ན་། ཤེས་པ་ཡིན་ནོ་༎
 nītārthena neyārthasamatā samānārthā sā śūnyatā |	ངེས་པའི་དོན་དང་། དྲང་བའི་དོན་མཉམ་པ་ཉིད་ཀྱིས་དོན་མཉམ་པ་དེ་ནི་། སྟོང་པ་ཉིད་དོ་༎
 samānārthena pudgalasamatā samā |	སྟོང་པ་ཉིད་དུ་དོན་མཉམ་པས་གང་ཟག་མཉམ་པ་ཉིད་མཉམ་མོ་༎
 pudgalasamatayā dharmasamatā samā | dharmasamatayā vimuktisamatā samā |	གང་ཟག་མཉམ་པ་ཉིད་ཀྱིས་ཆོས་མཉམ་པ་ཉིད་མཉམ་མོ༏་༏ཆོས་མཉམ་པ་ཉིད་ཀྱིས་རྣམ་པར་གྲོལ་བ་མཉམ་པ་ཉིད་མཉམ་སྟེ་།
 vimuktisamatayā cānubodho bodhiḥ || (jāa 52)	རྣམ་པར་གྲོལ་བ་མཉམ་པ་ཉིད་རྗེས་སུ་རྟོགས་པ་ནི་།
 §18 ms| 17a2-18a4, p| 319a4-320a5, d| 291b4-292b4, t| 357 245a12-b6, t| 358 251c29-252a1, t| 359(d) 259b18-c20|	བྱང་ཆུབ་བོ་༎
 rūpasaṅgasaṃyuktānāṃ mañjuśrīś cakṣuḥ saṅgaḥ |	འཇམ་དཔལ་། གཟུགས་ལ་ཆགས་པས་ཆགས་པར་གྱུར་པ་རྣམས་ཀྱི་མིག་ནི་། ཆགས་པ་ཡིན་ནོ་༎
 rūpacakṣuḥprakṛtijñānam asaṅgaḥ |	གཟུགས་དང་མིག་གི་རང་བཞིན་ཤེས་པ་ནི་། ཆགས་པ་མེད་པ་ཡིན་ནོ་༎
 dṛṣṭisaṅgasaṃyuktānāṃ svakāyaṃ saṅgaḥ |	ལྟ་བ་ལ་ཆགས་པར་གྱུར་པ་རྣམས་ཀྱི་རང་གི་ལུས་ནི་།
 sarvadṛṣṭikṛtānāṃ svakāyaprakṛtiś[ṭā̆]ūnyatājñānam asaṅgaḥ |	ཆགས་པ་ཡིན་ནོ་༎ ལྟ་བར་གྱུར་པ་ཐམས་ཅད་ཀྱི་རང་གི་ལུས་ཀྱི་རང་བཞིན་སྟོང་པ་ཉིད་དུ་ཤེས་པ་ནི་། ཆགས་པ་མེད་པ་ཡིན་༄༥༡༠བ་ནོ༏་༏ཚུལ་བཞིན་མ་ཡིན་པ་ཡིད་ལ་བྱེད་པ་ལ་ཆགས་པས་ཆགས་པར་གྱུར་པ་རྣམས་ཀྱི་ཆོས་ཀྱི་སྣང་བ་། ནི་། 
 ayoniśomanaskārasaṅgasaktānāṃ dharmālokaḥ saṅgaḥ |	ཆགས་པ་ཡིན་ནོ་༎
 yoniśomanaskāradharmapratyavekṣāprakṛtiśūnyatāsvabhāvaśūnyatājñānam asaṅgaḥ |	ཚུལ་བཞིན་ཡིད་ལ་བྱེད་པའི་ཆོས་ལ་སོ་སོར་རྟོག་ཅིང་ངོ་བོ་ཉིད་ཀྱིས་རང་བཞིན་སྟོང་པ་ཉིད་དུ་ཤེས་པ་ནི་། ཆགས་པ་མེད་པ་ཡིན་ནོ་༎
 vicikitsāmalasaṅgasaktānāṃ mokṣaḥ saṅgaḥ |	ཐེ་ཚོམ་གྱི་དྲི་མ་ལ་ཆགས་པས་ཆགས་པར་གྱུར་པ་རྣམས་ཀྱི་ཐར་པ་ནི་། ཆགས་པ་ཡིན་ནོ་༎
 adhimuktivimuktiyathābhūtajñānam asaṅgaḥ |	མོས་པ་དང་རྣམ་པར་གྲོལ་བ་ཡང་དག་པ་ཇི་ལྟ་བ་བཞིན་དུ་ཤེས་པ་ནི་། ཆགས་པ་མེད་པ་ཡིན་ནོ་༎
 kauśīdyamalasaṅgasaktānām adhigamadṛṣṭavīryatā saṅgaḥ |	ལེ་ལོའི་དྲི་མ་ལ་ཆགས་པས་ཆགས་པར་གྱུར་པ་རྣམས་ཀྱི་རྟོགས་པར་བྱ་བ་ལ་བརྩོན་འགྲུས་བརྟན་པ་ཉིད་ནི་། ཆགས་པ་ཡིན་ནོ་༎
 yathādharmāṇām anubodhaḥ saṅgaḥ |	ཆོས་ཇི་ལྟ་བ་བཞིན་རྟོགས་པ་ནི་། ཆགས་པ་མེད་པ་ཡིན་ནོ་༎
 nīvaraṇasaṅgayuktānāṃ bodhyaṅgāni saṅgaḥ |	སྒྲིབ་པ་ལ་ཆགས་པས་ཆགས་པར་གྱུར་པ་རྣམས་ཀྱི་བྱང་ཆུབ་ཀྱི་ཡན་ལག་རྣམས་ནི་། ཆགས་པ་ཡིན་ནོ་༎
 anāvaraṇajñānavimokṣo 'saṃgaḥ ||	སྒྲིབ་པ་མེད་པའི་རྣམ་པར་ཐར་པ་ཤེས་པ་ནི་། ཆགས་པ་མེད་པ་ཡིན་ནོ་༎
 prakṛtipariśuddhāḥ sarvadharmā hetupratyayasāmagryā pravartante |	རང་བཞིན་གྱིས་ཡོངས་སུ་དག་པའི་ཆོས་ཐམས་ཅད་ནི་། རྒྱུ་དང་རྐྱེན་ཚོགས་པ་ལས་འབྱུང་སྟེ་།
 tatra bodhisattvena saṃkleśahetur vyavadānahetuś ca parijñātavyaḥ |	དེ་ལ་བྱང་ཆུབ་སེམས་དཔས་ཀུན་ནས་ཉོན་མོངས་པའི་རྒྱུ་དང་། རྣམ་པར་བྱང་བའི་རྒྱུའང་ཡོངས་སུ་ཤེས་པར་བྱ་ཞིང་།
 saṃkleśahetuviśuddhyā ca vyavadānaviśuddhyā ca na sthātavyam||	ཀུན་ནས་ཉོན་མོངས་པའི་རྒྱུ་རྣམ་པར་དག་པ་དང་། རྣམ་པར་བྱང་བའི་རྒྱུ་རྣམ་པར་དག་པས་ཀྱང་གནས་པར་མི་བྱའོ་༎
 ātmasamutthānaṃ ca saṃkleśasya hetuḥ |	བདག་ཀུན་ནས་སློང་བ་དང་། ལྟ་བ་ཀུན་༄༥༡༡ཨ་༌༎ ནས་སློང་བ་ནི་། ཀུན་ནས་ཉོན་མོངས་པའི་རྒྱུ་ཡིན་ནོ་༎
 nairātmyadharmāvatārakṣāntir vyavadānasya hetuḥ |	ཆོས་བདག་མེད་པ་ལ་འཇུག་པའི་བཟོད་པ་ནི་། རྣམ་པར་བྱང་བའི་རྒྱུ་ཡིན་ནོ་༎
 ahaṃkāramamakāradṛṣṭiḥ saṃkleśasya hetuḥ |	ངར་འཛིན་པ་དང་། ང་རྒྱལ་གྱི་ལྟ་བ་ནི་།
 adhyātmopaśamo bahirdhāpacāraś ca vyavadānasya hetuḥ |	ཀུན་ནས་ཉོན་མོངས་པའི་རྒྱུ་ཡིན་ནོ་༎ ནང་ཉེ་བར་ཞི་པ་དང་། ཕྱི་རོལ་ཏུ་རྒྱུ་བ་མེད་པ་ནི་། རྣམ་པར་བྱང་བའི་རྒྱུ་ཡིན་ནོ་༎
 kāmavyāpādavihiṃsāvitarkaḥ (jāa 53)	འདོད་པ་དང་། གནོད་སེམས་དང་། རྣམ་པར་འཚེ་བ་དང་། རྟོག་པ་དག་ནི་།
 saṃkleśasya hetuḥ |	ཀུན་ནས་ཉོན་མོངས་པའི་རྒྱུ་ཡིན་ནོ་༎
 aśubhāmaitrīkaruṇāmuditopekṣāpratītyadharmāvatārakṣāntir vyavadānasya hetuḥ |	མི་སྡུག་པ་དང་། བྱམས་པ་དང་། སྙིང་རྗེ་དང་། དགའ་བ་དང་། བཏང་སྙོམས་དང་། བརྟེན་པའི་ཆོས་ལ་འཇུག་པའི་བཟོད་པ་ནི་། རྣམ་པར་བྱང་བའི་རྒྱུ་ཡིན་ནོ་༎
 catvāro viparyāsāḥ saṃkleśasya hetuḥ |	ཕྱིན་ཅི་ལོག་བཞི་ནི་། ཀུན་ནས་ཉོན་མོངས་པའི་རྒྱུ་ཡིན་ནོ་༎
 catvāri samyaksmṛtyupasthānāni vyavadānasya hetuḥ |	ཡང་དག་པའི་དྲན་པ་ཉེ་བར་གཞག་པ་བཞི་ནི་། རྣམ་པར་བྱང་བའི་རྒྱུ་ཡིན་ནོ་༎
 pañca nīvaraṇāni saṃkleśasya hetuḥ |	སྒྲིབ་པ་ལྔ་ནི་། ཀུན་ནས་ཉོན་མོངས་པའི་རྒྱུ་ཡིན་ནོ་༎
 pañcendriyāṇi vyavadānasya hetuḥ |	དབང་པོ་ལྔ་ནི་། རྣམ་པར་བྱང་བའི་རྒྱུ་ཡིན་ནོ་༎
 ṣaḍ āyatanāni saṃkleśasya hetuḥ |	སྐྱེ་མཆེད་དྲུག་ནི་། ཀུན་ནས་ཉོན་མོངས་པའི་རྒྱུ་ཡིན་ནོ་༎
 ṣaḍ anusmṛtayo vyavadānasya hetuḥ |	རྗེས་སུ་དྲན་པ་དྲུག་ནི་། རྣམ་པར་བྱང་བའི་རྒྱུ་ཡིན་ནོ་༎
 saptāsaddharmāḥ saṃkleśasya hetuḥ |	དམ་པ་མ་ཡིན་པའི་ཆོས་བདུན་ནི་། ཀུན་ནས་ཉོན་མོངས་པའི་རྒྱུ་ཡིན་ནོ་༎
 sapta bodhyaṅgāni vyavadānasya hetuḥ |	བྱང་ཆུབ་ཀྱི་ཡན་ལག་བདུན་ནི་། རྣམ་པར་བྱང་བའི་རྒྱུ་ཡིན་ནོ་༎
 aṣṭa mithyātvāni saṃkleśasya hetuḥ |	ལོག་པ་ཉིད་བརྒྱད་ནི་། ཀུན་ནས་ཉོན་མོངས་པའི་རྒྱུ་ཡིན་ནོ་༎
 aṣṭau samyaktvāni vyavadānasya hetuḥ |	ཡང་དག་༄༥༡༡བ་པ་ཉིད་བརྒྱད་ནི་། རྣམ་པར་བྱང་བའི་རྒྱུ་ཡིན་ནོ་༎
 navāghātavastūni saṃkleśasya hetuḥ |	ཀུན་ནས་མནར་སེམས་ཀྱི་དངོས་པོ་དགུ་ནི་། ཀུན་ནས་ཉོན་མོངས་པའི་རྒྱུ་ཡིན་ནོ་༎
 navānupūrvavihārasamāpattayo vyavadānasya hetuḥ |	མཐར་གྱིས་གནས་པའི་སྙོམས་པར་འཇུག་པ་དགུ་ནི་། རྣམ་པར་བྱང་བའི་རྒྱུ་ཡིན་ནོ་༎
 daśākuśalāḥ karmapathāḥ saṃkleśasya hetuḥ |	མི་དགེ་བ་བཅུའི་ལས་ཀྱི་ལམ་ནི་། ཀུན་ནས་ཉོན་མོངས་པའི་རྒྱུ་ཡིན་ནོ་༎
 daśa kuśalāḥ karmapathā vyavadānasya hetuḥ |	དགེ་བ་བཅུའི་ལས་ཀྱི་ལམ་ནི་། རྣམ་པར་བྱང་བའི་རྒྱུ་ཡིན་ཏེ་།
 saṃkṣiptena sarve 'kuśalā manaskārāḥ saṃkleśasya hetuḥ,	མདོར་ན་མི་དགེ་བ་ཡིད་ལ་བྱེད་པ་ཐམས་ཅད་ནི་། ཀུན་ནས་ཉོན་མོངས་པའི་རྒྱུ་ཡིན་ནོ་༎
 sarve kuśalā manaskārā vyavadānasya hetuḥ ||	དགེ་བ་ཡིད་ལ་བྱེད་པ་ཐམས་ཅད་ནི་། རྣམ་པར་བྱང་བའི་རྒྱུ་ཡིན་ནོ་༎
 tatra yaḥ saṃkleśasya hetuḥ, yaś ca vyavadānasya hetuḥ,	དེ་ལ་ཀུན་ནས་ཉོན་མོངས་པའི་རྒྱུ་གང་ཡིན་པ་དང་། རྣམ་པར་བྱང་བའི་རྒྱུ་གང་ཡིན་པའི་ཆོས་དེ་ཐམས་ཅད་ནི་།
 sarve te dharmāḥ prakṛtiśūnyā niḥsattvā nirjīvā niṣpoṣā niṣpuruṣā niṣpudgalā asvāmikā aparigrahā nirvyāpārā māyopamā alakṣaṇā adhyātmopaśāntāḥ	རང་བཞིན་གྱིས་སྟོང་པ་དང་། སེམས་ཅན་མེད་པ་དང་། སྲོག་མེད་པ་དང་། གང་ཟག་མེད་པ་དང་། བདག་པོ་མེད་པ་དང་། ཡོངས་སུ་འཛིན་པ་མེད་པ་དང་། བྱེད་པ་མེད་པ་དང་། སྒྱུ་མ་ལྟ་བུ་དང་། མཚན་ཉིད་མེད་པ་དང་། ནང་ཉེ་བར་ཞི་བ་ཡིན་ནོ་༎
 yaś cādhyātmopaśamaḥ sa praśamaḥ |	ནང་ཉེ་བར་ཞི་བ་གང་ཡིན་པ་དེ་ནི་། རབ་ཏུ་ཞི་བའོ་༎
 yaḥ praśamaḥ sā prakṛtiḥ |	རབ་ཏུ་ཞི་བ་གང་ཡིན་པ་དེ་ནི་། རང་བཞིན་ནོ་༎
 yā prakṛtiḥ so 'nupalambhaḥ |	རང་བཞིན་གང་ཡིན་པ་དེ་ནི་། དམིགས་སུ་མེད་པའོ་༎
 yo 'nupalambhaḥ so 'nilayaḥ |	དམིགས་སུ་མེད་པ་གང་ཡིན་པ་དེ་ནི་། གནས་མེད་པའོ་༎
 yaś cānilayaḥ tat kham |	གནས་མེད་པ་གང་ཡིན་པ་དེ་ནི་། དེ་ཁོ་ནའོ་༎
 khaṃ cākāśam |	དེ་ཁོ་ན་ནི་། ནམ་མཁའ་སྟེ་།
 sa ākāśasamān sarvadharmān prajānāti,	དེས་ཆོས་ཐམས་ཅད་༄༥༡༢ཨ་༌༎ ནམ་མཁའ་ལྟ་བུར་རབ་ཏུ་ཤེས་ན་།
 saṃkleśavyavadānena ca vyavaharati, na cākāśadharmatāṃ vijahāti | tat kasmād dhetoḥ |	ཀུན་ནས་ཉོན་མོངས་པ་དང་རྣམ་པར་བྱང་བས་སྤྱོད་ཀྱང་ནམ་མཁའི་ཆོས་ཉིད་དག་མི་སྤོང་ངོ་༎ དེ་ཅིའི་ཕྱིར་ཞེ་ན་།
 na kaścin mañjuśrīr dharmaḥ saṃvidyate yasyotpādo nirodho vā bhavet || (jāa 54) §19 ms| 18a4-6, p| 320a5-8, d| 292b5-7, t| 357 245b6-11, t| 358 252a1-6, t| 359(d) 259c20-26|	འཇམ་དཔལ་། གང་ལ་སྐྱེ་བའམ་། འགག་པར་འགྱུར་བའི་ཆོས་དེ་གང་ཡང་མེད་པའི་ཕྱིར་རོ་༎
 mañjuśrīr āha |	འཇམ་དཔལ་གྱིས་གསོལ་པ་།
 tat kathaṃ bhagavaṃs tathāgatena bodhiḥ prāptā |	བཅོམ་ལྡན་འདས་། འོ་ན༏་དེ་བཞིན་གཤེགས་པས་བྱང་ཆུབ་ཇི་ལྟར་བརྙེས་ལགས་།
 bhagavān āha |	བཅོམ་ལྡན་འདས་ཀྱི་བཀའ་སྩལ་པ་། འཇམ་དཔལ་། དེ་བཞིན་གཤེགས་པས་ནི་།
 amūlāpratiṣṭhānā mañjuśrīs tathāgatena bodhiḥ prāptā |	རྩ་བ་མེད་པ་དང་། གནས་མེད་པར་བྱང་ཆུབ་ཐོབ་བོ་༎
 mañjuśrīr āha |	འཇམ་དཔལ་གྱིས་གསོལ་པ་། བཅོམ་ལྡན་འདས་།
 tatra katamad bhagavan mūlaṃ katamat pratiṣṭhānam |	དེ་ལ་རྩ་བ་ནི་། གང་ལགས་། གནས་ནི་།
 bhagavān āha |	གང་ལགས་། བཅོམ་ལྡན་འདས་ཀྱིས་བཀའ་སྩལ་པ་། འཇམ་དཔལ་།
 satkāyo mañjuśrīr mūlam abhūtaparikalpaḥ pratiṣṭhānam |	འཇིག་ཚོགས་ནི་། རྩ་བ་ཡིན་ནོ་༎ ཡང་དག་པ་མ་ཡིན་པའི་ཀུན་ཏུ་རྟོག་པ་ནི་།
 tat tathāgatena mañjuśrīr bodhisamatayā sarvadharmasamatā jñātā |	གནས་ཡིན་ནོ་༎ འཇམ་དཔལ་། དེ་ལ་དེ་བཞིན་གཤེགས་པས་བྱང་ཆུབ་མཉམ་པ་ཉིད་ཀྱིས་ཆོས་ཐམས་ཅད་མཉམ་པ་ཉིད་དུ་ཤེས་ཏེ་། 
 tasmād ucyate mañjuśrīr amūlāpratiṣṭhānā tathāgatena bodhir abhisaṃbuddheti || §20 ms| 18a6-b6, p| 320a8-b6, d| 292b7-293a6, t| 357 245b12-18, t| 358 252a6-11, t| 359(d) 259c26-260a8|	འཇམ་དཔལ་། དེའི་ཕྱིར་དེ་བཞིན་གཤེགས་པས་རྩ་བ་མེད་པ་དང་། གནས་མེད་པར་བྱང་ཆུབ་མངོན་པར་རྫོགས་པར་སངས་རྒྱས་ཞེས་བྱའོ་༎
 bodhir mañjuśrīḥ śāntā copaśāntā ca |	འཇམ་དཔལ་། བྱང་ཆུབ་ནི་། ཞི་བ་དང་། ཉེ་བར་ཞི་བ་ཡིན་ཏེ་།
 tatra katamaḥ śamaḥ katama upaśamaḥ |	དེ་ལ་ཞི་བ་ནི་། གང་། ཉེ་བར་༄༥༡༢བ་ཞི་བ་ནི༏་གང་ཞེ་ན་།
 adhyātmaṃ śamaḥ,	ནང་ནི་། ཞི་བ་ཡིན་ནོ་༎ ཕྱི་རོལ་ནི་།
 bahirdhopaśamaḥ |	ཉེ་བར་ཞི་བ་ཡིན་ནོ་༎
 tat kasmād dhetoḥ |	དེ་ཅིའི་ཕྱིར་ཞེ་ན་། འཇམ་དཔལ་། མིག་ནི་།
 cakśur mañjuśrīḥ śūnyam ātmanā cātmīyena ca, prakṛtir asyaiṣā,	བདག་དང་བདག་གིས་སྟོང་སྟེ་། དེའི་རང་བཞིན་དེ་ཡིན་པའི་ཕྱིར་དེ་ནི་།
 ayam ucyate śama iti |	ཞི་བ་ཞེས་བྱའོ་༎
 sa cakṣuḥ śūnyam iti parijñāya rūpeṣu na dhāvati,	དེས་མིག་སྟོང་པ་ཞེས་བྱ་བར་ཡོངས་སུ་ཤེས་ནས་གཟུགས་རྣམས་ལ་མི་རྒྱུག་སྟེ་།
 tenocyata upaśama iti |	དེའི་ཕྱིར་ཉེ་བར་ཞི་བ་ཞེས་བྱའོ་༎
 evaṃ śrotraṃ śūnyam ātmanā cātmīyena ca, prakṛtir asyaiṣā,	དེ་བཞིན་དུ་རྣ་བ་ནི་། བདག་དང་བདག་གིས་སྟོང་སྟེ་། དེའི་རང་བཞིན་དེ་ཡིན་པའི་ཕྱིར་དེ་ནི་།
 ayam ucyate śama iti |	ཞི་བ་ཞེས་བྱའོ་༎
 sa śrotraṃ śūnyam iti parijñāya śabdeṣu na dhāvati,	དེས་རྣ་བ་སྟོང་པ་ཞེས་བྱ་བར་ཡོངས་སུ་ཤེས་ནས་སྒྲ་རྣམས་ལ་མི་རྒྱུག་སྟེ་།
 tenocyata upaśama iti |	དེའི་ཕྱིར་ཉེ་བར་ཞི་བ་ཞེས་བྱའོ་༎
 ghrāṇaṃ śūnyam ātmanā cātmīyena ca, prakṛtir asyaiṣā,	སྣ་ནི་། བདག་དང་བདག་གིས་སྟོང་སྟེ་། དེའི་རང་བཞིན་དེ་ཡིན་པའི་ཕྱིར་དེ་ནི་།
 ayam ucyate śama iti |	ཞི་བ་ཞེས་བྱའོ་༎
 sa ghrāṇaṃ śūnyam iti parijñāya gandheṣu na dhāvati,	དེས་སྣ་སྟོང་པ་ཞེས་བྱ་བར་ཡོངས་སུ་ཤེས་ནས་དྲི་རྣམས་ལ་མི་རྒྱུག་སྟེ་།
 tenocyata upaśama iti |	དེའི་ཕྱིར་ཉེ་བར་ཞི་བ་ཞེས་བྱའོ་༎
 jihvā śūnyātmanā cātmīyena ca, prakṛtir asyā eṣā,	ལྕེ་ནི་། བདག་དང་བདག་གིས་སྟོང་སྟེ་། དེའི་རང་བཞིན་དེ་ཡིན་པའི་ཕྱིར་དེ་ནི་།
 ayam ucyate śama iti |	ཞི་བ་ཞེས་བྱའོ་༎
 sa jihvā śūnyeti parijñāya raseṣu na (jāa 55)	དེས་ལྕེ་སྟོང་པ་ཞེས་བྱ་བར་ཡོངས་སུ་ཤེས་ནས་རོ་རྣམས་ལ་མི་རྒྱུག་སྟེ་།
 dhāvati, tenocyata upaśama iti |	དེའི་ཕྱིར་ཉེ་བར་ཞི་བ་ཞེས་བྱའོ་༎
 kāyaḥ śūnya ātmanā cātmīyena ca, prakṛtir asyaiṣā,	ལུས་ནི་། བདག་དང་བདག་གིས་སྟོང་སྟེ་། དེའི་རང་བཞིན་དེ་ཡིན་པའི་ཕྱིར་དེ་ནི་།
 ayam ucyate śama iti |	ཞི་བ་ཞེས་བྱའོ་༎
 sa kāyaṃ śūnyam iti parijñāya spraṣṭavyeṣu na dhāvati,	དེས་ལུས་སྟོང་པ་ཞེས་བྱ་བར་ཡོངས་སུ་ཤེས་ནས་རེག་བྱ་རྣམས་ལ་མི་རྒྱུག་སྟེ་།
 tenocyata upaśama iti |	དེའི་ཕྱིར་ཉེ་བར་ཞི་བ་ཞེས་བྱའོ་༎ འཇམ་དཔལ་།
 mano mañjuśrīḥ śūnyam ātmanā cātmīyena ca, prakṛtir asyaiṣā,	ཡིད་ནི་། བདག་དང་༄༥༡༣ཨ་༌༎ བདག་གིས་སྟོང་སྟེ་། དེའི་རང་བཞིན་དེ་ཡིན་པའི་ཕྱིར་དེ་ནི་།
 ayam ucyate śama iti |	ཞི་བ་ཞེས་བྱའོ་༎
 sa manaḥ śūnyam iti parijñāya dharmeṣu na dhāvati, tenocyata upaśama iti || §21 ms| 18b6-19a1, p| 320b6-8, d| 293a6-7, t| 357 245b18-21, t| 358 -, t| 359(d) 260a8-12|	དེས་ཡིད་སྟོང་པ་ཞེས་བྱ་བར་ཡོངས་སུ་ཤེས་ནས་ཆོས་རྣམས་ལ་མི་རྒྱུག་སྟེ༏་དེའི་ཕྱིར་ཉེ་བར་ཞི་བ་ཞེས་བྱའོ་༎
 bodhir mañjuśrīḥ prakṛtiprabhāsvarā cittaprakṛtiprabhāsvaratayā |	འཇམ་དཔལ་། བྱང་ཆུབ་ནི་། སེམས་ཀྱི་རང་བཞིན་འོད་གསལ་བ་ཉིད་ཀྱིས་རང་བཞིན་འོད་གསལ་བ་ཡིན་ཏེ་།
 tena kāraṇenocyate prakṛtiprabhāsvareti |	ཅིའི་ཕྱིར་འོད་གསལ་བ་ཞེས་བྱ་ཞེ་ན་།
 yā sā prakṛti sāsaṃkliṣṭā,	རང་བཞིན་གང་ཡིན་པ་དེ་ནི་། ཀུན་ནས་ཉོན་མོངས་པ་མེད་པ་།
 ākāśasamā,	ནམ་མཁའ་དང་མཉམ་པ་།
 ākāśaprakṛtiḥ,	ནམ་མཁའི་རང་བཞིན་ཅན་།
 ākāśasamavasaraṇā,	ནམ་མཁའ་ཡང་དག་པར་འདུ་བ་།
 ākāśopamā,	ནམ་མཁའ་ལྟ་བུ་སྟེ་།
 atyantaprabhāsvarā prakṛtiḥ || §22 ms| 19a1-4, p| 320b8-321a3, d| 293a7-b2, t| 357 245b22-27, t| 358 252a11-15, t| 359(d) 260a12-16|	རང་བཞིན་གྱིས་ཤིན་ཏུ་འོད་གསལ་བ་ཡིན་པའི་ཕྱིར་རོ་༎
 bodhir mañjuśrīr anāyūhāniryūhā |	འཇམ་དཔལ་། བྱང་ཆུབ་ནི་། བླང་བ་མེད་པ་ཉིད་དང་། དོར་བ་མེད་པ་ཉིད་ཡིན་ཏེ་།
 tatra katamānāyūhatā katamāniryūhatā |	དེ་ལ་བླང་བ་མེད་པ་ཉིད་ནི་། གང་། དོར་བ་མེད་པ་ཉིད་ནི་། གང་ཞེ་ན་། བླང་བ་མེད་པ་ཉིད་ཅེས་བྱ་བ་ནི་།
 anāyūhas tenocyate 'grahaḥ sarvadharmāṇām |	ཆོས་ཐམས་ཅད་གཟུང་དུ་མེད་པ་ཉིད་ཡིན་ནོ་༎ དོར་བ་མེད་པ་ཉིད་ཅེས་བྱ་བ་ནི་།
 aniryūha ucyate 'nutsargaḥ sarvadharmāṇām |	ཆོས་ཐམས་ཅད་སྤང་དུ་མེད་པ་ཉིད་ཡིན་ནོ་༎ འཇམ་དཔལ་། དེ་ལ་དེ་བཞིན་གཤེགས་པ་ནི་།
 tatra mañjuśrīs tathāgato 'nāyūho 'niryūha ogham avatārṣīt |	བླང་བ་མེད་པ་ཉིད་དང་། དོར་བ་མེད་པ་ཉིད་ཀྱིས་ཆུ་བོ་ལས་རྒལ་བར་གྱུར་ཏེ་།
 tathā cāvatārṣīd yathā tathatāyā nāpāraṃ na pāraṃ samanupaśyati |	ཇི་ལྟར་དེ་བཞིན་ཉིད་ཀྱི་ཚུ་རོལ་ཡང་དག་པར་རྗེས་སུ་མི་མཐོང་།
 iti hy apārapāravigatāḥ sarvadharmās tathāgatenābhisaṃbuddhāḥ |	ཕ་རོལ་ཡང་དག་པར་རྗེས་སུ་མི་མཐོང་བ་དེ་ལྟར་ཆུ་བོ་ལས་རྒལ་༄༥༡༣བ་ཏོ༏་༏དེ་ལྟར་དེ་བཞིན་གཤེགས་པས་ཚུ་རོལ་དང་ཕ་རོལ་དང་བྲལ་བའི་ཆོས་ཐམས་ཅད་མངོན་པར་རྫོགས་པར་བྱང་ཆུབ་སྟེ་། 
 tena tathāgata ity ucyate || (jāa 56) §23 ms| 19a4-b1, p| 321a3-8, d| 293b2-6, t| 357 245b27-c5, t| 358 252a15-18, t| 359(d) 260a16-25|	དེའི་ཕྱིར་དེ་བཞིན་གཤེགས་པ་ཞེས་བྱའོ་༎
 bodhir mañjuśrīr animittānārambaṇā |	འཇམ་དཔལ༏་བྱང་ཆུབ་ནི་། མཚན་མ་མེད་པ་ཉིད་དང་། དམིགས་པ་མེད་པ་ཉིད་ཡིན་ཏེ་།
 tatra katamānimittatā katamānārambaṇatā |	དེ་ལ་མཚན་མ་མེད་པ་ཉིད་ནི་། གང་། དམིགས་པ་མེད་པ་ཉིད་ནི་། གང་ཞེ་ན་།
 cakṣurvijñānānupalabdhir mañjuśrīr animittatā |	འཇམ་དཔལ༏་མིག་གི་རྣམ་པར་ཤེས་པ་མི་དམིགས་པ་ནི་། མཚན་མ་མེད་པ་ཉིད་ཡིན་ནོ་༎ གཟུགས་ཡང་དག་པར་རྗེས་སུ་མི་མཐོང་བ་ནི་།
 rūpasyāsamanupaśyanatānārambaṇatā |	དམིགས་པ་མེད་པ་ཉིད་ཡིན་ནོ་༎
 śrotravijñānānupalabdhir animittatā |	རྣ་བའི་རྣམ་པར་ཤེས་པ་མི་དམིགས་པ་ནི་། མཚན་མ་མེད་པ་ཉིད་ཡིན་ནོ་༎ སྒྲ་མཉན་དུ་མེད་པ་ནི་།
 śabdāśravaṇatānārambaṇatā|	དམིགས་པ་མེད་པ་ཉིད་ཡིན་ནོ་༎
 ghrāṇavijñānānupalabdhir animittatā |	སྣའི་རྣམ་པར་ཤེས་པ་མི་དམིགས་པ་ནི་། མཚན་མ་མེད་པ་ཉིད་ཡིན་ནོ་༎ དྲི་བསྣམ་དུ་མེད་པ་ནི་།
 gandhāghrāṇatānārambaṇatā |	དམིགས་སུ་མེད་པ་ཉིད་ཡིན་ནོ་༎
 jihvāvijñānānupalabdhir animittatā |	ལྕེའི་རྣམ་པར་ཤེས་པ་མི་དམིགས་པ་ནི་། མཚན་མ་མེད་པ་ཉིད་ཡིན་ནོ་༎
 rasāsvādanatānārambaṇatā |	རོ་མྱང་དུ་མེད་པ་ནི་། དམིགས་པ་མེད་པ་ཉིད་ཡིན་ནོ་༎
 kāyavijñānānupalabdhir animittatā |	ལུས་ཀྱི་རྣམ་པར་ཤེས་པ་མི་དམིགས་པ་ནི་། མཚན་མ་མེད་པ་ཉིད་ཡིན་ནོ་༎
 spraṣṭavyāspṛśaṇatānārambaṇatā |	རེག་བྱ་རེག་པར་བྱ་བ་མེད་པ་ནི་། དམིགས་པ་མེད་པ་ཉིད་ཡིན་ནོ་༎
 manovijñānānupalabdhir animittatā |	ཡིད་ཀྱི་རྣམ་པར་ཤེས་པ་མི་དམིགས་པ་ནི་། མཚན་མ་མེད་པ་ཉིད་ཡིན་ནོ་༎ ཆོས་རྣམས་རྣམ་པར་ཤེས་པར་བྱར་མེད་པ་ནི་།
 dharmāvijñānatānārambaṇatā |	དམིགས་པ་མེད་པ་༄༥༡༤ཨ་༌༎ ཉིད་ཡིན་ནོ་༎
 ayaṃ mañjuśrīr āryāṇāṃ gocaraḥ |	འཇམ་དཔལ་། དེ་ནི་། འཕགས་པ་རྣམས་ཀྱི་སྤྱོད་ཡུལ་ཡིན་ཏེ་། འཇམ་དཔལ་།
 yas traidhātuke 'gocaraḥ,	གང་ཁམས་གསུམ་པའི་སྤྱོད་ཡུལ་མ་ཡིན་པ་དེ་ནི་།
 ayaṃ mañjuśrīr āryāṇāṃ gocaraḥ || §24 ms| 19b1-3, p| 321a8-b3, d| 293b7-294a2, t| 357 245c5-11, t| 358 252a18-22, t| 359(d) 260a25-260b1|	འཕགས་པ་རྣམས་ཀྱི་སྤྱོད་ཡུལ་ཡིན་ནོ་༎ འཇམ་དཔལ་། བྱང་ཆུབ་ནི་། འདས་པ་མ་ཡིན་།
 bodhir mañjuśrīr nātītā nānāgatā na pratyutpannā tryadhvasamā trimaṇḍalaparicchinnā |	མ་འོངས་པ་མ་ཡིན་། ད་ལྟར་བྱུང་བ་མ་ཡིན་ཏེ་། དུས་གསུམ་མཉམ་པ་འཁོར་གསུམ་ཡོངས་སུ་ཆད་པ་ཡིན་ནོ་༎
 tatra katamo mañjuśrīs trimaṇḍalaparicchedaḥ |	འཇམ་དཔལ་། དེ་ལ་འཁོར་གསུམ་ཡོངས་སུ་ཆད་པ་གང་ཞེ་ན་།
 yad atīte cittaṃ nopalabhyate | anāgate vijñānaṃ na dhāvati | na pratyutpanne manaskāraḥ pravartate |	འདས་པ་ལ་སེམས་མི་འཇུག་པ་དང་། མ་འོངས་པ་ལ་རྣམ་པར་ཤེས་པ་མི་རྒྱུག་པ་དང་། དེ་ལྟར་བྱུང་བ་ལ་ཡིད་ལ་བྱེད་པ་མི་འབྱུང་བ་གང་ཡིན་པ་སྟེ་།
 sa cittamanovijñānāpratiṣṭhito na kalpayati na vikalpayati |	དེ་ནི་། སེམས་དང་། ཡིད་དང་། རྣམ་པར་ཤེས་པ་ལ་མི་གནས་ཤིང་རྟོག་པར་མི་བྱེད་། རྣམ་པར་རྟོག་པར་མི་བྱེད་དོ་༎ རྟོག་པར་མི་བྱེད་།
 anavakalpayann avikalpayan nātītaṃ karoty anāgataṃ na manyate pratyutpannaṃ na prapañcayati ||	རྣམ་པར་རྟོག་པར་མི་བྱེད་པ་ནི་། འདས་པ་ཡིད་ལ་མི་བྱེད་། མ་འོངས་པ་ལ་རློམ་སེམས་སུ་མི་བྱེད༏་དེ་ལྟར་བྱུང་བ་ལ་འཕྲོ་བར་མི་བྱེད་དོ་༎ འཇམ་དཔལ་།
 (jāa 57) §25 ms| 19b3-6, p| 321b3-b7, d| 294a2-5, t| 357 245c11-17, t| 358 252a22-24, t| 359(d) 260b1-6|	བྱང་ཆུབ་ནི་།
 bodhir mañjuśrīr aśarīrāsaṃskṛtā |	ལུས་མེད་པ་ཉིད་དང་། འདུས་མ་བྱས་པ་ཉིད་ཡིན་ཏེ་།
 tatrāśarīratā mañjuśrīr yā na cakṣurvijñānavijñeyā, na śrotra, na ghrāṇa,	འཇམ་དཔལ་། དེ་ལ་ལུས་མེད་པ་ཉིད་ནི༏་མིག་གི་རྣམ་པར་ཤེས་པས་རྣམ་པར་ཤེས་པར་བྱ་བ་མ་ཡིན་པ་དང་། 
 na jihvā, na kāya, na manovijñānavijñeyā |	རྣ་བ་དང་། སྣ་དང་། ལྕེ་དང་། ལུས་དང་། ཡིད་ཀྱི་རྣམ་པར་ཤེས་པས་རྣམ་པར་ཤེས་པར་བྱ་བ་མ་༄༥༡༤བ་ཡིན་པ་གང་ཡིན་པའོ་༎
 yan mañjuśrīr na cittamanovijñānavijñeyaṃ tad asaṃskṛtam |	འཇམ་དཔལ་། སེམས་དང་། ཡིད་དང་། རྣམ་པར་ཤེས་པས་རྣམ་པར་ཤེས་པར་བྱ་བ་མ་ཡིན་པ་གང་ཡིན་པ་དེ་ཉིད་འདུས་མ་བྱས་པ་ཉིད་ཡིན་ཏེ༏་འདུས་མ་བྱས་པ་ཉིད་ཅེས་བྱ་བ་ནི་།
 asaṃskṛtam ucyate yatra notpādo na sthitir na vyayaḥ |	གང་ལ་སྐྱེ་བ་མེད་པ་དང་། གནས་པ་མེད་པ་དང་། འཇིག་པ་མེད་པའོ་༎ དེ་ནི་།
 tad ucyate trimaṇḍalapariśuddham asaṃskṛtam |	འཁོར་གསུམ་ཡོངས་སུ་དག་པ་འདུས་མ་བྱས་པ་ཡིན་ཏེ་།
 yathaivāsaṃskṛtas tathaivaṃ saṃskṛtaṃ boddhavyam |	འདུས་མ་བྱས་པ་ཇི་ལྟ་བ་ཁོ་ན་བཞིན་དུ་འདུས་བྱས་ཀྱང་དེ་ལྟ་བུ་ཁོ་ན་ཡིན་པར་རྟོགས་པར་བྱའོ་༎
 tat kasya hetoḥ |	དེ་ཅིའི་ཕྱིར་ཞེ་ན་། འཇམ་དཔལ་།
 sarvadharmāṇāṃ yaḥ svabhāvaḥ so 'svabhāvaḥ,	ཆོས་ཐམས་ཅད་ཀྱི་ངོ་བོ་ཉིད་གང་ཡིན་པ་དེ་ནི་། ངོ་བོ་ཉིད་མེད་པ་སྟེ་། ངོ་བོ་ཉིད་མེད་པ་གང་ཡིན་པ་དེ་ལ་ནི་།
 tatra nāsti dvayam iti || §26 ms| 19b6-20a3, p| 321b7-322a4, d| 294a5-b1, t| 357 245c17-27, t| 358 252 a24-b3, t| 359(d) 260b6-16|	གཉིས་སུ་མེད་པའི་ཕྱིར་རོ་། འཇམ་དཔལ་།
 bodhir mañjuśrīr abhedapadam etat |	བྱང་ཆུབ་དེ་ནི་། དབྱེར་མེད་པའི་གཞི་ཡིན་ཏེ་།
 tatra katamo 'bhedaḥ,	དེ་ལ་དབྱེར་མེད་པ་ནི་། གང་། གཞི་ནི་།
 katamat padam |	གང་ཞེ་ན་།
 asaṃjñābhedas tathatā padam |	མིང་མེད་པ་ནི་། དབྱེར་མེད་པའོ་༎ དེ་བཞིན་ཉིད་ནི་། གཞིའོ་༎
 apratiṣṭhānam abhedo dharmadhātuḥ padam |	གནས་མེད་པ་ནི་། དབྱེར་མེད་པའོ་༎ ཆོས་ཀྱི་དབྱིངས་ནི་། གཞིའོ་༎
 anānātvam abhedo bhūtakoṭiḥ padam |	ཐ་དད་པ་ཉིད་མེད་པ་ནི་། དབྱེར་མེད་པའོ་༎ ཡང་དག་པའི་མཐའ་ནི་། གཞིའོ་༎
 anilambho 'bhedo 'calanatā padam |	དམིགས་པ་མེད་པ་ནི་། དབྱེར་མེད་པའོ་༎ ག-ཡོ་བ་མེད་པ་ནི་།
 śūnyatābhedo 'nimittaṃ padam |	གཞིའོ་༎ སྟོང་པ་ཉིད་ནི་། དབྱེར་མེད་པའོ་༎ མཚན་མ་མེད་པ་ནི་། གཞིའོ་༎
 avitarko 'bhedo 'praṇihitaṃ padam |	རྣམ་པར་རྟོག་པ་མེད་པ་ནི་། དབྱེར་མེད་པའོ་༎ སྨོན་པ་མེད་པ་ནི་།
 aprārthanābhedo niḥsattvatā padam |	༄༥༡༥ཨ་༌༎ གཞིའོ༏་༏སྒྲུབ་པ་མེད་པ་ནི་། དབྱེར་མེད་པའོ་༎ སེམས་ཅན་མེད་པ་ནི་། གཞིའོ་༎
 sattvāsvabhāvo 'bheda ākāśaṃ padam |	སེམས་ཅན་གྱི་ངོ་བོ་ཉིད་མེད་པ་ནི་། དབྱེར་མེད་པའོ་༎ ནམ་མཁའ་ནི་། གཞིའོ་༎
 anupalambho 'bhedo 'nutpādaṃ padam |	དམིགས་སུ་མེད་པ་ནི་། དབྱེར་མེད་པའོ་༎ སྐྱེ་བ་མེད་པ་ནི་། གཞིའོ་༎
 anirodho 'bhedo 'saṃskṛtaṃ padam |	འགག་པ་མེད་པ་ནི་། དབྱེར་མེད་པའོ་༎ འདུས་མ་བྱས་ནི་། གཞིའོ་༎
 apracāro 'bhedo bodhiḥ padam |	སྤྱོད་པ་མེད་པ་ནི་། དབྱེར་མེད་པའོ་༎ བྱང་ཆུབ་ནི་། གཞིའོ་༎
 vyupaśamo 'bhedo nirvāṇaṃ padam |	ཉེ་བར་ཞི་བ་ནི་། དབྱེར་མེད་པའོ་༎ མྱ་ངན་འདས་པ་ནི་། གཞིའོ་༎
 anabhinirvṛttir abhedo 'jātiḥ padam ||	མངོན་པར་འགྲུབ་པ་མེད་པ་ནི་། དབྱེར་མེད་པའོ་༎ སྐྱེ་བ་མེད་པ་ནི་།
 (jāa 58) §27 ms| 20a3-6, p| 322a4-7, d| 294b1-4, t| 357 245c27-246a4, t| 358 252b3-7, t| 359(d) 260b16-21|	གཞིའོ་༎
 bodhir mañjuśrīr na kāyenābhisambudhyate na cittena |	འཇམ་དཔལ་། བྱང་ཆུབ་ནི་། ལུས་ཀྱིས་མངོན་པར་རྫོགས་པར་བྱང་ཆུབ་པར་མི་འགྱུར་ཏེ་། སེམས་ཀྱིས་ཀྱང་མ་ཡིན་ནོ་༎
 tat kasmād dhetoḥ |	དེ་ཅིའི་ཕྱིར་ཞེ་ན་། འཇམ་དཔལ་། ལུས་ནི་། བེམ་པོ་།
 jaḍaḥ kāyo mañjuśrīr niśceṣṭo 'cetanas tṛṇakāṣṭhakuḍyaloṣṭapratibhāsopamaḥ |	ག-ཡོ་བ་མེད་པ་། སེམས་པ་མེད་པ་སྟེ་། རཙབ༹་དང་། རྩིག་པ་དང་། ཤིང་དང་། བོང་བ་དང་། གཟུགས་བརྙན་ལྟ་བུ་ཡིན་ལ་།
 cittaṃ ca māyopamaṃ riktaṃ tuccham abhūtam asaṃskṛtam |	སེམས་ཀྱང་སྒྱུ་མ་ལྟ་བུ་སྟེ་། གསོག་དང་། གསོབ་དང་། ཡང་དག་པ་མ་ཡིན་པ་དང་། འདུས་མ་བྱས་པ་ཡིན་པའི་ཕྱིར་རོ་༎ འཇམ་དཔལ་།
 yo mañjuśrīr evaṃ kāyasya cittasya cāvabodhaḥ,	གང་གིས་ལུས་དང་སེམས་དེ་ལྟར་རྟོགས་པ་དེ་ནི་།
 ayam ucyate mañjuśrīr bodhiḥ |	བྱང་ཆུབ་ཅེས་བྱ་སྟེ་། འཇམ་དཔལ་། དེའང་ཐ་སྙད་ལ་བརྟེན་པ་ཡིན་གྱི་།
 vyavahāram upādāya na punaḥ paramārthataḥ |	དོན་དམ་པར་ནི་།
 tat kasmād dhetoḥ |	མ་ཡིན་ནོ་༎ དེ་ཅིའི་ཕྱིར་༄༥༡༥བ་ཞེ་ན༏་འཇམ་དཔལ་། བྱང་ཆུབ་ནི་།
 na mañjuśrīr bodhiḥ kāyena vā cittena vā dharmeṇa vā adharmeṇa vā bhūtena vābhūtena vā satyena vā mṛṣā vā vacanīyā || §28 ms| 20a6-b2, p| 322a7-322b3, d| 294b4-7, t| 357 246a4-12, t| 358 252b7-10, t| 359(d) 260b21-27|	ལུས་དང་། སེམས་དང་། ཆོས་དང་། ཆོས་མ་ཡིན་པ་དང་། ཡང་དག་པ་དང་། ཡང་དག་པ་མ་ཡིན་པ་དང་། བདེན་པ་དང་། རྫུན་པས་བརྗོད་པར་བྱ་བ་མ་ཡིན་པའི་ཕྱིར་རོ་༎
 avacanīyā mañjuśrīr bodhiḥ sarvadharmaiḥ |	འཇམ་དཔལ་། བྱང་ཆུབ་ནི་། ཆོས་ཐམས་ཅད་ཀྱིས་བརྗོད་པར་བྱ་བ་མ་ཡིན་པ་སྟེ་།
 tat kasmād dhetoḥ |	དེ་ཅིའི་ཕྱིར་ཞེ་ན་། འཇམ་དཔལ་། བྱང་ཆུབ་ལ་ནི་།
 na mañjuśrīr bodhiḥ kiñcit sthānaṃ yena ca vyavahāraṃ gacchet |	གང་གིས་ཚིག་དང་། ཐ་སྙད་འཇུག་པར་འགྱུར་བའི་གནས་ཅུང་ཟད་ཀྱང་མེད་པའི་ཕྱིར་རོ་༎ འཇམ་དཔལ་། འདི་ལྟ་སྟེ་། དཔེར་ན་། ནམ་མཁའ་ནི་།
 yathā mañjuśrīr ākāśasthānam asaṃskṛtam anutpannam aniruddham avacanīyaṃ tathā mañjuśrīr bodhir asaṃskṛtāsthānānutpannāniruddhāvacanīyā |	གནས་མེད་པ༏་འདུས་མ་བྱས་པ་། མ་སྐྱེས་པ་། མ་འགགས་པ་། བརྗོད་པར་བྱ་བ་མ་ཡིན་པའོ་༎ འཇམ་དཔལ་། དེ་བཞིན་དུ་བྱང་ཆུབ་ཀྱང་གནས་མེད་པ་། འདུས་མ་བྱས་པ་། མ་སྐྱེས་པ་། མ་འགགས་པ་། བརྗོད་པར་བྱ་བ་མ་ཡིན་པའོ་༎ འཇམ་དཔལ་། འདི་ལྟ་སྟེ་། དཔེར་ན་།
 yathā mañjuśrīr bhūtaṃ parigaveṣyamāṇaṃ sarvadharmair avacanīyam,	ཡང་དག་པར་ཡོངས་སུ་ཚོལ་བ་ན་ཆོས་ཐམས་ཅད་ཀྱིས་བརྗོད་པར་བྱ་བ་མ་ཡིན་པ་དེ་བཞིན་དུ་། འཇམ་དཔལ་།
 evam eva mañjuśrīr bodhir bhūtā parigaveṣyamāṇā sarvadharmair avacanīyā |	ཡང་དག་པར་བྱང་ཆུབ་ཡོངས་སུ་ཚོལ་བ་ནའང་ཆོས་ཐམས་ཅད་ཀྱིས་བརྗོད་པར་བྱ་བ་མ་ཡིན་ནོ་༎ 
 tat kasmād dhetoḥ |	དེ་ཅིའི་ཕྱིར་ཞེ་ན་། འཇམ་དཔལ་།
 na mañjuśrīr bhūte vacanaṃ saṃvidyate 'nutpannāniruddhatvāt || (jāa 59) §29 ms| 20b2-21a4, p| 322b3-323a5, d| 294b7-295b1, t| 357 246a12-b2, t| 358 252b10-16, t| 359(d) 260b27-c15|	ཡང་དག་པར་ནི་ཚིག་ནི་། མ་སྐྱེས་པ་དང་། མ་འགགས་པ་ཡིན་པས་ཡོད་པ་མ་ཡིན་པའི་ཕྱིར་རོ་༎ འཇམ་དཔལ་།
 bodhir mañjuśrīr agrāhyatānālayatā |	བྱང་ཆུབ་ནི་། གཟུང་བ་མེད་པ་ཉིད་༄༥༡༦ཨ་༌༎ དང་། གནས་མེད་པ་ཉིད་ཡིན་ཏེ་། འཇམ་དཔལ་། དེ་ལ་གཟུང་བ་མེད་པ་ནི་། གང་། གནས་མེད་པ་ནི་།
 tatra mañjuśrīḥ katamāgrāhyatā katamānālayatā |	གང་ཞེ་ན་། འཇམ་དཔལ་། མིག་ཡོངས་སུ་ཤེས་པ་ནི་།
 cakṣuḥparijñā mañjuśrīr agrāhyatā rūpānupalabdhir anālayatā |	གཟུང་བ་མེད་པ་ཉིད་ཡིན་ནོ་༎ གཟུགས་དམིགས་སུ་མེད་པ་ནི་། གནས་མེད་པ་ཉིད་ཡིན་ནོ་༎
 śrotraparijñāgrāhyatā śabdānupalabdhir anālayatā |	རྣ་བ་ཡོངས་སུ་ཤེས་པ་ནི་། གཟུང་བ་མེད་པ་ཉིད་ཡིན་ནོ་༎ སྒྲ་དམིགས་སུ་མེད་པ་ནི་། གནས་མེད་པ་ཉིད་ཡིན་ནོ་༎
 ghrāṇaparijñāgrāhyatā gandhānupalabdhir anālayatā |	སྣ་ཡོངས་སུ་ཤེས་པ་ནི་། གཟུང་བ་མེད་པ་ཉིད་ཡིན་ནོ་༎ དྲི་དམིགས་སུ་མེད་པ་ནི་། གནས་མེད་པ་ཉིད་ཡིན་ནོ་༎
 jihvāparijñāgrāhyatā rasānupalabdhir anālayatā |	ལྕེ་ཡོངས་སུ་ཤེས་པ་ནི་། གཟུང་བ་མེད་པ་ཉིད་ཡིན་ནོ་༎ རོ་དམིགས་སུ་མེད་པ་ནི་། གནས་མེད་པ་ཉིད་ཡིན་ནོ་༎
 kāyaparijñāgrāhyatā spraṣṭavyānupalabdhir anālayatā |	ལུས་ཡོངས་སུ་ཤེས་པ་ནི་། གཟུང་བ་མེད་པ་ཉིད་ཡིན་ནོ་༎ རེག་བྱ་དམིགས་སུ་མེད་པ་ནི་། གནས་མེད་པ་ཉིད་ཡིན་ནོ་༎
 manaḥparijñāgrāhyatā dharmānupalabdhir anālayatā ||	ཡིད་ཡོངས་སུ་ཤེས་པ་ནི་། གཟུང་བ་མེད་པ་ཉིད་ཡིན་ནོ་༎ ཆོས་དམིགས་སུ་མེད་པ་ནི༏་གནས་མེད་པ་ཉིད་ཡིན་ནོ་༎
 evaṃ tathāgatenāgrāhyānālayā bodhir abhisaṃbuddhā | abhisaṃbudhya cakṣuṣo 'nanugrahāya rūpānupalabdhitaś cakṣurvijñānaṃ na pratiṣṭhitam |	དེ་བཞིན་གཤེགས་པས་ནི་། དེ་ལྟར་གཟུང་བ་མེད་པ་ཉིད་དང་། གནས་མེད་པ་ཉིད་དུ་བྱང་ཆུབ་མངོན་པར་རྫོགས་པར་སངས་རྒྱས་ཏེ༏་མངོན་པར་རྫོགས་པར་སངས་རྒྱས་ནས་ཀྱང་མིག་གཟུང་དུ་མེད་པ་དང་། གཟུགས་དམིགས་སུ་མེད་པའི་ཕྱིར་མིག་གི་རྣམ་པར་ཤེས་པ་ལ་མི་གནས་སོ་༎
 śrotrānanugrahāya śabdānupalabdhitaḥ śrotravijñānaṃ na pratiṣṭhitam |	རྣ་བ་གཟུང་༄༥༡༦བ་དུ་མེད་པ་དང་། སྒྲ་དམིགས་སུ་མེད་པའི་ཕྱིར་རྣ་བའི་རྣམ་པར་ཤེས་པ་ལ་མི་གནས་སོ་༎
 ghrāṇānanugrahāya gandhānupalabdhito ghrāṇavijñānaṃ na pratiṣṭhitam |	སྣ་གཟུང་དུ་མེད་པ་དང་། དྲི་དམིགས་སུ་མེད་པའི་ཕྱིར་སྣའི་རྣམ་པར་ཤེས་པ་ལ་མི་གནས་སོ་༎
 jihvānanugrahāya rasānupalabdhito jihvāvijñānaṃ na pratiṣṭhitam |	ལྕེ་གཟུང་དུ་མེད་པ་དང་། རོ་དམིགས་སུ་མེད་པའི་ཕྱིར་ལྕེའི་རྣམ་པར་ཤེས་པ་ལ་མི་གནས་སོ་༎
 kāyānanugrahāya spraṣṭavyānupalabdhitaḥ (jāa 60) kāyavijñānaṃ na pratiṣṭhitam |	ལུས་གཟུང་དུ་མེད་པ་དང་། རེག་བྱ་དམིགས་སུ་མེད་པའི་ཕྱིར་ལུས་ཀྱི་རྣམ་པར་ཤེས་པ་ལ་མི་གནས་སོ་༎
 mano'nanugrahāya dharmānupalabdhito manovijñānaṃ na pratiṣṭhitam |	ཡིད་གཟུང་དུ་མེད་པ་དང་། ཆོས་དམིགས་སུ་མེད་པའི་ཕྱིར་ཡིད་ཀྱི་རྣམ་པར་ཤེས་པ་ལ་མི་གནས་ཏེ་།
 tenāpratiṣṭhitavijñānas tathāgato 'rhan samyaksambuddha iti saṃkhyāṃ gacchati ||	དེའི་ཕྱིར་དེ་བཞིན་གཤེགས་པ་དགྲ་བཅོམ་པ་ཡང་དག་པར་རྫོགས་པའི་སངས་རྒྱས་ནི་། རྣམ་པར་ཤེས་པ་ལ་མི་གནས་པ་དང་ལྡན་པ་ཞེས་བྱ་བའི་གྲངས་སུ་འགྲོའོ་༎
 catvārīmāni mañjuśrīḥ sattvānāṃ cittapratiṣṭhāni |	འཇམ་དཔལ་། བཞི་པོ་འདི་དག་ནི་། སེམས་ཅན་རྣམས་ཀྱི་སེམས་ཀྱི་གནས་ཡིན་ཏེ་། བཞི་གང་ཞེ་ན་།
 katamāni catvāri yad uta rūpaṃ sattvānāṃ cittasya pratiṣṭhānam |	འདི་ལྟ་སྟེ་། གཟུགས་ནི་། སེམས་ཅན་རྣམས་ཀྱི་སེམས་ཀྱི་གནས་ཡིན་ནོ་༎
 evaṃ vedanāsaṃjñāsaṃskārā mañjuśrīḥ sattvānāṃ cittasya pratiṣṭhānam |	འཇམ་དཔལ༏་དེ་བཞིན་དུ་ཚོར་བ་དང་། འདུ་ཤེས་དང་། འདུ་བྱེད་རྣམས་ནི་། སེམས་ཅན་རྣམས་ཀྱི་སེམས་ཀྱི་གནས་ཡིན་ཏེ་། འཇམ་དཔལ་།
 tāni khalu punar imāni mañjuśrīś catvāri cittasya pratiṣṭhānāni tathāgatenānutpannāny aniruddhānīti jñātāni || §30 ms| 21a4-b6, p| 323a5-b7, d| 295b1-296a2, t| 357 246ab2-19, t| 358 252b16-26, t| 359(d) 260c15-261a5|	དེ་བཞིན་གཤེགས་པས་ནི༏་སེམས་ཅན་རྣམས་ཀྱི་སེམས་ཀྱི་གནས་བཞི་པོ་དེ་དག་མ་སྐྱེས་པ་དང་། མ་འགགས་པར་ཤེས་སོ་༎ འཇམ་དཔལ་།
 bodhir iti mañjuśrīḥ śūnyatāyā etad adhivacanam |	བྱང་ཆུབ་ཅེས་བྱ་བ་དེ་ནི་། སྟོང་པ་ཉིད་ཀྱི་ཚིག་༄༥༡༧ཨ་༌༎ བླ་དབ༹གས་ཡིན་ཏེ་།
 yayā śūnyatayā mañjuśrīr bodhiḥ śūnyā tayā śūnyatayā mañjuśrīḥ sarvadharmāḥ śūnyāḥ |	འཇམ་དཔལ་། སྟོང་པ་ཉིད་གང་གིས་བྱང་ཆུབ་སྟོང་པའི་སྟོང་པ་ཉིད་དེས་ཆོས་ཐམས་ཅད་ཀྱང་སྟོང་སྟེ་། འཇམ་དཔལ་དེ་བཞིན་གཤེགས་པས་ནི་།
 te tathāgatena yathaiva śūnyās tathaivābhisaṃbuddhāḥ |	དེ་དག་ཇི་ལྟར་སྟོང་པ་དེ་ལྟ་བུ་ཁོ་ནར་མངོན་པར་རྫོགས་པར་སངས་རྒྱས་སོ་༎ འཇམ་དཔལ་།
 na mañjuśrīḥ śūnyatayā śūnyatābhisaṃbuddhāḥ |	སྟོང་པ་ཉིད་ཀྱིས་སྟོང་པ་ཉིད་མངོན་པར་རྫོགས་པར་སངས་རྒྱས་པའང་མ་ཡིན་ཏེ་། འཇམ་དཔལ་།
 api tu khalu punar mañjuśrīr ekanayam etad yad uta śūnyatā vā bodhir vā |	འདི་ལྟ་སྟེ་། སྟོང་པ་ཉིད་དམ་། བྱང་ཆུབ་དེ་ནི་། ཤེས་པའི་ཚུལ་གཅིག་པ་ཡིན་ནོ་༎ འཇམ་དཔལ་།
 yatra mañjuśrīr na śūnyatā na bodhiḥ,	གང་ལ་སྟོང་པ་ཉིད་ཀྱང་མེད་། བྱང་ཆུབ་ཀྱང་མེད་པ་དེ་ལ་ནི་། འཇམ་དཔལ་།
 na tatra mañjuśrīḥ kiṃcid dvayaṃ yena dvayena śūnyatā vā bodhir vā dvidhākriyate |	གང་གིས་སྟོང་པ་ཉིད་དང་། བྱང་ཆུབ་སེམས་གཉིས་སུ་དབྱེ་བའི་གཉིས་ནི་།
 tat kasmād dhetoḥ |	ཅུང་ཟད་ཀྱང་མེད་དོ༏་༏དེ་ཅིའི་ཕྱིར་ཞེ་ན་། འཇམ་དཔལ་།
 advayā mañjuśrīḥ sarvadharmā alakṣaṇā advaidhīkārā anāmāno 'nimittāś cittamanovijñānāpagatā anutpannā aniruddhā (jāa 61)	ཆོས་ཐམས་ཅད་ནི་། གཉིས་སུ་མེད་པ་། མཚན་ཉིད་མེད་པ་། གཉིས་སུ་དབྱེར་མེད་པ་། མིང་མེད་པ་། མཚན་མ་མེད་པ་། སེམས་དང་ཡིད་དང་རྣམ་པར་ཤེས་པ་དང་བྲལ་བ་། མ་སྐྱེས་པ་། མ་འགགས་པ་།
 anācārā apracārā asamudācārā anakṣarā aghoṣāḥ ||	རྒྱུ་བ་མེད་པ་། སྤྱོད་པ་མེད་པ་། ཀུན་འབྱུང་བ་མེད་པ་། ཡི་གེ་མེད་པ༏་སྒྲ་མེད་པ་ཡིན་པའི་ཕྱིར་རོ་༎ བམ་བོ་གསུམ་པ་སྟེ་། ཐ་མ་།
 yat punar ucyate mañjuśrīḥ śūnyam iti,	འཇམ་དཔལ་། སྟོང་པ་ཉིད་ཅེས་བྱ་བ་གང་ཡིན་པ་དེ་ནི་།
 anabhiniveśagrāhasyaitad adhivacanam |	མངོན་པར་༄༥༡༧བ་ཞེ་ན་པ་མེད་པ་དང་། འཛིན་པ་མེད་པའི་ཚིག་བླ་དབ༹གས་ཡིན་ཏེ་།
 na punar atra mañjuśrīḥ paramārthataḥ kaścid dharma upalabhyate yaḥ śūnyam ity ucyate |	འཇམ་དཔལ་། དེ་ལ་ནི་། དོན་དམ་པར་ན་གང་སྟོང་པ་ཞེས་བྱ་བའི་ཆོས་གང་ཡང་དམིགས་སུ་མེད་དོ་༎ འཇམ་དཔལ་། འདི་ལྟ་སྟེ་།
 yathā mañjuśrīr ākāśam ākāśam ity ucyate,	དཔེར་ན་། ནམ་མཁའ་ནམ་མཁའ་ཞེས་བརྗོད་ཀྱང་ནམ་མཁའ་ནི་།
 avacanīyam ākāśam |	བརྗོད་པར་བྱ་བ་མ་ཡིན་ནོ་༎
 evam eva mañjuśrīḥ śūnyaṃ śūnyam ity ucyate,	འཇམ་དཔལ་། དེ་བཞིན་དུ་སྟོང་པ་སྟོང་པ་ཞེས་བརྗོད་ཀྱང་སྟོང་པ་པ་ནི་། བརྗོད་པར་བྱ་བ་མ་ཡིན་ཏེ་།
 avacanīyeṣu śūnyeṣu praveśaḥ sarvadharmāṇām |	ཆོས་ཐམས་ཅད་ཀྱིས་འཇུག་པ་ནི་། དེ་ལྟ་བུ་ཡིན་ནོ་༎
 anāmakā mañjuśrīḥ sarvadharmānām ataś ca vyākriyante |	འཇམ་དཔལ་། ཆོས་ཐམས་ཅད་ནི་། མིང་མེད་པ་ཡིན་ན༏་དེ་དག་ལ་མིང་གིས་བརྗོད་པར་བྱེད་དེ་། འཇམ་དཔལ་།
 na mañjuśrīr nāma deśasthaṃ na pradeśasthaṃ | tathābhisaṃbuddhās tathāgatena |	མིང་ནི་། ཡུལ་ན་གནས་པ་མ་ཡིན་། ཕྱོགས་ན་གནས་པ་མ་ཡིན་ནོ་༎ འཇམ་དཔལ་།
 nāmnā yo dharmo 'bhilapyate so 'pi dharmo na deśastho na pradeśasthaḥ |	ཇི་ལྟར་མིང་ཡུལ་ན་གནས་པ་མ་ཡིན་། ཕྱོགས་ན་གནས་པ་མ་ཡིན་པ་དེ་བཞིན་དུ་གང་གིས་ཆོས་གང་བརྗོད་པར་བྱེད་པའི་ཆོས་དེའང་ཡུལ་ན་གནས་པ་མ་ཡིན་། ཕྱོགས་ན་གནས་པ་མ་ཡིན་ནོ༏་༏འཇམ་དཔལ་། དེ་བཞིན་གཤེགས་པས་ནི་།
 evam ete mañjuśrīḥ sarvadharmās tathāgatena jñātā ādita evājātā anutpannā aniruddhā alakṣaṇāś cittamanovijñānāpagatā anakṣarā aghoṣāḥ |	ཆོས་དེ་དག་ཐམས་ཅད་དེ་ལྟར་གཟོད་མ་ནས་མ་སྐྱེས་པ་། མ་འགགས་པ་། མཚན་ཉིད་མེད་པ་། སེམས་དང་ཡིད་དང་རྣམ་པར་ཤེས་པ་དང་བྲལ་བ་། ཡི་གེ་མེད་པ་། སྒྲ་མེད་པར་ཤེས་སོ་༎ འཇམ་དཔལ་།
 yathā jñātās tathaivādhimuktāḥ |	ཇི་ལྟར་ཤེས་པ་དེ་ཁོ་ན་བཞིན་དུ་རྣམ་པར་གྲོལ་ཏེ་། བཅིངས་པ་ལས་༄༥༡༨ཨ་༌༎
 na mañjuśrīr buddho 'dhimucyate || §31 ms| 21b6-22a4, p| 323b7-324a5, d| 296a2-7, t| 357 246b19-246c1, t| 358 252b26-252c3, t| 359(W) 261a5-19|	གྲོལ་བར་གྱུར་པ་མ་ཡིན་ནོ་༎
 bodhir mañjuśrīr ākāśasamā |	འཇམ་དཔལ་། བྱང་ཆུབ་ནི་། ནམ་མཁའ་དང་མཉམ་པ་སྟེ་།
 ākāśaṃ ca na samaṃ na (jāa 62)	ནམ་མཁའ་ནི་། མཉམ་པ་མ་ཡིན་།
 viṣamaṃ bodhir api na samā na viṣamā |	མི་མཉམ་པ་མ་ཡིན་ལ་བྱང་ཆུབ་ཀྱང་མཉམ་པ་མ་ཡིན་། མི་མཉམ་པ་མ་ཡིན་ནོ་༎
 tat kasmād dhetoḥ |	དེ་ཅིའི་ཕྱིར་ཞེ་ན་། འཇམ་དཔལ་།
 yasya mañjuśrīr dharmasya na bhūtapariniṣpattir nāsau samo na viṣamo vā vaktavya iti |	ཆོས་གང་ལ་ཡང་དག་པར་ཡོངས་སུ་འགྲུབ་པ་མེད་པ་དེ་ནི༏་མཉམ་པ་དང་། མི་མཉམ་པར་བརྗོད་པར་བྱ་བ་མ་ཡིན་པའི་ཕྱིར་རོ་༎ འཇམ་དཔལ་།
 hi mañjuśrīs tathāgatena sarvadharmā asamā aviṣamā abhisaṃbuddhāḥ |	དེ་བཞིན་གཤེགས་པས་ནི་། དེ་ལྟར་ཆོས་ཐམས་ཅད་མཉམ་པ་མེད་པ་དང་། མི་མཉམ་པ་མེད་པར་མངོན་པར་རྫོགས་པར་སངས་རྒྱས་ཏེ་། ཇི་ལྟར་ཆོས་ཕྲ་རབ་ཙམ་ཡང་མཉམ་པར་མ་བྱས་།
 tathā cābhisaṃbuddhā athāṇur api na samīkṛto na viṣamīkṛtaḥ |	མི་མཉམ་པར་མ་བྱས་པ་དེ་ལྟར་མངོན་པར་རྫོགས་པར་སངས་རྒྱས་ཤིང་།
 yādṛśā eva te dharmāḥ tādṛśā eva vijñātāḥ |	ཡང་དག་པའི་ཤེས་པས་ཆོས་དེ་དག་ཇི་ལྟ་བུ་ཁོ་ནར་ཤེས་སོ་༎ འཇམ་དཔལ་།
 bhūtajñānena katamac ca mañjuśrīḥ sarvadharmā anutpannāniruddhāḥ, abhūtvā bhavanti, abhūtvāś ca prati vigacchanti |	ཡང་དག་པའི་ཤེས་པའང་གང་ཞེ་ན་། འཇམ་དཔལ་། ཆོས་ཐམས་ཅད་རྩ་བ་མེད་པ་དང་། མ་སྐྱེས་པ་དང་། མ་འགགས་པ་དང་། མ་བྱུང་བ་ལས་འབྱུང་བ་དང་། བྱུང་ནས་ཀྱང་འཇིག་པར་འགྱུར་ཏེ་།
 te cāsvāmikā aparigrahāḥ saṃbhavanti, asvāmikā aparigrahāś ca mañjuśrīḥ prati vigacchanti |	འཇམ་དཔལ་། དེ་དག་ཀྱང་བདག་པོ་མེད་པ་དང་། ཡོངས་སུ་འཛིན་པ་མེད་པར་འབྱུང་ཞིང་བདག་པོ་མེད་པ་དང་། ཡོངས་སུ་འཛིན་པ་མེད་པར་འཇིག་པར་ཤེས་པའོ་༎
 iti hi mañjuśrīḥ saṃbhavanti vibhavanti ca pratītya dharme vartante na cātra kaścid vartayitā |	འཇམ་དཔལ་། དེ་ལྟར་བྱུང་བ་༄༥༡༨བ་དང་། འཇིག་པ་ལ་བརྟེན་ནས་ཆོས་རྣམས་འཇུག་པར་འགྱུར་ཡང་འདི་ལ་འཇུག་པར་འགྱུར་བ་གང་ཡང་མེད་དེ་། དེ་ནི་།
 tad ucyate dharmopacchedāya tathāgato dharmaṃ deśayatīti || §32 ms| 22a4-22b3, p| 324a5-b5, d| 296a7-296b6, t| 357 246c2-17, t| 358 252c3-8, t| 359(W) 261a20-261b9|	ལམ་གྱི་རྒྱུན་བཅད་པའི་ཕྱིར་དེ་བཞིན་གཤེགས་པ་ཆོས་སྟོན་པ་ཞེས་བྱའོ་༎
 bodhir iti mañjuśrīr yathāvatpadam etat |	འཇམ་དཔལ་། བྱང་ཆུབ་ཅེས་བྱ་བ་དེ་ནི་། ཇི་ལྟ་བ་བཞིན་གྱི་གནས་ཡིན་ཏེ་།
 tatra mañjuśrīḥ katamad yathāvatpadam | mañjuśrīr bodhiḥ,	འཇམ་དཔལ་། དེ་ལ་ཇི་ལྟ་བ་བཞིན་གྱི་གནས་གང་ཞེ་ན་། འཇམ་དཔལ༏་ཇི་ལྟ་བ་བཞིན་གྱི་གནས་ཞེས་བྱ་བ་ནི་།
 yathā bodhis tathā rūpaṃ tathatān na vyativartate |	བྱང་ཆུབ་སྟེ་། བྱང་ཆུབ་ཇི་ལྟ་བ་དེ་བཞིན་གཟུགས་ཀྱང་དེ་བཞིན་ཉིད་ལས་མི་འདའོ་༎
 yathā bodhis tathā vedanāsaṃjñāsaṃskāravijñānaṃ tathatān na vyativartate |	བྱང་ཆུབ་ཇི་ལྟ་བ་དེ་བཞིན་དུ་ཚོར་བ་དང་། འདུ་ཤེས་དང་། འདུ་བྱེད་རྣམས་དང་། རྣམ་པར་ཤེས་པའང་དེ་བཞིན་ཉིད་ལས་མི་འདའོ་༎
 yathā bodhis tathā pṛthivīdhātus tathatān na vyativartate |	བྱང་ཆུབ་ཇི་ལྟ་བ་དེ་བཞིན་དུ་སའི་ཁམས་དང་དེ་བཞིན་ཉིད་ལས་མི་འདའོ་༎
 (jāa 63) yathā bodhis tathāpdhātus tejodhātus tathatān na vyativartate |	བྱང་ཆུབ་ཇི་ལྟ་བ་དེ་བཞིན་དུ་ཆུའི་ཁམས་དང་། མེའི་ཁམས་དང་། རླུང་གི་ཁམས་ཀྱང་དེ་བཞིན་ཉིད་ལས་མི་འདའོ་༎
 yathā bodhis tathā cakṣurdhātū rūpadhātuś cakṣurvijñānadhātus tathatān na vyativartate |	འཇམ་དཔལ་། བྱང་ཆུབ་ཇི་ལྟ་བ་དེ་བཞིན་དུ་མིག་གི་ཁམས་དང་། གཟུགས་ཀྱི་ཁམས་དང་། མིག་གི་རྣམ་པར་ཤེས་པའི་ཁམས་ཀྱང་དེ་བཞིན་ཉིད་ལས་མི་འདའོ་༎
 yathā hi mañjuśrīr bodhis tathā śrotradhātuḥ śabdadhātuḥ śrotravijñānadhātuḥ, ghrāṇadhātur gandhadātur ghrāṇavijñānadhātuḥ,	བྱང་ཆུབ་ཇི་ལྟ་བ་དེ་བཞིན་དུ་རྣ་བའི་ཁམས་དང་། སྒྲའི་ཁམས་དང་། རྣ་བའི་རྣམ་པར་ཤེས་པའི་ཁམས་དང་། སྣའི་ཁམས་དང་། དྲིའི་ཁམས་དང་། སྣའི་རྣམ་པར་ཤེས་པའི་ཁམས་དང་། ལྕེའི་༄༥༡༩ཨ་༌༎
 jihvādhātū rasadhātur jihvāvijñānadhātuḥ, kāyadhātuḥ spraṣṭavyadhātuḥ kāyavijñānadhātuḥ, manodhātur dharmadhātur manovijñānadhātus tathatān na vyativartante |	ཁམས་དང༏་རོའི་ཁམས་དང་། ལྕེའི་རྣམ་པར་ཤེས་པའི་ཁམས་དང་། ལུས་ཀྱི་ཁམས་དང་། རེག་བྱའི་ཁམས་དང་། ལུས་ཀྱི་རྣམ་པར་ཤེས་པའི་ཁམས་དང་། ཡིད་ཀྱི་ཁམས་དང་། ཆོས་ཀྱི་ཁམས་དང་། ཡིད་ཀྱི་རྣམ་པར་ཤེས་པའི་ཁམས་ཀྱང་དེ་བཞིན་ཉིད་ལས་མི་འདའོ་༎
 etāvatī ceyaṃ dharmaprajñaptiḥ |	ཆོས་གདགས་པ་ང་ནི༏་འདི་ཙམ་དུ་ཟད་དེ་།
 yaduta skandhadhātvāyatanaprajñaptiḥ |	འདི་ལྟ་སྟེ་། ཕུང་པོ་དང་། ཁམས་དང་། སྐྱེ་མཆེད་དུ་གདགས་པའོ་༎ དེ་བཞིན་གཤེགས་པས་ནི་།
 sā tathāgatena yathāvadabhisaṃbuddhā yathaiva pūrvāt tathā paścāt tathā madhye |	དེ་དག་ཡང་དག་པ་ཇི་ལྟ་བ་བཞིན་དུ་མངོན་པར་རྫོགས་པར་སངས་རྒྱས་ཤིང་ཕྱིན་ཅི་མ་ལོག་པར་མངོན་པར་རྫོགས་པར་སངས་རྒྱས་སོ་༎ དེ་དག་ནི་། སྔོན་ཇི་ལྟ་བ་བཞིན་དུ་ཕྱིས་ཀྱང་དེ་བཞིན་བར་དུའང་དེ་བཞིན་ཏེ་།
 pūrvāntato 'jātāparāntato 'saṃkrāntā madhyo viviktā |	སྔོན་གྱི་མཐར་མ་སྐྱེས་པ་དང་། ཕྱི་མའི་མཐར་མི་འཕོ་བ་དང་། དབུས་སུ་བདེན་པ་ཡིན་ནོ་༎
 evam evaiṣāṃ yathāvatpadaṃ bhavati | yathaikas tathā sarve,	དེ་ལྟར་དེ་དག་ཇི་ལྟ་བ་བཞིན་གྱི་གནས་ཡིན་ཏེ༏་གཅིག་ཇི་ལྟ་བ་བཞིན་དུ་ཐམས་ཅད་དེ་བཞིན་ལ་། 
 yathā sarve tathā caikaḥ |	ཐམས་ཅད་ཇི་ལྟ་བ་བཞིན་དུ་གཅིག་ཀྱང་དེ་བཞིན་ཏེ་།
 na cātra mañjuśrīr ekatvaṃ vā bahutvaṃ copalabhyate || §33 ms| 22b3-7, p| 324b5-325a1, d| 296b6-297a2, t| 357 246c17-23, t| 358 252c8-12, t| 359(W) 261b9-15|	འཇམ་དཔལ་། འདི་ལ་ནི་། གཅིག་པ་ཉིད་དམ༏་མང་པོ་ཉིད་དུ་དམིགས་སུ་མེད་དོ་༎ འཇམ་དཔལ་།
 bodhir mañjuśrīr ākārapraviśenānākārapraviṣṭā |	བྱང་ཆུབ་ནི་། རྣམ་པའི་འཇུག་པས་རྣམ་པ་མེད་པར་ཞུགས་པ་ཡིན་ཏེ་།
 tatra mañjuśrīḥ katama ākāraḥ |	འཇམ་དཔལ་། དེ་ལ་རྣམ་༄༥༡༩བ་པ་ནི༏་གང་།
 katamaś cānākāraḥ |	རྣམ་པ་མེད་པ་ནི་། གང་ཞེ་ན་།
 ākāro mañjuśrīr ucyata ārambhaḥ sarveṣāṃ kuśalānāṃ dharmāṇām |	འཇམ་དཔལ་། རྣམ་པ་ཞེས་བྱ་བ་ནི་། དགེ་བའི་ཆོས་ཐམས་ཅད་ལ་རྩོམ་པའོ་༎ རྣམ་པ་མེད་པ་ཞེས་བྱ་བ་ནི་།
 anākāra ucyate 'nupalambhaḥ sarveṣāṃ dharmāṇām |	ཆོས་ཐམས་ཅད་དམིགས་སུ་མེད་པའོ་༎
 ākāra ucyate 'navasthitasya cittasyāvasthānam |	རྣམ་པ་ཞེས་བྱ་བ་ནི་། སེམས་མི་གནས་པའི་གནས་སྐབས་སོ་༎
 anākāra ucyate (jāa 63)	རྣམ་པ་མེད་པ་ཞེས་བྱ་བ་ནི་།
 'nimittaḥ samādhir vimokṣamukham |	རྣམ་པར་ཐར་པའི་སྒོ་མཚན་མ་མེད་པའི་ཏིང་ངེ་འཛིན་ཏོ་༎ རྣམ་པ་ཞེས་བྱ་བ་ནི་།
 ākāra ucyate cittanātulanāgaṇanāpratyavekṣāvimokṣaḥ sarvadharmāṇām |	ཆོས་ཐམས་ཅད་ལ་སེམས་པ་དང་། འཇལ་བ་དང་། བགྲང་བ་དང་། སོ་སོར་རྟོག་པའོ་༎ རྣམ་པ་མེད་པ་ཞེས་བྱ་བ་ནི་།
 anākāra ucyate tulāsamatikramaḥ |	གཞལ་བ་ལས་ཡང་དག་པར་འདས་པ་སྟེ་།
 katamaś ca tulāsamatikramaḥ |	གཞལ་བ་ལས་ཡང་དག་པར་འདས་པའང་གང་ཞེ་ན་།
 yatra vijñānakarma nāsti |	གང་ལ་རྣམ་པར་ཤེས་པའི་ལས་མེད་པའོ་༎
 ākāra ucyate saṃskṛtapratyavekṣā |	རྣམ་པ་ཞེས་བྱ་བ་ནི་།
 anākāra ucyate 'saṃskṛtapratyavekṣā ||	འདུས་བྱས་ལ་སོ་སོར་རྟོག་པའོ་༎ རྣམ་པ་མེད་པ་ཞེས་བྱ་བ་ནི་། འདུས་མ་བྱས་ལ་སོ་སོར་རྟོག་པའོ་༎ འཇམ་དཔལ་།
 §34 ms| 22b7-23b4, p| 325a1-325b6, d| 297a2-297b5, t| 357 246c23-249a18, t| 358 252c12-26, t| 359(W) 261b16-261c10|	བྱང་ཆུབ་ནི་།
 bodhir mañjuśrīr anāsravo 'nupādānatā |	ཟག་པ་མེད་པ་ཉིད་དང་། ལེན་པ་མེད་པ་ཉིད་ཡིན་ཏེ་།
 tatra mañjuśrīḥ katamo 'nāsravaḥ katamānupādānatā |	འཇམ་དཔལ་། དེ་ལ་ཟག་པ་མེད་པ་ཉིད་གང་། ལེན་པ་མེད་པ་ཉིད་གང་ཞེ་ན་།
 anāsravatā mañjuśrīr ucyate caturṇām āsravānāṃ vigamaḥ |	འཇམ་དཔལ་། ཟག་པ་མེད་པ་ཉིད་ཅེས་བྱ་བ་ནི་། ཟག་པ་བཞི་དང་བྲལ་བ་སྟེ་།
 katameṣāṃ caturṇām,	བཞི་པོ་དེ་དག་ཀྱང་གང་ཞེ་ན་། འདི་ལྟ་སྟེ་།
 yaduta kāmāsravasya, bhavāsravasya, avidyāsravasya,	འདོད་པའི་ཟག་པ་དང་། སྲིད་པའི་ཟག་པ་དང་། མ་རིག་པའི་ཟག་པ་དང་། ལྟ་བའི་ཟག་པ་སྟེ་།
 dṛṣṭvāsravasya ca, eṣāṃ caturṇām āsravāṇām |	ཟག་པ་བཞི་པོ་༄༥༢༠ཨ་༌༎ དེ་དང་བྲལ་བའོ་༎
 anupādānatocyate caturṇām upādānānāṃ vigamaḥ |	ལེན་པ་མེད་པ་ཉིད་ཅེས་བྱ་བ་ནི་། ལེན་པ་བཞི་དང་བྲལ་བ་སྟེ་།
 katameṣāṃ caturṇām | kāmopādānasya,	བཞི་པོ་དེ་དག་ཀྱང་གང་ཞེ་ན་། འདི་ལྟ་སྟེ་།
 dṛṣṭyupādānasya, śīlavrataparāmarśopādānasya, ātmavādopādānasya ca,	འདོད་པའི་ལེན་པ་དང་། ལྟ་བའི་ལེན་པ་དང་། ཚུལ་ཁྲིམས་དང་བརྟུལ་ཞུགས་མཆོག་ཏུ་འཛིན་པའི་ལེན་པ་དང་། བདག་ཏུ་སྨྲ་བའི་ལེན་པ་སྟེ་།
 eṣāṃ caturṇām upādānānām | sarvāṇy avidyayā andhīkṛtāni,	ལེན་པ་བཞི་པོ་དེ་དག་དང་བྲལ་བའོ་༎ འཇམ་དཔལ་། དེ་ལ་སེམས་ཅན་མ་རིག་པས་ལྗོངས་པར་བྱས་པ་།
 tṛṣṇayālālapitāni,	སྲེད་པས་དཀྲུགས་པར་གྱུར་པ་དག་ནི་།
 anyonyābhiniveśyopādīyante |	ཕན་ཚུན་མངོན་པར་ཞེན་པར་གྱུར་ནས་ལེན་པར་བྱེད་ཀྱི་། དེ་བཞིན་གཤེགས་པས་ནི་།
 tatra mañjuśrīs tathāgata ātmavādopādānamūlaparijñātāvī | ātmaviśuddhyā sarvasattvaviśuddhim anugataḥ |	བདག་ཏུ་སྨྲ་བའི་ལེན་པ་རྩ་བ་ཡིན་པར་ཡོངས་སུ་ཤེས་ནས་བདག་རྣམ་པར་དག་པས་སེམས་ཅན་ཐམས་ཅད་རྣམ་པར་དག་པ་རྗེས་སུ་རྟོགས་པར་གྱུར་ཏེ་། 
 yā cātmaviśuddhiḥ sā sarvasattvaviśuddhiḥ | yā sarvasattvaviśuddhir advaidhā advaidhīkārā |	བདག་རྣམ་པར་དག་པ་དང་ཡིན་པ་དང་། སེམས་ཅན་རྣམ་པར་དག་པ་གང་ཡིན་པ་དེ་ནི་། གཉིས་སུ་མེད་དེ་གཉིས་སུ་དབྱེར་མེད་ལ་།
 (jāa 65) yaś cādvayārthaḥ so 'nutpādānirodhaḥ |	གཉིས་སུ་མེད་པའི་དོན་གང་ཡིན་པ་དེ་ནི་། སྐྱེ་བ་མེད་པ་དང་། འགག་པ་མེད་པ་ཡིན་ནོ་༎
 anutpādānirodhe mañjuśrīś cittamanovijñānaṃ na pravartate |	འཇམ་དཔལ་སྐྱེ་བ་མེད་པ་དང་། འགག་པ་མེད་པ་ལ་ནི་། སེམས་དང་། ཡིད་དང་། རྣམ་པར་ཤེས་པ་འཇུག་པར་མི་འགྱུར་ཏེ་། འཇམ་དཔལ་། གང་ལ་སེམས་དང་། ཡིད་དང་། རྣམ་པར་ཤེས་པ་མི་འཇུག་པ་དེ་ལ་ནི་།
 tatra na kaścit parikalpaḥ | yena vikalpo 'yoniśo 'manasi kuryāt |	ཡོངས་སུ་༄༥༢༠བ་རྟོགས་པ་གང་གིས་ཚུལ་བཞིན་མ་ཡིན་པ་ཡིད་ལ་བྱེད་པར་འགྱུར་བའི་ཡོངས་སུ་རྟོག་པ་གང་ཡང་མེད་དོ་༎
 sa yoniśo manaskārapravṛto 'vidyāṃ na samutthāpayati |	ཚུལ་བཞིན་ཡིད་ལ་བྱེད་པ་ལ་རབ་ཏུ་བརྩོན་པ་དེ་ནི་། མ་རིག་པ་ཀུན་ནས་སློང་བ་མི་བྱེད་དོ་༎
 yac cāvidyāyā asamutthānaṃ tad dvādaśānāṃ bhavāṅgānām asamutthānam |	མ་རིག་པ་ཀུན་ནས་ལྡང་བ་མེད་པ་གང་ཡིན་པ་དེ་ནི་། སྲིད་པའི་ཡན་ལག་བཅུ་གཉིས་པོ་དག་གི་ཀུན་ནས་སློང་བ་མེད་པ་ཡིན་ནོ་༎
 yad dvādaśānāṃ bhavāṅgānām asamutthānaṃ sājātiḥ |	སྲིད་པའི་ཡན་ལག་བཅུ་གཉིས་པོ་དག་གི་ཀུན་ནས་ལྡང་བ་མེད་པ་གང་ཡིན་པ་དེ་ནི་། སྐྱེ་བ་མེད་པ་ཡིན་ནོ་༎
 yā cājātiḥ sa niyāmaḥ |	སྐྱེ་བ་མེད་པ་གང་ཡིན་པ་དེ་ནི་། སྐྱོན་མེད་པ་ཡིན་ནོ་༎
 yo niyāmaḥ sa nītārthaḥ |	སྐྱོན་མེད་པ་གང་ཡིན་པ་དེ་ནི་།
 yo nītārthaḥ sa paramārthaḥ |	ངེས་པའི་དོན་ཡིན་ནོ་༎ ངེས་པའི་དོན་གང་ཡིན་པ་དེ་ནི་། དོན་དམ་པ་ཡིན་ནོ་༎
 yaḥ paramārthaḥ sa niḥpudgalārthaḥ |	དོན་དམ་པ་གང་ཡིན་པ་དེ་ནི་། གང་ཟག་མེད་པའི་དོན་ཡིན་ནོ་༎
 yo niḥpudgalārthaḥ so 'nabhilāpyārthaḥ |	གང་ཟག་མེད་པའི་དོན་གང་ཡིན་པ་དེ་ནི་།
 yaś cānabhilāpyārthaḥ sa pratītyasamutpādārthaḥ |	བརྗོད་དུ་མེད་པའི་དོན་ཡིན་ནོ་༎ བརྗོད་དུ་མེད་པའི་དོན་གང་ཡིན་པ་དེ་ནི་། རྟེན་ཅིང་འབྲེལ་པར་འབྱུང་བའི་དོན་ཡིན་ནོ་༎
 yaḥ pratītyasamutpādārthaḥ sa dharmārthaḥ |	རྟེན་ཅིང་འབྲེལ་བར་འབྱུང་བའི་དོན་གང་ཡིན་པ་དེ་ནི་། ཆོས་ཀྱི་དོན་ན་ཡིན་ནོ་༎
 yo dharmārthaḥ sa tathāgatārthaḥ |	ཆོས་ཀྱི་དོན་གང་ཡིན་པ་དེ་ནི་། དེ་བཞིན་གཤེགས་པའི་དོན་ཡིན་ཏེ་།
 tenocyate | yaḥ pratītyasamutpādaṃ paśyati sa dharmaṃ paśyati |	དེའི་ཕྱིར་གང་གིས་རྟེན་ཅིང་འབྲེལ་པར་འབྱུང་བ་མཐོང་བ་དེས་ཆོས་མཐོང་ངོ་༎
 yo dharmaṃ paśyati sa tathāgataṃ paśyati |	གང་གིས་ཆོས་མཐོང་བ་དེས་དེ་བཞིན་གཤེགས་པ་མཐོང་ངོ་༎ ཞེས་གསུངས་ཏེ་།
 tathā ca paśyati yathā parigaveṣyamāṇo na kiṃcit paśyati |	ཇི་ལྟར་ཡོངས་སུ་ཚོལ་བ་ན་ཅིའང་མི་མཐོང་བ་དེ་ལྟར་༄༥༢༡ཨ་༌༎ མཐོང་ངོ་༎
 tatra mañjuśrīḥ katamat kiṃcit |	འཇམ་དཔལ་། དེ་ལ་ཅིའང་ཞེས་བྱ་བ་གང་ཞེ་ན་།
 yaduta cittam ārambaṇaṃ ca |	འདི་ལྟ་སྟེ་། སེམས་ཅང་དམིགས་པ་སྟེ་།
 sa yadā na cittam, na cārambaṇaṃ paśyati tadā bhūtam paśyati |	དེས་གང་གི་ཚེ་སེམས་དང་དམིགས་པ་ཡང་དག་པར་རྗེས་སུ་མ་མཐོང་བ་དེའི་ཚེ་ན་ཡང་དག་པར་མཐོང་བ་ཡིན་པས་།
 evam ete dharmās tathāgatena saṃbuddhāḥ samatayā samāḥ ||	དེ་བཞིན་གཤེགས་པས་ནི་། ཆོས་དེ་དག་དེ་ལྟར་མཉམ་པ་ཉིད་ཀྱིས་མཉམ་པར་མངོན་པར་རྫོགས་པར་སངས་རྒྱས་སོ་༎ འཇམ་དཔལ་།
 §35 ms| 23b4-24a6, p| 325b6-3261, d| 297b5-298a7, t| 357 247a1-8, t| 358 252c26-253a17, t| 359(W) 261c11-262a5|	བྱང་ཆུབ་ནི་།
 bodhir mañjuśrīḥ śuddhā vimalā anaṅgaṇāḥ |	དག་པ་དང་། དྲི་མ་མེད་པ་དག་། ཉོན་མོངས་པ་མེད་པ་ཡིན་ཏེ་།
 tatra mañjuśrīḥ katamā śuddhiḥ,	འཇམ་དཔལ་། དེ་ལ་དག་པ་ནི༏་གང་།
 katamad vimalam,	དྲི་མ་མེད་པ་ནི་། གང་། ཉོན་མོངས་པ་ནི་།
 katamad anaṅgaṇam |	གང་ཞེ་ན་།
 śūnyatā mañjuśrīḥ śuddhiḥ,	འཇམ་དཔལ་། སྟོན་པ་ཉིད་ནི་། དག་པའོ་༎
 ānimittaṃ vimalam, (jāa 66)	མཚན་མ་མེད་པ་ནི་། དྲི་མ་མེད་པའོ་༎
 apraṇihitam anaṅgaṇam |	སྨོན་པ་མེད་པ་ནི་། ཉོན་མོངས་པ་མེད་པའོ་༎
 ajātiḥ śuddhiḥ,	སྐྱེ་བ་མེད་པའོ་༎ དག་པའོ་༎
 anabhisaṃskāro vimalam,	མངོན་པར་འདུ་བྱ་བ་མེད་པ་ནི་། དྲི་མ་མེད་པའོ་༎
 anutpādo 'naṅgaṇam |	འབྱུང་བ་མེད་པ་ནི་།
 prakṛtir viśuddhiḥ,	ཉོན་མོངས་པ་མེད་པའོ༏་༏རང་བཞིན་ནོ་།
 pariśuddhir vimalam,	དག་པའོ་༎ ཡོངས་སུ་དག་པ་ནི་། དྲི་མ་མེད་པའོ་༎
 prabhāsvaratānaṅgaṇam |	འོད་གསལ་བ་ནི་། ཉོན་མོངས་པ་མེད་པའོ་༎
 aprapañcaḥ śuddhiḥ,	སྤྲོས་པ་མེད་པ་ནི་། དག་པའོ་༎
 niṣprapañco vimalam,	སྤྲོས་པ་དང་བྲལ་བ་ནི་། དྲི་མ་མེད་པའོ་༎
 prapañcavyupaśamo 'naṅgaṇam |	སྤྲོས་པ་ཉེ་བར་ཞི་བ་ནི་། ཉོན་མོངས་པ་མེད་པའོ་༎
 tathatā viśuddhiḥ,	དེ་བཞིན་ཉིད་ནི་། དག་པའོ་༎
 dharmadhātur vimalam,	ཆོས་ཀྱི་དབྱིངས་ནི་། དྲི་མ་མེད་པའོ་༎
 bhūtakoṭir anaṅgaṇam |	ཡང་དག་༄༥༢༡བ་པའི་མཐའ་ནི་། ཉོན་མོངས་པ་མེད་པའོ་༎
 ākāśaṃ śuddhiḥ,	ནམ་མཁའ་ནི་། དག་པའོ་༎ བར་སྣང་ནི་།
 gaganaṃ vimalam,	དྲི་མ་མེད་པའོ་༎ ནམ་མཁའ་ནི་།
 kham anaṅgaṇam |	ཉོན་མོངས་པ་མེད་པའོ་༎
 adhyātmaḥ pariśuddhiḥ,	ནང་ཡོངས་སུ་ཤེས་པ་ནི༏་དག་པའོ་༎
 bahirdhāpracāro vimalam,	ཕྱི་རོལ་ཏུ་རྒྱུ་བ་མེད་པ་ནི་། དྲི་མ་མེད་པའོ་༎
 adhyātmabahirdhā cānupalabdhir anaṅgaṇam |	ཕྱི་ནང་དམིགས་སུ་མེད་པ་ནི་། ཉོན་མོངས་པ་མེད་པའོ་༎
 skandhaparijñā śuddhiḥ,	ཕུང་པོ་ཡོངས་སུ་ཤེས་པ་ནི་། དག་པའོ་༎ ཁམས་རང་བཞིན་མེད་པ་ནི་།
 dhātusvabhāvo vimalam,	དྲི་མ་མེད་པའོ་༎
 āyatanānām apakarṣo 'naṅgaṇam |	སྐྱེ་མཆོད་རྣམས་སྤོང་བ་ནི་། ཉོན་མོངས་པ་མེད་པའོ་༎
 atīte kṣayajñānaṃ śuddhiḥ,	འདས་པ་ལ་ཟད་པར་ཤེས་པ་ནི་། དག་པའོ་༎
 anāgate 'nutpādajñānaṃ vimalam,	མ་འོངས་པ་ལ་མི་སྐྱེ་བར་ཤེས་པ་ནི་། དྲི་མ་མེད་པའོ་༎
 pratyutpanne dharmadhātusthitijñānam anaṅgaṇam |	ད་ལྟར་བྱུང་བ་ལ་ཆོས་གནས་པར་ཤེས་པ་ནི་། ཉོན་མོངས་པ་མེད་པའོ་༎
 iti hi mañjuśrīḥ śuddhir vimalam anaṅgaṇam ity ekapadesmin samavasaranti |	འཇམ་དཔལ་། དེ་ལྟར་དག་པ་དང་། དྲི་མ་མེད་པ་དང་། ཉོན་མོངས་པ་མེད་པ་ནི་། གནས་གཅིག་ཏུ་ཡང་དག་པར་འདུ་སྟེ་།
 yaduta śāntapade |	འདི་ལྟ་སྟེ་། ཞི་བའི་གནས་སུའོ་༎
 yac chāntaṃ tat praśāntam |	ཞི་བ་གང་ཡིན་པ་དེ་ནི་། རབ་ཏུ་ཞི་བ་ཡིན་ནོ་༎
 yat praśāntaṃ tad upaśāntam |	རབ་ཏུ་ཞི་བ་གང་ཡིན་པ་དེ་ནི་།
 yad upaśāntaṃ sa upaśamaḥ |	ཉེ་བར་ཞི་བ་ཡིན་ནོ་༎ ཉེ་བར་ཞི་བ་གང་ཡིན་པ་དེ་ནི་། ཉེ་བར་ཞི་བར་གྱུར་བ་ཡིན་ནོ་༎
 yaś copaśamaḥ sa munir ity ucyate |	ཉེ་བར་ཞི་བར་གྱུར་པ་གང་ཡིན་པ་དེ་ནི་། ཐུབ་པ་ཞེས་བྱའོ་༎
 iti hi mañjuśrīr yathākāśaṃ tathā bodhiḥ |	འཇམ་དཔལ་། དེ་ལྟར་ན་། ནམ་མཁའ་ཇི་ལྟ་བར་བྱང་ཆུབ་ཀྱང་དེ་བཞིན་ནོ་༎
 yathā bodhis tathā dharmāḥ |	བྱང་ཆུབ་ཇི་ལྟ་བར་ཆོས་རྣམས་ཀྱང་དེ་བཞིན་ནོ་།
 yathā dharmās tathā sattvāḥ |	ཆོས་རྣམས་ཇི་ལྟ་བར་སེམས་ཅན་རྣམས་ཀྱང་དེ་བཞིན་ནོ་༎
 yathā sattvās tathā kṣetrāṇi |	སེམས་ཅན་རྣམས་ཇི་ལྟ་༄༥༢༢ཨ་༌༎ བར་ཞིང་རྣམས་ཀྱང་དེ་བཞིན་ནོ་༎
 yathā kṣetrāṇi tathā nirvāṇam |	ཞིང་རྣམས་ཇི་ལྟ་བར་མྱ་ངན་ལས་འདས་པའང་དེ་བཞིན་ནོ་༎
 tenocyate mañjuśrīr nirvāṇasamāḥ sarvadharmāḥ |	འཇམ་དཔལ་། དེའི་ཕྱིར་ཆོས་ཐམས་ཅད་ནི་མྱ་ངན་ལས་འདས་པ་དང་མཉམ་པ་ཞེས་བྱ་སྟེ་།
 niṣṭhāparyantakāraṇe 'pratipakṣaḥ |	མཐར་ཐུག་པར་གྱུར་བའི་ཕྱིར་གཉེན་པོ་མེད་པ་ཡིན་ལ་།
 niḥpratipakṣakāraṇenādiśuddhāḥ, ādivimalāḥ, ādyanaṅgaṇāḥ |	གཉེན་པོ་མེད་པའི་ཕྱིར་གཟོད་མ་ནས་དག་པ་དང་། གཟོད་མ་ནས་དྲི་མ་མེད་པ་དང་། གཟོད་མ་ནས་ཉོན་མོངས་པ་མེད་པ་ཡིན་ནོ་༎
 tatra mañjuśrīs tathāgatasyaivaṃrūpān sarvadharmān abhisaṃbuddhasya sattvānāṃ (jāa 67) ca dhātuṃ vyavalokayataḥ,	འཇམ་དཔལ་། དེ་ལ་དེ་བཞིན་གཤེགས་པ་ཆོས་ཐམས་ཅད་མངོན་པར་རྫོགས་པར་སངས་རྒྱས་པ་སེམས་ཅན་རྣམས་ཀྱི་ཁམས་ལ་གཟིགས་པ་ནི་། སེམས་ཅན་རྣམས་ལ་དག་པ་། དྲི་མ་མེད་པ་།
 śuddhā vimalā anaṅgaṇā vikrīḍitā nāma sattveṣu mahākaruṇāḥ pravartate || §36 ms| 24a6-25a6, p| 326b1-327b1, d| 298a7-299a6, t| 357 247b11-247c12, t| 358 253a17-253b1, t| 359(W) 262a6-262b5|	ཉོན་མོངས་པ་མེད་པས་རྣམ་པ་རོལ་པ་ཞེས་བྱ་བའི་ཐུགས་རྗེ་ཆེན་པོ་སྐྱེ་བར་འགྱུར་རོ་༎ འཇམ་དཔལ་།
 kathaṃ mañjuśrīr bodhisattvaś carati bodhisattvacaryāyām |	ཇི་ལྟར་ན་། བྱང་ཆུབ་སེམས་དཔའ་བྱང་ཆུབ་སེམས་དཔའི་སྤྱད་པ་སྤྱོད་པ་ཡིན་ཞེ་ན་། འཇམ་དཔལ་།
 yadā mañjuśrīr bodhisattvo na kṣayāya notpādāya nākṣayāya nānutpādāya nānyatkṣīṇakṣayāya ca manyate,	གང་གི་ཚེ་བྱང་ཆུབ་སེམས་དཔའ་ཟད་པའི་ཕྱིར་རློམ་སེམས་སུ་མི་བྱེད་ཅིང་མི་ཟད་པའི་ཕྱིར་ཡང་མ་ཡིན་། སྐྱེ་བའི་ཕྱིར་ཡང་མ་ཡིན་། མི་སྐྱེ་བའི་ཕྱིར་ཡང་མ་ཡིན་། གཏན་ཟད་པ་ཟད་པར་བྱ་བའི་ཕྱིར་ཡང་མ་ཡིན་།
 atyantānutpādaṃ ca na vikopayati |	གཏན་མི་སྐྱེ་བ་རྣམ་པར་འཁྲུགས་པར་ཡང་མི་བྱེད་པ་དེ་ལྟར་སྤྱོད་ན་།
 evaṃ ca mañjuśrīś carati bodhisattvacaryāyām |	འཇམ་དཔལ་། བྱང་ཆུབ་སེམས་དཔའ་བྱང་ཆུབ་སེམས་དཔའི་སྤྱད་པ་ལ་སྤྱོད་པ་ཡིན་ནོ་༎
 punar aparaṃ mañjuśrīr bodhisattvo 'tītaṃ cittaṃ kṣīṇam iti na carati |	འཇམ་༄༥༢༢བ་དཔལ༏་གཞན་ཡང་བྱང་ཆུབ་སེམས་དཔའ་འདས་པའི་སེམས་ལ་ཟད་པ་ཞེས་བྱ་བར་མི་སྤྱོད་། མ་འོངས་པའི་སེམས་ལ་མ་ཐོབ་པ་ཞེས་བྱ་བར་མི་སྤྱོད་།
 anāgataṃ cittam asaṃprāptam iti na carati | pratyutpannaṃ cittaṃ sthitam iti na carati | na cātītānāgatapratyutpanneṣu citteṣu sajati |	ད་ལྟར་བྱུང་བའི་སེམས་ལ་ཡོད་ཅེས་བྱ་བར་མི་སྤྱོད་ཅིང་འདས་པ་དང་། མ་འོངས་པ་དང་། ད་ལྟར་བྱུང་བའི་སེམས་ལ་ཆགས་པར་མི་འགྱུར་བ་དེ་ལྟར་སྤྱོད་ན་།
 evaṃ caran mañjuśrīr bodhisattvaś carati bodhisattvacaryāyām |	འཇམ་དཔལ་། བྱང་ཆུབ་སེམས་དཔའ་བྱང་ཆུབ་སེམས་དཔའི་སྤྱོད་པ་སྤྱོད་པ་ཡིན་ནོ་༎ འཇམ་དཔལ་།
 dānaṃ mañjuśrīr bodhiḥ sattvāś ca tathāgataś cādvayam etad advaidhīkāram |	གཞན་ཡང་བྱང་ཆུབ་སེམས་དཔའ་སྦྱིན་པ་དང་། བྱང་ཆུབ་དང་། སེམས་ཅན་རྣམས་དང་། དེ་བཞིན་གཤེགས་པ་དེ་ལ་གཉིས་སུ་མེད་དེ་གཉིས་སུ་བྱར་མེད་པ་དེ་ལྟར་སྤྱོད་ན་།
 evaṃ caran bodhisattvaś carati bodhisattvacaryāyām |	བྱང་ཆུབ་སེམས་དཔའི་སྤྱད་པ་སྤྱོད་པ་ཡིན་ནོ་༎ འཇམ་དཔལ་།
 śīlaṃ mañjuśrīr bodhiḥ sattvāś ca tathāgataś cādvayam etad advaidhīkāram | evaṃ caran bodhisattvaś carati bodhisattvacaryāyām | evaṃ kṣāntir bodhiḥ sattvāś ca tathāgataś ca, vīryaṃ bodhiḥ sattvāś ca tathāgataś ca, (jāa 68) dhyānaṃ bodhiḥ sattvāś ca tathāgataś ca,	དེ་བཞིན་དུ་བྱང་ཆུབ་སེམས་དཔའ་ཚུལ་ཁྲིམས་དང་། བྱང་ཆུབ་དང་། སེམས་ཅན་རྣམས་དང་། དེ་བཞིན་གཤེགས་པ་དེ་ལ་གཉིས་སུ་མེད་དེ་གཉིས་སུ་བྱར་མེད་པ་དེ་ལྟར་སྤྱོད་ན༏་བྱང་ཆུབ་སེམས་དཔའི་སྤྱད་པ་སྤྱོད་པ་ཡིན་ནོ་༎
 evaṃ prajñā bodhis tathāgataś ca sattvāś cādvayam etad advaidhīkāram |	འཇམ་དཔལ་། དེ་བཞིན་དུ་བྱང་ཆུབ་སེམས་དཔའ་བཟོད་པ་དང་། བྱང་ཆུབ་དང་། སེམས་ཅན་རྣམས་དང་། དེ་བཞིན་གཤེགས་པ་དང་། བརྩོན་འགྲུས་དང་། བྱང་ཆུབ་དང་། སེམས་ཅན་རྣམས་དང་། དེ་བཞིན་གཤེགས་པ་དང་། བསམ་གཏན་དང་། བྱང་ཆུབ་དང་། ༄༥༢༣ཨ་༌༎ སེམས་ཅན་རྣམས་དང་། དེ་བཞིན་གཤེགས་པ་དང་། དེ་བཞིན་དུ་ཤེས་རབ་དང་། བྱང་ཆུབ་དང་། སེམས་ཅན་རྣམས་དང་། དེ་བཞིན་གཤེགས་པ་དེ་ལ་གཉིས་སུ་མེད་དེ་གཉིས་སུ་དབྱེར་མེད་པ་དེ་ལྟར་སྤྱོད་ན་།
 evaṃ caran mañjuśrīr bodhisattvaś carati bodhisattvacaryāyām |	བྱང་ཆུབ་སེམས་དཔའི་སྤྱོད་པ་ལ་སྤྱོད་པའི་ཡིན་ནོ་༎
 sacen mañjuśrīr bodhisattvo na rūpaṃ śūnyam iti carati nāśūnyam iti |	འཇམ་དཔལ་། གལ་ཏེ་བྱང་ཆུབ་སེམས་དཔའ་གཟུགས་སྟོང་ཞེས་བྱ་བར་མི་སྤྱོད་། མི་སྟོང་ཞེས་བྱ་བར་མི་སྤྱོད་པ་དེ་ལྟར་སྤྱོད་ན་།
 evaṃ caran mañjuśrīr bodhisattvaś carati bodhisattvacaryāyām |	འཇམ་དཔལ་། བྱང་ཆུབ་སེམས་དཔའ་བྱང་ཆུབ་སེམས་དཔའི་སྤྱད་པ་ལ་སྤྱོད་པ་ཡིན་ནོ་༎
 tat kasmād dhetoḥ |	དེ་ཅིའི་ཕྱིར་ཞེ་ན་། འཇམ་དཔལ་།
 rūpam eva śūnyaṃ rūpasvabhāvena |	གཟུགས་ནི་། གཟུགས་ཀྱི་ངོ་བོ་ཉིད་ཀྱི་སྟོང་པའི་ཕྱིར་རོ་༎ འཇམ་དཔལ་།
 evaṃ vedanāsaṃjñāsaṃskāravijñānaṃ śūnyam iti carati nāśūnyam iti | evaṃ caran mañjuśrīr bodhisattvaś carati bodhisattvacaryāyām |	དེ་བཞིན་དུ་གལ་ཏེ་བྱང་ཆུབ་སེམས་དཔའ་ཚོར་བ་དང་། འདུ་ཤེས་དང་། འདུ་བྱེད་རྣམས་དང་། རྣམ་པར་ཤེས་པ་སྟོང་ཞེས་བྱ་བར་མི་སྤྱོད་། མི་སྟོང་ཞེས་བྱ་བར་མི་སྤྱོད་པ་དེ་ལྟར་སྤྱོད་ན༏་བྱང་ཆུབ་སེམས་དཔའ་བྱང་ཆུབ་སེམས་དཔའི་སྤྱོད་པ་ལ་སྤྱོད་པ་ཡིན་ནོ་༎
 tat kasmād dhetoḥ |	དེ་ཅིའི་ཕྱིར་ཞེ་ན་། འཇམ་དཔལ་།
 cittamanovijñānānupalabdhitvāt | sa na kaścin mañjuśrīr dharmo vidyate,	སེམས་དང་། ཡིད་དང་། རྣམ་པར་ཤེས་པ་དམིགས་སུ་མེད་པའི་ཕྱིར་གང་ཡོངས་སུ་ཤེས་པའམ་།
 yasya parijñānaṃ vā prahāṇaṃ vā bhāvanā vā sākṣātkriyā vā bhavet |	སྦང་བའམ་། བསྒོམ་པའམ་། མངོན་སུམ་དུ་བྱ་བའི་ཆོས་དེ་དག་གང་ཡང་ཡོད་པ་མ་ཡིན་པའི་ཕྱིར་རོ་༎
 yo sā mañjuśrīr budhyate |	འཇམ་༄༥༢༣བ་དཔལ༏་ཟད་པ་ཞེས་བྱ་བ་གང་ཡིན་པ་དེ་ནི་།
 kṣaya ity antakṣaya evāsau,	གཏན་ཟད་པ་ཁོ་ན་ཡིན་ནོ་༎
 yaś cātyantatatkṣīṇo na sa kṣapayitavyaḥ |	གཏན་ཟད་པ་གང་ཡིན་པ་དེ་ནི་། ཟད་པར་བྱ་བ་མ་ཡིན་ནོ་༎
 akṣeyakṣīyatvād akṣayaḥ |	ཟད་པ་བྱ་བ་མ་ཡིན་པའི་ཕྱིར་མི་ཟད་པ་ཡིན་ནོ་༎
 tat kasmād dhetoḥ |	དེ་ཅིའི་ཕྱིར་ཞེ་ན་། འཇམ་དཔལ་། དེ་ནི་།
 yathā ca kṣayaḥ saḥ |	ཇི་ལྟ་བ་བཞིན་དུ་ཟད་པ་ཡིན་ལ་།
 yaś ca yathāvat kṣayaḥ sa na kasyacit kṣayaḥ |	ཇི་ལྟ་བ་བཞིན་དུ་ཟད་པ་གང་ཡིན་པ་དེ་ལ་ནི་། ཟད་པ་ཅུང་ཟད་ཀྱང་མེད་ལ་།
 yasya na kasyacit kṣayas tad asaṃskṛtam |	གང་ལ་ཟད་པ་ཅུང་ཟད་ཀྱང་མེད་པ་དེ་ནི་། འདུས་མ་བྱས་པ་སྟེ་།
 yad asaṃskṛtaṃ tatra notpādo na nirodhaḥ | tenocyate |	འདུས་མ་བྱས་པ་གང་ཡིན་པ་དེ་ལ་ནི་། སྐྱེ་བའང་མེད་། འགག་པའང་མེད་པའི་ཕྱིར་རོ་༎
 utpādād vā tathāgatānām anutpādād vā sthitaivaiṣā dharmatā dharmasthititā dharmadhātuḥ |	དེའི་ཕྱིར་དེ་བཞིན་གཤེགས་པ་རྣམས་བྱུང་ཡང་རུང་། མ་བྱུང་ཡང་རུང་ཆོས་ཉིད་དང་། ཆོས་གནས་པ་ཉིད་དང་། ཆོས་ཀྱི་དབྱིངས་འདི་ནི་། གནས་པ་ཁོ་ན་ཞེས་བྱ་སྟེ་།
 yathā dharmadhātusthitis tathāgatajñānaṃ na pravṛttaṃ na nivṛttam |	ཇི་ལྟར་ཆོས་ཀྱི་དབྱིངས་ལ་གནས་པ་དེ་བཞིན་དུ་ཤེས་པ་དེའང་འཇུག་པར་མི་བྱེད་། ལྡོག་པར་མི་བྱེད་དོ་༎ ཇི་ལྟར་ཤེས་པ་དེ་འཇུག་པར་མི་བྱེད་།
 īdṛśena dharmanayapraveśena āsravā notpadyante na nirudhyante |	ལྡོག་པར་མི་བྱེད་པ་དེ་ལྟ་བུའི་ཆོས་ཀྱི་ཚུལ་ལ་འཇུག་པས་ཟག་པ་སྐྱེད་པར་མི་བྱེད་། འགག་པར་མི་བྱེད་དོ་༎
 āsravakṣaya iti mañjuśrīr vyavahārarutākṣarasaṃketaprajñaptir eṣā nātra kaścid dharma utpadyate vā nirudhyate vā || (jāa 69) iv	འཇམ་དཔལ་། ཟག་པ་ཟད་པ་ཞེས་བྱ་བ་དེ་ནི་། ཐ་སྙད་དང་། སྒྲ་དང་། ཡི་གེ་དང་། བརྡར་གདགས་པ་ཡིན་ཏེ་།
 §37 ms| 25a6-27a2, p| 327b1-329a6, d| 299a6-300b7,	འདི་ལ་ནི་། སྐྱེ་བའམ་། འགག་པར་འགྱུར་བའི་ཆོས་གང་ཡང་མེད་དོ་༎
 t| 357 247c12-248a6, t| 358 ö, t| 359(W) 262b6-263b2| atha khalu mañjuśrīḥ kumārabhūta utthāyāsanād ekāṃsam uttarāsaṃgaṃ kṛtvā dakṣiṇaṃ	དེ་ནས་འཇམ་དཔལ་གཞོན་ནུར་གྱུར་བ་སྟན་ལས་ལངས་ཏེ་བླ་གོས་ཕྲག་པ་གཅིག་༄༥༢༤ཨ་༌༎
 jānumaṇḍalaṃ pṛthivyāṃ pratiṣṭhāpya yena bhagavāṃs tenāñjaliṃ praṇamya gāthābhir bhagavatam abhyaṣṭāvīt |	ཏུ་གཟར་ནས་པུས་མོ་ག-ཡས་པའི་ལྷ་ངས་ལ་བཙུགས་ཏེ་བཅོམ་ལྡན་འདས་ག་ལ་བ་དེ་ལོགས་སུ་ཐལ་མོ་སྦྱར་བ་བཏུད་ནས་བཅོམ་ལྡན་འདས་ལ་ཚིགས་སུ་བཅད་པ་འདི་དག་གིས་མངོན་པར་བསྟོད་དོ་༎ 
 avarṇaliṅgasaṃsthāna anirodha asaṃbhava |	ཁ་དོག་རྟགས་དང་དབྱིབས་མི་མངའ༎ རྩ་བ་མི་མངའ་གནས་མི་མངའ༎ མི་འགག་འབྱུང་བ་མི་མངའ་བ་༎
 amūla apratiṣṭhāna nirālamba namo 'stu te || 1 ||	མི་རྟེན་ཁྱོད་ལ་ཕྱག་འཚལ་ལོ་༎
 apratiṣṭha anāyūha aniyūhānavasthita |	མི་གནས་གནས་པ་མི་མངའ་བ་༎ བླང་བ་མི་མངའ་དོར་མི་མངའ༎
 ṣaḍāyatanavinirmukta nirālamba namo 'stu te || 2 ||	སྐྱེ་མཆེད་དྲུག་ལས་རྣམ་གྲོལ་བ་༎ མི་རྟེན་ཁྱོད་ལ་ཕྱག་འཚལ་ལོ་༎
 asthita sarvadharmeṣu bhāvābhāvavivarjita |	ཆོས་རྣམས་ཀུན་ལ་མི་གནས་ཤིང་༎ དངོས་དང་དངོས་མེད་རྣམ་པར་སྤངས་༎
 saṃskārasamatāprāpta nirālamba namo 'stu te || 3 ||	འདུ་བྱེད་མཉམ་པ་ཉིད་བརྙེས་པ་༎ མི་རྟེན་ཁྱོད་ལ་ཕྱག་འཚལ་ལོ་༎
 traidhātukavinirmukta ākāśasamatāṃ gataḥ |	ཁམས་གསུམ་དག་ལས་རྣམ་པར་གྲོལ་༎ མཁའ་ལྟར་མཉམ་ཉིད་ཐུགས་སུ་ཚུད་༎
 nopalepyasi kāmeṣu nirālamba namo 'stu te || 4 || (jāa 70)	འདོད་པ་རྣམས་ཀྱིས་མི་གོས་པ་༎ མི་རྟེན་ཁྱོད་ལ་ཕྱག་འཚལ་ལོ་༎
 sadā samāhitaś cāsi gacchaṃs tiṣṭhaṃ śayann api |	གཤེགས་དང་བཞུགས་དང་གཟིམས་པ་ཡི་༎
 īryāpatheṣu sarveṣu nirālamba namo 'stu te || 5 ||	སྤྱོད་ལམ་རྣམ་པ་ཐམས་ཅད་དུ་༎ རྟག་ཏུ་མཉམ་པར་བཞག་མཛད་པ་༎ མི་རྟེན་ཁྱོད་ལ་ཕྱག་འཚལ་ལོ་༎ མཉམ་པར་བྱོན་ཅིང་མཉམ་པར་གཤེགས་༎
 samaṃ kṣeṣi samaṃ yāsi samatāyāṃ pratiṣṭhitaḥ |	མཉམ་པ་ཉིད་ལ་གནས་པ་པོ་༎
 samatāṃ na vikopesi nirālamba namo 'stu te || 6 ||	མཉམ་ཞིང་འཁྲུགས་པར་མི་མཛད་པ་༎ མི་རྟེན་ཁྱོད་ལ་ཕྱག་འཚལ་ལོ་༎ མཉམ་པ་ཉིད་ལ་ཞུགས་གྱུར་ཅིང་༎
 samatāṃ ca samāpannaḥ sarvadharmasamāhitaḥ |	ཆོས་རྣམས་ཀུན་ལ་༄༥༢༤བ་མཉམ་པར་བཞག་།
 ānimittasamāpanna nirālamba namo 'stu te || 7 ||	མཚན་མ་མེད་ལ་ཞུགས་གྱུར་པ་༎ མི་རྟེན་ཁྱོད་ལ་ཕྱག་འཚལ་ལོ་༎
 apratiṣṭhita nirālamba prajñākūṭasamāhita |	མི་གནས་དམིགས་པ་མི་མངའ་བ་༎ ཤེས་རབ་བསགས་ཤིང་མཉམ་པར་བཞག་།
 dharmaiśvaryam anuprāpta nirālamba namo 'stu te || 8 ||	ཆོས་ལ་མངའ་དབང་བརྙེས་གྱུར་པ་༎ མི་རྟེན་ཁྱོད་ལ་ཕྱག་འཚལ་ལོ་༎
 sarvasattvāna ye rūpā rutaghoṣās tathairyatāḥ |	སེམས་ཅན་ཀུན་གྱི་སྒྲ་སྐད་དང་། དེ་བཞིན་གཟུགས་དང་སྤྱོད་ལམ་དག་།
 ekakṣaṇena deśeṣi nirālamba namo 'stu te || 9 ||	སྐད་ཅིག་གཅིག་གིས་གཟིགས་མཛད་པ་༎ མི་རྟེན་ཁྱོད་ལ་ཕྱག་འཚལ་ལོ་༎
 nāmarūpavinirmukta skandhahetusamucchidaḥ |	མིང་དང་གཟུགས་ལས་རྣམ་པར་གྲོལ་༎ རྒྱུད་དང་ཕུང་པོ་ཐམས་ཅད་བཅད་༎
 anākārapraveśo 'si nirālamba namo 'stu te || 10 ||	རྣམ་པ་མེད་ལ་འཇུག་མཛད་པ་༎ མི་རྟེན་ཁྱོད་ལ་ཕྱག་འཚལ་ལོ་༎
 nimittāpagataś cāsi nimittakāravarjitaḥ |	མཚན་མ་དག་དང་རྣམ་བྲལ་ཞིང་༎ མཚན་མའི་རྣམ་པ་རྣམ་པར་སྤངས་༎
 ānimittapraveśo 'si nirālamba namo 'stu te || 11 || (jāa 71)	མཚན་མ་མེད་ལ་འཇུག་མཛད་པ་༎ མི་རྟེན་ཁྱོད་ལ་ཕྱག་འཚལ་ལོ་༎
 avikalpitasaṃkalpa apratiṣṭhitamānasa |	ཡང་དག་རྟོག་པས་རྣམ་མ་བརྟགས་ཐུགས་ཡིད་རབ་ཏུ་མི་གནས་ཤིང་༎
 asmṛty amanasīkāra nirālamba namo 'stu te || 12 ||	ཡིད་མཛད་མི་མངའ་མི་དགོངས་པ་༎ མི་རྟེན་ཁྱོད་ལ་ཕྱག་འཚལ་ལོ་༎ ནམ་མཁའ་འདྲ་བར་གནས་མི་མངའ༎
 anālayaṃ yathākāśaṃ niḥprapañcaṃ nirañjanam |	ཐོགས་པ་མི་མངའ་སྤྲོས་མི་མངའ༏་༏ནམ་མཁའ་མཉམ་པའི་ཐུགས་མངའ་བ་༎
 ākāśasamacitto 'si nirālamba namo 'stu te || 13 ||	མི་རྟེན་ཁྱོད་ལ་ཕྱག་འཚལ་ལོ་༎
 anantamadhyam ākāśaṃ buddhānāṃ caiva dharmatā |	ནམ་མཁའ་དབུས་མཐའ་མ་མཆིས་པ་༎ སངས་རྒྱས་ཆོས་ཉིད་དེ་དང་འདྲ་༎
 tryadhvasamatikrānta nirālamba namo 'stu te || 14 ||	དུས་གསུམ་ཡང་དག་འདུས་གྱུར་པ་༎ མི་རྟེན་ཁྱོད་ལ་ཕྱག་འཚལ་ལོ་༎
 ākāśalakṣaṇā buddhā ākāśaṃ cāpy alakṣaṇam |	ནམ་མཁའི་མཚན་ཉིད་སངས་རྒྱས་ཏེ་༎ ནམ་མཁའང་མཚན་ཉིད་མཆིས་མ་ལགས་༎
 kāryakāraṇanirmukta nirālamba namo 'stu te || 15 ||	རྒྱུ་དང་འབྲས་༄༥༢༥ཨ་༌༎ བུ་རྣམ་གྲོལ་ལ་༎ མི་རྟེན་ཁྱོད་ལ་ཕྱག་འཚལ་ལོ་༎ ངར་འཛིན་མི་མངའ་སྒྲ་མི་མངའ༎
 dakacandravad agrāhya sarvadharmeṣv aniśritaḥ |	གཟུང་བ་མ་མཆིས་ཆུ་ཟླ་འདྲ་༎ ཆོས་རྣམས་ཀུན་ལ་མི་གནས་པ་༎
 anahaṃkāra anirghoṣa nirālamba namo 'stu te || 16 ||	མི་རྟེན་ཁྱོད་ལ་ཕྱག་འཚལ་ལོ་༎
 aniśrito 'si skandheṣu dhātuṣv āyataneṣu ca |	ཕུང་པོ་རྣམས་དང་སྐྱེ་མཆེད་དང་། ཁམས་རྣམས་དག་ལ་མིག་ནས་པ་༎
 viparyāsavinirmukta nirālamba namo 'stu te || 17 || (jāa 72)	ཕྱིན་ཅི་ལོག་ལས་རྣམ་པར་གྲོལ་༎ མི་རྟེན་ཁྱོད་ལ་ཕྱག་འཚལ་ལོ་༎
 antadvayavinirmukta ātmadṛṣṭisamucchidaḥ |	མཐའ་གཉིས་དག་ལས་རྣམ་གྲོལ་ཞིང་། བདག་ཏུ་ལྟ་བ་ཡང་དག་བཅས་༎
 dharmadhātusamatāprāpta nirālamba namo 'stu te || 18 ||	ཆོས་དབྱིངས་མཉམ་པ་ཉིད་བརྙེས་པ་། མི་རྟེན་ཁྱོད་ལ་ཕྱག་འཚལ་ལོ༏་༏གཟུགས་ཀྱི་གྲངས་ལས་རྣམ་གྲོལ་ཞིང་༎
 rūpasaṃkhyāvinirmukta asaddharmavivarjitaḥ |	དམ་ཆོས་མ་ལགས་རྣམ་པར་སྤངས་༎
 anupādāna atyāga nirālamba namo 'stu te || 19 ||	ལེན་དང་གཏོང་བ་མི་མངའ་བ་། མི་རྟེན་ཁྱོད་ལ་ཕྱག་འཚལ་ལོ་༎
 māradoṣasamatikrānto dharmadhātuṃ gatiṃgataḥ |	བདུད་ཀྱི་མིང་ལས་རབ་འདས་ཤིང་༎ ཆོས་ཀུན་རྟོགས་པར་ཐུགས་སུ་ཆུད་༎
 anāvaraṇadharmo 'si nirālamba namo 'stu te || 20 ||	སྒྲིབ་པ་མི་མངའ་ཆོས་གྱུར་པ་༎ མི་རྟེན་ཁྱོད་ལ་ཕྱག་འཚལ་ལོ་༎
 astīti nocyate 'rthajñaiḥ nāstīty api tu nocyate |	དོན་འཚལ་རྣམས་ཀྱིས་མཆིས་མི་བརྗོད༏་༏མ་མཆིས་ཞེས་ཀྱང་བརྗོད་མི་བགྱི་༎
 avākpatha anādāna nirālamba namo 'stu te || 21 ||	ལེན་མེད་ཚིག་ལམ་མ་མཆིས་པ་༎ མི་རྟེན་ཁྱོད་ལ་ཕྱག་འཚལ་ལོ་༎
 dvayadharma aniśritya mānadhvajasamucchidaḥ |	གཉིས་ཀྱི་ཆོས་ལ་མི་རྟེན་པར་༎ ཐེག་པའི་རྒྱལ་མཚན་ཀུན་ཏུ་བཙུགས་༎
 dvayādvayavinirmukta nirālamba namo 'stu te || 22 ||	གཉིས་དང་གཉིས་མེད་རྣམ་གྲོལ་བ་༎ མི་རྟེན་ཁྱོད་ལ་ཕྱག་འཚལ་ལོ་༎
 jitās te mānasā doṣāḥ śārīrāś ca caturvidhāḥ |	ཁྱོད་ཀྱིས་ཡིད་ཀྱི་ཉེས་པ་དང་༎ ལུས་ཀྱི་ནད་བཞི་ཕམ་པར་མཛད་༎
 acintya vigataupamya nirālamba namo 'stu te || 23 || (jāa 73)	བསམ་ཡས་དཔེ་༄༥༢༥བ་དང་རྣམ་བྲལ་བ་༎ མི་རྟེན་ཁྱོད་ལ་ཕྱག་འཚལ་ལོ་༎ ལྷུན་གྱིས་གྲུབ་པར་འཇུག་མཛད་ཅིང་༎
 anābhogapravṛtto 'si sarvadoṣavivarjitaḥ |	ཉེས་པ་ཐམས་ཅད་རྣམ་པར་སྤངས་༎
 jñānapūrvaṅgamā ceṣtā nirālamba namo 'stu te || 24 ||	སྤྱོད་པ་མཁྱེན་པས་ཐོག་དྲངས་པ་༎ མི་རྟེན་ཁྱོད་ལ་ཕྱག་འཚལ་ལོ་༎
 anāsravā te smṛtiḥ sūkṣmā bhūtābhūteṣu tanmayā |	ཁྱོད་དགོངས་ཞི་ཞིང་ཟག་མི་མངའ༎ འབྱུང་མིན་འབྱུང་བའི་བདག་ཅན་༎
 aniketa asaṃkalpa nirālamba namo 'stu te || 25 ||	གནས་དང་རྟོག་པ་མི་མངའ་བ་༎ མི་རྟེན་ཁྱོད་ལ་ཕྱག་འཚལ་ལོ་༎
 anārambaṇena cittena sarvacittaṃ prajānasi |	དམིགས་པ་མི་མངའ་ཐུགས་ཀྱིས་སུ་༎ ཀུན་གྱི་སེམས་ནི་རབ་ཏུ་མཁྱེན་༎
 na cātmaparasaṃjñā te nirālamba namo 'stu te || 26 ||	བདག་གཞན་འདུ་ཤེས་མི་མངའ་བ་༎
 anārambaṇa anālamba sarvacittāna mohana |	མི་རྟེན་ཁྱོད་ལ་ཕྱག་འཚལ་ལོ༏་༏དམིགས་དང་དམིགས་པ་རྣམས་ཀྱིས་ནི་༎ ཀུན་གྱི་སེམས་ནི་རྨོངས་པར་བགྱིད་༎
 anārambaṇadharmo 'si nirālamba namo 'stu te || 27 ||	སྒྲིབ་པ་མེད་པའི་ཆོས་གྱུར་པ་༎ མི་རྟེན་ཁྱོད་ལ་ཕྱག་འཚལ་ལོ་༎
 anārambaṇaṃ ca taccittaṃ svabhāvena na vidyate |	དམིགས་པ་དག་དང་སེམས་རྣམས་ནི་༎ ངོ་བོ་ཉིད་མཆིས་མ་ལགས་༎
 acintya samatāprāpta nirālamba namo 'stu te || 28 ||	བསམ་ཡས་མཉམ་པ་ཉིད་བརྙེས་པ་༎ མི་རྟེན་ཁྱོད་ལ་ཕྱག་འཚལ་ལོ་༎
 aniśritena jñānena sarvakṣetrāṇi paśyasi |	གནས་པ་མི་མངའ་མཁྱེན་པ་ཡིས་༎ ཞིང་རྣམས་ཀུན་དང་དེ་བཞིན་དུ་༎
 sarvasattvacariṃ caiva nirālamba namo 'stu te || 29 ||	སེམས་ཅན་ཀུན་གྱི་སྤྱོད་གཟིགས་པ་༎ མི་རྟེན་ཁྱོད་ལ་ཕྱག་འཚལ་ལོ་༎ སངས་རྒྱས་རྣམས་ཀྱིས་ལན་དགའ་ཡང་༎
 cittaṃ na labdhaṃ buddhehi atyantāya kadācana |	སེམས་དང་ཆོས་ཀུན་གཏན་མ་དམིགས་༎
 sarvadharmā ca sarvajña nirālamba namo 'stu te || 30 ||	ཆོས་རྣམས་ཐམས་ཅད་ཀུན་མཁྱེན་པ་༎ མི་རྟེན་ཁྱོད་ལ་ཕྱག་འཚལ་ལོ་༎
 (jāa 74) māyopamāḥ sarvadharmā māyā caiva na vidyate |	ཆོས་ཀུན་སྒྱུ་མ་ལྟ་བུ་༄༥༢༦ཨ་༌༎ སྟེ༏་༏སྒྱུ་མ་ཉིད་ཀྱང་མཆིས་མ་ལགས་༎
 māyādharmavinirmukta nirālamba namo 'stu te || 31 ||	སྒྱུ་མའི་ཆོས་ལས་རྣམ་གྲོལ་བ་༎ མི་རྟེན་ཁྱོད་ལ་ཕྱག་འཚལ་ལོ་༎
 loke carasi saṃbuddha lokadharmair aniśritaḥ |	རྫོགས་སངས་འཇིག་རྟེན་སྤྱོད་མཛད་ཀྱང་༎ འཇིག་རྟེན་ཆོས་ལ་རྟེན་མི་མཛད་༎
 lokaṃ na ca vikalpeṣi nirālamba namo 'stu te || 32 ||	འཇིག་རྟེན་རྣམ་རྟོག་མི་མངའ་བ་༎ མི་རྟེན་ཁྱོད་ལ་ཕྱག་འཚལ་ལོ་༎
 śūnye carasi śūnyatvāc chūnyatvāc chūnyagocaraḥ |	སྟོང་ཕྱིར་སྟོང་ལ་སྤྱོད་མཛད་ཅིང་༎ ཁྱོད་ཉིད་སྟོང་ཞིང་སྤྱོད་ཡུལ་སྟོང་༎
 śūnyaṃ ca śūnyam ākhyāsi nirālamba namo 'stu te || 33 ||	སྟོང་པ་སྟོང་པར་སྟོན་མཛད་པ་༎ མི་རྟེན་ཁྱོད་ལ་ཕྱག་འཚལ་ལོ་༎
 vikurvasi mahāriddhyā māyopamasamādhinā |	སྒྱུ་མ་ལྟ་བུའི་ཏིང་འཛིན་དང་༎ རྫུ་འཕྲུལ་ཆེན་པོས་རྣམ་འཕྲུལ་ཞིང་༎
 nirnānātvaṃ samāpanna nirālamba namo 'stu te || 34 ||	ཐ་དད་མ་མཆིས་སྙོམས་ཞུགས་པ་༎ མི་རྟེན་ཁྱོད་ལ་ཕྱག་འཚལ་ལོ་༎
 anekatva anānātva dūrāsanne na vartase |	དུ་མ་མ་ལགས་གཅིག་མ་ལགས་༎ རིང་དང་ཉེ་ལ་མི་འཇུག་ཅིང་༎ གདེག་དང་གཞག་པ་མི་མངའ་བ་༎
 anutkṣepa anikṣepa nirālamba namo 'stu te || 35 ||	མི་རྟེན་ཁྱོད་ལ་ཕྱག་འཚལ་ལོ་༎
 ekakṣaṇe 'bhisaṃbuddha vajropamasamādhinā |	རྡོ་རྗེ་ལྟ་བུའི་ཏིང་འཛིན་གྱིས་༎ སྐད་ཅིག་གཅིག་ལ་མངོན་སངས་རྒྱས༏་༏དངོས་མ་མཆིས་པར་མཉམ་བཞག་པ་༎
 nirābhāsasamāpanna nirālamba namo 'stu te || 36 || (jāa 75)	མི་རྟེན་ཁྱོད་ལ་ཕྱག་འཚལ་ལོ་༎ འདྲེན་པ་དུས་རྣམས་ཐམས་ཅད་དུ་༎
 acalaṃ vetsi nirvāṇaṃ sarvatryadhvasu nāyaka |	མི་ག-ཡོ་མྱ་ངན་འདས་པ་རྟོགས་༎
 vividhopāyasampanna nirālamba namo 'stu te || 37 ||	སྣ་ཚོགས་ཐབས་དང་ལྡན་པ་པོ་༎ མི་རྟེན་ཁྱོད་ལ་ཕྱག་འཚལ་ལོ་༎
 pāraṃparyeṇa sattvānām upāyajñānakovidaḥ |	སེམས་ཅན་རྣམས་ཀྱི་བརྒྱུད་པའི་ཐབས་༎ མཁྱེན་པས་མཁས་པར་གྱུར་པ་ལགས་༎
 acalaṃ vetsi nirvāṇaṃ nirālamba namo 'stu te || 38 ||	དེ་ཕྱིར་༄༥༢༦བ་མི་ག-ཡོ་མྱ་ངན་འདས་༎ མི་རྟེན་ཁྱོད་ལ་ཕྱག་འཚལ་ལོ་༎
 nirnimitta nirābhoga niḥprapañca nirāmaya |	མཚན་མ་མི་མངའ་ལྷུན་གྱིས་གྲུབ་༎ སྤྲོས་པ་མི་མངའ་སྐྱོན་མི་མངའ༎
 nirābhāsa nirātmaika nirālamba namo 'stu te || 39 ||	སྣང་མེད་བདག་གི་མི་མངའ་བ་༎ མི་རྟེན་ཁྱོད་ལ་ཕྱག་འཚལ་ལོ་༎ རྣམ་རྟོག་མི་མངའ་སྐྱོན་མི་མངའ༎
 nirvikalpo nirātmīya yathaivātmānam ātmanā |	བདག་གིས་བདག་ཉིད་ཇི་བཞིན་པར་༎
 vetsi sarvajña sarvatra nirālamba namo 'stu te || 40 || §38 ms| 27a2-6, p| 329a6-b2, d|301a1-4, t| 357 -, t| 358 -, t| 359(W) 263b3-16|	ཀུན་ཏུ་མཁྱེན་པ་ཐམས་ཅད་མཁྱེན་༎ མི་རྟེན་ཁྱོད་ལ་ཕྱག་འཚལ་ལོ་༎
 vandāmi tvāṃ daśabala oghatīrṇaṃ vandāmi tvāṃ abhayadadaṃ viśāradam |	སྟོབས་བཅུ་ཆུ་བོ་རྒལ་བ་ཁྱོད་ལ་ཕྱག་འཚལ་ལོ་༎ འཇིགས་བྲལ་འཇིགས་མེད་སྩོལ་བ་ཁྱོད་ལ་ཕྱག་འཚལ་ལོ་༎
 dharmeṣu āveṇikaniścayaṃ gataṃ vandāmi tvāṃ sarvajagasya nāyakam || 1 || (jāa 76)	མ་འདྲེས་ཆོས་རྣམས་ངེས་པར་ཐུགས་སུ་ཆུད་གྱུར་པ་༎ འགྲོ་བ་ཀུན་གྱི་འདྲེན་པ་ཁྱོད་ལ་ཕྱག་འཚལ་ལོ་༎
 vandāmi saṃyojanabandhanacchidaṃ vandāmi tvāṃ pāragataṃ sthule sthitam |	ཀུན་སྦྱོར་འཆིང་བ་བཅད་པ་ཁྱོད་ལ་ཕྱག་འཚལ་ལོ་༎ ཕ་རོལ་བྱོན་ཏེ་ཐང་ལ་ཞུགས་པ་ཁྱོད་ལ་ཕྱག་འཚལ་ལོ་༎
 vandāmi tvāṃ khinnajagasya nāyakaṃ vandāmi saṃsāragata-ṃ-aniśritam || 2 ||	སྐྱེ་བོ་ངལ་པའི་རྣམ་འདྲེན་ཁྱོད་ལ་ཕྱག་འཚལ་ལོ་༎ འཁོར་བར་གཤེགས་ཤིང་མི་གནས་པ་ལ་ཕྱག་འཚལ་ལོ༏་༏འགྲོ་བ་ཐམས་ཅད་དག་ན་སེམས་ཅན་རྣམས་དང་ནི་༎ 
 vandāmi sattvasamādhānavigataṃ {gatīṣu} sarvāsu jātīsu vimuktamānasam |	ཐབས་ཅིག་བཞུགས་ཀྱང་ཐུགས་ཡིད་རབ་དབེན་པ་༎
 jale ruhaṃ vā salilair na lipyase niṣevitā te munir buddha śūnyatā || 3 ||	ཇི་ལྟར་པདམ་ཆབ་ཀྱིས་གོས་པར་མི་འགྱུར་ཞིང་༎
 vivekatā śāstṛpadaṃ niruttaraṃ vande nirālamba mahaughatīrṇam |	སངས་རྒྱས་ཐུབ་པ་ཁྱོད་ཀྱིས་སྟོང་ཉིད་ཤིན་ཏུ་བསྟེན་༎
 vibhāvitā sarvanimitta sarvaśo na te kahiṃcit praṇidhānu vidyate || 4 ||	མཚན་མ་ཐམས་ཅད་རྣམས་པ་ཀུན་ཏུ་རྣམ་པར་བཤིག་། ཁྱོད་ལ་གང་ཡང་སྨོན་པར་མཛད་པ་༄༥༢༧ཨ་༌༎ མཆིས་མ་ལགས་༎ སྟོན་པའི་གོ་འཕང་བླ་མེད་དབེན་པ་ཉིད་ལགས་ཏེ་༎
 acintiyaṃ buddha mahānubhāvaṃ vandāmi ākāśasamam aniśritam |	དམིགས་པ་མེད་ཆུ་བོ་རྒལ་བ་ཁྱོད་ལ་ཕྱག་འཚལ་ལོ༏་༏སངས་རྒྱས་མཐུ་ཆེན་བསམ་གྱིས་ཁྱབ་བ་མ་ལགས་ཏེ་༎ མི་གནས་ནམ་མཁའ་མཉམ་པ་ཉིད་ལ་ཕྱག་འཚལ་ལོ་༎
 vandāmi te sarvaguṇāgradhāri vandāmi tvāṃ merum ivodgataśriyam || 5 || (jāa 77) §39 ms| 27a6-27b4, p| 329b2-330a2, d| 301a4-301b3, t| 357 248a7-24, t| 358 -, t| 359(W) 263b17-263c1|	ཡོན་ཏན་ཀུན་གྱི་མཆོག་མངའ་ཁྱོད་ལ་ཕྱག་འཚལ་ལོ་༎ དཔལ་འཕགས་ལྷུན་པོ་འདྲ་བ་ཁྱོད་ལ་ཕྱག་འཚལ་ལོ་༎
 atha khalu bhagavān mañjuśriye kumārabhūtāya sādhukāram adāt |	དེ་ནས་བཅོམ་ལྡན་འདས་ཀྱིས་འཇམ་དཔལ་གཞོན་ནུར་གྱུར་པ་ལ་ལེགས་སོ་༎ ཞེས་བྱ་བ་བྱིན་ཏེ་། འཇམ་དཔལ་།
 sādhu sādhu mañjuśrīḥ |	ལེགས་སོ་༎ ལེགས་སོ༏། འཇམ་དཔལ་།
 subhāṣitaṃ te mañjuśrīr evam eva |	ཁྱོད་ཀྱིས་ལེགས་པར་སྨྲས་སོ་༎ འཇམ་དཔལ་། དེ་དེ་བཞིན་ཏེ་། འཇམ་དཔལ་། སངས་རྒྱས་རྣམས་ནི་། གཟུགས་ལས་བལྟ་བར་མི་བྱ་སྟེ་། ཆོས་ལས་མ་ཡིན་། མཚན་མ་ལས་མ་ཡིན་།
 mañjuśrīr na buddhā rūpato draṣṭavyā na dharmato na lakṣaṇato na dharmadhātutaḥ |	ཆོས་ཀྱི་དབྱིངས་ལས་ཀྱང་མ་ཡིན་ནོ་༎
 na buddhā ekākino na mahājanamadhyagatāḥ |	སངས་རྒྱས་རྣམས་ནི་། ཉག་གཅིག་བཞུགས་པ་མ་ཡིན་། སྐྱེ་བོ་མང་པོའི་ནང་ན་བཞུགས་པ་མ་ཡིན་ནོ་༎
 na buddhā kenacid dṛṣṭāḥ,	སངས་རྒྱས་རྣམས་ནི༏་སུས་ཀྱང་མཐོང་བ་མ་ཡིན་།
 na śrutā na pūjitā na pūjyante |	ཐོས་པ་མ་ཡིན་། མཆོད་པ་མ་ཡིན་ཏེ་། མཆོད་པར་བྱེད་པའང་མ་ཡིན་ནོ་༎
 na buddhā kasyacid dharmasya ekatvaṃ vā bahutvaṃ vā kurvanti |	སངས་རྒྱས་རྣམས་ནི་། ཆོས་འགའ་ཡང་༄༥༢༧བ་གཅིག་པ་ཉིད་དམ་། མང་པོ་ཉིད་དུ་མི་མཛད་པ་ཡིན་ནོ་༎
 na buddhair bodhiḥ prāptā |	སངས་རྒྱས་རྣམས་ཀྱི་བྱང་ཆུབ་བརྙེས་པ་མེད་དོ་༎
 na buddhāḥ kenacid dharmena prabhāvyante |	སངས་རྒྱས་རྣམས་ནི་། ཆོས་གང་གིས་ཀྱང་རབ་ཏུ་འབྱེད་པར་མི་བྱེད་དོ་༎ སངས་རྒྱས་རྣམས་ཀྱིས་ནི་།
 na buddhaiḥ kaścid dharmo dṛṣṭo na śruto na smṛto na vijñāto nājñātaḥ |	ཆོས་འགའ་ཡང་མ་གཟིགས་། མ་གསན་། མ་དགོངས་། རྣམ་པར་མི་མཁྱེན་། ཀུན་ཏུ་མི་མཁྱེན་ཏོ་༎
 na buddhair bhāṣitaṃ nodāhṛtam,	སངས་རྒྱས་རྣམས་ཀྱིས་ནི་། མ་གསུངས་། མ་བརྗོད་དོ་༎
 na buddhā bhāṣanti nodāharanti,	སངས་རྒྱས་རྣམས་ཀྱིས་ནི་། མི་གསུང་། མི་བརྗོད་དོ་༎
 na buddhā bhāṣiṣyanti nodāhariṣyanti |	སངས་རྒྱས་རྣམས་ནི་། གསུང་བར་མི་འགྱུར་། བརྗོད་པར་མི་འགྱུར་རོ་༎
 na buddhā abhisaṃbudhyanti,	སངས་རྒྱས་རྣམས་ནི་། མངོན་པར་རྫོགས་པར་འཚང་རྒྱ་བར་མི་མཛད་དོ་༎
 na buddhaiḥ kaścid dharmo 'bhisaṃbuddhaḥ |	སངས་རྒྱས་རྣམས་ཀྱིས་ནི་། ཆོས་གང་ཡང་མངོན་པར་རྫོགས་པར་འཚང་མ་རྒྱས་སོ་༎
 na buddhānāṃ kleśāḥ prahīṇāḥ,	སངས་རྒྱས་རྣམས་ནི་། ཉོན་མོངས་པ་མ་སྤངས་སོ་༎ སངས་རྒྱས་རྣམས་ཀྱིས་ནི་།
 na vyavadānaṃ sākṣātkṛtam |	རྣམ་པར་བྱང་བ་མངོན་སུམ་དུ་མ་མཛད་དོ་༎
 na buddhaiḥ kaścid dharmo dṛṣṭaḥ,	སངས་རྒྱས་རྣམས་ཀྱིས་ནི་། ཆོས་གང་ཡང་མ་གཟིགས་༎ མ་གསན་། མ་མྱངས་། མ་མ་ནམས་།
 na śruto nāghrāto na vijñātaḥ |	མ་རེག་།
 tat kasya hetoḥ |	མི་མཁྱེན་ཏོ་༎ དེ་ཅིའི་ཕྱིར་ཞེ་ན་། འཇམ་དཔལ་།
 ādipariśuddhatvāt sarvadharmāṇām || (jāa 78) v §40 ms| 27b4-28b2, p| 330a2-b6, d| 301b3-302a6, t| 357 248a24-248b20, t| 358 253b1-13, t| 359(W) 263c2-27|	ཆོས་ཐམས་ཅད་ནི་། གཟོད་མ་ནས་ཡོངས་སུ་དག་པ་ཡིན་པའི་ཕྱིར་རོ་༎
 (1) yaḥ kaścin mañjuśrīr bodhisattvaḥ trisāhasramahāsāhasralokadhātuparamāṇurajaḥsamān sattvān pratyekajinatve sthāpayed idaṃ dharmaparyāyaṃ nādhimuktaḥ |	འཇམ་དཔལ་། བྱང་ཆུབ་སེམས་དཔའ་ཆོས་ཀྱི་རྣམ་གྲངས་འདི་ལ་མོས་པ་གང་ལ་ལ་༄༥༢༨ཨ་༌༎ ཞིག་གིས་སྟོང་གསུམ་གྱི་སྟོང་ཆེན་པོའི་འཇིག་རྟེན་གྱི་ཁམས་ཀྱི་རྡུལ་ཕྲ་རབ་ཀྱི་རྡུལ་སྙེད་ཀྱི་སེམས་ཅན་རང་རྒྱལ་བ་ཉིད་ལ་བཀོད་པ་བས་ནི༏་འཇམ་དཔལ་། 
 yo cānyo mañjuśrīr bodhisattva imaṃ dharmaparyāyam adhimucyet |	བྱང་ཆུབ་སེམས་དཔའ་གཞན་གང་ཞིག་ཆོས་ཀྱི་རྣམ་གྲངས་འདི་ལ་མོས་པར་གྱུར་ནི༏་འཇམ་དཔལ་། ན་། དེ་ནི་།
 ayaṃ tato bahutaraṃ puṇyaṃ prasavati | kaḥ punar vādo ya imaṃ dharmaparyāyaṃ likhed lekhāpayed vā |	དེ་བས་ཆེས་བསོད་ནམས་མང་དུ་སྐྱེད་པར་གྱུར་ན༏་གང་ཆོས་ཀྱི་རྣམ་གྲངས་འདི་ཡི་གེར་འབྲིའམ་། ཡི་གེར་འབྲིར་འཇུག་པ་ལྟ་སྨོས་ཀྱང་ཅི་དགོས་ཏེ་།
 ayam eva tato bahutaraṃ puṇyaṃ prasavati ||	དེ་ནི་། དེ་བས་ཆེས་བསོད་ནམས་མང་དུ་བསྐྱེད་པར་འགྱུར་རོ་༎ འཇམ་དཔལ་། ཡོངས་སུ་བརྟག་པ་ཉེ་བར་བཟུང་ན་།
 (2) yāvanto mañjuśrīr bodhisattva trisāhasramahāsāhasre lokadhātau sattvāḥ saṃvidyante, aṇḍajā vā, jarāyujā vā, saṃsvedajā vā, opapādukā vā, rūpiṇo vā, arūpiṇo vā, saṃjñino vā, asaṃjñino vā, apadā vā, dvipadā vā, catuḥpadā vā, bahupadā vā, sarve te parikalpam upādāya, apūrvācaramaṃ mānuṣyakam ātmabhāvaṃ pratilabheyuḥ |	སྟོང་གསུམ་གྱི་སྟོང་ཆེན་པོའི་འཇིག་རྟེན་གྱི་ཁམས་ན་སེམས་ཅན་སྒོ་ང་ལས་སྐྱེས་པ་དང་། མངལ་ནས་སྐྱེས་པ་དང་། དྲོད་གཤེར་ལས་སྐྱེས་པ་དང་། རྫུས་ཏེ་སྐྱེས་པ་དང་། གཟུགས་ཅན་དང་། གཟུགས་མེད་པ་དང་། འདུ་ཤེས་ཅན་དང་། འདུ་ཤེས་མེད་པ་དང་། རྐང་པ་མེད་པ་དང་། རྐང་གཉིས་པ་དང་། རྐང་བཞི་པ་དང་། རྐང་མང་གང་ཇི་སྙེད་ཡོད་པ་དེ་དག་ཐམས་ཅད་སྔ་ཕྱི་མེད་པར་མིའི་ལུས་ཐོབ་པར་གྱུར་ལ་། 
 mānuṣyakam ātmabhāvaṃ pratilabhya bodhicittam utpādayeyuḥ |	མིའི་ལུས་ཐོབ་ནས་ཀྱང་བྱང་ཆུབ་ཏུ་སེམས་བསྐྱེད་པར་གྱུར་ལ་།
 bodhicittam utpādya ekaiko bodhisattvo gaṅgāsikatāsaṃkhyeyānāṃ buddhakṣetraparamāṇurajaḥsamānāṃ	བྱང་ཆུབ་ཏུ་སེམས་བསྐྱེད་ནས་ཀྱང་བྱང་ཆུབ་སེམས་དཔའ་རེ་རེས་ཀྱང་སངས་༄༥༢༨བ་རྒྱས་བྱང་ཆུབ་སེམས་དཔའ་དང་བཅས་། ཉན་ཐོས་དང་བཅས་པ་སངས་རྒྱས་ཀྱི་ཞིང་གངགའའི་བྱེ་མ་ལྟར་གྲངས་མེད་པའི་རྡུལ་ཕྲ་རབ་ཀྱི་རྡུལ་སྙེད་དག་ལ་བསྐལ་པ་གངགའའི་བྱེ་མ་ལྟར་གྲངས་མེད་པ་སྙེད་དུ་ན་དཔའ་དང་བཅས་། 
 buddhānāṃ bodhisattvānāṃ saśrāvakāṇāṃ cīvarapiṇḍapātaśayanāsanaglānapratyayabhaiṣajyapariṣkārair upatiṣṭhet |	བཟའ་དང་། ཞལ་ཟས་དང་། གཟིམས་ཆ་དང་། གདན་དང་། སྙུན་གྱི་གསོས་སྨན་དང་། ཡོ་བྱང་རྣམས་ཀྱིས་བསྙེན་བཀུར་བྱེད་ཅིང་།
 sarvasukhopadhānāni copasaṃharet | gaṅgāsikatāsaṃkhyeyāṃ kalpāṃs (jāa 79)	བདེ་བའི་ཡོ་བྱད་ཐམས་ཅད་ཀྱང་ཉེ་བར་སྒྲུབ་པར་བྱེད་ལ་།
 teṣāṃ ca parinirvṛtānāṃ stūpāni kārayet, ratnamayāni, yojanaśatocchritāni,	དེ་དག་ཡོངས་སུ་མྱ་ངན་ལས་འདས་པའི་མཆོད་རྟེན་རིན་པོ་ཆེ་ལས་བྱས་པའི་འཕང་དུ་དཔག་ཚད་བརྒྱ་ཡོད་པ་།
 ratnavedikāparivṛtāni,	རིན་པོ་ཆེའི་ལན་ཀན་གྱིས་ཡོངས་སུ་བསྐོར་བ་།
 maṇimuktāratnadāmakṛtaśobhāni,	ནོར་བུ་དང་། མུ་ཏིག་དང་། རིན་པོ་ཆེའི་ཆུན་པོས་མཛེས་པར་བྱས་པ་།
 ucchritacchatradhvajapatākāni,	གདུགས་དང་། རྒྱལ་མཚན་དང་། བ་དན་སྒྲེང་བ་།
 vaśirājamaṇiratnajālasaṃcchannāni | yo cānyo bodhisattva āśayasaṃpannaḥ |	ནོར་བུ་རིན་པོ་ཆེ་དབང་གི་རྒྱལ་པོའི་དྲ་བས་ཀུན་ནས་ག-ཡོགས་པ་ཤ་སྟག་ཀྱང་བྱེད་དུ་བཅུག་པ་བས་ནི་། འཇམ་དཔལ་།
 imaṃ dharmaparyāyaṃ sarvabuddhaviṣayāvatārajñānālokālaṃkāraṃ śrutvādhimucyed avataret pattīyet paribuddhet |	བྱང་ཆུབ་སེམས་དཔའ་བསམ་པ་ཕུན་སུམ་ཚོགས་པ་གཞན་གང་ཞིག་གིས་སངས་རྒྱས་ཐམས་ཅད་ཀྱི་ཡུལ་ལ་འཇུག་པ་ཡེ་ཤེས་སྣང་བའི་རྒྱན་ཞེས་བྱ་བའི་ཆོས་ཀྱི་རྣམ་གྲངས་འདི་ཐོས་ནས་མོས་པར་བྱེད་། འཇུག་པར་བྱེད་། ཡིད་ཆེས་པར་བྱེད་ཅིང་། ཡོངས་སུ་རྟོགས་པར་བྱས་ནས་ཀྱང་ཐ་ན་ཚིག་བཞི་པའི་ཚིགས་སུ་༄༥༢༩ཨ་༌༎
 antaśa ekām api gāthām uddiśed ayaṃ tato saṃkhyeyataraṃ puṇyaṃ prasavet |	བཅད་པ་གཅིག་ཙམ་ཞིག་ལུང་འབོགས་པར་བྱེད་ན་། དེ་ནི་། དེ་བས་ཆེས་སངས་རྒྱས་ཀྱི་ཡེ་ཤེས་རྗེས་སུ་རྟོགས་པར་འགྱུར་བའི་བསོད་ནམས་གྲངས་མེད་པ་བསྐྱེད་པར་འགྱུར་ཏེ་། 
 buddhajñānānugamanaṃ saṃvartakam asya puṇyābhisaṃskārasya | asya puṇyābhisaṃskārasya sa pūrvakaḥ puṇyābhisaṃskāraḥ, teṣāṃ bodhisattvānāṃ dānamayaṃ puṇyakriyāvastu śatatamām api kalāṃ nopaiti,	བསོད་ནམས་མངོན་པར་འདུ་བྱེད་པ་དེ་ལ་བྱང་ཆུབ་སེམས་དཔའ་དེ་དག་གི་སྦྱིན་པ་ལས་བྱུང་བའི་བསོད་ནམས་མངོན་པར་འདུ་བྱ་བ་སྔ་མ་དེས་ནི་།
 sahasratamām api,	བརྒྱའི་ཆར་ཡང་ཉེ་བར་མི་འགྲོའོ་༎
 koṭīśatasahasratamām api, kalām api, gaṇanām api, upamām api, upaniṣadam api nopaiti || §41 ms| 28b2-29b6, p| 330b6-332a2, d| 302a6-303a7, t| 357 248b22-249a10, t| 358 253b13-19, t| 359(W) 263c27-264b7|	སྟོང་གི་ཆ་དང་། འབུམ་གྱི་ཆ་དང་། བྱེ་བ་ཕྲག་འབུམ་གྱི་ཆ་དང་། གྲངས་དང་། ཆ་དང་། བགྲང་བ་དང་། དཔེ་དང་། རྒྱུར་ཡང་ཉེ་བར་མི་འགྲོའོ་༎ འཇམ་དཔལ་།
 (1) yaḥ kaścin mañjuśrīr gṛhī bodhisattvo gaṅgāsikatāsaṃkhyeyān buddhān bodhisattvān saśrāvakasaṃghān gaṅgāsikatāsaṃkhyeyān (jāa 80) kalpān cīvarapiṇḍapātaśayanāsanaglānapratyayabhaiṣajyapariṣkārair upatiṣṭhet |	བྱང་ཆུབ་སེམས་དཔའ་ཁྱིམ་པ་གང་ལ་ལ་ཞིག་གིས་སངས་རྒྱས་དང་བྱང་ཆུབ་སེམས་དཔའ་དང་བཅས་པ་། ཉན་ཐོས་ཀྱི་དགེ་འདུན་དང་བཅས་པ་གངགའའི་བྱེ་མ་ལྟར་གྲངས་མེད་པ་སྙེད་ཅིག་ལ་བསྐལ་པ་གངགའའི་བྱེ་མ་ལྟར་གྲངས་མེད་པ་སྙེད་དུ་ན་བཟའ་དང་། ཞལ་ཟས་དང་། གཟིམས་ཆ་དང་། གདན་དང་། སྙུན་གྱི་གསོས་སྨན་དང་། ཡོ་བྱད་རྣམས་ཀྱིས་བསྙེན་བཀུར་བྱེད་པ་བས་ནི་།
 yaś cānyaḥ pravrajito bodhisattvaḥ śīlavān āśayasaṃpanno 'ntaśo yas tiryagyonigate 'pi sattva ekasyāpy ālopaṃ dadyāt |	བྱང་ཆུབ་སེམས་དཔའ་རབ་ཏུ་བྱུང་བ་ཚུལ་ཁྲིམས་དང་ལྡན་པ་། བསམ་པ་ཕུན་སུམ་ཚོགས་པ་གཞན་གང་གིས་ཐ་ན་དུད་འགྲོའི་སྐྱེ་གནས་སུ་སྐྱེས་པའི་སེམས་ཅན་ལ་༄༥༢༩བ་སྦྱིན་པ་ཁམས་གཅིག་ཙམ་ཞིག་ཕྱིན་པར་གྱུར་ན་། 
 tasya puṇyābhisaṃskārasya pūrvakaḥ puṇyābhisaṃskāraḥ śatatamām api kalāṃ nopaiti, sahasratamām api,	བསོད་ནམས་མངོན་པར་འདུ་བྱ་བ་དེ་ལ་བསོད་ནམས་མངོན་པར་འདུ་བྱ་བ་སྔ་མ་དེས་བརྒྱའི་ཆར་ཡང་ཉེ་བར་མི་འགྲོའོ༏་༏སྟོང་གྱུར་ན་། གི་ཆ་དང་། 
 koṭīśatasahasratamām api, koṭīniyutasahasratamām api, yāvad upaniṣadam api na kṣamate ||	འབུམ་གྱི་ཆ་དང་། བྱེ་བ་ཕྲག་འབུམ་གྱི་ཆ་དང་། གྲངས་དང་། ཆ་དང་། བགྲང་བ་དང་། དཔེ་དང་། རྒྱུར་ཡང་ཉེ་བར་མི་འགྲོའོ༏་༏འཇམ་དཔལ་།
 (2) sacen mañjuśrīs trisāhasramahāsāhasralokadhātuparamāṇurajaḥsamā bodhisattvāḥ pravrajitāḥ śīlavanta āśayaśuddhāḥ,	གལ་ཏེ་བྱང་ཆུབ་སེམས་དཔའ་རབ་ཏུ་བྱུང་བ་ཚུལ་ཁྲིམས་དང་ལྡན་པ་སྟོང་གསུམ་གྱི་སྟོང་ཆེན་པོའི་རྡུལ་ཕྲ་རབ་ཀྱི་རྡུལ་སྙེད་དག་ལས་བྱང་ཆུབ་སེམས་དཔའ་རེ་རེས་ཀྱང་ཕྱོགས་བཅུའི་སངས་རྒྱས་བྱང་ཆུབ་སེམས་དཔའ་དང་བཅས་།
 tata ekaiko bodhisattvo gaṅgānadīsikatāsaṃkhyeyān buddhān bodhisattvān saśrāvakasaṃghāṃś cīvarapiṇḍapātaśayanāsanaglānapratyayabhaiṣajyapariskārair gaṅgānadīsikatāsaṃkhyeyān kalpān |	ཉན་ཐོས་དང་བཅས་པ་གངགའའི་བྱེ་མ་ལྟར་གྲངས་མེད་པ་སྙེད་དག་ལ་བསྐལ་པ་གངགའའི་བྱེ་མ་ལྟར་གྲངས་མེད་པ་སྙེད་དུ་ན་བཟའ་དང་། ཞལ་ཟས་དང་། གཟིམས་ཆ་དང་། གདན་དང་། སྙུན་གྱི་གསོས་སྨན་དང་། ཡོ་བྱད་རྣམས་ཀྱིས་བསྙེན་བཀུར་བྱེད་པར་གྱུར་ན་།
 yas teṣāṃ bodhisattvānāṃ puṇyābhisaṃskāro bhaved dānamayaḥ |	བྱང་ཆུབ་སེམས་དཔའ་དེ་དག་གི་སྦྱིན་པ་ལས་བྱུང་བའི་བསོད་ནམས་མངོན་པར་འདུ་བྱ་བ་གང་ཡིན་པ་དེ་ལ་ནི་།
 yo vānyo bodhisattva āśayaśuddho śīlavān gṛhī vā pravrajito vā,	བྱང་ཆུབ་སེམས་དཔའ་ཁྱིམ་པའམ་། རབ་ཏུ་བྱུང་བ་བསམ་པ་དག་པ་།
 imaṃ dharmaparyāyaṃ śrutvādhimucyet pattīyed vā likheta lekhāpayed vā |	ཚུལ་ཁྲིམས་དང་ལྡན་པ་གཞན་གང་ཞིག་གིས་ཆོས་ཀྱི་རྣམ་གྲངས་འདི་ཐོས་ནས་མོས་པར་༄༥༣༠ཨ་༌༎ པར་བྱེད་། འཇུག་པར་བྱེད་། ཡིད་ཆེས་པར་བྱེད་། ཡི་གེར་འབྲི་བར་བྱེད་། ཡི་གེར་འབྲིར་འཇུག་པར་བྱེད་ན་།
 asya puṇyābhisaṃskārasya sa pūrvakaḥ puṇyābhisaṃskāraḥ,	བསོད་ནམས་མངོན་པར་འདུ་བྱ་བ་དེ་ལ་བྱང་ཆུབ་སེམས་དཔའ་དེ་དག་གི་སྦྱིན་པ་ལས་བྱུང་བའི་བསོད་ནམས་མངོན་པར་འདུ་བྱ་བ་སྔ་མ་དེས་ནི་། 
 teṣāṃ bodhisattvānāṃ dānamayaṃ puṇyakriyāvastu śatatamīm api kalāṃ nopaiti, sahasratamīm api, yāvad upaniṣām api na kṣamate ||	བརྒྱའི་ཆར་ཡང་ཉེ་བར་མི་འགྲོའོ༏་༏སྟོང་གི་ཆ་དང་། འབུམ་གྱི་ཆ་དང་། བྱེ་བ་ཕྲག་འབུམ་གྱི་ཆ་དང་། གྲངས་དང་། ཆ་དང་། བགྲང་བ་དང་། དཔེ་དང་། རྒྱུར་ཡང་ཉེ་བར་མི་འགྲོའོ་༎ འཇམ་དཔལ་།
 (jāa 81) (3) sacen mañjuśrīr bodhisattvo mahāsattvas trisāhasramahāsāhasraṃ lokadhātuṃ saptaratnaparipūrṇāṃ kṛtvā buddhebhyo bhagavadbhyo dānaṃ dadyāt evaṃ dadan trisāhasramahāsāhasralokadhātuparamāṇurajaḥsamān kalpān dānaṃ dadyāt |	གལ་ཏེ་བྱང་ཆུབ་སེམས་དཔའ་སེམས་དཔའ་ཆེན་པོ་ཞིག་གིས་སྟོང་གསུམ་གྱི་སྟོང་ཆེན་པོའི་འཇིག་རྟེན་གྱི་ཁམས་རིན་པོ་ཆེ་སྣ་བདུན་གྱིས་ཡོངས་སུ་བཀང་སྟེ་སངས་རྒྱས་རྣམས་ལ་དབུལ་བར་འབུལ་ཞིང་། དེ་ལྟར་འབུལ་བས་བསྐལ་པ་སྟོང་གསུམ་གྱི་སྟོང་ཆེན་པོའི་འཇིག་རྟེན་གྱི་ཁམས་ཀྱི་རྡུལ་ཕྲ་རབ་ཀྱི་རྡུལ་སྙེད་དུ་འབུལ་བར་ཕུལ་བ་བས་། ནི་། 
 yo vānyo bodhisattva imān dharmaparyāyān antaśaś catuṣpādikāṃ gāthāṃ bodhisattvasya deśayet |	བྱང་ཆུབ་སེམས་དཔའ་གཞན་གང་ཞིག་གི་ཆོས་ཀྱི་རྣམ་གྲངས་འདི་ལས་ཐ་ན་ཚིག་བཞི་པའི་ཚིགས་སུ་བཅད་པ་གཅིག་ཙམ་ཞིག་བྱང་ཆུབ་སེམས་དཔའ་གཞན་ལ་བསྟན་པར་གྱུར་ན་།
 asya puṇyābhisaṃskārasya sa pūrvakaḥ puṇyābhisaṃskāraḥ śatatamām api kalāṃ nopaiti,	བསོད་ནམས་མངོན་པར་འདུ་བ་དེ་ལ་བསོད་ནམས་མངོན་པར་འདུ་བྱ་བ་སྔ་མ་དེས་ནི་། ༄༥༣༠བ་བརྒྱའི་ཆར་ཡང་ཉེ་བར་མི་འགྲོའོ་༎
 sahasratamām api, śatasahasratamām api, koṭīśatasahasratamām api, yāvad upaniṣām api na kṣamate ||	སྟོང་གི་ཆ་དང་། འབུམ་གྱི་ཆ་དང་། བྱེ་བ་ཕྲག་འབུམ་གྱི་ཆ་དང་། གྲངས་དང་། ཆ་དང་། བགྲང་བ་དང་། དཔེ་དང་། རྒྱུར་ཡང་ཉེ་བར་མི་འགྲོའོ་༎
 (4) tiṣṭhantu tāvan mañjuśrīḥ trisāhasramahāsāhasralokadhātuparamāṇurajaḥsamān kalpān dānaṃ dadataḥ puṇyābhisaṃskārāḥ |	འཇམ་དཔལ་། བསྐལ་པ་སྟོང་གསུམ་གྱི་སྟོང་ཆེན་པོའི་འཇིག་རྟེན་གྱི་ཁམས་ཀྱི་རྡུལ་ཕྲ་རབ་ཀྱི་རྡུལ་སྙེད་དུ་སྦྱིན་པའི་བསོད་ནམས་མངོན་པར་འདུ་བྱ་བ་ལྟ་ཞོག་གི་། འཇམ་དཔལ་།
 sacen mañjuśrīr gaṅgāsikatāsaṃkhyeyā bodhisattvā bhaveyuḥ |	གལ་ཏེ་བྱང་ཆུབ་སེམས་དཔའ་གངགའའི་བྱེ་མ་ལྟར་གྲངས་མེད་པ་སྙེད་ཅིག་བྱུང་བར་གྱུར་ལ་།
 tata ekaiko bodhisattvo gaṅgāsikatāsaṃkhyeyāni buddhakṣetrāṇi jāmbūnadasuvarṇamayāni,	དེ་དག་ལས་བྱང་ཆུབ་སེམས་དཔའ་རེ་རེས་ཀྱང་སངས་རྒྱས་ཀྱི་ཞིང་ཛམབུ་ཆུ་བོའི་གསེར་ལས་བྱས་པ་། 
 sarvavṛkṣāṃś ca divyair vastraiḥ pariveṣṭayitvā,	ཤིང་ལྗོན་པ་ཐམས་ཅད་ཀྱང་ལྷའི་གོས་རྣམས་ཀྱིས་ཡོངས་སུ་དཀྲིས་པ་།
 sarvaprabhāsamuccayamaṇiratnajālasaṃcchannāni kṛtvā,	ནོར་བུ་རིན་པོ་ཆེ་འོད་ཐམས་ཅད་ཡང་དག་པར་འདུས་པའི་དྲ་བས་ཀུན་ནས་ག-ཡོགས་པ་།
 vaśirājamaṇiratnamayaiḥ kūṭāgārair vidyutpradīpamaṇiratnavedikāparivṛtaiḥ paripūrṇāṃ kṛtvā,	ནོར་བུ་རིན་པོ་ཆེ་དབང་གི་རྒྱལ་པོ་ལས་བྱས་པའི་ཁང་པ་བརྩེགས་པ་། ནོར་བུ་རིན་པོ་ཆེ་གློག་གི་སྒྲོན་མའི་ལན་ཀན་གྱིས་ཡོངས་སུ་བསྐོར་བ་དག་གིས་ཡོངས་སུ་གང་བར་བྱས་པ་། གདུགས་དང་། རྒྱལ་མཚན་དང་། བ་དན་བསྒྲེང་བ་།
 ucchritacchatradhvajapatākābhir gaṅgānadīsikatāsaṃkhyeyebhyo buddhebhyo divase divase dānaṃ dadyāt | evaṃ dadaṅ gaṅgāsikatāsaṃkhyeyān kalpān dānaṃ dadyāt |	གངགའའི་བྱེ་མ་ལྟར་གྲངས་མེད་པ་ཇི་སྙེད་ཅིག་སངས་རྒྱས་གངགའའི་བྱེ་མ་ལྟར་གྲངས་མེད་པ་སྙེད་དག་ལ་ཉིན་གཅིག་བཞིན་དུ་དབུལ་བར་འབུལ་ཞིང་། དེ་ལྟར་ཕུལ་བས་བསྐལ་པ་གངགའའི་བྱེ་མ་ལྟར་གྲངས་མེད་པ་༄༥༣༡ཨ་༌༎
 yo vānyo bodhisattva imaṃ dharmaparyāyam adhimucyānyasya bodhisattvasyeto dharmaparyāyād antaśa ekām api catuṣpādikāṃ gāthāṃ deśayed avatārayed (jāa 82) vā |	སྙེད་དུ་འབུལ་བར་ཕུལ་བ་བས་ནི་། བྱང་ཆུབ་སེམས་དཔའ་གཞན་གང་ཞིག་གིས་ཆོས་ཀྱི་རྣམ་གྲངས་འདི་ལ་མོས་པར་བྱས་ནས་ཆོས་ཀྱི་རྣམ་གྲངས་འདི་ལས་ཐ་ན་ཚིག་བཞི་པའི་ཚིགས་སུ་བཅད་པ་གཅིག་ཙམ་ཞིག་བྱང་ཆུབ་སེམས་དཔའ་གཞན་ལ་བསྟན་ཏམ་། འཇུག་པར་བྱས་ན་།
 asya puṇyābhisaṃskārasya sa pūrvakaḥ puṇyābhisaṃskāras teṣāṃ bodhisattvānāṃ dānamayaḥ śatatamām api kalāṃ nopaiti,	བསོད་ནམས་མངོན་པར་འདུ་བྱ་བ་དེ་ལ་བྱང་ཆུབ་སེམས་དཔའ་དེ་དག་གི་སྦྱིན་པ་ལས་བྱུང་བའི་བསོད་ནམས་མངོན་པར་འདུ་བྱ་བ་སྔ་མ་དེས་ནི་། བརྒྱའི་ཆར་ཡང་ཉེ་བར་མི་འགྲོའོ་༎
 sahasratamām api, śatasahasratamām api, saṃkhyām api, kalām api, gaṇanām api, upaniṣām api, yāvad upaniṣadam api nopaiti || §42 ms| 29b6-301b1, p| 332a2-b4, d| 303a7-302a1, t| 357 249a11-249b5, t| 358 253b19-23, t| 359(W) 264b8-29|	སྟོང་གི་ཆ་དང་། འབུམ་གྱི་ཆ་དང་། བྱེ་བ་ཕྲག་འབུམ་གྱི་ཆ་དང་། གྲངས་དང་། ཆ་དང་། བགྲང་བ་དང་། དཔེ་དང་། རྒྱུར་ཡང་ཉེ་བར་མི་འགྲོའོ་༎ འཇམ་དཔལ་།
 (1) tadyathā mañjuśrīs traidhātukaparyāpannāḥ sarvasattvā narakatiryakpretayamalokopapannā bhaveyuḥ |	འདི་ལྟ་སྟེ་། དཔེར་ན་། ཁམས་གསུམ་དུ་གཏོགས་པའི་སེམས་ཅན་ཐམས་ཅད་སེམས་ཅན་དམྱལ་བ་དང་། དུད་འགྲོ་དང་། ཡི་དབ༹གས་དང་། གཤིན་རྗེའི་འཇིག་རྟེན་དུ་སྐྱེས་པར་གྱུར་ལ་།
 atha gṛhī bodhisattvas tān sarvān narakatiryakpretayamalokād uddhṛtya pratyekabuddhatve pratiṣṭhāpayet |	དེ་ནས་བྱང་ཆུབ་སེམས་དཔའི་ཁྱིམ་པ་ཞིག་གིས་སེམས་ཅན་དེ་དག་ཐམས་ཅད་སེམས་ཅན་དམྱལ་བ་དང་། དུད་འགྲོ་དང་། ཡི་དབ༹གས་དང་། གཤིན་རྗེའི་འཇིག་རྟེན་ནས་བཏོན་ཏེ་རང་སངས་རྒྱས་ཉིད་ལ་བཀོད་པ་བས་ནི་།
 yo vānyo bodhisattvaḥ pravrajito 'ntaśas tiryagyonigate 'pi sattva ekam ālopaṃ dadyāt |	བྱང་ཆུབ་སེམས་དཔའ་རབ་ཏུ་བྱུང་བ་གཞན་གང་ཞིག་གིས་ཐ་༄༥༣༡བ་ན་དུད་འགྲོའི་སྐྱེ་གནས་སུ་སྐྱེས་པའི་སེམས་ཅན་ལ་སྦྱིན་པ་ཁམ་གཅིག་ཙམ་ཞིག་བྱིན་པར་གྱུར་ན་།
 ayaṃ tato bahutaram asaṃkhyeyataraṃ puṇyaṃ prasavayāt ||	དེ་ནི་། དེ་བས་ཆེས་བསོད་ནམས་མང་བ་དང་། ཆེས་བསོད་ནམས་གྲངས་མེད་པ་བསྐྱེད་པར་འགྱུར་རོ་༎ འཇམ་དཔལ་།
 (2) sacen mañjuśrīr daśasu dikṣu buddhakṣetrānabhilāpyakoṭīniyutaśatasahasraparamāṇurajaḥsamāḥ pravrajitā bodhisattvā bhaveyuḥ |	གལ་ཏེ་བྱང་ཆུབ་སེམས་དཔའ་རབ་ཏུ་བྱུང་བ་སངས་རྒྱས་ཀྱི་ཞིང་བཅུའི་རྡུལ་ཕྲ་རབ་ཀྱི་རྡུལ་སྙེད་ཅིག་བྱུང་བར་གྱུར་ལ༏་དེ་དག་ལས་བྱང་ཆུབ་སེམས་དཔའ་རེ་རེས་ཀྱང་ཕྱོགས་བཅུའི་ཕྱོགས་ཆ་རེ་རེར་སངས་རྒྱས་བཅོམ་ལྡན་འདས་སངས་རྒྱས་ཀྱི་ཞིང་བརྗོད་དུ་མེད་པ་བྱེ་བ་ཁྲག་ཁྲིག་འབུམ་ཕྲག་བཅུའི་རྡུལ་ཕྲ་རབ་ཀྱི་རྡུལ་སྙེད་དག་མཐོང་བར་གྱུར་ཅིང་། དེ་བཞིན་གཤེགས་པ་བྱང་ཆུབ་སེམས་དཔའ་དང་བཅས་།
 tata ekaiko bodhisattvo daśasu dikṣv ekaikasmin digbhāge daśabuddhakṣetrānabhilāpyakoṭīniyutaśatasahasraparamāṇurajaḥsamān buddhān bhagavataḥ paśyet | ekaikaṃ ca tathāgataṃ sabodhisattvaṃ saśrāvakaṃ daśasu buddhakṣetrānabhilāpyakoṭīniyutaśatasahasraparamaṇurajaḥsamān (jāa 83) kalpāṃś cīvarapiṇḍapātaśayanāsanaglānapratyayabhaiṣajyapariṣkārair upatiṣṭhet |	ཉན་ཐོས་དང་བཅས་པ་རེ་རེ་ལའང་བསྐལ་པ་སངས་རྒྱས་ཀྱི་ཞིང་བརྗོད་དུ་མེད་པ་བྱེ་བ་ཁྲག་ཁྲིག་འབུམ་ཕྲག་བཅུའི་རྡུལ་ཕྲ་རབ་ཀྱི་རྡུལ་སྙེད་དུ་ན་བཟའ་དང་། ཞལ་ཟས་དང་། གཟིམས་ཆ་དང་། གདན་དང་། སྙུན་གྱི་གསོས་སྨན་དང་། ཡོ་བྱད་རྣམས་ཀྱིས་ཀྱང་བསྙེན་བཀུར་བྱེད་ལ་།
 ekaikasya ca tathāgatasya divase divase buddhakṣetrānabhilāpyakoṭīniyutaśatasahasraparamāṇurajaḥsamān lokadhātūn vaśirājamaṇiratnapratipūrṇān kṛtvā dānaṃ dadyāt |	དེ་བཞིན་གཤེགས་པ་རེ་རེ་ལའང་ཉིན་གཅིག་བཞིན་དུ་འཇིག་རྟེན་གྱི་ཁམས་སངས་རྒྱས་ཀྱི་ཞིང་བརྗོད་དུ་མེད་པ་བྱེ་བ་ཁྲག་ཁྲིག་འབུམ་ཕྲག་བཅུའི་རྡུལ་ཕྲ་རབ་ཀྱི་རྡུལ་སྙེད་དག་ནོར་བུ་རིན་པོ་ཆེ་དབང་གི་རྒྱལ་པོས་ཡོངས་སུ་བཀང་སྟེ་དབུལ་བར་ཕུལ་བ་བས་༄༥༣༢ཨ་༌༎
 yo vānyo bodhisattvo 'smin dharmaparyāye 'dhimukto 'ntaśas tiryagyonigate 'pi sattva ekam ālopaṃ dadyāt | asya puṇyābhisaṃskārasya pūrvakaḥ puṇyābhisaṃskāras teṣāṃ bodhisattvānāṃ dānamayaḥ śatatamām api kalāṃ nopaiti, sahasratamām api, śatasahasratāmām api, saṃkhyām api, kalām api, gaṇanām api, upaniṣām api,	ན༏་བྱང་ཆུབ་སེམས་དཔའ་ཆོས་ཀྱི་རྣམ་གྲངས་འདི་ལ་མོས་པར་གྱུར་པ་གཞན་ཞིག་གིས་ཐ་ན་དུད་འགྲོའི་སྐྱེ་གནས་སུ་སྐྱེས་པའི་སེམས་ཅན་ལ་སྦྱིན་པ་ཁམ་གཅིག་ཙམ་ཞིག་བྱིན་པར་གྱུར་ན་། བསོད་ནམས་མངོན་པར་འདུ་བྱ་བ་དེ་ལ་བྱང་ཆུབ་སེམས་དཔའ་དེ་དག་གི་སྦྱིན་པ་ལས་བྱུང་བའི་བསོད་ནམས་མངོན་པར་འདུ་བྱ་བ་སྔ་། མ་དེས་ནི་། 
 upaniṣadam api na kṣamate |	བརྒྱའི་ཆར་ཡང་ཉེ་བར་མི་འགྲོའོ་༎ སྟོང་གི་ཆ་དང་། འབུམ་གྱི་ཆ་དང་། བྱེ་བ་ཕྲག་འབུམ་གྱི་ཆ་དང་། གྲངས་དང་། ཆ་དང་། བགྲང་བ་དང་། དཔེ་དང་། རྒྱུར་ཡང་ཉེ་བར་མི་འགྲོའོ་༎
 tat kasya hetoḥ |	དེ་ཅིའི་ཕྱིར་ཞེ་ན་། འཇམ་དཔལ་། འདི་ལྟ་སྟེ་།
 avaivartikānāṃ bodhisattvānām iyaṃ mudrā yadutāsya dharmaparyāyasya śravaḥ || §43 ms| 30b1-31a5, p| 332b4-333a4, d| 304a1-304b6, t| 357 249b6-249c19, t| 358 -, t| 359(W) 264b30-265a11|	ཆོས་ཀྱི་རྣམ་གྲངས་འདི་ཐོས་པ་ནི་། བྱང་ཆུབ་སེམས་དཔའ་ཕྱིར་མི་ལྡོག་པ་རྣམས་ཀྱི་ཕྱག་རྒྱ་ཡིན་པའི་ཕྱིར་རོ་༎
 (1) sacen mañjuśrīr bodhisattvo daśasu dikṣu sarvalokadhātuṣu sattvān śraddhānusāritve pratiṣṭhāpayet |	འཇམ་དཔལ་། གལ་ཏེ་བྱང་ཆུབ་སེམས་དཔའ་ལ་ལ་ཞིག་གིས་ཕྱོགས་བཅུའི་འཇིག་རྟེན་གྱི་ཁམས་ཀྱི་སེམས་ཅན་ཐམས་ཅད་དད་པའི་རྗེས་སུ་འབྲང་བ་ཉིད་ལ་བཀོད་པ་བས་ནི་། 
 yo vānyo bodhisattva ekaṃ sattvam arthānusāritve pratiṣṭhāpayet |	བྱང་ཆུབ་སེམས་དཔའ་གཞན་གང་ཞིག་གིས་སེམས་ཅན་གཅིག་ཅིག་དོན་གྱི་རྗེས་སུ་འབྲང་བ་ཉིད་ལ་བཀོད་པར་གྱུར་ན་།
 ayaṃ tato 'saṃkhyeyataraṃ puṇyaṃ prasavati ||	དེ་ནི་། དེ་བས་ཆེས་བསོད་ནམས་གྲངས་མེད་པ་བསྐྱེད་པར་༄༥༣༢བ་འགྱུར་རོ་༎ འཇམ་དཔལ་།
 (2) sacen mañjuśrīr bodhisattvo daśadikṣu sarvalokadhātuṣu sarvasattvān arthānusāritve pratiṣṭhāpayet |	གལ་ཏེ་བྱང་ཆུབ་སེམས་དཔའ་ལ་ལ་ཞིག་གིས་ཕྱོགས་བཅུའི་འཇིག་རྟེན་གྱི་ཁམས་ཀྱི་སེམས་ཅན་ཐམས་ཅད་དོན་གྱི་རྗེས་སུ་འབྲང་བ་ཉིད་ལ་བཀོད་པ་བས་ནི་། 
 yo vānyo bodhisattva ekaṃ sattvaṃ dharmānusāritve pratiṣṭhāpayet |	བྱང་ཆུབ་སེམས་དཔའ་གཞན་གང་ཞིག་གིས་སེམས་ཅན་གཅིག་ཅིག་ཆོས་ཀྱི་རྗེས་སུ་འབྲང་བ་ཉིད་ལ་བཀོད་པར་གྱུར་ན་།
 ayaṃ (jāa 84) tato 'saṃkhyeyataraṃ puṇyaṃ prasavati ||	དེ་ནི་། དེ་བས་ཆེས་བསོད་ནམས་གྲངས་མེད་པ་བསྐྱེད་པར་འགྱུར་རོ་༎ འཇམ་དཔལ་།
 (3) sacen mañjuśrīr bodhisattvo daśasu dikṣu sarvalokadhātuṣu sattvān dharmānusāritve pratiṣṭhāpayet |	གལ་ཏེ་བྱང་ཆུབ་སེམས་དཔའ་ལ་ལ་ཞིག་གིས་ཕྱོགས་བཅུའི་འཇིག་རྟེན་གྱི་ཁམས་ཀྱི་སེམས་ཅན་ཐམས་ཅད་ཆོས་ཀྱི་རྗེས་སུ་འབྲང་བ་ཉིད་ལ་བཀོད་པ་བས་ནི་། 
 yo vānyo bodhisattva ekaṃ sattvaṃ srotāpattiphale pratiṣṭhāpayet |	བྱང་ཆུབ་སེམས་དཔའ་གཞན་གང་ཞིག་གིས་སེམས་ཅན་གཅིག་ཅིག་རྒྱུན་དུ་ཞུགས་པའི་འབྲས་བུ་ལ་བཀོད་པར་གྱུར་ན་།
 ayaṃ tato 'saṃkhyeyataraṃ puṇyaṃ prasavati ||	དེ་ནི་། དེ་བས་ཆེས་བསོད་ནམས་གྲངས་མེད་པ་བསྐྱེད་པར་འགྱུར་རོ་༎ འཇམ་དཔལ་།
 (4) sacen mañjuśrīr bodhisattvo daśasu dikṣu sarvalokadhātuṣu sarvasattvān srota-āpattiphale pratiṣṭhāpayet |	གལ་ཏེ་བྱང་ཆུབ་སེམས་དཔའ་ལ་ལ་ཞིག་གིས་ཕྱོགས་བཅུའི་འཇིག་རྟེན་གྱི་ཁམས་ཀྱི་སེམས་ཅན་ཐམས་ཅད་རྒྱུན་དུ་ཞུགས་པའི་འབྲས་བུ་ལ་བཀོད་པ་བས་ནི་། 
 yo vānyo bodhisattva ekaṃ sattvaṃ sakṛdāgāmiphale pratiṣṭhāpayet |	བྱང་ཆུབ་སེམས་དཔའ་གཞན་གང་ཞིག་གིས་སེམས་ཅན་གཅིག་ཅིག་ལན་གཅིག་ཕྱིར་འོང་བའི་འབྲས་བུ་ལ་བཀོད་པར་གྱུར་པ་དེ་ནི་།
 ayaṃ tato 'saṃkhyeyataraṃ puṇyaṃ prasavati ||	དེ་བས་ཆེས་བསོད་ནམས་གྲངས་མེད་པ་བསྐྱེད་པར་འགྱུར་རོ་༎ ༄༥༣༣ཨ་༌༎ འཇམ་དཔལ་།
 (5) sacen mañjuśrīr bodhisattvo daśasu dikṣu sarvalokadhātuṣu sarvasattvān sakṛdāgāmiphale pratiṣṭhāpayet |	གལ་ཏེ་བྱང་ཆུབ་སེམས་དཔའ་ལ་ལ་ཞིག་གིས་ཕྱོགས་བཅུའི་འཇིག་རྟེན་གྱི་ཁམས་ཀྱི་སེམས་ཅན་ཐམས་ཅད་ལན་གཅིག་ཕྱིར་འོང་བའི་འབྲས་བུ་ལ་བཀོད་པ་བས་ནི་། 
 yo vānyo bodhisattva ekaṃ sattvam ānāgāmiphale pratiṣṭhāpayet |	བྱང་ཆུབ་སེམས་དཔའ་གཞན་གང་ཞིག་གིས་སེམས་ཅན་གཅིག་ཅིག་ཕྱིར་མི་འོང་བའི་འབྲས་བུ་ལ་བཀོད་པར་གྱུར་ན༏་དེ་ནི་།
 ayaṃ tato 'saṃkhyeyataraṃ puṇyaṃ prasavati ||	དེ་བས་ཆེས་བསོད་ནམས་གྲངས་མེད་པ་བསྐྱེད་པར་འགྱུར་རོ་༎ འཇམ་དཔལ་།
 (6) sacen mañjuśrīr bodhisattvo daśasu dikṣu sarvalokadhātuṣu sarvasattvān anāgāmiphale pratiṣṭhāpayet |	གལ་ཏེ་བྱང་ཆུབ་སེམས་དཔའ་ལ་ལ་ཞིག་གིས་ཕྱོགས་བཅུའི་འཇིག་རྟེན་གྱི་ཁམས་ཀྱི་སེམས་ཅན་ཐམས་ཅད་ཕྱིར་མི་འོང་བའི་འབྲས་བུ་ལ་བཀོད་པ་བས་ནི་། 
 yo (jāa 85) vānyo bodhisattva ekaṃ sattvaṃ arhatve pratiṣṭhāpayet |	བྱང་ཆུབ་སེམས་དཔའ་གཞན་གང་ཞིག་གིས་སེམས་ཅན་གཅིག་ཅིག་དགྲ་བཅོམ་པ་ཉིད་ལ་བཀོད་པར་གྱུར་ན་།
 ayaṃ tato 'saṃkhyeyataraṃ puṇyaṃ prasavati ||	དེ་ནི་། དེ་བས་ཆེས་བསོད་ནམས་གྲངས་མེད་པ་བསྐྱེད་པར་འགྱུར་རོ་༎ འཇམ་དཔལ་།
 (7) sacen mañjuśrīr bodhisattvo daśasu dikṣu sarvalokadhātuṣu sarvasattvān arhatve pratiṣṭhāpayet | yo vānyo bodhisattva ekaṃ sattvaṃ pratyekabuddhatve pratiṣṭhāpayet |	གལ་ཏེ་བྱང་ཆུབ་སེམས་དཔའ་ལ་ལ་ཞིག་གིས་ཕྱོགས་བཅུའི་འཇིག་རྟེན་གྱི་ཁམས་ཀྱི་སེམས་ཅན་ཐམས་ཅད་དགྲ་བཅོམ་པ་ཉིད་ལ་བཀོད་པ་བས་ནི་། བྱང་ཆུབ་སེམས་དཔའ་གཞན་གང་ཞིག་གིས་སེམས་ཅན་གཅིག་ཅིག་རང་སངས་རྒྱས་ཉིད་ལ་བཀོད་པར་། གྱུར་ན་། 
 ayaṃ tato 'saṃkhyeyataraṃ puṇyaṃ prasavati ||	དེ་ནི་། དེ་བས་ཆེས་བསོད་ནམས་གྲངས་མེད་པ་བསྐྱེད་པར་འགྱུར་༄༥༣༣བ་རོ༏་༏འཇམ་དཔལ་།
 (8) sacen mañjuśrīr bodhisattvo daśasu dikṣu sarvalokadhātuṣu sarvasattvān pratyekabuddhatve pratiṣṭhāpayet | yo vānyo bodhisattva ekaṃ sattvaṃ bodhicitte pratiṣṭhāpayet |	གལ་ཏེ་བྱང་ཆུབ་སེམས་དཔའ་གང་ལ་ལ་ཞིག་གིས་ཕྱོགས་བཅུའི་འཇིག་རྟེན་གྱི་ཁམས་ཀྱི་སེམས་ཅན་ཐམས་ཅད་རང་སངས་རྒྱས་ཉིད་ལ་བཀོད་པ་བས་ནི༏་བྱང་ཆུབ་སེམས་དཔའ་གཞན་གང་ཞིག་གིས་སེམས་ཅན་གཅིག་ཅིག་བྱང་ཆུབ་ཀྱི་སེམས་ལ་བཀོད་པར་གྱུར་ན་། 
 ayaṃ tato 'saṃkhyeyataraṃ puṇyaṃ prasavet ||	དེ་ནི་། དེ་བས་ཆེས་བསོད་ནམས་གྲངས་མེད་པ་བསྐྱེད་པར་འགྱུར་རོ་༎ འཇམ་དཔལ་།
 (9) sacen mañjuśrīr bodhisattvo daśasu dikṣu sarvalokadhātuṣu sarvasattvān bodhicitte pratiṣṭhāpayet | yo vānyo bodhisattva ekaṃ sattvam avaivartikatve pratiṣṭhāpayet |	གལ་ཏེ་བྱང་ཆུབ་སེམས་དཔའ་ལ་ལ་ཞིག་གིས་ཕྱོགས་བཅུའི་འཇིག་རྟེན་གྱི་ཁམས་ཀྱི་སེམས་ཅན་ཐམས་ཅད་བྱང་ཆུབ་ཀྱི་སེམས་ལ་བཀོད་པ་བས་ནི་། བྱང་ཆུབ་སེམས་དཔའ་གཞན་གང་ཞིག་གིས་སེམས་ཅན་གཅིག་ཅིག་ཕྱིར་མི་ལྡོག་པ་ཉིད་ལ་བཀོད་། པར་གྱུར་ན་། 
 ayaṃ tato bahutaraṃ puṇyaṃ prasavet || (jāa 86)	དེ་ནི་། དེ་བས་ཆེས་བསོད་ནམས་གྲངས་མེད་པ་བསྐྱེད་པར་འགྱུར་རོ་༎ འཇམ་དཔལ་།
 (10) sacen mañjuśrīr bodhisattvaḥ sarvasattvān avaivartikatve pratiṣṭhāpayet |	གལ་ཏེ་བྱང་ཆུབ་སེམས་དཔའ་ལ་ལ་ཞིག་གིས་ཕྱོགས་བཅུའི་འཇིག་རྟེན་གྱི་ཁམས་ཀྱི་སེམས་ཅན་ཐམས་ཅད་ཕྱིར་མི་ལྡོག་པ་ཉིད་ལ་བཀོད་པ་བས་ནི་། 
 yo vānyo bodhisattva imaṃ dharmaparyāyam adhimuktaḥ likhāpayitvā parebhyo vistareṇa saṃprakāśayet, antaśa ekaṃ sattvam apy asmin dharmaparyāye 'vatārayet |	བྱང་ཆུབ་སེམས་དཔའ་གཞན་གང་ཞིག་གིས་ཆོས་ཀྱི་རྣམ་གྲངས་འདི་ལ་མོས་ཤིང་ཡི་གེར་འབྲིར་བཅུག་ནས་གཞན་དག་ལ་རྒྱ་ཆེར་ཡང་དག་པར་སྟོན་པ་དང་། ཐ་ན་སེམས་ཅན་གཅིག་ཅིག་ཆོས་ཀྱི་རྣམ་གྲངས་འདི་ལ་འཇུག་པར་བྱས་ན་།
 ayaṃ tato bahutaraṃ puṇyaṃ prasavet ||	དེ་ནི་། དེ་བས་ཆེས་༄༥༣༤ཨ་༌༎ བསོད་ནམས་གྲངས་མེད་པ་བསྐྱེད་པར་འགྱུར་རོ་༎
 §44 ms| 31a5-32a3, p| 333a4-334a5, d| 304b6-305a7, t| 357 249c19-250a14, t| 358 253b23-253c18, t| 359(W) 265a12-265b24| atha khalu bhagavāṃs tasyāṃ velāyām imā gāthā abhāṣat |	དེ་ནས་དེའི་ཚེ་བཅོམ་ལྡན་འདས་ཀྱིས་ཚིགས་སུ་བཅད་པ་འདི་དག་བཀའ་སྩལ་ཏོ༏་༏བྱང་ཆུབ་སེམས་དཔའ་གང་ཞིག་ཟད་པའི་དུས་མཐའི་ཚེ་༎
 yo bodhisattvo daśabuddhakoṭināṃ saddharmaṃ dhārayet kṣayāntakāle |	སངས་རྒྱས་བྱེ་བ་ཕྲག་བཅུའི་དམ་ཆོས་འཛིན་པ་བས་༎
 sūtraṃ ca yo 'nyaḥ śṛṇuyāt sagauravād idaṃ tataḥ puṇyamahāntaṃ viśeṣayet || 1 ||	གང་ཞིག་མདོ་སྡེ་འདི་ནི་ཉན་པར་བྱེད་གྱུར་ན༏་༏དེ་ནི་དེ་བས་བསོད་ནམས་ཆེན་པོ་ཁྱད་པར་འཕགས་༎ 
 yo buddhakoṭīdaśa pūjayed ṛddhyā samākramya daśāsu dikṣu |	གང་ཞིག་རྫུ་འཕྲུལ་སྟོབས་ཀྱིས་ཕྱོགས་བཅུར་སོང་ནས་ནི་༎ སངས་རྒྱས་བྱེ་བ་ཕྲག་བཅུ་དག་ལ་མཆོད་བྱེད་ཅིང་༎
 vandāpayet sa puruṣāṃś ca sarvān kṛtvā kṛpāṃ sarvasukheṣv agṛddhaḥ || 2 || (jāa 87)	སྙིང་རྗེ་བསྐྱེད་དེ་བདེ་བ་ཀུན་ལ་ཆགས་མེད་པར་༎ སྐྱེས་བུ་དམ་པ་ཐམས་ཅད་ཕྱག་འཚལ་བཙུད་པ་བས་༎
 yaś cedaṃ sūtraṃ jinadharmasūcakaṃ parasya deśeta muhūrtakaṃ pi |	གང་ཞིག་བདེར་གཤེགས་བསྟན་ལ་སེམས་རབ་དད་གྱུར་ཅིང་༎ རྒྱལ་བའི་ཆོས་རྣམས་སྨོན་པར་བྱེད་པའི་མདོ་སྡེ་འདི་༎ གཞན་ལ་ཡུད་ཙམ་གཅིག་ཅིག་སྟོན་པར་བྱེད་གྱུར་ན་༎
 prasannacittaḥ sugatasya śāsana idaṃ tataḥ puṇyaphalaṃ viśiṣyate || 3 ||	དེ་ནི་དེ་བས་བསོད་ནམས་འབྲས་བུ་ཁྱད་པར་འཕགས་༎
 saṃdarśya sūtraṃ sugatapraveditaṃ pradīpabhūtaṃ marumānuṣāṇāṃ |	བདེ་གཤེགས་བསྟན་པའི་མདོ་སྡེ་སྒྲོན་མར་གྱུར་པ་འདི་༎ གང་གིས་ལྷ་དང་མི་ལ་ཡང་དག་བསྟན་༎
 sa tīkṣṇaprajñaś ca mahābalaś ca buddhāna bhūmiṃ labhate ca śīghram || 4 ||	བྱས་པ་དེ་ནི་ཤེས་རབ་རྣོ་ཞིང་མཐུ་ཆེན་ལྡན་གྱུར་ལ་༎ སངས་རྒྱས་རྣམས་ཀྱིས་ཡང་མྱུར་དུ་འཐོབ་པར་འགྱུར་༎
 kathāṃ śruṇitvā sugatānam īdṛśaṃ saṃśrāvayed yaś ca dvitīyasattve |	གང་གིས་བདེ་གཤེགས་སངས་རྒྱས་མི་མཆོག་དེ་དག་ནི་༎
 teṣāṃ ca buddhāna narottamānāṃ parinirvṛtānāṃ nirupādhiśeṣe || 5 ||	ཕུང་པོ་ལྷག་མ་མེད་༄༥༣༤བ་པར་ཡོངས་སུ་མྱ་ངན་ལས་༎ འདས་པར་གྱུར་བ་དག་གི་དེ་འདྲའི་སྒྲ་ཐོས་ནས་༎ སེམས་ཅན་གཞན་ལའང་ཡང་དག་སྒྲོག་པར་བྱེད་གྱུར་ཅིང་༎ མཆོད་རྟེན་གནམ་འཕང་མཐོ་བ་སྲིད་རྩེའི་མཐར་ཐུག་པ་༎ ཁྱོན་དང་ལྡན་པར་གྱུར་པའང་སྲིད་རྩེ་ཇི་བཞིན་པ་༎
 stūpān pratiṣṭhāpaya uccaśobhanān bhavāgraparyantasuratnacitrān | chatraiḥ patākais tatha ghaṇṭaśabdaiḥ pariṇāhavante hi yathā bhavāgram || 6 || (jāa 88)	རིན་ཆེན་མཛེས་པས་སྤྲས་ཤིང་གདུགས་དང་བ་དན་དང་༎ དེ་བཞིན་དྲིལ་སྒྲས་མཛེས་པར་བྱེད་དུ་གཅིག་གྱུར་པས་༎ འདི་ན་བྱང་ཆུབ་སེམས་དཔའ་གང་ཞིག་འདི་འདྲ་བའི་༎
 icche tv ayaṃ kaścid iha bodhisattvaḥ sūtraṃ śruṇitvā ima evarūpam |	མདོ་སྡེ་འདི་ཐོས་ལུས་ལ་གནས་པར་འགྱུར་བའམ་༎ གླེགས་བམ་བྲི་བ་བྱས་ཏེ་གཞག་པར་བྱེད་འདོད་ན་༎
 kāye pratiṣṭhāpayi pustake vā idaṃ tataḥ puṇyaphalaṃ viśiṣyate || 7 ||	དེ་ནི་དེ་ཡི་བསོད་ནམས་འབྲས་བུ་ཁྱད་པར་འཕགས་༎ སེར་སྣའི་དྲི་མ་བསལ་བར་གྱུར་ཅིང་འཇིགས་མེད་པའི་༎
 yo bodhisattvo imu dharmu dhārayed apanītamāccharyamalo viśāradaḥ |	བྱང་ཆུབ་སེམས་དཔའ་གང་ཞིག་ཆོས་འདི་འཛིན་བྱེད་ན་༎
 puṇyaṃ bhavet tasya hi aprameyaṃ labheta bodhiṃ ca yathepsitena || 8 ||	དེ་ཡི་བསོད་ནམས་དཔག་ཏུ་ཡོད་པར་མི་འགྱུར་ཏེ་༎ ཇི་ལྟར་འདོད་པ་བཞིན་དུ་བྱང་ཆུབ་ཐོབ་པར་འགྱུར་༎
 idaṃ hi sūtraṃ sugataiḥ praśastaṃ parigṛhītaṃ bahubodhisattvaiḥ |	མདོ་འདི་བདེ་བར་གཤེགས་པ་རྣམས་ཀྱིས་རབ་བསྔགས་ཤིང་༎ བྱང་ཆུབ་སེམས་དཔའ་མང་པོས་ཡོངས་སུ་བཟུང་བ་ཡིན་༎
 tathāgatānām iha-m-ātmabhāva ākāśadhātve hi sarveṣu darśitaḥ || 9 || (jāa 89) §45 ms| 31b6-32a3, p| 334a5-334a8, d| 305a5-8, t| 357 250a10-14, t| 358 253c14-18, t| 359(W) 265b20-24|	དེ་བཞིན་གཤེགས་པ་རྣམས་ཀྱི་སྐུ་ལུས་ནམ་མཁའ་ཡི་༎ ཁམས་དང་འདྲ་བ་ཐམས་ཅད་འདིར་ནི་བསྟན་པ་ཡིན་༎
 idam avocad bhagavān āttamanā āryamañjuśrīr bodhisattvaḥ,	བཅོམ་ལྡན་འདས་ཀྱིས་དེ་སྐད་ཅེས་བཀའ་སྩལ་ནས་བྱང་ཆུབ་སེམས་དཔའ་སེམས་དཔའ་ཆེན་པོ་འཇམ་དཔལ་གཞོན་ནུར་གྱུར་པ་དང་། བྱང་ཆུབ་སེམས་༄༥༣༥ཨ་༌༎
 te ca daśadiganantāparyantāśeṣalokadhātusaṃnipatitā bodhisattvā mahāsattvā iti ca mahāśrāvakāḥ sadevamānuṣāsuragandharvaś ca loko bhagavato bhāṣitam abhyanandann iti || || āryasarvabuddhaviṣayāvatārajñānālokālaṃkāra nāma mahāyānasūtraṃ samāptam || || ye dharmā hetuprabhavā hetuṃ teṣāṃ tathāgato hy avadat | teṣāṃ ca yo nirodha evaṃvādī mahāśramaṇaḥ ||	དཔའ་དང་། ཉན་ཐོས་ཆེན་པོ་གྲངས་མེད་པ་བསམ་གྱིས་མི་ཁྱབ་བརྗོད་དུ་མེད་པ་དག་དང་། ལྷ་དང་། མི་དང་། ལྷ་མ་ཡིན་དང་། ནམ་མཁའ་ལྡིང་དང་། དྲི་ཟར་བཅས་པའི་འཇིག་རྟེན་ཡི་རང་སྟེ་བཅོམ་ལྡན་འདས་ཀྱིས་གསུངས་པ་ལ་མངོན་པར་བསྟོད་དོ་༎ འཕགས་པ་སངས་རྒྱས་ཐམས་ཅད་ཀྱི་ཡུལ་ལ་འཇུག་པ་ཡེ་ཤེས་སྣང་བའི་རྒྱན་ཅེས་བྱ་བ་ཐེག་པ་ཆེན་པོའི་མདོ་རྫོགས་སོ་༎༎
 deyadharmo 'yaṃ pravaramahāyānayāyinaḥ bhikṣuśīladhvajasya ca tatra puṇyaṃ tad bhavatv ācāryopādhyāyamātāpitṛpūrvaṃgamaṃ kṛtvā sakalasattvarāśer anuttarajñānaphalāvāptaya iti ||	རྒྱ་གར་གྱི་མཁན་པོ་སུ་རེནདྲ་བོ་དྷི་དང་། ཞུ་ཆེན་གྱི་ལོ་ཙའ་བ་བནདྷེ་ཡེ་ཤེས་སྡེ་ལ་སོགས་པས་བསྒྱུར་ཅིང་ཞུས་ཏེ་གཏན་ལ་ཕབ་པ་། 
