skt	tib
 namo bhagavatyā āryaprajñāpāramitāyai ||	༄༢༨༨ཨ་། །རྒྱ་གར་སྐད་དུ་། ཨའརྱ་པྲཛཉའ་པ་ར་མི་ཏ་ན་ཡ་ཤ་ཏ་པ་ཉཙ་ཤ་ཏི་ཀའ་༎ བོད་སྐད་དུ་། འཕགས་པ་ཤེས་རབ་ཀྱི་ཕ་རོལ་ཏུ་ཕྱིན་པའི་ཚུལ་བརྒྱ་ལྔ་བཅུ་བ་༎ བཅོམ་ལྡན་འདས་ཤེས་རབ་ཀྱི་ཕ་རོལ་ཏུ་ཕྱིན་པ་ལ་ཕྱག་འཚལ་ལོ་༎
 aśp 1| evam mayā śrutam ekasmin samaye bhagavān sarvatathāgatavajrādhiṣṭhānasamayajñānavividhaviśeṣasamanvāgataḥ	འདི་སྐད་བདག་གིས་ཐོས་པའི་དུས་གཅིག་ན་།བཅོམ་ལྡན་འདས་དེ་བཞིན་གཤེགས་པ་ཐམས་ཅད་ཀྱིས་མཁྱེན་པའི་བྱེ་བྲག་རྣམ་པ་ཐ་དད་པ་དང་ལྡན་པ་། དེ་བཞིན་གཤེགས་པ་རིན་པོ་ཆེ་ཐམས་ཅད་ཀྱི་ཅོད་པན་གྱིས་།
 sarvatathāgataratnamukuṭatraidhātukābhiṣekaprāptaḥ sarvatathāgatasarvajñajñānamahāyogeśvaraḥ	ཁམས་གསུམ་དུ་དབང་བཅུ་རྫོགས་པ་། དེ་བཞིན་གཤེགས་པ་ཐམས་ཅད་ཀྱི་མ་། ཐམས་ཅད་མཁྱེན་པའི་ཡེ་ཤེས་དང་ལྡན་པ་།
 sarvatathāgatasarvamudrāsamatādhigato viśvakāryakaraṇatayāśeṣānavaśeṣasattvadhātusarvāśāparipūrisarvakarmakṛn	རྣལ་འབྱོར་ཅན་ཆེན་པོའི་དབང་ཕྱུག་། དེ་བཞིན་གཤེགས་པ་ཐམས་ཅད་ཀྱི་ཕྱག་རྒྱས་ཆོས་ཐམས་ཅད་ཀྱི་མཉམ་པ་ཉིད་ཐུགས་སུ་ཆུད་པ་། སྣ་ཚོགས་ཀྱི་བྱ་བ་མཛད་དེ་མ་ལུས་པ་ན་སེམས་ཅན་གྱི་ཁམས་ལུས་པ་མེད་པ་ཐམས་ཅད་ཀྱི་རེ་བ་ཐམས་ཅད་ཡོངས་སུ་བསྐང་བའི་འཕྲིན་ལས་མཛད་པ་། ཐུགས་རྗེ་ཆེན་པོ་རྣམ་པར་སྣང་མཛད་ཆེན་པོ་།
 mahāvairocanaḥ śāśvatas tryadhvasamatāsthitasarvakāyavākcittavajras tathāgataḥ sarvatathāgatādhyuṣitapraśastabhūṣite	རྟག་པ་ཁམས་གསུམ་༄༢༨༨བ་གྱི་མཉམ་པ་ཉིད་ལ་བཞུགས་པ་། སྐུ་དང་། གསུང་དང་། ཐུགས་ཐམས་ཅད་རྡོ་རྗེ་དེ་བཞིན་གཤེགས་པ་། ལྷའི་རྒྱལ་པོ་གཞན་འཕྲུལ་དབང་བྱེད་ཀྱི་གནས་༎ འདོད་པའི་ཁམས་ཐམས་ཅད་ན་།
 mahāmaṇiratnapratyupte vicitravarṇaghaṇṭāvasaktamārutoddhūtapaṭtapatākāsragdāmacāmarahārārdhahāracandropaśobhite sarvakāmadhātūpariparanirmitavaśavartino devarājasya bhavane vijahāra ||	ནོར་བུ་རིན་པོ་ཆེ་ཆེན་པོས་རབ་ཏུ་སྤྲས་པ་དང་། བ་དན་ཁ་དོག་སྣ་ཚོགས་དྲིལ་བུ་བརྒྱུས་པ་རླུང་གིས་བསྐྱོད་པ་དང་། མེ་ཏོག་གི་ཕྲེང་བ་དང་། རྔ་མ་དང་། རྒྱན་ཕྲེང་དང་། ཆུན་འཕྱང་དང་། ཟླ་བ་ལྟ་བུས་མཛེས་པར་བྱས་པ་༎ དེ་བཞིན་གཤེགས་པ་ཐམས་ཅད་བཞུགས་པ་། ཤེས་པ་བསྟོད་པ་ན་།
 aśp 2| aṣṭābhir bodhisattvakoṭībhiḥ sārdham | tadyathā vajrapāṇinā ca bodhisattvena mahāsattvena | avalokiteśvareṇa ca bodhisattvena mahāsattvena | ākāśagarbheṇa ca bodhisattvena mahāsattvena | vajramuṣṭinā ca bodhisattvena mahāsattvena | mañjuśriyā ca bodhisattvena mahāsattvena | sahacittotpāditadharmacakrapravartinā ca bodhisattvena mahāsattvena | gaganagañjena ca bodhisattvena mahāsattvena | sarvamārabalapramardinā ca bodhisattvena mahāsattvena ||	བྱང་ཆུབ་སེམས་དཔའ་བྱེ་བ་ཕྲག་བརྒྱ་དང་ཐབས་ཅིག་ཏུ་བཞུགས་པ་ལ་འདི་ལྟ་སྟེ་། བྱང་ཆུབ་སེམས་དཔའ་སེམས་དཔའ་ཆེན་པོ་ལག་ན་རྡོ་རྗེ་དང་། སྤྱན་རས་གཟིགས་དབང་ཕྱུག་དང་། ནམ་མཁའི་སྙིང་པོ་དང་། རྡོ་རྗེ་ཁུ་ཚུར་དང་། འཇམ་དཔལ་དང་། སེམས་བསྐྱེད་མ་ཐག་ཏུ་ཆོས་ཀྱི་འཁོར་ལོ་བསྐོར་བ་དང་། ནམ་མཁའ་མཛོད་དང་། བྱང་ཆུབ་སེམས་དཔའ་སེམས་དཔའ་ཆེན་པོ་བདུད་ཀྱི་སྟོབས་ཐམས་ཅད་རབ་ཏུ་འཇོམས་པ་དང་། དེ་དག་ལ་སོགས་པ་བྱང་ཆུབ་སེམས་དཔའ་བྱེ་བ་ཕྲག་བརྒྱ་དང་ཐབས་ཅིག་སྟེ་།
 aśp 3| evaṃ pramukhābhir aṣṭābhir bodhisattvakoṭībhiḥ parivṛtaḥ puraskṛto dharmaṃ deśayati sma | ādau kalyāṇaṃ madhye kalyāṇaṃ paryavasāne kalyāṇaṃ svarthaṃ suvyañjanam kevalaṃ paripūrṇaṃ pariśuddhaṃ paryavadātaṃ sarvadharmaviśuddhimukhaṃ brahmacaryam saṃprakāśayati sma ||	ཡོངས་སུ་བསྐོར་ཅིང་མདུན་གྱིས་བལྟས་ནས་ཆོས་སྟོན་ཏེ་།
 aśp 4| yad uta sarvadharmasvabhāvaviśuddhimukhaṃ nama	ཤེས་རབ་ཀྱི་ཕ་རོལ་ཏུ་ཕྱིན་པའི་ཚུལ་ཆོས་ཐམས་ཅད་ཀྱི་ངོ་བོ་ཉིད་རྣམ་པར་དག་པའི་སྒོ་ཞེས་བྱ་བ་། ཐོག་མར་དགེ་བ་། བར་དུ་༄༢༨༩ཨ་༌༎ དགེ་བ་། ཐ་མར་དགེ་བ་། དོན་བཟང་པོ་། ཚིག་འབྲུ་བཟང་པོ་། མ་འདྲེས་པ་། ཡོངས་སུ་རྫོགས་པ་། ཡོངས་སུ་བྱང་བ་།
 prajñāpāramitānayaṃ deśayati sma | tadyathā (1) surataviśuddhipadam etad yat uta bodhisattvapadam |	ཡང་དག་པར་སྟོན་ཏེ་། འདི་ལྟར་རབ་ཏུ་དགའ་བ་རྣམ་པར་དག་པའི་གནས་དེ་ནི་།
 (2) rāgavāṇaviśuddhipadam etad yad uta bodhisattvapadam |	འདི་ལྟ་སྟེ་། བྱང་ཆུབ་སེམས་པའི་གནས་སོ་༎ འདོད་ཆགས་ཀྱི་མཐའ་རྣམ་པར་དག་པའི་གནས་དེ་ནི་༎
 (3) dveṣavahniviśuddhipadam etad yad uta bodhisattvapadam |	འདི་ལྟ་སྟེ་། བྱང་ཆུབ་སེམས་དཔའི་གནས་སོ་༎ རེག་པ་རྣམ་པར་དག་པའི་གནས་དེ་ནི་།
 (4) snehabandhanaviśuddhipadam etad yad uta bodhisattvapadam | (5) sarvaiśvaryādhipatyaviśuddhipadam etad yad uta bodhisattvapadam |	འདི་ལྟ་སྟེ་། བྱང་ཆུབ་སེམས་དཔའི་གནས་སོ་༎ སྡུག་པའི་འཆིང་བ་རྣམ་པར་དག་པའི་གནས་སོ་༎
 (6) dṛṣṭiviśuddhipadam etad yad uta bodhisattvapadam | (7) rativiśuddhipadam	ལྟ་བ་རྣམ་པར་དག་པའི་གནས་དེ་ནི་། འདི་ལྟ་སྟེ་། བྱང་ཆུབ་སེམས་དཔའི་གནས་སོ་༎ དགའ་བ་རྣམ་པར་དག་པའི་གནས་དེ་ནི་༎
 etad yad uta bodhisattvapadam |	འདི་ལྟ་སྟེ་། བྱང་ཆུབ་སེམས་དཔའི་གནས་སོ་༎
 (8) tṛṣṇāviśuddhipadam etad yad uta bodhisattvapadam |	སྲེད་པ་རྣམ་པར་དག་པའི་གནས་དེ་ནི་༎ འདི་ལྟ་སྟེ་། བྱང་ཆུབ་སེམས་དཔའི་གནས་སོ་༎
 (9) garvaviśuddhipadam etad yad uta bodhisattvapadam |	བསྙེམས་པ་རྣམ་པར་དག་པའི་གནས་དེ་ནི་འདི་ལྟ་སྟེ་། བྱང་ཆུབ་སེམས་དཔའི་གནས་སོ་༎
 (10) bhūṣaṇaviśuddhipadam etad yad uta bodhisattvapadam |	རྒྱན་རྣམ་པར་དག་པའི་གནས་དེ་ནི་།
 (11) manohlādanaviśuddhipadam etad yad uta bodhisattvapadam |	འདི་ལྟ་སྟེ་། བྱང་ཆུབ་སེམས་དཔའི་གནས་སོ་༎ ཡིད་ཚིམ་པར་བྱེད་པ་line missing?་༄༢༨༩བ་རྣམ་པར་དག་པའི་གནས་དེ་ནི་།
 (12) ālokaviśuddhipadam etad yad uta bodhisattvapadam | (13) kāyaviśuddhipadam etad yad uta bodhisattvapadam |	འདི་ལྟ་སྟེ་། བྱང་ཆུབ་སེམས་དཔའི་གནས་སོ་༎ སྣང་བ་རྣམ་པར་དག་པའི་གནས་དེ་ནི་།
 (14) kāyasukhaviśuddhipadam etad yad uta bodhisattvapadam |	འདི་ལྟ་སྟེ་། བྱང་ཆུབ་སེམས་དཔའི་གནས་སོ་༎ ལུས་བདེ་བ་རྣམ་པར་དག་པའི་གནས་དེ་ནི་།
 (15) rūpaviśuddhipadam etad yad uta bodhisattvapadam |	འདི་ལྟ་སྟེ་། བྱང་ཆུབ་སེམས་དཔའི་གནས་སོ་༎ གཟུགས་རྣམ་པར་དག་པའི་གནས་དེ་ནི་།
 (16) śabdaviśuddhipadam etad yad uta bodhisattvapadam |	འདི་ལྟ་སྟེ་། བྱང་ཆུབ་སེམས་དཔའི་གནས་སོ་༎ སྒྲ་རྣམ་པར་དག་པའི་གནས་དེ་ནི་།
 (17) gandhaviśuddhipadam etad yad uta bodhisattvapadam |	འདི་ལྟ་སྟེ་། བྱང་ཆུབ་སེམས་དཔའི་གནས་སོ་༎ དྲི་རྣམ་པར་དག་པའི་གནས་དེ་ནི་།
 (18) rasaviśuddhipadam etad yad uta bodhisattvapadam | (19) sparśaviśuddhipadam etad yad uta bodhisattvapadam |	འདི་ལྟ་སྟེ་། བྱང་ཆུབ་སེམས་དཔའི་གནས་སོ༏་༏རོ་རྣམ་པར་དག་པའི་གནས་དེ་ནི་།
 (20) dharmaviśuddhipadam etad yad uta bodhisattvapadam |	འདི་ལྟ་སྟེ་། བྱང་ཆུབ་སེམས་དཔའི་གནས་སོ་༎ རེག་རྣམ་པར་དག་པའི་གནས་དེ་ནི་།
 tat kasya hetoḥ |	འདི་ལྟ་སྟེ་། བྱང་ཆུབ་སེམས་དཔའི་གནས་སོ༏་༏དེ་ཅིའི་ཕྱིར་ཞེ་ན་།
 tathā hi sarvadharmāḥ svabhāvaviśuddhāḥ sarvadharmāsvabhāvatayā prajñāpāramitāviśuddhiteti ||	འདི་ལྟར་ཆོས་ཐམས་ཅད་ནི་ངོ་བོ་ཉིད་ཀྱི་རྣམ་པར་དག་པ་སྟེ་། ཆོས་ཐམས་ཅད་ཀྱི་ངོ་བོ་ཉིད་ཀྱི་སྟོང་པ་ཉིད་པས་། ཤེས་རབ་ཀྱི་ཕ་རོལ་ཏུ་ཕྱིན་པ་ཡོངས་སུ་དག་པའོ་༎
 aśp 5| yaḥ kaścid vajrapāṇe imaṃ sarvadharmasvabhāvaviśuddhipadanirhāranāmadheyaṃ	ལག་ན་རྡོ་རྗེ་༎ སུ་ལ་ལས་ཆོས་ཐམས་ཅད་ཀྱི་ངོ་བོ་ཉིད་རྣམ་པར་དག་པའི་སྒོ་སྒྲུབ་པའི་ཤེས་རབ་ཀྱི་ཕ་རོལ་ཏུ་ཕྱིན་པའི་ཚུལ་འདི་ལན་གཅིག་ཐོས་ན་ཡང་། 
 prajñāpāramitānayaṃ sakṛd api śroṣyati tasyā bodhimaṇḍāt sarvajñeyāvaraṇakleśāvaraṇakarmāvaraṇāni	དེ་བྱང་ཆུབ་ཀྱི་སྙིང་པོའི་བར་དུ་སྒྲིབ་པ་ཐམས་ཅད་དང་། ཆོད་པ་དང་། ཉོན་མོངས་པའི་སྒྲིབ་པ་དང་། ཆོས་ཀྱི་སྒྲིབ་པ་དང་། ལས་ཀྱི་སྒྲིབ་པ་ཆེན་པོ་བསགས་ཀྱང་༄༢༩༠ཨ་༌༎
 mahānty apy upacinvato na kadācid api narakādyapāyopapattir bhaviṣyati |	སེམས་ཅན་དམྱལ་བ་ལ་སོགས་པ་ངན་སོང་དུ་ནམ་ཡང་སྐྱེ་བར་མི་འགྱུར་།
 pāpāni ca kṛtamātrāṇy aduḥkhataḥ kṣayaṃ yāsyanti | yaś ca dhārayiṣyati dine dine vācayiṣyati svādhyāyiṣyati yoniśaś ca manasikariṣyati sa ihaiva janmani sarvadharmasamatāvajrasamādhipratilambhāt sarvadharmeśvaro bhaviśyati |	སྡིག་པ་ཡང་བྱས་མ་ཐག་ཏུ་སྡུག་བསྔལ་མེད་པར་བྱང་བར་འགྱུར་རོ༏་༏སུ་ཞིག་འཛིན་པ་དང་། ཉིན་རེ་བཞིན་ཀློག་པ་དང་། ཁ་ཏོན་བྱེད་པ་དང་། ཚུལ་བཞིན་ཡིད་ལ་བྱེད་པ་དེ་ཚེ་འདི་ཉིད་ལ་ཆོས་ཐམས་ཅད་ཀྱི་མཉམ་པ་ཉིད་རྡོ་རྗེའི་ཏིང་ངེ་འཛིན་ཐོབ་པས་། ཆོས་ཐམས་ཅད་ལ་དབང་བསྒྱུར་བར་འགྱུར་རོ་༎
 sarvaratiprītiprāmodyāny anubhaviṣyati |	ཆོས་ཐམས་ཅད་ལ་དགའ་བ་དང་། མགུ་བ་དང་། མཆོག་ཏུ་དགའ་བ་མྱོང་བར་འགྱུར་རོ་༎
 ṣoḍaśame mahābodhisattvajanmani tathāgatatvaṃ pratilapsyate vajradharatvaṃ ceti ||	བྱང་ཆུབ་སེམས་དཔའ་ཆེན་པོའི་ཚེ་བཅུ་དྲུག་གིས་དེ་བཞིན་གཤེགས་པ་འམ་། རྡོ་རྗེ་འཛིན་ཐོབ་པར་འགྱུར་རོ་༎
 aśp 6| atha bhagavān sarvatathāgatamahāyānābhisamayaḥ sarvamaṇḍalaḥ sakalavajradhātvagryasattvaḥ	དེ་ནས་བཅོམ་ལྡན་འདས་ལག་ན་རྡོ་རྗེ་དེ་བཞིན་གཤེགས་པ་ཐམས་ཅད་པ་། ཐེག་པ་ཆེན་པོ་མངོན་པར་རྟོགས་པ་། དཀྱིལ་འཁོར་ཐམས་ཅད་པ་༎
 sakalatraidhātukasarvatrilokavijayy aśeṣānavaśeṣasattvadhātuvinayanasamarthaḥ sarvārthasiddhaḥ	རྡོ་རྗེ་འཛིན་མཐའ་དག་གི་སེམས་ཅན་གྱི་མཆོག་ཁམས་གསུམ་མ་ལུས་པ་དག་ན༏་འཇིག་རྟེན་གསུམ་པོ་ཐམས་ཅད་ལས་རྣམ་པར་རྒྱལ་བ་། སེམས་ཅན་གྱི་ཁམས་ལུས་པ་མེད་པ་འདུལ་བ་། དོན་ཐམས་ཅད་གྲུབ་པ་།
 sarvavajrapāṇir mahāsamayo 'nekavajramahāguhyasattvaparivāra imam eva prajñāpāramitānayārtham	དམ་ཚིག་ཆེན་པོ་པ་། རྡོ་རྗེ་གསང་བའི་སེམས་ཅན་དུ་མས་ག-ཡོག་བྱས་པ་དེ་ཤེས་རབ་ཀྱི་ཕ་རོལ་ཏུ་ཕྱིན་པའི་ཚུལ་གྱི་དོན་འདི་སྟོན་ཏེ་། བཞིན་རབ་ཏུ་འཛུམ་ཞིང་ལག་པ་ག-ཡོན་པ་རྡོ་རྗེ་བསྒྱིངས་༄༢༩༠བ་ཏེ་། ཐོག་མའི་རྡོ་རྗེ་ཆེན་པོ་གསོར་ནས་།
 udyotayan prahasitavadanas tad ādyaṃ mahāvajram vāmagarvollālanatayā svahṛdyutkarṣaṇayogena	རང་གི་སྙིང་གར་གཏོད་པའི་ཚུལ་གྱིས་འཛིན་ཅིང་།
 dhārayann idam mahāsukhavajrāmoghasamayaṃ nāma svatattvahṛdayam	བདེ་བ་ཆེན་པོ་རྡོ་རྗེ་དོན་ཡོད་པའི་དམ་ཚིལ་གཅེས་བྱ་བ་རང་གི་དེ་ཁོ་ན་ཉིད་ཀྱི་སྙིང་པོ་འདི་སྨྲས་སོ་༎
 agāt* hūṃ ||	ཧའུམ། 
 aśp 7| atha bhagavān vairocanas tathāgataḥ punar apīmaṃ prajñāpāramitānayaṃ sarvatathāgatavajradharmatābhisaṃbodhinirhāraṃ nāma deśayati sma	དེ་ནས་བཅོམ་ལྡན་འདས་དེ་བཞིན་གཤེགས་པ་རྣམ་པར་སྣང་མཛད་ཀྱིས་ཡང་དེ་བཞིན་གཤེགས་པ་ཐམས་ཅད་ཀྱི་མཉམ་པ་ཉིད་མངོན་པར་རྫོགས་པར་བྱང་ཆུབ་པར་སྒྲུབ་པ་ཞེས་བྱ་བ་ཤེས་རབ་ཀྱི་ཕ་རོལ་ཏུ་ཕྱིན་པའི་ཚུལ་འདི་བཤད་དོ་༎
 vajrasamatābhisaṃbodho mahābodhir vajradṛḍhatayā |	རྡོ་རྗེ་སྲ་བ་ཉིད་ཀྱིས་ཕྱིར་། རྡོ་རྗེ་མཉམ་པ་ཉིད་མངོན་པར་རྫོགས་པར་བྱང་ཆུབ་པ་ནི༏་བྱང་ཆུབ་ཆེན་པོའོ་༎
 arthasamatābhisaṃbodho mahābodhir ekārthatayā |	དོན་གཅིག་པའི་ཕྱིར་དོན་གྱི་མཉམ་པ་ཉིད་མངོན་པར་རྫོགས་པར་བྱང་ཆུབ་པ་ནི་། བྱང་ཆུབ་ཆེན་པོའོ་༎
 dharmasamatābhisaṃbodho mahābodhiḥ sarvadharmaviśuddhitayā |	ངོ་བོ་ཉིད་ཀྱིས་རྣམ་པར་དག་པའི་ཕྱིར་ཆོས་ཀྱི་མཉམ་པ་ཉིད་མངོན་པར་རྫོགས་པར་བྱང་ཆུབ་པ་ནི་། བྱང་ཆུབ་ཆེན་པོའོ་༎
 sarvasamatābhisaṃbodho mahābodhiḥ sarvadharmasvabhāvāvikalpatayeti ||	ཐམས་ཅད་ལ་རྣམ་པར་མི་རྟོག་པའི་ཕྱིར་། ཐམས་ཅད་ཀྱི་མཉམ་པ་ཉིད་མངོན་པར་རྫོགས་པར་བྱང་ཆུབ་པ་ནི་། བྱང་ཆུབ་ཆེན་པོའོ་༎
 aśp 8| yaḥ kaścid vajrapāṇe imāṃś caturo dharmavihārāñ śroṣyati dhārayiṣyati vācayiṣyati bhāvayiṣyati sa sarvapāpasamācāro 'pi sarvāpāyasamatikrānto bhaviṣyaty ā bodhimaṇḍāt* |	ལག་ན་རྡོ་རྗེ་། སུ་ལ་ལ་ཆོས་མངོན་པར་སྒྲུབ་པ་བཞི་པོ་འདི་དག་ཉན་པ་དང་། འཛིན་པ་དང་། ཀློག་པ་དང་། སྒོམ་པ་དེ་སྡིག་པ་ཐམས་ཅད་སྤྱོད་ཀྱང་། བྱང་ཆུབ་ཀྱི་སྙིང་པོ་ལ་འདུག་གི་བར་དུ་ངན་སོང་ཐམས་ཅད་ལས་ཡང་དག་པར་འདས་པར་འགྱུར་རོ་༎ 
 kṣipraṃ cānuttarāṃ samyaksaṃbodhim abhisaṃbhotsyata iti ||	མྱུར་དུ་བླ་ན་མེད་པ་ཡང་དག་པར་༄༢༩༡ཨ་༌༎ རྫོགས་པའི་བྱང་ཆུབ་ཏུ་མངོན་པར་རྫོགས་པར་འཚང་རྒྱ་བར་འགྱུར་རོ་༎
 aśp 9| athedam uktvā bhagavāñ jñānamuṣṭiparigraha idam evārthapadaṃ bhūyasyā mātrayoddīpayan smitamukha idaṃ sarvadharmasamatāhṛdayam abhāṣata | vajra āḥ ||	དེ་ནས་དེ་སྐད་ཅེས་བཀའ་སྩལ་ནས་བཅོམ་ལྡན་འདས་ཡེ་ཤེས་ཀྱི་ཁུ་ཚུར་ཡོངས་སུ་འཛིན་པ་། དོན་གནས་འདི་ཉིད་རྒྱ་ཆེར་སྟོན་ཅིང་། བཞིན་རབ་ཏུ་འཛུམ་དམུལ་ཏེ་།
 aśp 10| atha bhagavān sarvaduṣṭavinayanaśākyamunis tathāgataḥ punar api sarvadharmasamatāvijayasaṅgrahaṃ nāma prajñāpāramitānirhāram abhāṣata	ཆོས་ཐམས་ཅད་ཀྱི་མཉམ་པ་ཉིད་ཀྱི་སྙིང་པོ་རབ་ཏུ་སྨྲས་སོ་༎ ཨཨ༏་དེ་ནས་མ་རུངས་པ་ཐམས་ཅད་འདུལ་བ་བཅོམ་ལྡན་འདས་དེ་བཞིན་གཤེགས་པ་ཤའཀྱ་ཐུབ་པས་ཀྱང་ཡང་ཆོས་ཐམས་ཅད་ཀྱི་མཉམ་པ་ཉིད་ཀྱིས་རྣམ་པར་རྒྱལ་བ་བསྡུ་བ་ཞེས་བྱ་བ་ཤེས་རབ་ཀྱི་ཕ་རོལ་ཏུ་ཕྱིན་པ་སྒྲུབ་པ་འདི་བཤད་དེ་། 
 rāgāprapañcatayā dveṣāprapañcatā |	འདོད་ཆགས་ཀྱི་སྤྲོས་པ་མེད་པ་ཉིད་ཀྱིས་ཞེ་སྡང་གི་སྤྲོས་པ་མེད་པ་ཉིད་བཤད་དེ་། དོ་༎ 
 dveṣāprapañcatayā mohāprapañcatā |	ཞེ་སྡང་གི་སྤྲོས་པ་མེད་པ་ཉིད་ཀྱིས་གཏི་མུག་གི་སྤྲོས་པ་མེད་བཤད་དེ་། 
 mohāprapañcatayā sarvadharmāprapañcatā |	དོ་༎ པ་ཉིད་དོ་༎ གཏི་མུག་གི་སྤྲོས་པ་མེད་པ་ཉིད་ཀྱིས་ཆོས་ཐམས་ཅད་སྤྲོས་པ་མེད་པ་ཉིད་དོ་༎
 sarvadharmāprapañcatayā prajñāpāramitāprapañcatā veditavyeti ||	ཆོས་ཐམས་ཅད་ཀྱི་སྤྲོས་པ་མེད་པ་ཉིད་ཀྱིས་ཤེས་རབ་ཀྱི་ཕ་རོལ་ཏུ་ཕྱིན་པ་སྤྲོས་པ་མེད་པ་ཉིད་དུ་རིག་པར་བྱའོ་༎ ལག་ན་རྡོ་རྗེ་།
 aśp 11| yaḥ kaścid vajrapāṇe imaṃ prajñāpāramitānayaṃ śroṣyati dhārayiṣyati vācayiṣyati bhāvayiṣyati tasya traidhātukopapannān api sarvasattvān prapātayato nāpāyagamanaṃ bhaviṣyati vinayavaśam upādāya |	སུ་ལ་ལ་ཤེས་རབ་ཀྱི་ཕ་རོལ་ཏུ་ཕྱིན་པའི་ཚུལ་འདི་ཉན་པ་དང་། འཛིན་པ་དང་། ཀློག་པ་དང་། སྒོམ་པ་ངེས་འདུལ་བའི་དབང་གི་ཕྱིར་ཁམས་གསུམ་དུ་སྐྱེས་པའི་སེམས་ཅན་ཐམས་ཅད་བསད་ཀྱང་ངན་སོང་དུ་འགྲོ་བར་མི་འགྱུར་ཏེ་།
 kṣipraṃ cānuttarāṃ samyaksaṃbodhim abhisaṃbhotsyata iti ||	མྱུར་དུ་བླ་ན་མེད་པ་ཡང་དག་༄༢༩༡བ་པར་རྫོགས་པའི་བྱང་ཆུབ་ཏུ་མངོན་པར་རྫོགས་པར་འཚང་རྒྱ་བར་ཡང་འགྱུར་རོ་༎
 aśp 12| atha vajrapāṇir imam eva dharmatārthaṃ bhūyasyā mātrayoddīpayaṃs trilokavijayavajrāṃ	དེ་ནས་བཅོམ་ལྡན་འདས་ལག་ན་རྡོ་རྗེ་ཆོས་ཉིད་འདིའི་དོན་རྒྱ་ཆེན་པོ་སྟོན་ཏེ་། འཇིག་རྟེན་གསུམ་ལས་རྣམ་པར་རྒྱལ་བའི་རྡོ་རྗེ་ཞེས་བྱ་བའི་ཕྱག་རྒྱ་བཅིངས་ནས་ཁྲོ་གཉེར་དང་བཅས་ཤིང་སྨིན་མ་བཏེག་སྟེ་། འབར་བར་ལྟ་ལ་པདམའི་གདོང་ཁྲོ་ཞིང་དགོད་དེ་།
 nāma mudrāṃ baddhvā sabhrukuṭibhrūbhaṅgadīptadṛṣṭivihasitaruṣiteṣaddaṃṣṭrākarālavadanakamalaḥ	མཆེ་བ་གཙིགས་ནས་རྐང་པ་ག-ཡོན་པ་བརྐྱང་བའི་ཚུལ་དུ་གནས་པས་གནས་ནས་།
 pratyālīḍhasthānastha idaṃ vajrahūṃkāraṃ nāma hṛdayam abhāṣata | vajra hūṃ ||	རྡོ་རྗེ་ཧའུམ་ཞེས་བྱ་བའི་སྙིང་པོ་འདི་སྨྲས་སོ་༎ ཧའུམ། 
 aśp 13| atha bhagavān svabhāvaviśuddhadharmatāprāptas tathāgataḥ punar apīmaṃ sarvadharmasamatāvalokiteśvarajñānamudraṃ nāma prajñāpāramitānayārtham abhāṣata |	དེ་ནས་བཅོམ་ལྡན་འདས་དེ་བཞིན་གཤེགས་པ་ངེ་བོ་ཉིད་དག་པའི་ཆོས་ཉིད་ཐོབ་པས་། ཡང་ཆོས་ཐམས་ཅད་ཀྱི་མཉམ་པ་ཉིད་སྤྱན་རས་གཟིགས་དབང་ཕྱུག་གི་ཡེ་ཤེས་ཀྱི་ཕྱག་རྒྱ་ཞེས་བྱ་བ་། 
 sarvarāgaviśuddhitā loke sarvadveṣaviśuddhitāyai saṃvartate |	ཤེས་རབ་ཀྱི་ཕ་རོལ་ཏུ་ཕྱིན་པའི་ཚུལ་འདི་བཤད་དེ༏་འདོད་ཆགས་ཐམས་ཅད་རྣམ་པར་དག་པས་འཇིག་རྟེན་ན་ཞེ་སྡང་ཐམས་ཅད་རྣམ་པར་དག་པར་འགྱུར་རོ་༎
 sarvamalaviśuddhitā loke sarvapāpaviśuddhitāyai saṃvartate |	དྲི་མ་ཐམས་ཅད་རྣམ་པར་དག་པས་འཇིག་རྟེན་ན་སྡིག་པ་ཐམས་ཅད་རྣམ་པར་དག་པར་འགྱུར་རོ་༎ 
 sarvadharmaviśuddhitā loke sarvasattvaviśuddhitāyai saṃvartate |	ཆོས་ཐམས་ཅད་རྣམ་པར་དག་པས་འཇིག་རྟེན་ན་སེམས་ཅན་ཐམས་ཅད་རྣམ་པར་དག་པར་རོ་༎ འགྱུར་རོ་༎ 
 sarvajñānaviśuddhitā loke prajñāpāramitāviśuddhitāyai saṃvartate ||	ཤེས་པ་ཐམས་ཅད་རྣམ་པར་དག་བས་འཇིག་རྟེན་ན་ཤེས་རབ་ཀྱི་ཕ་རོལ་ཏུ་ཕྱིན་པ་རྣམ་པར་དག་པར་འགྱུར་རོ་རོ་༎ འགྱུར་རོ་༎ ༎ ལག་ན་རྡོ་རྗེ་།
 aśp 14| yaḥ kaścid vajrapāṇe imaṃ nayaṃ śroṣyati dhārayisyati vācayiṣyati bhāvayiṣyati sa sarvarāgamadhyasthito 'pi padmam iva rāgadoṣair na malair āgantukair lepaṃ yāsyati |	སུ་ལ་ལ་ཤེས་རབ་ཀྱི་ཕ་རོལ་ཏུ་ཕྱིན་པའི་ཚུལ་འདི་ཉན་པ་༄༢༩༢ཨ་༌༎ དང་། འཛིན་པ་དང་། ཀློག་པ་དང་། སྒོམ་པ་དེ་འདོད་ཆགས་དང་། དྲི་མ་ཐམས་ཅད་ཀྱི་ནང་ན་འདུག་ཀྱང་པདམ་ལྟ་བུར་འདོད་ཆགས་ཀྱི་ཉེས་པ་རྣམས་དང༏་དྲི་མ་རྣམས་དང་། གློ་བུར་གྱི་ཉོན་མོངས་པ་རྣམས་ཀྱིས་གོས་པར་མི་འགྱུར་ཏེ་།
 kṣipraṃ cānuttarāṃ samyaksaṃbodhim abhisaṃbhotsyata iti ||	མྱུར་དུ་བླ་ན་མེད་པ་ཡང་དག་པར་རྫོགས་པའི་བྱང་ཆུབ་མངོན་པར་རྫོགས་པར་འཚང་རྒྱ་བར་ཡང་འགྱུར་རོ་༎ 
 aśp 15| atha bhagavān avalokiteśvaro bodhisattvo mahāsattva imam evārthapadaṃ bhūyasyā	དེ་ནས་བྱང་ཆུབ་སེམས་དཔའ་ཆེན་པོ་སྤྱན་རས་གཟིགས་དབང་ཕྱུག་དོན་གྱི་གནས་འདི་ཉིད་རྒྱ་ཆེར་སྟོན་ཅིང་བཞིན་རབ་ཏུ་འཛུམ་ཡང་འགྱུར་རོ་༎ དམུལ་ཏེ་། 
 mātrayoddīpayan prahasitavadanaḥ padmapattravikāsanatayā rāgādinirlepatām avalokayann	པདམའི་འདབ་མ་ཁ་འབྱེད་པས་འདོད་ཆགས་ལ་སོགས་པའི་དྲི་མས་མི་གོས་པ་ལ་ལྟ་ཞིང་།
 idaṃ sarvajagadviśvarūpapadmaṃ nāma hṛdayam abhāṣata | hrīḥ ||	འགྲོ་བ་ཐམས་ཅད་ཀྱི་ཕྱིར་པདམ་གཟུགས་སྣ་ཚོགས་ཞེས་བྱ་བའི་སྙིང་པོ་འདི་སྨྲས་སོ་༎ ཧརའི༔། 
 aśp 16| atha bhagavān sarvatraidhātukādhipatis tathāgataḥ punar api sarvatathāgatābhiṣekasambhavajñānagarbhaṃ nāma prajñāpāramitānayārtham abhāṣata abhiṣekadānaṃ sarvatraidhātukarājyapratilambhāya saṃvartate |	དེ་ནས་བཅོམ་ལྡན་འདས་དེ་བཞིན་གཤེགས་པ་ཁམས་གསུམ་ཐམས་ཅད་ཀྱི་དབང་པོས་ཡང་དེ་བཞིན་གཤེགས་པ་ཐམས་ཅད་ཀྱི་དབང་བསྐུར་བ་ལས་བྱུང་བའི་ཡེ་ཤེས་ཀྱི་སྙིང་པོ་ཞེས་བྱ་བ་ཤེས་རབ་ཀྱི་ཕ་རོལ་ཏུ་ཕྱིན་པའི་ཚུལ་འདི་བཤད་དེ་། དབང་བསྐུར་བ་སྦྱིན་པ་ནི་ཁམས་གསུམ་ཐམས་ཅད་ཀྱི་རྒྱལ་སྲིད་ཐོབ་པར་འགྱུར་རོ་༎
 arthadānaṃ sarvāśāparipūryai saṃvartate |	ནོར་སྦྱིན་པ་ནི་རེ་བ་ཐམས་ཅད་ཡོངས་སུ་རྫོགས་པར་འགྱུར་རོ་༎
 dharmadānaṃ sarvadharmasamatāprāptyai saṃvartate |	ཆོས་སྦྱིན་པ་ནི་ཆོས་ཐམས་ཅད་ཀྱི་མཉམ་པ་ཉིད་ཐོབ་པར་འགྱུར་རོ་༎
 āmiṣadānam sarvakāyavākcittasukhapratilambhāya saṃvartate ||	ཟང་ཟིང་གི་སྦྱིན་པ་ནི་ལུས་དང་། དག་དང་། སེམས་ཀྱི་བདེ་བ་ཐམས་ཅད་༄༢༩༢བ་ཐོབ་པར་འགྱུར་རོ་༎
 aśp 17| athākāśagarbho bodhisattvo mahāsattvaḥ prahasitavadano bhūtvā svaśirasi vajraratnābhiṣekamālām avabandhayann imam eva dharmatārthaṃ bhūyasyā mātrayoddīpayann idaṃ sarvābhiṣekasamayaratnaṃ	དེ་ནས་བྱང་ཆུབ་སེམས་དཔའ་སེམས་དཔའ་ཆེན་པོ་ནམ་མཁའི་སྙིང་པོ་བཞིན་རབ་ཏུ་འཛུམ་ཏེ་། རང་གི་མགོ་ལ་རྡོ་རྗེ་རིན་པོ་ཆེའི་དབང་བསྐུར་བའི་ཕྲེང་བ་འཆིང་ཞིང་དོན་འདི་ཉིད་རྒྱ་ཆེར་སྟོན་ཏེ་། དབང་བསྐུར་བ་ཐམས་ཅད་ཀྱི་དམ་ཚིག་རིན་པོ་ཆེ་ཞེས་བྱ་བའི་སྙིང་པོ་ཆེར་སྟོན་ཏེ་། 
 nāma hṛdayam abhāṣata | trāṃ ||	འདི་སྨྲས་སོ་༎ 
 aśp 18| atha bhagavān sarvatathāgatajñānamudrāprāptaḥ sarvatathāgatamuṣṭidharaḥ sarvatathāgataḥ	ཏརའ༔། དེ་ནས་བཅོམ་ལྡན་འདས་དེ་བཞིན་གཤེགས་པ་ཐམས་ཅད་ཀྱི་ཡེ་ཤེས་ཀྱི་ཕྱག་རྒྱ་ཐོབ་པ་། དེ་བཞིན་གཤེགས་པ་ཐམས་ཅད་ཀྱི་ཁུ་ཚུར་འཛིན་པ་།
 śāśvataḥ punar apīmaṃ sarvatathāgatajñānamudrādhiṣṭhānavajraṃ nāma prajñāparamitānayārtham abhāṣata |	དེ་བཞིན་གཤེགས་པ་རྟག་པས་ཡང་དེ་བཞིན་གཤེགས་པ་ཐམས་ཅད་ཀྱི་ཡེ་ཤེས་ཀྱི་ཕྱག་རྒྱའི་གནས་རྡོ་རྗེ་ཞེས་བྱ་བ་ཤེས་རབ་ཀྱི་ཕ་རོལ་ཏུ་ཕྱིན་པའི་ཚུལ་འདི་བཤད་དེ་།
 sarvatathāgatakāyamudrāparigrahaḥ sarvatathāgatatvāya saṃvartate |	དེ་བཞིན་གཤེགས་པ་ཐམས་ཅད་ཀྱི་སྐུའི་ཕྱག་རྒྱ་ཡོངས་སུ་འཛིན་པ་ནི་དེ་བཞིན་གཤེགས་པ་ཐམས་ཅད་ཉིད་དུ་འགྱུར་རོ་༎
 sarvatathāgatavāṅmudrāparigrahaḥ sarvadharmapratilambhāya saṃvartate |	དེ་བཞིན་གཤེགས་པ་ཐམས་ཅད་ཀྱི་གསུང་གི་ཕྱག་རྒྱ་ཡོངས་སུ་འཛིན་པ་ནི་ཆོས་ཐམས་ཅད་ཐོབ་པར་འགྱུར་རོ་༎ 
 sarvatathāgatacittamudrāparigrahaḥ sarvasamādhipratilambhāya saṃvartate |	དེ་བཞིན་གཤེགས་པ་ཐམས་ཅད་ཀྱི་ཐུགས་ཀྱི་ཕྱག་རྒྱ་ཡོངས་སུ་འཛིན་པ་ནི་ཏིང་ངེ་འཛིན་ཐམས་ཅད་ཐོབ་པར་འགྱུར་རོ་༎
 sarvatathāgatavajramudrāparigrahaḥ sarvakāyavākcittavajratvottamasiddhyai saṃvartate |	དེ་བཞིན་གཤེགས་པ་ཐམས་ཅད་ཀྱི་རྡོ་རྗེའི་ཕྱག་རྒྱ་ཡོངས་སུ་འཛིན་པ་ནི་ལུས་དང་། ངག་དང་། སེམས་ཐམས་ཅད་རྡོ་རྗེར་རྡོ་རྗེའི་དངོས་གྲུབ་དམ་པ་ཐོབ་པར་འགྱུར་རོ་༎
 aśp 19| yaḥ kaścid vajrapāṇe imam dharmaparyāyaṃ śroṣyati dhārayiṣyati vācayiṣyaty	སུ་ལ་ལ་ཤེས་རབ་ཀྱི་ཕ་རོལ་ཏུ་ཕྱིན་པའི་ཚུལ་འདི་༄༢༩༣ཨ་༌༎
 uddeksyati bhāvayiṣyati sa sarvasiddhīḥ sarvasaṃpattīḥ sarvajñānāni sarvakāryāṇi sarvakāyavākcittavajratvasarvottamasiddhiṃ ca pratilapsyate |	ཉན་པ་དང་། འཛིན་པ་དང་། ཀློག་པ་དང་། ལུང་འབོགས་པ་དང་། སྐོམ་པ་དེས་དངོས་གྲུབ་ཐམས་ཅད་དང་། ཕུན་སུམ་ཚོགས་པ་ཐམས་ཅད་དང་། ཤེས་པ་ཐམས་ཅད་དང་། དགོས་པ་ཐམས་ཅད་དང་། ལུས་དང་། ངག་དང་། སེམས་ཐམས་ཅད་རྡོ་རྗེར་རྡོ་རྗེའི་དངོས་གྲུབ་དམ་པ་ཐོབ་ནས་།
 ksipraṃ cānuttarāṃ samyaksaṃbodhim abhisaṃbhotsyata iti ||	མྱུར་དུ་བླ་ན་མེད་པ་ཡང་དག་པར་རྫོགས་པའི་བྱང་ཆུབ་མངོན་པར་རྫོགས་པར་འཚང་རྒྱ་བར་འགྱུར་རོ་༎ 
 aśp 20| atha bhagavān vajramuṣṭir mahāsamayavajramudrāparigraha imam evārthaṃ bhūyasyā	དེ་ནས་བྱང་ཆུབ་སེམས་དཔའ་སེམས་དཔའ་ཆེན་པོ་རྡོ་རྗེའི་ཁུ་ཚུར་དམ་ཚིག་ཆེན་པོའི་རྡོ་རྗེའི་ཕྱག་རྒྱ་ཡོངས་སུ་འཛིན་པས་དོན་གནས་འདི་རྒྱ་ཆེར་བསྟན་ཏེ་།
 mātrayoddīpayan prahasitavadana idaṃ sarvadṛḍhavajramudrāsiddhisamayaṃ nāma hṛdayam abhāṣata | aḥ ||	དེ་བཞིན་རབ་ཏུ་འཛུམ་ཞིང་རྡོ་རྗེ་སྲ་བའི་ཕྱག་རྒྱ་དངོས་གྲུབ་ཐམས་ཅད་ཀྱི་དམ་ཚིག་ཅེས་བྱ་བའི་སྙིང་པོ་འདི་སྨྲས་སོ་༎
 aśp 21| atha bhagavān sarvadharmasamatāprapañcas tathāgataḥ punar apīmaṃ cakrākṣaraparivartaṃ nāma prajñāpāramitānayārtham abhāṣata |	ཨཨ༔། དེ་ནས་བཅོམ་ལྡན་འདས་ཆོས་ཐམས་ཅད་སྤྲོས་པ་མེད་པའི་དེ་བཞིན་གཤེགས་པས་ཡང་འཁོར་ལོ་ལྟར་ཡི་གེ་བསྐོར་བ་ཞེས་བྱ་བ་ཤེས་རབ་ཀྱི་ཕ་རོལ་ཏུ་ཕྱིན་པའི་ཚུལ་འདི་བཤད་དེ་།
 śūnyāḥ sarvadharmā niḥsvabhāvatāyogena |	ངོ་བོ་ཉིད་མེད་པའི་ཚུལ་གྱིས་ཆོས་ཐམས་ཅད་སྟོང་པ་ཉིད་དོ་༎
 animittāḥ sarvadharmā nirnimittatām upādāya |	མཚན་མ་མེད་པའི་ཚུལ་གྱིས་ཆོས་ཐམས་ཅད་མཚན་མ་མེད་པའོ་༎
 araṇihitāḥ saradharmā apraṇidhānayogena |	སྨོན་པ་མེད་པའི་ཚུལ་གྱིས་ཆོས་ཐམས་ཅད་སྨོན་པ་མེད་པའོ་༎
 pakṛtiprabhāsvarāḥ prajñāpāramitāpariśuddhā ||	ཤེས་རབ་ཀྱི་ཕ་རོལ་ཏུ་ཕྱིན་པ་ཡོངས་སུ་དག་པས་ཆོས་ཐམས་ཅད་རང་བཞིན་གྱིས་འོད་༄༢༩༣བ་གསལ་བའོ་༎ དེ་ནས་བཅོམ་ལྡན་འདས་འཇམ་དཔལ་གཞོན་ནུར་གྱུར་བ་དོན་འདི་ཉིད་རྒྱ་ཆེར་སྟོན་གསལ་བའོ་༎ ཏེ་། བཞིན་རབ་ཏུ་འཛུམ་བཞིན་དུ་བདག་གི་རལ་གྲི་དེས་དེ་བཞིན་གཤེགས་པ་ཐམས་ཅད་ལ་འདེབས་ཤིང་ཤེས་རབ་ཀྱི་ཕ་རོལ་ཏུ་ཕྱིན་པའི་སྙིང་པོའི་མཆོག་འདི་སྨྲས་སོ་༎
 aśp 22-31 missing aśp 32| |||t* tatra mahāvajreśvara idaṃ tattvahṛdayam agāt* |	ཨཨ༔། དེ་ནས་བཅོམ་ལྡན་འདས་དེ་བཞིན་གཤེགས་པ་ཐམས་ཅད་ཀྱི་འཁོར་དེར་འདུས་པའི་དེ་བཞིན་གཤེགས་པའི་འཁོར་ལོ་ཆེན་པོ་ལ་འཇུག་པ་ཞེས་བྱ་བ་ཤེས་རབ་ཀྱི་ཕ་རོལ་ཏུ་ཕྱིན་པའི་ཚུལ་འདི་བཤད་དོ་༎ རྡོ་རྗེ་མཉམ་པ་ཉིད་ལ་འཇུག་པ་ནི་དེ་བཞིན་གཤེགས་པ་ཐམས་ཅད་ཀྱི་འཁོར་ལོ་ལ་འཇུག་པར་འགྱུར་རོ་༎ དོན་གྱི་མཉམ་པ་ཉིད་ལ་འཇུག་པ་ནི་བྱང་ཆུབ་སེམས་དཔའ་སེམས་དཔའ་ཆེན་པོའི་འཁོར་ལོ་ལ་འཇུག་པར་འགྱུར་རོ་༎ ཆོས་ཐམས་ཅད་ཀྱི་མཉམ་པ་ཉིད་ལ་འཇུག་པ་ནི་དམ་པའི་ཆོས་ཀྱི་འཁོར་ལོ་ལ་འཇུག་པར་འགྱུར་རོ་༎ ཐམས་ཅད་ཀྱི་མཉམ་པ་ཉིད་ལ་འཇུག་པ་ནི་འཁོར་ལོ་ཐམས་ཅད་ལ་འཇུག་པར་འགྱུར་རོ་༎ འགྱུར་རོ་༎ དེ་ནས་བྱང་ཆུབ་སེམས་དཔའ་སེམས་བསྐྱེད་མ་ཐག་ཏུ་ཆོས་ཀྱི་འཁོར་ལོ་བསྐོར་བ་ཆོས་མཉམ་པ་ཉིད་ཀྱི་དོན་རྒྱ་ཆེར་སྟོན་ཅིང་བཞིན་འཛུམ་ནས་། རྡོ་རྗེའི་འཁོར་ལོ་བསྐོར་ཞིང་རྡོ་རྗེའི་འཁོར་ལོ་ཐམས་ཅད་ལ་འཇུག་པ་ཞེས་བྱ་བའི་སྙིང་པོ་འདི་སྨྲས་སོ་༎ ཧའུམ། དེ་ནས་བཅོམ་ལྡན་འདས་དེ་བཞིན་གཤེགས་པ་ལ་མཆོད་པ་ཐམས་ཅད་ཀྱི་ཆོ་ག་༄༢༩༤ཨ་༌༎ རྒྱས་པའི་སྣོད་ཀྱིས་མཆོད་པ་ཐམས་ཅད་ཀྱི་མཆོག་ཅེས་བྱ་བ་ཤེས་རབ་ཀྱི་ཕ་རོལ་ཏུ་ཕྱིན་པའི་ཚུལ་འདི་བཤད་དོ་༎ བྱང་ཆུབ་ཀྱི་སེམས་བསྐྱེད་པ་ནི་། དེ་བཞིན་གཤེགས་པ་ཐམས་ཅད་ལ་མཆོད་པའི་ཆོ་ག་རྒྱ་ཆེ་བའོ་༎ སེམས་ཅན་གྱི་ཁམས་ཐམས་ཅད་ཡོངས་སུ་སྐྱོབ་པ་ན་དེ་བཞིན་གཤེགས་པ་ཐམས་ཅད་ལ་མཆོད་པའི་ཆོ་ག་རྒྱས་པའོ་༎ དམ་པའི་ཆོས་ཡོངས་སུ་འཛིན་པ་ནི་དེ་བཞིན་གཤེགས་པ་ཐམས་ཅད་ལ་མཆོད་པའི་ཆོ་ག་རྒྱས་པའོ་༎ ཤེས་རབ་ཀྱི་ཕ་རོལ་ཏུ་ཕྱིན་པ་ཡི་གེར་འདྲི་བ་དང༏་ཡི་གེར་འདྲིར་འཇུག་པ་པའོ་༎ དང་། འཛིན་པ་དང་། ཀློག་པ་དང་། བརྗོད་པ་དང་། སྟོན་པ་དང་། ཉན་པ་དང་། སེམས་དང་། སྒོམ་པ་དང་། མཆོད་པ་བྱེད་པ་ནི་དེ་བཞིན་གཤེགས་པ་ཐམས་ཅད་ལ་མཆོད་པའི་ཆོ་ག་རྒྱས་པའོ་༎། དེ་ནས་བྱང་ཆུབ་སེམས་དཔའ་སེམས་དཔའ་ཆེན་པོ་ནམ་མཁའི་མཛོད་དོན་དེ་ཉིད་རྒྱ་ཆེར་སྟོན་ཏེ་། བཞིན་རབ་ཏུ་འཛུམ་ཞིང་ལས་ཐམས་ཅད་དོན་ཡོད་པའི་དམ་ཚིག་ཅེས་བྱ་བའི་སྙིང་པོ་འདི་། སྨྲས་སོ་༎ 
 oṃ vajranetrībhyaḥ svāhā ||	ཨཨོམ།
 aśp 33| atha bhagavān anantāparyantaniṣṭhas tathāgato 'paryantāniṣṭhadharmā punar	དེ་ནས་བཅོམ་ལྡན་འདས་དེ་བཞིན་གཤེགས་པ་། སེམས་ཅན་ཐམས་ཅད་འདུལ་ནུས་པ་། ཡང་ཡེ་ཤེས་ཀྱི་ཁུ་ཚུར་ཡོངས་སུ་འཛིན་པ་། སེམས་ཅན་ཐམས་ཅད་འདུལ་བ་ཤེས་པའི་སྙིང་པོ་ཞེས་བྱ་བ་ཤེས་རབ་ཀྱི་ཕ་རོལ་ཏུ་ཕྱིན་པའི་ཚུལ་༄༢༩༤བ་འདི་བཤད་དོ་༎ སེམས་ཅན་ཐམས་ཅད་མཉམ་པ་ཉིད་པས་། ཁྲོ་བོ་མཉམ་པ་ཉིད་དོ་༎ སེམས་ཅན་ཐམས་ཅད་འདུལ་བ་ཉིད་པས་། ཁྲོ་བོ་འདུལ་བ་ཉིད་དོ་༎ སེམས་ཅན་ཐམས་ཅད་ཆོས་ཉིད་པས་ཁྲོ་བོ་ཆོས་ཉིད་དོ་༎ སེམས་ཅན་ཐམས་ཅད་རྡོ་རྗེ་ཉིད་པས་ཁྲོ་བོ་རྡོ་རྗེ་ཉིད་དོ་༎ དེ་ཅིའི་ཕྱིར་ཞེ་ན་། འདི་ལྟར་སེམས་ཅན་ཐམས་ཅད་འདུལ་བ་ནི་བྱང་ཆུབ་པོ་༎ དེ་ནས་བྱང་ཆུབ་སེམས་དཔའ་བདུད་ཀྱི་སྟོབས་ཐམས་ཅད་རབ་ཏུ་འཇོམས་པ་དོན་དེ་ཉིད་རྒྱ་ཆེར་སྟོན་ཏེ་། བཞིན་རབ་ཏུ་འཛུམ་ཞིང་རྡོ་རྗེ་མཆེ་བའི་ཕྱག་རྒྱ་དང་། རྡོ་རྗེ་གནོད་སྦྱིན་གྱི་གཟུགས་ཀྱིས་རྡོ་རྗེ་ཁྲོ་བོའི་གད་མོ་ཞེས་བྱ་བའི་སྙིང་པོ་འདི་སྨྲས་སོ་༎ ཧ༏་དེ་ནས་བཅོམ་ལྡན་འདས་དེ་བཞིན་གཤེགས་པ་། ཆོས་ཐམས་ཅད་ཀྱི་མཉམ་པ་ཉིད་ལ་གནས་པས་ཡང་ཆོས་ཐམས་ཅད་ཀྱི་མཆོག་ཅེས་བྱ་བ་ཤེས་རབ་ཀྱི་ཕ་རོལ་ཏུ་ཕྱིན་པའི་ཚུལ་འདི་བཤད་དོ་༎ ཐམས་ཅད་མཉམ་པ་ཉིད་པས་ཤེས་རབ་ཀྱི་ཕ་རོལ་ཏུ་ཕྱིན་པ་མཉམ་པ་ཉིད་དོ་དོ་༎ ༎ ཐམས་ཅད་དོན་ཉིད་པས་ཤེས་རབ་ཀྱི་ཕ་རོལ་ཏུ་ཕྱིན་པ་དོན་ཉིད་དོ་༎ ཐམས་ཅད་ཆོས་ཉིད་པས་ཤེས་རབ་ཀྱི་ཕ་རོལ་ཏུ་ཕྱིན་པ་ཆོས་ཉིད་དོ་༎ ཐམས་ཅད་ལས་ཉིད་པས་ཤེས་རབ་ཀྱི་ཕ་རོལ་ཏུ་ཕྱིན་པ་ལས་ཉིད་དུ་རིག་པར་བྱའོ་༎ དེ་ནས་བཅོམ་ལྡན་འདས་ལག་ན་རྡོ་རྗེ་དེ་བཞིན་གཤེགས་པ་དང་། བྱང་ཆུབ་སེམས་དཔའ་ཐམས་ཅད་ཀྱི་དོན་ཡོད་པའི་དམ་ཚིག་༄༢༩༥ཨ་༌༎ གི་དཀྱིལ་འཁོར་བྱིན་གྱིས་རློབ་པ་ཞེས་བྱ་བའི་ཏིང་ངེ་འཛིན་ལ་སྙོམས་པར་ཞུགས་ནས་། དོན་ཡོད་པ་ཐམས་ཅད་ཀྱི་དམ་ཚིག་ཅེས་བྱ་བའི་སྙིང་པོ་འདི་སྨྲས་སོ་༎ ཧའུམ། དེ་ནས་བཅོམ་ལྡན་འདས་དེ་བཞིན་གཤེགས་པ་ཐམས་ཅད་པ་། རྣམ་པར་སྣང་མཛད་ཀྱིས་ཡང་སེམས་ཅན་ཐམས་ཅད་བྱིན་གྱིས་རློབ་པ་ཞེས་བྱ་བ་ཤེས་རབ་ཀྱི་ཕ་རོལ་ཏུ་ཕྱིན་པའི་ཚུལ་འདི་བཤད་དོ་༎ བྱང་ཆུབ་སེམས་དཔའ་སེམས་དཔའ་ཆེན་པོ་ཀུན་ཏུ་བཟང་པོ་ཐམས་ཅད་ཀྱི་རང་བཞིན་ཡིན་པས་སེམས་ཅན་ཐམས་ཅད་ནི་དེ་བཞིན་གཤེགས་པའི་སྙིང་པོ་ཅན་ནོ་༎ ཐམས་ཅད་རྡོ་རྗེའི་སྙིང་པོས་དབང་བསྐུར་བ་ཉིད་པས་སེམས་ཅན་ཐམས་ཅད་ནི་རྡོ་རྗེའི་སྙིང་པོ་ཅན་ནོ་༎ ངག་ཐམས་ཅད་རབ་ཏུ་འབྱུང་བས་སེམས་ཅན་ཐམས་ཅད་ནི་ཆོས་ཀྱི་སྙིང་པོ་ཅན་ནོ་༎ སེམས་ཅན་ཐམས་ཅད་ཀྱི་བྱ་བ་བྱེད་པ་ལ་སྦྱོར་བས་། སེམས་ཅན་ཐམས་ཅད་ནི་ལས་ཀྱི་སྙིང་པོ་ཅན་ནོ་༎ དེ་ནས་ཕྱི་རོལ་ཀྱི་རྡོ་རྗེའི་རིགས་རྣམས་ཀྱིས་ཅ་ཅོའི་སྒྲ་ཕྱུང་ནས་ཆོས་ཉིད་ཀྱི་དོན་རྒྱ་ཆེར་སྟོན་ཅིང་སྙིང་པོ་ཕུལ་ཏེ་། དེ་ནས་རྡོ་རྗེའི་དབང་ཕྱུག་ཆེན་པོས་རང་གི་དེ་ཁོ་ནའི་སྙིང་པོ་འདི་ཕུལ་ལོ་༎ དརའི་། དེ་ནས་མ་མོ་ཐམས་ཅད་ཀྱིས་བཅོམ་ལྡན་འདས་ལ་ཕྱག་འཚལ་ཏེ་། མགྲིན་གཅིག་ཏུ་ཐམས་ཅད་དགུག་པ་དང་། གཟུང་བ་དང་། གཞིག་པ་དང་། ༄༢༩༥བ་སྒྲུབ་པའི་དམ་ཚིག་ཅེས་བྱ་བ་རང་གི་དེ་ཁོ་ནའི་སྙིང་པོ་འདི་ཕུལ་ལོ་༎ བྷྱོ༔་དེ་ནས་སྦྲང་རྩིར་བྱེད་ལ་སོགས་པ་མིང་པོ་གསུམ་གྱིས་བཅོམ་ལྡན་འདས་ལ་ཕྱག་འཚལ་ཏེ་། ཚིགས་མཐུན་པར་རང་གི་དེ་ཁོ་ནའི་སྙིང་པོ་འདི་ཕུལ་ལོ་༎ སབ༹འ༔་དེ་ནས་སྲིང་མོ་བཞིས་བཅོམ་ལྡན་འདས་ལ་ཕྱག་འཚལ་ཏེ་། རང་གི་དེ་ཁོ་ནའི་སྙིང་པོ་འདི་ཕུལ་ལོ་༎
 apy asya kalpasya pariniṣṭhādhiṣṭhānārtham imaṃ sarvadharmasamatāpariniṣṭhādhiṣṭhānavajraṃ nāma prajñāpāramitānayārtham abhāṣata | prajñāpāramitānantatayā sarvatathāgatānantatā |	ཧའ༏་དེ་ནས་བཅོམ་ལྡན་འདས་དེ་བཞིན་གཤེགས་པ་མཐའ་ཡས་མུ་མེད་ལ་མཐར་ཐུག་ཅིང་མུ་མེད་པའི་ཆོས་དང་ལྡན་པས་ཡང་ཆོས་འདི་མཐར་ཐུག་པར་བྱིན་གྱིས་བརླབ་པར་བྱ་བའི་ཕྱིར་ཆོས་ཐམས་ཅད་ཀྱི་མཉམ་པ་ཉིད་ཀྱི་མཐར་ཐུག་པས་བྱིན་གྱིས་བརླབས་པ་རྡོ་རྗེ་ཞེས་བྱ་བ་ཤེས་རབ་ཀྱི་ཕ་རོལ་ཏུ་ཕྱིན་པའི་ཚུལ་འདི་བཤད་དོ་༎ ཤེས་རབ་ཀྱི་ཕ་རོལ་ཏུ་ཕྱིན་པ་མཐའ་ཡས་པ་ཉིད་པས་དེ་བཞིན་གཤེགས་པ་ཐམས་ཅད་མཐའ་ཡས་པ་ཉིད་དོ་༎
 prajñāpāramitāparyantatayā sarvadharmāparyantatā |	ཤེས་རབ་ཀྱི་ཕ་རོལ་ཏུ་ཕྱིན་པ་མུ་མེད་པ་ཉིད་པས་རྡོ་རྗེ་ཐམས་ཅད་མུ་མེད་པ་ཉིད་དོ་༎ ཤེས་རབ་ཀྱི་ཕྱིན་པ་དུ་མཉིད་པས་ཆོས་ཐམས་ཅད་དུ་མ་ཉིད་དོ་༎
 prajñāpāramitānekatayā sarvadharmānekatā | prajñāpāramitāpariniṣṭhatayā sarvadharmāpariniṣṭhatā bhavati|| aśp 33*| vajra oṃ sarvadharmatāprapañco hili sarvadharmatā mili sarvānurāgiṇi svāhā ||	ཤེས་རབ་ཀྱི་ཕ་རོལ་ཏུ་ཕྱིན་པ་མཐར་ཐུག་པ་མེད་པ་ཉིད་པས་ཆོས་ཐམས་ཅད་མཐར་ཐུག་པ་མེད་པ་ཉིད་ཡིན་ནོ་༎
 aśp 34| yaḥ kaścid vajrapāṇe imaṃ dharmaparyāyaṃ śroṣyati dhārayiṣyati vācayiṣyaty uddekṣyati pravartayiṣyati bhāvayiṣyati tasyāniṣṭhāṃ buddhabodhisattvacaryāṃ gatvā sarvāvaraṇapariniṣṭhatayā tathāgatatvaṃ vajradharatvaṃ vāśu bhaviṣyati || aśp 34*| namaḥ sarvatathāgatānāṃ namaḥ sarvavajradharāṇām | oṃ bhagavann ārāt pāraṃ viśodhaya svāhā || oṃkārapūrvaṅgamād oghottāraṇaṃ kariṣyāmi sarvasattvānāṃ |	སུ་ལ་ལ་ཤེས་རབ་ཀྱི་ཕ་རོལ་ཏུ་ཕྱིན་པའི་ཚུལ་འདི་ཉམ་པ་དང་། འཛིན་པ་དང་། འཆང་བ་དང་། གློག་པ་དང་། སྟོན་པ་དང་། བརྗོད་པ་དང་། སྒོམ་པ་དེས་སངས་རྒྱས་དང་། བྱང་ཆུབ་སེམས་༄༢༩༦ཨ་༌༎ དཔའི་སྤྱོད་པ་ཐུག་པ་མེད་པའི་མཐར་ཕྱིན་ཏེ་། སྒྲིབ་པ་ཐམས་ཅད་ཟད་ནས་དེ་བཞིན་གཤེགས་པ་འམ་། རྡོ་རྗེ་འཛིན་པར་མྱུར་དུ་འགྱུར་རོ་༎
 aśp 35| atha sarvatathāgatāḥ samājam āgamyāsya dharmaparyāyasyāmogham apratihatāśusiddhyarthaṃ vajrapāṇaye sādhukāram adāt*	དེ་ནས་དེ་བཞིན་གཤེགས་པ་ཐམས་ཅད་འདུས་ཏེ་། ཆོས་ཀྱི་རྣམ་གྲངས་འདི་དོན་ཡོད་པ་དང་། ཐོགས་པ་མེད་པར་མྱུར་དུ་འགྲུབ་པར་བྱ་བའི་ཕྱིར་༎ ལག་ན་རྡོ་རྗེ་ལ་ལེགས་སོ་ཞེས་བྱ་བ་བྱིན་ནོ་༎
 sādhu sādhu mahāsattva sādhu sādhu mahāsukha |	སེམས་ཅན་ཆེན་པོ་ལེགས་སོ་ལེགས་༎ བདེ་བ་ཆེན་པོ་ལེགས་སོ་ལེགས་༎ ཐེག་པ་ཆེན་པོ་ལེགས་སོ་ལེགས་༎
 sādhu sādhu mahāyāna sādhu sādhu mahāmate || 1||	བློ་གྲོས་ཆེན་པོ་ལེགས་སོ་ལེགས་༎
 subhāṣitam idaṃ kalpaṃ vajrasūtram adhiṣṭhitam* |	ཆོ་ག་འདི་ནི་ལེགས་པར་སྨྲས་༎
 sarvavajradharair buddhair amoghavinayottamam* || 2 ||	སངས་རྒྱས་རྡོ་རྗེ་འཛིན་ཀུན་གྱིས་༎ འབྲས་བུ་ཡོད་པ་འདུལ་བའི་མཆོག་། རྡོ་རྗེ་མདོ་སྡེ་བྱིན་གྱིས་བརླབས་༎
 dhārayisyanti ye hīmaṃ kalparājam anuttaram* |	ཆོ་གའི་རྒྱལ་པོ་བླ་ན་མེད་༎ གང་རྣམས་འདི་དག་འཛིན་པ་ནི་༎
 adhṛṣṭāś cāghatavyāś ca sarvamārādibhis tu te || 3 ||	བདུད་ལ་སོགས་པ་ཐམས་ཅད་ཀྱིས་༎ དེ་དག་མི་སོད་མི་ཚུགས་སོ་༎
 buddhatvaṃ bodhisattvatvam uttamāḥ sarvasiddhayaḥ |	སངས་རྒྱས་བྱང་ཆུབ་སེམས་དཔའ་དང་༎ དངོས་གྲུབ་དམ་པ་ཐམས་ཅད་ཀྱང་༎
 acirād eva lapsyante sarvabuddhavaco yathā || 4 || aśp 36|	སངས་རྒྱས་ཀུན་གྱིས་གསུངས་པ་བཞིན་༎ རིང་པོར་མི་ཐོགས་ཐོབ་པར་འགྱུར་༎ དེ་སྐད་གསུངས་ནས་གསང་གྲུབ་ཕྱིར་༎ རྡོ་རྗེ་ཅན་གྱིས་བཤད་པ་ལ་༎
 idam uktvā tu sarvāgrāḥ sarvabuddhāḥ sasauraghanāḥ | vajriṇā guhyasiddhyarthaṃ bhāṣitaṃ cābhyanandi te || 5 ||	ཀུན་མཆོག་སངས་རྒྱས་མཁས་བཅས་པ་༎ ཐམས་ཅད་ཀྱིས་ནི་མངོན་པར་བསྟོད་༎
 aśp 37| atha bhagavān vairocanas tathāgataḥ sarvatathāgataguhyadharmatāprāptaḥ sarvadharmāprapañcaḥ punar apīdaṃ mahāsukhavajrāmoghasamayaṃ nāmāmoghavajradharmasamatāprajñāpāramitānayamukhaṃ paramādyam anādinidhanamadhyam uttamam abhāṣata |	དེ་ནས་བཅོམ་ལྡན་འདས་དེ་བཞིན་གཤེགས་པ་རྣམ་པར་༄༢༩༦བ་སྣང་མཛད་དེ་བཞིན་གཤེགས་པ་ཐམས་ཅད་ཀྱི་གསང་བའི་ཆོས་ཉིད་བརྙེས་པ་ཆོས་ཐམས་ཅད་སྤྲོས་པ་མེད་པས་ཡང་བདེ་བ་ཆེན་པོ་རྡོ་རྗེའི་དོན་ཡོད་པའི་དམ་ཚིག་ཅེས་བྱ་བ་རྡོ་རྗེ་དོན་ཡོད་པའི་ཆོས་མཉམ་པ་ཉིད་ཀྱི་ཤེས་རབ་ཀྱི་ཕ་རོལ་ཏུ་ཕྱིན་པའི་སྒོ་མཆོག་དང་པོ་ཐོག་མ་དང་། ཐ་མ་ད་དང་། དབུས་མེད་པའི་དམ་པ་འདི་གསུངས་སོ་༎
 mahārāgottamasiddhir mahābodhisattvānāṃ mahāsukhottamasiddhyai saṃvartate |	བྱང་ཆུབ་སེམས་དཔའ་ཆེན་པོ་རྣམས་ཀྱི་འདོད་ཆགས་ཆེན་པོ་དངོས་གྲུབ་དམ་པ་ནི་དེ་བཞིན་གཤེགས་པ་ཐམས་ཅད་ཀྱི་བདེ་བ་ཆེན་པོ་དངོས་གྲུབ་དམ་པར་འགྱུར་རོ་༎
 mahāsukhottamasiddhir mahābodhisattvānāṃ sarvatathāgatamahābodhyuttamasiddhyai saṃvartate |	བྱང་ཆུབ་སེམས་དཔའ་ཆེན་པོ་རྣམས་ཀྱིས་བདེ་བ་ཆེན་པོ་དངོས་གྲུབ་དམ་པ་ནི་དེ་བཞིན་གཤེགས་པ་ཐམས་ཅད་ཀྱི་བྱང་ཆུབ་ཆེན་པོ་དངོས་གྲུབ་དམ་པར་འགྱུར་རོ་༎
 sarvatathāgatamahābodhyuttamasiddhir mahābodhisattvānāṃ sarvamahāmārapramardanottamasiddhyai saṃvartate | sarvamahāmārapramardanottamasiddhir mahābodhisattvānāṃ sarvatraidhātukādhipatyottamasiddhyai saṃvartate | sakalatraidhātukaiśvaryottamasiddhir mahābodhisattvānām aśeṣānavaśeṣasattvadhātuviśodhanādhyavasāyahetvarthenety	བྱང་ཆུབ་སེམས་དཔའ་ཆེན་པོ་རྣམས་ཀྱི་དེ་བཞིན་གཤེགས་པ་ཐམས་ཅད་ཀྱི་བྱང་ཆུབ་ཆེན་པོ་དངོས་གྲུབ་དམ་པ་ནི་བདུད་ཆེན་པོའི་སྟོབས་ཐམས་ཅད་རབ་ཏུ་འཇོམས་པ་དངོས་གྲུབ་དམ་པར་འགྱུར་རོ་༎ བྱང་ཆུབ་སེམས་དཔའ་ཆེན་པོ་རྣམས་ཀྱི་བདུད་ཆེན་པོའི་སྟོབས་ཐམས་ཅད་རབ་ཏུ་འཇོམས་པ་དངོས་གྲུབ་དམ་པ་ནི་ཁམས་གསུམ་པ་ཐམས་ཅད་ཀྱི་དབང་ཕྱུག་ཆེན་པོ་དངོས་གྲུབ་དམ་པར་འགྱུར་རོ་༎ ༎ བྱང་ཆུབ་སེམས་དཔའ་ཆེན་པོ་རྣམས་ཀྱི་ཁམས་གསུམ་པ་ཐམས་ཅད་ཀྱི་དབང་ཕྱུག་ཆེན་པོའི་དངོས་གྲུབ་དམ་པ་ནི་འཇིག་རྟེན་གྱི་ཁམས་མ་ལུས་པ་ན་སེམས་ཅན་༄༢༩༧ཨ་༌༎
 āsaṃsārādhyavasāyināṃ mahāvīryāṇāṃ mahāsattvānām aśeṣānavaśeṣasattvadhātuparitrāṇasarvahitasukhottamasiddhyai saṃvartate || aśp 37*| oṃ vajra | oṃ sarvatathāgatamāte | mahāsukhavajradhāriṇi | sarvasamatāpraveśani | sarvaduḥkhakṣayaṅkari | sarvasukhapradāyike | sarvasukhapradāyini svāhā ||	གྱི་ཁམས་ལུས་པ་མེད་པ་ཡོངས་སུ་སྦྱོང་བར་འདོད་པའི་རྒྱུའི་ཕྱིར་། འཁོར་བ་ལ་ཡང་ཆགས་ཤིང་བརྩོན་འགྲུས་ཆེ་བའི་བྱང་ཆུབ་སེམས་དཔའ་ཆེན་པོ་རྣམས་ཀྱི་འཇིག་རྟེན་གྱི་ཁམས་མ་ལུས་པ་ན་སེམས་ཅན་གྱི་ཁམས་ལུས་པ་མེད་པ་ཡོངས་སུ་བསྐྱབ་པ་དང་། སེམས་ཅན་ཐམས་ཅད་ལ་ཕན་པ་དང་། བདེ་བ་དང་། མཆོག་ཏུ་ཤིན་ཏུ་བདེ་བ་ཆེན་པོའི་དངོས་གྲུབ་དམ་པར་འགྱུར་རོ་༎
 aśp 38| tat kasya hetoḥ |	དེ་ཅིའི་ཕྱིར་ཞེ་ན་།
 yāvat saṃsāravāsasthā bhavanti varasūrayaḥ |	ཇི་སྲིད་འཁོར་བའི་གནས་སུ་ནི་༎ མཁས་མཆོག་འདུག་པར་འགྱུར་བའི་ཚེ་༎
 tāvat sattvārtham atulaṃ śaktāḥ kartum anirvṛtāḥ || 6 ||	དེ་སྲིད་མཚུངས་མེད་སེམས་ཅན་དོན་༎ མྱ་ངན་མི་འདའ་བྱེད་པར་ནུས་༎
 prajñāpāramitopāyajñānādhiṣṭhānavāsitāḥ |	ཤེས་རབ་ཕ་རོལ་ཕྱིན་ཐབས་དང་༎ ཡེ་ཤེས་གནས་སུ་བསྒྲུབས་པས་ནི་༎
 sarvadharmaviśuddhyā tu bhāvaśuddhā bhavanti ha || 7 ||	ཆོས་ཀུན་རྣམ་པར་དག་པའི་ཕྱིར་༎ འཁོར་བ་ཡོངས་སུ་དག་པར་གྱུར་༎ ཆགས་ལ་སོགས་པས་འདུལ་ན་ནི་༎ འཁོར་བའི་བར་དུ་རྟག་པར་ཡང་༎
 rāgādivinayo loka ā bhavāt pāpakṛt sadā |	འཇིག་རྟེན་སྡིག་བྱེད་དེ་སྦྱང་ཕྱིར་༎
 teṣāṃ viśodhanārthaṃ tu vinayanty ā bhavāt svayam || 8 ||	འཁོར་བ་སྲིད་དུ་བདག་ཉིད་འདུལ་༎
 yathā padmaṃ suraktaṃ tu rāgadoṣair na lipyate |	ཇི་ལྟར་པདམ་རབ་དམར་ཡང་༎ ཚོན་གྱི་ཉེས་པས་མི་གོས་པ་༎
 vāsadoṣair bhave nityaṃ na lipyante jagaddhitāḥ || 9 ||	དེ་བཞིན་གནས་པའི་ཉེས་པ་ཡིས་༎ འགྲོ་ཕན་རྣམས་ལ་མི་གོས་སོ་༎
 mahārāgaviśuddhās tu mahāsaukhyā mahādhanāḥ |	འདོད་ཆགས་ཆེན་པོ་རྣམ་པར་དག་། བདེ་བ་ཆེ་ཞིང་ནོར་ཆེ་ལ་༎ ཁམས་གསུམ་དབང་ཕྱུག་ཐོབ་པས་ན་༎
 tridhātvīśvaratām prāptāḥ sattvārthaṃ kurvate dṛḍham || 10 || iti ||	སེམས་ཅན་དོན་རྣམས་བརྟན་པར་བྱེད་༎
 aśp 39| yaḥ kaścid vajrapāṇe imaṃ paramādyam prajñāpāramitānayamukhaṃ dharmaparyāyaṃ	ལག་ན་རྡོ་རྗེ་། སུ་ལ་ལ་ནང་པར་༄༢༩༧བ་ལངས་ནས་མཆོག་དང་པོ་ཤེས་རབ་ཀྱི་ཕ་རོལ་ཏུ་ཕྱིན་པའི་ཚུལ་གྱི་སྒོའི་ཆོས་ཀྱི་རྣམ་གྲངས་འདི་ཉིན་རེ་ཞིང་འདོན་པ་དང་། 
 dine dine kālyam utthāyoccārayiṣyati śroṣyati vā sa sarvasukhasaumanasyalābhī mahāsukhavajrāmoghasamayasiddhim ātyantikīm ihaiva janmani lapsyate |	ཉན་པ་དང་། འཛིན་པ་དང་། ཀློག་པ་དང་། སྒོམ་པ་དེ་ཡིད་བདེ་བ་དང་། བདེ་བ་ཐམས་ཅད་ཐོབ་པར་འགྱུར་རོ་༎ བདེ་བ་ཆེན་པོ་པ་རྡོ་རྗེ་དོན་ཡོད་པའི་དམ་ཚིག་དངོས་གྲུབ་ཀྱི་མཆོག་ཀྱང་ཚེ་འདི་ལ་ཐོབ་པར་འགྱུར་རོ་༎
 sarvatathāgatavajraguhyottamasiddhir mahāvajradharo bhaviṣyati tathagato veti ||	དེ་བཞིན་གཤེགས་པ་ཐམས་ཅད་ཀྱི་གསང་བ་མཆོག་ཀྱང་འགྲུབ་སྟེ་། རྡོ་རྗེ་འཛིན་ཐམས་ཅད་ཀྱི་ཆེན་པོ་འམ་། དེ་བཞིན་གཤེགས་པར་འགྱུར་རོ་༎
 aśp 40| atha bhagavān vajrapāṇiṃ guhyakādhipatim āmantrayate sma |	དེ་ནས་བཅོམ་ལྡན་འདས་ཀྱིས་གསང་བའི་བདག་པོ་ལག་ན་རྡོ་རྗེ་ལ་བཀའ་སྩལ་བ་། གསང་བ་པའི་བདག་པོ་༎
 imāni guhyakādhipate pañcaviṃśatiprajñāpāramitānayamukhāni dhārayitavyāni |	ཤེས་རབ་ཀྱི་ཕ་རོལ་ཏུ་ཕྱིན་པའི་ཚུལ་གྱི་སྒོའི་སྔགས་ཀྱི་ཚིག་ཉི་ཤུ་རྩ་ལྔ་པོ་འདི་རྣམས་སོ་༎ 
 oṃ bodhicittavajre || 1 ||	ཨཨོམ་བྱང་ཆུབ་ཀྱི་སེམས་རྡོ་རྗེ་།
 oṃ samantabhadracarye || 2 ||	ཨཨོམ་ཀུན་ཏུ་བཟང་པོའི་སྤྱོད་པ་།
 oṃ cintāmaṇi || 3 ||	ཨཨོམ་ཡིད་བཞིན་གྱི་ནོར་བུ་།
 oṃ anirodhe || 4 ||	ཨཨོམ་འགོག་པ་མེད་པ་།
 oṃ jātivivartani || 5 ||	ཨཨོམ་སྐྱེ་བ་བཟློག་པ་།
 oṃ sarvavijñāne || 6 ||	ཨཨོམ་རྣམ་པར་ཤེས་པ་ཐམས་ཅད་།
 oṃ mahāvirāgadharmate || 7 ||	ཨཨོམ་འདོད་ཆགས་དང་བྲལ་བའི་ཆོས་ཉིད་ཆེན་པོ་།
 oṃ vīryakavace || 8 ||	ཨཨོམ་བརྩོན་འགྲུས་ཀྱི་གོ་ཆ་།
 oṃ sarvagāmini || 9 ||	ཨཨོམ་ཀུན་ཏུ་འགྲོ་བ་།
 oṃ vajrakavacadṛḍhacitte || 10 ||	ཨཨོམ་རྡོ་རྗེ་སྲ་བའི་སེམས་། ཧའུམ་ཕཏ།
 oṃ sarvatathāgate || 11 ||	ཨཨོམ་དེ་བཞིན་གཤེགས་པ་ཐམས་ཅད་།
 oṃ svabhāvaviśuddhe || 12 ||	ཨཨོམ་ངོ་བོ་ཉིད་རྣམ་པར་དག་པ་།
 oṃ dharmatājñānaviśuddhe || 13 ||	ཨཨོམ་ཆོས་ཉིད་ཤེས་པ་རྣམ་པར་དག་པ་།
 oṃ karmaviśodhani hūṃ || 14 ||	ཨཨོམ་དེ་བཞིན་ལས་རྣམ་པར་སྦྱོང་བ་།
 oṃ nisumbhavajriṇi phaṭ* || 15 ||	ཧའུམ་ཨཨོམ་ངེས་པར་གནོད་མཛེས་༄༢༩༨ཨ་༌༎ རྡོ་རྗེ་ཅན་། ཕཏ། 
 oṃ kāmarāge || 16 ||	ཨཨོམ་འདོད་པ་ལ་འདོད་ཆགས་པ་།
 oṃ jaha vajre || 17 ||	ཨཨོམ་སྤོང་བའི་རྡོ་རྗེ་ཅན་།
 oṃ hūṃ sarvadāyini || 18 ||	ཨཨོམ་ཧའུམ་ཐམས་ཅད་འདུལ་བ་།
 oṃ hrīḥ || 19 ||	ཨཨོམ་ཧརའི༔།
 oṃ akāramukhe || 20 ||	ཨཨོམ་ཨཨ་ཞེས་བྱ་བའི་སྒོ་༎
 oṃ prajñāpāramite || 21 ||	ཨཨོམ་ཤེས་རབ་ཀྱི་ཕ་རོལ་ཏུ་ཕྱིན་པ་།
 oṃ aṃ vaṃ hūṃ oṃ aḥ || 22 ||	ཨའམ་བམ་ཧའུམ་ཨཨ་ཨཨོམ།
 oṃ sarvatathāgatakāyāgre || 23 ||	ཨཨོམ་དེ་བཞིན་གཤེགས་པ་ཐམས་ཅད་ཀྱི་སྐུའི་མཆོག་།
 oṃ sarvatathāgatavāgviśuddhe || 24 ||	ཨཨོམ་དེ་བཞིན་གཤེགས་པ་ཐམས་ཅད་ཀྱི་གསུང་རམ་པར་དག་པ་།
 oṃ sarvatathāgatacittavajre || 25 ||	ཨཨོམ་དེ་བཞིན་གཤེགས་པ་ཐམས་ཅད་ཀྱི་ཐུགས་རྡོ་རྗེ་ཨཨ༔་ཨཨོམ་ཨཨ་། སྡིག་པས་བཅིངས་པ་ཐམས་ཅད་ཆོས་ཤིག་། ངན་སོང་གི་རྒྱུད་ཐམས་ཅད་ལས་ཐར་པར་གྱིས་ཤིག་། ཨཨོམ་དམ་ཚིགས་ཐམས་ཅད་ཀྱི་རྡོ་རྗེ་ཧའུམ་ཏྲཏ། སྡིག་པ་གཞོམ་པའི་ཕྱག་རྒྱ་དང་སྔགས་ཏེ་། དེ་བཞིན་གཤེགས་པ་ཐམས་ཅད་ཀྱི་གསང་བའི་དངོས་གྲུབ་དམ་པ་རྡོ་རྗེ་འཛིན་ཆེན་པོ་དང་། དེ་བཞིན་གཤེགས་པར་འགྱུར་རོ་༎
 aśp 42| nāyaṃ vajrapāṇe 'navaropitakuśalamūlānāṃ sattvānāṃ karṇapuṭe nipatiṣyati |	ལག་ན་རྡོ་རྗེ་། འདི་ནི་སེམས་ཅན་དགེ་བའི་རྩ་བ་མ་བསྐྱེད་པ་རྣམས་ཀྱི་རྣ་ལམ་དུ་ཐོས་པར་མི་འགྱུར་རོ་༎ འདི་ནི་སེམས་ཅན་དགེ་བའི་རྩ་བ་མ་བསྐྱེད་པ་རྣམས་ཀྱིས་མཉན་པ་འམ་། ཡི་གེར་འདྲི་བ་འམ་། ཡི་གེར་འདིར་གཞུག་པ་འམ་། བཀླག་པ་འམ་། འཆང་བ་འམ་། བསྒོམ་པ་འམ་།
 nāpy anavaropitakuśalamūlaiḥ sattvaiḥ śakyo likhituṃ paṭhituṃ dhārayituṃ vācayituṃ satkartuṃ gurukartuṃ mānayituṃ pūjayitum* |	བསྟི་སྟང་དུ་བྱ་བའམ་། རི་མོར་བྱ་བ་འམ་། མཆོད་པར་མི་ནུས་སོ་༎
 anyatra bahubuddhāvaropitakuśalamūlās te sattvā bhaviṣyanti ya imaṃ prajñāpāramitānayamukham dharmaparyāyam antaśa ekākṣaram api śroṣyanti | kiṃ punaḥ sakalaṃ parisamāptam* |	གང་དག་གིས་ཤེས་རབ་ཀྱི་ཕ་རོལ་ཏུ་ཕྱིན་པའི་ཚུལ་གྱི་ཆོས་ཀྱི་རྣམ་གྲངས་འདི་ལས་ཐ་ན་ཡི་གེ་འབྲུ་༄༢༩༨བ་གཅིག་ཙམ་ཐོས་ན་ཡང་སེམས་ཅན་དེ་དག་ནི་གཞན་ན་སངས་རྒྱས་མང་པོ་ལ་དགེ་བའི་རྩ་བ་བསྐྱེད་པ་ཡིན་ན་མཐའ་དག་རྫོགས་པ་ལྟ་ཅི་སྨོས་། ལག་ན་རྡོ་རྗེ་།
 yena kenacid vajrapāṇe 'śītigaṅgānadīvālukāsamāni buddhakoṭiniyutaśatasahasrāṇi na satkṛtāni na gurukṛtāni na mānitāni na pūjitāni bhavanti tena na śakyo 'ayaṃ prajñāpāramitānayamukho dharmaparyāyaḥ śrotum* |	གང་ལ་ལ་དག་སངས་རྒྱས་བྱེ་བ་ཁྲག་ཁྲིག་གང་གའའི་ཀླུང་བརྒྱད་ཅུའི་བྱེ་མ་སྙེད་ལ་བཀུར་སྟི་མ་བྱས་པ་དང་། བླ་མར་མ་བྱས་པ་དང་། བསྟི་སྟང་མ་བྱས་པ་དང་། མཆོད་པ་མ་བྱས་པ་དེ་དག་གིས་ཤེས་རབ་ཀྱི་ཕ་རོལ་ཏུ་ཕྱིན་པའི་ཚུལ་གྱི་སྒོའི་ཆོས་ཀྱི་རྣམ་གྲང་འདི་ཐོས་པར་མི་ནུས་སོ་༎
 tasmāc caityabhūtaḥ pṛthivīpradeśo bhaviṣyati yatrāyaṃ dharmaparyāyaḥ pracariṣyati |	ཆོས་ཀྱི་རྣམ་གྲངས་འདི་གང་ན་སྤྱོད་པའི་ས་ཕྱོགས་དེ་མཆོད་རྟེན་དུ་འགྱུར་རོ་༎
 vandanīyaś ca sa pudgalo bahukalpakoṭī bhaviṣyati yasyāyaṃ dharmaparyāyaḥ kāyagato vā pustakagato vā bhaviṣyati |	ཆོས་ཀྱི་རྣམ་གྲངས་འདི་གང་གི་ལུས་ལ་ཐོགས་སམ་། གླེགས་བམ་ལ་བྲིས་ཏེ་སྤྱོད་པའི་གང་ཟག་དེ་ཕྱག་བྱ་བའི་གནས་སུ་འགྱུར་རོ་༎
 jātismaraś ca bahukalpakoṭī bhaviṣyati |	དེ་བསྐལ་བ་བྱེ་བ་མང་པོར་སྐྱེ་བ་དྲན་པར་འགྱུར་རོ་༎
 na cāsya māraḥ pāpīyān antarāyaṃ kariṣyati |	དེ་ལ་བདུད་སྡིག་ཏོ་ཅན་པར་ཆད་བྱེད་པར་མི་འགྱུར་རོ་༎
 catvāraś cāsya mahārājānaḥ pṛṣṭhataḥ pṛṣṭhataḥ samanubaddhā bhaviṣyanti rakṣāvaraṇaguptaye anyāś ca devatāḥ |	རྒྱལ་པོ་ཆེན་པོ་བཞི་དང་། ལྷ་གཞན་རྣམས་ཀྱང་དེ་ལ་བསྲུང་པ་དང་། བསྐྱབ་པ་དང་། སྦ་བའི་ཕྱིར་རྟག་ཏུ་ཕྱི་བཞིན་འབྲང་བར་འགྱུར་རོ་༎
 na ca viṣamāparihāreṇa kālaṃ kariṣyati |	ཡ་ང་བ་མ་སྤངས་པར་འཆི་བར་མི་འགྱུར་རོ་༎
 sarvabuddhabodhisattvasamanvāhṛtaś ca bhaviṣyati |	སངས་རྒྱས་དང་། བྱང་ཆུབ་སེམས་དཔའ་ཐམས་ཅད་ཀྱིས་དགོངས་པར་འགྱུར་རོ་༎
 samāsato yatra buddhakṣetre ākāṅkṣiṣyate tatra tatropapatsyate |	མདོར་ན་སངས་རྒྱས་ཀྱི་ཞིང་གང་དང་གང་དུ་འདོད་པ་དེ་དང་དེར་སྐྱེའོ་༎
 evaṃ bahvanuśaṃsaḥ prajñāpāramitānayamukho dharmaparyāyaḥ | api ca pradeśamātraṃ mayā kīrtitam iti ||	དེ་ལྟར་ཤེས་རབ་ཀྱི་ཕ་རོལ་ཏུ་ཕྱིན་པའི་ཚུལ་གྱི་སྒོའི་ཆོས་ཀྱི་རྣམ་གྲངས་འདི་ཕན་ཡོན་མང་མོད་ཀྱི་ངས་ཕྱོགས་ཙམ་ཞིག་༄༢༩༩ཨ་༌༎ བརྗོད་དོ་༎
 aśp 43| idam avocad bhagavān* |	བཅོམ་ལྡན་འདས་ཀྱིས་དེ་སྐད་ཅེས་བཀའ་སྩལ་ནས་།
 āttamanaso vajrapāṇipramukhā bodhisattvā mahāsattvāḥ sā ca sarvāvatī parṣat sadevamānuṣāsuragandharvaś ca loko bhagavato bhāṣitam abhyanandan*	བྱང་ཆུབ་སེམས་དཔའ་སེམས་དཔའ་ཆེན་པོ་ལག་ན་རྡོ་རྗེ་དང་། བྱང་ཆུབ་སེམས་དཔའ་དེ་དག་དང་། ཐམས་ཅད་དང་ལྡན་པའི་འཁོར་དེ་དག་དང་། ལྷ་དང་། མི་དང་། ལྷ་མ་ཡིན་དང་། དྲི་ཟར་བཅས་པའི་འཇིག་རྟེན་ཡི་རངས་ཏེ་། བཅོམ་ལྡན་འདས་ཀྱིས་གསུངས་པ་ལ་མངོན་པར་བསྟོད་དོ་༎
