skt	tib
 āryaśrīmahādevīvyākaraṇam [= dvādaśadaṇḍakanāmāṣṭaśatavimalīkaraṇā] oṃ namaḥ sarvabuddhabodhisattvebhyaḥ ||	༄༡༠༢བ་རྒྱ་གར་སྐད་དུ་། ཨའརྱ་ཤརའི་མ་ཧའ་དེ་བི་བཡའ་ཀ་ར་ན་། བོད་སྐད་དུ་། འཕགས་པ་ལྷ་མོ་ཆེན་མོ་དཔལ་ལུང་བསྟན་པ་། སངས་རྒྱས་དང་བྱང་ཆུབ་སེམས་དཔའ་ཐམས་ཅད་ལ་ཕྱག་འཚལ་ལོ་༎
 evaṃ mayā śrutamekasamaye bhagavān sukhāvatyāṃ viharati sma mahatā bodhisattvasaṃghena sārdhaṃ - tadyathā avalokiteśvareṇa ca bodhisattvena mahāsattvena mahāsthāmaprāptena ca bodhisattvena mahāsattvena sarvanīvaraṇaviṣkaṃbhinā ca bodhisattvena mahāsattvena kṣitigarbheṇa ca bodhisattvena mahāsattvena samantabhadreṇa ca bodhisattvena mahāsattvena ākāśagarbheṇa ca bodhisattvena mahāsattvena vajrapāṇinā ca bodhisattvena mahāsattvena sarvabhayahareṇa ca bodhisattvena mahāsattvena evaṃ sarvamaṅgaladhāriṇā ca bodhisattvena mahāsattvena sarvapuṇyalakṣaṇadhāriṇā ca bodhisattvena mahāsattvena candrasūryatrailokyadhāriṇā ca bodhisattvena mahāsattvena sarvatīrthamaṅgaladhāriṇā ca bodhisattvena mahāsattvena maṃjuśriyā ca kumārabhūtena ca bodhisattvena mahāsattvena evaṃpramukhairbodhisattvairmahāsattvaiḥ | (śmdv 94)	འདི་སྐད་བདག་གིས་ཐོས་པ་དུས་གཅིག་ནི་། བཅོམ་ལྡན་འདས་བདེ་བ་ཅན་ན་བྱང་ཆུབ་སེམས་༄༡༠༣ཨ་༌༎ དཔའི་དགེ་འདུན་ཆེན་པོ་འདི་ལྟ་སྟེ་། བྱང་ཆུབ་སེམས་དཔའ་སེམས་དཔའ་ཆེན་པོ་སྤྱན་རས་གཟིགས་དབང་ཕྱུག་དང་། བྱང་ཆུབ་སེམས་དཔའ་སེམས་དཔའ་ཆེན་པོ་མཐུ་ཆེན་ཐོབ་པ་དང་། བྱང་ཆུབ་སེམས་དཔའ་སེམས་དཔའ་ཆེན་པོ་སྒྲིབ་པ་ཐམས་ཅད་རྣམ་པར་སེལ་བ་དང་། བྱང་ཆུབ་སེམས་དཔའ་སེམས་དཔའ་ཆེན་པོ་སའི་སྙིང་པོ་དང་། བྱང་ཆུབ་སེམས་དཔའ་སེམས་དཔའ་ཆེན་པོ་ཀུན་ཏུ་བཟང་པོ་དང་། བྱང་ཆུབ་སེམས་དཔའ་སེམས་དཔའ་ཆེན་པོ་ནམ་མཁའི་སྙིང་པོ་དང་། བྱང་ཆུབ་སེམས་དཔའ་སེམས་དཔའ་ཆེན་པོ་ལག་ན་རྡོ་རྗེ་དང་། བྱང་ཆུབ་སེམས་དཔའ་སེམས་དཔའ་ཆེན་པོ་འཇིགས་པ་ཐམས་ཅད་སེལ་བ་དང་། དེ་བཞིན་དུ་བྱང་ཆུབ་སེམས་དཔའ་སེམས་དཔའ་ཆེན་པོ་དག་བྱེད་ཀྱི་བཀྲ་ཤིས་ཐམས་ཅད་འཛིན་པ་དང་། བྱང་ཆུབ་སེམས་དཔའ་སེམས་དཔའ་ཆེན་པོ་བསོད་ནམས་ཀྱི་མཚན་ཐམས་ཅད་འཛིན་པ་དང་། བྱང་ཆུབ་སེམས་དཔའ་སེམས་དཔའ་ཆེན་པོ་ཉི་ཟླ་དང་། འཇིག་རྟེན་འཛིན་པ་དང་། བྱང་ཆུབ་སེམས་དཔའ་སེམས་དཔའ་ཆེན་པོ་མུ་སྟེགས་ཀྱི་བཀྲ་ཤིས་ཐམས་ཅད་འཛིན་པ་དང་། བྱང་ཆུབ་སེམས་དཔའ་སེམས་དཔའ་ཆེན་པོ་འཇམ་དཔལ་གཞོན་ནུར་གྱུར་པ་དང་། དེ་ལ་སོགས་པ་བསྐལ་པ་བཟང་པོའི་བྱང་ཆུབ་སེམས་དཔའ་སེམས་དཔའ་ཆེན་པོ་ཐམས་༄༡༠༣བ་ཅད་དང་ཐབས་ཅིག་ཏུ་བཞུགས་སོ་༎
 atha khalvāryāvalokiteśvaro bodhisattvo mahāsattvo yena bhagavāṃstenopasaṃkrāntaḥ | upasaṃkramya bhagavataḥ pādau śirasābhivandyaikānte nyaṣīdat | śrīrapi mahādevī bhagavantamevopasaṃkrāntā |	དེ་ནས་བྱང་ཆུབ་སེམས་དཔའ་སེམས་དཔའ་ཆེན་པོ་སྤྱན་རས་གཟིགས་དབང་ཕྱུག་བཅོམ་ལྡན་འདས་ག་ལ་བ་དེར་སོང་སྟེ་ཕྱིན་ནས་བཅོམ་ལྡན་འདས་ཀྱི་ཞབས་ལ་མགོ་བོས་ཕྱག་འཚལ་ཏེ་ཕྱོགས་གཅིག་ཏུ་འདུག་གོ་། 
 upasaṃkramya bhagavataḥ pādau śatasahasraṃ pradakṣīṇīkṛtya sarvāṃśca tān sukhāvatīnivāsino bodhisattvān mahāsattvān śirasābhivandyaikānte nyaṣīdat	ལྷ་མོ་ཆེན་པོ་དཔལ་ཡང་བཅོམ་ལྡན་འདས་ཀྱི་ཐད་དུ་སོང་སྟེ་ཕྱིན་ནས་བཅོམ་ལྡན་འདས་ཀྱི་ཞབས་ལ་མགོ་བོས་ཕྱག་འཚལ་ཏེ་ལན་གསུམ་བསྐོར་བ་བྱས་ནས་བདེ་བ་ཅན་ན་གནས་པའི་བྱང་ཆུབ་སེམས་དཔའ་སེམས་དཔའ་ཆེན་པོ་དེ་དག་ལ་ཡང་མགོ་བོས་ཕྱག་འཚལ་ཏེ་ཕྱོགས་གཅིག་ཏུ་འདུག་གོ་༎
 atha khalu bhagavānanekaśatasahasrapuṇyālaṃkṛtastathāgatakoṭiparivṛtaḥ sarvaśakrabrahmalokapālastutastavitaḥ	དེ་ནས་བཅོམ་ལྡན་འདས་བསོད་ནམས་བརྒྱ་སྟོང་དུ་མས་བརྒྱན་ཅིང་། དེ་བཞིན་གཤེགས་པ་བྱེ་བ་དག་གིས་ཡོངས་སུ་བསྐོར་ཏེ་བརྒྱ་བྱིན་དང་། ཚངས་པ་དང་། འཇིག་རྟེན་སྐྱོང་བ་ཐམས་ཅད་ཀྱིས་བསྟོད་ཅིང་བསྔགས་སོ་༎
 śriyaṃ mahādevīṃ dṛṣṭā mahābrahmasvareṇāvalokiteśvaraṃ bodhisattvaṃ mahāsattvametadavocat |	ལྷ་མོ་ཆེན་མོ་དཔལ་ལ་གཟིགས་ནས་ཚངས་པ་ཆེན་པོའི་གསུང་གིས་བྱང་ཆུབ་སེམས་དཔའ་སེམས་དཔའ་ཆེན་པོ་སྤྱན་རས་གཟིགས་དབང་ཕྱུག་ལ་འདི་སྐད་ཅེས་བཀའ་སྩལ་ཏོ་༎ སྤྱན་རས་གཟིགས་དབང་ཕྱུག་། རྒྱལ་པོའམ་། བློན་པོའམ་། དགེ་སློང་ངམ་།
 yaḥ kaścidavalokiteśvara rājā vā rājamātro vā bhikṣubhikṣuṇyupāsakopāsikā vā brāhmaṇakṣatriyaviṭśūdrā vā śriyā mahādevyā aṣṭottaraṃ śataṃ vimalaprakhyaṃ nāma stotraṃ dhārayiṣyanti tasya	དགེ་སློང་མའམ་། དགེ་བསྙེན་ནམ་། དགེ་བསྙེན་མའམ་། བྲམ་ཟེའམ་། རྒྱལ་རིགས་སམ་། རྗེའུ་རིགས་སམ་། དམངས་རིགས་གང་ལ་ལ་ལྷ་མོ་ཆེན་མོ་དཔལ་གྱི་མིང་བརྒྱ་༄༡༠༤ཨ་༌༎ རྩ་བརྒྱད་དྲི་མ་མེད་པར་གྲགས་པ་ཞེས་བྱ་བའི་བསྟོད་པ་འདི་འཆང་ན་།
 rājñaḥ kṣatriyasya viṣaye teṣāṃ sattvānāṃ sarvabhayetyupadravā praśamiṣyanti | sarvacoradhūrtamanuṣyāmanuṣyabhayaṃ na bhaviṣyati |	རྒྱལ་རིགས་ཀྱི་རྒྱལ་པོ་དེའི་ཡུལ་དང་། སེམས་ཅན་དེ་དག་གི་འཇིགས་པ་དང་། ཡམས་ཀྱི་ནད་གནོད་པ་ཐམས་ཅད་ཞི་བར་འགྱུར་ཞིང་ཆོམ་རྐུན་དང་། ག-ཡོ་ཅན་དང་། མི་དང་། མི་མ་ཡིན་པའི་འཇིགས་པ་ཐམས་ཅད་འབྱུང་བར་མི་འགྱུར་ཏེ་།
 sarvadhanadhānyakośakoṣṭhāgāravivṛddhirbhaviṣyati |	ནོར་དང་། འབྲུ་དང་། མཛོད་དང་། བང་བ་ཐམས་ཅད་རྣམ་པར་འཕེལ་བར་འགྱུར་རོ་༎
 tasya ca rājñaḥ kṣatriyasya gṛhe śrīrnivasiṣyati |	རྒྱལ་རིགས་ཀྱི་རྒྱལ་པོ་དེའི་ཁྱིམ་དུ་ཡང་དཔལ་ངེས་པར་གནས་པར་འགྱུར་རོ་༎
 atha te bodhisattvā mahāsattvā evaṃ vācamabhāṣanta |	དེ་ནས་བྱང་ཆུབ་སེམས་དཔའ་སེམས་དཔའ་ཆེན་པོ་དེ་དག་གིས་ཚིག་འདི་སྐད་ཅེས་གསོལ་ཏོ་༎ བཅོམ་ལྡན་འདས་༎
 sādhu sādhu (śmdv 95) bhagavan subhāṣiteyaṃ vāk |	གསུང་འདི་ལེགས་པར་བཀའ་སྩལ་པ་ལེགས་སོ་ལེགས་སོ་༎ ལེགས་ཏེ་།
 ye śriyā mahādevyā nāmadheyāni dhārayiṣyanti teṣāmapīmā guṇānuśaṃsā bhaviṣyanti |	གང་དག་ལྷ་མོ་ཆེན་མོ་དཔལ་གྱི་མིང་རྣམས་འཛིན་པ་དང་། ཐོས་ནས་ཀྱང་སྒྲུབ་པར་བགྱིད་པ་དེ་དག་གི་ཡོན་ཏན་དང་། པན་ཡོན་ནི་༎
 athāryāvalokiteśvaro bodhisattvo mahāsattvo bhagavantametadavocat |	དེ་དག་ལགས་སོ་༎ དེ་ནས་བྱང་ཆུབ་སེམས་དཔའ་སེམས་དཔའ་ཆེན་པོ་འཕགས་པ་སྤྱན་རས་གཟིགས་དབང་ཕྱུག་གིས་བཅོམ་ལྡན་འདས་ལ་འདི་སྐད་ཅེས་གསོལ་ཏོ་༎ བཅོམ་ལྡན་འདས་།
 kutra bhagavan śriyā mahādevyā kuśalamūlamavaropitam |	ལྷ་མོ་དཔལ་གྱིས་དགེ་བའི་རྩ་བ་གང་དུ་བསྐྱེད་པ་ལགས་།
 bhagavānāha |	བཅོམ་ལྡན་འདས་ཀྱིས་བཀའ་སྩལ་པ་།
 gaṃgānadīvālukāsamānāṃ tathāgatānāmantikāt śriyā mahādevyā kuśalamūlamavaropitam |	ལྷ་མོ་ཆེན་མོ་དཔལ་གྱིས་དེ་བཞིན་གཤེགས་༄༡༠༤བ་པ་གངགའའི་ཀླུང་གི་བྱེ་མ་སྙེད་ལ་དགེ་བའི་རྩ་བ་བསྐྱེད་དེ་།
 bhūtapūrvamavalokiteśvara atīte 'dhvani ratnasaṃbhavāyāṃ lokadhātau ratnakusumaguṇasāgaravaidūryakanakagirisuvarṇakāṃcanaprabhāsaśrīrnāma tathāgato loke udapādi |	སྤྱན་རས་གཟིགས་དབང་ཕྱུག་། སྔོན་བྱུང་བ་འདས་པའི་དུས་ན་འཇིག་རྟེན་གྱི་ཁམས་རིན་པོ་ཆེ་ལས་བྱུང་བ་ཞེས་བྱ་བ་ན་དེ་བཞིན་གཤེགས་པ་རིན་པོ་ཆེའི་མེ་ཏོག་ཡོན་ཏན་གྱི་རྒྱ་མཚོ་བེཨེ་དའུརྱ་དང་། གསེར་གྱི་རི་བོ་མདོག་མཛེས་གསེར་འོད་དཔལ་ཞེས་བྱ་བ་འཇིག་རྟེན་དུ་བྱུང་སྟེ་།
 tasyāntike śriyā mahādevyā kuśalamūlamavaropitamanyeṣāṃ ca bahūnāṃ tathāgatānāmantike |	དེ་བཞིན་གཤེགས་པ་མང་པོ་གཞན་དག་ལ་ཡང་ལྷ་མོ་ཆེན་མོ་དཔལ་གྱིས་དགེ་བའི་རྩ་བ་བསྐྱེད་དོ་༎ 
 imāni ca tathāgatanāmāni tasyāḥ śriyā mahādevyāḥ kuśalamūlavivṛddhisaṃpattikarāṇi | sadānubaddhānitāni śriyā mahādevyā yānīha samudḥritāni sarvapāpaharāṇi sarvakilviṣanāśanāni sarvakāryavimalīkaraṇāni dhanadhānyākarṣaṇavivṛddhikarāṇi dāridryaparicchedanakarāṇi	དེ་བཞིན་གཤེགས་པའི་མཚན་འདི་དག་ཀྱང་ལྷ་མོ་ཆེན་མོ་དཔལ་དེའི་དགེ་བའི་རྩ་བ་རྣམ་པར་འཕེལ་བ་དང་། འགྲུབ་པར་བྱེད་པ་དང་། རྟག་ཏུ་རྗེས་སུ་འབྲང་བ་ཡིན་ཏེ་། དེ་དག་ནི་།
 sarvadevanāgayakṣagandharvāsuragaruḍakinnaramahoragāvarjanākarṣaṇakarāṇi sarvetyupadravopasargopāyāsasarvakalikalahavigrahavivādapraśamanakarāṇi ṣaṭpāramitāniṣpādanakarāṇi | (śmdv 96)	འདིར་ལྷ་མོ་དཔལ་ཡང་དག་པར་བརྗོད་པ་དང་། སྡིག་པ་ཐམས་ཅད་སེལ་བ་དང་། ཉེས་སྡིག་ཐམས་ཅད་མེད་པར་བྱེད་པ་དང་། ལུས་ཐམས་ཅད་དྲི་མ་མེད་པར་བྱེད་པ་དང་། ནོར་དང་། འབྲུ་རྣམས་འདུ་ཞིང་འཕེལ་བར་བྱེད་པ་དང་། དབུལ་བ་གཅོད་པར་བྱེད་པ་དང་། ལྷ་དང་། ཀླུ་དང་། གནོད་སྦྱིན་དང་། དྲི་ཟ་དང་། ལྷ་མ་ཡིན་དང་། ནམ་མཁའ་ལྡིང་དང་། མིའམ་ཅི་དང་། ལྟོ་འཕྱེ་ཆེན་པོ་ཐམས་ཅད་འདུན་པར་བྱེད་ཅིང་འགུགས་པར་བྱེད་པ་དང་། ཡམས་ཀྱི་ནད་དང་། གནོད་པ་དང་། འཐབ་པ་དང་། འཁྲུག་པ་དང་། འགྱེད་པ་དང་། རྩོད་པ་ཐམས་ཅད་ཞི་བར་བྱེད་པ་དང་། ཕ་རོལ་ཏུ་ཕྱིན་པ་དྲུག་སྒྲུབ་པར་༄༡༠༥ཨ་༌༎ བྱེད་པའོ་༎ འདི་ལྟ་སྟེ་།
 namaḥ śrīghanāya tathāgatāya |	དེ་བཞིན་གཤེགས་པ་དཔལ་སྟུག་པོ་ལ་ཕྱག་འཚལ་ལོ་༎
 namo ratnakusumaguṇasāgaravaiḍūryakanakagirisuvarṇakāṃcanaprabhāsaśriye tathāgatāya |	དེ་བཞིན་གཤེགས་པ་རིན་པོ་ཆེའི་མེ་ཏོག་ཡོན་ཏན་གྱི་རྒྱ་མཚོ་བེཨེ་དའུརྱ་དང་། གསེར་གྱི་རི་བོ་མདོག་མཛེས་གསེར་འོད་དཔལ་ལ་ཕྱག་འཚལ་ལོ་༎
 namo gaṅgāsarvatīrthamukhamaṅgalaśriye tathāgatāya |	དེ་བཞིན་གཤེགས་པ་གངགའའི་མུ་སྟེགས་ཀྱི་སྒོ་ཐམས་ཅད་བཀྲ་ཤིས་ཀྱི་དཔལ་ལ་ཕྱག་འཚལ་ལོ་༎
 namaścandanakusumatejonakṣatraprabhāsaśriye tathāgatāya |	དེ་བཞིན་གཤེགས་པ་ཙནདན་གྱི་མེ་ཏོག་གཟི་བརྗོད་སྐར་མའི་འོད་ཀྱི་དཔལ་ལ་ཕྱག་འཚལ་ལོ་༎
 namaḥ samantāvabhāsavijitasaṃgrāmaśriye tathāgatāya |	དེ་བཞིན་གཤེགས་པ་ཀུན་ཏུ་སྣང་བ་ག-ཡུལ་ལས་རྣམ་པར་རྒྱལ་བའི་དཔལ་ལ་ཕྱག་འཚལ་ལོ་༎
 namo guṇasamudrāvabhāsamaṇḍalaśriye tathāgatāya |	དེ་བཞིན་གཤེགས་པ་ཡོན་ཏན་རྒྱ་མཚོ་སྣང་བའི་དཀྱིལ་འཁོར་གྱི་དཔལ་ལ་ཕྱག་འཚལ་ལོ་༎
 namo dhārmavikurvaṇadhvajavegaśriye tathāgatāya |	དེ་བཞིན་གཤེགས་པ་ཆོས་ཀྱེ་ཆོ་འཕྲུལ་རྒྱལ་མཚན་ཤུགས་ཀྱི་དཔལ་ལ་ཕྱག་འཚལ་ལོ་༎
 namo jyotiḥsaumyagandhāvabhāsaśriye tathāgatāya |	དེ་བཞིན་གཤེགས་པ་སྐར་འོད་ཞི་བའི་སྤོས་སྣང་དཔལ་ལ་ཕྱག་འཚལ་ལོ་༎
 namaḥ sattvāśayaśamanaśarīraśriye tathāgatāya |	དེ་བཞིན་གཤེགས་པ་སེམས་ཅན་གྱི་བསམ་པ་ཞི་བར་མཛད་པའི་སྐུའི་དཔལ་ལ་ཕྱག་འཚལ་ལོ་༎
 namaḥ praṇidhānasāgarāvabhāsaśriye tathāgatāya |	དེ་བཞིན་གཤེགས་པ་སྨོན་ལམ་རྒྱ་མཚོས་སྣང་བའི་དཔལ་ལ་ཕྱག་འཚལ་ལོ་༎
 namaḥ suparikīrtitanāmadheyaśriye tathāgatāya |	བཅོམ་ལྡན་འདས་དེ་བཞིན་གཤེགས་པ་ཤིན་ཏུ་ཡོངས་སུ་བརྗོད་པ་མཚན་གསོལ་དཔལ་ལ་ཕྱག་འཚལ་ལོ་༎ དེ་བཞིན་གཤེགས་པ་ཕྱིར་མི་ལྡོག་པའི་འཁོར་ལོ་རིན་པོ་ཆེའི་གནས་༄༡༠༥བ་ཀྱི་དཔལ་ལ་ཕྱག་༎ འཚལ་ལོ་༎ དེ་བཞིན་གཤེགས་པ་ཉི་མའི་དཀྱིལ་འཁོར་འོད་འཕགས་པ་དཔལ་ལ་ཕྱག་འཚལ་ལོ་༎ འཚལ་ལོ་༎ 
 namaḥ asaṃkhyeyavīryasusaṃprasthitaśriye tathāgatāya |	༎ དེ་བཞིན་གཤེགས་པ་བརྩོན་འགྲུས་གྲངས་མེད་པ་ལ་ཡང་དག་པར་རྫོགས་པའི་དཔལ་ལ་ཕྱག་འཚལ་ལོ་༎
 namaḥ aprameyasuvarṇottaprabhāsaśriye tathāgatāya |	དེ་བཞིན་གཤེགས་པ་དཔག་ཏུ་མེད་པའི་གསེར་མཆོག་སྣང་བའི་དཔལ་ལ་ཕྱག་འཚལ་ལོ་༎
 namaḥ sarvasvarāṅgarutanirghoṣaśriye tathāgatāya |	དེ་བཞིན་གཤེགས་པ་གསུང་གི་ཡན་ལག་ཐམས་ཅད་ཀྱི་སྒྲ་དབྱངས་ཀྱི་དཔལ་ལ་ཕྱག་འཚལ་ལོ་༎
 namaḥ prajñāpradīpāsaṃkhyeyaprabhāketuśriye tathāgatāya | namo nārāyaṇavratasannāhasumeruśriye (śmdv 97) tathāgatāya |	དེ་བཞིན་གཤེགས་པ་ཤེས་རབ་སྒྲོན་མ་གྲངས་མེད་པའི་འོད་ཀྱི་ཏོག་གི་དཔལ་ལ་ཕྱག་འཚལ་ལོ་༎ དེ་བཞིན་གཤེགས་པ་སྲེད་མེད་ཀྱི་བུའི་བརྟུལ་ཞུགས་ཀྱི་ཆོ་ག་ལྷུན་པོའི་དཔལ་ལ་ཕྱག་འཚལ་༎ ལོ་༎ 
 namo brahmaśriye tathāgatāya |	དེ་བཞིན་གཤེགས་པ་ཚངས་པའི་དཔལ་ལ་ཕྱག་འཚལ་ལོ་༎
 namo maheśvaraśriye tathāgatāya |	དེ་བཞིན་གཤེགས་པ་དབང་ཕྱུག་ཆེན་པོའི་དཔལ་ལ་ཕྱག་འཚལ་ལོ་༎
 namaścandrasuryaśriye tathāgatāya |	དེ་བཞིན་གཤེགས་པ་ཉི་ཟླའི་འོད་དཔལ་ལ་ཕྱག་འཚལ་ལོ་༎
 namo gambhīradharmaprabhārājaśriye tathāgatāya | namo gaganapradīpābhirāmaśriye tathāgatāya |	དེ་བཞིན་གཤེགས་པ་ཟབ་མོའི་ཆོས་ཀྱི་འོད་ཀྱི་རྒྱལ་པོའི་དཔལ་ལ་ཕྱག་འཚལ་ལོ༏་༏དེ་བཞིན་གཤེགས་པ་ནམ་མཁའི་སྒྲོན་མ་འོད་བཟང་དཔལ་ལ་ཕྱག་འཚལ་ལོ་༎ 
 namaḥ sūryaprabhāketuśriye tathāgatāya |	དེ་བཞིན་གཤེགས་པ་ཉི་འོད་ཏོག་གི་དཔལ་ལ་ཕྱག་འཚལ་ལོ་༎
 namo gandhapradīpaśriye tathāgatāya |	དེ་བཞིན་གཤེགས་པ་སྤོས་ཀྱི་སྒྲོན་མའི་དཔལ་ལ་ཕྱག་འཚལ་ལོ་༎
 namaḥ sāgaragarbhasaṃbhavaśriye tathāgatāya |	དེ་བཞིན་གཤེགས་པ་རྒྱ་མཚོའི་སྙིང་པོ་ལས་བྱུང་བའི་དཔལ་ལ་ཕྱག་འཚལ་ལོ་༎
 namo nirmitameghagarjanayaśaḥśriye tathāgatāya |	དེ་བཞིན་གཤེགས་པ་སྤྲུལ་པའི་འབྲུག་སྒྲ་སྙན་པའི་དཔལ་ལ་ཕྱག་༄༡༠༦ཨ་༌༎ འཚལ་ལོ་༎
 namaḥ sarvadharmaprabhāsavyūhaśriye tathāgatāya |	དེ་བཞིན་གཤེགས་པ་ཆོས་ཀྱི་སྣང་བ་ཐམས་ཅད་བཀོད་པའི་དཔལ་ལ་ཕྱག་འཚལ་ལོ་༎
 namo drumarājavivardhitaśriye tathāgatāya |	དེ་བཞིན་གཤེགས་པ་ཤིང་གི་རྒྱལ་པོ་ལྟར་སྐྱེས་པའི་དཔལ་ལ་ཕྱག་འཚལ་ལོ་༎
 namo ratnārciḥparvataśriye tathāgatāya |	དེ་བཞིན་གཤེགས་པ་རིན་ཆེན་འོད་འཕྲོ་རི་བོའི་དཔལ་ལ་ཕྱག་འཚལ་ལོ་༎
 namo jñānārciḥ sāgaraśriye tathāgatāya |	དེ་བཞིན་གཤེགས་པ་ཡེ་ཤེས་འོད་འཕྲོ་རྒྱ་མཚོའི་དཔལ་ལ་ཕྱག་འཚལ་ལོ་༎
 namo mahāpraṇidhivegaśriye tathāgatāya |	དེ་བཞིན་གཤེགས་པ་སྨོན་ལམ་ཆེན་པོའི་ཤུགས་ཀྱི་དཔལ་ལ་ཕྱག་འཚལ་ལོ་༎
 namo mahāmeghaśriye tathāgatāya |	དེ་བཞིན་གཤེགས་པ་སྤྲིན་ཆེན་པོའི་དཔལ་ལ་ཕྱག་འཚལ་ལོ་༎
 namaḥ smṛtiketurājaśriye tathāgatāya |	དེ་བཞིན་གཤེགས་པ་དྲན་པའི་ཏོག་གི་རྒྱལ་པོ་ལ་ཕྱག་འཚལ་ལོ་༎
 nama indraketudhvajarājaśriye tathāgatāya |	དེ་བཞིན་གཤེགས་པ་དབང་པོ་ཏོག་གི་རྒྱལ་མཚན་གྱི་རྒྱལ་པོའི་དཔལ་ལ་ཕྱག་འཚལ་ལོ་༎
 namaḥ sarvadhanadhānyākarṣaṇaśriye tathāgatāya |	དེ་བཞིན་གཤེགས་པ་ནོར་དང་འབྲུ་ཐམས་ཅད་སྡུད་པའི་དཔལ་ལ་ཕྱག་འཚལ་ལོ་༎
 namaḥ saumyākarṣaṇaśriye tathāgatāya |	དེ་བཞིན་གཤེགས་པ་ཞི་བ་འདྲེན་པའི་དཔལ་ལ་ཕྱག་འཚལ་ལོ་༎
 namo lakṣmyākarṣaṇaśriye tathāgatāya |	དེ་བཞིན་གཤེགས་པ་ཕུན་སུམ་ཚོགས་པ་འགུགས་པའི་དཔལ་ལ་ཕྱག་འཚལ་ལོ་༎ དེ་བཞིན་གཤེགས་པའི་མཚན་འདི་དག་རིམ་གྲོར་བྱས་ཏེ་བཅང་བར་བྱའོ་༎ བཀླག་པར་བྱའོ་༎
 imāni tathāgatanāmāni satkṛtya dhārayitavyāni vācayitavyāni evaṃ sa kulaputro vā kuladuhitā vā bahutaraṃ puṇyaṃ prasaviṣyati |	དེ་ལྟར་བྱས་ན་། རིགས་ཀྱི་བུའམ་། རིགས་ཀྱི་བུ་མོ་དེའི་བསོད་ནམས་ཤིན་ཏུ་མང་དུ་བསྐྱེད་པར་འགྱུར་རོ་༎
 vyākṛtā ca śrīmahādevī tathāgataiḥ |	ལྷ་མོ་ཆེན་མོ་དཔལ་དེ་བཞིན་གཤེགས་པ་ཐམས་ཅད་ཀྱིས་ལུང་བསྟན་ཏེ་།
 bhaviṣyasi tvaṃ śrīmahādevī anāgate 'dhvani śrīmahāratnapratimaṇḍitāyāṃ lokadhātau tatra śrīmaṇiratnasambhavo nāma tathāgato 'rhan samyak sambuddhaḥ	ལྷ་མོ་ཆེན་མོ་དཔལ་ཁྱོད་མ་༄༡༠༦བ་འོངས་པའི་དུས་ན་འཇིག་རྟེན་གྱི་ཁམས་དཔལ་ཆེན་པོ་རིན་པོ་ཆེས་བརྒྱན་པ་ཞེས་བྱ་བར་དེ་བཞིན་གཤེགས་པ་དགྲ་བཅོམ་པ་ཡང་དག་པར་རྫོགས་པའི་སངས་རྒྱས་དཔལ་ནོར་བུ་རིན་པོ་ཆེ་ལས་བྱུང་བ་ཞེས་བྱ་བར་འགྱུར་ཏེ་།
 sā ca lokadhāturnānādivyaratnapratimaṇḍitā bhaviṣyati |	འཇིག་རྟེན་གྱི་ཁམས་དེ་ཡང་ལྷའི་རིན་པོ་ཆེ་སྣ་ཚོགས་ཀྱིས་བརྒྱན་པར་འགྱུར་རོ་༎
 (śmdv 98) tatra ca lokadhātau sa eva tathāgata ālokakaro bhaviṣyati |	འཇིག་རྟེན་གྱི་ཁམས་དེར་དེ་བཞིན་གཤེགས་པ་དེ་ཉིད་སྣང་བར་མཛད་པར་འགྱུར་ལ་།
 te ca bodhisattvāstatra buddhakṣetre svayaṃprabhā bhaviṣyantyaparimitāyuṣaśca |	འཇིག་རྟེན་གྱི་ཁམས་དེ་ན་གནས་པའི་བྱང་ཆུབ་སེམས་དཔའ་དེ་དག་ཀྱང་རང་ལས་འོད་འབྱུང་ཞིང་ཚེ་དཔག་ཏུ་མེད་པར་འགྱུར་རོ་༎
 ākāśataśca buddhadharmasaṅghaśabdo niścariṣyati |	ནམ་མཁའ་ལས་ཀྱང་སངས་རྒྱས་དང་། ཆོས་དང་། དགེ་འདུན་གྱི་སྒྲ་འབྱུང་བར་འགྱུར་རོ་༎
 ye ca bodhisattvāstatra buddhakṣetre upapatsyante sarve te padmakarkaṭikāsūpapatsyante |	སངས་རྒྱས་ཀྱི་ཞིང་དེར་བྱང་ཆུབ་སེམས་དཔའ་གང་དག་སྐྱེ་བར་འགྱུར་བ་དེ་དག་ཐམས་ཅད་ཀྱང་པདམའི་སྙིང་པོ་དག་ལས་སྐྱེ་བར་འགྱུར་རོ་ཞེས་ལུང་བསྟན་ཏོ་༎ 
 tatra katamaddādaśadaṇḍakaṃ nāmāṣṭaśataṃ vimalaprakhyaṃ stotram |	དེ་ལ་མིང་བརྒྱ་རྩ་བརྒྱད་དྲི་མ་མེད་པ་ལྟ་བུ་ཞེས་བྱ་བའི་བསྟོད་པ་རྒྱུན་ཆགས་བཅུ་གཉིས་གང་ཞེ་ན་། འཇིགས་པ་མེད་པ་སྤྱན་རས་གཟིགས་དབང་ཕྱུག་།
 śṛṇu abhayāvalokiteśvara śriyā mahādevyā nāmāni | tadyathā sarvatathāgatābhiṣiktāsarvadevatābhiṣiktā sarvatathāgatamātā sarvadevatāmātā sarvatathāgataśrīḥ sarvabodhisattvaśrīḥ sarvāryaśrāvakapratyekabuddhaśrīḥ brahmaviṣṇumaheśvaraśrīḥ	ལྷ་མོ་ཆེན་མོ་དཔལ་གྱི་མིང་རྣམ་པར་ཉོན་ཅིག་། འདི་ལྟ་སྟེ་། དེ་བཞིན་གཤེགས་པ་ཐམས་ཅད་ཀྱིས་དབང་བསྐུར་བ་། ལྷ་ཐམས་ཅད་ཀྱིས་དབང་བསྐུར་བ་། དེ་བཞིན་གཤེགས་པ་ཐམས་ཅད་ཀྱི་ཡུམ་། ལྷ་ཐམས་ཅད་ཀྱི་མ་། དེ་བཞིན་གཤེགས་པ་ཐམས་ཅད་ཀྱི་དཔལ་། བྱང་ཆུབ་སེམས་དཔའ་ཐམས་ཅད་ཀྱི་དཔལ་། ༄༡༠༧ཨ་༌༎ འཕགས་པ་ཉན་ཐོས་དང་། རང་སངས་རྒྱས་ཐམས་ཅད་ཀྱི་དཔལ་། ཚངས་པ་དང་། ཁྱབ་འཇུག་དང་། དབང་ཕྱུག་ཆེན་པོ་རྣམས་ཀྱི་དཔལ་།
 mahāsthānagataśrīḥ sarvadevatābhimukhaśrīḥ sarvadevanāgayakṣagandharvāsuragaruḍakinnaramahoragaśrīḥ	ལྷ་ལ་སོགས་པ་ཐམས་ཅད་ཀྱི་དཔལ་། གནས་ཐམས་ཅད་ཡོད་པའི་དཔལ་། ལྷ་དང་། ཀླུ་དང་། གནོད་སྦྱིན་དང་། དྲི་ཟ་དང་། ལྷ་མ་ཡིན་དང་། ནམ་མཁའ་ལྡིང་དང་། མིའམ་ཅི་དང་། ལྟོ་འཕྱེ་ཆེན་པོ་ཐམས་ཅད་ཀྱི་དཔལ་།
 sarvavidyādharavajrapāṇivajradharaśrīḥ catuḥpañcalokapālaśrīḥ aṣṭagrahāṣṭāviṃśatinakṣatraśrīḥ oṃ sāvitrī dhātrī mātā caturvedaśrīḥ lakṣmīḥ bhūtamātā jayā vijayā gaṅgā sarvatīrthā	རིག་སྔགས་འཆང་དང་། ལག་ན་རྡོ་རྗེ་དང་། རྡོ་རྗེ་འཆང་ཐམས་ཅད་ཀྱི་དཔལ་། འཇིག་རྟེན་སྐྱོང་བ་བཞི་དང་། ལྔའི་དཔལ་། གཟའ་བརྒྱད་དང་རྒྱུ་སྐར་ཉི་ཤུ་རྩ་བརྒྱད་ཀྱི་དཔལ་ལོ་༎ ཨཨོམ་ཉི་མའི་བུ་མོའམ་། ཡུམ་རིག་བྱེད་བཞིའི་དཔལ་། བཀྲ་ཤིས་མ་། སེམས་ཅན་གྱི་མ་། རྣམ་པར་རྒྱལ་མ་། གངགའ་མ་། མུ་སྟེགས་ཐམས་ཅད་མ་། བཀྲ་ཤིས་ཐམས་ཅད་མ་།
 sarvamaṅgalyā vimalanirmalakaraśrīḥ sarvapāpahantrī nirmadakarā candraśrīḥ sūryaśrīḥ sarvagrahaśrīḥ siṃhavāhinī śatasahasrakoṭipadmavivarasaṃcchannā padmā padmasambhavā padmālayā padmadharā padmāvatī anekaratnāṃśumālā dhanadā śvetā mahāśvetā śvetabhujā	དྲི་མ་མེད་པར་བྱེད་པའི་དཔལ་། སྡིག་པ་ཐམས་ཅད་འཕྲོག་མ་། རྒྱགས་བྱེད་མ་། ཟླ་བའི་དཔལ་། ཉི་མའི་དཔལ༏་གཟའ་ཐམས་ཅད་ཀྱི་དཔལ་། སེངགེ་ལ་ཞོན་མ་། པདམའི་མཆོག་འབུམ་གྱིས་བཀབ་མ་། པདམ་། པདམ་ལས་བྱུང་མ་། པདམ་ལ་གནས་མ་། པདམ་འཛིན་མ་། པདམ་དང་ལྡན་མ་། རིན་པོ་ཆེ་འོད་འབར་བའི་ཕྲེང་བ་དུ་མ་དང་ལྡན་མ་། ནོར་སྦྱིན་མ་། དཀར་མོ་། དཀར་མོ་ཆེན་མོ་། ལག་དཀར་མ་། བཀྲ་ཤིས་ཐམས་ཅད་འཛིན་མ་།
 sarvamaṅgaladhāriṇī sarvapuṇyopacitāṅgī dākṣāyaṇī śatasahasrabhujā śatasahasranayanā śatasahasraśirā (śmdv 99) vividhavicitramaṇimaulidharā surūpā viśvarūpā yaśā mahāyaśā saumyā bahujīmūtā pavitrakeśā candrakāntā sūryakāntā śubhā śubhakartrī sarvasattvābhimukhī āryākusumaśrīḥ kusumeśvarā	བསོད་ནམས་ཐམས་ཅད་བསགས་པའི་༄༡༠༧བ་ལུས་ཅན་མ་། ཤེས་ཉིན་གྱི་བུ་མོ་། ལག་པ་འབུམ་ལྡན་མ་། མིག་འབུམ་ལྡན་མ་། མགོ་འབུམ་ལྡན་མ་། ནོར་བུ་རྣམ་པ་སྣ་ཚོགས་ཀྱི་ཅོད་པན་དང་ལྡན་མ་། གཟུགས་བཟང་མ་། ཀུན་གྱི་གཟུགས་ཅན་མ་། གྲགས་མ་། ཤིན་ཏུ་གྲགས་མ་། ཞི་མ་། སྤྲིན་འདྲ་བའི་སྐྲ་གཙང་མ་། ཟླ་བ་ལྟར་མཛེས་མ་། དགེ་མ་། དགེ་བྱེད་མ་། སེམས་ཅན་ཐམས་ཅད་ལ་མངོན་དུ་ཕྱོགས་པའི་དཔལ་། འཕགས་པ་མེ་ཏོག་གི་དཔལ་། མེ་ཏོག་གི་དབང་ཕྱུག་མ་།
 sarvasumeruparvatarājaśrīḥ sarvanadīsarīcchrīḥ sarvatoyasamudraśrīḥ sarvatīrthābhimukhaśrīḥ	རིའི་རྒྱལ་པོ་རི་རབ་ཐམས་ཅད་ཀྱི་དཔལ་། ཆུ་ཀླུང་དང་། མཚོ་ཐམས་ཅད་ཀྱི་དཔལ་། ཆུ་དང་རྒྱ་མཚོ་ཐམས་ཅད་ཀྱི་དཔལ་། མུ་སྟེགས་ཐམས་ཅད་མངོན་དུ་ཕྱོགས་པའི་དཔལ་།
 sarvauṣadhitṛṇavanaspatidhanadhānyaśrīḥ hiraṇyadā annapānadāprabhāsvarā ālokakarā pavitrāṅgā sarvatathāgatavaśavartinī sarvadevagaṇamukhaśrīḥ yamavaruṇākuberavāsavaśrīḥ dātrī bhoktrī tejā tejovatī vibhūtīḥ samṛddhiḥ vivṛddhiḥ unnatiḥ dharmaśrīḥ mādhavāśrayā kusumanilayā anasūyā puruṣakārāśrayā sarvapavitragātrā maṅgalahastā sarvālakṣmīnāśayitrī	སྨན་དང་། རཙབ༹་དང་། ནགས་ཚལ་དང་། ནོར་དང་། འབྲུ་ཐམས་ཅད་ཀྱི་དཔལ་། གསེར་སྦྱིན་མ་། ཟས་དང་། སྐོམ་སྤྱིན་མ་། འོད་གསལ་མ་། སྣང་མ་། ལུས་གཙང་མ་། དེ་བཞིན་གཤེགས་པ་ཐམས་ཅད་ཀྱི་དབང་བསྒྱུར་མ་། ལྷའི་ཚོགས་ཐམས་ཅད་ལ་མངོན་དུ་ཕྱོགས་མའི་དཔལ་། གཤིན་རྗེ་དང་། ཆུ་ལྷ་དང་། ལུས་ངན་དང་། བརྒྱ་བྱིན་ལ་སོགས་པའི་དཔལ་། སྦྱིན་བྱེད་མ་། ལོངས་སྤྱོད་མ་། གཟི་བརྗིད་མ་། གཟི་བརྗིད་ལྡན་མ་། ཕུན་སུམ་ཚོགས་མ་། འབྱོར་པ་མ་། རྣམ་པར་འཕེལ་མ་། མཐོང་མ་། ཆོས་ཀྱི་དཔལ་མ་། ཁྱབ་འཇུག་ལ་བརྟེན་མ་། ཀུ་མུ་ད་ལ་གནས་མ་། གནོད་སྦྱིན་མ་། བཟོད་སྦྱིན་མ་། མཐུ་རྩལ་གྱི་གནས་མ་། དག་བྱེད་དང་བཀྲ་ཤིས་༄༡༠༨ཨ་༌༎ ཐམས་ཅད་ཀྱི་ལག་ལྡན་མ་། བཀྲ་མི་ཤིས་པ་ཐམས་ཅད་འཇིག་བྱེད་མ་། བསོད་ནམས་ཐམས་ཅད་སྡུད་པའི་དཔལ་།
 sarvapuṇyākarṣaṇaśrīḥ sarvapṛthivīśrīḥ sarvarājaśrīḥ sarvavidyādhararājaśrīḥ sarvabhūtayakṣarākṣasapretapiśācakuṃbhāṇḍamahoragaśrīḥ	ས་ཐམས་ཅད་དང་རྒྱལ་པོ་ཐམས་ཅད་ཀྱི་དཔལ་། རིག་སྔགས་འཆང་གི་རྒྱལ་པོ་ཐམས་ཅད་ཀྱི་དཔལ་། འབྱུང་པོ་དང་། གནོད་སྦྱིན་དང་། སྲིན་པོ་དང་། ཡི་དབ༹གས་དང་། ཤ་ཟ་དང་། གྲུལ་བུམ་དང་། ལྟོ་འཕྱེ་ཆེན་པོ་ཐམས་ཅད་ཀྱི་དཔལ་། ལྷའི་གནས་དང་། ལྷ་ཐམས་ཅད་ཀྱི་དཔལ་། བཟླས་བརྗོད་དང་བཟླས་བརྗོད་དུ་བྱ་བ་དང་། སྦྱིན་སྲེག་དང་སྦྱིན་སྲེག་ཏུ་བྱ་བ་དང་། བཀྲ་ཤིས་ཐམས་ཅད་ཀྱི་དཔལ་། འོད་ལྡན་མ་། མཆོག་དགའ་མ་། སྐལ་པས་འགྱུར་མ་། དྲང་སྲོང་ཐམས་ཅད་དགའ་བར་བརྗོད་པའི་དཔལ་། བུད་མེད་ཐམས་ཅད་ཀྱི་གནས་།
 dyutiḥ pramodabhāgyalolā sarvarṣipavitraśrīḥ sarvaśrīḥ bhavajyeṣṭhottamaśrīḥ sarvakinnarasarvasūryottamaśrīḥ niravadyasthānavāsinīrūpavatī sukhakarī kuberakāntā dharmarājaśrīḥ |	ཀུན་གྱི་གཙོ་མོ་དཔལ་གྱི་མཆོག་། མིའམ་ཅི་མོ་ཐམས་ཅད་དང་། ལྷ་མ་ཡིན་མོ་ཐམས་ཅད་ཀྱི་དཔལ་གྱི་མཆོག་། ཁ་ན་མ་ཐོ་བ་མེད་པའི་གནས་ན་འདུག་མ་། ཡིད་འོང་མ་སིམ་བྱེད་མ་། ལུས་ངན་ལ་སྡུག་མ་། ཆོས་ཀྱི་རྒྱལ་པོའི་དཔལ་།
 oṃ vilokaya tāraya mocaya mama sarvaduḥkhebhyaḥ sarvapuṇyasambhārānāmukhīkuru svāhā |	ཨཨོམ་སྡུག་བསྔལ་ཐམས་ཅད་ལས་རྣམ་པར་གཟིགས་ཤིང་སྒྲོལ་ཅིག་། ཐར་བར་མཛོད་ཅིག་། བསོད་ནམས་ཀྱི་ཚོགས་ཐམས་ཅད་བདག་ལ་མངོན་དུ་གྱུར་བར་མཛོད་ཅིག་སབ༹འ་ཧའ་།
 oṃ gaṅgādisarvatīrthānyāmuikhīkuru svāhā | oṃ sāvitryai svāhā |	ཨཨོམ་གངགའ་སརྦ་ཏིརཐ་མུ་ཁེ་སབ༹འ་ཧའ་། ཨཨོམ་སརྦ་བི་ཏྲེ་སབ༹འ་ཧའ་། སརྦ་མམ་ག་ལ་དྷའ་ར་ནི་སབ༹འ་ཧའ་། ཙ་ཏུ་རེ་བེ་ད་སརྦ་ནཀཤ་༄༡༠༨བ་ཏྲ༏་གའ་ཧའ་ག་། ནའ་ཧའ་ག་།
 sarvamaṅgaladhāriṇyai (śmdv 100) svāhā | caturvedanakṣatragrahagaṇādimūrtyai svāhā |	ནའ་དྷའ་མའུརྟ་ཡེ་སབ༹འ་ཧའ་།
 brahmaṇe svāhā | viṣṇave svāhā | rudrāya svāhā | viśvamukhāya svāhā |	བྲཧམའ་ཡ་སབ༹འ་ཧའ་། བིཤནུ་ཡེ་སབ༹འ་ཧའ་། རུ་དརའ་ཡ་སབ༹འ་ཧའ་། བི་ཤབ༹་མུ་ཁའ་ཡ་སབ༹འ་ཧའ་།
 oṃ nigrigrini sarvakāryasādhani sini sini āvāhayāmi devi śrīvaiśravaṇāya svāhā | suvarṇadhanadhānyākarṣaṇyai svāhā |	ཨཨོམ་གྲི་ནི་གྲི་ན་སརྦ་ཀའརྱ་སའ་དྷ་ནི་། སི་ནི་སི་ནི་། ཨའ་བའ་ཧའ་། དེ་བ་ཧའ་། བེཨེ་ཤྲ་མ་ནའ་ཡ་སབ༹འ་ཧའ་། སུ་བརྣ་། དྷ་ན་དྷྱ་ནྱ་། ཨའ་ཀརཤ་ནྱེཨེ་སབ༹འ་ཧའ་། སརྦ་པུ་ནྱེཨེ་སབ༹འ་ཧའ་། ཤརའི་ཧེ་བ་ཏེ་ཨའ་ཀརཤ་ནྱེཨེ་སབ༹འ་ཧའ་།
 sarvapuṇyākarṣaṇyai svāhā | śrīdevatākarṣaṇyai svāhā | sarvapāpanāśanyai svāhā | sarvālakṣmīpraśamanyai svāhā |	སརྦ་པའ་པམ་ན་ཤ་མྱེཨེ་སབ༹འ་ཧའ་། སརྦ་ཨཨ་ལཀཤམི་པྲ་ཤ་མ་ནྱེཨེ་སབ༹འ་ཧའ་།
 sarvatathāgatābhiṣiktāyai svāhā |	སརྦ་ཏ་ཐའ་ག་ཏ་ཨཨ་བྷི་ཤེ་ཀ་ཡེ་སབ༹འ་ཧའ་། སརྦ་དེ་བ་ཏ་ཨཨ་བྷི་མུ་ཁ་ཤྲི་ཡེ་ཨཨ་ཡུར་བ་ལ་པརྣ་ཀེ་ར་ཡེ་སབ༹འ་ཧའ་། སརྦ་བ་ཏི་ཏབ༹་མམ་ག་ལ་ཧ་སྟ་ཡ་སབ༹འ་ཧའ་། སིམ་ག་བ་ཧ་ན་ནེ་སབ༹འ་ཧའ་།
 sarvadevatābhimukhaśriye svāhā | āyurbalavarṇakarāyai svāhā |	པདམ་སམ་བྷུ་ཏ་ཡེ་སབ༹འ་ཧའ་།
 sarvapavitramaṅgalahastāyai svāhā | siṃhavāhinyai svāhā | padmasaṃbhūtāyai svāhā | sarvakṛtyakākhordavināśanyai svāhā | imāni tānyabhayāvalokiteśvaraśriyā mahādevyā nāmāni sarvakilviṣanāśanāni sarvapāpavidhvaṃsanakarāṇi sarvapuṇyākarṣaṇakarāṇi sarvālakṣmīpraśamanakarāṇi sarvaśrīsaubhāgyākarṣaṇakarāṇi |	སརྦ་ཀྲ་ཏི་ཀ་ཁོརྡ་བི་ནའ་ཤ་ནེ་སབ༹འ་ཧའ་། འཇིགས་པ་མེད་པ་སྤྱན་རས་གཟིགས་དབང་ཕྱུག་། གང་ལ་ལ་ལྷ་མོ་ཆེན་མོ་དཔལ་གྱི་མིང་ཉེས་སྡིག་ཐམས་ཅད་མེད་པར་བྱེད་པ་། སྡིག་པ་ཐམས་ཅད་འཇོམས་པར་བྱེད་པ་། བསོད་ནམས་ཐམས་ཅད་སྡུད་པར་བྱེད་པ་། བཀྲ་མི་ཤིས་པ་ཐམས་ཅད་མེད་པར་བྱེད་པ་།
 yaḥ kaścidvārayiṣyati imāni tathāgatanāmāni kalyamutthāya śucinā sarvabuddhānāṃ puṣpadhūpaṃ dattvā śriyai mahādevyai candanadhūpaṃ dattvā vācayitavyāni sarvaśriyamadhigamiṣyati	དཔལ་དང་། བདེ་བ་དང་། སྐལ་པ་བཟང་པོ་ཐམས་ཅད་སྡུད་པར་བྱེད་པ་འདི་དག་དང་། དེ་བཞིན་གཤེགས་པའི་མཚན་འདི་དག་འཆང་བ་དང་། ཀློག་པར་བྱེད་པ་དེས་ནང་པར་ལངས་ཏེ་གཙང་པར་བྱས་ལ་སངས་རྒྱས་ཐམས་ཅད་ལ་མེ་ཏོག་དང་བདུག་པ་གསོལ་ནས་ལྷ་མོ་ཆེན་མོ་དཔལ་ལ་ཡང་ཙནདན་གྱི་བདུག་པ་ཕུལ་ཏེ་བཀླགས་ན་། དེས་དཔལ་ཐམས་ཅད་མཐོང་བར་འགྱུར་༎
 sarvasukhasaumanasyalābhī bhaviṣyati sarvadevatāśca rakṣāvaraṇaguptiṃ kariṣyanti	བདེ་བ་དང་། ཡིད་བདེ་བ་ཐམས་ཅད་ཐོབ་པར་འགྱུར་། ལྷ་ཐམས་༄༡༠༩ཨ་༌༎ ཅད་ཀྱང་སྲུང་བ་དང་། བསྐྱབ་པ་དང་། སྦེད་པ་བྱེད་པར་འགྱུར་༎
 sarvakāryasiddhistasya bhaviṣyati | idamavocadbhagavānāttamanā abhayāvalokiteśvaro bodhisattvo mahāsattvaḥ |	དེའི་དགོས་པ་ཐམས་ཅད་འགྲུབ་པར་འགྱུར་རོ་༎
