skt	tib
 advayaparamārthā nāmasaṃgīti oṃ namaḥ śrīmahāmañjunāthāya atha vajradharaḥ śrīmān durdāntadamakaḥ paraḥ |	དེ་ནས་དཔལ་ལྡན་རྡོ་རྗེ་འཆང་༎ གདུལ་དཀའ་འདུལ་བ་རྣམས་ཀྱི་མཆོག་།
 trilokavijayī vīro guhyarāṭ kuliśeśvaraḥ || mns_1 ||	དཔའ་བོ་འཇིག་རྟེན་གསུམ་ལས་རྒྱལ་༎ རྡོ་རྗེ་དབང་ཕྱུག་གསང་བའི་རྒྱལ་༎
 vibuddhapuṇḍarīkākṣaḥ protphullakamalānanaḥ |	རྣམ་རྒྱས་པདམ་དཀར་པོའི་སྤྱན༏་༏པདམ་རབ་ཏུ་རྒྱས་པའི་ཞལ་༎ རང་གི་ལག་གི་རྡོ་རྗེ་མཆོག་།
 prollālayan vajravaraṃ svakareṇa muhurmuhuḥ || mns_2 ||	ཡང་དང་ཡང་དུ་གསོར་བྱེད་པ་༎ ཁྲོ་གཉེར་ལྡན་པའི་རླབས་ལ་སོགས་༎
 bhṛkuṭītaraṅgapramukhair anantair vajrapāṇibhiḥ | durdāntadamakair vīrair vīrabībhatsarūpibhiḥ || mns_3 ||	ལག་ན་རྡོ་རྗེ་མཐའ་ཡས་པ་༎ ༼༌༎ རྒྱལ་བ་གཉིས་པ་འཇམ་མགོན་བློ་བཟང་གྲགས་༎༽ ༼༌༎ མཁས་བཙུན་བཟང་གྲུབ ༧རྒྱལ་མཆོག་ཐུབ་བསྟན་མཚོན་ཁ་?་༽ ༄༢བ་དཔའ་བོ་གདུལ་དཀའ་འདུལ་བ་པོ་༎ དཔའ་བོ་འཇིགས་རུང་གཟུགས་ཅན་དང་༎ རྡོ་རྗེ་རྩེ་མོ་རབ་འཕྲོ་བ་༎
 ullālayadbhiḥ svakaraiḥ prasphuradvajrakoṭibhiḥ |	རང་གི་ལག་གིས་གསོར་བྱེད་པ་༎
 prajñopāyamahākaruṇā- jagadarthakaraiḥ paraḥ || mns_4 ||	ཤེས་རབ་ཐབས་དང་སྙིང་རྗེ་ཆེ་༎ འགྲོ་དོན་བྱེད་པ་རྣམས་ཀྱི་མཆོག་། དགའ་མགུ་རངས་པའི་བསམས་པ་ཅན་༎
 hṛṣṭatuṣṭāśayair muditaiḥ krodhavigraharūpibhiḥ |	ཁྲོ་བོའི་ལུས་ཀྱི་གཟུགས་ལྡན་པ་༎ སངས་རྒྱས་འཕྲིན་ལས་བྱེད་པའི་མགོན་༎
 buddhakṛtyakarair nāthaiḥ sārddhaṃ praṇatavigrahaiḥ || mns_5 ||	ལུས་བཏུད་རྣམས་ཀྱིས་ལྷན་ཅིག་ཏུ་༎
 praṇamya nāthaṃ saṃbuddhaṃ bhagavantaṃ tathāgatam |	མགོན་པོ་བཅོམ་ལྡན་དེ་བཞིན་གཤེགས་༎ རྫོགས་སངས་རྒྱས་ལ་ཕྱག་འཚལ་ཏེ་༎
 kṛtāñjalipuṭo bhūtvā idam āha sthito 'grataḥ || mns_6 ||	ཐལ་མོ་སྦྱར་བ་བྱས་གྱུར་ནས་༎ སྤྱན་སྔར་འདུག་སྟེ་འདི་སྐད་གསོལ་༎
 maddhitāya mamārthāya anukampāya me vibho |	ཁྱབ་བདག་བདག་ལ་སྨན་པ་དང་༎ བདག་དོན་བདག་ལ་ཐུགས་བརྩེའི་ཕྱིར་༎
 māyājālābhisaṃbodhiṃ yathā lābhī bhavāmy aham || mns_7 ||	སྒྱུ་འཕྲུལ་དྲ་བས་མངོན་རྫོགས་པའི་༎ བྱང་ཆུབ་ཇི་ལྟར་བདག་ཐོབ་མཛོད་༎ ཉོན་མོངས་པས་ནི་སེམས་དཀྲུགས་ཤིང་༎
 ajñānapaṅkamagnānāṃ kleśavyākulacetasām |	མི་ཤེས་འདམ་དུ་བྱིང་བ་ཡི་༎
 hitāya sarvasattvānām anuttaraphalāptaye || mns_8 ||	༄༣ཨ་༅༎ སེམས་ཅན་ཀུན་ལ་སྨན་པ་དང་༎ བླ་མེད་འབྲས་བུ་ཐོབ་པའི་ཕྱིར་༎
 prakāśayatu saṃbuddho bhagavāñ śāstā jagadguruḥ |	བཅོམ་ལྡན་སྟོན་པ་རྫོགས་སངས་རྒྱས་༎ འགྲོ་བའི་བླ་མས་བཤད་དུ་གསོལ་༎
 mahāsamayatattvajña indrayāśayavit paraḥ || mns_9 ||	དམ་ཚིག་ཆེན་པོ་དེ་ཉིད་མཁྱེན་༎ དབང་པོ་བསམ་པ་རིག་པ་མཆོག་། བཅོམ་ལྡན་འདས་ཀྱི་ཡེ་ཤེས་སྐུ་༎
 bhagavajjñānakāyasya mahoṣṇīṣasya gīṣpateh |	གཙུག་ཏོར་ཆེན་པོ་ཚིག་གི་བདག་༎
 mañjuśrījñānasattvasya jñānamūrteḥ svayambhuvaḥ || mns_10 ||	འཇམ་དཔལ་ཡེ་ཤེས་སེམས་དཔའ་ཡི་༎ ཡེ་ཤེས་སྐུ་སྟེ་རང་བྱུང་བ་༎
 gambhīrārthām udārārthaṃ mahārthām asamāṃ śivām | ādimadhyāntakalyāṇīṃ nāmasaṃgītim uttamām || mns_11 ||	དོན་ཟབ་དོན་ནི་རྒྱ་ཆེ་ཞིང་༎ དོན་ཆེན་མཚུངས་མེད་རབ་ཞི་བ་༎ ཐོག་མ་བར་དང་མཐར་དགེ་བ་༎ མཚན་ཡང་དག་པར་བརྗོད་པ་མཆོག་།
 yātītair bhāṣitā buddhair bhāṣiṣyante hy anāgatāḥ |	འདས་པའི་སངས་རྒྱས་རྣམས་ཀྱིས་གསུངས་༎
 pratyutpannāś ca saṃbuddhā yāṃ bhāṣante punaḥ punaḥ || mns_12 ||	མ་འོངས་རྣམས་ཀྱང་གསུང་འགྱུར་ལ་༎ ད་ལྟར་བྱུང་བའི་རྫོགས་སངས་རྒྱས་༎ གང་ཡང་ཡང་ཡང་གསུང་བ་གང་༎
 māyājāle mahātantre yā cāsmin saṃpragīyate |	རྒྱུད་ཆེན་སྒྱུ་འཕྲུལ་དྲ་པ་འདིར་༎
 mahāvajradharair hṛṣṭair ameyair mantradhāribhiḥ || mns_13 ||	རྡོ་རྗེ་འཆང་ཆེན་གསང་སྔགས་འཆང་༎ དཔག་མེད་རྣམས་༄༣བ་ཀྱིས་དགྱེས་པ་ཡིས་༎ གང་ཡང་ཡང་དག་རབ་གསུངས་པ་༎
 ahaṃ caināṃ dhārayiṣyāmy ā niryāṇāṃ dṛḍhāśayaḥ |	བདག་ཀྱང་འདི་ནི་གཟུང་བར་བགྱི་༎ བསམ་པ་བརྟན་པོས་ངེས་འབྱུང་བར་༎
 yathā bhavāmy ahaṃ nātha sarvasaṃbuddhaguhyadhṛk || mns_14 || prakāśayiṣye sattvānāṃ yathāśayaviśeṣataḥ |	མགོན་པོ་རྫོགས་སངས་རྒྱས་ཀུན་གྱི་༎ གསང་འཛིན་ཇི་ལྟར་བདག་འགྱུར་བགྱི་༎
 aśeṣakleśanāśāya aśeṣājñānahānaye || mns_15 ||	ཉོན་མོངས་མ་ལུས་བསལ་བ་དང་༎ མི་ཤེས་མ་ལུས་སྤང་བའི་ཕྱིར་༎ སེམས་ཅན་རྣམས་ཀྱི་བསམ་པ་ཡི་༎ ཁྱད་པར་ཇི་བཞིན་རབ་བཤད་འཚལ་༎
 evam adhyeṣya guhyendro vajrapāṇis tathāgatam |	གསང་དབང་ལག་ན་རྡོ་རྗེ་ཡིས་༎ དེ་བཞིན་གཤེགས་ལ་དེ་སྐད་དུ་༎ གསོལ་བཏབ་པ་ཐལ་མོ་སྦྱར་བྱས་ཏེ་༎
 kṛtāñjalipuṭo bhūtvā prahvakāyaḥ sthito 'grataḥ || mns_16 || iti adhyeṣaṇajñānagāthāḥ ṣoḍaśa |	ལུས་བཏུད་ནས་ནི་སྤྱན་སྔར་འདུག་།
 atha śākyamunir bhagavān saṃbuddho dvipadottamaḥ |	དེ་ནས་བཅོམ་ལྡན་ཤའཀྱ་ཐུབ་༎ རྫོགས་པའི་སངས་རྒྱས་རྐང་གཉིས་མཆོག་།
 nirṇamayyāyatāṃ sphītaṃ svajihvāṃ svamukhāc chubhām || mns_17 ||	ཉིད་ཀྱི་ཞལ་ནས་ལྗགས་བཟང་དགེ་༎ རིང་ཞིང་ཡངས་པ་བརྐྱང་མཛད་དེ་༎ འཇིག་རྟེན་གསུམ་པོ་སྣང་བྱེད་ཅིང་༎ བདུད་བཞིའི་དགྲ་རྣམས་འདུལ་བྱེད་པ་༎
 smitaṃ saṃdarśya lokānām apāyatrayaśodhanam | trilokābhāsakaraṇaṃ caturmārāriśāsanam || mns_18 ||	འཇིག་རྟེན་རྣམས་ཀྱི་ངན་སོང་གསུམ་༎ སྦྱོང་བར་བྱེད་པའི་འཛུམ་བསྟན་ནས་༎
 trilokam āpūrayantyā brāhmyā madhurayā girā |	ཚངས་པའི་གསུང་ནི་སྙན་པ་ཡིས་༎ འཇིག་རྟེན་གསུམ་པོ་ཀུན་བཀང་སྟེ་༎
 pratyabhāṣata guhyendraṃ vajrapāṇiṃ mahābalam || mns_19 ||	ལག་ན་རྡོ་རྗེ་སྟོབས་པོ་ཆེ་༎ གསང་དབང་ལ་ནི་སླར་གསུངས་པ་༎
 sādhu vajradhara śrīman sādhu te vajrapāṇaye |	ལེགས་སོ་དཔལ་ལྡན་རྡོ་རྗེ་འཆང་༎ ལག་ན་རྡོ་རྗེ་ཁྱོད་ལེགས་སོ་༎
 yas taṃ jagaddhitārthāya mahākaruṇayānvitaḥ || mns_20 || mahārthāṃ nāmasaṃgītiṃ pavitrām aghanāśinīm |	འགྲོ་ལ་ཕན་པའི་དོན་དུ་ཁྱོད༏་༏སྙིང་རྗེ་ཆེ་དང་ལྡན་གྱུར་ཏེ་༎
 mañjuśrījñānakāyasya mattaḥ śrotuṃ samudyataḥ || mns_21 ||	འཇམ་དཔལ་ཡེ་ཤེས་སྐུ་ཡི་མཚན་༎ ཡང་དག་བརྗོད་པ་དོན་ཆེ་བ་༎ དག་པར་བྱེད་ཅིང་སྡིག་སེལ་བ་༎
 tat sādhu deśayāmy eṣaḥ ahaṃ te guhyakādhipa |	ང་ལས་ཉན་པར་བརྩོན་པ་ནི་༎ ༄༤ཨ་༌༎ གསང་བའི་བདག་པོ་ཁྱོད་ལེགས་སོ་༎ དེ་ཕྱིར་འདི་ནི་ངས་བཤད་བྱ་༎
 śṛṇu tvam ekāgramanās tat sādhu bhagavann iti || mns_22 || iti prativacanajñānagāthāḥ ṣaṭ |	ཁྱོད་ནི་རྩེ་གཅིག་ཡིད་ཀྱིས་ཉོན་༎ བཅོམ་ལྡན་དེ་ནི་ལེགས་ཞེས་གསོལ་༎
 atha śākyamunir bhagavān sakalaṃ mantrakulaṃ mahat |	ད་ནས་བཅོམ་ལྡན་ཤའཀྱ་ཐུབ་༎ གསང་སྔགས་མཐའ་དག་རིགས་ཆེན་པོ་༎
 mantravidyādharakulaṃ vyavalokya kulatrayam || mns_23 ||	གསང་སྔགས་རིག་པ་འཆང་བའི་རིགས་༎ རིགས་གསུམ་ལ་ནི་རྣམ་པར་གཟིགས་༎
 lokalokottarakulaṃ lokālokakulaṃ mahat |	འཇིག་རྟེན་འཇིག་རྟེན་འདས་པའི་རིགས་༎
 mahāmudrākulaṃ cāgryaṃ mahoṣṇīṣakulaṃ mahat || mns_24 || iti ṣaṭkulāvalokanajñānagāthe dve |	འཇིག་རྟེན་སྣང་བྱེད་རིགས་ཆེན་དང་༎ ཕྱག་རྒྱ་ཆེན་པོའི་རིགས་མཆོག་དང་༎ གཙུག་ཏོར་ཆེན་པོའི་རིགས་ཆེན་ནོ་༎
 imāṃ ṣaṇmantrarājānāṃ saṃyuktām advayodayām |	གསང་སྔགས་རྒྱལ་པོ་དྲུག་ལྡན་ཞིགན་༎ གཉིས་སུ་མེད་པར་འབྱུང་བ་དང་༎ སྐྱེ་བ་མེད་པའི་ཆོས་ཅན་འདི་༎
 anutpādadharmiṇīṃ gāthāṃ bhāṣate sma girāṃ pateḥ || mns_25 ||	ཚིག་གི་བདག་པོས་ཚིགས་བཅད་གསུངས་༎ ཨཨ་ཨའ་། ཨཻ་ཨའི་། ཨཽ་ཨའུ་། ཨཨེ་ཨཨེཨེ་། ཨཨོ་ཨཨོཨོ་།
 a ā i ī u ū e ai o au aṃ aḥ sthito hṛdi | jñānamūrtir ahaṃ buddho buddhānāṃ tryadhvavartinām || mns_26 ||	ཨཨམ་ཨཨ༔སཐི་ཏོ་ཧྲི་དི་། ཛཉའ་ན་མའུརྟི་ར་ཧམ་བུདདྷོ་བུདདྷ་ནའམ།
 oṃ vajratīkṣṇaduḥkhacchedaprajñājñānamūrtaye |*	ཏྲྱ་དྷབ༹་བ་རཏཏི་ནམ་ཨཨོམ་བཛྲ་ཏིཀཤན་དུ༔ཁ་ཙཚེ་དེ༔པྲ་ཛཉའ་ཛཉའ་ན་མའུརཏཏ་ཡེ་། ཛཉའ་ན་ཀའ་ཡ་།
 jñānakāyavāgiśvarārāpacanāya te namaḥ || mns_27 ||* iti māyājālābhisaṃbodhikramagāthās tisraḥ |	ཝའ་གའི་ཤབ༹་ར་ཨཨ་ར་པ་ཙ་ན་ཡ་ཏེ་ན་མ༔༎
 tad yathā bhagavān buddhaḥ saṃbuddho 'kārasambhavaḥ |	འདི་ལྟར་སངས་རྒྱས་བཅོམ་ལྡན་འདས་༎ རྫོགས་པའི་སངས་རྒྱས་ཨཨ་ཡིག་བྱུང་༎
 akāraḥ sarvavarṇāgryo mahārthaḥ paramākṣaraḥ || mns_28 ||	ཨཨ་ཡིག་ཡིག་འབྲུ་ཀུན་གྱི་མཆོག་། དོན་ཆེན་འགྱུར་མེད་དམ་པ་ཡིན་༎
 mahāprāṇo hy anutpādo vāgudāhāravarjitaḥ |	སྲོག་ཆེན་པོ་སྟེ་སྐྱེ་བ་མེད༏་༏ཚིག་ཏུ་བརྗོད་པ་སྤངས་པ་སྟེ་༎
 sarvābhilāpahetvagryaḥ sarvavāksuprabhāsvaraḥ || mns_29 ||	བརྗོད་པ་ཀུན་གྱི་རྒྱུ་ཡི་མཆོག་། ཚིག་ཀུན་རབ་ཏུ་གསལ་བར་བྱེད་༎
 mahāmahamahārāgaḥ sarvasattvaratiṃkaraḥ |	མཆོད་པ་ཆེན་པོ་འདོད་ཆགས་ཆེ་༎ སེམས་ཅན་ཐམས་ཅད་༄༤བ་དགའ་བར་བྱེད་༎
 mahāmahamahādveṣaḥ sarvakleśamahāripuḥ || mns_30 ||	མཆོད་པ་ཆེན་པོ་ཞེ་སྡང་ཆེ་༎ ཉོན་མོངས་ཀུན་གྱི་ངག་ཆེ་བ་༎
 mahāmahamahāmoho mūḍhadhīmohasūdanaḥ |	མཆོད་པ་ཆེན་པོ་གཏི་མུག་ཆེ་༎ གཏི་མུག་བློ་སྟེ་གཏི་མུག་སེལ་༎
 mahāmahamahākrodho mahākrodharipur mahān || mns_31 ||	མཆོད་པ་ཆེན་པོ་ཁྲོ་བ་ཆེ་༎ ཁྲོ་བ་ཆེན་པོ་དགྲ་ཆེ་བ་༎
 mahāmahamahālobhaḥ sarvalobhaniṣūdanaḥ |	མཆོད་པ་ཆེན་པོ་ཆགས་པ་ཆེ་༎ ཆགས་པ་ཐམས་ཅད་སེལ་བར་བྱེད་༎
 mahākāmo mahāsaukhyo mahāmodo mahāratiḥ || mns_32 ||	འདོད་པ་ཆེན་པོ་བ་དེ་བ་ཆེ་༎
 mahārūpo mahākāyo mahāvarṇo mahāvapuḥ |	དགའ་བ་ཆེན་པོ་མགུ་བ་ཆེ་༎ གཟུགས་ཆེ་ལུས་ཀྱང་ཆེ་བ་སྟེ་༎ ཁ་དོག་ཆེ་ཞིང་ལུས་བོད་ཆེ་༎
 mahānāmā mahodāro mahāvipulamaṇḍalaḥ || mns_33 ||	མིང་ཡང་ཆེ་ཞིང་རྒྱ་ཆེ་བ་༎ དཀྱིལ་འཁོར་ཆེན་པོ་ཡངས་པ་ཡིན་༎ ཤེས་རབ་ཆེན་པོ་མཚོན་འཆད་བ་༎
 mahāprajñāyudhadharo mahākleśāṅkuśo 'graṇīḥ |	ཉོན་མོངས་ལྕགས་ཀྱུ་ཆེ་བའི་མཆོག་།
 mahāyaśā mahākīrtir mahājyotir mahādyutiḥ || mns_34 ||	གྲགས་ཆེན་སྙན་གྲགས་ཆེན་པོ་སྟེ་༎ སྣང་བ་ཆེན་པོ་གསལ་བ་ཆེ་༎ མཁས་པ་སྒྱུ་འཕྲུལ་ཆེན་པོ་འཆང་༎
 mahāmāyādharo vidvān mahāmāyārthasādhakaḥ |	སྒྱུ་འཕྲུལ་ཆེན་པོ་དོན་སྒྲུབ་པ་༎
 mahāmāyāratirato mahāmāyendrajālikaḥ || mns_35 ||	སྒྱུ་འཕྲུལ་ཆེན་པོ་དགའ་བས་དགའ༎ སྒྱུ་འཕྲུལ་ཆེན་པོ་མིག་འཕྲུལ་ཅན་༎
 mahādānapatiḥ śreṣṭho mahāśīladharo 'graṇīḥ |	སྦྱིན་བདག་ཆེན་པོ་གཙོ་བོ་སྟེ་༎ ཚུལ་ཁྲིམས་ཆེན་པོ་འཆང་བའི་མཆོག་།
 mahākṣāntidharo dhīro mahāvīryaparākramaḥ || mns_36 ||	བཟད་ཆེན་འཆང་བ་བརྟན་པ་སྟེ་༎ བརྩོན་འགྲུས་ཆེན་པོ་ཕ་རོལ་གནོན་༎
 mahādhyānasamādhistho mahāprajñāśarīradḥṛk |	བསམ་གཏན་ཆེན་པོ་ཏིང་འཛིན་གནས་༎ ཤེས་རབ་ཆེན་པོ་ལུས་འཆང་བ་༎
 mahābalo mahopāyaḥ praṇidhir jñanasāgaraḥ || mns_37 ||	སྟོབས་པོ་ཆེ་ལ་ཐབས་ཆེ་བ་༎ སྨོན་ལམ་ཡེ་ཤེས་རྒྱ་མཚོ་སྟེ་༎ བྱམས་ཆེན་རང་བཞིན་དཔག་ཏུ་མེད་༎
 mahāmaitrīmayo 'meyo mahākāruṇiko 'gradhīḥ |	སྙིང་རྗེ་ཆེན་པོ་བློ་ཡི་མཆོག་།
 mahāprajño mahādhīmān mahopāyo mahākṛtiḥ || mns_38 ||	ཤེས་རབ་ཆེན་པོ་བློ་ཆེན་ལྡན་༎ ཐབས་ཆེན་བྱེད་པ་ཆེན་པོ་སྟེ་༎
 mahāṛddhibalopeto mahāvego mahājavaḥ |	རྫུ་འཕྲུལ་ཆེན་པོ་སྟོབས་དང་ལྡན་༎ ཤུགས་ཆེན་མགྱོགས་པ་ཆེན་པོ་སྟེ་༎
 maharddhiko maheśākhyo mahābalaparākramaḥ || mns_39 ||	རྫུ་འཕྲུལ་ཆེན་པོ་ཆེར་གྲགས་པ་༎ སྟོབས་ཆེན་༄༥ཨ་༌༎ ཕ་རོལ་གནོན་པ་པོ་༎
 mahābhavādrīsaṃbhettā mahāvajradharo ghanaḥ |	སྲིད་པའི་རི་བོ་ཆེན་པོ་འཇོམས་༎ མཁྲེགས་ཤིང་རྡོ་རྗེ་ཆེན་པོ་འཆང་༎
 mahākrūro mahāraudro mahābhayabhayaṃkaraḥ || mns_40 ||	དྲག་པོ་ཆེན་པོ་དྲག་ཤུལ་ཆེ་༎ འཇིགས་ཆེན་འཇིགས་པར་བྱེད་པ་པོ༏་༏མགོན་པོ་རིགས་མཆོག་ཆེན་པོ་སྟེ་༎
 mahāvidyottamo nātho mahāmantrottamo guruḥ |	བླ་མ་གསང་སྔགས་ཆེ་བ་མཆོག་།
 mahāyānanayārūḍho mahāyānanayottamaḥ || mns_41 || iti vajradhātumaṇḍalajñānagāthāś caturdaśa |	ཐེག་པ་ཆེན་པོའི་ཚུལ་ལ་གནས་༎ ཐེག་པ་ཆེན་པོའི་ཚུལ་གྱི་མཆོག་༎ སངས་རྒྱས་རྣམ་པར་སྣད་མཛད་ཆེ་།
 mahāvairocano buddho mahāmaunī mahāmuniḥ |	ཐུབ་པ་ཆེན་པོ་ཐུབ་ཆེན་ལྡན་།
 mahāmantranayodbhūto mahāmantranayātmakaḥ || mns_42 ||	གསང་སྔགས་ཚུལ་ཆེན་ལས་བྱུང་བ་༎ གསང་སྔགས་ཚུལ་ཆེན་བདག་ཉིད་ཅན་༎
 daśapāramitāprapto daśapāramitāśrayaḥ |	ཕ་རོལ་ཕྱིན་བཅུ་ཐོབ་པ་སྟེ་༎ ཕ་རོལ་པྱིན་པ་བཅུ་ལ་གནས་༎
 daśapāramitāśuddhir daśapāramitānayaḥ || mns_43 ||	ཕ་རོལ་ཕྱིན་བཅུ་དག་པ་སྟེ་༎ ཕ་རོལ་ཕྱིན་པ་བཅུ་ཡི་ཚུལ་༎
 daśabhūmīśvaro nātho daśabhūmipratiṣṭhitaḥ |	ས་བཅུའི་དབང་ཕྱུག་མགོན་པོ་སྟེ་༎ ས་ཅུ་ལ་ནི་རབ་ཏུ་གནས་༎
 daśajñānaviśuddhātmā daśajñānaviśuddhadhṛk || mns_44 ||	ཤེས་བཅུ་རྣམ་དག་བདག་ཉིད་ཅན་༎
 daśākāro daśārthārtho munīndro daśabalo vibhuḥ |	ཤེས་བཅུ་རྣམ་དག་འཆང་བ་པོ༏་༏རྣམ་པ་བཅུ་པོ་དོན་བཅུའི་དོན་༎ ཐུབ་དབང་སྟོབས་བཅུ་ཁྱབ་པའི་བདག་།
 aśeṣaviśvārthakaro daśākāravaśī mahān || mns_45 ||	ཀུན་གྱི་དོན་ནི་མ་ལུས་བྱེད་༎ རྣམ་བཅུ་དབང་ལྡན་ཆེ་བ་པོ་༎
 anādir niṣprapañcātmā śuddhātmā tathatātmakaḥ |	ཐོག་མ་མེད་པ་སྤྲོས་མེད་བདག་༎ དེ་བཞིན་ཉིད་དག་དག་པའི་བདག་། ཡང་དག་སྨྲ་ཞིང་ཆིག་གཞན་མེད་༎
 bhūtavādī yathāvādī tathākārī ananyavāk || mns_46 ||	ཇི་སྐད་སྨྲས་པ་དེ་བཞིན་བྱེད་༎
 advayo 'dvayavādī ca bhūtakoṭivyavasthitaḥ |	གཉིས་སུ་མེད་པ་གཉིས་མེད་སྨྲ་༎ ཡང་དག་མཐའ་ལ་རྣམ་པར་གནས་༎
 nairātmyasiṃhanirṇādī kutīrthyamṛgabhīkaraḥ || mns_47 ||	བདག་མེད་སེངྒེའི་སྒྲ་དང་ལྡན་༎ མུ་སྟེགས་རི་དབ༹གས་ངན་འཇིགས་བྱེད་༎
 sarvatrago 'moghagatis tathāgatamanojavaḥ |	ཀུན་ཏུ་འགྲོ་པ་དོན་ཡོད་བགྲོད་༎ དེ་བཞིན་གཤེགས་པའི་ཡིད་ལྟར་མགྱོགས་༎
 jino jitārir vijayo cakravartī mahābalaḥ || mns_48 ||	རྒྱལ་བ་དགྲ་རྒྱལ་རྣམ་པར་རྒྱལ་༎ ༄༥བ་འཁོར་ལོས་བསྒྱུར་བ་སྟོབས་པོ་ཆེ་༎
 gaṇamukhyo gaṇācāryo gaṇeśo gaṇapatir vaśī |	ཚོགས་ཀྱི་སློབ་དཔོན་ཚོགས་ཀྱི་གཙོ་༎ ཚོགས་རྗེ་ཚོགས་བདག་དབང་དང་ལྡན་༎
 mahānubhāvo dhaureyo 'nanyaneyo mahānayaḥ || mns_49 ||	མཐུ་ཆེན་གཅེས་པར་འཛིན་པ་སྟེ་༎ ཚུལ་ཆེན་གཞན་གྱི་འདྲེན་པ་མིན་༎
 vāgīśo vākpatir vāgmī vācaspatir anantagīḥ |	ཚིག་རྗེ་ཚིག་བདག་སྨྲ་མཁས་པ་༎
 satyavāk satyavādī ca catuḥsatyopadeśakaḥ || mns_50 ||	ཚིག་ལ་དབང་བ་ཚིག་མཐའ་ཡས་༎ ཚིག་བདེན་བདེན་པར་སྨྲ་བ་དང་༎ བདེན་པ་བཞི་ནི་སྟོན་པ་པོ་༎
 avaivartiko hy anāgāmī khaḍgaḥ pratyekanāyakaḥ |	ཕྱིར་མི་ལྡོག་པ་ཕྱིར་མི་འོང་༎ བསེ་རུ་སོ་སོར་འདྲེན་པ་སྟེ༏་༏ངེས་འབྱུང་སྣ་ཚོགས་ངེས་འབྱུང་བ་༎
 nānāniryāṇaniryāto mahābhūtaikakāraṇaḥ || mns_51 ||	འབྱུང་བ་ཆེན་པོ་རྒྱུ་གཅིག་པུ་༎
 arhan kṣīṇāsravo bhikṣur vītarāgo jitendriyaḥ |	དགེ་སློང་དགྲ་བཅོམ་ཟག་པ་ཟད་༎ འདོད་ཆགས་བྲལ་བ་དབང་པོ་ཐུལ་༎
 kṣemaprāpto 'bhayaprāptaḥ śītībhūto hy anāvilaḥ || mns_52 ||	བདེ་བ་རྙེད་པ་འཇིགས་མེད་ཐོབ་༎ བསིལ་བར་གྱུར་པ་གོས་པ་མེད་༎
 vidyācaraṇasaṃpannaḥ sugato lokavit paraḥ |	རིག་པ་དང་ནི་རྐང་པར་ལྡན་༎ བདེར་གཤེགས་འཇིག་རྟེན་རིག་པ་མཆོག་།
 nirmamo nirahaṃkāraḥ satyadvayanayasthitaḥ || mns_53 ||	བདག་གིར་མི་འཛིན་ངར་མི་འཛིན་༎ བདེན་པ་གཉིས་ཀྱི་ཚུལ་ལ་གནས་༎ འཁྲོ་བའི་ཕ་རོལ་མཐར་གནས་པ་༎
 saṃsārapārakoṭisthaḥ kṛtakṛtyaḥ sthalasthitaḥ |	བྱ་བ་བྱས་པ་སྐམ་སར་གནས་༎ ཡེ་ཤེས་འབའ་ཞིག་ངེས་འབྱུང་བ་༎
 kaivalyajñānaniṣṭhyūtaḥ prajñāśastro vidāraṇaḥ || mns_54 ||	ཤེས་རབ་མཚོན་ཆས་རྣམ་འཇོམས་པ་༎
 saddharmo dharmarāḍ bhāsvāṃl lokālokakaraḥ paraḥ |	དམ་ཆོས་ཆོས་རྒྱལ་གསལ་བར་ལྡན་༎ འཇིག་རྟེན་སྣང་བར་བྱེད་པའི་མཆོག་།
 dharmeśvaro dharmarājaḥ śreyomārgopadeśakaḥ || mns_55 ||	ཆོས་ཀྱི་དབང་ཕྱུག་ཆོས་ཀྱི་རྒྱལ་༎ ལེགས་པའི་ལམ་ནི་སྟོན་པ་པོ་༎
 siddhārthaḥ siddhasaṃkalpaḥ sarvasaṃkalpavarjitah |	དོན་གྲུབ་གྲུབ་པའི་ཀུན་རྟོག་ནི་༎ ཀུན་ཏུ་རྟོག་པ་ཐམས་ཅད་སྤངས་༎
 nirvikalpo 'kṣayo dhātur dharmadhātuḥ paro 'vyayaḥ || mns_56 ||	རྣམ་པར་མི་རྟོག་དབྱིངས་མི་ཟད༏་༏ཆོས་དབྱིངས་དམ་པ་ཟད་མི་ཤེས་༎
 puṇyavān puṇyasaṃbhāro jñānaṃ jñānākaraṃ mahat | jñānavān sadasajjñānī saṃbhāradvayasaṃbhṛtaḥ || mns_57 ||	བསོད་ནམས་ལྡན་པ་བསོད་ནམས་ཚོགས་༎ ཡེ་ཤེས་ཡེ་ཤེས་འབྱུང་གནས་ཆེ་༎ ཡེ་ཤེས་ལྡན་པ་ཡོད་མེད་ཤེས་༎ ཚོགས་གཉིས་ཚོགས་དང་ཡང་༄༦ཨ་༌༎ དག་ལྡན་༎ རྟག་པ་ཀུན་རྒྱལ་རྣལ་འབྱོར་ཅན་༎
 śāśvato viśvarāḍ yogī dhyānaṃ dhyeyo dhiyāṃ patiḥ |	བསམ་གཏན་བསམ་བྱས་བློ་ཡི་བདག་།
 pratyātmavedyo hy acalaḥ paramādyas trikāyadhṛk || mns_58 ||	སོ་སོ་རང་རིག་མི་ག-ཡོ་བ་༎ མཆོག་གི་དང་པོ་སྐུ་གསུམ་འཆང་༎
 pañcakāyātmako buddhaḥ pañcajñānātmako vibhuḥ |	སངས་རྒྱས་སྐུ་ལྔའི་བདག་ཉིད་ཅན་༎ ཁྱབ་བདག་ཡེ་ཤེས་ལྔ་ཡི་བདག་། སངས་རྒྱས་ལྔ་བདག་ཅོད་པན་ཅན་༎
 pañcabuddhātmamukuṭaḥ pañcacakṣur asaṅgadhṛk || mns_59 ||	སྤྱན་ལྔ་ཆགས་པ་མེད་པ་འཆང་༎
 janakaḥ sarvabuddhānāṃ buddhaputraḥ paro varaḥ |	སངས་རྒྱས་ཐམས་ཅད་སྐྱེད་པ་པོ་༎ སངས་རྒྱས་སྲས་པོ་དམ་པ་མཆོག་།
 prajñābhavodbhavo yonir dharmayonir bhavāntakṛt || mns_60 ||	ཤེས་རབ་སྲིད་འབྱུང་སྐྱེ་གནས་ཏེ་༎ ཆོས་ཀྱི་སྐྱེ་གནས་སྲིད་མཐར་བྱེད་༎
 ghanaikasāro vajrātmā sadyojāto jagatpatiḥ |	གཅིག་པུ་སྲེ་མཁྲེགས་རྡོ་རྗེའི་བདག་། འཕྲལ་དུ་བསྐྱེད་པ་འགྲོ་བའི་བདག་།
 gaganodbhavaḥ svayambhūḥ prajñājñānānalo mahān || mns_61 ||	ནམ་མཁའ་ལས་བྱུང་རང་བྱུང་བ་༎ ཤེས་རབ་ཡེ་ཤེས་མེ་བོ་ཆ་༎
 vairocano mahādīptir jñānajyotir virocanaḥ |	འོད་ཆེན་རྣམ་པར་སྣང་བར་བྱེད་༎
 jagatpradīpo jñānolko mahātejāḥ prabhāsvaraḥ || mns_62 ||	ཡེ་ཤེས་སྣང་བ་ལམ་མེ་བ་༎ འགྲོ་བའི་མར་མེ་ཡེ་ཤེས་སྒྲོན་༎ གཟི་བརྗིད་ཆེན་པོ་འོད་གསལ་བ༏་༏རིག་པའི་རྒྱལ་མཆོག་སྔགས་དབང་པོ་༎
 vidyārājo 'gramantreśo mantrarājo mahārthakṛt |	གསང་སྔགས་རྒྱལ་པོ་དོན་ཆེན་བྱེད་༎
 mahoṣṇīṣo 'dbhūtoṣṇīṣo viśvadarśī viyatpatiḥ || mns_63 ||	གཙུག་ཏོར་ཆེན་པོ་རྨད་བྱུང་གཙུག་། ནམ་མཁའི་བདག་པོ་སྣ་ཚོགས་སྟོན་༎
 sarvabuddhātmabhāvāgryo jagadānandalocanaḥ |	སངས་རྒྱས་ཀུན་བདག་དངོས་པོ་མཆོག་། འགྲོ་བ་དགའ་བའི་མིག་དང་ལྡན་༎ སྣ་ཚོགས་གཟུགས་ཅན་སྐྱེད་པ་པོ་༎
 viśvarūpī vidhātā ca pūjyo mānyo mahāṛṣiḥ || mns_64 ||	མཆོད་འོས་རྗེད་འོས་དྲང་སྲོང་ཆེ་༎
 kulatrayadharo mantrī mahāsamayamantradhṛk |	རིགས་གསུམ་འཆང་བ་གསང་སྔགས་ལྡན་༎ དམ་ཚིག་ཆེན་པོ་གསང་སྔགས་འཇིན་༎ གཙོ་བོ་དཀོན་མཆོག་གསུམ་འཛིན་པ་༎
 ratnatrayadharaḥ śreṣṭhas triyānottamadeśakaḥ || mns_65 ||	ཐེག་པ་མཆོག་གསུམ་སྟོན་པ་པོ་༎ དོན་ཡོད་ཞགས་པ་རྣམ་པར་རྒྱལ་།
 amoghapāśo vijayī vajrapāśo mahāgrahaḥ |	འཛིན་པ་ཆེན་པོ་རྡོ་རྗེ་ཞགས་།
 vajrāṅkuśo mahāpāśaḥ vajrabhairavabhīkaraḥ || mns_66 || iti suciśuddhadharmadhātujñānagāthāḥ pādonapañcaviṃśatiḥ |	རྡོ་རྗེ་ལྕགས་ཀྱུ་༄༦བ་ཞགས་པ་ཆེ་༎ རྡོ་རྗེ་འཇིགས་བྱེད་འཇིགས་པར་བྱེད་༎
 krodharāṭ ṣaṇmukho bhīmaḥ ṣaṇnetraḥ ṣaḍbhūjo balī |	ཁྲོ་བོའི་རྒྱལ་པོ་གདོང་དྲུག་འཇིགས་༎ མིག་དྲུག་ལག་དྲུག་སྟོབས་དང་ལྡན་།
 daṃṣṭrakarālaḥ kaṅkālo halāhalaḥ śatānanaḥ || mns_67 ||	ཀེང་རུས་མཆེ་བ་གཙིགས་པ་པོ་༎ ཧ་ལ་ཧ་ལ་གདོང་བརྒྱ་པ་༎
 yamāntako vighnarājo vajravego bhayaṃkaraḥ |	གཤིན་རྗེ་མཐར་བྱེད་བགེགས་ཀྱི་རྒྱལ་༎ རྡོ་རྗེ་ཤུགས་ཅན་འཇིགས་བྱེད་པ་༎ རྡོ་རྗེ་གྲགས་པ་རྡོ་རྗེ་སྙིང་༎
 vighuṣṭavajro hṛdvajro māyāvājro mahodaraḥ || mns_68 ||	སྒྱུ་འཕྲུལ་རྡོ་རྗེ་གསུས་པོ་ཆེ་༎ རྡོ་རྗེ་སྐྱེ་གནས་རྡོ་རྗེའི་དབང་༎
 kuliśeśo vajrayonir vajramaṇḍo nabhopamaḥ |	རྡོ་རྗེ་སྙིང་པོ་མཁའ་འདྲ་བ༏་༏མི་ག-ཡོ་རལ་པ་གཅིག་བསྒྱིངས་པ་༎
 acalaikajaṭāṭopo gajacarmapaṭārdradhṛk || mns_69 ||	གླང་ཆེན་པགས་པ་རློན་པ་འཆང་༎
 hāhākāro mahāghoro hīhīkāro bhayānakaḥ |	དྲག་ཆེན་ཧའ་ཧའ་ཞེས་སྒྲོག་པ་༎ ཧི་ཧི་ཞེས་སྒྲོག་འཇིགས་པར་བྱེད་༎
 aṭṭahāso mahāhāso vajrahāso mahāravaḥ || mns_70 ||	གད་མོ་ཆེན་པོ་གད་རྒྱངས་ཅན་༎ རྡོ་རྗེ་གད་མོ་ཆེར་སྒྲོག་པ་༎
 vajrasattvo mahāsattvo vajrarājo mahāsukhaḥ |	རྡོ་རྗེ་སེམས་དཔའ་སེམས་དཔའ་ཆེ་༎ རྡོ་རྗེ་རྒྱལ་པོ་བདེ་བ་ཆེ་༎ རྡོ་རྗེ་གཏུམ་པོ་དགའ་བ་ཆེ་༎
 vajracaṇḍo mahāmodo vajrahūṃkārahūṃkṛtiḥ || mns_71 ||	རྡོ་རྗེ་ཧའུམ་མཛད་ཧའུམ་གི་གཟུགས་༎
 vajrabāṇāyudhadharo vajrakhaḍgo nikṛntanaḥ |	རྡོ་རྗེ་མདའ་ཡི་མཚོན་འཆང་བ་༎ རྡོ་རྗེ་རལ་གྲིས་གཅོད་མཛད་པ་༎
 viśvavajradharo vajrī ekavajrī raṇañjahaḥ || mns_72 ||	རྡོ་རྗེ་ཀུན་འཆང་རྡོ་རྗེ་ཅན་༎ རྡོ་རྗེ་གཅིག་པུ་ག-ཡུལ་སེལ་བ་༎ རྡོ་རྗེ་འབར་བ་གཙིགས་པའི་མིག་༎
 vajrajvālākarālākṣo vajrajvālāśiroruhaḥ |	མགོ་སྐྱེས་རྡོ་རྗེ་འབར་བ་སྟེ་༎
 vajrāveśo mahāveśaḥ śatākṣo vajralocanaḥ || mns_73 ||	རྡོ་རྗེ་འབེབས་པ་འབེབས་པ་ཆེ་༎ མིག་བརྒྱ་པ་སྟེ་རྡོ་རྗེའི་མིག་།
 vajraromāṅkuratanur vajraromaikavigrahaḥ |	རྡོ་རྗེའི་སྤུ་ནི་མྱུ་གུ་ལུས་༎ རྡོ་རྗེའི་སྤུ་ནི་ལུས་གཅིག་པུ་༎ རྡོ་རྗེ་རྩེ་མོ་སེན་མོས་བརྩམས་༎
 vajrakoṭinakhārambho vajrasāraghanacchaviḥ || mns_74 ||	རྡོ་རྗེ་སྙིང་པོ་པགས་པ་མཁྲེགས་༎
 vajramālādharaḥ śrīmān vajrābharaṇabhūṣitaḥ |	རྡོ་རྗེ་ཕྲེང་ཐོགས་དཔལ་དང་ལྡན་༎ རྡོ་རྗེའི་རྒྱན་གྱིས་བརྒྱན་པ་སྟེ་༎ གད་རྒྱངས་ཧའ་ཧའ་ངས་པར་སྒྲོག་།
 hāhāṭṭahāso nirghoṣo vajraghoṣaḥ ṣaḍakṣaraḥ || mns_75 ||	ཡི་གེ་དྲུག་པ་རྡོ་རྗེའི་སྒྲ་༎
 mañjughoṣo mahānādas trailokyaikaravo mahān |	འཇམ་པའི་དབྱངས་ནི་སྒྲ་ཆེ་བ་༎ འཇིག་རྟེན་གསུམ་གཅིག་སྒྲ་ཆེན་པོ་༎
 ākāśadhātuparyanta- ghoṣo ghoṣavatāṃ varaḥ || mns_76 || ity ādarśajñānagāthāḥ pādena sārdhaṃ daśa |	ནམ་མཁའི་ཁམས་ཀྱི་མཐར་ཐུག་༄༧ཨ་༌༎ སྒྲ༏་༏སྒྲ་དང་ལྡན་པ་རྣམས་ཀྱི་མཆོག་།
 tathatābhūtanairātmya- bhūtakoṭir anakṣaraḥ |	ཡང་དག་མེད་དེ་དེ་བཞིན་ཉིད་༎ ཡང་དག་མཐའ་སྟེ་ཡི་གེ་མེད་༎
 śūnyatāvādivṛṣabho gambhīrodāragarjanaḥ || mns_77 ||	སྟོང་ཉིད་སྨྲ་བའི་ཁྱུ་མཆོག་སྟེ་༎ ཟབ་ཅིང་རྒྱ་ཆེའི་སྒྲ་སྒྲོག་པ་༎
 dharmaśaṅkhyo mahāśabdo dharmagaṇḍī mahāraṇaḥ |	ཆོས་ཀྱི་དུང་སྟེ་སྒྲ་ཆེན་པེ་༎ ཆོས་ཀྱི་གནདའི་སྒྲ་བོ་ཆེ་༎
 apratiṣṭhatanirvāṇo daśadigdharmadundubhiḥ || mns_78 ||	རབ་ཏུ་མི་གནས་མྱ་ངན་འདས་༎ ཕྱོགས་བཅུར་ཆོས་ཀྱི་རྔ་བོ་ཆེ་༎
 arūpo rūpavān agryo nānarūpo manomayaḥ |	གཟུགས་མེད་གཟུགས་ལྡན་དམ་པ་སྟེ་༎ སྣ་ཚོགས་གཟུགས་ཅན་ཡིད་རང་བཞིན་༎
 sarvarūpāvabhāsaśrīr aśeṣapratibimbadhṛk || mns_79 ||	གཟུགས་རྣམས་ཐམས་ཅད་སྣང་བའི་དཔལ་༎ གཟུགས་བརྙན་མ་ལུས་འཆང་བ་པོ་༎ སྣང་བ་མེད་ཅིང་ཆེ་བར་གྲགས་༎
 apradhṛṣyo maheśākhyas traidhātukamaheśvaraḥ |	ཁམས་གསུམ་དབང་ཕྱུག་ཆེན་པོ་སྟེ༏་༏འཕགས་ལམ་ཤིན་ཏུ་མཐོ་ལ་གནས་༎
 samucchritāryamārgastho dharmaketur mahodayaḥ || mns_80 ||	ཆོས་ཀྱི་ཏོག་ནི་ཆེར་འབྱུང་བ་༎
 trailokyaikakumārāṅgaḥ sthaviro vṛddhaḥ prajāpatiḥ |	འཇིག་རྟེན་གསུམ་པོ་གཅིག་གཞོན་ལུས་༎ གནས་བརྟན་རྒན་པོ་སྐྱེ་རྒུའི་བདག་།
 dvātriṃśallakṣaṇadharaḥ kāntas trailokyasundaraḥ || mns_81 ||	སུམ་ཅུ་རྩ་གཉིས་མཚན་འཆང་བ་༎ སྡུག་གུ་འཇིག་རྟེན་གསུམ་ན་མཛེས་༎
 lokajñānaguṇācāryo lokācāryo viśāradaḥ |	སློབ་དཔོན་འཇིག་རྟེན་ཡོན་ཏན་ཤེས་༎ འཇིག་རྟེན་སློབ་དཔོན་འཇིགས་པ་མེད་༎
 nāthas trātā trilokāptaḥ śaraṇaṃ tāyy anuttaraḥ || mns_82 ||	མགོན་སྐྱོབ་འཇིག་རྟེན་གསུམ་ཁྱབ་པ་༎ སྐྱབས་དང་སྐྱོབ་པ་བླ་ན་མེད་༎
 gaganābhogasaṃbhogaḥ sarvajñajñānasāgaraḥ |	ནམ་མཁའ་ཁྱབ་པ་ལོངས་སྤྱོད་པ་༎ ཐམས་ཅད་མཁྱེན་པ་ཡེ་ཤེས་མཚོ་༎
 avidyāṇḍakośasaṃbhettā bhavapañjaradāraṇaḥ || mns_83 ||	མ་རིག་སྒོ་ངའི་སྦུབས་འབྱེད་པ་༎ སྲིད་པའི་དྲ་བ་འཇོམས་པ་པོ་༎
 śamitāśeṣasaṃkleśaḥ saṃsārārṇavapāragaḥ |	ཉོན་མོངས་མ་ལུས་ཞི་བྱེད་པ་༎ འཁོར་བའི་རྒྱ་མཚོ་ཕ་རོལ་སོན་༎
 jñānābhiṣekamukuṭaḥ samyaksaṃbuddhabhūṣaṇaḥ || mns_84 ||	ཡེ་ཤེས་དབང་བསྐུར་ཅོད་པན་ཅན་༎ ཡང་དག་རྫོགས་པའི་སངས་རྒྱས་རྒྱན་༎
 triduḥkhaduḥkhaśamanas tryanto 'nantas trimuktigaḥ |	སྡུག་བསྔལ་གསུམ་གྱི་སྡུག་བསྔལ་༄༧བ་ཞི༏་༏གསུམ་མཐའ་མཐའ་ཡས་གྲོལ་གསུམ་པ་༎
 sarvāvaraṇanirmukta ākāśasamatāṃ gataḥ || mns_85 ||	སྒྲིབ་པ་ཐམས་ཅད་ངེས་པར་གྲོལ་༎ མཁའ་ལྟར་མཉམ་པ་ཉིད་ལ་གནས་༎ ཉོན་མོངས་དྲི་མ་ཀུན་ལས་འདས་༎
 sarvakleśamalātitas tryadhvānadhvagatiṃ gataḥ |	དུས་གསུམ་དུས་མེད་རྟོག་པར་གནས་༎
 sarvasattvamahānāgo guṇaśekharaśekharaḥ || mns_86 ||	སེམས་ཅན་ཀུན་གྱི་ཀླུ་ཆེན་པོ་༎ ཡོན་ཏན་ཐོད་ཅན་རྣམས་ཀྱི་ཐོད་༎
 sarvopādhivinirmukto vyomavartmani susthitaḥ |	ལྷག་མ་ཀུན་ལས་རྣམ་གྲོལ་བ་༎ ནམ་མཁའི་ལམ་ལ་རབ་གནས་པ་༎
 mahācintāmaṇidharaḥ sarvaratnottamo vibhuḥ || mns_87 ||	ཡིད་བཞིན་ནོར་བུ་ཆེན་པོ་འཆང་༎ ཁྱབ་བདག་རིན་ཆེན་ཀུན་གྱི་མཆོག་།
 mahākalpataruḥ sphīto mahābhadraghaṭottamaḥ |	དཔག་བསམ་ཤིང་ཆེན་རྒྱས་པ་སྟེ་༎ བུམ་པ་བཟང་པོ་ཆེ་བའི་མཆོག་།
 sarvasattvārthakṛt kartā hitaiṣī sattvavatsalaḥ || mns_88 ||	བྱེད་པ་སེམས་ཅན་ཀུན་དོན་བྱེད་༎ ཕན་ཐོགས་སེམས་ཅན་མཉེས་གཤིན་པ་༎
 śubhāśubhajñaḥ kālajñaḥ samayajñaḥ samayī vibhuḥ |	བཟང་ངན་ཤེས་པ་དུས་ཤེས་པ་༎ ཁྱབ་བདག་དམ་ཤེས་དམ་ཚིག་ལྡན་༎ དུས་ཤེས་སེམས་ཅན་དབང་པོ་ཤེས་༎
 sattvendriyajño velajño vimuktitrayakovidaḥ || mns_89 ||	རྣམ་གྲོལ་གསུམ་ལ་མཁས་པ་པོ་༎
 guṇī guṇajño dharmajñaḥ praśasto maṅgalodayaḥ |	ཡོན་ཏན་ལྡན་ཞིང་ཡོན་ཏན་ཤེས་༎ ཆོས་ཤེས་རབ་ཞི་བཀྲ་ཤིས་འབྱུང་༎ བཀྲ་ཤིས་ཀུན་གྱི་བཀྲ་ཤིས་པ་༎
 sarvamaṅgalamāṅgalyaḥ kīrtir lakṣmīr yaśaḥ śubhaḥ || mns_90 ||	གྲགས་པ་དཔལ་མོ་སྙན་པ་དགེ་༎
 mahotsavo mahāśvāso mahānando mahāratiḥ |	དབུགས་འབྱིན་ཆེན་པོ་དགའ་སྟོན་ཆེ་༎ དགའ་བ་ཆེན་པོ་རོལ་པ་ཆེ་༎
 satkāraḥ satkṛtir bhūtiḥ pramodaḥ śrīr yaśaspatiḥ || mns_91 ||	བཀུར་སྟི་རིམ་གྲོ་ཕུན་སུམ་ཚོགས་༎ རབ་ཏུ་དགའ་བ་གྲགས་བདག་དཔལ་༎
 vareṇyo varadaḥ śreṣṭhaḥ śaraṇyaḥ śaraṇottamaḥ |	མཆོག་ལྡན་མཆོག་སྤྱིན་གཙོ་བོ་སྟེ་༎ སྐྱབས་ཀྱི་དམ་པ་སྐྱབས་སུ་འོས་༎
 mahābhayāriḥ pravaro niḥśeṣabhayanāśanaḥ || mns_92 ||	རབ་མཆོག་འཇིགས་པ་ཆེན་པོའི་དགྲ༏་༏འཇིགས་པ་མ་ལུས་སེལ་བ་པོ་༎
 śikhī śikhaṇḍī jaṭilo jaṭī mauṇḍī kirīṭimān |	གཙུག་ཕུད་ཕུད་བུ་རལ་པ་ཅན་༎ རལ་བ་མགོ་རེག་ཅོད་པ་ན་ལྡན་༎
 pañcānanaḥ pañcaśikhaḥ pañcacīrakaśekharaḥ || mns_93 ||	གདོང་ལྔ་གཙུག་ཕུད་ལྔ་དང་ལྡན་༎ ཟུར་ཕུད་ལྔ་དང་ལྡན་པའི་ཐོད་༎ མགོ་ཟླུམ་༄༨ཨ་༌༎ བརྟུལ་ཞུགས་ཆེན་པོ་འཆང་༎
 mahāvratadharo mauñjī brahmacārī vratottamaḥ |	ཚངས་པར་སྤྱོད་པ་བརྟུལ་ཞུགས་མཆོག་།
 mahātapās taponiṣṭhaḥ snātako gautamo 'graṇīḥ || mns_94 ||	དཀའ་ཐུབ་མཐར་ཕྱིན་དཀའ་ཐུབ་ཆེ་༎ ཁྲུས་ལྡན་གོཨོའུ་ཏ་མ་མཆོག་།
 brahmavid brāhmaṇo brahmā brahmanirvāṇam āptavān |	བྲམ་ཟེ་། ཚངས་པ་ཚངས་པ་རིག་། ཚངས་པ་མྱ་ངན་འདས་པ་ཐོབ་༎
 muktir mokṣo vimokṣāṅgo vimuktiḥ śāntatā śivaḥ || mns_95 ||	གྲོལ་བ་ཐར་པ་རྣམ་གྲོལ་ལུས་༎ རྣམ་གྲོལ་ཞི་བ་ཞི་བ་ཉིད་༎
 nirvāṇaṃ nirvṛtiḥ śāntiḥ śreyo niryāṇam antagaḥ |	མྱ་ངན་འདས་ཞི་མྱ་ངན་འདས་༎
 sukhaduḥkhāntakṛn niṣṭhā vairāgyam upādhikṣayaḥ || mns_96 ||	ལེགས་པར་ངེས་འབྱུང་མཐར་བྱེད་བ༏་༏བདེ་བ་སྡུག་བསྔལ་མཐར་བྱེད་གནས་༎ འདོད་ཆགས་བྲལ་བ་བརྟགས་པ་ཟད་༎
 ajayo 'nupamo 'vyakto nirābhāso nirañjanaḥ |	ཐུབ་པ་མེད་པ་དཔེ་མེད་པ་༎ གསལ་མིན་མི་སྣང་གོས་པ་མེད་༎
 niṣkalaḥ sarvago vyāpī sūkṣmo bījam anāśravaḥ || mns_97 ||	ཆ་མེད་ཀུན་འགྲོ་ཁྱབ་པ་པོ་༎ ཕྲ་མོ་ས་བོན་ཟག་པ་མེད་༎
 arajo virajo vimalo vāntadoṣo nirāmayaḥ |	རྡུལ་མེད་རྡུལ་བྲལ་དྲི་མ་མེད་༎ ཉེས་པ་སྤངས་པ་སྐྱོན་མེད་པ་༎ ཤིན་ཏུ་རབ་སད་རྣམ་སད་བདག་།
 suprabuddho vibuddhātmā sarvajñāḥ sarvavit paraḥ || mns_98 ||	ཐམས་ཅད་ཡེ་ཤེས་ཀུན་རིག་མཆོག་།
 vijñānadharmatātīto jñān amadvayarūpadhṛk |	རྣམ་པར་ཤེས་པའི་ཆོས་ཉིད་འདས་༎ ཡེ་ཤེས་གཉིས་མང་ཚུལ་འཆང་བ་༎
 nirvikalpo nirābhogas tryadhvasaṃbuddhakāryakṛt || mns_99 ||	རྣམ་པར་རྟོག་མེད་ལྷུན་གྱིས་གྲུབ་༎ དུས་གསུམ་སངས་རྒྱས་ལས་བྱེད་པ་༎
 anādinidhano buddha ādibuddho niranvayaḥ |	སངས་རྒྱས་ཐོག་མ་ཐ་མ་མེད་༎ དང་པོའི་སངས་རྒྱས་རིགས་མེད་པ་༎
 jñānaikacakṣur amalo jñānamūrtis tathāgataḥ || mns_100 ||	ཡེ་ཤེས་མིག་གཅིག་དྲི་མ་མེད་༎ ཡེ་ཤེས་ལུས་ཅན་དེ་བཞིན་གཤེགས་༎
 vāgīśvaro mahāvādī vādirāḍ vādipuṅgavaḥ |	ཚིག་གི་དབང་ཕྱུག་སྨྲ་བ་ཆེ་༎ སྨྲ་བའི་སྐྱེས་མཆོག་སྨྲ་བའི་རྒྱལ་༎ སྨྲ་བའི་དམ་པ་མཆོག་གི་གནས་༎
 vadatāṃ varo variṣṭho vādisiṃho 'parājitaḥ || mns_101 ||	སྨྲ་བའི་སེངྒེ་ཐུབ་པ་མེད་༎
 samantadarśī pramodyas tejomālī sudarśanaḥ |	ཀུན་ཏུ་ལྟ་བ་མཆོག་ཏུ་དགའ༎
 śrīvatsaḥ suprabho dīptir bhā bhāsurakaradyutiḥ || mns_102 ||	གཟི་བརྗིད་ཕྲེང་ལྡན་བལྟ་ན་སྡུག་། འོད་བཟང་འབར་བ་དཔལ་གྱི་བེའུ་༎ སྣང་བ་གསལ་བར་བྱེད་༄༨བ་པའི་འོད་༎
 mahābhiṣagvaraḥ śreṣthaḥ śalyahartā niruttaraḥ |	སྨན་པ་ཆེ་མཆོག་གཙོ་བོ་སྟེ་༎ ཟུག་རྡུ་འབྱིན་པ་བླ་ན་མེད་༎ སྨན་རྣམས་མ་ལུས་ལྗོན་པའི་ཤིང་༎
 aśeṣabhaiṣajyataruḥ kleśavyādhir mahāripuḥ || mns_103 ||	ཉོན་མོངས་ནད་ཀྱི་དགྲ་ཆེ་བ་༎
 trailokyatilakaḥ kāntaḥ śrīmān nakṣatramaṇḍalaḥ |	སྡུག་གུ་འཇིག་རྟེན་གསུམ་གྱི་མཆོག་། དཔལ་ལྡན་རྒྱུ་སྐར་དཀྱིལ་འཁོར་ཙན་༎
 daśadigvyomaparyyanto dharmadhvajamahocchrayaḥ || mns_104 ||	ཕྱོགས་བཅུ་ནམ་མཁའི་མཐར་ཐུག་པ་༎ ཆོས་ཀྱི་རྒྱལ་མཚན་ཆེན་པོ་སྒྲེང་༎ འགྲོ་བའི་གདུགས་གཅིག་ཡངས་པ་སྟེ་༎
 jagacchatraikavipulo maitrīkaruṇamaṇḍalaḥ |	བྱམས་དང་སྙིང་རྗེའི་དཀྱིལ་འཁོར་ཅན་༎
 padmanṛtyeśvaraḥ śrīmān ratnacchatro mahāvibhuḥ || mns_105 ||	དཔལ་ལྡན་པདམ་གར་དབང་ཕྱུག་། ཁྱབ་བདག་ཆེན་པོ་རིན་ཆེན་གདུགས་༎
 sarvabuddhamahārājaḥ sarvabuddhātmabhāvadhṛk |	སངས་རྒྱས་ཀུན་གྱི་རྒྱལ་པོ་ཆེ་༎ སངས་རྒྱས་ཀུན་བདག་དངོས་པོ་འཛིན་༎
 sarvabuddhamahāyogaḥ sarvabuddhaikaśāsanaḥ || mns_106 ||	སངས་རྒྱས་ཀུན་གྱི་རྣལ་འབྱོར་ཆེ་༎ སངས་རྒྱས་ཀུན་གྱི་བསྟན་པ་གཅིག་།
 vajraratnābhiṣekaśrīḥ sarvaratnādhipeśvaraḥ |	རྡོ་རྗེ་རིན་ཆེན་དབང་བསྐུར་དཔལ་༎ རིན་ཆེན་ཀུན་བདག་དབང་ཕྱུག་སྟེ་༎
 sarvalokeśvarapatiḥ sarvavajradharādhipaḥ || mns_107 ||	འཇིག་རྟེན་དབང་ཕྱུག་ཀུན་གྱི་བདག་། རྡོ་རྗེ་ཀུན་འཆང་མངའ་བདག་སྟེ་༎
 sarvabuddhamahācittaḥ sarvabuddhamanogatiḥ |	སངས་རྒྱས་ཀུན་གྱི་ཐུགས་ཆེ་བ་༎ སངས་རྒྱས་ཀུན་གྱི་ཐུགས་ལ་གནས་༎
 sarvabuddhamahākāyaḥ sarvabuddhasarasvatī || mns_108 ||	སངས་རྒྱས་ཀུན་གྱི་སྐུ་ཆེ་བ་༎ སངས་རྒྱས་ཀུན་གྱི་མཚོ་དང་ལྡན་༎
 vajrasūryo mahāloko vajrenduvimalaprabhaḥ |	རྡོ་རྗེ་ཉི་མ་སྣང་བ་ཆེ་༎ རྡོ་རྗེ་ཟླ་བ་དྲི་མེད་འོད་༎
 virāgādimahārāgo viśvavarṇojjvalaprabhaḥ || mns_109 ||	ཆགས་བྲལ་དང་པོ་ཆགས་པ་ཆེ་༎ ཁ་དོག་སྣ་ཚོགས་འབར་བའི་འོད་༎
 saṃbuddhavajraparyaṅko buddhasaṃgītidharmadhṛk |	རྡོ་རྗེ་སྐྱིལ་ཀྲུང་རྫོགས་སངས་རྒྱས་༎ སངས་རྒྱས་བརྗོད་པའི་ཆོས་འཛིན་པ་༎
 buddhapadmodbhavaḥ śrīmān sarvajñajñānakoṣadhṛk || mns_110 ||	དཔལ་ལྡན་སངས་རྒྱས་པདམ་སྐྱེས་༎ ཀུན་མཁྱེན་ཡེ་ཤེས་མཛོད་འཇིན་པ་༎ རྒྱལ་པོ་སྒྱུ་འཕྲུལ་སྣ་ཚོགས་འཆང་༎
 viśvamāyādharo rājā buddhavidyādharo mahān |	ཆེ་བ་སངས་རྒྱས་རིག་བ་འཆང་༎
 vajratīkṣno mahākhaḍgo viśuddhaḥ paramākṣaraḥ || mns_111 ||	རྡོ་རྗེ་རྣོན་བོ་རལ་གྲི་ཆེ་༎ རྣམ་པར་དག་པ་འགྱུར་མེད་མཆོག་།
 duḥkhacchedamahāyāna- vajradharmamahāyudhaḥ |	༄༩ཨ་༌༎ ཐེག་པ་ཆེན་པོ་སྡུག་བསྔལ་གཅོད་༎ མཚོན་ཆ་ཆེན་པོ་རྡོ་རྗེ་ཆོས་༎ རྡོ་རྗེ་ཟབ་མོ་ཛིན་ཛིཀ་།
 jinajig vajragāmbhīryo vajrabuddhir yathārthavit || mns_112 ||	རྡོ་རྗེ་བློ་གྲོས་དོན་བཞིན་རིག་།
 sarvapāramitāpūrī sarvabhūmivibhūṣaṇaḥ |	ཕ་རོལ་ཕྱིན་པ་ཀུན་རྫོགས་པ་༎ ས་རྣམས་ཐམས་ཅད་རྣམ་པར་བརྒྱན་༎
 viśuddhadharmanairātmyaḥ samyagjñānenduhṛtprabhaḥ || mns_113 ||	རྣམ་པར་དག་པ་བདག་མེད་ཆོས་༎ ཡང་དག་ཡེ་ཤེས་ཟླ་སྙིང་འོད་༎
 māyājālamahodyogaḥ sarvatantrādhipaḥ paraḥ |	སྒྱུ་འཕྲུལ་དྲ་བ་རྣལ་འབྱོར་ཆེ་༎ རྒྱུད་ཀུན་གྱི་ནི་བདག་པོ་མཆོག་།
 aśeṣavajraparyaṅko niḥśeṣajñānakāyadhṛk || mns_114 ||	མ་ལུས་རྡོ་རྗེ་སྐྱིལ་ཀླུང་སྟེ་༎ ཡེ་ཤེས་སྐུ་རྣམས་མ་ལུས་འཆང་༎
 samantabhadraḥ sumatiḥ kṣitigarbho jagaddhṛtiḥ |	ཀུན་ཏུ་བཟང་པོ་བློ་གྲོས་བཟང་༎
 sarvabuddhamahāgarbho viśvanirmāṇacakradhṛk || mns_115 ||	ས་ཡི་སྙིང་པོ་འགྲོ་བ་འཛིན་༎ སངས་རྒྱས་ཀུན་གྱི་སྙིང་པོ་ཆེ་༎ སྣ་ཚོགས་སྤྲུལ་པའི་འཁོར་ལོ་འཆང་༎
 sarvabhāvasvabhāvāgryaḥ sarvabhāvasvabhāvavadḥrk |	དངོས་པོ་ཀུན་གྱི་རང་བཞིན་མཆོག་། དངོས་པོ་ཀུན་གྱི་རང་བཞིན་འཛིན་༎
 anutpādadharmā viśvārthaḥ sarvadharmasvabhāvadḥrk || mns_116 ||	སྐྱེ་མེད་ཆོས་ཏེ་སྣ་ཚོགས་དོན་༎ ཆོས་ཀུན་ངོ་བོ་ཉིད་འཆང་བ་༎
 ekakṣaṇamahāprajñaḥ sarvadharmāvabodhadhṛk |	སྐད་ཅིག་གཅིག་ལ་ཤེས་རབ་ཆེ་༎ ཆོས་ཀུན་ཁོང་དུ་ཆུད་། པ་འཆང་༎
 sarvadharmābhisamayo bhūtāntamunir agradhīḥ || mns_117 ||	ཆོས་ཀུན་མངོན་པར་རྟོགས་པ་སྟེ་༎ ཐུབ་པ་བློ་མཆོག་ཡང་དག་མཐའ། མི་ག-ཡོ་རབ་ཏུ་དང་བའི་བདག་༎
 stimitaḥ suprasannātmā samyaksaṃbuddhabodhidhṛk |	རྫོགས་པའི་སངས་རྒྱས་བྱང་ཆུབ་འཆང་༎
 pratyakṣaḥ sarvabuddhānāṃ jñānārciḥ suprabhāsvaraḥ || mns_118 || iti pratyavekṣaṇajñānagāthāḥ dvācatvāriṃśat |	སངས་རྒྱས་ཀུན་གྱི་མངོན་གསུམ་པ་༎ ཡེ་ཤེས་མེ་ལྕེ་འོད་རབ་གསལ་༎
 iṣṭārthasādhakaḥ paraḥ sarvāpāyaviśodhakaḥ |	འདོད་པའི་དོན་སྒྲུབ་དམ་པ་སྟེ་༎ ངན་སོང་ཐམས་ཅད་རྣམ་སྦྱོང་བ་༎
 sarvasattvottamo nāthaḥ sarvasattvapramocakaḥ || mns_119 ||	མགོན་པོ་སེམས་ཅན་ཀུན་གྱི་མཆོག་༎ སེམས་ཅན་ཐམས་ཅད་རབ་གོལ་བདེ་༎
 kleśasaṃgrāmaśūraikaḥ ajñānaripudarpahā |	ཉོན་མོངས་ག-ཡུལ་དུ་གཅིག་དཔའ་བ་༎ མི་ཤེས་དགྲ་ཡེ་དྲེགས་པ་འཇོམས་༎
 dhīḥ śṛṅgāradharaḥ śrīmān vīrabībhatsarūpadhṛk || mns_120 ||	བློ་ནི་སྒེག་འཆང་དཔལ་དང་ལྡན་༎ དཔའ་བོ་མི་སྡུག་གཟུགས་འཆང་བ་༎
 bāhuduṇḍaśatākṣepaḥ padanikṣepanarttanaḥ |	ལག་པའི་དབྱུག་༄༩བ་པ་བརྒྱ་བསྐྱོད་ཅིང་༎
 śrīmacchatabhujābhoga- gaganābhoganarttanaḥ || mns_121 ||	རྐང་པ་བསྐྱོད་པས་གར་བྱེད་པ་༎ དཔལ་ལྡན་ལག་པ་བརྒྱས་གང་ལ་༎ ནམ་མཁའ་ཁྱབ་པར་གར་བྱེད་པ་༎
 ekapādatalākrānta- mahīmaṇḍatale sthitaḥ |	རྐང་པ་གཅིག་གིས་མཐིལ་གནོན་པ་༎
 brahmāṇḍaśikharākrānta- pādāṅguṣṭhanakhe sthitaḥ || mns_122 ||	ས་ཡི་སྙིང་པོ་མཐིལ་ལ་གནས་ཚངས་པའི་སྒོ་ངའི་རྩེ་མོ་གནོན་༎ རྐང་མཐེབ་སེན་མོ་ལ་གནས་པ་༎
 ekārtho 'dvayadharmārthaḥ paramārtho 'vinaśvaraḥ |	དོན་གཅིག་གཉིས་མེད་ཆོས་ཀྱི་དོན་༎ དམ་པའི་དོན་ཏེ་འཇིགས་པ་མེད་༎
 nānāvijñaptirūpārthaś cittavijñānasaṃtatiḥ || mns_123 ||	རྣམ་རིག་སྣ་ཚོགས་རང་བཞིན་དོན་༎ སེམས་དང་རྣམ་ཤེས་རྒྱུད་དང་ལྡན་༎
 aśeṣabhāvārtharatiḥ śūnyatāratir agradhīḥ |	དངོས་པོ་མ་ལུས་དོན་དགའ་བ་༎ སྟོང་པ་ཉིད་དགའ་མཆོག་གི་བློ་།
 bhavarāgādyatītaś ca bhavatrayamahāratiḥ || mns_124 ||	སྲིད་པའི་འདོད་ཆགས་ལ་སོགས་འདས་༎ སྲིད་པ་གསུམ་པོ་དགའ་བ་ཆེ་༎
 śuddhaḥ śubhrābhradhavalaḥ śaraccandrāṃśusuprabhaḥ |	དག་པ་སྤྲིན་དཀར་བཞིན་དུ་དཀར་༎ འོད་བཟང་སྟོན་ཀའི་ཟླ་བའི་འོད་༎ ཉི་མ་འཆར་ཀའི་དཀྱིལ་ལྟར་མཛེས་༎
 bālārkamaṇḍalacchāyo mahārāganakhaprabhaḥ || mns_125 ||	འདོད་ཆགས་ཆེན་པོ་སེན་མོའི་འོད་༎ ཟུར་ཕུད་བཟང་པོ་མཐོན་ཁ་མཆོག་།
 indranīlāgrasaccīro mahānīlakacāgradhṛk |	སྐྲ་མཆོག་མཐོན་ཁ་ཆེན་པོ་འཆང་༎
 mahāmaṇimayūkhaśrīr buddhanirvāṇabhūṣaṇaḥ || mns_126 || lokadhātuśatākampī ṛddhipādamahākramaḥ |	ནོར་བུ་ཆེན་པོ་འོད་ཆགས་དཔལ་༎ སངས་རྒྱས་སྤྲུལ་པའི་རྒྱན་དང་ལྡན་༎ འཇིག་རྟེན་ཁམས་བརྒྱ་ཀུན་བསྐྱོར་པ་༎ རྫུ་འཕྲུལ་རྐང་པ་སྟོབས་ཆེན་ལྡན་༎
 mahāsmṛtidharas tattvaś catuḥsmṛtisamādhirāṭ || mns_127 ||	དེ་ཉིད་དྲན་པ་ཆེན་པོ་འཆང་༎ དྲན་པ་བཞི་པོ་ཏིང་འཛིན་རྒྱལ་༎
 bodhyaṅgakusumāmodas tathāgataguṇodadhiḥ |	བྱང་ཆུབ་ཡན་ལག་མེ་ཏོག་དགའ༎ དེ་བཞིན་གཤེགས་པ་ཡོན་ཏན་མཚོ་༎
 aṣṭāṅgamārganayavit samyaksaṃbuddhamārgavit || mns_128 ||	ལམ་གྱི་ཡན་ལག་བརྒྱད་ཚུལ་རིག་། ཡང་དག་སངས་རྒྱས་ལམ་རིག་པ་༎ སེམས་ཅན་ཀུན་ལ་ཤས་ཆེར་ཆགས་༎
 sarvasattvamahāsaṅgo niḥsaṅgo gaganopamaḥ |	ནམ་མཁའ་ལྟ་བུར་ཆགས་པ་མེད་༎
 sarvasattvamanojātaḥ sarvasattvamanojavaḥ || mns_129 ||	སེམས་ཅན་ཀུན་གྱི་ཡིད་ལས་སྐྱེས་༎ སེམས་ཅན་ཀུན་གྱི་ཡིད་ལྟར་མགྱོགས་༎
 sarvasattvendriyārthajñaḥ sarvasattvamanoharaḥ |	སེམས་ཅན་ཀུན་གྱི་དབང་དོན་ཤེས་༎ སེམས་༄༡༠ཨ་༌༎ ཅན་ཀུན་གྱི་ཡིད་འཕྲོག་པ་༎
 pañcaskandhārthatattvajñaḥ pañcaskandhaviśuddhadhṛk || mns_130 ||	ཕུང་པོ་ལྔ་དོན་དེ་ཉིད་ཤེས་༎ རྣམ་དག་ཕུང་པོ་ལྔ་འཆང་བ་༎ ཐམས་ཅད་ངེས་འབྱུང་མཐའ་ལ་གནས་༎
 sarvaniryāṇakoṭisthaḥ sarvaniryāṇakovidaḥ |	ཐམས་ཅད་ངེས་པར་འབྱུང་བ་མཁའ་ཐམས་ཅད་ངེས་འབྱུང་ལམ་ལ་གནས་༎
 sarvaniryāṇamārgasthaḥ sarvaniryāṇadeśakaḥ || mns_131 ||	ཐམས་ཅད་ངེས་འབྱུང་སྟོན་པ་པོ་༎
 dvādaśāṅgabhavotkhāto dvādaśākāraśuddhadhṛk |	ཡན་ལག་བཅུ་གཉིས་སྲིད་རྩ་བཏོན་༎ དག་པ་རྣམ་པ་བཅུ་གཉིས་འཆང་༎ དབེན་བཞིའི་ཚུལ་གྱི་རྣམ་པ་ཅན་།
 catuḥsatyanayākāro aṣṭajñānāvabodhadhṛk || mns_132 ||	ཤེས་པ་བརྒྱད་པོ་རྟོགས་པ་འཆང་༎
 dvādaśākārasatyārthaḥ ṣoḍaśākāratattvavit |	བདེན་དོན་རྣམ་པ་བཅུ་གཉིས་ལྡན་༎ དེ་ཉིད་རྣམ་པ་བཅུ་དྲུག་རིག་།
 viṃśatyākārasaṃbodhir vibuddhaḥ sarvavit paraḥ || mns_133 ||	རྣམ་པ་ཉི་ཤུས་བྱང་ཆུབ་པ་༎ རྣམ་པར་སངས་རྒྱས་ཀུན་རིག་མཆོག་།
 ameyabuddhanirmāṇa- kāyakoṭivibhāvakaḥ |	དཔག་མེད་སངས་རྒྱས་སྤྲུལ་པ་ཡི་༎ སྐུ་ཡི་མཐའ་ནི་རྣམ་སྒོམ་པ་༎
 sarvakṣaṇābhisamayaḥ sarvacittakṣaṇārthavit || mns_134 ||	སྐད་ཅིག་ཐམས་ཅད་མངོན་པར་རྟོགས་༎ སེམས་ཀྱི་སྐད་ཅིག་དོན་ཀུན་རིག་།
 nānāyānanayopāya- jagadarthavibhāvakaḥ |	ཐེག་པ་སྣ་ཚོགས་ཐབས་ཚུལ་གྱི་༎ འགྲོ་བའི་དོན་གྱི་རྣམ་དབྱེ་ཅན་༎
 yānatritayaniryāta ekayānaphale sthithaḥ || mns_135 ||	ཐེག་པ་གསུམ་གྱི་ངེས་འབྱུང་ནི་༎ ཐེག་པ་གཅིག་གི་འབྲས་བུར་གནས་༎
 kleśadhātuviśuddhātmā karmadhātukṣayaṃkaraḥ |	ཉོན་མོངས་ཁམས་རྣམས་རྣམ་དག་བདག་།
 oghodadhisamuttīrṇo yogakāntāraniḥsṛtaḥ || mns_136 ||	ལས་ཀྱི་ཁམས་རྣམས་ཟད་བྱེད་པ༏་༏ཆུ་བོ་རྒྱ་མཚོ་ཀུན་ལས་རྒལ་༎ སྦྱོར་བའི་དགོན་པ་ལས་བྱུང་བ་༎
 kleśopakleśasaṃkleśa- suprahīṇasavāsanaḥ |	ཉོན་མོངས་ཉེ་ཉོན་ཀུན་ཉོན་མོངས་༎ བག་ཆགས་བཅས་པ་རབ་སྤངས་པ་༎
 prajñopāyamahākaruṇā amoghajagadarthakṛt || mns_137 ||	སྙིང་རྗེ་ཆེན་པོ་ཤེས་རབ་ཐབས་༎ དོན་ཡོད་འགྲོ་བའི་དོན་མཛད་པ་༎ འདུ་ཤེས་ཐམས་ཅད་རབ་སྤངས་དོན་༎
 sarvasaṃjñāprahīṇārtho vijñānārtho nirodhakṛt |	རྣམ་ཤེས་དོན་ནི་འགོག་པ་འཆང་༎
 sarvasattvamanoviṣayaḥ sarvasattvamanogatiḥ || mns_138 ||	སེམས་ཅན་ཀུན་གྱི་ཡིད་ཀྱི་ཡུལ་༎ སེམས་ཅན་ཀུན་གྱི་ཡིད་གནས་པ་༎ སེམས་ཅན་ཀུན་༄༡༠བ་གྱི་ཡིད་ན་གནས་༎
 sarvasattvamano'ntasthas taccittasamatāṃ gataḥ |	དེ་དག་སེམས་དང་མཉམ་ཉིད་སོན་༎
 sarvasattvamanohlādī sarvasattvamanoratiḥ || mns_139 ||	སེམས་ཅན་ཀུན་ཡིད་ཚིམ་པར་བྱེད་༎ སེམས་ཅན་ཀུན་གྱི་ཡིད་དགའ་བ་༎ གྲུབ་མཐའ་འཁྲུལ་པ་ལྡན་པ་མིན་༎
 siddhānto vibhramāpetaḥ sarvabhrāntivivarjitaḥ |	འཁྲུལ་པ་ཐམས་ཅད་རྣམ་པར་སྤངས་༎
 niḥsaṃdigdhamatis tryarthaḥ sarvārthas triguṇātmakaḥ || mns_140 ||	དོན་གསུམ་ཐེ་ཚོམ་མེད་པའི་བློ་༎ ཀུན་དོན་ཡོན་ཏན་གསུམ་གྱི་བདག་༎
 pañcaskandhārthas trikālaḥ sarvakṣaṇavibhāvakaḥ |	དུས་གསུམ་ཕུང་པོ་ལྔ་ཡི་དོན་༎ སྐད་ཅིག་ཐམས་ཅད་རྣམ་སྒོམ་པ་༎
 ekakṣaṇābhisaṃbuddhaḥ sarvabuddhasvabhāvadhṛk || mns_141 ||	སྐད་ཅིག་གཅིག་མངོན་རྫོགས་སངས་རྒྱས་༎ སངས་རྒྱས་ཀུན་གྱི་རང་བཞིན་འཆང་༎
 anaṅgakāyaḥ kāyāgryaḥ kāyakoṭivibhāvakaḥ |	ལུས་མེད་སྐུས་ཏེ་སྐུ་ཡི་མཆོག་། སྐུ་ནི་བྱེ་བ་རྣམ་པར་འགྱེད་༎ གཟུགས་རྣམས་མ་ལུས་ཀུན་ཏུ་སྟོན་༎
 aśeṣarūpasandarśī ratnaketur mahāmaṇiḥ || mns_142 || iti samatājñānatathāścaturviṃśatiḥ |	སྣོར་བུ་ཆེན་པོ་རིན་ཆེན་ཏོག་།
 sarvasaṃbuddhaboddhavyo buddhabodhir anuttaraḥ |	སངས་རྒྱས་ཀུན་གྱིས་རྟོགས་བྱ་བ་༎ སངས་རྒྱས་བྱང་ཆུབ་བླ་ན་མེད་༎
 anakṣaro mantrayonir mahāmantrakulatrayaḥ || mns_143 ||	གསང་སྔགས་སྐྱེ་གནས་ཡི་གེ་མེད་༎ གསང་སྔགས་ཆེན་པོ་རིགས་གསུམ་པ་༎
 sarvamantrārthajanako mahābindur anakṣaraḥ |	གསང་སྔགས་དོན་ཀུན་སྐྱེད་པ་པོ་༎ ཐིག་ལེ་ཆེན་པོ་ཡི་གེ་མེད་༎
 pañcākṣaro mahāśūnyo binduśūnyaḥ ṣaḍakṣaraḥ || mns_144 ||	སྟོང་པ་ཆེན་པོ་ཡི་གེ་ལྔ་༎ ཐིག་ལེ་སྟོང་པ་ཡི་གེ་དྲུག་།
 sarvākāro nirākāraḥ ṣoḍaśārdhārdhabindudhṛk |	རྣམ་པ་ཐམས་ཅད་རྣམ་པ་མེད་༎ བཅུ་དྲུག་ཕྱེད་ཕྱེད་ཐིག་ལེ་ཅན་༎ ཆ་མེད་ཆ་ལྡན་ལས་འདས་པ་༎
 akalaḥ kalanātītaś caturthadhyānakoṭidhṛk || mns_145 ||	བསམ་གཏན་བཞི་པའི་རྩེ་མོ་འཆང་༎
 sarvadhyānakalābhijñāḥ samādhikulagotravit |	བསམ་གཏན་ཡན་ལག་ཀུན་ཤེས་ཤིང་༎ ཏིང་འཛིན་རིག་དང་རྒྱུད་རིག་པ་༎
 samādhikāyaḥ kāyāgryaḥ sarvasaṃbhogakāyarāṭ || mns_146 ||	ཏིང་འཛིན་སྐུ་སྟེ་སྐུ་ཡི་མཆོག་། ལོངས་སྤྱོད་རྫོགས་སྐུ་ཀུན་གྱི་རྒྱལ་༎
 nirmāṇakāyaḥ kāyāngryo buddhanirmāṇavaṃśadhṛk |	སྤྲུལ་པའི་སྐུ་སྟེ་སྐུ་ཡི་མཆོག་། སངས་རྒྱས་སྤྲུལ་པའི་རྒྱུད་འཆང་བ་༎
 daśadigviśvanirmāṇo yathāvaj jagadarthakṛt || mns_147 ||	ཕྱོགས་བཅུར་སྤྲུལ་པ་སྣ་ཚོགས་འགྱེད་༎ ཇི་བཞིན་འགྲོ་བའི་དོན་བྱེད་པ་༎
 devātidevo devendraḥ surendro dānavādhipaḥ | amarendraḥ suraguruḥ pramathaḥ pramatheśvaraḥ || mns_148 ||	ལྷ་ཡི་དབང་པོ་ལྷ་ཡི་ལྷ་༎ ལྷ་མིན་དབང་པོ་སྦྱིན་བྱེད་བདག་། ༄༡༡ཨ་༌༎ ལྷ་ཡི་བླ་མ་འཆི་མེད་དབང་༎ རབ་འཇོམས་རབ་འཇོམས་དབང་ཕྱུག་པོ་༎
 uttīrṇabhavakāntāra ekaḥ śāstā jagadguruḥ |	སྲིད་པའི་དགོན་པ་ལས་རྒལ་བ་༎ སྟོན་པ་གཅིག་པུ་འགྲོ་བའི་བླ་༎
 prakhyātadaśadigloko dharmadānapatir mahān || mns_149 ||	འཇིག་རྟེན་ཕྱོགས་བཅུར་རབ་གྲགས་པ་༎ ཆོས་ཀྱི་སྦྱིན་བདག་ཆེ་བ་པོ་༎
 maitrīsannahasannaddhaḥ karuṇāvarmavarmitaḥ |	བྱམས་པའི་གོ་ཆ་ཆས་པ་སྟེ་༎ སྙིང་རྗེ་ཡི་ནི་ཡ་ལད་བགོས་༎
 prajñākhaḍgadhanurbāṇaḥ kleśājñānaraṇaṃjahaḥ || mns_150 ||	ཤེས་རབ་རལ་གྲི་མདའ་གཞུ་ཐོགས་༎ ཉོན་མོངས་མི་ཤེས་ག-ཡུལ་ངོ་སེལ༏་༏དཔའ་བོ་བདུད་དགྲ་བདུད་འདུལ་བ་༎
 mārārir mārajid vīraś caturmārabhayāntakṛt |	བདུད་བཞིའི་འཇིགས་པ་མཐར་བྱེད་པ་༎ བདུད་དཔུང་ཐམས་ཅད་ཕམ་པར་བྱེད་༎
 sarvamāracamūjetā saṃbuddho lokanāyakaḥ || mns_151 ||	རྫོགས་པའི་སངས་རྒྱས་འཇིག་རྟེན་འདྲེན་༎ མཆོད་འོས་བསྟོད་འོས་ཕྱག་གི་གནས་༎ རྟག་ཏུ་རིམ་གྲོ་བྱ་བའི་འོས་༎
 vandyaḥ pūjyo 'bhivādyaś ca mānanīyaś ca nityaśaḥ |	བཀུར་འོས་རྗེད་པར་བྱ་བའི་མཆོག་།
 arcanīyatamo mānyo namasyaḥ paramo guruḥ || mns_152 ||	ཕྱག་བྱར་འོས་པ་བླ་མའི་མཆོག་།
 trailokyaikakramagatir vyomaparyyantavikramaḥ |	འཇིག་རྟེན་གསུམ་པོ་གོམ་གཅིག་བགྲོད་༎ ནམ་མཁའ་མཐའ་མེད་རྣམ་པར་གནོན་༎
 traividyaḥ śrotriyaḥ pūtaḥ ṣaḍabhijñaḥ ṣaḍanusmṛtiḥ || mns_153 ||	གསུམ་རིག་གཙང་མ་དག་པ་སྟེ་༎ མངོན་ཤེས་དྲུག་ལྡན་རྗེས་དྲན་དྲུག་།
 bodhisattvo mahāsattvo lokātīto maharddhikaḥ |	བྱང་ཆུབ་སེམས་དཔའ་སེམས་དཔའ་ཆེ་༎ རྫུ་འཕྲུལ་ཆེན་པོ་འཇིག་རྟེན་འདས༏་༏ཤེས་རབ་ཕ་རོལ་ཕྱིན་པའི་མཐའ༎
 prajñāpāramitāniṣṭhaḥ prajñātattvatvam āgataḥ || mns_154 ||	ཤེས་རབ་ཀྱི་ནི་དེ་ཉིད་ཐོབ་༎ བདག་རིག་གཞན་རིག་ཐམས་ཅད་པ་༎
 ātmavit paravit sarvaḥ savīryo hy agrapudgalaḥ |	ཀུན་ལ་ཕན་པ་གང་ཟག་མཆོག་། འཇིག་རྟེན་དཔེ་ལས་འདས་པ་སྟེ་༎
 sarvopamām atikrānto jñeyo jñānādhipaḥ paraḥ || mns_155 ||	ཤེས་དང་ཤེས་བྱའི་བདག་པོ་མཆོག་།
 dharmadānapatiḥ śreṣṭhaś caturmudrārthadeśakaḥ |	གཙོ་པོ་ཆོས་ཀྱི་སྦྱིན་པའི་བདག་། ཕྱག་རྒྱ་བཞི་པོའི་དོན་སྟོན་པ་༎ འགྲོ་བའི་བསྙེན་བཀུར་གནས་ཀྱི་མཆོག་།
 paryupāsyatamo jagatāṃ niryāṇatrayayāyinām || mns_156 ||	ངེས་འབྱུང་གསུམ་པོ་བགྲོད་རྣམས་༄༡༡བ་ཀྱི༏་༏དོན་གྱི་དམ་པ་རྣམ་དག་དཔལ་༎
 paramārthaviśuddhaśrīs trailokyasubhago mahān |	འཇིག་རྟེན་གསུམ་གྱི་སྐལ་བཟང་ཆེ་༎
 sarvasampatkaraḥ śrīmān mañjuśrīḥ śrīmatāṃ varaḥ || mns_157 || iti kṛtyānuṣṭhānajñānagāthāḥ pañcadaśaḥ |	དཔལ་ལྡན་འབྱོར་པ་ཀུན་བྱེད་པ་༎ འཇམ་དཔལ་དཔལ་དང་ལྡན་པའི་མཆོག་།
 namas te varadavajrāgrya bhūtakoṭe namo 'stu te |	མཆོག་སྦྱིན་རྡོ་རྗེ་མཆོག་ཁྱོད་འདུད་༎ ཡང་དག་མཐར་གྱུར་ཁྱོད་ལ་འདུད་༎
 namas te śūnyatāgarbha buddhabodhe namostu te || mns_158 ||	སྟོང་ཉིད་སྙིང་པོ་ཁྱོད་ལ་འདུད་༎ སངས་རྒྱས་བྱང་ཆུབ་ཁྱོད་ལ་འདུད་༎
 buddharāga namas te 'stu buddhakāma namo namaḥ |	སངས་རྒྱས་ཆགས་པ་ཁྱོད་ལ་འདུད་༎ སངས་རྒྱས་འདོད་ལ་ཕྱག་འཚལ་འདུད་༎ སངས་རྒྱས་དགྱེས་པ་ཁྱོད་ལ་འདུད་༎
 buddhaprīte namas tubhyaṃ buddhamoda namo namaḥ || mns_159 ||	སངས་རྒྱས་རོལ་ལ་ཕྱག་འཚལ་འདུད་༎ སངས་རྒྱས་འཛུམ་པ་ཁྱོད་ལ་འདུད་༎
 buddhasmita namas tubhyaṃ buddhahāsa namo namaḥ |	སངས་རྒྱས་སྣང་ལ་ཕྱག་འཚལ་འདུད་༎
 buddhavāca namas tubhyaṃ buddhabhāva namo namaḥ || mns_160 ||	སངས་རྒྱས་གསུང་བ་ཁྱོད་ལ་འདུད་༎ སངས་རྒྱས་ཐུགས་ལ་ཕྱག་འཚལ་འདུད་༎ དངོས་མེད་ལས་བྱུང་ཁྱོད་ལ་འདུད་༎
 abhavodbhava namas tubhyaṃ namas te buddhasaṃbhava |	སངས་རྒྱས་འབྱུང་བ་ཁྱོད་ལ་འདུད་༎
 gaganodbhava namas tubhyaṃ namas te jñānasaṃbhava || mns_161 ||	ནམ་མཁའ་ལས་བྱུང་ཁྱོད་ལ་འདུད་༎ ཡེ་ཤེས་ལས་བྱུང་ཁྱོད་ལ་འདུད་༎
 māyājāla namas tubhyaṃ namas te buddhanāṭaka |	སྒྱུ་འཕྲུལ་དྲ་བ་ཁྱོད་ལ་འདུད་༎ སངས་རྒྱས་གར་མཛད་ཁྱོད་ལ་འདུད་༎
 namas te sarvasarvebhyo jñānakāya namo 'stu te || mns_162 || [|||]	ཐམས་ཅད་ཐམས་ཅད་ཁྱོད་ལ་འདུད་༎ ཡེ་ཤེས་སྐུ་ཉིད་ཁྱོད་ལ་འདུད་༎
 iyamasau vajrapāṇeḥ vajradharabhagavato jñānamūrteḥ sarvatathāgatajñānakāyasya mañjuśrījñānasattvasyāveṇikapariśuddhā nāmasaṃgitistavānuttaraprītiprāsādamahodvilya	ལག་ན་རྡོ་རྗེ་རྡོ་རྗེ་འཆང་། འདི་ནི་། བཅོམ་ལྡན་འདས་ཀྱི་ཡེ་ཤེས་ཀྱི་སྐུ་དང་། དེ་བཞིན་གཤེགས་པ་ཐམས་ཅད་ཀྱི་ཡེ་ཤེས་ཀྱི་སྐུ་དང་། འཇམ་དཔལ་ཡེ་ཤེས་སེམས་དཔའི་མ་འདྲེས་པ་ཡོངས་སུ་དག་པའི་མཚན་ཡང་དག་པར་བརྗོད་པའོ་༎
 kāyavāṅmanoguhyapariśuddhyai,	ཁྱོད་ཀྱི་བླ་ན་མེད་པའི་དགའ་བ་དང་རབ་ཏུ་དང་བ་དང་མགུ་བ་ཆེན་པོ་ཡང་དག་པར་བསྐྱེད་པའི་དོན་དང་། སྐུ་དང་གསུང་དང་ཐུགས་ཀྱི་གསང་བ་ཡོངས་སུ་དག་པའི་ཕྱིར་དང་། ཡོངས་སུ་མ་༄༡༢ཨ་༌༎
 aparipūrṇapariśuddhabhūmiparimitāpuṇyajñānasaṃbhāraparipūripariśuddhyai, anadhigatānuttarārthasyādhigamāya, aprāptasya prāptyai,	རྫོགས་པ་དང་ཡོངས་སུ་མ་དག་པའི་ས་དང་ཕ་རོལ་ཏུ་ཕྱིན་པ་དང་བསོད་ནམས་དང་ཡེ་ཤེས་ཀྱི་ཚོགས་ཡོངས་སུ་རྫོགས་པ་དང་ཡོངས་སུ་དག་པའི་ཕྱིར་དང་། བླ་ན་མེད་བའི་དོན་ལྷག་པར་མ་རྟོགས་པ་ལྷག་པར་རྟོགས་པའི་ཕྱིར་དང་། མ་ཐོབ་པ་ཐོབ་པའི་ཕྱིར་དང་། ཇི་སྲིད་དེ་བཞིན་གཤེགས་པ་ཐམས་ཅད་ཀྱི་དམ་པའི་ཆོས་ཀྱི་ཚུལ་ཡང་དག་པར་གཟུང་བའི་དོན་དུ་ཡང་བདག་གིས་བསྟན་པ་དང་། ཡང་དག་པར་རབ་ཏུ་བཤད་པ་དང་། རྣམ་པར་བཀྲོལ་བ་དང་། རྣམ་པར་ཕྱེ་བ་དང་། རབ་ཏུ་གསལ་བར་བྱས་པ་དང་། བྱིན་གྱིས་བརླབས་པའོ་༎ ལག་ན་རྡོ་རྗེ་རྡོ་རྗེ་འཆང་། འདི་ནི་།
 yāvatsarvatathāgatasarvadharmanetrīsaṃdhāraṇārthaṃ ca mayā deśitā,	ངས་ཁྱོད་ཀྱི་རྒྱུད་ལ་སྔགས་ཀྱི་ཆོས་ཉིད་ཐམས་ཅད་ཀྱི་བྱིན་གྱི་རླབས་ཀྱིས་བྱིན་གྱིས་བརླབས་པའོ་༎ འདི་ནི་། འཁོར་ལོ་དང་པོའི་རྗེས་སུ་བསྔགས་པ་བཅུ་གཅིག་གོ་༎ གཞན་ཡང་ལག་ན་རྡོ་རྗེ་རྡོ་རྗེ་འཆང་། མཚན་ཡང་དག་པར་བརྗོད་པ་འདི་ནི་། ཤིན་ཏུ་ཡོངས་སུ་དག་པ་།
 saṃprakāśitā,	ཡོངས་སུ་བྱང་བ་། ཐམས་ཅད་མཁྱེན་པའི་ཡེ་ཤེས་དང་། སྐུ་དང་གསུང་དང་ཐུགས་ཀྱི་གསང་བར་གྱུར་བའོ་༎ དེ་བཞིན་གཤེགས་པ་ཐམས་ཅད་ཀྱི་སངས་རྒྱས་ཀྱི་བྱང་ཆུབ་པའོ་༎ ཡང་དག་པར་རྫོགས་པའི་སངས་རྒྱས་རྣམས་ཀྱི་མངོན་པར་རྟོགས་པའོ་༎ དེ་བཞིན་གཤེགས་པ་ཐམས་ཅད་ཀྱི་བླ་ན་མེད་པའོ་༎ བདེ་བར་གཤེགས་པ་ཐམས་ཅད་ཀྱི་ཆོས་ཀྱི་དབྱིངས་རྟོགས་པའོ་༎ རྒྱལ་བ་རྣམས་ཀྱི་བདུད་ཀྱི་༄༡༢བ་སྟོབས་ཐམས་ཅད་ཕམ་པར་བྱེད་པའོ་༎ སྟོབས་བཅུ་དང་ལྡན་པ་ཐམས་ཅད་ཀྱི་སྟོབས་བཅུའི་སྟོབས་སུ་གྱུར་པའོ་༎ ཐམས་ཅད་མཁྱེན་པའི་ཡེ་ཤེས་རྣམས་ཀྱི་ཐམས་ཅད་མཁྱེན་པའོ་༎ ཆོས་ཐམས་ཅད་ཀྱི་ལུང་ངོ་༎ སངས་རྒྱས་ཐམས་ཅད་ཀྱི་ཡང་དག་པར་ཀུན་ཆུབ་པའོ་༎ བྱང་ཆུབ་སེམས་དཔའ་སེམས་དཔའ་ཆེན་པོ་ཐམས་ཅད་ཀྱི་དྲི་མ་མེད་པ་ཤིན་ཏུ་ཡོངས་སུ་དག་པ་། བསོད་ནམས་དང་ཡེ་ཤེས་ཀྱི་ཚོགས་ཡོངས་སུ་རྫོགས་པའོ་༎ ཉན་ཐོས་དང་རང་སངས་རྒྱས་ཐམས་ཅད་ཀྱི་རབ་ཏུ་སྐྱེ་བའོ་༎ ལྷ་དང་མི་ཐམས་ཅད་ཀྱི་ཕུན་སུམ་ཚོགས་པའི་ཞིང་ངོ་༎ ཐེག་པ་ཆེན་པོའི་རབ་ཏུ་གནས་པའོ་༎ བྱང་ཆུབ་སེམས་དཔའི་སྤྱོད་པའི་འབྱུང་ཁུངས་སོ་༎ འཕགས་པའི་ལམ་ཡང་དག་པའི་མཐར་ཐུག་པའོ་༎ རྣམ་པར་གྲོལ་བ་རྣམས་ཀྱི་བརྟག་པའོ་༎ ངེས་པར་འབྱུང་བའི་ལམ་གྱི་སྐྱེད་པའོ་༎ དེ་བཞིན་གཤེགས་པའི་གདུང་གི་རྒྱུན་མི་འཆད་པའོ་༎ བྱང་ཆུབ་སེམས་དཔའ་ཆེན་པོའི་རིགས་དང་རྒྱུད་རབ་ཏུ་འཕེལ་བའོ་༎ ཕས་ཀྱི་རྒོལ་བ་ཐམས་ཅད་ཀྱི་ཚར་གཅོད་པའོ་༎ མུ་སྟེགས་པ་ཐམས་ཅད་ཀྱི་རྣམ་པར་འཇོམས་པའོ་༎ བདུད་བཞིའི་སྟོབས་དང་དཔུང་དང་སྡེ་རྣམས་ཀྱི་ཕམ་པར་བྱེད་པའོ་༎ སེམས་ཅན་ཐམས་ཅད་ཀྱི་ཡང་དག་པར་། སྡང་པའོ་༎ ངེས་པར་འབྱུང་བས་བགྲོད་པ་ཐམས་ཅད་ཀྱི་འཕགས་པའི་ལམ་ཡོངས་སུ་སྨིན་པའོ་༎ ཚངས་པའི་གནས་བཞི་ལ་གནས་པ་རྣམས་ཀྱི་ཏིང་ངེ་འཛིན་ནོ་༎ སེམས་རྩེ་གཅིག་བ་༄༡༣ཨ་༌༎ རྣམས་ཀྱི་བསམ་གཏན་ནོ་༎ ལུས་དང་ངག་དང་ཡིད་མངོན་པར་སྦྱོར་བ་རྣམས་ཀྱི་རྣལ་འབྱོར་རོ་༎ ཡང་དག་པར་སྦྱོར་པ་ཐམས་ཅད་ཀུན་ཏུ་སྦྱོར་བ་དང་བྲལ་བའོ་༎ ཉོན་མོངས་པ་དང་ཉེ་བའི་ཉོན་མོངས་པ་ཐམས་ཅད་ཀྱི་སྤོང་བའོ་༎ སྒྲིབ་པ་ཐམས་ཅད་ཀྱི་ཉེ་བར་ཞི་བའོ་༎ འཆིང་བ་ཐམས་ཅད་ཀྱི་རྣམ་པར་གྲོལ་བའོ་༎ ལྷག་མ་ཐམས་ཅད་ཀྱི་ཐར་པའོ་༎ སེམས་ཉེ་བར་འཕྲོ་བ་ཐམས་ཅད་ཀྱི་ཞི་བའོ་༎ འབྱོར་པ་ཐམས་ཅད་ཀྱི་འབྱུང་གནས་སོ་༎ རྒུད་པ་ཐམས་ཅད་ཀྱི་རབ་ཏུ་འཇོམས་པའོ་༎ ངན་སོང་གི་སྒོ་ཐམས་ཅད་ཀྱི་འགེབས་པའོ་༎ རྣམ་པར་གྲོལ་བའི་གྲོང་ཁྱེར་གྱི་ལམ་དམ་པའོ་༎ འཁོར་བའི་འཁོར་ལོའི་རབ་ཏུ་མི་འཇུག་པའོ་༎ ཆོས་ཀྱི་འཁོར་ལོའི་རབ་ཏུ་བསྐོར་བའོ་༎ དེ་བཞིན་གཤེགས་པའི་བསྟན་པའི་གདུགས་དང་རྒྱལ་མཚན་དང་བ་དན་རབ་ཏུ་སྒྲེང་བའོ་༎ དམ་བའི་ཆོས་སྟོན་པའི་ལྷག་པར་གནས་པའོ་༎ བྱང་ཆུབ་སེམས་དཔའི་སྔགས་ཀྱི་སྒོའི་སྤྱོད་པ་རྣམས་ཀྱི་མྱུར་དུ་གྲུབ་པའོ་༎ ཤེས་རབ་ཀྱི་ཕ་རོལ་ཏུ་ཕྱིན་པ་རྣམས་ལ་མངོན་པར་སྦྱོར་བ་རྣམས་ཀྱི་སྒོམ་པར་ལྷག་པར་རྟོགས་པའོ་༎ གཉིས་སུ་མེད་པ་སོ་སོར་རྟོག་པར་སྒོམ་པ་མངོན་པར་སྦྱོར་བ་རྣམས་ཀྱི་སྟོང་པ་ཉིད་སོ་སོར་རྟོགས་པའོ་༎ ཕ་རོལ་ཏུ་ཕྱིན་པ་དང་ཚོགས་ཐམས་ཅད་ཀྱི་སྐྱེད་པའོ་༎ ཡོངས་སུ་དག་པའི་ས་དང་ཕ་རོལ་ཏུ་ཕྱིན་པ་ཐམས་ཅད་ཀྱི་ཡོངས་སུ་རྫོགས་པའོ་༎ ཡང་དག་པའི་འཕགས་༄༡༣བ་པའི་བདེན་པ་བཞི་པོ་རྣམས་ཀྱི་སོ་སོར་རྟོག་པའོ་༎ དྲན་པ་ཉེ་པར་གཞག་པ་བཞི་པོ་རྣམས་ཀྱི་ཆོས་ཐམས་ཅད་གཅིག་པའི་སེམས་སོ་སོར་རྟོགས་པའོ་༎ མཚན་ཡང་དག་པར་བརྗོད་པ་འདི་ནི་། ཇི་སྲིད་སངས་རྒྱས་ཀྱི་ཡོན་ཏན་ཐམས་ཅད་ཀྱི་ཡོངས་སུ་རྫོགས་པའི་བར་རོ་༎ འདི་ནི་། འཁོར་ལོ་གཉིས་པའི་རྗེས་སུ་བསྔགས་པ་ལྔ་བཅུ་རྩ་གཉིས་སོ་༎ གཞན་ཡང་ལག་ན་རྡོ་རྗེ་རྡོ་རྗེ་འཆང་། མཚན་ཡང་དག་པར་བརྗོད་པ་འདི་ནི་། སེམས་ཅན་ཐམས་ཅད་ཀྱི་ལུས་དང་ངག་དང་ཡིད་ཀྱིས་ཀུན་ཏུ་སྤྱད་པའི་སྡིག་པ་མ་ལུས་པ་རབ་ཏུ་ཞི་བར་བྱེད་པའོ་༎ སེམས་ཅན་ཐམས་ཅད་ཀྱི་ངན་སོང་ཐམས་ཅད་རྣམ་པར་སྦྱོང་བའོ་༎ ངན་འགྲོ་ཐམས་ཅད་ཟློག་པའོ་༎ ལས་ཀྱི་སྒྲིབ་པ་ཐམས་ཅད་ཡང་དག་པར་གཅོད་པའོ་༎ མི་ཁོམ་པ་བརྒྱད་དུ་སྐྱེ་བར་འགྱུར་བ་ཐམས་ཅད་མི་སྐྱེ་བར་བྱེད་པའོ་༎ འཇིགས་པ་ཆེན་པོ་བརྒྱད་ཉེ་བར་ཞི་བར་བྱེད་པའོ་༎ རྨི་ལམ་ངན་པ་ཐམས་ཅད་ངེས་པར་སེལ་བའོ་༎ མཚན་མ་ངན་པ་ཐམས་ཅད་རྣམ་པར་སེལ་བར་བྱེད་པའོ་༎ ལྟས་ངན་པ་དང་བགེགས་ཐམས་ཅད་ཉེ་བར་ཞི་བར་བྱེད་པའོ་༎ བདུད་ཀྱི་དགྲའི་ལས་ཐམས་ཅད་ཐག་རིང་དུ་བྱེད་པའོ་༎ དགེ་བའི་རྩ་བ་དང་བསོད་ནམས་ཐམས་ཅད་ཉེ་བར་འཕེལ་བར་བྱེད་པའོ་༎ ཚུལ་བཞིན་མ་ཡིན་པའི་ཡིད་ལ་བྱེད་པ་ཐམས་ཅད་མི་སྐྱེ་བར་བྱེད་པའོ་༎ རྒྱགས་བ་དང་ང་རྒྱལ་དང་དྲེགས་པ་དང་ངར་འཛིན་པ་ཐམས་ཅད་ངེས་པར་འཇོམས་པར་བྱེད་པའོ་༎ སྡུག་བསྔལ་དང་ཡིད་མི་༄༡༤ཨ་༌༎ བདེ་བ་ཐམས་ཅད་མི་སྐྱེ་བར་བྱེད་པའོ་༎ དེ་བཞིན་གཤེགས་པ་ཐམས་ཅད་ཀྱི་སྙིང་པོར་གྱུར་པའོ་༎ བྱང་ཆུབ་སེམས་དཔའ་ཐམས་ཅད་ཀྱི་གསང་བར་གྱུར་པའོ་༎ ཉན་ཐོས་དང་རང་སངས་རྒྱས་ཐམས་ཅད་ཀྱི་གསང་ཆེན་དུ་གྱུར་པའོ་༎ ཕྱག་རྒྱ་དང་སྔགས་ཐམས་ཅད་དུ་གྱུར་པའོ་༎ ཆོས་ཐམས་ཅད་བརྗོད་དུ་མེད་པར་སྨྲ་བ་རྣམས་ཀྱི་དྲན་པ་དང་ཤེས་བཞིན་ཡང་དག་པར་སྐྱེད་པའོ་༎ བླ་ན་མེད་པའི་ཤེས་རབ་དང་ཡིད་གཞུང་པར་བྱེད་པའོ་༎ ནད་མེད་པ་དང་སྟོབས་དང་དབང་ཕྱུག་ཕུན་སུམ་ཚོགས་པར་བྱེད་པའོ་༎ དཔལ་དང་དགེ་བ་དང་ཞི་བ་དང་ལེགས་པ་རབ་ཏུ་འཕེལ་བར་བྱེད་པའོ་༎ གྲགས་པ་དང་སྙན་པ་དང་ཚིགས་སུ་བཅད་པ་དང་བསྟོད་པ་རབ་ཏུ་གསལ་བར་བྱེད་པའོ་༎ ནད་དང་འཇིགས་པ་ཆེན་པོ་ཐམས་ཅད་ཉེ་བར་ཞི་བར་བྱེད་པའོ་༎ ཤིན་ཏུ་དག་པ་རྣམས་ཀྱི་ཤིན་ཏུ་དག་པའོ་༎ ཤིན་ཏུ་གཙང་བ་རྣམས་ཀྱི་ཤིན་ཏུ་གཙང་བའོ་༎ ཤིན་ཏུ་འབྱོར་ལྡན་རྣམས་ཀྱི་ཤིན་ཏུ་འབྱོར་ལྡན་ནོ༏་༏ཤིན་ཏུ་བཀྲ་ཤིས་པ་རྣམས་ཀྱི་ཤིན་ཏུ་བཀྲ་ཤིས་པའོ་༎ སྐྱབས་འདོད་པ་རྣམས་ཀྱི་སྐྱབས་སོ་༎ གནས་འདོད་པ་རྣམས་ཀྱི་གནས་སོ་༎ སྐྱོབ་པ་འདོད་པ་རྣམས་ཀྱི་སྐྱོབ་པའོ་༎ དཔུང་གཉེན་མེད་པ་རྣམས་ཀྱི་དཔུང་གཉེན་ནོ་༎ གླིང་འདོད་པ་རྣམས་ཀྱི་གླིང་དུ་གྱུར་པའོ་༎ རྟེན་འདོད་པ་རྣམས་ཀྱི་བླ་ན་མེད་པའི་རྟེན་དུ་གྱུར་པའོ་༎ སྲིད་པའི་རྒྱ་མཚོའི་ང་རོལ་ཏུ་འགྲོ་༄༡༤བ་བ་རྣམས་ཀྱི་གྲུར་གྱུར་པའོ་༎ ནད་ཐམས་ཅད་ངེས་པར་འཇོམས་པའི་ཕྱིར་སྨན་པའི་རྒྱལ་པོ་ཆེན་པོར་གྱུར་པའོ་༎ བླང་བར་བྱ་བ་དང་དོར་བར་བྱ་བའི་དངོས་པོ་རྣམ་པར་དབྱེ་བའི་ཕྱིར་ཤེས་རབ་ཏུ་གྱུར་པའོ་༎ ལྟ་བ་ངན་པའི་མུན་པའི་སྨག་རུམ་ཐམས་ཅད་བསལ་བའི་ཕྱིར་ཡེ་ཤེས་ཀྱི་སྣང་བར་པའོ་༎ གྱུར་པའོ་༎ སེམས་ཅན་ཐམས་ཅད་ཀྱི་བསམ་པ་དང་འདོད་པ་ཇི་ལྟ་བ་བཞིན་དུ་ཡོངས་སུ་རྫོགས་པའི་ཕྱིར་ཡིད་བཞིན་གྱི་ནོར་བུར་པའོ་༎ གྱུར་པའོ་༎ 
 vivṛtā,	གྱུར་པའོ་༎ འཇམ་དཔལ་གྱི་ཡེ་ཤེས་ཀྱི་སྐུ་རབ་ཏུ་ཐོབ་པའི་ཕྱིར་ཐམས་ཅད་མཁྱེན་པའི་ཡེ་ཤེས་སུ་གྱུར་པའོ་༎ སྤྱན་ལྔ་རབ་ཏུ་ཐོབ་པའི་ཕྱིར་ཡོངས་སུ་དག་པའི་ཡེ་ཤེས་གཟིགས་པར་གྱུར་པའོ་༎ ཟང་ཟིང་དང་མི་འཇིགས་པ་དང་ཆོས་ཀྱི་སྦྱིན་པ་རབ་ཏུ་གཏོང་པ་ཉིད་ཀྱིས་ཕ་རོལ་ཏུ་ཕྱིན་པ་དྲུག་ཡོངས་སུ་རྫོགས་པར་གྱུར་པའོ་༎ བསོད་ནམས་དང་ཡེ་ཤེས་ཀྱི་ཚོགས་དང་ཏིང་ངེ་འཛིན་ཡོངས་སུ་རྫོགས་པ་ཉིད་ཀྱིས་ས་བཅུ་རབ་ཏུ་ཐོབ་པར་གྱུར་པའོ་༎ གཉིས་ཀྱི་ཆོས་དང་བྲལ་བའི་ཕྱིར་གཉིས་སུ་མེད་པའི་ཆོས་ཉིད་དོ༏་༏ལྷག་པར་སྒྲོ་འདོགས་པ་དང་བྲལ་བ་ཉིད་ཀྱི་ཕྱིར་དེ་བཞིན་ཉིད་ཀྱི་རང་བཞིན་དང་གཞན་མ་ཡིན་པའི་ཆོས་ཉིད་དོ་༎ དེ་བཞིན་གཤེགས་པ་ཐམས་ཅད་ཀྱི་ཡེ་ཤེས་ཀྱི་སྐུ་ཡོངས་སུ་དག་པའི་རང་བཞིན་ཉིད་ཀྱིས་ཡང་དག་པའི་རང་བཞིན་ཉིད་དོ་༎ ལྟ་བ་ངན་པའི་ཚང་ཚིང་མ་ལུས་པ་ངེས་པར་སེལ་བ་ཉིད་ཀྱིས་རྣམ་པ་ཐམས་ཅད་ཆེན་པོ་སྟོང་པ་ཉིད་ཀྱི་རང་བཞིན་ཉིད་དོ་༎ མཚན་ཡང་དག་༄༡༥ཨ་༌༎ པར་བརྗོད་པ་འདི་ནི་། འདི་ལྟར་གཉིས་སུ་མེད་པའི་ཆོས་ཉིད་ཀྱི་དོན་དང་མིང་ཡང་དག་པར་འཛིན་པ་རབ་ཏུ་གསལ་བར་བྱེད་པ་ཉིད་ཀྱི་ས་ཆོས་ཐམས་ཅད་བརྗོད་དུ་མེད་པར་གྱུར་པའོ་༎ འདི་ནི་། འཁོར་ལོ་གསུམ་པའི་རྗེས་སུ་བསྔགས་པ་ལྔ་བཅུ་རྩ་གཉིས་སོ་༎ གཞན་ཡང་ལག་ན་རྡོ་རྗེ་རྡོ་རྗེ་འཆང་། རིགས་ཀྱི་བུའམ་རིགས་ཀྱི་བུ་མོ་གང་ལ་ལ་སྔགས་ཀྱི་སྒོའི་སྤྱོད་པ་སྤྱོད་པས་བཅོམ་ལྡན་འདས་ཡེ་ཤེས་སེམས་དཔའི་ཡེ་ཤེས་ཀྱི་སྐུ་། དེ་བཞིན་གཤེགས་པ་ཐམས་ཅད་ཀྱི་ཡེ་ཤེས་ཀྱི་སྐུ་གཉིས་སུ་མེད་པ་དོན་དམ་པའི་མཚན་ཡང་དག་པར་བརྗོད་པ་གཙུག་གི་ནོར་བུ་ཞེས་བྱ་བ་འདི་མཐའ་དག་ཡོངས་སུ་རྫོགས་པ་མ་ཚང་བ་མེད་པ་། དུམ་བུ་མ་ཡིན་པ་། ཚིགས་སུ་བཅད་པ་དང་། ཚིག་དང་། ཡི་གེ་འདི་རྣམས་ཉིད་ཀྱི་ཉི་མ་སོ་སོར་དུས་གསུམ་དུ་འཛིན་པར་བྱེད་པ་དང་། རྗོད་པར་བྱེད་པ་དང་། ཀུན་ཆུབ་པར་བྱེད་པ་དང་། ཚུལ་བཞིན་ཡིད་ལ་བྱེད་པ་དང་། གཞན་རྣམས་ལ་ཡང་དུས་ཇི་ལྟ་བར་རྒྱས་པར་ཇི་ལྟ་བ་བཞིན་རབ་ཏུ་གསལ་བར་བྱེད་པ་དང་། མཚན་གྱི་དོན་གཞན་དང་གཞན་རེ་རེ་ཞིང་ཡང་འཇམ་དཔལ་ཡེ་ཤེས་ཀྱི་སྐུ་མངོན་དུ་བྱས་ཏེ་ཡིད་རྩེ་གཅིག་པས་སྒོམ་པར་བྱེད་པ་དང་། 
 vibhajitottānikṛtā,	དང་། ལྷག་པར་མོས་པ་དང་། དེ་ཁོ་ན་ཡིད་ལ་བྱེད་པ་དག་གིས་ཀུན་ནས་སྒོའི་གནས་པས་གནས་པ་དང་། ཆོས་ཐམས་ཅད་སོ་སོར་རྟོགས་པ་དང་། མཆོག་ཏུ་གྱུར་པ་དང་རྙོག་པ་མེད་པ་༄༡༥བ་དང་ཤེས་རབ་ཀྱིས་རྗེས་སུ་འབིགས་པ་དང་། དད་པས་ཡང་དག་པར་བགྲོད་པ་དེ་ལ་ནི་། དུས་གསུམ་དུ་དུས་མེད་པར་སངས་རྒྱས་དང་བྱང་ཆུབ་སེམས་དཔའ་ཐམས་ཅད་ཡང་དག་པར་འདུས་ཏེ་ཡང་དག་པར་གཤེགས་ཤིང་ཡང་དག་པར་བྱོན་ནས་ཆོས་ཐམས་ཅད་ཀྱི་སྒོ་རྣམས་ཉེ་བར་སྟོན་པར་འགྱུར་རོ་༎ བདག་ཉིད་སྒོམ་པ་ཉེ་བར་སྟོན་པར་བྱེད་དོ་༎
 adhiṣṭhatā cayaṃ mayā vajrapāṇe vajradhara tava santāne citte sarvamantradharmatādhiṣṭhāneneti || mns_163 ||	སངས་རྒྱས་དང་བྱང་ཆུབ་སེམས་དཔའ་ཐམས་ཅད་ཀྱི་བྱིན་གྱི་རླབས་ཀྱིས་ཀྱང་ལུས་དང་ངག་དང་ཡིད་ཀྱི་རྒྱུད་ལ་ཡང་དག་པར་བྱིན་གྱིས་རློབ་པར་བྱེད་དོ་༎ སངས་རྒྱས་དང་བྱང་ཆུབ་སེམས་དཔའ་ཐམས་ཅད་ཀྱི་རྗེས་སུ་འཛིན་པས་ཀྱང་འཛིན་པར་བྱེད་དོ་༎ བྱེད་དོ་༎ ཆོས་ཐམས་ཅད་ལ་མི་འཇིགས་པའི་སྤོབས་པ་ཡང་ཉེ་བར་སྒྲུབ་པར་བྱེད་དོ་༎ བྱེད་དོ་༎ བྱེད་དོ་༎ དགྲ་བཅོམ་པ་དང་ཉན་ཐོས་དང་རང་སངས་རྒྱས་ཐམས་ཅད་ཀྱང་འཕགས་པའི་ཆོས་ལ་སྡུག་པའི་བསམ་པ་ཉིད་ཀྱིས་བདག་གི་དངོས་པོ་ཡང་ཉེ་བར་སྟོན་བྱེད་དོ་༎ བྱེད་དོ་༎ བྱེད་དོ་༎ པར་བྱེད་དོ་༎ གདུལ་དཀའ་བ་འདུལ་བ་པོ་རྣམས་ཀྱང་ཁྲོ་བོའི་རྒྱལ་པོ་ཆེན་པོ་དང་། རྡོ་རྗེ་འཆང་ཆེན་པོ་ལ་སོགས་པ་འགྲོ་བ་ཡོངས་སུ་སྐྱོབ་པར་གྱུར་པ་གཟུགས་སྣ་ཚོགས་པའི་སྤྲུལ་པའི་སྐུ་རྣམས་ཀྱིས་མདངས་དང་སྟོབས་དང་གཟི་བརྗིད་ཟིལ་གྱིས་མི་གནོན་པ་ཉིད་དང་། སྔགས་དང་། ཕྱག་རྒྱ་དང་། མངོན་པར་རྫོགས་པ་དང་། དཀྱིལ་འཁོར་རྣམས་ཉེ་བར་སྟོན་པར་བྱེད་དོ་༎ སྔགས་དང་རིག་པའི་རྒྱལ་པོ་མ་ལུས་པ་དང་། བགེགས་དང་ལོག་འདྲེན་དང་བདུད་དང་དགྲ་ཕྱིར་རྒོལ་བ་དང་གཞན་གྱིས་མི་ཐུབ་པ་༄༡༦ཨ་༌༎ ཆེན་པོ་ཐམས་ཅད་ཀྱང་མཚན་མོ་དང་ཉིན་མོར་བཅས་པར་སྐད་ཅིག་སོ་སོར་སྤྱོད་པ་ཐམས་ཅད་དང་། ལམ་རྣམས་སུ་སྲུང་བ་དང་སྐྱོབ་པ་དང་སྦེད་པར་བྱེད་དོ་༎ ཚངས་པ་དང་དབང་པོ་དང་ཉེ་དབང་དང་དྲག་པོ་དང་སྲེད་མེད་ཀྱི་བུ་དང་ཀུན་འགྱེད་གཞོན་ནུ་དང་དབང་ཕྱུག་ཆེན་པོ་དང་སྨིན་དྲུག་གི་བུ་དང་ནག་པོ་ཆེན་པོ་དང་དགའ་བྱེད་དབང་ཕྱུག་དང་གཤིན་རྗེ་དང་ཆུ་ལྷ་དང་ལུས་ངན་དང་འཕྲོག་མ་དང་ཕྱོགས་བཅུའི་འཇིག་རྟེན་སྐྱོང་བ་གང་ཡིན་པ་དེ་དག་ཐམས་ཅད་ཀྱང་རྟག་པར་རྒྱུན་དུ་མཚན་མོ་དང་ཉིན་མོར་བཅས་པ་འགྲོ་བ་དང་གནས་པ་དང་ཉལ་བ་དང་འདུག་པ་དང་གཉིད་ལོག་པ་དང་གཉིད་སད་པ་དང་མཉམ་པར་བཞག་པ་དང་མཉམ་པར་མ་བཞག་པ་དང་གཅིག་པུར་གནས་པ་དང་སྐྱེ་བོ་མང་པོའི་ནང་དུ་སོང་བ་དང་། ཇི་སྲིད་གྲོང་དང་གྲོང་ཁྱེར་དང་གྲོང་རྡལ་དང་ལྗོངས་དང་ཡུལ་འཁོར་དང་རྒྱལ་པོའི་ཕོ་བྲང་ན་གནས་པ་དང་། དབང་པོའི་ཕུར་པ་དང་སྒོ་ཁང་དང་ལམ་སྲང་དང་བཞི་མདོ་དང་སུམ་མདོ་དང་གྲོང་ཁྱེར་གྱི་བར་དང་ཚོང་ཁང་གི་ནང་དུ་གནས་པ་དང་། ཇི་སྲིད་ཁང་སྟོང་དང་རི་དང་དགོན་པ་དང་ཆུ་ཀླུང་དང་དུར་ཁྲོད་དང་ནགས་ཚང་ཚིང་དུ་ཉེ་བར་སོན་པ་དང་། འབགས་པ་དང་མ་འབགས་པ་དང་མྱོས་པ་དང་རབ་ཏུ་མྱོས་པ་ན་རྟག་ཏུ་ཐམས་ཅད་ཀྱི་རྣམ་པ་ཐམས་ཅད་དུ་མཆོག་ཏུ་སྲུང་བ་དང་། སྐྱོབ་པ་དང་། སྦེད་པར་བྱེད་པར་འགྱུར་རོ་༎ ཉིན་མོ་དང་མཚན་མོ་མཆོག་ཏུ་བེ་དི་༄༡༦བ་ལེགས་སུ་བྱེད་པར་འགྱུར་རོ་༎ གཞན་ཡང་གང་དག་ལྷ་དང་ཀླུ་དང་གནོད་སྦྱིན་དང་དྲི་ཟ་དང་ལྷ་མ་ཡིན་དང་ནམ་མཁའ་ལྡིང་དང་མི་འམ་ཅི་དང་ལྟོ་འཕྱེ་ཆེན་པོ་དང་མི་དང་མི་མ་ཡིན་པ་རྣམས་དང་། གཞན་ཡང་གང་དག་གཟའ་དང་རྒྱུ་སྐར་དང་མ་མོ་དང་ཚོགས་ཀྱི་བདག་པོ་རྣམས་དང་། གང་ཡང་མ་མོ་བདུན་པོ་རྣམས་དང་། གང་ཡང་གནོད་སྦྱིན་མོ་དང་སྲིན་མོ་དང་ཤ་ཟ་མོ་རྣམས་ཏེ་། དེ་རྣམས་ཐམས་ཅད་ལྷན་ཅིག་མཐུན་པར་སྡེ་དང་བཅས་པ་འཁོར་དང་བཅས་པ་རྣམས་ཀྱིས་སྤྱོད་ལམ་དང་ལམ་རྣམས་སུ་ཡང་མཆོག་ཏུ་བསྲུང་བ་དང་། བསྐྱབ་པ་དང་། སྦ་བར་བྱེད་པར་འགྱུར་རོ་༎ གཞན་ཡང་དེའི་ལུས་ལ་མདངས་དང་སྟོབས་རབ་ཏུ་འཇུག་པར་བྱེད་དོ་༎ ནད་མེད་པ་དང་སྟོབས་དང་ཚེ་འཕེལ་བ་ཡང་ཉེ་བར་སྒྲུབ་པར་བྱེད་དོ་༎ འདི་ནི་། འཁོར་ལོ་བཞི་པའི་རྗེས་སུ་བསྔགས་པ་བཅུ་དགུ་པའོ་༎ གཞན་ཡང་ལག་ན་རྡོ་རྗེ་རྡོ་རྗེ་འཆང་། མཚན་ཡང་དག་པར་བརྗོད་པ་གཙུག་གི་ནོར་བུ་ཞེས་བྱ་བ་འདི་ནི་། ཉི་མ་སོ་སོར་མ་ཉམས་པར་ཡང་དག་པར་བླངས་ཏེ་མགྲིན་པར་གནས་པ་ལན་གསུམ་དུ་ཁ་ཏོན་དུ་བྱེད་པ་དང་། གླེགས་བམ་ཏུ་ཆུད་པ་ཀློག་པར་བྱེད་པ་དང་། རབ་ཏུ་འདོན་པར་བྱེད་པ་དང་། བཅོམ་ལྡན་འདས་འཇམ་དཔལ་ཡེ་ཤེས་སེམས་དཔའི་གཟུགས་ལ་དམིགས་ཏེ་དེའི་གཟུགས་ཀྱི་རྗེས་སུ་སེམས་པར་བྱེད་པ་དང་། ཡང་དེའི་གཟུགས་ཀྱི་རྗེས་སུ་བསམ་གཏན་བྱེད་པ་དེ་ཉིད་སྤྲུལ་པའི་གཟུགས་ཀྱི་སྐུས་ཡུན་མི་རིང་བ་ཉིད་ལས་གདུལ་བྱའི་དབང་ཉེ་བར་བཟུང་ནས་༄༡༧ཨ་༌༎ མཐོང་བར་འགྱུར་རོ་༎ སངས་རྒྱས་དང་བྱང་ཆུབ་སེམས་དཔའ་ཐམས་ཅད་སྣ་ཚོགས་པའི་སྤྲུལ་བའི་གཟུགས་ཀྱི་སྐུ་དང་ལྷན་ཅིག་གནས་པ་ནམ་མཁའི་མཐིལ་ན་བཞུགས་པ་རྣམས་ཀྱང་མཐོང་བར་འགྱུར་རོ་༎ སེམས་དཔའ་ཆེན་པོ་དེའི་སྐྱེ་བ་ཇི་ལྟར་གྱུར་ཀྱང་ངན་འགྲོ་དང་ངན་སོང་དུ་ལྟུང་བའི་འཇིགས་པ་འབྱུང་བར་མི་འགྱུར་རོ་༎ རིགས་ངན་དུ་སྐྱེ་བར་མི་འགྱུར་རོ་༎ ཡུལ་མཐའ་འཁོབ་ཀྱི་སྐྱེ་བོར་སྐྱེ་བར་མི་འགྱུར་རོ་༎ དབང་པོ་དམན་པར་མི་འགྱུར་རོ་༎ དབང་པོ་མ་ཚང་བར་མི་འགྱུར་རོ་༎ ལོག་པར་ལྟ་བའི་རིགས་སུ་སྐྱེ་བར་མི་འགྱུར་རོ་༎ སངས་རྒྱས་མི་བཞུགས་པའི་སངས་རྒྱས་ཀྱི་ཞིང་རྣམས་སུ་སྐྱེ་བར་མི་འགྱུར་རོ་༎ སངས་རྒྱས་འབྱུང་བ་དང་དེས་བསྟན་པའི་ཆོས་སྤོང་བ་དང་ལྐོག་ཏུ་གྱུར་པར་མི་འགྱུར་རོ་༎ ལྷ་ཚེ་རིང་པོ་རྣམས་སུ་སྐྱེ་བར་མི་འགྱུར་རོ་༎ མུ་གེ་དང་ནད་དང་མཚོན་གྱི་བསྐལ་པ་རྣམས་ལ་སྐྱེ་བར་མི་འགྱུར་རོ་༎ སྙིགས་མ་ལྔའི་དུས་རྣམས་ལ་སྐྱེ་བར་མི་འགྱུར་རོ་༎ རྒྱལ་པོ་དང་ཆོམ་རྐུན་དང་དགྲའི་འཇིགས་པ་འབྱུང་བར་མི་འགྱུར་རོ་༎ རྒུད་པ་དང་དབུལ་བའི་འཇིགས་པ་ཐམས་ཅད་འབྱུང་བར་མི་འགྱུར་རོ་༎ མི་བསྔགས་པ་དང་སྐུར་པ་འདེབས་པ་དང་སྨོད་པ་དང་མི་སྙན་པ་དང་གྲགས་པ་ངན་པའི་འཇིགས་པ་འབྱུང་བར་མི་འགྱུར་རོ་༎ སྐྱེ་བ་བཟང་བོ་དང་རིགས་དང་རུས་ཕུན་སུམ་ཚོགས་པ་འབྱུང་བར་འགྱུར་རོ་༎ ཀུན་ནས་མཛེས་པར་གྱུར་པ་དང་གཟུགས་༄༡༧བ་དང་ཁ་དོག་ཡང་དག་པར་ལྡན་པར་འགྱུར་རོ་༎ འཇིག་རྟེན་པ་རྣམས་ཀྱི་སྡུག་པ་དང་ཡིད་ལ་འབབ་པ་དང་འགྲོགས་ན་མཆོག་ཏུ་བདེ་བ་དང་མཐོང་ན་དགའ་བར་འགྱུར་རོ་༎ འཇིག་རྟེན་པ་རྣམས་ཀྱི་མཛེས་པ་དང་སྐལ་བ་བཟང་པོ་དང་ལྡན་པ་དང་ཚིག་གཟུང་བར་བྱ་བར་འགྱུར་རོ་༎ གང་དང་གང་དུ་སྐྱེ་བར་འགྱུར་བ་དེ་དང་དེར་སྐྱེ་བ་དན་པར་འགྱུར་བར་འགྱུར་རོ་༎ རོ་༎ ལོངས་སྤྱོད་ཆེ་བ་དང་འཁོར་མང་བ་དང་ལོངས་སྤྱོད་མི་ཟད་པ་དང་འཁོར་མི་ཟད་པར་འགྱུར་རོ་༎ སེམས་ཅན་ཐམས་ཅད་ཀྱི་མཆོག་ཏུ་གྱུར་པའི་སྨོན་ལམ་དང་ཡེ་ཤེས་དང་ཡང་དག་པར་ལྡན་པར་འགྱུར་རོ་༎ རང་བཞིན་གྱིས་ཀྱང་ཕ་རོལ་ཏུ་ཕྱིན་པ་དྲུག་གི་ཡོན་ཏན་དང་ཡང་དག་པར་ལྡན་པར་འགྱུར་རོ་༎ ཚངས་པའི་གནས་བཞི་ལ་གནས་པར་འགྱུར་རོ་༎ དྲན་པ་དང་ཤེས་བཞིན་དང་ཐབས་དང་སྟོབས་དང་སྨོན་ལམ་དང་ཡེ་ཤེས་དང་ཡང་དག་པར་ལྡན་པར་འགྱུར་རོ་༎ བསྟན་བཅོས་ཐམས་ཅད་ལ་འཇིགས་པ་མེད་པ་དང་སྨྲ་མཁས་པར་ཡང་འགྱུར་རོ་པར་འགྱུར་རོ་༎ ༎ ཚིག་གསལ་བ་དང་བླུན་པོ་མ་ཡིན་པ་དང་བློ་གསལ་བར་འགྱུར་རོ་པར་འགྱུར་རོ་༎ ༎ ༎ མཁས་པ་དང་ལེ་ལོ་མེད་པ་དང་ཆོག་ཤེས་པ་དང་དོན་ཆེ་བ་དང་སྲེད་པ་མེད་བར་འགྱུར་རོ་༎ སེམས་ཅན་ཐམས་ཅད་ཀྱི་མཆོག་ཏུ་ཡིད་བརྟན་པར་བྱ་བ་དང་སློབ་དཔོན་དང་བླ་མར་བཀུར་བར་བྱ་བར་འགྱུར་རོ་༎ དེའི་སྔོན་མ་ཐོས་པའི་བཟོ་དང་རྩིས་དྲང་ཤེས་པ་དང་བསྟན་བཅོས་ཐམས་ཅད་ཀྱང་དོན་དང་གཞུང་ལས་རབ་ཏུ་གསལ་བ་ཡང་དག་པར་རྟོགས་༄༡༨ཨ་༌༎ པར་འགྱུར་རོ་༎ ཤིན་ཏུ་ཡོངས་སུ་དག་པའི་ཚུལ་ཁྲིམས་དང་འཚོ་བ་དང་ཀུན་ཏུ་སྤྱོད་པ་སྤྱོད་པ་དང་ལྡན་པར་འགྱུར་རོ་༎ ལེགས་པར་རབ་ཏུ་འབྱུང་བ་དང་ལེགས་པར་བསྙེན་པར་རྫོགས་པར་འགྱུར་རོ་༎ ཐམས་ཅད་མཁྱེན་པ་ཉིད་བྱང་ཆུབ་ཀྱི་སེམས་རབ་ཏུ་བརྗེད་པ་མེད་པར་འགྱུར་རོ་༎ ཉན་ཐོས་དང་དགྲ་བཅོམ་པ་དང་རང་སངས་རྒྱས་ཀྱི་ངེས་པ་དང་བགྲོད་པ་ལ་གནས་པར་ནམ་ཡང་མི་འགྱུར་རོ་༎
 iti prathamacakrasyeyamanuśaṃsā ekādaśa padāni [|||]	འདི་ནི་། འཁོར་ལོ་ལྔ་པའི་རྗེས་སུ་བསྔགས་པ་ལྔ་བཅུ་རྩ་གཅིག་གོ་༎ ལག་ན་རྡོ་རྗེ་རྡོ་རྗེ་འཆང་། དེ་ལྟར་ཡོན་ཏན་དཔག་ཏུ་མེད་པ་དང་ཡང་དག་པར་ལྡན་པར་འགྱུར་རོ་༎ རྣམ་པ་དེ་ལྟ་བུའི་ཡོན་ཏན་དཔག་ཏུ་མེད་པ་གཞན་རྣམས་དང་ཡང་དག་པར་ལྡན་པར་འགྱུར་རོ་༎ ལག་ན་རྡོ་རྗེ་རྡོ་རྗེ་འཆང་། དོན་དམ་པའི་མཚན་ཡང་དག་པར་བརྗོད་པ་འདི་ཡང་དག་པར་འཛིན་པའི་སྐྱེས་བུ་གང་ཟག་ནི་། རིང་པོ་མི་ཐོགས་པར་བསོད་ནམས་དང་ཡེ་ཤེས་ཀྱི་ཚོགས་ལེགས་པར་བསགས་ཏེ་ཤིན་ཏུ་མྱུར་བར་སངས་རྒྱས་ཀྱི་ཡོན་ཏན་རྣམས་ཡང་དག་པར་བསྒྲུབས་ནས་བླ་ན་མེད་པ་ཡང་དག་པར་རྫོགས་པའི་བྱང་ཆུབ་མངོན་པར་རྫོགས་པར་འཚང་རྒྱ་བར་། འགྱུར་རོ་༎ བསྐལ་པ་མང་པོར་ཡོངས་སུ་མྱ་ངན་ལས་མི་འདའ་བའི་ཆོས་ཀྱིས་སེམས་ཅན་ཐམས་ཅད་ཀྱི་བླ་ན་མེད་པའི་ཆོས་སྟོན་པ་པོ་དང་ཕྱོགས་བཅུར་ཆོས་ཀྱི་རྔ་བོ་ཆེ་ལྷག་པར་གནས་པའི་ཆོས་ཀྱི་རྒྱལ་པོར་འགྱུར་རོ་༎ འདི་ནི་། འཁོར་༄༡༨བ་ལོ་དྲུག་པའི་བསྔགས་པ་དཔག་ཏུ་མེད་པའོ་༎༎ ཨཨོམ་སརྦ་དྷརམའ་བྷའ་ཝ་སབ༹་བྷའ་བ་བི་ཤུདདྷ་བཛྲ་ཙཀཤུ༔་ཨཨ་ཨའ༔་ཨཨམ་ཨཨ༔་པྲ་ཀྲི་ཏི་པ་རི་ཤུདདྷ༔་སརྦ་དྷརྨ༔་ཡ་དུ་ཏ་། སརྦ་ཏ་ཐའ་ག་ཏ་ཛཉའ་ན་ཀའ་ཡ་མཉཛུ་ཤརའི་པ་རི་ཤུདདྷི་ཏའ་། མུ་པ་དའ་ཡེ་ཏི་། ཨཨ་ཨའ༔་སརྦ་ཏ་ཐའ་ག་ཏ་ཧྲི་ད་ཡ་། ཧ་ར་ཧ་ར་། ཨཨོམ་ཧའུམ་ཧརའི༔་བྷ་ག་ཝན་། ཛཉའ་ན་མུརཏཏི་ཝའ་གའི་ཤབ༹་ར་མ་ཧའ་པའ་ཙ་། སརྦ་དྷརམའ་ག་ག་ནའ་མ་ལ་སུ་པ་རི་ཤུདདྷ་། དྷརམའ་དྷའ་ཏུ་ཛཉའ་ན་གརབྷ་ཨཨ༔།
 atha vajradharaḥ śrīmān hṛṣṭatuṣṭaḥ kṛtāñjaliḥ |	དེ་ནས་དཔལ་ལྡན་རྡོ་རྗེ་འཆང་༎ དགའ་ཞིང་མགུ་ནས་ཐལ་མོ་སྦྱར་༎ མགོན་པོ་བཅོམ་ལྡན་དེ་བཞིན་གཤེགས་༎
 praṇamya nāthaṃ saṃbuddhaṃ bhagavantaṃ tathāgataṃ || mns_*1 ||	རྫོགས་སངས་རྒྱས་ལ་ཕྱག་འཚལ་ནས་༎
 anyaiś ca bahubhir nāthair guhyendrair vajrapāṇibhiḥ |	རྣམ་མང་མགོན་པོ་གཞན་རྣམས་དང་༎ གསང་དབང་ལག་ན་རྡོ་རྗེ་དེ་༎
 sa sārddhaṃ krodharājānaiḥ provācoccair idaṃ vacaḥ || mns_*2 ||	ཁྲོ་བོའི་རྒྱལ་པོར་བཅས་རྣམས་ཀྱིས་༎ གསང་བསྟོད་ནས་ནི་ཚིག་འདི་གསོལ་༎
 anumodāmahe nātha sādhu sādhu subhāṣitam |	མགོན་པོ་བདག་ཅག་རྗེས་ཡི་རང་༎ ལེགས་སོ་ལེགས་སོ་ལེགས་པར་གསུངས་༎ བདག་ཅག་ཡང་དག་རྫོགས་པ་ཡི་༎
 kṛto 'smākaṃ mahān arthaḥ samyaksaṃbodhiprāpakaḥ || mns_*3 ||	བྱང་ཆུབ་ཐོབ་པའི་དོན་ཆེན་མཛད་༎
 jagataś cāpy ānāthasya vimuktiphalakāṅkṣiṇaḥ |	འགྲོ་བ་མགོན་མེད་རྣམས་དང་ནི་༎ རྣམ་གོལ་འབྲས་བུ་འཚལ་བ་ཡི་༎
 śreyo mārgo viśuddho 'yaṃ māyājālanayoditaḥ || mns_*4 ||	རྣམ་དག་ལེགས་པའི་ལམ་འདི་ནི་༎ སྒྱུ་འཕྲུལ་དྲ་བའི་ཚུལ་བསྟན་པ་༎
 gambhīrodāravaipulyo mahārtho jagadarthakṛt |	ཟབ་ཅིང་ཡངས་ལ་རྒྱ་ཆེ་བ་༎ དོན་ཆེན་འགྲོ་བའི་དོན་བྱེད་པ་༎
 buddhānāṃ viṣayo hy eṣa samyaksaṃbuddhabhāṣitaḥ || mns_*5 || ity upasaṃhāragāthāḥ pañca |	སངས་རྒྱས་རྣམས་ཀྱི་ཡུལ་འདི་ནི་༎ རྫོགས་པའི་སངས་རྒྱས་ཀུན་གྱིས་བཤད་།
 ārthamāyājālaṣoḍaśasāhāsrikān mahāyogatantrāntaḥ pātisamādhijālapaṭalād bhagavatā śrīśākyamuninā bhāṣitā bhagavato mañjuśrījñānasattvasyādvayaparamārtha nāmasaṃgītiḥ parisamāptā |	རྣལ་འབྱོར་ཆེན་པོའི་རྒྱུད་སྒྱུ་འཕྲུལ་དྲ་བ་སྟོང་ཕྲག་བཅུ་དྲུག་པའི་ཏི་?་ལེའུ་?་ལས་?་བྱུང་?་བ་། འཇམ་དཔལ་ཡེ་ཤེས་སེམས་དཔའི་དོན་དམ་པའི་མཚན་ཡང་དག་པར་བརྗོད་པ་བཅོམ་བྱུང་?་བ་། ༄༡༩ཨ་༌༎ ལྡན་འདས་དེ་བཞིན་གཤེགས་པ་ཤའཀྱ་ཐུབ་པས་གསུངས་པ་རྫོགས་སོ་༎༎
 paṇḍita ratnakāji vajrācāryasya bauddhastotrasaṃgrahoddhṛta saṃgrahakartā sampādakaśca janārdanaśāstrī pāṇḍeyaḥ ī| siṅ| likhyata, jayakarta,	ཐུན་མོང་དང་ཐུན་མོང་མ་ཡིན་པའི་གསུང་རབ་ཐམས་ཅད་ལ་དབང་འབྱོར་པའི་བདག་ཉིད་ཆེན་པོ་བླ་མ་དམ་པ་ཆོས་ཀྱི་རྒྱལ་པོའི་བཀའ་དྲིན་གྱིས་ཉེ་བར་བསྐྱངས་པ་སྒྲ་སྒྱུར་གྱི་ལོ་ཙའ་བ་བློ་གྲོས་བརྟན་པས་། བསམ་གཏན་གླིང་གི་དབེན་གནས་སུ་བསྒྱུར་ཞིང་དག་པར་བྱས་པའོ་། སྔོན་གྱི་སྒྲ་སྒྱུར་ཆེན་པོ་དེ་དག་གིས་༎ རྒྱུད་འདི་བསྒྱུར་ཅིང་ཀུན་ལ་གྲགས་ལགས་མོད་༎ འོན་ཀྱང་སྒྲ་དོན་གཙུག་ལག་ཇི་བཞིན་དུ་༎
