skt	tib
 mahāpratisarā vidyārājñī namo bhagavatyai āryamahāpratisarāyai | namaḥ samyaksaṃbudhebhyaḥ ||	༄༥༢ཨ་། རྒྱ་གར་སྐད་དུ་། ཨའརྱ་མཧའ་པྲ་ཏི་ས་ར་བིདཡའ་རའི་ཛཉའི་། བོད་སྐད་དུ༏་འཕགས་པ་རིག་པའི་རྒྱལ་མོ་སོ་སོར་འབྲང་བ་ཆེན་མོ་༎ སངས་རྒྱས་དང་བྱང་ཆུབ་སེམས་དཔའ་ཐམས་ཅད་ལ་ཕྱག་འཚལ་ལོ་༎
 evaṃ mayā śrutam ekasmin samaye bhagavān vajrameruśikharakuṭāgāre viharati sma |	འདི་སྐད་བདག་གིས་ཐོས་པ་དུས་༄༥༢བ་གཅིག་ན་། བཅོམ་ལྡན་འདས་རྡོ་རྗེའི་ལྷུན་པོ་ཆེན་པོའི་ཟོམ་ན་ཁང་པ་བརྩེགས་པ་རྡོ་རྗེ་ཆེན་པོའི་ཏིང་ངེ་འཛིན་གྱི་སའི་གནས་།
 mahāvajrasamādhibhūmipratisthāne mahāvajrakalpavṛkṣasamalaṃkṛte |	རྡོ་རྗེ་ཆེན་པོའི་དཔག་བསམ་གྱི་ཤིང་ལྗོན་པས་ལེགས་པར་བརྒྱན་པ་།
 mahāvajrapuṣkiriṇīratnapadmaprabhodbhāsite |	རྡོ་རྗེ་ཆེན་པོའི་རྫིང་གི་རིན་པོ་ཆེ་དང་པདམའི་འོད་ཀྱིས་སྣང་བར་བྱས་པ་།
 mahāvajravālikāsaṃskṛtabhūmibhāge |	ས་ཕྱོགས་རྡོ་རྗེ་ཆེན་པོའི་བྱེ་མ་བདལ་བ་།
 mahāvajrādhiṣṭhāne |	རྡོ་རྗེ་ཆེན་པོར་བྱིན་གྱིས་བརླབས་པ་།
 mahāvajramaṇḍalamāḍe |	འཁོར་གྱི་ཁྱམས་རྡོ་རྗེ་ཆེན་པོ་ལས་བྱས་པ་།
 śakrasya devānām indrasya bhavane | mahāvajrasiṃhāsanakoṭīniyutaśatasahasravirājite |	ལྷའི་དབང་པོ་བརྒྱ་བྱིན་གྱི་རྡོ་རྗེའི་སེངྒེའི་ཁྲི་ཆེན་པོ་བྱེ་བ་ཁྲག་ཁྲིག་བརྒྱ་སྟོང་གིས་རྣམ་པར་མཛེས་པ་། 
 dharmadeśanāpratibhānaprātihāryasamanvāgate |	ཆོས་བསྟན་པ་དང་། ཆོ་འཕྲུལ་ཅན་སངས་རྒྱས་ཐམས་ཅད་ཀྱི་བྱིན་གྱི་རླབས་ཀྱིས་བྱིན་གྱིས་བརླབས་པ་།
 sarvabuddhādhiṣṭhānādhiṣṭhite sarvadharmasamatāpraveśe sarvajñatāniryāte | caturaśītibhir bodhisatvakoṭīniyutaśatasahasraiḥ sārdham |	ཆོས་ཐམས་ཅད་ཀྱི་མཉམ་པ་ཉིད་ལ་འཇུག་པ་ཐམས་ཅད་མཁྱེན་པ་ཉིད་ཀྱིས་ངེས་པར་འབྱུང་བ་ན་བྱང་ཆུབ་སེམས་དཔའ་བྱེ་བ་ཁྲག་ཁྲིག་འབུམ་ཕྲག་བརྒྱད་ཅུ་རྩ་བཞི་ཐམས་ཅད་ཀྱང་སྐྱེ་བ་གཅིག་གིས་ཐོགས་པ་།
 sarvair ekajātibhir avaivartikair anuttarāyāṃ samyaksaṃbodhau mahāsthāmaprāptair mahāvajravimokṣasamādhibuddhakṣetravikurvaṇamahāprātihāryasaṃdarśakaiḥ	བླ་ན་མེད་པ་ཡང་དག་པར་རྫོགས་པའི་བྱང་ཆུབ་ལས་ཕྱིར་མི་ལྡོག་པ་། མཐུ་ཆེན་པོ་ཐོབ་པ་། རྡོ་རྗེ་ཆེན་པོའི་རྣམ་པར་ཐར་པ་དང་། ཏིང་ངེ་འཛིན་གྱི་སངས་རྒྱས་ཀྱི་ཞིང་དུ་མར་རྣམ་པར་འཕྲུལ་པ་དང་། ཆོ་འཕྲུལ་ཆེན་པོ་ཀུན་ཏུ་སྟོན་པ་།
 ekacitrakṣaṇabhavamuhūrtasarvasatvacittacaritānupraveśavicitramadhurodāragambhīradharmadeśanāpratibhānaprātihāryasaṃdarśakair	སེམས་ཀྱི་སྐད་ཅིག་། ཐང་གཅིག་། ཡུད་ཙམ་གཅིག་ལ་སེམས་ཅན་ཐམས་ཅད་ཀྱི་སེམས་དང་། སྤྱོད་པའི་རྗེས་སུ་འཇུག་པའི་ཆོས་སྟོན་པ་སྣ་ཚོགས་སྙན་ཅིང་རྒྱ་ཆེ་ལ་ཟབ་ཅིང་ཡངས་པ་དང་། 
 anekabuddhakṣetratathāgatamahāpūjameghārcanāvimokṣamukhadhāraṇīsamādhivaśitābhijñāvaeṇikabodhyaṅgamārgabhūmipāramitopāyakauśalyasaṃgrahavastramahāmaitrīkaruṇāmuditopekṣāmaitrībalaviviktaparyavadātacittasaṃtānaiḥ tadyathā | vajragarbheṇa ca bodhisatvena mahāsatvena | vajranetreṇa ca | vajragātreṇa ca | vajramatinā ca | vajrahastena ca | vajrasaṃhatena ca | vajranārāyaṇena ca | vajravikurvitena ca | vajrakūtena ca | vajrarāśinā ca | vajrāṅkuśena ca | suvajreṇa ca | vajrasenena ca | vajraketunā ca bodhisatvena mahāsatvena || evaṃ pramukhair bodhisatvakoṭīniyutaśatasahasraiḥ sārdhaṃ saṃbahulaiś ca mahāśrāvakaiḥ sarvair arhadbhir kṣīṇāsravair ucchinnabhavasaṃyojanaiḥ	༄༥༣ཨ་༌༎ སྤེབས་པ་དང་། ཆོ་འཕྲུལ་དང་ལྡན་པ་། སངས་རྒྱས་ཀྱི་ཞིའི་དུ་མར་དེ་བཞིན་གཤེགས་པ་ལ་མཆོད་པ་ཆེན་པོའི་སྤྲིན་གྱིས་མཆོད་པ་དང་། རྣམ་པར་ཐར་པའི་སྒོ་དང་། གཟུངས་དང་། ཏིང་ངེ་འཛིན་དང་། དབང་པོ་དང་། མངོན་པར་ཤེས་པ་དང་། མ་འདྲེས་པ་དང་། བྱང་ཆུབ་ཀྱི་ཡན་ལག་དང་། ལམ་དང་། ས་དང་། ཕ་རོལ་ཏུ་ཕྱིན་པ་དང་། ཐབས་ལ་མཁས་པ་དང་། བསྡུ་བའི་དངོས་པོ་དང་། བྱམས་པ་དང་། སྙིང་རྗེ་དང་། དགའ་བ་དང་། བཏང་སྙོམས་དང་། བྱམས་པའི་སྟོབས་དང་། བདེན་པ་དང་། ཡོངས་སུ་བྱང་བའི་སེམས་ཀྱི་རྒྱུན་དང་ལྡན་པ་ཤ་སྟག་ལ་འདི་ལྟ་སྟེ་། བྱང་ཆུབ་སེམས་དཔའ་སེམས་དཔའ་ཆེན་པོ་རྡོ་རྗེའི་སྙིང་པོ་དང་། རྡོ་རྗེའི་ལུས་དང་། རྡོ་རྗེའི་བློ་གྲོས་དང་། ལག་ན་རྡོ་རྗེ་དང་། རྡོ་རྗེ་འདུས་པ་དང་། རྡོ་རྗེ་མཐུ་བོ་ཆེ་དང་། རྡོ་རྗེ་རྣམ་པར་འཕྲུལ་པ་དང་། རྡོ་རྗེ་བརྩེགས་པ་དང་། རྡོ་རྗེ་ཕུང་པོ་དང་། རྡོ་རྗེ་བཟང་པོ་དང་། བྱང་ཆུབ་སེམས་དཔའ་སེམས་དཔའ་ཆེན་པོ་རྡོ་རྗེའི་ཏོག་དང་། དེ་དག་ལ་སོགས་པ་བྱང་ཆུབ་སེམས་དཔའ་བྱེ་བ་ཁྲག་ཁྲིག་འབུམ་ཕྲག་བརྒྱད་ཅུ་རྩ་བཞི་དང་། ཉན་ཐོས་ཆེན་པོ་རབ་ཏུ་མང་པོ་ཐམས་ཅད་ཀྱང་དགྲ་བཅོམ་པ་། ཟག་པ་ཟད་པ་། སྲིད་པར་ཀུན་ཏུ་སྦྱོར་བ་ཡོངས་སུ་ཆད་པ་།
 samyagājñāsuvimuktacittaiḥ suvimuktaprajñair acintyasamādhibalaprātihāryavikurvaṇamahāsthāmaprāptair asaṅgajñānadarśibhiḥ | sarvair vigatamalair nidagdhasaṃkleśavāsanābījaiḥ ||	ཡང་དག་པའི་ཤེས་པས་སེམས་ཤིན་ཏུ་རྣམ་པར་གྲོལ་༄༥༣བ་བ༏་རྫུ་འཕྲུལ་གྱི་སྟོབས་དང་། ཆོ་འཕྲུལ་བསམ་གྱིས་མི་ཁྱབ་པས་རྣམ་པར་འཕྲུལ་པའི་མཐུ་ཆེན་པོ་ཐོབ་པ་། ལྟ་བ་ཆགས་པ་མེད་པ་། ཐམས་ཅད་ཀྱང་དྲི་མ་དང་བྲལ་བ་ཐོབ་པ་།
 yadutāyuṣmatā ca śāradvatīputreṇa | āyuṣmatā ca pūrṇamaitrāyaṇīputreṇa | āyuṣmatā ca kaphinena | āyuṣmatā ca subhūtinā | āyuṣmatā ca revatena | āyuṣmatā ca mahāmaudgalyāyanena | āyuṣmatā ca cundena | āyuṣmatā ca nandena | āyuṣmatā ca sunandena | āyuṣmatā ca kāśyapena | āyuṣmatā ca mahākāśyapena | āyuṣmatā ca nandīkāśyapena | āyuṣmatā coruvilvākāśyapena | āyuṣmatā ca gayākāśyapena ||	ཀུན་ནས་ཉོན་མོངས་པའི་བག་ཆགས་ཀྱི་ས་བོན་ངེས་པར་བསྲེགས་པ་ཤ་སྟག་ལ་འདི་ལྟ་སྟེ་། ཚེ་དང་ལྡན་པ་ཤའ་རིའི་བུ་དང་། ཚེ་དང་ལྡན་པ་བྱམས་མའི་བུ་གང་པོ་དང་། ཚེ་དང་ལྡན་པ་ཀ་པི་ན་དང་། ཚེ་དང་ལྡན་པ་རབ་འབྱོར་དང་། ཚེ་དང་ལྡན་པ་མོཨོ་དགལ་གྱི་བུ་ཆེན་པོ་དང་། ཚེ་དང་ལྡན་པ་སྐུལ་བྱེད་དང་། ཚེ་དང་ལྡན་པ་དགའ་བྱེད་དང་། ཚེ་དང་ལྡན་པ་འོད་སྲུང་དང་། ཚེ་དང་ལྡན་པ་འོད་སྲུང་ཆེན་པོ་དང་། ཚེ་དང་ལྡན་པ་ལྟེང་རྒྱས་འོད་སྲུང་དང་། དེ་དག་ལ་སོགས་པ་ཉན་ཐོས་ཆེན་པོ་རབ་ཏུ་མང་པོ་དང་། ལྷའི་བུ་དབང་ཕྱུག་ཆེན་པོ་ལ་སོགས་པ་གནས་གཙང་མའི་རིས་ཀྱི་ལྷའི་བུ་གྲངས་མེད་དཔག་ཏུ་མེད་པ་། 
 evaṃ pramukhaiḥ saṃbahulair mahāśrāvakaiḥ sārdhaṃ maheśvaradevaputrapramukhaiś cāsaṃkhyeyair aparimāṇair anabhilāṣyānabhilāṣyaiḥ śuddhāvāsakayikair devaputraiḥ || brahmaṇā ca sahāpatinā | brahmakāyikadevaputrapramukhair devaputraiḥ | suyāmena ca devaputreṇa | suyāmakāyikadevaputraparivāreṇa | saṃtuṣitena ca devaputraparivāreṇa | nirmāṇaratinā ca | paranirmitavaśavartinā ca | śakreṇa ca devānām indreṇa | sarvadevaputraparivāreṇa || vemacitriṇā cāsurendreṇa | balinā ca | prahlādena ca | rāhunā ca |	བརྗོད་དུ་མེད་པའི་ཡང་བརྗོད་དུ་མེད་པ་དག་དང་། མི་མཇེད་ཀྱི་བདག་པོ་ཚངས་པ་ལ་སོགས་པ་ཚངས་རིས་ཀྱི་ལྷའི་བུ་རྣམས་དང་། ལྷའི་བུ་རབ་འཐབ་བྲལ་ག-ཡོག་འཐབ་བྲལ་གྱི་རིས་ཀྱི་ལྷའི་བུ་དང་བཅས་པ་དང་། ཡོངས་སུ་དགའ་ལྡན་དང་། འཕྲུལ་དགའ་དང་། གཞན་འཕྲུལ་དབང་བྱེད་དང་། ལྷའི་དབང་པོ་བརྒྱ་བྱིན་ལྷའི་བུ་ཐམས་ཅད་ཀྱི་འཁོར་ཅན་དང་། ལྷ་མ་ཡིན་གྱི་དབང་པོ་ཐགས་བཟང་རིས་དང་། སྟོབས་ཅན་དང་། རབ་སིམ་དང་། སྒྲ་གཅན་༄༥༤ཨ་༌༎
 vairocanena ca | subāhunā ca | evaṃ pramukhair aparimitāprameyāsaṃkhyeyair asurendraiḥ || sāgareṇa ca nāgarājena | takṣakena ca | vāsukinā cā | śaṅkhapālena ca | karkoṭakena ca | padmena ca | mahāpadmena ca |	དང་། རྣམ་པར་སྣང་བྱེད་དང་། དེ་དག་ལ་སོགས་པ་ལྷ་མ་ཡིན་གྱི་དབང་པོ་ཚད་མེད་གྲངས་མེད་དཔག་ཏུ་མེད་པ་རྣམས་དང་། 
 evaṃ pramukhair aparimitāprameyāsaṃkhyeyair nāgarājaiḥ || drumeṇa ca kinnararājena | anekakinnaraparivāreṇa || pañcaśikhena ca gandharvarājena | anekagandharvarājaparivāreṇa ca || sarvārthasiddhena ca vidyādhararājena | anekavidyādhararājaparivāreṇa ||	ཀླུའི་རྒྱལ་པོ་རྒྱ་མཚོ་དང་། འཇོག་པོ་དང་། ནོར་རྒྱས་ཀྱི་བུ་དང་། དུང་སྐྱོང་དང་། སྟོབས་ཀྱི་རྒྱུ་དང་། པདམ་དང་། པདམ་ཆེན་པོ་དང་། དེ་དག་ལ་སོགས་པ་ཀླུའི་རྒྱལ་པོ་ཚད་མེད་གྲངས་མེད་དཔག་ཏུ་མེད་པ་རྣམས་དང་། མིའམ་ཅིའི་རྒྱལ་པོ་ལྗོན་པ་མི་འམ་ཅིའི་རྒྱལ་པོ་ག-ཡོག་དུ་མ་ཅན་དང་། དྲི་ཟའི་རྒྱལ་པོ་ཟུར་ཕུད་ལྔ་པ་དྲི་ཟའི་རྒྱལ་པོ་ག-ཡོག་དུ་མ་ཅན་དང་། རིག་སྔགས་འཆང་གི་རྒྱལ་པོ་དོན་ཐམས་ཅད་གྲུབ་པ་རིག་སྔགས་འཆང་གི་རྒྱལ་པོ་ག-ཡོག་དུ་མ་ཅན་དང་། 
 suparṇākṣeṇa ca garuḍarājena | anekagaruḍarājaparivāreṇa || vaiśramaṇena ca | māṇibhadreṇa ca | pūrṇabhadreṇa ca |	ནམ་མཁའ་ལྡིང་གི་རྒྱལ་པོ་གསེར་མིག་ནམ་མཁའ་ལྡིང་གི་རྒྱལ་པོ་ག-ཡོག་དུ་མ་ཅན་དང་། 
 pāñcikena ca yakṣarājena | anekayakṣarājaparivāreṇa || hārītyā ca pañcaputraśataparivārayā | saptabhiś ca lokamātṛbhiḥ |	ཅན་དང་། 
 saptabhiś ca mahārākṣasībhiḥ saptabhiś ca maharṣivaraiḥ | antarīkṣacaraiś ca sarvanakṣatragrahadevataiḥ | digbhiś ca vidigbhiś ca | pṛthivyā ca sarasvatyā ca | bhūtaiś ca vighnaiś ca vināyakaiś ca pretabhūtamaharddhikaiḥ | sarvaiś ca parvatarājaiḥ | varuṇena ca lokapālena | sarvasamudradevatāparivāreṇa | virūḍhakena ca virūpākṣeṇa ca daṇḍapāṇinā ca | naigutena ca | jātavedasā ca | saptabhiś ca mahāvāyubhiḥ | īśānena ca sapatnikena | anekagaṇakoṭīniyutaśatasahasraparivāreṇa || nārāyaṇena ca saparivāreṇa | dantakena ca dāmakena ca lohakena ca mohakena ca | mahāgaṇapatinā ca | megholkena ca | vināyakendreṇa ca | anekavighnavināyakaparivāreṇa || ṣaṣṭyā ca koṭagiryā ca catasṛbhiś ca bhaginībhiḥ sabhrātṛkābhiḥ || vajrāṅkuśyā ca | vajraśaṅkarayā ca | catuḥṣaṣṭibhiś ca vajrahūtībhiḥ | vajrasenena ca subāhunā ca | mūrdhaṭakena ca | anekavajrakulaparivāreṇa ||	གནོད་སྦྱིན་གྱི་རྒྱལ་པོ་རྣམ་ཐོས་ཀྱི་བུ་དང་། ནོར་བུ་བཟང་དང་། གང་བ་བཟང་དང་། ལྔས་རྩེན་གནོད་སྦྱིན་གྱི་རྒྱལ་པོ་ག-ཡོག་དུ་མ་ཅན་དང་། འཕྲོག་མ་བུ་ལྔ་བརྒྱའི་ག-ཡོག་དུ་མ་ཅན་དང་། འཇིག་རྟེན་གྱི་མ་བདུན་དང་། སྲིན་མོ་ཆེན་མོ་བདུན་དང་། དྲང་སྲོང་གི་མཆོག་ཆེན་པོ་བདུན་དང་། བར་སྣང་ལ་རྒྱུ་བའི་རྒྱུ་སྐར་དང་། གཟའ་ཐམས་ཅད་ཀྱི་ལྷ་རྣམས་དང་། ཕྱོགས་ཀྱི་ལྷ་རྣམས་དང་། ཕྱོགས་མཚམས་ཀྱི་ལྷ་རྣམས་དང་། སའི་ལྷ་དང་། དབྱངས་ཅན་དང་། འབྱུང་པོ་རྣམས་དང་། ༄༥༤བ་བགེགས་རྣམས་དང་། ལོག་འདྲེན་རྣམས་དང་། ཡི་དབ༹གས་རྣམས་དང་། འབྱུང་པོ་རྫུ་འཕྲུལ་ཆེན་པོ་རྣམས་དང་། རིའི་རྒྱལ་པོ་ཐམས་ཅད་དང་། འཇིག་རྟེན་སྐྱོང་བ་ཆུ་ལྷ་ག-ཡོག་རྒྱ་མཚོའི་ལྷ་ཐམས་ཅད་དང་བཅས་པ་དང་། འཕགས་སྐྱེས་པོ་དང་། མིག་མི་བཟང་དང་། ལག་ན་བེ་ཅོན་དང་། བདེན་བྲལ་དང་། མེའི་ལྷ་དང་། རླུང་གི་ལྷ་ཆེན་པོ་བདུན་དང་། དབང་བདག་ཆུང་མ་དང་བཅས་པ་ག-ཡོག་བྱེ་བ་ཁྲག་ཁྲིག་འབུམ་ཕྲག་དུ་མ་ཅན་དང་། སྲེད་མེད་ཀྱི་བུ་ག-ཡོག་དང་བཅས་པ་དང་། བྱིན་པ་པོ་དང་། ཕྲང་བ་ཅན་དང་། ཟླ་བ་ཅན་དང་། ལྕགས་ཅན་དང་། ཚོགས་ཀྱི་བདག་པོ་ཆེན་པོ་དང་། སྤྲིན་ཏ་ལ་ལ་དང་། ལོག་འདྲེན་གྱི་དབང་པོ་བགེགས་ལོག་འདྲེན་གྱི་དབང་པོ་ག-ཡོག་དུ་མ་ཅན་དང་། ཤིང་གསེབ་ཀྱི་ལྷ་དྲུག་ཅུ་དང་། སྲིང་མོ་བཞི་མིང་པོ་དང་བཅས་པ་དང་། རྡོ་རྗེའི་ལུ་གུ་རྒྱུད་དང་། རྡོ་རྗེའི་ཕོ་ཉ་མོ་དྲུག་ཅུ་རྩ་བཞི་དང་། རྡོ་རྗེའི་སྡེ་དང་། ལག་བཟང་དང་། གཙུག་གིས་འགྲོ་རྡོ་རྗེའི་རིས་ཀྱི་འཁོར་དུ་མ་དང་བཅས་པ་དང་། དེ་ལས་གཞན་པ་སངས་རྒྱས་དང་། ཆོས་དང་། དགེ་འདུན་ལ་མངོན་པར་དད་པའི་ལྷ་དང་། ཀླུ་དང་། གནོད་སྦྱིན་དང་། དྲི་ཟ་དང་། ལྷ་མ་ཡིན་དང་། ནམ་མཁའ་ལྡིང་དང་། མིའམ་ཅི་དང་། ལྟོ་འཕྱེ་ཆེན་པོ་དང་། འབྱུང་པོ་དང་། ཡི་དབ༹གས་དང་། ཤ་ཟ་དང་། གྲིབ་གནོན་དང་། སྨྱོ་བྱེད་དང་། བརྗེད་བྱེད་དང་། ༄༥༥ཨ་༌༎ སྐེམ་བྱེད་དང་། སྒྲུབ་པ་དང་། སྦྲུལ་འཛིན་བཅས་པ་དང་། གནོན་པོ་ཚད་མེད་གྲངས་མེད་དཔག་ཏུ་མེད་པ་དག་དང་། ལྷའི་བུ་ཉི་མ་དང་། ལྷའི་བུ་ཟླ་བ་དང་། ནུབ་ཀའི་ལྷ་དང་། ནང་པར་གྱི་ལྷ་དང་། དུས་ཀྱི་ལྷ་ཐམས་ཅད་དང་། སའི་ལྷ་དང་ཐབས་ཅིག་ཏུ་བཞུགས་ཏེ་། བཅོམ་ལྡན་འདས་དེ་ཆོས་ཀྱི་འཁོར་ལོ་ནི་ཤིན་ཏུ་བསྐོར་།
 tad anyaiś ca buddhadharmasaṃghābhiprasannaiḥ | aparimitāprameyāsaṃkhyeyair devanāgayakṣagandharvāsuragaruḍakinnaramahoragabhūtapretapiśāconmārdāpasmārasādhyasāhillakoṣṭarakaiḥ || sūryeṇa ca devaputreṇa | candreṇa ca devaputreṇa | sucandreṇa ca devaputreṇa | sandhyayā ca devatayā | uṣasā ca devatayā | sarvaiś ca gantubhiḥ | rodasinyā ca devatayā | prajāpatyā ca devatayā sārdham ||	སངས་རྒྱས་ཀྱི་མཛད་པ་ནི་།
 ity api ca bhagavān supravartitadharmacakraḥ supariniṣṭhitabuddhakāryaḥ suparipūrṇapuṇyajñānasaṃbhāraḥ	ཤིན་ཏུ་ཡོངས་སུ་མཐར་ཕྱིན་། བསོད་ནམས་དང་ཡེ་ཤེས་ཀྱི་ཚོགས་ནི་། ཤིན་ཏུ་ཡོངས་སུ་རྫོགས་།
 suparigṛhītasarvajñatāmahābodhipāramitābhūmilābhojjvalitadvātriṃśatmahāpuruṣalakṣaṇālaṃkṛtaśarīraś (mp_4)	ཐམས་ཅད་མཁྱེན་པ་ནི་ཤིན་ཏུ་ཡོངས་སུ་བཟུང་། བྱང་ཆུབ་ཆེན་པོའི་ཕྱིར་ཕ་རོལ་ཏུ་ཕྱིན་པ་དང་ས་ནི་བརྙེས་། སྐྱེས་བུ་ཆེན་པོའི་མཚན་སུམ་ཅུ་རྩ་གཉིས་ཀྱིས་བརྒྱན་པའི་སྐུ་ནི་རབ་ཏུ་འབར་།
 caturaśītyanuvyañjanavirājitaḥ sarvāṅgāvayavaśobhaḥ sarvasatvānavalokitamūrdhānirjitaḥ	ཡན་ལག་དང་ཉིང་ལག་ཐམས་ཅད་ནི་དཔེ་བྱད་བཟང་པོ་བརྒྱད་ཅུས་རྣམ་པར་སྤྲས་། དབུའི་གཙུག་ནི་སེམས་ཅན་ཐམས་ཅད་ཀྱིས་བལྟར་མི་མཐོང་། བདུད་ཀྱི་ལས་ཐམས་ཅད་ལ་ནི་མཁས་། སེམས་ཅན་ཐམས་ཅད་ཀྱི་སེམས་དང་སྤྱོད་པ་ནི་ཤེས་། སྤྱན་རྣམ་པ་ལྔ་ནི་མངའ།
 sarvamārakarmakovidaḥ sarvasatvajñānapañcavidhacakṣuḥ sarvākāravaropetaḥ sarvajñajñānasamanvāgataḥ	རྣམ་པ་ཐམས་ཅད་ཀྱི་མཆོག་དང་ནི་ལྡན་། ཐམས་ཅད་མཁྱེན་པའི་ཡེ་ཤེས་དང་ནི་ལྡན་།
 sarvabuddhadharmasamanvāgataḥ |	སངས་རྒྱས་ཀྱི་ཆོས་ཐམས་ཅད་དང་ནི་ལྡན་།
 sarvamāraparapramādikugaṇigaṇapramathana udgatakīrtiśabdaśloka ārṣabhasiṃhanādaṃnadī	བདུད་དང་ཕས་ཀྱི་རྒོལ་བའི་ཚོགས་ཐམས་ཅད་ནི་བཅོམ་། གྲགས་པ་དང་། སྒྲ་༄༥༥བ་དང་། ཚིགས་སུ་བཅད་པས་ནི་འཕགས་། ཁྱུ་མཆོག་དང་སེངྒེའི་སྒྲ་ནི་སྒྲོག་།
 samucchinnāvidyāndhakāro	མ་རིག་པའི་མུན་པ་ནི་ཀུན་ཏུ་བསལ་།
 'saṃkhyeyāparimāṇakoṭīniyutaśatasahasradānaśīlakṣāntivīryadhyānaprajñopāyabalapraṇidhānapāramitāduṣkaracaryāvinivartitadvātriṃśatmahāpuruṣalakṣaṇacaturaśītyanuvyañjanagātraśobhaḥ	བསྐལ་པ་བྱེ་བ་ཁྲག་ཁྲིག་འབུམ་ཕྲག་གྲངས་མེད་དཔག་ཏུ་མེད་པར་སྦྱིན་པ་དང་། ཚུལ་ཁྲིམས་དང་། བཟོད་པ་དང་། བརྩོན་འགྲུས་དང་། བསམ་གཏན་དང་། ཤེས་རབ་དང་། ཐབས་དང་། སྟོབས་དང་། སྨོན་ལམ་དང་། ཡེ་ཤེས་ཀྱི་ཕ་རོལ་ཏུ་ཕྱིན་པ་དང་། བྱ་དཀའ་བའི་སྤྱོད་པ་ལས་ནི་ཕྱིར་མ་ལོག་། སྐུ་ནི་སྐྱེས་བུ་ཆེན་པོའི་མཚན་སུམ་ཅུ་རྩ་གཉིས་དང་དཔེ་བྱད་བཟང་པོ་བརྒྱད་ཅུས་བརྒྱན་ཏེ་རབ་ཏུ་མཛེས་ཤིང་རྡོ་རྗེ་རིན་པོ་ཆེའི་པདམའི་སྙིང་པོའི་སེངྒེའི་ཁྲི་ཆེན་པོ་རྡོ་རྗེ་རིན་པོ་ཆེ་དང་། མུ་ཏིག་དང་། དྲིལ་བུ་ག-ཡེར་ཀའི་དྲ་བ་དུ་མ་སྒྲ་འབྱུང་བ་།
 mahāvajraratnapadmagarbhasiṃhāsane niṣaṇṇaḥ | anekavajraratnavedikāsaṃskṛtapādapīṭhasupratiṣṭhite |	རྩ་བའི་དྲུང་ན་རྡོ་རྗེ་རིན་པོ་ཆེའི་སྟེགས་བུ་དུ་མ་ཤིན་ཏུ་བརྟན་པར་གནས་པ་།
 anekavajraratnamakaramukhodgīrṇalohitamuktāvalīnibaddhagandhāyake |	རྡོ་རྗེའི་རིན་པོ་ཆེའི་ཆུ་སྲིན་དུ་མའི་ཁ་ནས་བྱུང་བའི་མུ་ཏིག་དམར་པོའི་ཕྲེང་བ་བྲེས་པའི་ཕང་བཤམས་པ་།
 anekavajraratnamuktakiṅkiṇījālakalukalonnādite |	རིན་པོ་ཆེ་དུ་མ་པདམའི་སྙིང་པོ་ལ་ཆགས་པ་།
 anekavajraratnakarṇikāvilagnakarketanamahākarketanendranīlapuṣparāgaraśmijālāvabhāsitasamantaprasādike |	རིན་པོ་ཆེ་ཀེ་ཀེ་རུ་དང་། ཀེ་ཀེ་རུ་ཆེན་པོ་དང་། ཨཨནད་རྙིལ་དང་། ཨཨནད་རྙིལ་ཆེན་པོ་དང་། དུན་ལས་ཀྱི་འོད་ཟེར་ཆེན་པོ་འཚེར་བས་སྣང་བར་བྱས་ཏེ་ཀུན་ནས་མཛེས་པ༏་གདུགས་རྩ་བ་དང་བཅས་པ་། 
 anekavajraratnaśalākāvibhūṣitoddaṇḍātapatrakoṭīniyutaśatasahasrakṛtacchāyāparikare |	རྡོ་རྗེ་རིན་པོ་ཆེའི་ཤར་བུ་དུ་མས་རྣམ་པར་བརྒྱན་པ་། སྐྱེ་བ་ཁྲག་ཁྲིག་འབུམ་ཕྲག་དུ་མས་རྣམ་པར་བརྒྱན་པ་། བྱེ་བ་ཁྲག་ཁྲིག་འབུམ་ཕྲ་༄༥༦ཨ་༌༎ དུ་མས་ཀུན་ནས་བསྐྱབས་པ་།
 anekakalpavṛṣadrumopaśobhitavistāre sumerumātre vajraratnapadmāsane niṣaṇṇaḥ |	དཔག་བསམ་གྱི་ཤིང་དུ་མས་རྒྱས་པར་མཛེས་པར་བྱས་པ་། རྡོ་རྗེ་རིན་པོ་ཆེའི་ཁྲི་རི་རབ་ཙམ་ལ་བཞུགས་ཏེ་གསེར་གྱི་རི་བོའི་རྒྱལ་པོ་ལྟར་དཔལ་ནི་། རབ་ཏུ་འབར་།
 kāñcanaparvatarāja iva śriyā jvalanasūryasahasrābhir ekaprabhāmaṇḍalavirājita bhūmibhāgaḥ |	ས་ཕྱོགས་ནི་། ཉི་མ་སྟོང་བས་ལྷག་པའི་འོད་ཀྱི་དཀྱིལ་འཁོར་གྱིས་རྣམ་པར་བརྒྱན་།
 suparipūrṇacandramaṇḍala iva sarvalokapriyadarśano mahākalpavṛkṣa iva buddhadharmaiḥ saṃkusumito dharmaṃ deśayati sma || ādau kalyāṇaṃ madhye kalyāṇaṃ paryavasāne kalyāṇaṃ svarthaṃ suvyañjanaṃ kevalaṃ paripūrṇaṃ pariśuddhaṃ paryavadātaṃ brahmacaryaṃ saṃprakāśayati sma ||	ཟླ་བ་ཉ་བ་ལྟར་འཇིག་རྟེན་ཐམས་ཅད་ལ་སྡུག་པར་ནི༏་སྣང་། དཔག་བསམ་གྱི་ཤིང་ལྗོན་པ་ཆེན་པོ་ལྟར་སངས་རྒྱས་ཀྱི་ཆོས་རྣམས་ནི་། ཤིན་ཏུ་རྒྱས་ཤིང་ཆོས་སྟོན་ཏེ་། ཚངས་པར་སྤྱོད་པ་། ཐོག་མར་དགེ་བ་། བར་དུ་དགེ་བ༏་ཐ་མར་དགེ་བ་། དོན་བཟང་པོ་། ཚིག་འབྲུ་བཟང་པོ་། མ་འདྲེས་པ་། ཡོངས་སུ་རྫོགས་པ་། ཡོངས་སུ་དག་པ་།
 atha khalu bhagavān mūrdhna ūrṇakeśāt sarvabuddhasaṃdarśanaṃ nāma raśmijālaṃ pramuñcati sma |	ཡོངས་སུ་བྱང་བ་ཡང་དག་པར་རབ་ཏུ་སྟོན་ཏོ་༎ དེ་ནས་བཅོམ་ལྡན་འདས་ཀྱི་སྨིན་མཚམས་ཀྱི་མཛོད་སྤུ་ནས་འོད་ཟེར་གྱི་དྲ་བ་སངས་རྒྱས་ཐམས་ཅད་ཀྱི་ཞིང་ཀུན་ཏུ་སྟོན་པ་ཞེས་བྱ་བ་བཀྱེ་སྟེ་། 
 tena ca raśmijvālenāyaṃ trisāhasramahāsāhasralokadhātur avabhāsitaḥ | sphuṭīkṛto 'bhūt |	འོད་ཟེར་གྱི་དྲ་བ་དེས་སྟོང་གསུམ་གྱི་སྟོང་ཆེན་པོའི་འཇིག་རྟེན་གྱི་ཁམས་འདི་སྣང་བས་ཁྱབ་པར་གྱུར་ཏོ་༎
 yāvanti ca gaṅgānadīvālukopamāni buddhakṣetrāṇi tāni ca sarvāṇi tenāvabhāsena sphuṭīkṛtāny avabhāsitāny abhūvan | ye ca teṣu buddhakṣetreṣu buddhā bhagavanto 'nekasiṃhāsanakoṭīniyutaśatasahasravyūhakūṭāgāravimāneṣu dharmaṃ darśayati sma | sārdhaṃ (mp_5) mahāśrāvakair bodhisatvair bhikṣubhikṣuṇyupāsakopāsikābhir devanāgayakṣagandharvāsuragaruḍakinnaramahoragaiḥ sārdham ||	སངས་རྒྱས་ཀྱི་ཞིང་གང་དག་ན་སངས་རྒྱས་བཅོམ་ལྡན་འདས་སེངྒེའི་ཁྲི་བཀོད་པ་དུ་མའི་ཁང་པ་བརྩེགས་པའི་གཞལ་མེད་ཁང་ན་ཉན་ཐོས་དང་། བྱང་ཆུབ་སེམས་དཔའ་སེམས་དཔའ་ཆེན་པོ་དང་། དགེ་སློང་དང་། དགེ་སློང་མ་དང་། དགེ་བསྙེན་དང་། དགེ་བསྙེན་༄༥༦བ་མ་དང་། ལྷ་དང་། ཀླུ་དང་། གནོད་སྦྱིན་དང་། དྲི་ཟ་དང་། ལྷ་མ་ཡིན་དང་། ནམ་མཁའ་ལྡིང་དང་། མིའམ་ཅི་དང་། ལྟོ་འཕྱེ་ཆེན་པོ་ཐམས་ཅད་དང་ཐབས་ཅིག་ཏུ་ཆོས་སྟོན་པའི་སངས་རྒྱས་ཀྱི་ཞིང་གངྒའའི་ཀླུང་གི་བྱེ་མ་སྙེད་དང་མཉམ་པ་དེ་དག་ཐམས་ཅད་ཀྱང་སྣང་བ་དེས་ཁྱབ་པར་གྱུར་ཏོ་༎
 atha khalu bhagavāṃs tāṃ vistīrṇāṃ pariṣadām āmantrayate sma || athāto mahāpratisarāṃ mahāvidyāṃ pravakṣāmi sarvasatvānukampayā |	དེ་ནས་བཅོམ་ལྡན་འདས་ཀྱིས་འཁོར་ཕལ་པོ་ཆེ་ལ་བཀའ་སྩལ་པ༏་སེམས་ཅན་ཀུན་ལ་སྙིང་བརྩེའི་ཕྱིར་༎ 
 dhāraṇī duṣkṛtasyaiva sarvaduṣṭapramardanī |	ཉེས་པར་བྱས་དང་གནོད་པ་ཀུན་༎ རབ་འཇོམས་སོ་སོར་འབྲང་བ་ཡི་༎ གཟུངས་འདི་རབ་ཏུ་བཤད་པར་བྱ་༎ འདི་ནི་ཐོས་པ་ཙམ་གྱིས་ཀྱང་༎
 yasyāśravaṇamātreṇa pāpā gacchanti saṃkṣayam ||	སྡིག་པ་ཀུན་ནི་ཟད་པར་འགྱུར་༎
 sukhadā sarvasatvānāṃ sarvavyādhipramocanī |	སེམས་ཅན་ཀུན་ལ་བདེ་བ་སྦྱིན་༎ ནད་དོ་ཅོག་ལས་གྲོལ་བར་བྱེད་༎ སེམས་ཅན་ཀུན་ལ་སྙིང་བརྩེ་བས་༎ ལུས་ཅན་ངན་འགྲོར་འགྲོ་བ་དང་༎ དེ་དག་ཐམས་ཅད་བསྐྱབ་པའི་ཕྱིར་༎
 kāruṇyāt sarvasatvānāṃ lokanāthena bhāṣitā || paritrāṇāya sarveṣāṃ dehināṃ pāpakāriṇām |	འཇིག་རྟེན་དག་གི་མགོན་པོས་གསུངས་༎
 anayā kṛtarakṣas tu praviśed asurālayam ||	འདི་ཡིས་སྲུང་བ་བྱས་ན་ནི་༎ ལྷ་མ་ཡིན་གྱི་གནས་སུ་འཇུག་།
 aḍakavatīṃ tathā gacched yakṣāṇām ālayaṃ bhuvi |	དེ་བཞིན་ལྕང་ལོ་ཅན་དང་ནི་༎ སྲིན་པོའི་གནས་ཀྱི་སར་ཡང་འགྲོ་༎ འབྱུང་པོ་ཀླུ་དང་ཤ་ཟ་རྣམས་༎
 bhūtanāgapiśācānāṃ yuddhe bhairavadāruṇe ||	མི་བཟད་འཇིགས་པའི་ག-ཡུལ་འགྱེད་པར་༎
 adhṛṣyaḥ sarvaśatrūṇāṃ sarvabhūtagaṇair api |	འབྱུང་པོའི་ཚོགས་རྣམས་ཐམས་ཅད་དང་༎ དགྲ་བོ་ཅོག་གིས་མི་ཚུགས་སོ་༎
 grahā sarve vinaśyanti nāma grahaṇakīrtanaiḥ ||	མིང་ཙམ་བཟུང་སྟེ་བརྗོད་བྱས་ཀྱང་༎
 skandhonmādā apasmārāḥ piśācā ḍākiṇīgrahāḥ |	སྐེམ་བྱེད་བརྗེད་བྱེད་སྨྱོ་བྱེད་དང་༎ མཁའ་འགྲོ་མ་དང་ཤ་ཟ་དང་༎ གདོན་རྣམས་༄༥༧ཨ་༌༎ རབ་ཏུ་བརླག་པར་འགྱུར་༎ སོ་སོར་འབྲང་བའི་གཟི་བརྗིད་ཀྱིས་༎
 ojobhakṣā mahātejā hiṃsante mānuṣīprajām ||	གཟི་ཆེན་མདངས་རྣམས་ཟ་བ་དང་༎ མི་ཡི་སྐྱེ་རྒུ་རྣམས་འཚེ་བ་༎
 te sarve stambhitā bhonti pratisarāyās tu tejasā |	དེ་དག་ཐམས་ཅད་རེངས་བྱེད་འགྱུར་༎
 paracakrā vinaśyanti kākhordā ye ca dāruṇāḥ ||	བྱད་སྟེམས་མི་བཟད་གང་ཡིན་དང་༎ ཕ་རོལ་དམག་ཚོགས་ཕུང་བར་བྱེད་༎
 mantrakarmā na bādhante mūlakarmāc ca mucyate |	སྔགས་ཀྱི་ལས་ཀྱིས་གནོད་མི་འགྱུར་༎ རྩ་བའི་ལས་ལས་རྣམ་པར་གྲོལ་༎
 na viṣaṃ na garaṃ nāgnir na śastraṃ naiva codakam ||	དུག་དང་དུག་སྦྱར་མེས་མི་ཚུགས་༎ མཚོན་དང་ཆུས་ཀྱང་ཚུགས་མི་འགྱུར་༎ ལྕེ་འབབ་གློག་གིས་མི་ཚུགས་ཏེ་༎
 aśanir vidyutaś caiva kālavāyur na bādhate |	དུས་ཀྱི་རླུང་གིས་གནོད་མི་འགྱུར་༎ རིག་པའི་རྒྱལ་མོའི་གཟི་བརྗིད་ཀྱིས་༎
 sarvaśatrūn pramathnāti vidyārājño hi tejasā || upasargā vinaśyanti vyādhayo na bhavanty api |	དགྲ་ཀུན་རབ་ཏུ་འཇོམས་པར་འགྱུར་༎ དེ་ཡི་དོན་རྣམས་ཐམས་ཅད་འགྲུབ་༎
 sarve 'rthās tasya sidhyanti jayaṃ prāpnoti nityaśaḥ ||	རྟག་ཏུ་རྒྱལ་བ་ཐོབ་པར་འགྱུར་༎
 yaḥ kaścid dhārayed vidyāṃ kaṇṭhe bāhau ca nityaśaḥ |	གང་གིས་རྟག་ཏུ་མགུལ་པའམ་༎ ལག་པར་རིག་པ་བཏགས་ན་ནི་༎
 tasya sarvāṇi kāryāṇi sidhyante nātra saṃśayaḥ ||	དེ་ཡི་དགོས་པ་ཡོད་དོ་ཅོག་། འགྲུབ་འགྱུར་འདི་ལ་ཐེ་ཚོམ་མེད་༎
 nityaṃ rakṣanti devendrā nāgarājās tathaiva ca | bodhisatvā mahāvīryā buddhāḥ pratyekanāyakāḥ ||	བྱང་ཆུབ་སེམས་དཔའ་ཆེན་པོ་དང་༎ སངས་རྒྱས་རྣམས་དང་རང་འདྲེན་དང་༎ དེ་བཞིན་ཀླུ་ཡི་རྒྱལ་པོ་དང་༎ ལྷ་དབང་རྣམས་ནི་རྟག་ཏུ་སྲུང་༎ སོ་སོར་འབྲང་བའི་གཟུངས་འཛིན་ལ་༎
 śrāvakāḥ sarvabuddhānāṃ vidyādevyo mahābalāḥ |	ཉན་ཐོས་སངས་རྒྱས་ཐམས་ཅད་དང་༎ རིག་པའི་ལྷ་མོ་རྫུ་འཕྲུལ་ཆེ་༎
 rakṣāṃ kurvanti satataṃ pratisarādhārakasya vai ||	རྟག་ཏུ་སྲུང་བ་བྱེད་པར་འགྱུར་༎
 vajrapāṇiś ca yakṣendro rājānaś caturas tathā |	ལག་ན་རྡོ་རྗེ་གནོད་སྦྱིན་དབང་༎ དེ་བཞིན་རྒྱལ་པོ་བཞི་རྣམས་དང་༎ དེ་༄༥༧བ་ལ་ཉིན་དང་མཚན་རྣམས་སུ་༎
 tasya rakṣāṃ kariṣyanti divā rātrau na saṃśayaḥ ||	སྲུང་བར་བྱེད་དེ་ཐེ་ཚོམ་མེད་༎
 śakraś ca trideśaiḥ sārdhaṃ brahmā viṣṇur maheśvarāḥ |	བརྒྱ་བྱིན་ལྷ་དང་བཅས་པ་དང་༎ ཚངས་པ་ཁྱབ་འཇུག་དབང་ཆེན་དང་༎ དགའ་བའི་དབང་པོ་ནག་པོ་ཆེ་༎
 nandikeśo mahākālaḥ kārtikeyo gaṇeśvaraḥ ||	སྨིན་དྲུག་བུ་དང་ཚོགས་ཀྱི་དབང་༎
 sarve mātṛgaṇās tasya tathānye mārakāyikāḥ | ṛṣayaś ca mahātejā devāś caiva maharddhikāḥ || nityaṃ rakṣāṃ kariṣyanti pratisarādhārakasya vai |	མ་མོའི་ཚོགས་རྣམས་ཐམས་ཅད་དང་༎ དེ་བཞིན་བདུད་རིས་གཞན་རྣམས་དང་༎ དྲང་སྲོང་གཟི་བརྗིད་ཆེ་རྣམས་དང་༎ རྫུ་འཕྲུལ་ཆེན་པོའི་ལྷ་རྣམས་དང་༎ དེ་ཀུན་སོ་སོར་འབྲང་བ་ཡི་༎ གཟུངས་འཛིན་དེ་ལ་སྲུང་བར་བྱེད་༎
 buddhāś caiva mahātmāno vidyādevyo mahābalāḥ || mahāvīryā mahātejā mahābalaparākramāḥ |	སངས་རྒྱས་བདག་ཉིད་ཆེ་རྣམས་དང་༎ རིག་པའི་ལྷ་མོ་སྟོབས་ཆེན་དང་༎ བདག་གི་མ་དང་ཁྲོ་གཉེར་དང་༎ ལྷ་མོ་སྒྲོལ་མ་ལྕགས་ཀྱུ་དང་༎ རྡོ་རྗེ་ལུ་གུ་རྒྱུད་དང་དཀར་༎
 māmakī bhṛkuṭī caiva tārādevī tathāṅkuśī || vajrasaṃkalayā śvetā mahāśvetā tathaiva ca | mahākālī ca dūtyaś ca vajradūtyas tathāparāḥ ||	དེ་བཞིན་དཀར་མོ་ཆེན་མོ་དང་༎ ནག་མོ་ཆེ་དང་ཕོ་ཉ་དང་༎ དེ་བཞིན་རྡོ་རྗེ་ཕོ་ཉ་དང་། ཞགས་པ་བཟང་དང་རྡོ་རྗེ་ཞགས་༎
 supāśī vajrapāśī ca cakrapāṇir mahābalāḥ |	ལག་ན་རྡོ་རྗེ་སྟོབས་པོ་ཆེ་༎
 vajramālā mahāvidyā tathaivāmṛtakuṇḍaliḥ ||	རིག་པ་ལྷ་མོ་རྡོ་རྗེ་ཕྲེང་༎
 aparājitā mahādevī kālakarṇī mahābalāḥ |	བདུད་རྩི་ཐབ་སྦྱོར་བྱེད་པ་དང་༎ གཞན་གྱིས་མི་ཐུབ་ལྷ་མོ་ཆེ་༎ རྣ་བ་ནག་མོ་སྟོབས་ཆེན་མོ་༎
 tathā dhanyā mahābhāgā padmakuṇḍalir eva ca ||	དཔལ་ཡོན་ལྡན་པ་སྐལ་ཆེན་དང་༎ རྣ་ཆ་གདུབ་ཀོར་པདམ་འདྲ་༎
 puṣpadantī maṇicūḍā svarṇakeśī ca piṅgalā |	མེ་ཏོག་སོ་ཅན་ནོར་བུ་གཙུག་། སྐྲ་མདོག་མཛེས་དང་ཁྱབ་པ་མོ་༎
 mahātejā mahādevī dhanyā ca vidyunmālinī ||	ལྷ་མོ་གཟི་བརྗིད་ཆེན་མོ་དང་༎ དཔལ་ཡོན་ལྡན་པ་གློག་ཕྲེང་ཅན་༎
 rākṣasy aikajaṭā caiva buddhākṣitikanāyikā |	སྲིན་པོ་རལ་པ་གཅིག་པ་དང་༎ སངས་རྒྱས་སྲུང་ཞེས་བྱ་བ་དང་༎ སྐལ་བ་ཆེན་པོ་མི་ཐོད་ཅན་༎ ལངཀའི་བདག་པོ་༄༥༨ཨ་༌༎
 kāpālinī mahābhāgā dhanyā laṅkeśvarī tathā ||	དཔལ་ཡོན་ཅན་༎
 anyāś ca bahavo vidyāsatvānugrahakārikāḥ |	གཞན་ཡང་ལྷ་མོ་མང་པོ་རྣམས་༎ སེམས་ཅན་རྗེས་སུ་འཛིན་བྱེད་དག་།
 tasya rakṣāṃ kariṣyanti yasya vidyā kare sthitā ||	རིག་པ་གང་གི་ལག་ན་གནས་༎ དེ་ལ་སྲུང་བ་བྱེད་པར་འགྱུར་༎
 hārītī pāñcikaś caiva śaṅkhinī kūṭadantinī |	འཕྲོག་མ་དང་ནི་ལྔས་རྩེན་དང་༎ དུང་ཅན་དང་ནི་སོ་བརྩེགས་མ་༎
 śrīdevī sarasvatī caiva taṃ rakṣanti sadānugāḥ ||	དཔལ་གྱི་ལྷ་མོ་དབྱངས་ཅན་ཡང་༎ དེ་ཡི་རྗེས་འགྲོ་རྟག་ཏུ་སྲུང་༎ སོ་སོར་འབྲང་བ་ཆེན་མོ་འདི་༎
 mahāpratisarām etāṃ yā strī dhārayate sadā |	བུད་མེད་གང་ཞིག་རྟག་འཆང་ན་༎
 sarvasiddhir bhavet tasyāḥ putragarbhā nityaśaḥ ||	དེ་ཡི་ཐམས་ཅད་འགྲུབ་པར་འགྱུར་༎ རྟག་པར་མངལ་ན་བུ་ཕོ་ཆགས་༎
 sukhaṃ garbhāṇi vardhante sukhaṃ prasūyati gurviṇī |	མངལ་རྣམས་ན་ཡང་བདེ་བར་སྐྱེ་༎ སྦྲུམ་མ་དག་ཀྱང་བདེ་བར་འགྱུར་༎
 vyādhayaś cāpi naśyanti sarvapāpā na saṃśayaḥ ||	ནད་དང་སྡིག་པ་ཐམས་ཅད་ཀྱང་༎ འཇིག་པར་འགྱུར་ཏེ་ཐེ་ཚོམ་མེད་༎
 puṇyavān balavān nityaṃ dhanadhānyaṃ pravardhate |	བསོད་ནམས་ལྡན་ཞིང་སྟོབས་དང་ལྡན་༎ ནོར་དང་འབྲུ་ཡང་རྟག་ཏུ་འཕེལ་༎
 ādeyavacanaś cāpi pūjanīyo bhaviṣyati ||	ཚིག་ཀྱང་གཟུང་དུ་འོས་པ་དང་༎ མཆོད་པའི་འོས་སུ་འགྱུར་བ་ཉིད་༎
 śucir dvārayate yas tu striyo vā puruṣo 'tha vā |	བུད་མེད་དང་ནི་སྐྱེས་པའང་རུང་༎ གཙང་མ་གང་ཞིག་འཆང་བསྲེལ་ན་༎ དེ་ནི་སེམས་ཅན་ཐམས་ཅད་དག་།
 sa bhavet sarvasatvānāṃ mokṣanāthe samudayataḥ ||	ཐར་པར་བྱ་ཕྱིར་བརྩོན་པར་འགྱུར་༎
 sukhitaś ca bhaven nityaṃ sarvavyādhivivarjitam ||	རྟག་ཏུ་བདེ་བར་འགྱུར་བ་ཡིན་༎ ནད་དོ་ཅོག་ཀྱང་རྣམ་པར་སྤངས་༎ སླས་དང་སྐྱེ་བོ་མང་བཅས་པའི་༎
 rājāno vaśagās tasya sāntaḥpuramahājanāḥ ||	རྒྱལ་པོའང་དེ་ཡི་དབང་དུ་འགྱུར་༎
 nityaṃ ca jvalate lakṣmyā puṇyarāśir vivardhate |	ཕུན་སུམ་ཚོགས་པ་རྟག་ཏུ་འབར་༎ བསོད་ནམས་ཕུང་པོ་རྣམ་པར་འཕེལ་༎
 sarvakalpās tasya sidhyanti praviṣṭaḥ sarvamaṇḍale ||	དེ་ཡི་བསམ་པ་ཐམས་ཅད་འགྲུབ་༎ དཀྱིལ་འཁོར་༄༥༨བ་ཀུན་ཏུ་ཞུགས་པ་ཡིན་༎
 sarvatra samayajño 'sau jinasya vacanaṃ yathā |	རྒྱལ་བ་རྣམས་ཀྱི་བཀའ་བཞིན་དུ་༎ དེ་ནི་ཀུན་ཏུ་དམ་ཚིག་ཤེས་༎
 duḥsvapnā na prabādhante sarvapāpaharīparāḥ ||	རྨི་ལམ་ངན་པ་རྨི་མི་འགྱུར་༎ སྡིག་པ་ཐམས་ཅད་འཕྲོག་པའི་མཆོག་།
 kilbiṣāś caiva naśyanti pratyamitrās tathaiva ca |	སྡིག་པ་རྣམས་དང་དེ་བཞིན་དུ་༎ དགྲ་ཡང་རབ་ཏུ་ཕུང་བར་བྱེད་༎
 sarvagrahavināśārthaṃ bhāṣitā jñānamaheśvaraiḥ ||	གཟའ་ཀུན་རྣམ་པར་གཞིག་པའི་ཕྱིར་༎ ཡེ་ཤེས་དབང་ཕྱུག་ཆེན་པོས་གསུངས་༎ འདོད་པ་ཐམས་ཅད་སྦྱིན་པར་བྱེད་༎
 sarvakāmaṃgamā hy eṣā bhāvayed yas tu nityaśaḥ |	དེ་ཕྱིར་རྟག་ཏུ་བཅང་བར་བྱ་༎
 tad idānīṃ pravakṣāmi bhūtasaṃghā śṛṇontu me || namo buddhāya | namo dharmāya |	འབྱུང་པོའི་ཚོགས་རྣམས་ང་ལ་ཉོན་༎ ང་ནི་རབ་ཏུ་འདི་བརྗོད་དོ་༎
 namo saṃghāya | namaḥ sarvatathāgatānāṃ namo namaḥ | namaḥ sarvabuddhabodhisatvadharmasaṃghebhyaḥ ||	དེ་བཞིན་གཤེགས་པ་ཐམས་ཅད་ལ་ཕྱག་འཚལ་ལོ༏་༏སངས་རྒྱས་དང་། བྱང་ཆུབ་སེམས་དཔའ་ཐམས་ཅད་དང་། སངས་རྒྱས་དང་། ཆོས་དང་། དགེ་འདུན་ལ་ཕྱག་འཚལ་ལོ་༎
 tadyathā | oṃ vipulagarbhe |	ཨཨོམ་བི་པུ་ལ་གརབྷེ་། བི་པུ་ལ་བི་མ་ལེ་།
 vimali jayagarbhe |	བི་མལ་གརབྷེ་། བི་མ་ལེ་། ཛ་ཡ་གརབྷེ་།
 oṃ vipulavimale | vimalagarbhe vajrajvālāgarbhe gatigahane |	བཛྲ་ཛབ༹་ལ་གརབྷེ་།
 gagane |	ག་ཏི་ག་ཧ་ནི་།
 gaganaviśodhani |	ག་ག་ན་བི་ཤོ་དྷ་ནེ་།
 sarvapāpaviśodhani |	སརབབ་པའ་པ་བི་ཤོ་དྷ་ནེ་།
 oṃ guṇavati gaganavicāriṇi | gagariṇi 2 giri 2 giriṇi 2 gamari 2 gaha 2 gargāri 2 gagari 2 gaṃbhari 2 gabhi 2 gahi 2 gamani 2 gare 2 guru 2 gubha 2 guha 2 guruṇicale |	ཨཨོམ་གུ་ན་བ་ཏི་། ག་ག་ན་། པི་ཙའ་རི་ནི་ག་ག་རི་ནི་གི་རི་གི་རི༏་གི་རི་ནི་གི་རི་ནི་། ག་མ་རི་ག་མ་རི་། ག་ཧ་ག་ཧ་། གརགའ་རི་གརགའ་རི་། ག་ག་རི་ག་ག་རི་། གམ་བྷ་རི་། གམ་བྷ་རི་། ག་བྷི་ག་བྷི་། ག་ཧི་ག་ཧི་། ག་མ་ནི་ག་མ་ནི་། ག་རི་ག་རི་། གུ་བྷ་གུ་བྷ་།
 guhaṇi 2 guruṇe 2 culu 2 gucile 2 jaya vijaya 2 |	གུ་ཧ་གུ་ཧ་། གུ་རུ་གུ་ནི་། ཙ་ལེ་གུ་ཧ་ནི་། གུ་ཧ་ནི་། གུ་རུ་ནི་། ཙུ་ལུ་ཙུ་ལུ་། ཙ་ལེ་ཙ་ལེ་། མུ་ཙི་ལེ་མུ་ཙུ་ལེ་། ཛ་ཡེ་བི་ཛ་ཡེ་།
 sarvabhayavigate |	སརབབ་བྷ་ཡ་བི་ག་ཏེ་།
 sarvagarbhasaṃrakṣaṇi |	སརབབ་སམ་༄༥༩ཨ་༌༎ ར་ཀཤ་ནི༏་སི་རི་སི་རི་།
 śiri 2 tiri 2 miri 2 ghiri 2 samantākarṣaṇi |	བྷི་རི་བྷི་རི་། མི་རི་མི་རི་། མི་རི་མི་རི་། གི་རི་གི་རི་། གྷི་རི་གྷི་རི་། ས་མནཏ་བརཤ་ནི་། བཅོམ་ལྡན་འདས་མ་སེམས་ཅན་འདྲེན་མ་། ཀུན་ནས་འདྲེན་མ་།
 sarvaśatrupramathani |	དགྲ་ཐམས་ཅད་འཇོམས་པར་མཛད་མ་།
 rakṣa 2 māṃ sarvasatvān sarvabhayebhyaḥ sarvopadravebhyaḥ sarvavyādhibhyaḥ |	བདག་འཇིགས་པ་ཐམས་ཅད་དང་། གནོད་པ་ཐམས་ཅད་དང་། ནད་འགོ་བ་ཐམས་ཅད་དང་། ནད་ཐམས་ཅད་ལས་སྲུང་དུ་གསོལ་། སྲུང་དུ་གསོལ་།
 ciri 2 viri 2 dhiri 2 vigatāvaraṇe |	ཙི་རི་ཙི་རི་། བི་རི་བི་རི་། དྷི་རི་དྷི་རི་། བི་ག་ཏ་། ཨའ་བ་ར་ནེ་།
 viśodhani |	བི་ཤོ་དྷ་ནི་།
 vividhāvaraṇavināśani |	བི་བི་དྷ་། ཨའ་པ་ར་ནི་། བི་ནའ་ཤ་ནི་། མུ་རི་མུ་རི་།
 muri 2 muci 2 muli 2 cili 2 kili 2 mili 2 kamale vimale |	མུ་ཙི་མུ་ཙི་། མུ་ལི་མུ་ལི་། ཙི་ལི་ཙི་ལི་། ཀི་ལི་ཀི་ལི་། མི་ལེ་མི་ལེ་། ཀ་མ་ལེ་། བི་མ་ལེ་། ཛ་ཡེ་བི་ཛ་ཡེ་། བི་ཛ་ཡའ་།
 jaye vijaye jayāvahe |	བ་ཧེ་ཛ་ཡ་བ་ཏི་།
 jayavati viśeṣavati |	བ་ཤེ་ཤ་བ་ཏི་།
 bhagavati ratnamukuṭamālādhari |	བཅོམ་ལྡན་འདས་མ་རིན་པོ་ཆེའི་ཅོད་པན་དང་། ཕྲེང་བ་མངའ་བ་།
 bahuvividhavicitraveśadhāriṇi | bhagavati mahāvidyādevi rakṣa 2 (mp_8)	ཆ་བྱད་རྣམ་པ་སྣ་ཚོགས་མངའ་བ་། བཅོམ་ལྡན་འདས་མ་རིག་པའི་ལྷ་མོ་ཆེན་མོ་།
 māṃ saparivāraṃ sarvasatvāṃś ca samantān sarvapāpaviśodhani | huru 2 muru 2 rakṣa 2 māṃ sarvasatvāṃś cānāthān atrāṇān aparāyaṇāt primocya sarvaduḥkhebhyaḥ caṇḍe 2 caṇḍi 2 caṇḍini 2 vegavati 2 sarvaduṣṭanivāriṇi	སྡིག་པ་ཐམས་ཅད་རྣམ་པར་སྦྱོང་བ༏་བདག་ལ་ཐམས་ཅད་དུ་ཀུན་ནས་སྲུང་དུ་གསོལ་། སྲུང་དུ་གསོལ་། ཧུ་རུ་ཧུ་རུ་། མུ་རུ་མུ་རུ་། རཀཤ་རཀཤ་མ་མ་། མགོན་མ་མཆིས་པ་། སྐྱབས་མ་མཆིས་པ་། དཔུང་གཉེན་མ་མཆིས་པ་བདག་ལ་སྲུང་དུ་གསོལ་། སྲུང་དུ་གསོལ་། བདག་སྡུག་བསྔལ་ཐམས་ཅད་ལས་ཐར་བར་མཛད་དུ་གསོལ་། ཙནདེ་ཙནདེ་། ཙནདི་ནི་ཙནདི་ནི་། ༄༥༩བ་བོ་ག་བ་ཏི་། སརབབ་དུཤཏ་ནི་བའ་ར་ནི་།
 vijayavāhiṇi |	བི་ཛ་ཡ་། བའ་ཧི་ནི་།
 huru 2 muru 2 curu 2 turu 2 āyuḥpālani suravarapramathani |	ཧུ་རུ་ཧུ་རུ་། མུ་རུ་མུ་རུ་། ཙུ་རུ་ཙུ་རུ་། ཏུ་རུ་ཏུ་རུ་། ཨའ་ཡུ་བའ་ལི་ནི་། སུ་ར་བ་ར་པྲ་མ་ཐ་ནི་།
 sarvadevagaṇapūjite |	སརབབ་དེ་བ་ག་ན་པའུ་ཛི་ཏེ་།
 cili 2 dhili 2 samantāvalokite |	ཙི་རི་ཙི་རི༏་དྷི་རི་དྷི་རི་། ས་མནཏ་ཨཨ་བ་ལོ་ཀི་ཏེ་།
 prabhe 2 suprabhe |	པྲ་བྷེ་པྲ་བྷེ་། སུ་པྲ་བྷེ་།
 suprabhaviśuddhe sarvapāpaviśodhani |	སུ་པྲ་བྷ་བི་ཤུདདྷེ་སརབབ་པའ་པམ་བི་ཤུདདྷེ་།
 dhuru 2 dharaṇidhare dhara 2 sumu 2 musu 2 rurucale cālaya sarvaduṣṭān pūraya me sarvapāpaviśuddhe āśāṃ śrīvasudhare jayakamale |	སརབབ་པའ་པམ་བི་ཤོ་དྷ་ནེ་། དྷུ་རུ་དྷུ་རུ་། དྷ་ར་ནི་། དྷ་རེ་།
 kṣiṇi 2 varadāṃkuśe |	དྷ་ར་དྷ་ར་། སུ་མུ་སུ་མུ་། མུ་སུ་མུ་སུ་། རུ་རུ་ཙ་ལེ་། ཙ་ལ་ཡ་། དཔལ་གྱི་སྐུ་མངའ་བ་། བདག་ལ་གནོད་པར་སེམས་པ་ལས་བསྐྱབ་ཏུ་གསོལ་། བདག་གི་བསམ་པ་རྫོགས་པར་མཛད་དུ་གསོལ་། ཛ་ཡ་ཀ་མ་ལེ་། ཀཤི་ནི་ཀཤི་ནི་།
 oṃ padmaviśuddhe | śodhaya 2 śuddhe 2 bhara 2 bhiri 2 bhuru 2 maṅgalaviśuddhe |	བ་ར་ད་། ཨཨམ་ཀུ་ཤེ་། ཨཨོམ་པདམ་བི་ཤུདྷེ་། ཤོ་དྷ་ཡ་ཤོ་དྷ་ཡ་། ཤུདདྷེ་ཤུདདྷེ་། བྷ་ར་བྷ་ར་། བྷི་རི་བྷི་རི་། བྷུ་རུ་བྷུ་རུ་། མངྒ་ལ་བི་ཤུདྷེ་།
 pavitramukhi |	བ་བི་ཏྲ་མུ་ཁི་། ཁདགི་ནི་ཁདགན་།
 khaṅgini 2 khara 2 jvalitaśikhare |	ཁ་ར་ཁ་ར་། ཛབ༹་ལ་ཏི་ཤི་ཁ་རེ་།
 samantāvalokitaprabhe | suprabhaviśuddhe |	ས་མནཏ་ཨཨ་བ་ལོ་ཀི་ཏ་བྲ་བྷེ་སུ་པྲ་བྷ་བི་ཤུདདྷེ་།
 samantaprasāritāvabhāsaśuddhe |	ས་མནཏ་པྲ་སའ་ར་ཏི་ཨཨ་བ་བྷའ་སི་ཏ་ཤུདདྷེ་། ཛབ༹་ལ་ཛབ༹་ལ་།
 jvala 2 sarvadevasamākarṣaṇi |	སརབབ་དེ་བ་ག་ན་། གྲ་ཧ་ན་ཀཤ་ཏྲ༏་ས་མ་ཨའ་ཀརཤ་ནི་།
 satyaprate |	སཏྱ་པྲ་ཏེ་།
 oṃ hrītraṃ tara 2 tāraya 2 māṃ sarvasatvāṃś ca nāgavilokite |	ཨཨོམ་ཧྲི་ཏྲ་ཏ་ར་ཏ་ར་། ཏ་རའ་ཡ་ཏ་རའ་ཡ་། གླང་པོ་ཆེའི་ལྟ་སྟངས་ཀྱིས་གཟིགས་མ་། བདག་མིའི་གནོད་པ་ལས་བསྒྲལ་དུ་གསོལ་།
 lahu 2 hulu 2 hutu 2 turu 2 kiṇi 2 kṣiṇi 2 huni 2 sarvagrahabhakṣaṇi |	ལ་ཧུ་ལ་ཧུ༏་ཧུ་ལུ་ཧུ་ལུ་། ཧུ་དུ་ཧུ་དུ་། ཏུ་རུ་ཏུ་རུ་། ཀི་ནི་ཀི་ནི་། ཀཤི་ནི་ཀཤི་ནི་། ཧུ་ནི་ཧུ་ནི་། སརབབ་གྲ་ཧ་བྷཀཤི་ནི་།
 piṅgale 2 muru 2 mucu 2 musu 2 musuri rate |	པིམ་ག་ལེ་བིམ་ག་ལེ་། མུ་ཙུ་མུ་ཙུ་། སུ་མུ་སུ་མུ་།
 tara 2 nāgavalokite |	སུ་བི་ཙ་ལེ་། ཏ་ར་ཏ་༄༦༠ཨ་༌༎ ར༏་བཅོམ་ལྡན་འདས་མ་གླང་པོ་ཆེའི་ལྟ་སྟངས་ཀྱིས་གཟིགས་མ་།
 tāraya bhagavati atha mahādāruṇabhayebhyaḥ | sarvatra samantena vajraprākāravajrapāśabandhena vajrajvālāviśuddhe |	ཐམས་ཅད་དུ་ཀུན་ནས་ཕྱོགས་ཐམས་ཅད་བཅིང་བ་དང་། རྡོ་རྗེའི་ར་བ་དང་། རྡོ་རྗེའི་ཞགས་པའི་བཅིང་བས་བདག་འཇིགས་པ་ཆེན་པོ་བརྒྱད་ལས་བསྒྲལ་དུ་གསོལ་། བཛྲ་ཛབ༹་ལ་བི་ཤུདདྷེ་། བྷུ་རི་བྷུ་རི་། དྷ་ར་དྷ་ར་། ཏི་རི་ཏི་རི་། ཏུ་རུ་ཏུ་རུ་། བྷ་ག་བ་ཏི་།
 bhuri 2 bhagavati garbhasaṃśodhani |	གརབྷ་བི་ཤུདདྷེ༏་གརབྷ་བི་ཤོ་དྷ་ནི་། ཀུཀཤི་སམཔུ་ར་ནི་ཛབ༹་ལ་ཛབ༹་ལ་།
 kukṣisaṃpūraṇi |	ཙ་ལ་ཙ་ལ་།
 jvala 2 cala 2 jvālani |	ཛབ༹འ་ལི་ནི་།
 varṣantu devaḥ samantena divyodakena amṛtavarṣaṇi devatāvatāraṇi |	ལྷའི་ཆུས་ཀུན་ཏུ་ཆར་དབབ་ཏུ་གསོལ་། ཨཨ་མྲི་ཏ་བརཤ་ནི་དེ་བ་ཏ་། ཨཨ་བ་ཏའ་བ་ར་ནི་།
 abhiṣiñcantu māṃ sugatavaravacanāmṛtavaravapuṣe rakṣa 2 māṃ sarvatra sarvadā |	བདེ་བར་གཤེགས་པའི་གསུང་རབ་བདུད་རྩི་མཆོག་གི་སྐུ་དང་ལྡན་པ་བདག་ལ་དབང་བསྐུར་དུ་གསོལ་། འཐབ་པ་དང་། འཐབ་མོ་དང་། རྩོད་པ་དང་། འགྱེད་པ་དང་༎ རྨི་ལམ་ངན་པ་དང་། ལྟས་ངན་པ་དང་། བཀྲ་མི་ཤིས་པ་དང་། སྡིག་པ་ཐམས་ཅད་རྣམ་པར་སྦྱོང་བ་གནོད་སྦྱིན་དང་། སྲིན་པོ་དང་། ཀླུ་ཐམས་ཅད་འཇོམས་པ་།
 sarvabhayebhyaḥ sarvopadravebhyaḥ sarvopasargebhyaḥ sarvavyādhibhyaḥ sarvaduṣṭabhayabhītebhyaḥ sarvakalikalahavigrahavivādaduḥsvapnadurnimittāmaṅgalapāpaviśodhani sarvayakṣarākṣasanāgavidāraṇi |	གནོད་པས་འཇིགས་སྐྲག་པ་བདག་འཇིགས་པ་ཐམས་ཅད་དང་། གནོད་པ་ཐམས་ཅད་དང་། ནད་འགོ་བ་ཐམས་ཅད་དང་། ནད་ཐམས་ཅད་ལས་ཐམས་ཅད་དུ་རྟག་པར་སྲུང་དུ་གསོལ་། སྲུང་དུ་གསོལ་། བ་ལ་བ་ལ་།
 cala 2 balavati |	བ་ལ་བ་ཏི་། ཛ་ཡ་ཛ་ཡ་།
 jaya 2 vijaya 2 jayatu sarvatra sarvakālaṃ sidhyantu me |	བི་ཛ་ཡ་བི་ཛ་ཡ་། ཐམས་ཅད་དུ་དུས་ཀུན་ཏུ་བདག་རྒྱལ་བར་མཛད་དུ་གསོལ་། བདག་ལ་༄༦༠བ་རིག་པ་ཆེན་མོ་འདི་གྲུབ་པར་མཛད་དུ་གསོལ་།
 iyaṃ vidyā sādhaya maṇḍalaṃ ghāṭaya vighnān |	དཀྱིལ་འཁོར་ཆེན་པོ་སྒྲུབ་ཏུ་གསོལ་།
 jaya 2 siddhe 2 sidhya 2 budhya 2 pūraya 2 pūraṇi 2 pūraya me āśāṃ sarvavidyodgatamūrte |	གསང་སྔགས་རྣམས་གྲུབ་ཏུ་གསོལ་། བགེགས་རྣམས་གཞོམ་དུ་གསོལ་། ཛ་ཡ་ཛ་ཡ༏་སིདདྷི་སིདདྷི་། སིདདྷྱ་སིདདྷྱ་། བུདདྷྱ་བུདདྷྱ་། པའུ་ར་ཡ་པའུ་ར་ཡ་། སམ་པའུ་ར་ནི་པའུ་ར་ནི་། བདག་གི་བསམ་པ་རྫོགས་པར་མཛད་དུ་གསོལ་། རིག་པ་ཐམས་ཅད་ལས་བྱུང་བའི་སྐུ་ཅན་།
 jayottari jayakari jayavati |	རྒྱལ་བ་ལྷག་པར་རྒྱལ་བ་ཅན་། དེ་བཞིན་གཤེགས་པའི་སྙིང་པོ་རྣམ་པར་དག་པ་བཅོམ་ལྡན་འདས་མ་བཞུགས་སུ་གསོལ་། བཞུགས་སུ་གསོལ་།
 tiṣṭha 2 bhagavati samayam anupālaya sarvatathāgatahṛdayaśuddhe vyavalokaya māṃ saparivāraṃ sarvasatvāṃś (mp_9)	དམ་ཚིག་བསྐྱང་དུ་གསོལ་།
 cātha mahādāruṇabhayeṣu sarvāsāṃ paripūraya trāyasva mahābhayebhyaḥ |	འཇིགས་པ་མི་བཟད་པ་ཆེན་པོ་བརྒྱད་ལས་བདག་ལ་གཟིགས་སུ་གསོལ་། ས་ར་ས་ར་། པྲ་ས་ར་པྲ་ས་ར་།
 sara 2 prasara 2 sarvāvaraṇaviśodhani samantākāramaṇḍalaviśuddhe |	སརབབ་ཨའ་བ་ར་ན་བི་ཤོ་དྷ་ནི་། ས་མནཏ་ཨཨ་ཀའ་ར་མནད་ལ་བི་ཤུདདྷེ་། བི་ག་ཏེ་།
 vigate 2 vigatamale |	བི་ག་ཏ་མ་ལེ་།
 sarvamalaviśodhani | sarvāmaṅgalaviśuddhe | sarvāmaṅgalaviśodhani |	སརབབ་མ་ལ་བི་ཤོ་དྷ་ནི་། ཀཤི་ནི་ཀཤི་ནི་།
 kṣiṇi 2 sarvapāpaviśuddhe |	སརབབ་པའ་པམ་བི་ཤུདདྷེ་།
 malavigate |	མ་ལ་བི་ག་ཏེ་། ཛ་ཡ་བ་ཏི་།
 jayavati tejovati vajravati trailokyādhiṣṭhite svāhā ||	ཏེ་ཛོ་ཏེ་ཛོ་བ་ཏི་། བཛྲ་བཛྲ་བ་ཏི་སབ༹འཧའ་། འཇིག་རྟེན་གསུམ་དུ་བྱིན་གྱིས་བརླབས་པ་ལ་སབ༹འཧའ་།
 sarvatathāgatamūrdhābhiṣikte svāhā ||	དེ་བཞིན་གཤེགས་པ་ཐམས་ཅད་ཀྱི་སྤྱི་བོ་ནས་དབང་བསྐུར་བ་ལ་སབ༹འཧའ་།
 sarvabuddhabodhisatvābhiṣikte svāhā ||	བྱང་ཆུབ་སེམས་དཔའ་ཐམས་ཅད་ཀྱིས་དབང་བསྐུར་བ་ལ་སབ༹འཧའ་།
 sarvatathāgatahṛdayaviśuddhe svāhā ||	ལྷ་ཐམས་ཅད་ཀྱིས་དབང་བསྐུར་བ་ལ་སབ༹འཧའ་།
 sarvatathāgatābhiṣikte svāhā || sarvatathāgatahṛdayādhiṣṭhitahṛdaye svāhā ||	ལྷ་ཐམས་ཅད་ཀྱིས་བདང་བསྐུར་བ་ལ་སབ༹འཧའ་དེ་བཞིན་གཤེགས་པ་ཐམས་ཅད་ཀྱི་སྙིང་པོས་བྱིན་གྱིས་བརླབས་པ་ལ་སབ༹འཧའ་།
 sarvatathāgatahṛdayasiddhe svāhā ||	དེ་བཞིན་གཤེགས་༄༦༡ཨ་༌༎ པ་ཐམས་ཅད་ཀྱིས་དམ་ཚིག་གྲུབ་པ་ལ་སབ༹འཧའ་།
 indre indravati indravyavalokite |	དབང་པོ་དང་ལྡན་པ་དབང་པོས་རྣམ་པར་བལྟས་པ་ལ་སབ༹འཧའ་།
 brahme brahmādhyuṣite svāhā ||	ཚངས་པ་དང་ཚངས་པ་ལ་གནས་པ་ལ་སབ༹འཧའ་།
 viṣṇunamaskṛte svāhā |	ཁྱབ་འཇུག་གིས་ཕྱག་བྱས་པ་ལ་སབ༹འཧའ་།
 maheśvaravanditapūjitāyai svāhā ||	དབང་ཕྱུག་ཆེན་པོས་ཕྱག་འཚལ་ཞིང་མཆོད་པ་ལ་སབ༹འཧའ་།
 vajradhara vajrapāṇibalavīryādhiṣṭhite svāhā ||	རྡོ་རྗེ་འཛིན་ལག་ན་རྡོ་རྗེའི་སྟོབས་དང་བརྩོན་འགྲུས་ཀྱིས་བྱིན་གྱིས་བརླབས་པ་ལ་སབ༹འཧའ་།
 dhṛtarāṣṭrāye svāhā |	ཡུལ་འཁོར་སྲུང་ལ་སབ༹འཧའ་།
 virūḍhakāya svāhā |	འཕགས་སྐྱེས་པོ་ལ་སབ༹འཧའ་།
 virūpākṣāya svāhā |	མིག་མི་བཟང་ལ་སབ༹འཧའ་།
 vaiśramaṇāya svāhā |	རྣམ་ཐོས་ཀྱི་བུ་ལ་སབ༹འཧའ་།
 caturmahārājanamaskṛtāya svāhā ||	རྒྱལ་པོ་ཆེན་པོ་བཞིས་ཕྱག་འཚལ་བ་ལ་སབ༹འཧའ་།
 yamāya svāhā |	གཤིན་རྗེ་ལ་སབ༹འཧའ་།
 yamapūjitanamaskṛtāya svāhā ||	གཤིན་རྗེས་མཆོད་ཅིང་ཕྱག་འཚལ་བ་ལ་སབ༹འཧའ་།
 varuṇāya svāhā |	ཆུའི་ལྷ་ལ་སབ༹འཧའ་།
 mārutāya svāhā |	རླུང་ལྷ་ལ་སབ༹འཧའ་།
 mahāmārutāya svāhā | agnaye svāhā |	རླུང་ལྷ་ཆེན་པོ་ལ་སབ༹འཧའ་།
 vāyave svāhā || nāgavilokitāya svāhā |	མེ་ལྷ་ལ་སབ༹འཧའ༏་ཀླུས་རྣམ་པར་བལྟས་པ་ལ་སབ༹འཧའ་།
 devagaṇebhyaḥ svāhā |	ལྷའི་ཚོགས་རྣམས་ལ་སབ༹འཧའ་།
 nāgagaṇebhyaḥ svāhā |	ཀླུའི་ཚོགས་རྣམས་ལ་སབ༹འཧའ་།
 yakṣagaṇebhyaḥ svāhā |	གནོད་སྦྱིན་གྱི་ཚོགས་རྣམས་ལ་སབ༹འཧའ་།
 rākṣasagaṇebhyaḥ svāhā | gandharvagaṇebhyaḥ svāhā |	སྲིན་པོའི་ཚོགས་རྣམས་ལ་སབ༹འཧའ༏་དྲི་ཟའི་ཚོགས་རྣམས་ལ་སབ༹འཧའ་།
 asuragaṇebhyaḥ svāhā |	ལྷ་མ་ཡིན་གྱི་ཚོགས་རྣམས་ལ་སབ༹འཧའ་།
 garuḍagaṇebhyaḥ svāhā |	ནམ་མཁའ་ལྡིང་གི་ཚོགས་རྣམས་ལ་སབ༹འཧའ་།
 kinnaragaṇebhyaḥ svāhā |	མི་འམ་ཅིའི་ཚོགས་རྣམས་ལ་སབ༹འཧའ་།
 mahoragagaṇebhyaḥ svāhā |	ལྟོ་འཕྱེ་ཆེན་པོའི་ཚོགས་རྣམས་ལ་སབ༹འཧའ་།
 manuṣyagaṇebhyaḥ svāhā |	མི་རྣམས་ལ་སབ༹འཧའ་།
 amanuṣyagaṇebhyaḥ svāhā ||	མི་མ་ཡིན་པ་རྣམས་ལ་སབ༹འཧའ་།
 sarvagrahebhyaḥ svāhā |	གདོན་རྣམས་ལ་སབ༹འ་ཧའ་།
 sarvabhūtebhyaḥ svāhā |	འབྱུང་པོ་ཐམས་ཅད་ལ་སབ༹འཧའ་།
 sarvapretebhyaḥ svāhā |	ཡི་དབ༹གས་ལ་སབ༹འཧའ་།
 sarvapiśācebhyaḥ svāhā |	༄༦༡བ་ཤ་ཟ་ལ་སབ༹འཧའ་།
 sarvāpasmārebhyaḥ svāhā | sarvakumbhāṇḍebhyaḥ svāha |	བརྗེད་བྱེད་ལ་སབ༹འཧའ་།
 sarvapūtanebhyaḥ svāhā |	གནོན་པོ་ལ་སབ༹འཧའ་།
 sarvakaṭapūtanebhyaḥ svāhā | sarvaduṣṭapraduṣṭebhyaḥ svāhā || oṃ dhuru 2 svāhā |	གྲུལ་བུམ་ལ་སབ༹འཧའ་།
 oṃ turu 2 svāhā | oṃ kuru 2 svāhā | oṃ (mp_10) curu 2 svāhā |	ཨཨོམ་དྷུ་རུ་དྷུ་རུ་སབ༹འཧའ་།
 oṃ muru 2 svāhā ||	ཏུ་རུ་ཏུ་རུ་སབ༹འཧའ་། མུ་རུ་མུ་རུ་སབ༹འཧའ་། ཧ་ན་ཧ་ན་།
 hara 2 sarvaśatrūn svāhā |	སརབབ་ཤ་ཏརའུམ་སབ༹འཧའ་།
 daha 2 sarvaduṣṭān svāhā | paca 2 sarvapratyarthikapratyamitrān svāhā ||	ད་ཧ་ད་ཧ་སརབབ་དུཤཏའ་ནའམ་སབ༹འཧའ་།
 ye mahāhitaiṣiṇas teṣāṃ sarveṣāṃ śarīraṃ jvālaya 2 duṣṭacittānāṃ svāhā ||	གང་དག་བདག་ལ་མི་ཕན་པར་འདོད་པ་དེ་དག་ཐམས་ཅད་ཀྱིས་ལུས་ཛབ༹འ་ལ་ཡ་སརབབ་དུཤཏ་ཙི་ཏརའ་ནའ་སབ༹འཧའ་།
 jvalitāya svāhā |	འབར་བ་ལ་སབ༹འཧའ་།
 prajvalitāya svāhā | dīptajvālāya svāhā |	རབ་ཏུ་འབར་བ་ལ་སབ༹འཧའ་།
 vajrajvālāya svāhā |	རྡོ་རྗེ་འབར་བ་ལ་སབ༹འཧའ་། མ་ལྕེ་འབར་བ་ལ་སབ༹འཧའ་།
 samantajvālāya svāhā ||	ཀུན་ཏུ་འབར་བ་ལ་སབ༹འཧའ་།
 māṇibhadrāya svāhā |	ནོར་བུ་བཟང་ལ་སབ༹འཧའ་།
 pūrṇabhadrāya svāhā | kālāya svāhā |	གང་བ་བཟང་པོ་ལ་སབ༹འཧའ་།
 mahākālāya svāhā |	ནག་པོ་ཆེན་པོ་ལ་སབ༹འཧའ་།
 mātṛgaṇāya svāhā ||	མ་མོའི་ཚོགས་ལ་སབ༹འཧའ་།
 yakṣaṇīnāṃ svāhā |	གནོད་སྦྱིན་མོ་རྣམས་ལ་སབ༹འཧའ་།
 rākṣasīnāṃ svāhā | pretapiśācaḍākinīnāṃ svāhā |	སྲིན་མོ་རྣམས་ལ་སབ༹འཧའ་།
 ākāśamātṛṇāṃ svāhā | samudragāminīnāṃ svāhā |	ནམ་མཁའི་མ་མོ་རྣམས་ལ་སབ༹འཧའ་།
 samudravāśinīnāṃ svāhā |	རྒྱ་མཚོ་ན་གནས་པ་རྣམས་ལ་སབ༹འཧའ་།
 rātricarāṇāṃ svāhā |	མཚན་མོ་རྒྱུ་བ་རྣམས་ལ་སབ༹འཧའ་།
 divasacarāṇāṃ svāhā | trisandhyacarāṇāṃ svāhā |	ཉིན་མོ་རྒྱུ་བ་རྣམས་ལ་སབ༹འཧའ༏་དུས་གསུམ་དུ་རྒྱུ་བ་རྣམས་ལ་སབ༹འཧའ་།
 velācarāṇāṃ svāhā |	དུས་སུ་རྒྱུ་བ་རྣམས་ལ་སབ༹འཧའ་།
 avelācarāṇāṃ svāhā ||	དུས་མ་ཡིན་པར་རྒྱུ་བ་རྣམས་ལ་སབ༹འཧའ་།
 garbhaharebhyaḥ svāhā | garbhāhāriṇībhyaḥ svāhā |	ཟས་སུ་མངལ་ཟ་བ་རྣམས་ལ་སབ༹འཧའ་།
 garbhasaṃdhāriṇībhyah svāhā || hulu 2 svāhā | oṃ svāhā |	མངལ་འཛིན་པ་ལ་སབ༹འཧའ༏་ཧུ་ལུ་ཧུ་ལུ་སབ༹འཧའ་། ཨཨོམ་སབ༹འཧའ་།
 bhūḥ svāhā |	སབ༹༔་སབ༹འཧའ་།
 bhuvaḥ svāhā |	བྷུ༔་སབ༹འཧའ་།
 bhūrbhuvaḥ svaḥ svāhā ||	བྷུ་བ༔་སབ༹འཧའ་།
 ciṭi 2 svāhā | viṭi 2 svāhā ||	བྷུརབྷུ་བ༔་སབ༹འཧའ་། ཙི་ཏི་ཙི་ཏི་སབ༹འཧའ་།
 dharaṇi svāhā |	བི་ཏི་བི་ཏི་སབ༹འཧའ་།
 dhāraṇi svāhā |	དྷ་ར་ནི་སབ༹འཧའ་། དྷའ་ར་ནི་སབ༹འཧའ་།
 agniḥ svāhā tejovāyuḥ svāhā ||	ཨཨགནི་སབ༹འཧའ་།
 cili 2 svāhā | śili 2 svāhā |	ཏེ་ཛོ་བ་ཡུ་སབ༹འཧའ༏་ཙི་ལི་ཙི་ལི་སབ༹འཧའ་།
 mili 2 svāhā |	མི་ལི་མི་ལི་སབ༹འཧའ་། སི་ལི་སི་ལི་སབ༹འཧའ་།
 budhya 2 svāhā |	བུདདྷྱ་བུདདྷྱ་སབ༹འཧའ་།
 sidhya 2 svāhā ||	སིདདྷྱ་སིདདྷྱ་སབ༹འཧའ་།
 maṇḍalabandhe svāhā |	མནད་ལ་བནདྷེ་སབ༹འཧའ་།
 sīmābandhe svāhā ||	སའི་མའ་བནདྷེ་སབ༹འཧའ་། དྷ་ར་ནི་བནདྷེ་སབ༹འཧའ་།
 sarvaśatrūn bhañjaya 2 svāhā |	སརབབ་ཤ་ཏརའུ་བྷཉཛ་ཡ་༄༦༢ཨ་༌༎ སབ༹འཧའ༏་ཛམ་བྷ་ཡ་ཛམ་བྷ་ཡ་སབ༹འཧའ་།
 stambhaya 2 svāhā |	སྟམ་བྷ་ཡ་སྟམ་བྷ་ཡ་སབ༹འཧའ་།
 chinda 2 svāhā |	ཚིནད་ཚིནད་སབ༹འཧའ་།
 bhinda 2 svāhā | 2 svāhā |	བྷིནད་བྷིནད་སབ༹འཧའ་།
 bhañja 2 svāhā |	བྷཉཛ་བྷཉཛ་སབ༹འཧའ་།
 bandha 2 svāhā |	བནདའ་བནདའ་སབ༹འཧའ་།
 mohaya 2 svāhā ||	མོ་ཧ་ཡ་མོ་ཧ་ཡ་སབ༹འཧའ་།
 maṇiviśuddhe svāhā |	མ་ནི་བི་ཤུདདྷེ་སབ༹འཧའ་།
 sūrye sūryaviśuddhe svāhā | candre pūrṇacandre svāhā ||	སའུརྱེ་སབ༹འཧའ་།
 śodhani svāhā |	སའུརྱེ་བི་ཤུདདྷེ་སབ༹འཧའ་།
 viśodhani svāhā || grahebhyaḥ svāhā |	ཤོ་དྷ་ནི་བི་ཤོ་དྷ་ནི་སབ༹འཧའ་། ཙནདྲེ་ཙནདྲེ་པ་རི་པའུ་རྣ་ཙནདེ་གྲ་ཧེ་བྷྱ༔་སབ༹འཧའ་།
 nakṣatrebhyaḥ svāhā |	ནཀཤ་ཏྲེ་བྷྱ༔་སབ༹འཧའ་།
 śivebhyaḥ svāhā |	ཤི་བེ་བྷྱ༔་སབ༹འཧའ་།
 (mp_11) śāntibhyaḥ svāhā |	ཤའནཏི་བྷྱ༔་སབ༹འཧའ་།
 puṣṭibhyaḥ svāhā |	པུཤཏི་བྷྱ༔་སབ༹འཧའ་།
 svastyayanebhyaḥ svāhā ||	སབ༹་སྟྱེ་ཡ་ན་བྷྱ༔་སབ༹འཧའ་། གརབྷ་དྷ་རེ་སབ༹འཧའ་།
 śivaṃkari svāhā |	ཤི་བམ་ཀ་རི་སབ༹འཧའ་།
 śaṃkari svāhā |	ཤི་ཀ་རི་སབ༹འཧའ་།
 śāntiṃkari svāhā |	ཤའནཏི་ཀ་རི་སབ༹འཧའ་།
 puṣṭiṃkari svāhā |	པུཤཏིམ་ཀ་རི་སབ༹འཧའ་།
 balavardhani svāhā |	བེ་ལ་བརདྷ་ནི་སབ༹འཧའ་།
 balavardhanaṃkari svāhā | śrīkari svāhā |	བ་ལ་བརདྷ་ནི་ཀ་རི་སབ༹འཧའ༏་ཤརའི་ཀ་རི་སབ༹འཧའ་།
 śrīvardhani svāhā |	ཤརའི་བརདྷ་ནི་སབ༹འཧའ་།
 śrījvālini svāhā |	ཤརའི་ཛབ༹འ་ལ་ན་སབ༹འཧའ་།
 muci svāhā |	མུ་ཙི་སབ༹འཧའ་།
 namuci svāhā |	ན་མུ་ཙི་སབ༹འཧའ་།
 muruci svāhā |	མ་རུ་ཙི་སབ༹འཧའ་།
 vegavati svāhā ||	བེ་ག་བ་ཏི་སབ༹འཧའ་།
 oṃ sarvatathāgatamūrte pravaravigatabhaye śamayasva me bhagavati sarvapāpaṃ svastir mama sarvasatvānāṃ ca svāhā ||	ཨཨོམ་བཅོམ་ལྡན་འདས་མ་དེ་བཞིན་གཤེགས་པ་ཐམས་ཅད་ཀྱི་སྐུ་མཆོག་དྲི་མ་དང་བྲེལ་བ་། བདག་གི་སྡིག་པ་ཐམས་ཅད་ཞི་བར་མཛད་དུ་གསོལ་། བདག་བདེ་ལེགས་སུ་གྱུར་ཅིག་།
 oṃ muni 2 vimuni 2 dhari cari calane bhayavigate bhayahariṇi |	ཨཨོམ་མུ་ནེ་མུ་ནེ་། བི་མུ་ནི་བི་མུ་ནི༏་དྷ་རི་ཙ་ལ་ཙ་ལ་ནེ་། བྷ་ག་བ་ཏི་། བྷ་ཡ་བི་ག་ཏེ་། བྷ་ཡ་ཧ་རི་ནི་། བོ་དྷི་བོ་དྷི་། བོ་དྷ་ཡ་བོ་དྷ་ཡ་།
 bodhi 2 bodhaya 2 buddhili 2 sarvatathāgatahṛdayajuṣṭe svāhā ||	བུདདྷི་ལི་བུདདྷི་ལི་། ཙུམབུ་ལི་ཙུམབུ་ལི་སབ༹འཧའ་། སརབབ་ཏ་ཐའ་ག་ཏ་ཧྲི་ད་ཡ་ཛུ་ཤེ་སབ༹འཧའ༏་ཨཨོམ་མུ་ནི་མུ་ནི་མུ་ནི་བ་རེ་། དེ་བཞིན་གཤེགས་པ་ཐམས་ཅད་ཀྱི་རིག་པའི་དབང་བསྐུར་བ་།
 oṃ muni 2 munivare abhisiñcantu māṃ sarvasatvāṃś ca sarvatathāgatāḥ sarvavidyābhiṣekair mahāvajrakavacamudrāmudritaiḥ sarvatathāgatahṛdayādhiṣṭhitavajre svāhā ||	རྡོ་རྗེའི་གོ་ཆ་ཆེན་པོའི་ཕྱག་རྒྱས་བཏབ་པ་ཐམས་ཅད་ཀྱིས་བདག་༄༦༢བ་ལ་དབང་བསྐུར་དུ་གསོལ་། སརབབ་ཏ་ཐའ་ག་ཏ་ཧྲི་ད་ཡ་། ཨཨ་དྷིཤཐ་ན་ཨཨ་དྷིཤཐི་ཏེ་བཛྲེ་སབ༹འཧའ་།
 samantajvālāmālāviśuddhisphūritacintāmaṇimahāmūdrāhṛdayāparājitā mahādhāraṇī tena khalu samayena tasyām eva pariṣadi mahābrāhmaṇaḥ saṃnipatito 'bhūt | saṃniṣaṇṇaś ca || tatra bhagavān mahābrāhmaṇam āmantrayate sma |	བྲམ་ཟེ་ཆེན་པོའི་རིག་པའི་རྒྱལ་མོ་སོ་སོར་འབྲང་བ་ཆེན་པོ་། ཀུན་ནས་མེ་ལྕེའི་ཕྲེང་བ་རྣམ་པར་དག་པས་རྒྱས་པ་།
 asyā mahāpratisarāyā mahāvidyārājñaḥ sahasravarṇamātreṇa mahābrāhmaṇa tasya kulaputrasya vā kuladuhitur vā sarvapāpavinirmuktir bhavati |	ཡིད་བཞིན་གྱི་ནོར་བུའི་ཕྱག་རྒྱ་དང་། སྙིང་པོ་གཞན་གྱིས་མི་ཐུབ་པའི་གཟུངས་འདི་རིགས་ཀྱི་བུའམ་། རིགས་ཀྱི་བུ་མོས་ཐོས་མ་ཐག་ཏུ་སྡིག་པ་ཐམས་ཅད་ལས་རྣམ་པར་གྲོལ་བར་འགྱུར་རོ་༎
 yasya punar iyaṃ hṛdayagatā bhaviṣyati | sa mahābrāhmaṇa vajrakāya iti veditavyaḥ |	བྲམ་ཟེ་ཆེན་པོ་། རིག་པ་འདི་གང་གི་སྙིང་ལ་གནས་པར་གྱུར་པ་དེའི་ལུས་རྡོ་རྗེར་རིག་པར་བྱའོ་༎
 nāgnis tasya kāye kramiṣyati |	དེའི་ལུས་ལ་མེས་མི་ཚུགས་སོ་༎
 kim iti saṃjñitaṃ | yadā kapilavastumahānagaravare rāhulabhadraḥ kumāro mātuḥ kukṣigato 'bhūd yadā ṣaḍvarṣātikrānte sarvārthasiddhena kumāreṇa mama nābhiḥ pādaṃ suṣṭhena pṛṣṭho nirgatas tad ājānāmi | nānyat kiṃcid iti | parikīrṇāgninā viṣodakena taptakuṭhārikayāturayamānān atrāthāparājitā bhavāmi |	ཅི་མངོན་ཞེ་ན༏་གང་གི་ཚེ་གྲོང་ཁྱེར་ཆེན་པོ་སེར་སྐྱའི་གནས་ན་གཞོན་ནུ་སྒྲ་གཅན་ཟིན་བཟང་པོ་མངལ་དུ་ཞུགས་པ་དེའི་ཚེ་ཤའཀྱའི་བུ་མོ་ས་འཚོ་མ་བདག་ཉིད་མེའི་ནང་དུ་མཆོངས་པ་དང་། 
 tadā gopayā śākyakanyayā ātmānam agnikhadāyāṃ prakṣiptaḥ | tatra padminī prādurbhūtā | tadā rāhulabhadrakumāro mātuḥ kukṣigato eva imāṃ vidyāṃ manasy akarṣīt |	དེར་པདམ་དག་བྱུང་སྟེ་དེའི་ཚེ་གཞོན་ནུ་སྒྲ་གཅན་ཟིན་བཟང་པོ་མངལ་ན་གནས་བཞིན་དུ་རིག་པ་འདི་ཡིད་ལ་བྱས་སོ་༎
 asyā vidyāyā anusmaraṇamātreṇa (mp_12) so 'pi tasmin kṣaṇe śītībhāvam udāgataḥ | tato gopāyāḥ śākyakanyāyāḥ śarīram agninā na spṛṣṭam |	རིག་པ་འདི་རྗེས་སུ་དྲན་པ་ཙམ་གྱིས་མེ་དེ་སྐད་ཅིག་དེ་ཉིད་ལ་བསིལ་བར་གྱུར་ཏོ་༎ དེ་ནས་ཤའཀྱའི་བུ་མོ་ས་འཚོ་མའི་ལུས་ལ་མེས་མ་རེག་གོ་།
 tat kasya hetor eṣā vidyā sarvatathāgatādhiṣṭhitā |	དེ་ཅིའི་ཕྱིར་ཞེ་ན་། རིག་པ་འདི་ནི་། དེ་བཞིན་གཤེགས་པ་ཐམས་ཅད་ཀྱི་བྱིན་གྱིས་བརླབས་པའོ་༎
 tena hetunāyaṃ mahābrāhmaṇo 'gnir na dahati |	བྲམ་ཟེ་ཆེན་པོ་། རྒྱུ་དེས་ན་མེས་མི་འཚིག་གོ་།
 na ca viṣeṇa śakyaṃ taṃ jīvitād vyaparopayitum |	དུག་གིས་ཀྱང་སྲོག་དང་འབྲལ་བར་མི་ནུས་སོ་༎
 tat katham iti ||	དེ་ཅི་ལྟ་ཞེ་ན་།
 yadā mahābrāhmaṇa śūrpārake mahānagaravare koṣavaṇikasya śreṣṭhinaḥ putro vidyāvādiko babhūva |	བྲམ་ཟེ་ཆེན་པོ་། གང་གི་༄༦༣ཨ་༌༎ ཚེ་གྲོང་ཁྱེར་ཆེན་པོ་བདེ་བར་ཕ་རོལ་ཏུ་འགྲོ་བ་ཞེས་བྱ་བ་ན་ཚོང་དཔོན་མཛོད་སྟོབས་ཅན་གྱི་བུ་རིག་པ་སྨྲ་བར་གྱུར་ཏོ་༎
 tena tad vidyābalena takṣako nāgarājā ākarṣitaḥ |	དེའི་རིག་པའི་སྟོབས་དེས་ཀླུའི་རྒྱལ་པོ་འཇོག་པོ་བཀུག་གོ་།
 ākarṣayitvā ca pramāṇavaśād baddho nadānto yāvat tenāsau krodhād daṣṭaḥ | sa tīvrāṃ kharāṃ kaṭukāṃ vedanāṃ vedayati |	བཀུག་ནས་ཀྱང་བག་མེད་པའི་དབང་གིས་མ་བཅིབས་པས་དེས་ཁྲོས་ནས་དེ་ལ་བཟུང་བ་དང་། དེ་ཚོར་བ་མི་བཟད་པ་མྱོང་ནས་ཇི་ལྟར་ཡང་བདག་ནི་།
 yathā jānāmi ca me jīvitaṃ niruddham iti | tatra bahavo vādikā āhutāḥ |	སྲོག་དང་བྲལ་ལོ་སྙམ་དུ་ཤེས་སོ་༎
 na ca kaścic chaknoti viṣaṃ cikitsitum | atha traiva śūrpārake mahānagaravare vimalaviśuddhir nāmopāsikā prativasati sma | mahākaruṇāsamanvāgatā tasya iyaṃ mahāvidyārājñī jihvāgre 'bhūt |	ད་ནས་སྨྲ་བ་ཅན་མང་པོ་བོས་ཀྱང་འགའ་ཙམ་གྱིས་ཀྱང་དུག་ལས་གསོ་བར་མ་ནུས་སོ་༎ དེ་ནས་གྲོང་ཁྱེར་ཆེན་པོ་བདེ་བར་ཕ་རོལ་ཏུ་འགྲོ་བ་ན་དགེ་བསྙེན་མ་དྲི་མ་མེད་པར་དག་པ་ཞེས་བྱ་བ་སྙིང་རྗེ་ཆེན་པོ་དང་ལྡན་པ་ཞིག་གནས་པ་དེས་རིག་པའི་རྒྱལ་མོ་ཆེན་མོ་འདི་ཁ་ཏོན་དུ་ཤེས་སོ༏་༏དེ་དེའི་གནས་སུ་སོང་སྟེ་ཕྱིན་པ་དང་། རིག་པ་ཆེན་པོ་འདི་བརྗོད་དོ་༎
 sā tasyāntikam upasaṃkrāntā upasaṃkramyemāṃ mahāvidyāṃ pravartayāmāsa | sā tayaikavelāyām anusmṛtamātrayā nirviṣaṃ smṛtipratilabdhaṃ kṛtvā tato mahāvyasanāt parimocayitvā imām eva śuddhiputre mahāvidyāṃ hṛdayagatāṃ kārayati sma | yathā vidhivad anujñātam iti ||	དེས་དེ་ལ་ལན་གཅིག་བརྗོད་པ་ཙམ་གྱིས་དེ་དུག་མེད་པར་བྱས་ཤིང་དེ་དྲན་པ་རྙེད་པར་བྱས་ཏེ་སྡུག་བསྔལ་ཆེན་པོ་དེ་ལས་ཡོངས་སུ་ཐར་པར་བྱས་ནས་རིག་པ་ཆེན་མོའི་སྙིང་པོ་འདི་ཆོ་ག་ཇི་ལྟར་བཀའ་སྩལ་པ་བཞིན་དུ་ཚོང་དཔོན་གྱི་བུ་དེའི་སྙིང་ལ་གནས་པར་བྱས་སོ་༎ 
 api ca mahābrāhmaṇa kiṃ parijñātam iti |	བྲམ་ཟེ་ཆེན་པོ་། གཞན་ཡང་ཇི་ལྟར་ཡོངས་སུ་ཤེས་ཤེ་ན་།
 bārāṇāsyāṃ mahānagaryām anupūrveṇānuvicaramāṇo rājā brahmadatta iti saṃkhyāṃ gacchati | tasya prātisīmiko balacakrarājā caturaṅgabalakāyaṃ saṃnāhya bārāṇasīmahānagarīṃ parivārya vināśayitum ārabdhaḥ | tato rājñā brahmadattasyāmātyair niveditam |	རྒྱལ་པོ་ཚངས་པས་བྱིན་ཞེས་བྱ་བའི་གྲངས་སུ་ཆུད་པ་ཞིག་གྲོང་ཁྱེར་ཆེན་པོ་༄༦༣བ་ཝའ་ར་ནའ་སི་ན་སྔོན་ཡོངས་སུ་རྒྱུ་བའི་ཚེ་དེའི་ཤར་ཕྱོགས་ཀྱི་མཚམས་ཀྱི་སྟོབས་ཀྱི་འཁོར་ལོས་བསྒྱུར་བའི་རྒྱལ་པོ་དེས་དཔུང་གི་ཚོགས་ཡན་ལག་བཞི་པ་གོ་བསྐོན་ཏེ་གྲོང་ཁྱེར་ཆེན་པོ་ཝའ་ར་ནའ་སི་ཀུན་ནས་བསྐོར་ནས་གཞོམ་པར་བཤམས་སོ་༎ དེ་ནས་རྒྱལ་པོ་ཚངས་པས་བྱིན་དེ་ལ་བློན་པོ་རྣམས་ཀྱིས་སྨྲས་པ་། ལྷ་།
 deva paracakreṇa nagaram apahṛtam |	ཕ་རོལ་གྱི་དམག་ཚོགས་ཀྱིས་གྲོང་ཁྱེར་འཕྲོག་ལ་ཐུག་ན་།
 tataḥ kiṃ tu khalu vayam upāyaṃ kuryāmo yenaitat paracakraṃ vinaśyet | ājñāṃ prayaccha | rājā kathayati | alpotsukā bhavanto mā bhavata |	ཐབས་གང་གིས་ཕ་རོལ་གྱི་དམག་ཚོགས་གཞོམ་པར་བགྱི་བཀའ་སྩལ་དུ་གསོལ་ཞེས་བྱས་པ་དང་། རྒྱལ་པོས་ཁྱེད་འཚེར་འགྲིབ་ཆུང་དུར་གྱིས་ཤིག་།
 asti mama mahāpratisarā nāma vidyārājñī |	རིག་པའི་རྒྱལ་མོ་སོ་སོར་འབྲང་བ་ཆེན་མོ་ཞེས་བྱ་བ་ཡོད་དེ་།
 yenāham ihemaṃ caturaṅgabalakāyaṃ parājeṣyāmi |	ངས་དེས་དཔུང་གི་ཚོགས་ཡན་ལག་བཞི་པ་འདི་ཕམ་པར་བྱའོ་༎
 tathā kariṣyāmi | amātyāḥ śirasā praṇipatyocuḥ |	ཐལ་བ་བཞིན་དུ་བྱའོ༏་༏ཞེས་བསྒོ་བ་དང་། བློན་པོ་རྣམས་ཀྱི་མགོ་བཏུད་དེ་རྒྱལ་པོ་ཆེན་པོ་།
 kim idaṃ mahārāja nāsmābhiḥ kadācid api na śrutam iti | rājā prāha | aham idānīṃ pratyakṣaṃ darśanaṃ kariṣyāmi |	སྔོན་བདག་གིས་ནམ་ཡང་མ་ཐོས་པ་འདི་ཅི་ཞིག་ལགས་ཞེས་སྨྲས་པ་དང་། རྒྱལ་པོས་ངས་དེ་མངོན་སུམ་དུ་བྱའོ་༎ ཞེས་བསྒོའོ་༎
 atha sa rājā brahmadatto (mp_13) nānāgandhodakena snātaḥ śirāḥ śucivastraṃ prāvṛtya imāṃ mahāpratisarāṃ mahāvidyārājñīṃ yathāvidhinābhilikhya śiraḥ keśe 'vasthāpya imām eva mahāvidyārājñīṃ kavacaṃ kṛtvā	དེ་ནས་རྒྱལ་པོ་ཚངས་པས་བྱིན་སྤོས་ཆུ་སྣ་ཚོགས་ཀྱིས་མགོ་བཀྲུས་ཏེ་གོས་གཙང་མ་བགོས་ནས་རིག་པའི་རྒྱལ་མོ་འདི་ཆོ་ག་བཞིན་དུ་བྲིས་ཏེ་མགོའི་གཙུག་གི་སྐྲའི་ནང་དུ་བཞག་ནས་རིག་པའི་རྒྱལ་མོ་ཆེན་མོ་འདི་ཉིད་ཀྱིས་གོ་ཆ་བྱས་ཏེ་ག-ཡུལ་གྱི་ནང་དུ་ཞུགས་པ་དང་། གཅིག་པུས་༄༦༤ཨ་༌༎
 saṃgrāmamadhye 'vatīrya ekākinaiva sarvāsau caturaṅgabalakāyaḥ parājitaḥ | āmarditaś ca tāvad yāvac caraṇaṃ gataḥ | iti kṛtvāsau balacakrarājā mukta iti ||	དཔུང་གི་ཚོགས་ཡན་ལག་བཞི་པ་ཐམས་ཅད་ཕམ་པར་བྱས་ཏེ་ཇི་སྲིད་སྐྱབས་སུ་དོང་བ་དེ་སྲིད་དུ་འདིས་ཚར་བཅད་ནས་སྟོབས་ཀྱི་འཁོར་ལོས་བསྒྱུར་བའི་རྒྱལ་པོ་དེ་གཅིག་པུ་བཏང་ངོ་༎
 evaṃ hi mahābrāhmaṇa pratyakṣaṃ mahānubhāveyaṃ mahāvidyārājñī sarvatathāgatahṛdayamudrādhiṣṭhitā |	བྲམ་ཟེ་ཆེན་པོ་། དེ་ལྟར་ན་རིག་པའི་རྒྱལ་པོ་ཆེན་མོ་དེ་བཞིན་གཤེགས་པ་ཐམས་ཅད་ཀྱི་སྙིང་པོ་དང་ཕྱག་རྒྱས་བྱིན་གྱིས་བརླབས་པ་མཐུ་ཆེན་པོ་འདི་མངོན་སུམ་དུ་གྱུར་པ་ཡིན་ཏེ་།
 pratyakṣam eveti dhārayitavyā |	མངོན་སུམ་དུ་གྱུར་ཏོ་༎ སྙམ་དུ་གཟུང་བར་བྱའོ་༎
 sarvatathāgatasamaiṣā draṣṭavyā |	དེ་བཞིན་གཤེགས་པ་ཐམས་ཅད་དང་མཚུངས་པ་ཉིད་དུ་བལྟ་བར་བྱའོ་༎
 ye kecit paścime kāle paścime samaye alpāyuṣkānāṃ mandabhāgyānāṃ mandadhānyānaṃ parīttabhāgyānāṃ satvānām arthāya hitāya sukhāya draṣṭavyā |	ཕྱི་མའི་ཚེ་ཕྱི་མའི་དུས་ན་སེམས་ཅན་ཚེ་ཐུང་བ་རྣམས་དང་། བསོད་ནམས་ཆུང་བ་རྣམས་དང་། ལོངས་སྤྱོད་ཆུང་བ་རྣམས་ལ་ཕན་པར་འགྱུར་བར་བལྟའོ་༎
 yaḥ kaścin mahābrāhmaṇa imāṃ mahāvidyārājñīṃ yathāvidhinā likhitvā bāhau kaṇṭhe dhārayiṣyati |	བྲམ་ཟེ་ཆེན་པོ་། གང་ལ་ལ་ཞིག་རིག་པའི་རྒྱལ་མོ་སོ་སོར་འབྲང་བ་ཆེན་མོ་འདི་ཆོ་ག་བཞིན་དུ་བྲིས་ཏེ་ལག་པའམ་། མགུལ་དུ་བཏགས་ན་།
 sa sarvatathāgatādhiṣṭhito veditavyaḥ |	དེ་དེ་བཞིན་གཤེགས་པ་ཐམས་ཅད་ཀྱི་བྱིན་གྱིས་བརླབས་པར་རིག་པར་བྱའོ་༎
 sarvatathāgatakāya iti veditavyaḥ |	དེ་དེ་བཞིན་གཤེགས་པ་ཐམས་ཅད་ཀྱི་སྐུར་རིག་པར་བྱའོ་༎
 vajrakāya iti veditavyaḥ |	རྡོ་རྗེའི་ལུས་ཡིན་པར་རིག་པར་བྱའོ་༎
 sarvatathāgatadhātugarbha iti veditavyaḥ |	དེ་དེ་བཞིན་གཤེགས་པ་ཐམས་ཅད་ཀྱི་རིང་བསྲེལ་གྱི་སྙིང་པོ་ཅན་ཡིན་པར་རིག་པར་བྱའོ་༎
 sarvatathāgatanetra iti veditavyaḥ |	དེ་དེ་བཞིན་གཤེགས་པ་ཐམས་ཅད་ཀྱི་སྤྱན་ཡིན་པར་རིག་པར་༄༦༤བ་བྱའོ༏་༏དེ་རྡོ་རྗེ་ཆེན་པོའི་ལུས་སུ་རིག་པར་བྱའོ་༎
 jvālitārciśarīra iti veditavyaḥ |	དེ་འབར་བ་འོད་འཕྲོ་བའི་ལུས་དང་ལྡན་པར་རིག་པར་བྱའོ་༎
 abhedyakavaca iti veditavyaḥ |	དེ་མི་ཤིགས་པའི་གོ་ཆ་ཅན་དུ་རིག་པར་བྱའོ་༎
 sa sarvaśatrūṇāṃ pramathana iti veditavyaḥ |	དེ་དགྲ་ཐམས་ཅད་རབ་ཏུ་འཇོམས་པར་རིག་པར་བྱའོ་༎
 sarvapāpāvaraṇanirdahana iti veditavyaḥ |	དེ་སྒྲིབ་པ་དང་སྡིག་པ་ཐམས་ཅད་འཇོམས་པར་རིག་པར་བྱའོ་༎
 sarvanarakagativiśodhana iti veditavyaḥ |	དེ་སེམས་ཅན་དམྱལ་བའི་འགྲོ་བ་རྣམས་སྦྱོང་བར་རིག་པར་བྱའོ་༎ དེ་ཅིའི་ཕྱིར་ཞེ་ན་།
 kim iti pūrvaṃ parijñātaṃ mahābrāhmaṇa anyatamasmiṃ pṛthivīpradeśe bhikṣuśrāddhas	སྔོན་ཡོངས་སུ་ཤེས་པ་ཡིན་ཏེ་། བྲམ་ཟེ་ཆེན་པོ་། ཕྱོགས་གཞན་ཞིག་ན་དགེ་སློང་མ་དད་པ་།
 tathāgatakulaśikṣākhaṇḍako 'dattādāyī sukhādvārahārakaḥ saṃghikaṃ cāturdiśikaṃ staupikaṃ	དེ་བཞིན་གཤེགས་པའི་རིགས་ལ་བསླབ་པ་འདྲལ་བ་། མ་བྱིན་པར་ལེན་པ་། བཟའ་བ་འདུ་བའི་སྒོ་འཕྲོག་པ་།
 gaṇaprāptaṃ ca yad dravyaṃ tat paudgalikaṃ kṛtvā sarvam adhiṣṭhāya takṣayati | yāvad apareṇa samayena mahāvyādhinā pṛṣṭaḥ | sa mahatīṃ duḥkhāvedanām anubhavati |	དགེ་འདུན་གྱི་དང་། ཕྱོགས་བཞི་དང་། ཚོགས་རྫས་སུ་གྱུར་པ་དེ་ཐམས་ཅད་གང་ཟག་གིར་བྱིན་གྱིས་བརླབས་ཏེ་ཟ་བ་ཞིག་དུས་གཞན་ཞིག་ན་ནད་ཚབས་ཆེན་པོས་བཏབ་པ་དང་། སྡུག་བསྔལ་ཆེན་པོའི་ཚོར་བ་མྱོང་ངོ་༎
 sa tapasvī atrāṇo 'parāyaṇo 'pratiśaraṇo mahāntasukrośaṇāśabdaṃ karoti | atha tasminn eva pṛthivīpradeśe upāsako brāhmaṇo prativasati |	ཉོན་མོངས་ཏེ་སྐྱབས་མེད་དཔུང་གཉེན་མེད་ནས་ཀུ་ཅོའི་སྒྲ་ཆེན་པོ་འབྱིན་ཏོ༏་༏བྲམ་ཟེ་ཆེན་པོ་། དེ་ནས་ཕྱོགས་དེ་ན་དགེ་བསྙེན་ཞིག་གནས་པ་དེས་སྒྲ་དེ་ཐོས་སོ་༎
 tena tac chabdaḥ śrutaḥ | śrutvā ca punar yena sa bhikṣus tenopasaṃkrānta upasaṃkramya tasya bhikṣor imāṃ mahāpratisarāṃ mahāvidyārājñīṃ likhitvā kaṇṭhe badhnāti sma	ཐོས་ནས་ཀྱང་དགེ་སློང་དེ་ག་ལ་བ་དེར་སོང་སྟེ་ཕྱིན་ནས་རིག་པའི་རྒྱལ་མོ་སོ་སོར་འབྲང་བ་ཆེན་མོ་འདི་བྲིས་ཏེ་དགེ་སློང་དེའི་མགུལ་དུ་བཏགས་སོ་༎
 samanantarabaddhāyāṃ mahāpratisarāyāṃ mahāvidyārājñyāṃ tasya bhikṣoḥ sarvā vedanāḥ (mp_14)	རིག་པའི་རྒྱལ་མོ་སོ་སོར་འབྲང་བ་ཆེན་མོ་དགེ་སློང་དེའི་མགུལ་དུ་བཏགས་མ་ཐག་ཏུ་ཚོར་བ་ཐམས་༄༦༥ཨ་༌༎ ཅད་ནི༏་རབ་ཏུ་ཞི་། ནད་ཐམས་ཅད་ལས་ནི་།
 praśāntāḥ sarvavyādhibhyaḥ parimuktaḥ svasthaḥ saṃvṛtta iti | tasyām eva rātryām atyayābhyupasthite smṛtipratilabdhaḥ kālagataḥ |	ཡོངས་སུ་ཐར་ཏེ་སོས་པར་གྱུར་ནས་དེའི་མཚན་མོ་ཟད་པ་དང་། དྲན་པ་ཤིན་ཏུ་ཉེ་བར་བཞག་སྟེ་འཆི་བའི་དུས་བྱས་སོ་༎
 tasminn eva kṣatravare utsṛṣṭo 'vīcau mahānarake upapannaḥ |	ལུས་དེ་བོར་བ་དང་སེམས་ཅན་དམྱལ་བ་ཆེན་པོ་མནར་མེད་པར་སྐྱེས་སོ་༎
 tac ca tasya mṛtaśarīraṃ bhikṣubhiḥ kūṭe sthāpitam |	དེའི་རོ་དེ་ཡང་དགེ་སློང་དག་གིས་སྒང་བུ་ཞིག་ལ་བཞག་གོ་།
 sā ca tasya mahāpratisarā mahāvidyārājñī kaṇṭhe baddhaivāsthitā |	རིག་པ་ཆེན་མོ་སོ་སོར་འབྲང་བ་ཆེན་མོ་དེ་ཡང་དེའི་མགུལ་དུ་བཏགས་པ་བཞིན་དུ་གནས་སོ་༎ 
 samanantaropapannasya tasya bhikṣos tasminn avīcau mahānarake teṣāṃ nārakānāṃ satvānāṃ sarvaduḥkhavedanāḥ śāntāḥ | te ca nārakasatvāḥ sarvasukhasamarpitā abhūvan |	དགེ་སློང་དེ་མནར་མེད་པར་དེར་སྐྱེས་མ་ཐག་ཏུ་སེམས་ཅན་དམྱལ་བའི་སེམས་ཅན་དེ་དག་གི་སྡུག་བསྔལ་གྱི་ཚོར་བ་ཐམས་ཅད་རབ་ཏུ་ཞི་ནས་སེམས་ཅན་དམྱལ་བའི་སེམས་ཅན་དེ་དག་ཐམས་ཅད་བདེ་བ་ཐམས་ཅད་ཀྱིས་ཚིམ་པར་སོ་༎ གྱུར་ཏོ་༎ 
 ye ca te mahānta-āvicikā-agniskandhās te 'pi sarveṇa sarvam upaśāntā iti |	མཚམས་མེད་པའི་མེའི་ཕུང་པོ་གང་ཡིན་པ་དེ་དག་ཐམས་ཅད་ཀྱང་ཡོངས་སུ་ཞི་བར་གྱུར་ཏོ་༎
 atha te yamapuruṣā vismayam āpannā yamasya dharmarājasyemaṃ niścayaṃ vistareṇārocayati sma ||	དེ་ནས་གཤིན་རྗེའི་མི་དེ་དག་ཐམས་ཅད་ངོ་མཚར་སྐྱེས་ནས་ཆོས་ཀྱི་རྒྱལ་པོ་གཤིན་རྗེ་ལ་ངེས་པའི་ཚིག་འདི་དག་རྒྱས་པར་བརྗོད་དོ་༎ སེམས་ཅན་ལས་ལས་སྐྱེས་པ་ཡི་༎
 ativismayam idaṃ deva dṛṣyate narakasaṃkaṭe | praśāntā dāruṇā duḥkhāḥ satvānāṃ karmajāś ca ye |	སྡུག་བསྔལ་མི་བཟད་རབ་ཏུ་ཞི་༎ ཤིན་ཏུ་ངོ་མཚར་འདི་ནི་ལྷ་༎ སེམས་དམྱལ་ཉམ་ང་རྣམས་ན་འདའ༎
 praśāntās te 'pi cāṅgārā dehasthā dehināśayā ||	སེམས་ཅན་ལུས་ལ་རྟག་གནས་པའི་༎ མེ་མ་མུར་དེ་རབ་ཏུ་ཞི་༎ སོག་ལེ་རྣམས་ཀྱིས་གཤེག་༄༦༥བ་མ་མཆིས་༎
 karapattrā na bādhante kṣuradhārā na sajjate |	སྤུ་གྲིའི་སོས་ཀྱང་གཅོད་མི་བགྱིད་༎
 ayaḥśālmalayo bhagnāḥ praśāntā lohakumbhayaḥ ||	ལྕགས་སྡོང་ཤལ་མ་རི་ཡང་ཆག་། ལྕགས་ཟངས་ཐམས་ཅད་རབ་ཏུ་ཞི་༎ རལ་གྲི་ལོ་མ་ཅན་ནགས་ན་༎
 asipattrāvane pattrā na bādhante karmajā punaḥ |	ལས་སྐྱེས་ལོ་མ་གནོད་མི་འགྱུར་༎
 yamas tvaṃ dharmarājo 'si dharmeṇa śāsayase prajām ||	ཆོས་ཀྱི་རྒྱལ་པོ་གཤིན་རྗེ་ཁྱོད་༎ མི་རྣམས་ལ་ནི་ཆོས་ཀྱིས་སྟོན་༎
 idaṃ tu kāraṇaṃ nālpam asmākaṃ vaktum arhasi |	རྒྱུ་འདི་མི་ཆུང་བདག་ཅག་ལ་༎ ཁྱོད་ཀྱིས་བརྗོད་པར་མཛད་པའི་རིགས་༎
 tato 'sau dharmarājā vai dharmātmā dharmaniścayaḥ ||	དེ་ནས་ཆོས་ཀྱི་བདག་ཉིད་ཅན་༎ ཆོས་ངེས་ཆོས་ཀྱི་རྒྱལ་པོ་དེས་༎
 karuṇāśayanaṣṭānāṃ vākyaṃ śrutvedam īdṛśam |	སྙིང་རྗེའི་བསམ་པ་ཉམས་རྣམས་ཀྱི་༎ འདི་འདྲའི་ཚིག་དེ་ཐོས་གྱུར་ནས་༎
 kim etat kathyatāṃ śīghraṃ kathaṃ tv iti vaco 'vadat ||	མྱུར་དུ་འདི་ནི་ཅི་ཡིན་སྨྲས་༎ འདི་ནི་ཅི་འདྲ་ཡང་སྨྲོས་ཤིག་།
 tatas te duṣṭasatvānāṃ yamabhṛtyā sudāruṇāḥ |	དེ་ནས་མི་བཟད་གཤིན་རྗེའི་མི་༎ གནོད་པའི་རྒྱུན་ཅན་དེ་དག་གིས་༎
 yamasya dharmarājasya idaṃ vacanam aśrūvan ||	ཆོས་ཀྱི་རྒྱལ་པོ་གཤིན་རྗེ་ལ་༎ འདི་སྐད་ཀྱི་ནི་ཚིག་སྨྲས་སོ་༎ མནར་མེད་རབ་ཏུ་ཉམ་ང་བར་༎
 ayaṃ deva mahāsatva utpanno narakasaṃkaṭe |	སེམས་ཅན་ཆེན་པོ་འདི་སྐྱེས་ལྷ་༎
 avīcir yasya nāmedaṃ tenāsau narakasaṃkaṭa ucyate ||	གང་གི་མིང་ནི་མནར་མེད་པ་༎ དེས་ན་དེ་ནི་ཉམ་ངར་བརྗོད་༎
 karmāṇaṃ yasya vaicitryaṃ satvā ye hi sukhīkṛtam |	གང་གིས་སེམས་ཅན་བདེ་བགྱིས་པ་༎ རྣམ་པ་སྣ་ཚོགས་ལས་ལ་གཟིགས་༎
 sukhino hy eva sarvatra punar yānti surālayam ||	འདི་ནི་ཀུན་ཏུ་བདེ་གྱུར་ནས་༎ སླར་ཡང་ལྷ་ཡི་གནས་སུ་མཆི་༎
 yamo 'pi dharmarājā vai dṛṣṭvā vadati vismitaḥ |	ཆོས་ཀྱི་རྒྱལ་པོ་གཤིན་རྗེས་ཀྱང་༎ མཐོང་ནས་ངོ་མཚར་སྨྲས་པ་ནི་༎
 maharddhiko 'yaṃ mahac cāsya śarīraṃ pūrvo janmikam ||	འདི་ནི་རྫུ་འཕྲུལ་ཆེ་བ་སྟེ༏་༏འདི་ནི་ཚེ་རབས་ལྔ་ལུས་ཚེ་༎ ཇི་ལྟར་སྐུ་གདུང་བརྒྱ་མང་པོས་༎
 yathā dhātuśatair vṛndaṃ stūpaṃ śobhati śāśvatam |	སྟོན་པའི་མཆོད་རྟེན་མཛེས་པ་ལྟར་༎ སོ་སོར་འབྲང་བ་མགུལ་བཏགས་པས་༎ དེ་ཡི་ལུས་ནི་དེ་༄༦༦ཨ་༌༎
 tathāsya śobhate kāyaḥ pratisarābaddhakaṇṭhakaḥ ||	བཞིན་མཛེས་༎
 atha te narakapālā yakṣā yamasya dharmarājasya idaṃ vacanam abruvan |	དེ་ནས་སེམས་ཅན་དམྱལ་བའི་སྲུང་མ་དེ་དག་གིས་ཆོས་ཀྱི་རྒྱལ་པོ་གཤིན་རྗེ་ལ་འདི་སྐད་ཅེས་སྨྲས་སོ་༎ 
 katham iyaṃ deva pratisarety ucyate |	ལྷ་། ཇི་ལྟར་ན་འདི་སོ་སོར་འབྲང་བ་ཞེས་བགྱི་།
 dharmarāja uvāca |	ཆོས་ཀྱི་རྒྱལ་པོས་སྨྲས་པ་། གང་གིས་ཚིག་རྣམས་སོ་སོར་དྲན་༎
 pratipat smārayed yas tu sa na gacchati durgatiṃ sugatiṃ gacchate cāsau pratisarābhāvabhāvitaḥ |	དེ་ནི་ངན་འགྲོར་འགྲོ་མི་འགྱུར་༎ སོ་སོར་འབྲང་བ་སྒོམ་པ་ཡི་༎ ཤེས་རབ་ཅན་དེ་བདེ་འགྲོར་འགྲོ་།
 yūyaṃ narakapālā vai gacchatha puṣkarāvatīṃ |	སེམས་ཅན་དམྱལ་བའི་སྲུང་མ་ཁྱོད་༎ རབ་ཏུ་རྒྱས་དང་ལྡན་པར་དོང་༎ དེར་ནི་སྒང་བུ་མཐོན་པོ་ལ་༎
 tad rakṣatha mahākūṭaṃ devataiḥ parivāritam |	ལྷ་རྣམས་ཀྱིས་ནི་བསྐོར་བ་ལྟོས་༎
 taṃ dṛṣṭvā sarvasarvasakheṣu maitracittā bhaviṣyatha |	དེ་མཐོང་སེམས་ཅན་ཐམས་ཅད་ལ་༎ བྱམས་པའི་སེམས་སུ་འགྱུར་བར་གྱིས་༎
 atha te yakṣā yamapuruṣā tasyām eva rātryāṃ puṣkarāvatīṃ gatāḥ |	དེ་ནས་གཤིན་རྗེའི་མི་དེ་དག་དེ་ཉིད་ཀྱི་ནུབ་མོ་རྒྱས་པ་དང་ལྡན་པར་དོང་ངོ་༎
 te paśyanti tadā tatra rājadhānīsamīpataḥ |	དེ་ཚེ་དེར་ནི་དེ་དག་གིས་༎ རྒྱལ་པོའི་ཕོ་བྲང་ཉེ་བ་ན་༎
 tac ca kūṭaṃ samantena ekadvārāsamākulam ||	སྒང་བུ་དེ་ཡི་ཁོར་ཡུག་ན་༎
 mṛtaśarīraṃ paśyanti pratisarābaddhakaṇṭhakam |	འབར་བ་གཅིག་གིས་གང་བར་མཐོང་༎ མི་རོ་ཞིག་གི་མགུལ་བ་ན་༎ སོ་སོར་འབྲང་བ་བཏགས་པའང་མཐོང་༎
 devā nāgāś ca gandharvā yakṣarākṣasakinnarāḥ ||	ལྷ་དང་ཀླུ་དང་དྲི་ཟ་དང་༎ གནོད་སྦྱིན་སྲིན་པོ་མི་འམ་ཅིས་༎ ཀུན་ནས་འཁོར་བར་བསྐོར་ནས་ནི་༎
 parivārya samantena pūjāṃ kurvanty anuttarām |	བླ་ན་མེད་པའི་མཆོད་པ་བྱེད་༎
 yāvat tasya ca tair yakṣaiḥ pratisarākūṭeti nāma sthāpitam ||	དེ་ལ་གནོད་སྦྱིན་དེ་དག་གིས་༎ སོ་སོར་འབྲང་བའི་སྒང་ཞེས་བཏགས་༎
 atha te yakṣā punar āgatya yamasya dharmarājasyemaṃ niścayaṃ vistareṇārocayati sma | evam etad deva tvayābhihitaṃ |	དེ་ནས་གནོད་སྦྱིན་དེ་དག་གིས་ཆོས་ཀྱི་རྒྱལ་པོ་གཤིན་རྗེའི་ངེས་པ་དེ་རྟོགས་ཏེ་སླར་ལོག་༄༦༦བ་ནས་ལྷ༏་ཁྱོད་ཀྱིས་བཀའ་སྩལ་པ་བཞིན་ནོ་༎ ཞེས་རྒྱས་པར་བརྗོད་དོ་༎
 samanantarodite tasmin vacanaparyavasāne mahāsatvas taṃ nārakaṃ śarīraṃ vijahya trāyastriṃśeṣu deveṣūpapannaḥ |	དེ་སྐད་ཅེས་སྨྲས་མ་ཐག་ཏུ་ཆིག་དེ་སྨྲས་པའི་ཐ་མ་ལ་སེམས་ཅན་ཆེན་པོ་དེ་སེམས་ཅན་དམྱལ་བའི་ལུས་དེ་བོར་ནས་སུམ་ཅུ་རྩ་གསུམ་པའི་ལྷ་རྣམས་ཀྱི་ནང་དུ་སྐྱེས་སོ་༎
 tena hetunā pratisarāpūrvīdevaputra ity ucyate |	རྒྱུ་དེས་ན་སྔོན་སོ་སོར་འབྲང་བའི་ལྷའི་བུ་ཞེས་བྱའོ་༎ བྲམ་ཟེ་ཆེན་པོ་། དེས་ན་སྔོན་ཆད་ཡོངས་སུ་ཤེས་སོ་༎
 tena hi mahābrāhmaṇa parijñātavatī pūrvatas tasmād eveyaṃ mahāpratisarā dhārayitavyā vācayitavyā likhitavyā yathāvidhinā nityaṃ śarīragatāṃ kṛtvā dhārayitavyā |	དེའི་ཕྱིར་སོ་སོར་འབྲང་བ་ཆེན་མོ་འདི་གདོན་མི་ཟ་བར་གཟུང་བར་བྱའོ་༎ ཡི་གེར་བྲི་བར་བྱ་། བཀླག་པར་བྱའོ་༎ ཆོ་ག་བཞིན་དུ་རྟག་ཏུ་ལུས་ལ་བཏགས་ནས་བཅད་བར་བྱ་སྟེ་།
 sa nityaṃ sarvavyasanaduḥkhebhyaḥ parimucyate |	དེ་རྟག་ཏུ་སྡུག་བསྔལ་ཞིང་ཉམ་ཐག་པ་ཐམས་ཅད་ལས་ཡོངས་སུ་ཐར་པར་འགྱུར་།
 sarvadurgatibhayabhairavebhya uttarati |	ངན་འགྲོའི་འཇིགས་སྐྲག་པ་ཐམས་ཅད་ལས་རྒལ་བར་འགྱུར་རོ་༎
 na vidyutā śakyaṃ pātayitum |	གློག་གིས་འགྱེལ་བར་བྱེད་མི་ནུས་སོ་༎ གློག་གིས་ཇི་ལྟར་མི་ནུས་ཤེ་ན་། བྲམ་ཟེ་ཆེན་པོ་།
 kim iti vidyutā parijñātam ||	སྔོན་ཡོངས་སུ་ཤེས་ཏེ་།
 pūrvaṃ mahābrāhmaṇa hiṅgumardane mahānagare vimalaśaṅkho nāma śreṣṭhī mahādhanakanakasamṛddhaḥ paripūrṇakośakośāgārasaṃpanno babhūva |	གྲོང་ཁྱེར་ཆེན་པོའི་མཆོག་ཤིང་ཀུན་རྫི་བ་ན་ཚོང་དཔོན་ཆེན་པོ་དྲི་མེད་དུང་ཞེས་བྱ་བ་། ནོར་མང་བ་། གསེར་ཤིན་ཏུ་འབྱོར་བ་། མཛོད་དང་བང་བ་ཀུན་ཏུ་གང་ཞིང་ཕུན་སུམ་ཚོགས་པ་ཞིག་གནས་ཏེ་།
 sa mahāsārthavāha iti khyātavān |	དེད་དཔོན་ཞེས་བྱ་བར་གྲགས་སོ་༎
 atha sa mahāsārthavāho yānapātram āsādya mahāsamudram avatīrṇaḥ |	དེ་ནས་དེད་དཔོན་ཆེན་པོ་དེས་གྲུ་བོ་ཆེ་དེ་རྙེད་ནས་རྒྱ་མཚོ་ཆེན་པོར་ཞུགས་པ་དང་། ཉ་མིད་རྣམས་ཀྱིས་དེའི་གྲུ་དེ་བཟུང་ནས་རྣམ་པར་༄༦༧ཨ་༌༎
 (mp_16) yāvat timiṅgilaiḥ so 'sya poto 'vastabdhaḥ vināśayitukāmā nāgāś ca saṃkṣubdhā mahāntagarjanā sphoṭaṃ kurvanti |	གཞིག་པར་འདོད་པའི་ཀླུ་རྣམས་ཀྱང་འཁྲུགས་ཏེ་འབྲུག་སྒྲ་ཆེན་པོ་སྒྲོག་གོ་།
 vidyudulkām utsṛjanti vajrāśaniṃ pravarṣitum ārabdhāḥ |	གློག་དང་སྐར་མདའ་ཡང་གཏོང་ངོ་༎ རྡོ་རྗེའི་ལྕེ་འབེབས་པར་ཡང་བཤམས་སོ་༎
 tatas te vaṇijo mahatā duḥkhenābhyāhatacittās taṃ mahāntaṃ nāgasaṃkṣobhaṃ vidyudulkāṃ	དེ་ནས་ཚོང་པ་དེ་དག་སྡུག་བསྔལ་ཆེན་པོས་སེམས་ནོན་ཏོ་༎
 vajrāśaniṃ cotsṛjanti taiś ca timiṅgilaiḥ potam avastabdhaṃ dṛṣṭvā mahāntaṃ utkrośanaṃ	ཀླུ་འཁྲུགས་པ་ཆེན་པོ་དེ་དང་། གློག་དང་། སྐར་མདའ་དང་། རྡོ་རྗེའི་ལྕེ་འབེབས་པ་དང་། ཉ་མིད་དེ་དག་གིས་ཀྱང་གྲུ་བོ་ཆེ་བཟུང་བར་མཐོང་ནས་ཀུ་ཅོའི་སྒྲ་ཆེན་པོ་བཏོན་ཏོ་༎ དེ་དག་ལྷ་ཁྱད་པར་ཅན་རྣམས་ལ་གསོལ་བ་བཏབ་ཀྱང་འགའ་ཙམ་ཡང་དེ་དག་གི་དཔུང་གཉེན་དུ་མ་གྱུར་ཏོ་༎
 śabdaṃ kartum ārabdhaḥ | te viśeṣair nāyācayanti | tatas te sārthavāhasyopagamya karuṇam idaṃ vacanam abruvan |	དེ་ནས་དེ་དག་ཚོང་དཔོན་སེམས་རབ་ཏུ་བརྟན་པའི་གན་དུ་སོང་ནས་དེ་དག་གིས་སྙིང་རྗེ་རྗེ་སྐད་དུ་ཚིག་འདི་སྐད་སྨྲས་སོ་༎
 paritrāyasva tvaṃ mahāsatva mocayāsmān mahābhayāt | atha khalu mahāsārthavāho dṛḍhacitto mahāmatiḥ vaṇijo viklavībhūtān idaṃ vacanam abruvat |	སེམས་ཅན་ཆེན་པོ་ཁྱོད་ཀྱིས་བདག་ཅག་བསྐྱབ་ཅིང་འཇིགས་པ་ཆེན་པོ་ལས་ཐར་པར་མཛད་དུ་གསོལ་། དེ་ནས་དེད་དཔོན་ཆེན་པོ་སེམས་བརྟན་པ་བློ་གྲོས་ཆེན་པོ་དེས་ཚོང་པ་འཁྲུགས་པར་གྱུར་པ་རྣམས་ལ་ཚིག་འདི་སྐད་སྨྲས་སོ་༎ མ་འཇིགས་མ་འཇིགས་ཚོང་བ་རྣམས་༎
 mā bhair mā bhair vaṇijo bhavanto vīratāṃ vrajata |	ཁྱེད་ཅག་བརྟན་པར་དེངས་ཤིག་དང་༎ ཁྱེད་རྣམས་སྡུག་བསྔལ་ཆེན་པོ་ཡི་༎
 ahaṃ vo mocayiṣyāmy ato duḥkhamahārṇavāt |	རྒྱ་མཚོ་ཆེ་ལས་ངས་བསྒྲལ་ལོ་༎
 tata vīramānaso bhūtā vaṇija idaṃ vacanam abruvan |	དེ་ནས་ཡིད་ནི་བརྟན་གྱུར་ནས་༎ ཚོང་པ་རྣམས་ཀྱིས་ཚིག་འདི་སྨྲས་༎ སེམས་ཅན་ཆེན་པོ་འདི་ཅི་ལགས་༎
 kim etat tena mahāsatva brūhi śīghram avighnataḥ |	བགེགས་༄༦༧བ་བྲལ་མྱུར་དུ་བཀའ་སྩོལ་ཅིག་།
 yāvad jīvitam asmākaṃ tvat prabhāvād mahāmate kathyatāṃ jñānamahātmyaṃ paścāt kiṃ kariṣyasi |	བློ་གྲོས་ཆེན་པོ་ཁྱོད་ཀྱི་མཐུས་༎ བདག་ཅག་ཇི་སྲིད་འཚོ་བའི་ཚེ་༎ ཡེ་ཤེས་ཆེ་བའི་བདག་ཉིད་གསུངས་༎ སླད་ན་ཁྱོད་ཀྱིས་ཅི་ཞིག་བགྱི་༎
 tataḥ sārthapatis teṣām imāṃ vidyām udāharat |	དེ་ནས་མགྲོན་མང་བདག་པོ་ཡིས་༎ དེ་དག་ལ་ནི་ཚིག་འདི་བརྗོད་༎ དེ་ལ་སོ་སོར་འབྲང་བ་ཡི་༎
 asti mama mahāvidyā pratisarā nāma viśrutā ||	རིག་པ་ཆེན་མོར་གྲགས་པ་ཡོད་༎ གནོད་བྱེད་ཐམས་ཅད་སེལ་བར་བྱེད་༎
 mardanī sarvabuddhānāṃ mahābalaparākramāḥ |	སྟོབས་ཆེན་ཕ་རོལ་གནོན་བྱེད་པ་༎
 tenāhaṃ mocayiṣyāmi ato duḥkhamahārṇavāt ||	དེས་ནི་རབ་ཏུ་སྡུག་བསྔལ་བའི་༎ འཇིགས་པ་ཆེ་ལས་ངས་བསྒྲལ་ལོ་༎
 tataḥ mahāsārthavāhas tasyāṃ velāyām imāṃ mahāpratisarāṃ mahāvidyārājñīṃ likhitvā dhvajāgrāvaropitāṃ karoti sma | samanantaraṃ dhvajāgrāvaropitāyām asyāṃ mahāpratisarāyāṃ mahāvidyārājñyāṃ sarva eva te timiṅgilās taṃ potam ekajvālībhūtaṃ paśyanti |	དེ་ནས་དེད་དཔོན་ཆེན་པོས་དེའི་ཚེ་རིག་པའི་རྒྱལ་མོ་འདི་བྲིས་ནས་རྒྱལ་མཚན་གྱི་རྩེ་མོ་ལ་བཏགས་པ་དང་། རིག་པའི་རྒྱལ་མོ་ཆེན་མོ་སོ་སོར་འབྲང་བ་ཆེན་མོ་རྒྱལ་མཚན་གྱི་རྩེ་མོ་ལ་བཏགས་མ་ཐག་ཏུ་ཉ་མིད་དེ་དག་ཐམས་ཅད་ཀྱིས་གྲུ་བོ་ཆེ་དེ་མེ་ལྕེ་གཅིག་ཏུ་གྱུར་པ་མཐོང་ངོ་༎ 
 tatas te nāgā maitramanasas teṣām antike 'vatīrya pūjāṃ kartum ārabdhāḥ |	དེ་ནས་ཀླུ་དེ་དག་བྱམས་པའི་ཡིད་ཀྱིས་དེ་དག་གི་དྲུང་དུ་ལྷགས་ནས་མཆོད་པ་བྱ་བར་བཤམས་སོ་༎ ཉ་མིད་དེ་དག་ཀྱང་རིག་པའི་རྒྱལ་པོ་སོ་སོར་འབྲང་བ་ཆེན་མོ་འདི་ཉིད་ཀྱི་མཐུས་ཚིག་ནས་བྱེར་ཏེ་ཞི་བར་གྱུར་ཏོ་༎
 te ca timiṅgilā asyā mahāpratisarāyā mahāvidyārājñyā anubhāvena dahyamānāḥ | prapalāyitvā vilapaṃ gatāḥ | sārthikās tair mahānāgair mahati mahāratnadvīpe prāpitā iti ||	མགྲོན་པོ་ཕལ་པོ་ཆེ་དེ་དག་ཀྱང་ཀླུ་ཆེན་པོ་དེ་དག་གིས་རིན་པོ་ཆེའི་གླིང་ཆེན་པོར་ཕྱིན་པར་བྱས་སོ༏་༏དེ་ལྟར་ན་ཡེ་ཤེས་དང་ལྡན་པ་རིག་པ་ཆེན་མོ་སོ་སོར་འབྲང་བ་ཆེན་མོ་ནི་། 
 jñātavatīyaṃ mahāvidyā mahāpratisarā sarvatathāgatādhiṣṭhitā tena hetunā mahābrāhmaṇa mahāvidyeti khyātā |	དེ་བཞིན་གཤེགས་པ་ཐམས་ཅད་ཀྱིས་བྱིན་གྱིས་བརླབས་པ་སྟེ་། བྲམ་ཟེ་ཆེན་པོ་། ༄༦༨ཨ་༌༎ རྒྱུ་དེས་ན་འདི་རིག་པ་ཆེན་མོ་ཞེས་གྲགས་སོ་༎
 tasmād avaśyam (mp_17)	འདི་ནི་།
 eveyaṃ dhvajāgrāvaropitaṃ kṛtvā dhārayitavyā |	ངེས་པར་རྒྱལ་མཚན་གྱི་རྩེ་མོ་ལ་བཏགས་ཏེ་བཅད་བར་བྱའོ་༎
 sarvavātaśītākālameghavidyudaśanīṃ praśamayati |	རླུང་དང་། གྲང་བ་དང་། དུས་མ་ཡིན་པའི་སྤྲིན་དང་། གློག་དང་། ལྕེ་འབབ་པ་ཐམས་ཅད་རབ་ཏུ་ཞི་བར་བྱེད་དེ་།
 sarvadevamanuṣyāmanuṣyavigrahavivādeṣu parimocayati |	ལྷ་དང་། མི་དང་། ལྷ་མ་ཡིན་གྱི་འཐབ་པ་དང་། རྩོད་པ་ལས་ཡོངས་སུ་ཐར་པར་བྱེད་དོ་༎
 sarvadaṃṣṭramaśakaśarabhakaprāṇakajātā vividharūpāḥ | sasyavināśakā na prabhavanti | praśamaṃ gacchanti |	སྦྲང་བུ་མཆུ་རིང་དང་། ཤ་སྦྲང་དང་། བྱི་བ་དང་། སྲོག་ཆགས་ཀྱི་རིགས་གཟུགས་རྣམ་པ་སྣ་ཚོགས་ལོ་ཏོག་མ་རུང་བར་བྱེད་པ་ཐམས་ཅད་མཐུ་མེད་ཅིང་རབ་ཏུ་ཞི་བར་འགྱུར་རོ་༎
 sarvaduṣṭacittā mṛgapakṣidaṃṣṭriṇo vinaśyanti |	རི་དབ༹གས་དང་། བྱ་དང་། གཅན་གཟན་གནོད་པར་སེམས་པ་ཐམས་ཅད་རྣམ་པར་འཇིགས་པར་འགྱུར་རོ་༎
 sarvāṇi ca puṣpaphalapattravanaspatyoṣadhisasyādīny abhivardhante | arasāni svādūni mṛdūni ca bhaviṣyanti |	མེ་ཏོག་དང་། འབྲས་བུ་དང་། ལོ་མ་དང་། ནགས་ཚལ་དང་། སྨན་དང་། ལོ་ཏོག་ལ་སོགས་པ་ཐམས་ཅད་འཕེལ་བར་འགྱུར་ཏེ་།
 samyag eva paripācitāni bhaviṣyanti |	རབ་ཏུ་བྲོ་ཞིང་ཞིམ་པ་དང་། འཇམ་པར་འགྱུར་རོ༏་༏ལེགས་པར་ཡོངས་སུ་སྨིན་པར་འགྱུར་རོ་༎
 ativṛṣṭyenāvṛṣṭidoṣāḥ sarveṇa sarvaṃ na bhaviṣyanti |	ཧ་ཅང་ཆར་ཆེ་བ་དང་། ཆར་དཀོན་པའི་ཉེས་པ་རྣམས་ཡོངས་སུ་མི་འབྱུང་ངོ་༎ ཆར་དུས་སུ་འབབ་ཅིང་།
 kālavṛṣṭir bhaviṣyanti nākālavṛṣṭiḥ |	དུས་མ་ཡིན་པར་མི་འབབ་པར་འགྱུར་རོ་༎
 ye ca tasmin viṣaye mahānāgās te samyag eva kālena kālaṃ varṣadhārām utsṛjanti |	ཡུལ་དེའི་ཀླུ་ཆེན་པོ་གང་ཡིན་པ་དེ་དག་ཀྱང་དུས་དུས་སུ་ཆར་གྱི་རྒྱུན་ལེགས་པར་འབེབས་སོ་༎ 
 yasmin viṣaye iyaṃ vidyārājñī mahāpratisarā nāma pracariṣyati |	ཡུལ་གང་ན་རིག་པའི་༄༦༨བ་རྒྱལ་མོ་སོ་སོར་འབྲང་མ་ཆེན་མོ་ཞེས་བྱ་བ་འདི་སྤྱོད་པའི་ཡུལ་དེར་སེམས་ཅན་དེ་དག་གིས་ཤེས་སོ་༎ 
 tatra taiḥ satvair jñātvā pūjāsatkāraṃ kṛtvā nānāgandhair nānāpuṣpair nānāvastraiḥ	པར་བྱ་སྟེ་། སྤོས་སྣ་ཚོགས་དང་། བདུག་པ་སྣ་ཚོགས་དང་། མེ་ཏོག་སྣ་ཚོགས་ཀྱིས་མཆོད་ཅིང་བསྟི་སྟང་བྱས་ལ་།
 pariveṣayitvā caityasyopari dhvajāgrāvaropayitāṃ kṛtvā nānāvādyatūryasaṃgītibhir	ཚོན་སྣ་ཚོགས་ཀྱིས་དཀྲིས་ཏེ་རྒྱལ་མཚན་གྱི་རྩེ་མོ་ལ་བཏགས་ནས་གླུ་དབྱངས་དང་། རོལ་མོ་སིལ་སྙན་བྱས་ཏེ་།
 vādyamānābhiḥ pradakṣiṇīkartavyā | tatas teṣāṃ mahāsatvānāṃ yathā ciñcitam āśāṃ paripūrayiṣyanti | devatāḥ śakrabrahmaprabhṛtayaḥ |	བསྐོར་བ་བྱས་ནས་ལྷ་རྣམས་དང་། བརྒྱ་བྱིན་དང་། ཚངས་པ་ལ་སོགས་པའི་སེམས་ཅན་ཆེན་པོ་དེ་དག་གིས་བསམ་པ་ཇི་ལྟ་བ་བཞིན་དུ་རེ་བ་ཡོངས་སུ་རྫོགས་པར་བྱེད་པར་འགྱུར་རོ་༎
 athavā yathāyathāvidhinā likhyate tathātathā samṛdhyate |	ཆོ་ག་ཇི་ལྟ་བ་བཞིན་དུ་དེ་ལྟ་དེ་ལྟ་བུར་འགྲུབ་སྟེ་། བུ་ཕོ་འདོད་ནའང་ཁྱེའུར་འགྲུབ་༎ མངལ་ན་འཛིན་པ་དམ་པར་འགྱུར་༎
 putrārthī labhate garbhasaṃdhāraṇī parāḥ sukhena vardhate garbhaḥ sukhenaiva prasūyate |	མངལ་ན་བདེ་བར་སྐྱེ་བ་དང་༎ མངལ་ནས་བདེ་བར་བཙའ་བར་འགྱུར་༎
 kālena vardhate garbhaḥ kālena parimucyate |	མངལ་ན་དུས་བཞིན་སྐྱེ་བ་དང་༎ དུས་བཞིན་རབ་ཏུ་བཙའ་བར་འགྱུར་༎
 kim iti mahābrāhmaṇa pūrvavac chrūyatām ||	ཅིས་མངོན་ཞེ་ན་། བྲམ་ཟེ་ཆེན་པོ་། སྔ་མ་བཞིན་དུ་དེ་ཉོན་ཅིག་།
 ihaiva magadhaviṣaye rājā prasāritapāṇir nāma sa cāputrako 'bhūva | kim iti prasāritapāṇir iti khyātān |	ཡུལ་མ་ག་དྷ་འདི་ཉིད་ན་རྒྱལ་པོ་ལག་བརྐྱང་ཞེས་བྱ་བ་དེ་བུ་མེད་པར་གྱུར་ཏོ་༎ ཅིའི་ཕྱིར་ལག་བརྐྱང་ཞེས་བྱ་ཞེས་ན་།
 tena rājñā jātamātreṇa pāṇiṃ prasārya mātuḥ stanau gṛhītvā yāvad āptaṃ kṣīraṃ pītam |	རྒྱལ་པོ་དེ་བཙས་མ་ཐག་ཏུ་ལག་པ་བརྐྱངས་ནས་མའི་ནུ་ཞོ་ལ་བཟུང་སྟེ་། ནུ་ཞོ་ངོམས་ངོམས་སུ་འཐུངས་སོ་༎
 tau ca stanau saha sparśamātreṇa suvarṇavarṇau saṃvṛttau | nityakālaṃ ca mahatā kṣīreṇa pravardhataḥ |	ནུ་མ་དེ་གཉིས་ལ་རེག་མ་ཐག་ཏུ་གསེར་གྱི་ཁ་དོག་ཏུ་གྱུར་ཏེ་། དུས་ཀུན་ཏུ་ནུ་ཞོ་འཕེལ་བར་གྱུར་༄༦༩ཨ་༌༎
 tena kāraṇena tasya rājñaḥ prasāritapāṇir iti nāma sthāpitam |	ཏོ༏་༏རྒྱུ་དེས་ན་རྒྱལ་པོ་ལག་བརྐྱང་ཞེས་བྱ་བར་བཏགས་པར་གྱུར་ཏོ་༎
 anyac ca tasya rājñaḥ yācanakajanā āgacchanti |	གཞན་ཡང་གང་གི་ཚེ་རྒྱལ་པོའི་གན་དུ་སྐྱེ་བོ་སློང་མོ་བ་འོངས་པ་དེའི་ཚེ་།
 tadā sa rājā dakṣiṇapāṇiṃ prasārayaty upary antarikṣe bodhisatvaḥ sa rājā tena hetunā tasya buddhābhiprasannā devatā divyai ratnaviśeṣaiḥ suvarṇamaṇibhiś ca pāṇiṃ paripūrayanti |	རྒྱལ་པོ་དེ་ལག་བ་ག-ཡས་པ་བར་སྣང་ལ་བརྐྱང་བ་དང་། རྒྱལ་པོ་བྱང་ཆུབ་སེམས་དཔའ་དེ་རྒྱུ་དེས་སངས་རྒྱས་ལ་མངོན་པར་དད་པའི་ལྷ་རྣམས་ཀྱིས་ལྷའི་རིན་པོ་ཆེ་ཁྱད་པར་དུ་འཕགས་པ་གསེར་དང་། ནོར་བུ་རྣམས་ཀྱིས་ལག་པ་གང་བར་བྱེད་དོ་༎
 tadā sa rājā tebhyo yācanakajanebhyo (mp_18)	རྒྱལ་པོ་དེས་ཀྱང་སྐྱེ་བོ་སློང་མོ་པ་ལྷགས་པ་རྣམས་ལ་རབ་ཏུ་བྱིན་ནོ་༎
 'nuprayacchanti | yathā cintamātreṇa sarvayācanakajanānāṃ sarvasukhasaṃpattikāmāṃ dadāti |	བསམ་པ་ཙམ་གྱིས་སློང་མོ་པ་ཐམས་ཅད་ལ་འདོད་པ་བཞིན་དུ་བདེ་བ་ཕུན་སུམ་ཚོགས་པ་ཐམས་ཅད་བྱིན་ཏོ་༎
 devānāṃ ca mahānti pūjāsatkārāṇi karoti putrahetor na ca putraṃ pratilabhate | sa paurāṇāṃ tathāgatacaityānāṃ purataḥ pūjāsatkāraṃ kartum ārabdhaḥ |	བུ་ཕོ་འདོད་པའི་ཕྱིར་ལྷ་རྣམས་ལ་མཆོད་པ་དང་། བསྟི་སྟང་ཆེར་བྱས་ཀྱང་བུ་ཕོ་མ་རྙེད་ནས་དེ་སྔོན་གྱི་དེ་བཞིན་གཤེགས་པ་དག་གི་མཆོད་རྟེན་རྣམས་ཀྱི་མདུན་དུ་བསྟི་སྟང་བྱ་བར་བརྩམས་ཏེ་། 
 mahānti ca pūjāsatkārāṇi karoti dānāni ca dadāti |	མཆོད་པ་དང་། བསྟི་སྟང་ཆེན་པོ་བྱས་སོ་༎ སྦྱིན་པ་ཆེན་པོ་བྱིན་ཏོ་༎
 upavāsam upavasati |	བསྙེན་གནས་ལ་ཡང་ཉེ་བར་གནས་སོ་༎
 mahānti ca puṇyāni ca karoti |	བསོད་ནམས་ཆེན་པོ་བྱས་སོ་༎ སྦྱིན་པ་ཆེན་པོ་དེ་དག་ཀྱང་མི་ཟད་པར་བྱིན་ཏོ༏་༏དེ་ཅིའི་ཕྱིར་ཞེ་ན་། བྲམ་ཟེ་ཆེན་པོ་།
 akṣiṇāny eva dānāni dadāti | tat kasya hetor bhūtapūrvaṃ mahābrāhmaṇa asminn eva magadhaviṣaye mallā nāma janapade kuśinagare mahāpaṭṭanavare bhagavataḥ prabhūtaratnasya tathāgatasya śāsane samutpanno	སྔོན་བྱུང་བ་ཡུལ་མ་ག་དྷ་འདི་ཉིད་ན་གྱད་ཡུལ་ཞེས་བྱ་བའི་གྲོང་ཁྱེར་ཀུ་ཤའི་ཚོང་དུས་ཆེན་པོའི་མཆོག་ན་བཅོམ་༄༦༩བ་ལྡན་འདས་རིན་ཆེན་མང་གི་བསྟན་པ་ལ་ཞུགས་པ་།
 dharmacittakaḥ kaścid mahāsatvo dharmamatir nāma śreṣṭhī prativasati | sa sarvasatvānām antike mahākaruṇācittam upasthāpya imām eva mahāvidyāṃ mahāpratisarām ārabhya dharmaṃ deśayati sma | atha kaścid eko daridrapuruṣas taṃ dharmaṃ śrutvā tasya śreṣṭhina idaṃ vacanam abruvat |	ཚོང་དཔོན་ཆོས་ཀྱི་བློ་གྲོས་ཞེས་བྱ་བ་ཆོས་སེམས་པའི་སེམས་ཅན་ཆེན་པོ་ཞིག་གནས་པ་དེ་སེམས་ཅན་ཐམས་ཅད་ལ་སྙིང་རྗེ་ཆེན་པོའི་སེམས་ཉེ་བར་བཞག་ནས་རིག་པ་ཆེན་མོ་སོ་སོར་འབྲང་མ་འདི་ཉིད་ལས་བརྩམས་ཏེ་ཆོས་སྟོན་ཏོ་༎ དེ་ནས་མི་དབུལ་པོ་ཞིག་གིས་ཆོས་དེ་ཐོས་ནས་ཚོང་དཔོན་ཆེན་པོ་དེ་ལ་ཚིག་འདི་སྐད་ཅེས་བདག་ཇོ་བོའི་ཁབ་ཏུ་གླ་བགྱིའོ་༎
 aham āryasya niveśane bhṛtikarmaṃ kariṣyāmi dharmaṃ ca śroṣyāmi | yadā mama kiṃcid bhaviṣyati tadāhaṃ dharmaṃ pūjayiṣyāmi |	ཆོས་ཀྱང་ཉན་ནོ་༎ གང་གི་ཚེ་བདག་གིས་ཅུང་ཟད་རྙེད་པར་གྱུར་པ་དེའི་ཚེ་བདག་ཆོས་ལ་མཆོད་པ་བགྱིད་དོ་ཞེས་སྨྲས་ནས་དེའི་ཁྱིམ་ན་ལས་བྱེད་ཅིང་ཆོས་ཀྱང་ཉན་ཏོ་༎ 
 tasya gṛhavyāpāraṃ kurvato dharmaṃ ca śṛṇvato yāvad apareṇa kālasamayena śreṣṭhinā eko dīnāro dattaḥ |	དུས་གཞན་ཞིག་ན་དེ་ལ་ཚོང་དཔོན་དེས་དི་ན་ར་གཅིག་བྱིན་པ་དང་ཀྱང་ཉན་ཏོ་༎ 
 sa tena sarvasatvaparitrāṇārthaṃ bodhicittam utpādya sādhāṛaṃ kṛtvā mahāpratisarāratneti niryātitā | evaṃ praṇidhānaṃ kṛtam anena mahāphalena mama sarvasatvānāṃ ca dāridraduḥkhasaṃcchedaḥ syāt |	། དེས་སེམས་ཅན་ཐམས་ཅད་ཡོངས་སུ་བསྐྱབ་པའི་ཕྱིར་བྱང་ཆུབ་ཀྱི་སེམས་བསྐྱེད་ནས་སེམས་ཅན་ཐམས་ཅད་དང་ཐུན་མོང་དུ་བྱས་ནས་རིན་པོ་ཆེ་སྙིམ་པས་སོ་སོར་འབྲང་མ་ཆེན་མོ་ལ་ཕུལ་ནས་སྦྱིན་པའི་འབྲས་བུ་ཆེན་པོ་འདིས་བདག་དང་སེམས་ཅན་ཐམས་ཅད་ཀྱི་དབུལ་བ་ཀུན་ཏུ་གཅོད་པར་གྱུར་ཅིག་ཅེས་སྨོན་ལམ་དེ་སྐད་ཀྱང་བཏབ་བོ་༎
 anena kāraṇena tad dānaṃ parīkṣayaṃ na gacchati |	རྒྱུ་དེས་ན་སྦྱིན་པ་དེ་ཡོངས་སུ་མི་ཟད་པར་གྱུར་ཏོ་༎
 evaṃ bahuvidhānekavidhapuṇyābhisaṃskārakṛto devatāś ca pūjitā yāvad buddhā bhagavantaḥ pūjitās tadā ca śuddhāvāsakāyikābhir devatābhiḥ svapne darśanaṃ dattam |	དེ་ལྟར་བསོད་ནམས་མངོན་པར་འདུ་བྱ་བ་རྣམ་པ་མང་པོ་རྣམ་པ་དུ་མ་བྱས་ཏེ་ལྷ་རྣམས་ཀྱང་མཆོད་པ་ནས་སངས་༄༧༠ཨ་༌༎ རྒྱས་བཅོམ་ལྡན་འདས་ཀྱི་བར་དུ་མཆོད་པ་དང་། དེའི་ཚེ་གནས་གཙང་མའི་རིས་ཀྱི་ལྷ་རྣམས་ཀྱིས་རྨི་ལྟས་སུ་བསྟན་ཏེ་འདི་སྐད་དུ་ཀྱེ་རྒྱལ་པོ་ཆེན་པོ་། 
 evaṃ cābhihitaṃ bho mahārāja samantajvālāmālāviśuddhisphūritacintāmaṇir mahāmudrāhṛdayāparājitā	སོ་སོར་འབྲང་མ་ཆེན་མོ་ཞེས་བྱ་བ་ཀུན་ནས་མེ་ལྕེའི་ཕྲེང་བ་རྣམ་པར་དག་པས་རྒྱས་པ་ཡིད་བཞིན་གྱི་ནོར་བུའི་པོ་ཆེན་པོ་། ཕྱག་རྒྱ་དང་། 
 mahādhāraṇī mahāvidyārājñī mahāpratisarā nāma taṃ yathāvidhinā kalpenābhihitena upavāsoṣitāyā	སྙིང་པོ་གཞན་གྱིས་མི་ཐུབ་པའི་གཟུངས་ཆེན་མོ་རིག་པའི་རྒྱལ་མོ་ཆོ་ག་ལས་ཇི་སྐད་འབྱུང་བ་བཞིན་པོ་ཆེན་པོ་། ཕྱག་རྒྱ་དང་། དུ་བྲིས་ལ་། 
 agramahiṣyā devyāḥ śarīre baddhā tatas te putrapratilambho bhaviṣyatīti | atha sa rājā prativiśuddhas tasyām eva rātryām atyayena saṃkhyālipinakṣatragrahavipañcakān kulabrāhmaṇān saṃnipātya yathāvidhinā (mp_19) kalpopadiṣṭena puṣye nakṣatrarāje pratipanne susnātagātrāyā upavāsoṣitāyā agramahiṣyā devyā yathāvidhinā likhyemāṃ mahāpratisarāṃ mahāvidyārājñīṃ kaṇṭhe baddhavān |	བཙུན་མོ་དམ་པ་སྨྱུང་བ་བྱས་ལ་ཆོ་ག་བཞིན་དུ་ལུས་ལ་བཏགས་ན་ཁྱོད་བུ་ཕོ་ཡོད་པར་འགྱུར་རོ་ཞེས་བསྒོའོ༏་༏དེ་ནས་རྒྱལ་པོ་སད་དེ་མཚན་མོ་ཟད་ནས་རྩིས་དང་། ཡི་གེའི་འབྲུ་དང་། རྒྱུ་སྐར་དང་། གཟའ་རྣམ་པར་འབྱེད་པའི་བྲམ་ཟེ་རྣམས་བསགས་ནས་ཆོ་ག་ལས་འབྱུང་བ་བཞིན་དུ་རྒྱུ་སྐར་གྱི་རྒྱལ་པོ་རྒྱལ་གྱི་ཉིན་པར་བཙུན་མོ་དམ་པ་ལུས་ཤིན་ཏུ་ལེགས་པར་བཀྲུས་ཏེ་སྨྱུང་བ་བྱས་ནས་རིག་པའི་རྒྱལ་མོ་ཆེན་མོ་འདི་ཡང་ཆོ་ག་བཞིན་དུ་བྲིས་ཏེ་བཙུན་མོ་དམ་པའི་མགུལ་དུ་བཏགས་སོ་༎ 
 mahatīṃ mahābuddhacaityeṣu pūjām akarṣīd anekāni ca ratnaviśeṣāṇi satvānāṃ dānāni dattāni |	སངས་རྒྱས་ཀྱི་མཆོད་རྟེན་རྣམས་ལ་མཆོད་པ་ཆེན་པོ་བྱས་སོ་༎ རིན་པོ་ཆེ་ཁྱད་པར་ཅན་དུ་མ་ཡང་སེམས་ཅན་རྣམས་ལ་སྦྱིན་པ་བྱིན་ནོ་༎
 tato navānāṃ māsānām abhyayāt putro jāto 'bhirūpaḥ prāsādiko darśanīyaḥ |	དེ་ནས་ཟླ་བ་དགུ་ལོན་པ་དང་། བུ་ཕོ་གཟུགས་བཟང་བ་། མཛེས་པ་། བལྟ་ན་སྡུག་པ་། ཁ་དོག་བཟང་པེ་།
 paramayā śubhavarṇapuṣkalatayā samanvāgata iti ||	རྒྱས་པ་༄༧༠བ་མཆོག་དང་ལྡན་པ་ཞིག་བཙས་སོ་༎ བྲམ་ཟེ་ཆེན་པོ་།
 tato jñātvā mahābrāhmaṇa sarvakāmaṃgamā aparājitā mahāpratisarāratneti viśrutā mahāvidyārājñī sarvatathāgatapujitā śakrasyāpīyaṃ cūḍāmaṇiḥ sarvathā	དེ་ལྟར་ཤེས་ནས་རིག་པའི་རྒྱལ་མོ་ཆེན་མོ་དེ་བཞིན་གཤེགས་པ་ཐམས་ཅད་ཀྱིས་མཆོད་པ་། འདོད་པ་ཐམས་ཅད་དུ་འགྲོ་བ་གཞན་གྱིས་མི་ཐུབ་པ་སོ་སོར་འབྲང་མ་ཆེན་མོ་དཀོན་མཆོག་ཅེས་གྲགས་སོ་༎ འདི་ནི་། རྟག་ཏུ་བརྒྱ་བྱིན་གྱི་གཙུག་གི་ནོར་བུ་ཡིན་ནོ་༎
 yadā śakro devānām indro mahāsaṃgrāmam asuraiḥ sārdhaṃ kartukāmas tadā imāṃ mahāvidyāṃ kavacaṃ kṛtvā saṃgrāmamadhye 'vatīrya cūḍāyām avasthāpya sarvāsurān nirjitya sukhaṃ svastinā kṣemeṇa devapuraṃ praviśati |	གང་གི་ཚེ་ལྷའི་དབང་པོ་བརྒྱ་བྱིན་ལྷ་མ་ཡིན་རྣམས་དང་། ག-ཡུལ་ཆེན་པོ་འགྱེད་པར་འདོད་པ་དེའི་ཚེ་འདི་ཉིད་ཀྱིས་གོ་ཆ་བྱས་ནས་སྤྱི་གཙུག་ཏུ་བཏགས་ཏེ་ལྷ་མ་ཡིན་ཐམས་ཅད་ཕམ་པར་བྱས༏་ཕ་རོལ་ཕམ་པར་བྱས་ནས་དགེ་བ་དང་བདེ་བས་བདེ་བར་ལྷའི་གྲོང་ཁྱེར་དུ་འཇུག་སྟེ་།
 sarvāsurair adhṛṣyo bhaviṣyati |	ལྷ་མ་ཡིན་ཐམས་ཅད་ཀྱིས་མི་ཚུགས་པ་ཡིན་ནོ་༎ བྲམ་ཟེ་ཆེན་པོ་།
 evaṃ hi mahābrāhmaṇa prathamacittotpādam upādāya boddhisatvasya mahāsatvasyemāṃ mahāpratisarāṃ mahāvidyārājñīṃ dhārayataḥ sarvamārair anavamṛdyatā bhavati |	དེ་ལྟར་ན་སེམས་དང་པོ་བསྐྱེད་པ་ནས་བཟུང་སྟེ་རིག་པའི་རྒྱལ་མོ་སོ་སོར་འབྲང་མ་ཆེན་མོ་འདི་འཆང་པའི་བྱང་ཆུབ་སེམས་དཔའ་ལ་བདུད་ཐམས་ཅད་ཀྱིས་མི་ཚུགས་སོ་༎ འདི་གང་གིས་ལུས་ལ་བཏགས་སམ་།
 yasyaiṣā kaṇṭhagatā bhaviṣyati sa sarvatathāgatādhiṣṭhito bhaviṣyati |	མགུལ་དུ་བཏགས་པ་དེ་དེ་བཞིན་གཤེགས་པ་ཐམས་ཅད་ཀྱིས་བྱིན་གྱིས་བརླབས་པར་འགྱུར་རོ་༎
 sarvabuddhabodhisatvasaṃrakṣito bhaviṣyati |	དེ་ལ་བྱང་ཆུབ་སེམས་དཔའ་ཐམས་ཅད་ཡང་དག་པར་སྲུང་བར་འགྱུར་རོ་༎
 sarvadevamanuṣyāmanuṣyarājarājāmātyabrāhmaṇagṛhapatibhiś ca satatasamitaṃ vanditaḥ pūjitaḥ saṃmānito bhaviṣyati |	ལྷ་དང་། མི་དང་། རྒྱལ་པོ་དང་། རྒྱལ་པོའི་བློན་པོ་དང་། བྲམ་ཟེ་དང་། ཁྱིམ་བདག་ཐམས་ཅད་ཀྱིས་ཀྱང་རྟག་པར་རྒྱུན་དུ་ཕྱག་༄༧༡ཨ་༌༎ བྱ་ཞིང་མཆོད་པ་དང་། རིམ་གྲོ་བྱེད་པར་འགྱུར་རོ་༎
 sarvadevāsuragaruḍakinnaramahoragābhyarcitaḥ pūjito bhaviṣyati | sa mahāsatva ity uvāca |	ལྷ་དང་། ལྷ་མ་ཡིན་དང་། ནམ་མཁའ་ལྡིང་དང་། མི་འམ་ཅི་དང་། ལྟོ་འཕྱེ་ཆེན་པོས་རྗེད་ཅིང་མཆོད་པར་འགྱུར་རོ༏་༏བཅོམ་ལྡན་འདས་བདུད་ཀྱི་དཔུང་རབ་ཏུ་འཇོམས་པས་ཀྱང་དེ་ལ་སེམས་ཅན་ཆེན་པོ་ཞེས་གསུངས་སོ་༎ ནད་ཐམས་ཅད་དང་བྲལ་བར་འགྱུར་རོ་༎
 bhagavān mārabalapramardakaḥ sarvavyādhivigato bhaviṣyati | sarve 'tyupadravopasargāś cāsya praśāmyanti |	དེ་ལ་ཡམས་ཀྱི་ནད་དང་། གནོད་པ་ཐམས་ཅད་དང་། ནད་འགོ་བ་ཐམས་ཅད་རབ་ཏུ་ཞི་བར་འགྱུར་རོ་༎
 tasya mahāsatvasya sarvaśokavigamo bhaviṣyati |	སེམས་ཅན་ཆེན་པོ་དེ་མྱ་ངན་ཐམས་ཅད་དང་བྲལ་བར་འགྱུར་རོ་༎
 sarvadevatāś cāsya satatasamitaṃ rakṣāvaraṇaguptiṃ vidhāsyanti |	དེ་ལ་ལྷ་ཐམས་ཅད་ཀྱང་རྟག་པར་རྒྱུན་ཏུ་སྲུང་བ་དང་། སྐྱོབ་པ་དང་། སྤེད་པར་བྱེད་པར་འགྱུར་རོ་༎
 imāni cānena catvāry aparājitāmahāvidyāmantrapadahṛdayāni satatasamitaṃ likhitvā kāyakaṇṭhagatāni kṛtvā dhārayitavyāni |	དེས་གཞན་གྱིས་མི་ཐུབ་པའི་གསང་སྔགས་ཆེན་པོའི་སྙིང་པོ་འདི་དག་བྲིས་ཏེ་རྟག་པར་རྒྱུན་དུ་ལུས་ལ་གདགས་ཤིང་བཅང་བར་བྱ་།
 sasamitaṃ ca manasi kartavyāni |	རྟག་པར་རྒྱུན་དུ་ཡིད་ལ་བྱའོ་༎
 svādhyātavyāni bhāvayitavyāni cādhyāśayena sarvaduḥsvapnadurnimittāmaṅgalyabhāvā vinaśyanti |	ཁ་ཏོན་དུ་བྱའོ་༎ བསམ་པ་ཐག་པ་ནས་བསྒོམ་པར་བྱའོ་༎ སྡུག་བསྔལ་བ་དང་། རྨི་ལམ་ངན་པ་དང་། ལྟས་ངན་པ་དང་། བཀྲ་མི་ཤིས་པའི་དངོས་པོ་ཐམས་ཅད་རྣམ་པར་འཇོམས་པར་འགྱུར་རོ་༎
 sarvasukhasaṃpattayaś ca prādurbhaviṣyanti |	བདེ་བ་ཕུན་སུམ་ཚོགས་པ་ཐམས་ཅད་འབྱུང་བར་འགྱུར་རོ་༎ འདི་ནི་།
 (mp_20) atra mantrapadāḥ siddhāḥ sarvakarmakarāḥ śrutāḥ ||	གསང་སྔགས་གྱི་གཞི་ལས་ཐམས་ཅད་བྱེད་པ་དགེ་བ་རྣམས་གྲུབ་པའོ་༎ ཏདྱ་ཐའ་།
 tadyathā | oṃ amṛtavare vara vara pravara viśuddhe hūṃ hūṃ phaṭ phaṭ svāhā ||	ཨཨོམ་ཨཨ་མྲི་ཏེ་ཨཨ་མྲི་ཏ་བ་རེ་། བ་ར་བ་རེ་། ༄༧༡བ་པྲ་བྷ་རེ་བི་ཤུདདྷེ་ཧའུམ་ཧའུམ་ཕཏ་ཕཏ་སབ༹འཧའ་།
 oṃ amṛtavilokini garbhasaṃrakṣaṇi ākarṣaṇi hūṃ hūṃ phaṭ phaṭ svāhā || aparājitāhṛdayam ||	ཨཨོམ་ཨཨ་མྲི་ཏ་བི་ལོ་ཀི་ནི་གརབྷ་ས་མ་རཀཤ་ནི་། ཨའ་ཀརཤ་ནི་ཧའུམ་ཧའུམ་ཕཏ་ཕཏ་སབ༹འཧའ་། གཞན་གྱིས་མི་ཐུབ་པའི་སྙིང་པོའོ་༎ ཨཨོམ་བི་མ་ལེ་བི་བུ་ལེ་ཛ་ཡ་བ་རེ་།
 oṃ vimale vipule jaya vare amṛte hūṃ hūṃ phaṭ phaṭ svāhā ||	ཛ་ཡ་བའ་ཧི་ནི་། ཨཨ་མྲི་ཏེ་། བི་ར་ཛེ་ཧའུམ་ཧའུམ་ཕཏ་སབ༹འཧའ་།
 oṃ bhara bhara saṃbhara saṃbhara indriyabalaviśodhane hūṃ hūṃ phaṭ phaṭ svāhā ||	ཨཨོམ་བྷ་ར་བྷ་ར་སམ་དྷ་ར་སམ་བྷ་ར་། ཨཻནདྲི་ཡ་བ་ལ་བི་ཤོ་དྷ་ནི་། རུ་རུ་ཙ་ལེ་ཧའུམ་ཧའུམ་ཕཏ་ཕཏ་སབ༹འཧའ་། ཉེ་བའི་སྙིང་པོའི་རིག་པའོ་༎
 oṃ maṇidhari vajriṇi mahāpratisare hūṃ hūṃ phaṭ phaṭ svāhā ||	ཨཨོམ་མ་ནི་དྷ་རི་། བཛྲི་ནི་མ་ཧའ་པྲ་ཏི་ས་རེ་ཧའུམ་ཧའུམ་ཕཏ་ཕཏ་སབ༹འཧའ་། རབ་ཏུ་གསང་བའི་སྙིང་པོའོ་༎
 upahṛdayavidyā || aśeṣaiḥ sarvabuddhair bodhisatvaiś ca śrāvakair ekasvarasaṃnipātena ekasvaranirghoṣeṇa imāni dhāraṇīmantrapadāni bhāṣitāni mahāpratisarāmahāvidyārājñīhṛdayakavacāny etāni	སངས་རྒྱས་དང་བྱང་ཆུབ་སེམས་དཔའ་མ་ལུས་པ་ཐམས་ཅད་ཐབས་ཅིག་ཏུ་འདུས་ནས་སྒྲ་དབྱངས་གཅིག་ཏུ་གཟུངས་ཀྱི་གསང་སྔགས་ཀྱི་གཞི་འདི་དག་གསུངས་སོ་༎ གསང་སྔགས་འདི་དག་ནི་། རིག་པའི་རྒྱལ་མོ་ཆེན་མོ་སོ་སོར་འབྲང་མ་ཆེན་མོའི་སྙིང་པོ་དང་གོ་ཆའོ་༎
 mantrapattrapadāni sarvatathāgatadharmamudrayā mudritāni |	དེ་བཞིན་གཤེགས་པ་ཐམས་ཅད་ཀྱིས་ཕྱག་རྒྱས་བཏབ་པའོ་༎ འདི་ཐོས་པར་ཡང་རབ་ཏུ་དཀའ་ན་།
 atidullabham apy eṣāṃ śravaṇaṃ kiṃ punaḥ likhanapaṭhanadhāraṇavācanaparadeśanā buddhakṛtyam etad iti jñātavyā | iyaṃ hy atīva sarvapāpakṣayaṃkarā |	ཡི་གེར་བྲི་བ་དང་། ཚིག་ཏུ་འདོན་པ་དང་། ཀློག་པ་དང་། འཆང་བ་དང་། གཞན་ལ་ཡང་སྟོན་པ་ལྟ་ཅི་སྨོས་ཏེ་། དེ་ནི་། སངས་རྒྱས་ལ་བྱ་བ་བྱས་པར་རིག་པར་བྱའོ་༎ འདི་ནི་། དེ་བཞིན་གཤེགས་པ་ཐམས་ཅད་ཀྱིས་རབ་ཏུ་བསྔགས་སོ་༎
 sarvatathāgataiḥ praśaṃsitā anumoditā vyākṛtā paramadullabheyaṃ mahādhāraṇī aparājitā mahāpratisarā nāmadheyaṃ śravaṇam api paramadullabham	རྗེས་སུ་ཡི་རང་ངོ་༎ ལུང་བསྟན་ཏོ་༎ སོ་སོར་འབྲང་མ་ཆེན་མོ་གཞན་གྱིས་མི་ཐུབ་པའི་གཟུངས་འདི་མཆོག་ཏུ་དཀོན་པའོ་༎ སོ་༄༧༢ཨ་༌༎ སོར་འབྲང་མ་ཆེན་མོ་འདིའི་མིང་ཐོས་པར་ཡང་ཤིན་ཏུ་དཀའ་སྟེ་།
 iyaṃ sarvapāpakṣayaṃkarī |	གཟུངས་ཆེན་མོ་འདི་ནི་། སྡིག་པ་ཐམས་ཅད་བྱང་བར་བྱེད་པ་། སྟོབས་ཆེ་བ་།
 mahābalaparākramā mahātejā mahāprabhāvā mahāguṇodbhāvanī sarvamārakāyikadevatāvidhvaṃsanakarī |	ཕ་རོལ་གནོན་པ༏་གཟི་བརྗིད་ཆེ་བ་། འོད་ཆེ་བ་། ཡོན་ཏན་བརྗོད་པར་ཆེ་བ་། མཐུ་ཆེ་བ་། བདུད་ཀྱི་རིས་ཀྱི་ལྷ་ཐམས་ཅད་རྣམ་པར་འཇོམས་པར་བྱེད་པ་།
 sarvavāsanānusaṃdhisamudghāṭanakarī |	བག་ཆགས་ཀྱི་མཚམས་སྦྱོར་བའི་བདུད་ཀྱི་ཞགས་པ་གཅོད་པ་།
 sarvamārapāśasamucchedanakarī paramantramudrāviṣakākhordakiraṇaprayogavidveṣaṇābhicārakānāṃ ca duṣṭacittānāṃ vidhvaṃsanakarī |	ཕ་རོལ་གྱི་སྔགས་དང་། ཕྱག་རྒྱ་དང་། དུག་དང་། བྱད་དང་། ག-ཡེང་བྱེད་ཀྱི་སྦྱོར་བ་དང་། གནོད་པར་བྱ་བ་དག་དྲག་ཤུལ་དུ་སྤྱོད་པ་དང་། གནོད་པའི་སེམས་དང་ལྡན་པ་རྣམས་རྣམ་པར་སྦྱོང་བར་བྱེད་པ་།
 sarvabuddhabodhisatvāryagaṇavarapūjitābhiratānāṃ paripālanakarī |	སངས་རྒྱས་དང་། བྱང་ཆུབ་སེམས་དཔའ་དང་། འཕགས་པའི་ཚོགས་ཐམས་ཅད་ལ་མཆོད་པ་དམ་པ་བྱེད་པར་མངོན་པར་དགའ་བ་རྣམས་ལ་ཡོངས་སུ་སྐྱོང་བར་བྱེད་པ་།
 mahāyānodgrahaṇalikhanavācanapaṭhanasvādhyāyanaśravaṇadhāraṇābhiyuktānāṃ paripālikeyaṃ	ཐེག་པ་ཆེན་པོ་འཛིན་པ་དང་། ཡི་གེར་འབྲི་བ་དང་། ཀློག་པ་དང་། ཚིག་ཏུ་འདོན་པ་དང་། ཁ་ཏོན་བྱེད་པ་དང་། ཉན་པ་དང་འཆང་བར་མངོན་པར་བརྩོན་པ་རྣམས་ལ་ཡོངས་སུ་སྐྱོང་བའོ་༎
 mahādhāraṇī yāvad buddhabodhiparipūrayitrīyaṃ mahābrāhmaṇa mahāpratisarā mahāvidyārājñī	བྲམ་ཟེ་ཆེན་པོ་། སོ་སོར་འབྲང་མ་ཆེན་མོ་རིག་པའི་རྒྱལ་མོ་འདི་ནི་། སངས་རྒྱས་ཀྱི་བྱང་ཆུབ་ཀྱི་བར་དུ་ཡོངས་སུ་རྫོགས་པར་བྱེད་པ་སྟེ་།
 na kvacit pratijanyate sarvatra mahāpūjāṃ prāpnoti yathāhaṃ śāstā jitaviṣayaḥ |	གང་དུའང་ཐོགས་པ་མེད་དོ་༎ སྟོན་པ་དགྲ་ལས་རྒྱལ་བ་ཇི་ལྟ་བ་བཞིན་དུ་ཐམས་ཅད་དུ་ཡང་མཆོད་༄༧༢བ་པ་ཆེན་པོ་ཐོབ་པར་འགྱུར་རོ་༎
 kim iti pūrvaṃ parijñātavatīyaṃ (mp_21)	ཅི་མངོན་ཞེ་ན་།
 mahābrahmaṇa mahāvidyārājñī sarvavighnavināyakānāṃ vidhavaṃsayitrī ||	རིག་པ་ཆེན་མོ་བགེགས་དང་ལོག་འདྲེན་ཐམས་ཅད་རྣམ་པར་འཇོམས་པར་བྱེད་པ་འདི་ནི་། སྔོན་ཡོངས་སུ་ཤེས་ཏེ་།
 yadā ca bhagavān vipulaprahasitavadanamaṇikanakaratnajvalaraśmiprabhāsābhyudgatarājas tathāgato 'rhan samyaksaṃbuddho yena bodhimaṇḍalas tenopasaṃkrānta upasaṃkramya sarvabuddhapraśastaṃ	གང་གི་ཚེ་བཅོམ་ལྡན་འདས་དེ་བཞིན་གཤེགས་པ་དགྲ་བཅོམ་པ་ཡང་དག་པར་རྫོགས་པའི་སངས་རྒྱས་རྒྱ་ཆེར་རབ་ཏུ་བཞད་པའི་ཞལ་ནོར་བུ་དང་གསེར་དང་རིན་པོ་ཆེ་འབར་བའི་འོད་ཟེར་སྣང་བ་མངོན་པར་འཕགས་པའི་རྒྱལ་པོ་དང་པོ་མངོན་པར་སངས་རྒྱས་ནས་བྱང་ཆུབ་ཀྱི་སྙིང་པོ་ག་ལ་བ་དེར་གཤེགས་ཏེ་།
 dharmacakraṃ pravartayitukāmas tadā tasya bhagavataḥ sarvamāraiḥ saparivārair anekamārakoṭīniyutaśatasahasraparivṛtair	སངས་རྒྱས་ཐམས་ཅད་ཀྱིས་བསྔགས་པའི་ཆོས་ཀྱི་འཁོར་ལོ་རབ་ཏུ་བསྐོར་བར་བཞེད་པ་དེའི་ཚེ་བཅོམ་ལྡན་འདས་དེ་ལ་བདུད་ག-ཡོག་དང་བཅས་པ་བདུད་བྱེ་བ་ཁྲག་ཁྲིག་བརྒྱ་སྟོང་དུ་མས་བསྐོར་བ་། གཟུགས་སྣ་ཚོགས་། མི་སྡུག་པ་། འཇིགས་འཇིགས་ལྟར་འདུག་པ་། སྒྲ་མི་སྙན་པ་།
 nānārūpavirūpabhayabhairavaśabdākulair bahuvividhamāraviṣayavikurvaṇādhiṣṭhānādhiṣṭhitair nānāpraharaṇavṛṣṭībhir abhinirmāyāgatya caturdiśaṃ parivāryāntarāyaḥ kartum ārabdhaḥ |	བདུད་ཀྱི་ཡུལ་རྣམ་པ་སྣ་ཚོགས་རྣམ་པར་འཕྲུལ་པར་བྱིན་གྱིས་རློབ་པ་མཚོན་ཆ་རྣམ་པ་སྣ་ཚོགས་ཀྱི་ཆར་འབེབས་པ་མངོན་པར་སྤྲུལ་ནས་ལྷགས་ཏེ་ཕྱོགས་བཞི་ནས་བསྐོར་ཏེ་བར་ཆད་བྱ་བར་བརྩམས་པ་དང་། 
 tataḥ sa bhagavān vipulaprahasitavadanamaṇikanakaratnajvalaraśmiprabhāsābhyudgatarājo	དེ་ནས་བཅོམ་ལྡན་འདས་རྒྱ་ཆེར་རབ་ཏུ་བཞད་པའི་ཞལ་ནོར་བུ་དང་གསེར་དང་རིན་པོ་ཆེ་འབར་བའི་འོད་ཟེར་སྣང་བ་མངོན་པར་འཕགས་པའི་རྒྱལ་པོ་ཡུད་ཙམ་ཞིག་ཅང་མི་གསུང་པར་བཞུགས་༄༧༣ཨ་༌༎
 muhūrtaṃ tūṣṇīm āsthāya imāṃ mahāpratisarāṃ mahāvidyārājñīṃ manasā saptakṛtvaḥ pravartayāmāsa |	ནས་རིག་པའི་རྒྱལ་མོ་སོ་སོར་འབྲང་མ་ཆེན་མོ་འདི་ཡིད་ཀྱིས་ལན་བདུན་བརྗོད་དོ་༎
 samanantaraṃ pravartayitāyām asyāṃ mahāpratisarāyāṃ mahāvidyārājñyāṃ tatkṣaṇād eva sarve te mārāḥ pāpīyāṃso dadṛśur bhagavata ekaikasmād romakūpavivarād anekakoṭīniyutaśatasahasrāṇi puruṣāṇāṃ saṃnaddhakavacānāṃ jvalitakhaṅgaparaśupāśamudgarāsimusaratriśūrahastānām evaṃ vācaṃ pravyāharamāṇāni gacchanti |	རིག་པའི་རྒྱལ་མོ་ཆེན་མོ་སོ་སོར་འབྲང་མ་ཆེན་པོ་འདི་བརྗོད་མ་ཐག་ཏུ་སྐད་ཅིག་དེ་ཉིད་ལ་བདུད་སྡིག་ཅན་དེ་དག་ཐམས་ཅད་ཀྱིས་བཅོམ་ལྡན་འདས་ཀྱི་བ་སྤུའི་བུ་ག་རེ་རེ་ནས་སྐྱེས་བུ་གོ་ཆ་གྱོན་པ་བྱེ་བ་ཁྲག་ཁྲིག་བརྒྱ་སྟོང་དུ་མ་རལ་གྲི་དང་། དགྲ་སྟ་དང་། ཞགས་པ་དང་། ཐོ་བ་དང་། རྩེ་གསུམ་འབར་བ་ལག་ན་ཐོགས་པ་ཤ་སྟག་ཚིག་འདི་སྐད་དུ་། གང་དག་བཅོམ་ལྡན་འདས་ལ་གནོད་པར་བྱེད་པ་བདུད་གནོད་སེམས་ཅན་རྣམས་ཟུངས་ཤིག་ཟུངས་ཤིག་།
 gṛhṇata 2 bandhata 2 duṣṭamārān vidhvaṃsaya duṣṭacittān vicūrṇaya jīvitaṃ sarvaduṣṭagrahavighnavināyakānāṃ ye bhagavato viheṭhanaṃ kurvanti	ཆིངས་ཤིག་ཆིངས་ཤིག་། གནོད་པར་སེམས་པ་ཐམས་ཅད་རབ་ཏུ་ཆོམས་ཤིག་། གནོད་སེམས་ཅན་དང་། གཟའ་དང་། བགེགས་དང་། ལོག་འདྲེན་ཐམས་ཅད་ཀྱི་སྲོག་ཕྱེ་མར་གྱིས་ཤིག་ཅེས་འཛེར་ཅིང་ཐོན་པ་མཐོང་ངོ་༎
 tatas te sarvaduṣṭamārāmaitrīkhaṅgeṇābhinirjitāṃ kṛtvā kecic chikṣāpadāni grāhitā |	དེ་ནས་བདུད་དེ་དག་ཐམས་ཅད་བྱམས་པའི་རལ་གྲིས་མངོན་པར་བཏུལ་ནས་ལ་ལས་ནི་། བསླབ་པའི་གཞི་རྣམས་བཟུང་བ་ནས་ལ་ལ་ནི་།
 kecid yāvad anuttarāyāṃ samyaksaṃbodhau vyākṛtās tatra mahānubhāvāḥ |	བླ་ན་མེད་པ་ཡང་དག་པར་རྫོགས་པའི་བྱང་ཆུབ་ཏུ་ལུང་བསྟན་པའི་བར་དུའོ་༎ དེ་ལ་མཐུ་ཆེ་བ་གཞན་དག་ནི་།
 anye punas tān tathāgataromavivaravinirgatān mahāpuruṣān dṛṣṭvā tasmin nagare vihvalībhūtā ṛddhiparihīṇā naṣṭapratibhānabalaparākramā vidhvastāḥ	དེ་བཞིན་གཤེགས་པའི་བ་སྤུའི་བུ་ག་ནས་ཐོན་པའི་སྐྱེས་བུ་ཆེན་པོ་དེ་དག་མཐོང་༄༧༣བ་ནས་གྲོང་ཁྱེར་དེ་ཉིད་དུ་སྤ་བཀོང་བར་གྱུར་། རྫུ་འཕྲུལ་ཡོངས་སུ་ཉམས་། སྤོབས་པ་དང་། སྟོབས་དང་། རྩལ་མེད་པར་གྱུར་ཅིང་།
 samastāḥ samantāt prapalīnā iti |	མདའ་གཞུ་དག་ཀྱང་ཆག་ནས་བྱེར་རོ་༎
 tato bhagavatā dharmacakraṃ prativartitam | yathānyair buddhair iti | sarvavighnavināyakān mārāṃś ca pāpīyāṃso vidhvaṃsayitvottīrṇaḥ pāraṃgata iti |	དེ་ནས་བཅོམ་ལྡན་འདས་ཀྱིས་བགེགས་དང་། ལོག་འདྲེན་དང་། བདུད་སྡིག་ཅན་ཐམས་ཅད་རབ་ཏུ་བཅོམ་ནས་སངས་རྒྱས་གཞན་དག་ཇི་ལྟ་བ་བཞིན་དུ་ཆོས་ཀྱི་འཁོར་ལོ་རབ་ཏུ་བསྐོར་ཏོ་༎ བརྒལ་ཏོ་༎ ཕ་རོལ་ཏུ་རབ་ཏུ་གཤེགས་སོ་༎
 evaṃ hi mahābrāhmaṇa mahābalavegarddhipāramitāprāpteyaṃ mahāpratisarā mahāvidyārājñī smaraṇamātreṇa sarvavyasanabhayabhairavebhyaḥ (mp_22) parimocayati | āśayapariviśuddhānāṃ satvānāṃ nānyeṣāṃ duṣṭacetasām |	བྲམ་ཟེ་ཆེན་པོ་། དེ་ལྟར་ན་རིག་པའི་རྒྱལ་མོ་སོ་སོར་འབྲང་མ་ཆེན་མོ་སྟོབས་ཀྱི་དྲག་ཤུལ་ཆེ་བ་། རྫུ་འཕྲུལ་གྱི་ཕ་རོལ་ཏུ་ཕྱིན་པ་འདི་དྲན་པ་ཙམ་གྱིས་སེམས་ཅན་བསམ་པ་ཡོངས་སུ་དག་པ་རྣམས་དང་། གཞན་གནོད་སེམས་ཅན་རྣམས་ཀྱང་སྡུག་བསྔལ་བ་དང་། འཇིགས་སྐྲག་པ་ཐམས་ཅད་ལས་ཡོངས་སུ་ཐར་པར་བྱེད་དོ་༎
 tasmāt tarhi mahābrāhmaṇa nityam evānusmaraṇamātreṇa manasi kartavyā |	བྲམ་ཟེ་ཆེན་པོ་། དེ་ལྟ་བས་ན་རྟག་པར་རྗེས་སུ་དྲན་པའི་ཡིད་ལ་བྱེད་པས་ཡིད་ལ་བྱའོ་༎
 sarvakālaṃ ca likhitvā kāyakaṇṭhagatāṃ kṛtvā dhārayitavyā |	ཡི་གེར་བྲིས་ཏེ་རྟག་ཏུ་ལུས་ལ་གདགས་ཤིང་བཅང་བར་བྱའོ་༎
 kim iti pūrvavac chrūyatām ||	ཅི་མངོན་ཞེ་ན་། སྔ་མ་བཞིན་དུ་ཉོན་ཅིག་།
 ujjayanyāṃ mahānagaryāṃ rājño brahmadattasya vihite kenacit puruṣeṇāparādhaḥ kṛtaḥ | sa rājñā brahmadattena vadhakapuruṣebhya ājñaptaḥ | bhavato gacchatainaṃ puruṣaṃ jīvitād vyaparopayateti |	རྒྱལ་པོ་ཚངས་པས་བྱིན་གྱི་ཡུལ་ན་གྲོང་ཁྱེར་ཆེན་པོ་འཕགས་རྒྱལ་དུ་མི་ཞིག་ལ་ཉེས་པ་བྱུང་ནས་རྒྱལ་པོ་ཚངས་པས་བྱིན་གྱིས་གཤེད་མའི་མི་རྣམས་ལ་ཁྱོད་ཀྱིས་མི་འདི་སོད་ཅིག་ཅེས་བསྒོའོ་༎ 
 atha te vadhapuruṣās taṃ rājñājñaptaṃ puruṣaṃ gṛhītvā parvatavivaraṃ nītvā asikośān niṣkāsya taṃ puruṣaṃ jīvitād vyaparopayitum ārabdhaḥ |	དེ་ནས་གཤེད་མའི་མི་དེ་དག་གིས་རྒྱལ་པོས་བསྒོ་བ་༄༧༤ཨ་༌༎ བཞིན་དུ་མི་དེ་ཁྲིད་དེ་རི་སུལ་ཞིག་ཏུ་ཕྱིན་ནས་རལ་གྲི་ཤུབས་ནས་ཕྱུང་སྟེ་གསད་པར་བཤམས་པ་དང་། 
 tadā sa puruṣa imāṃ mahāpratisarāṃ mahāvidyārājñīṃ manasā smṛtavān likhitāṃ ca dakṣiṇe bāhau baddhvā dhārayati sma |	དེའི་ཚེ་མི་དེས་རིག་པའི་རྒྱལ་མོ་སོ་སོར་འབྲང་བ་ཆེན་མོ་འདི་ཡིད་བཤམས་པ་དང་། ལ་དྲན་ནོ་༎ ཡི་གེར་བྲིས་ནས་ལག་པ་ག-ཡས་པ་ལ་བཏགས་ཤིང་འདུག་བཤམས་པ་དང་། ལ་དྲན་ནོ་༎ 
 tasya mahāsatvasyāsyā mahāvidyāyāḥ prabhāvenāsir ekajvālībhūtā khaṇḍakhaṇḍaṃ yathā pāṃśumayo vikīrṇa iti |	གོ་། སེམས་ཅན་ཆེན་པོ་དེའི་རིག་པ་འདིའི་མཐུས་རལ་གྲི་མེ་ལྕེ་གཅིག་ཏུ་གྱུར་ནས་རྡུལ་གཏོར་བ་བཞིན་དུ་དུམ་བུ་དུམ་བུར་གྱུར་ཏོ་༎
 tatas te vadhakapuruṣā imam evaṃ niścayaṃ rājaṃ vistareṇārocayāmāsuḥ |	དེ་ནས་གཤེད་མའི་མི་དག་གིས་ངེས་པ་འདི་རྒྱལ་པོ་ལ་ཞིབ་ཏུ་བསྙད་དོ་༎
 tato rājā prakupitaś caṇḍībhūtaḥ kathayati | gacchata bho puruṣā anyatarasmin pradeśe yakṣaguhāsti |	དེ་ནས་རྒྱལ་པོ་དེ་རབ་ཏུ་འཁྲུགས་ནས་ཀྱེ་མི་འདི་དག་ས་ཕྱོགས་ཤིག་ན་གནོད་སྦྱིན་གྱི་ཕུག་ཡོད་དེ་། 
 tatra bahūni yakṣaśatasahasrāṇi prativasanti piśitāśīni |	དེ་ན་གནོད་སྦྱིན་བརྒྱ་སྟོང་མང་པོ་ཤ་རྗེ་ན་ཟ་བ་གནས་ཀྱི་།
 tatra nītvā chorayata | tataḥ sa puruṣo vadhakapuruṣais tasyāṃ yakṣaguhāyāṃ choritaḥ |	དེར་ཁྲིད་དེ་འོར་ཅིག་ཅེས་བསྒོའོ༏་༏དེ་ནས་མི་དེ་གཤེད་མའི་མི་དེ་དག་གིས་གནོད་སྦྱིན་གྱི་ཕུག་དེར་བོར་རོ་༎
 samanantara chorite tasmin yakṣaguhāyāṃ tatas te yakṣāḥ sarve tuṣṭamanaso hṛṣṭacittāś ca pradhāvitā mānuṣaṃ bhakṣayiṣyāma iti | te paśyanti asyā mahāpratisarāyā mahāvidyārājñyā anubhāvena taṃ puruṣam ekajvalībhūtaṃ dedīpyamānaṃ vigrahaṃ dṛṣṭvā ca sarva eva te yakṣā saṃtrastā dahyamānaṃ svaśarīraṃ paśyanti |	གནོད་སྦྱིན་གྱི་ཕུག་དེར་བོར་མ་ཐག་ཏུ་དེ་ནས་གནོད་སྦྱིན་དེ་དག་ཐམས་ཅད་ཡིད་དགའ་སྟེ་མི་ཤ་བཟའོ་སྙམ་དུ་བརྒྱུགས་པ་དང་། དེ་དག་གིས་སོ་སོར་འབྲང་བ་འདིའི་མཐུས་མི་དེ་ལ་མེ་ལྕེ་གཅིག་ཏུ་གྱུར་པའི་འོད་འཕྲོ་བ་རབ་ཏུ་འབར་བར་མཐོང་ངོ་༎
 atha te yakṣā vismayaṃ samāpannās taṃ puruṣaṃ gṛhītvā bahirdvāre 'vasthāpya pradakṣiṇīkartum ārabdhāḥ |	མཐོང་ནས་ཀྱང་ཐམས་ཅད་སྡངས་ནས་རང་རང་གི་ལུས་ཚིག་པར་མཐོང་ངོ་༎ དེ་ནས་གནོད་སྦྱིན་དེ་དག་ངོ་མཚར་སྐྱེས་ནས་མི་དེ་ཁྲིད་དེ་སྒོའི་ཕྱི་རོལ་ཏུ་བཞག་༄༧༤བ་ནས་བསྐོར་བ་བྱ་བར་བརྩམས་པ་ནས་གཤེད་མའི་མི་དེ་དག་གིས་རྒྱལ་པོ་ལ་ཞིབ་ཏུ་བསྙད་པའི་བར་དུ་སྔ་མ་བཞིན་ནོ་༎
 yāvat tair vadhakapuruṣai rājñe niścayo 'yaṃ vistareṇāroitaḥ | tato bhūyo rājā prakupitaś caṇḍībhūtaḥ kathayati | yad eva bhavanto gacchatainaṃ puruṣaṃ baddhvā nadyāṃ prakṣipata |	དེ་ནས་རྒྱལ་པོ་ཆེར་འཁྲུགས་ཏེ་སྡངས་ནས་གལ་ཏེ་དེ་ལྟར་ན་ཁྱེད་ཅག་དེངས་ལ་མི་འདི་ཆིངས་ཏེ་ཆུར་བོར་ཅིག་ཅེས་བསྒོ་བ་དང་། གཤེད་མའི་མི་དེ་དག་གིས་ཁྲིད་དེ་ཆུར་བོར་རོ་༎
 tataḥ sa puruṣo vadhakapuruṣair baddhvā nadyām prakṣiptaḥ | samanantaraṃ prakṣipte tasmin mahāpuruṣe sā nadī nirudakī bhūtā yatha sa (mp_23) puruṣaḥ sthalagata eva tiṣṭhati |	མི་དེ་ཆུར་བོར་མ་ཐག་ཏུ་མི་དེ་ཇི་ལྟར་ཐང་ལ་འདུག་པ་བཞིན་དུ་ཆུ་མེད་པར་གྱུར་ཏོ་༎ 
 tāni ca bandhanāni khaṇḍakhaṇḍaṃ vicūrṇitāni |	ཆིངས་པ་དེ་དག་ཀྱང་དུམ་བུར་ཆད་དོ་༎
 rājā śrutvā tato rājā vismitotphullavadanaḥ kathayati |	རྒྱལ་པོས་དེ་སྐད་ཐོས་པ་དང་། དེ་ནས་རྒྱལ་པོ་ངོ་མཚར་དུ་གྱུར་ནས་མིག་ཚུགས་སུ་བལྟས་ཏེ་།
 aho vismayam idaṃ puruṣasya dṛśyate |	ཀྱེ་མའོ་མི་འདི་ངོ་མཚར་ཏོ་༎
 kim atra kāraṇaṃ syād iti me vitarkaḥ |	འདི་ལ་རྒྱུ་ཅི་ཞིག་ཡོད་སྙམ་དུ་རྣམ་པར་རྟོག་པར་གྱུར་ཏོ་༎
 atha sa rājā taṃ puruṣam āhūyainam āha |	ཞེས་སྨྲས་སོ་༎ དེ་ནས་རྒྱལ་པོ་དེས་མི་དེ་བཀུག་སྟེ་།
 kiṃ tvaṃ bhoḥ puruṣa jānāsi |	ཀྱེ་མི་ཁྱོད་ཅི་ཞིག་ཤེས་ཞེས་དེ་སྐད་སྨྲས་སོ་༎
 sa puruṣa uvāca |	མི་དེས་སྨྲས་པ་།
 nāhaṃ mahārāja kiṃcid api jānāmi |	རྒྱལ་པོ་ཆེན་པོ་།
 anyatra mahāpratisarāṃ mahāvidyārājñīṃ dhārayāmi |	རིག་པ་ཆེན་མོ་སོ་སོར་འབྲང་བ་ཆེན་མོ་འཆང་བ་ལས་། གཞན་ནི་། ཅི་ཡང་མ་འཚལ་ཏེ༏་ལྷ་། དེ་ནི་།
 asyā eṣa deva mahāprabhāvaḥ |	དེའི་མཐུ་ལགས་སོ་༎
 rājā āha |	རྒྱལ་པོས་སྨྲས་པ་།
 aho āścaryam idaṃ mahat |	ངོ་མཚར་ཆེའོ་༎
 mahāvidyā subhāṣitā |	རིག་པ་ཆེན་མོ་དགེ་བར་གསུངས་༎ འཆི་བདག་ནན་ཏུར་རྨོངས་བྱེད་པ་༎
 mohanī mṛtyudaṇḍasya sarvabuddhair adhiṣṭhitā |	སངས་རྒྱས་ཀུན་གྱིས་བྱིན་གྱིས་བརླབས་༎
 tāraṇī sarvasatvānāṃ sarvaduḥkhapramocanī |	སེམས་ཅན་ཐམས་ཅད་རབ་ཏུ་སྒྲོལ་༎ ནད་དང་སྡུག་བསྔལ་ཐར་པར་བྱེད་༎
 mahāvidyā mahātejā akālamṛtyumocanī |	རིག་པ་ཆེན་མོ་གཟི་བརྗིད་ཆེ་༎ དུས་མིན་འཆི་ལས་རབ་ཏུ་སྒྲོལ་༎ ༄༧༥ཨ་༌༎ ནད་ཆེན་རྣམས་ནི་ཟློག་བྱེད་པ་༎
 bhāṣitā kāruṇikair nāthair mahāroganivāriṇī |	མགོན་པོ་ཐུགས་རྗེ་ཅན་གྱིས་གསུངས་༎
 tato rājñā prahṛṣṭamānasena mahāpratisarā mahāvidyārājñī pūjitā mānitābhinanditā |	དེ་ནས་རྒྱལ་པོ་རབ་ཏུ་དགའ་བའི་ཡིད་ཀྱིས་རིག་པའི་རྒྱལ་མོ་ཆེན་མོ་སོ་སོར་འབྲང་བ་ཆེན་མོ་ལ་མཆོད་ནས་མངོན་པར་བསྟོད་དོ་༎
 tasya puruṣasya poṭṭabandhaṃ kṛtvā svasya janapadasya purastān nagarajyeṣṭhatāyām abhiṣeko dattaḥ |	མི་དེ་ཡང་བློན་ཐབས་བྱིན་ཏེ་རང་གི་གཉེན་གྱི་མདུན་དུ་གྲོང་ཁྱེར་གྱི་གཙོ་བོར་དབང་བསྐུར་ཏོ་༎ 
 evaṃ hi mahābrāhmaṇa iyaṃ mahāpratisarā mahāvidyārājñī sarvatra mahatīpūjāṃ labhate |	བྲམ་ཟེ་ཆེན་པོ༏་དེ་ལྟར་ན་རིག་པའི་རྒྱལ་མོ་སོ་སོར་འབྲང་བ་ཆེན་མོ་འདིས་ཐམས་ཅད་དུ་ཡང་མཆོད་པ་ཆེན་པོ་རྙེད་དོ་ཏོ་༎ 
 anabhikramaṇīyā sarvaduṣṭacittaiḥ sarvaiḥ pūjanīyā |	༎ སེམས་ཅན་གནོད་སེམས་ཅན་ཐམས་ཅད་ཀྱིས་ཀྱང་འགལ་བར་མི་བྱའོ་༎
 evaṃ hi mahābrāhmaṇa pūrvam iyaṃ mahāpratisarā mahāvidyārājñī na kvacit pratihanyate |	དེ་ལྟར་ན་། རིག་པའི་རྒྱལ་མོ་ཆེན་མོ་འདི་ཡོངས་སུ་ཤེས་ཏེ་གང་དུ་ཡང་ཐོགས་པ་མེད་དོ་༎
 tasmād avaśyam iyaṃ mahāvidyārājñī kāyakaṇṭhagatāṃ kṛtvā dhārayitavyā |	དེ་ལྟ་བས་ན་གདོན་མི་ཟ་བར་རྟག་ཏུ་ལུས་ལ་གདགས་ཤིང་བཅང་བར་བྱའོ་༎ བྲམ་ཟེ་ཆེན་པོ་༎
 api tu mahābrāhmaṇa manukṣetreṇeyaṃ mahāvidyārājñī supraśastena vidhānena likhitavyā ||	སྐར་མ་བཟང་པོ་ལ་ཆོ་ག་ལེགས་པར་བྱས་ཏེ་རིག་པའི་རྒྱལ་མོ་འདི་བྲི་བར་བྱའོ་༎
 atha sa mahābrāhmaṇo 'tīva prahṛṣṭamanasā bhagavantaṃ pañcamaṇḍalakenābhipraṇamya praṣṭum ārabdhaḥ |	དེ་ནས་བྲམ་ཟེ་ཆེན་པོ་དེ་ཡིད་རབ་ཏུ་དགའ་ནས་བཅོམ་ལྡན་འདས་ལ་ཡན་ལག་ལྡས་ཕྱག་འཚལ་ཏེ་ཞུས་པ་། བཙུན་པ་བཅོམ་ལྡན་འདས་།
 kīdṛśena bhadanta bhagavan vidhāneneyaṃ mahāpratisarā mahāvidyārājñī likhitavyā ||	རིག་པའི་རྒྱལ་མོ་འདིའི་ཆོ་ག་ཇི་ལྟར་བགྱིས་ཏེ་བྲི་བར་བགྱི་།
 bhagavān āha |	བཅོམ་ལྡན་འདས་ཀྱིས་བཀའ་སྩལ་པ་། བྲམ་ཟེ་ཆེན་པོ་༎
 śṛṇu mahābrāhmaṇa tvām ahaṃ vakṣye sarvasatvānukaṃpayā |	ཁྱོད་ཉོན་ཅིག་། སེམས་ཅན་ཀུན་ལ་སྙིང་བརྩེའི་ཕྱིར་༎ ངས་ནི་ཁྱོད་ལ་བཤད་པར་བྱ་༎
 yena satvāḥ sukhino bhontu mucyatai karmasaṃkaṭāt ||	གང་གིས་སེམས་ཅན་བདེ་བྱེད་ཅིང་༎ ཉམ་ང་བ་ཡི་༄༧༥བ་ལས་ལས་འགྲོལ་༎
 vyādhitānāṃ ca mokṣārthaṃ strīṇāṃ garbhasamudbhavam |	ནད་རྣམས་ལས་ཀྱང་ཐར་བྱ་དང་༎ བུད་མེད་སྦྲུམ་མར་འགྱུར་བ་དང་༎ སེམས་ཅན་རྣམས་ཀྱི་དབུལ་བ་ཡི་༎
 bhaviṣyati ca satvānāṃ dāridryavaraṇarohaṇam ||	རྨ་རྣམས་གསོ་བར་བྱ་ཕྱིར་རོ་༎
 upavāsoṣito bhūtvā nakṣatre puṣyasaṃmate |	བསྙེན་གནས་དག་ལ་གནས་གྱུར་ནས་༎ རྒྱུ་སྐར་རྒྱལ་དུ་ཤེས་པ་ལ་༎
 buddhapūjāparo bhūtvā cittam utpācya bodhaye ||	སངས་རྒྱས་མཆོད་ལ་བརྩོན་བྱས་ཏེ་༎ བྱང་ཆུབ་ཕྱིར་ནི་སེམས་ཀྱང་བསྐྱེད་༎
 karuṇāmreḍitacittena maitryā cāpi samanvitaḥ |	སྙིང་རྗེས་ཀུན་ཏུ་བརླན་སེམས་དང་༎ བྱམས་པ་དང་ཡང་ལྡན་གྱུར་ནས་༎
 hitādhānaparaś cāpi sarvasatveṣu nityaśaḥ ||	རྟག་ཏུ་སེམས་ཅན་ཐམས་ཅད་ལ་༎ ཕན་པ་བསྐྱེད་པ་བརྩོན་པར་བྱ་༎
 snātvā candanakarpūraiḥ kastūrīsalilena ca |	ཙནདན་དང་ནི་གུར་གུམ་དང་༎ གླ་རྩིར་བསྲེས་པའི་ཆུས་བཀྲུས་ཏེ་༎
 śucivastrāṇi prāvṛtya dhūpitāni ca dhūpanaiḥ ||	བདུག་པ་རྣམས་ཀྱིས་བདུགས་པ་ཡི༏་༏གོས་གཙང་རྣམས་ཀྱིས་བགོ་བར་བྱ་༎ ས་དང་ལྕི་བ་བསྲེས་པ་ཡི་༎
 tato maṇḍalakaṃ kṛtvā śṛṅgomayasamanvitam |	དེ་ཡི་འོག་ཏུ་དཀྱིལ་འཁོར་བྱ་༎
 pañcaraṅgikacūrṇena citraya maṇḍalaṃ śubham ||	བུམ་པ་གང་བ་བཞི་བཞག་སྟེ་༎
 pūrṇakumbhāś ca caturaḥ pañcamaṃ madhyamaṇḍale |	ལྔ་པ་དཀྱིལ་འཁོར་དབུས་སུ་གཞག་། དེ་ལ་རིན་ཐང་ཆེན་པོ་ཡི་༎
 puṣpadhūpāś ca gandhāś ca dātavyātra mahārihā || dhūpanaṃ candanaṃ caiva spṛkkāguru tathaiva ca |	མེ་ཏོག་བདུག་པ་སྤོས་རྣམས་གསོལ་༎ ཙནདན་སྤྲི་ཀ་དེ་བཞིན་དུ་༎ ཨཨ་ག་རུ་དང་དུ་རུ་ཀ་།
 pañcaśarkarā rukmā ca dātavyātra vidhānataḥ ||	ཤ་ཁ་ར་དང་ལྔ་སྦྱར་བའི་༎ བདུག་པ་ཆོ་ག་བཞིན་དུ་དབུལ་༎ ཆོ་ག་ཇི་བཞིན་དུས་བཞིན་བྱ་༎
 nānāvidhāni puṣpāṇi yathākālaṃ yathāvidhiḥ |	ལོ་ཏོག་རྣམ་པ་སྣ་ཚོགས་རྣམས་༎
 sarvapuṣpaphalair bījair gandhaiś cāpi sumaṇḍitān ||	མེ་ཏོག་འབྲས་བུ་ས་བོན་དང་༎ སྤོས་རྣམས་ཀུན་གྱིས་ལེགས་པར་བརྒྱན་༎
 ghṛtamākṣikadugdhaiś ca pāvakaiḥ payasādibhiḥ |	མར་དང་སྦྲང་རྩི་འོ་མ་དང་༎ ནས་ཐུག་འོ་ཐུག་ལ་སོགས་པས་༎
 pūrayed balikumbhāś ca lakṣaṇād yān sumaṅgalān ||	གཏོར་མའི་བུམ་པ་དགང་བར་བྱ་༎ མཚན་མ་ཤིན་ཏུ་བཀྲ་ཤིས་པ་༎
 sthāpayec caturo dikṣu pañcamaṃ madhyamaṇḍale |	ཕྱོགས་བཞི་རྣམས་སུ་གཞག་པར་བྱ་༎ ལྔ་པ་དཀྱིལ་འཁོར་དབུས་༄༧༦ཨ་༌༎ སུ་གཞག་།
 sthāpanīyāḥ śarāvāṃś ca koṇeṣu gandhapūritāḥ || catvāraḥ kīlakāś cāpi khādirā dṛḍhaveśitāḥ |	སྤོས་ཀྱིས་བཀང་བའི་ཕུར་བུ་རྣམས་༎
 pañcaraṅgikasūtreṇa veśayitvā vicakṣaṇāḥ |	གྲ་བཞི་དག་ཏུ་གཞག་པར་བྱ་༎
 samabhāgena sthāpyetāṃ nipatyān maṇḍalād bahiḥ |	དཀྱིལ་འཁོར་གྱི་ནི་འགྲམ་ལོགས་སུ་༎ སེང་ལྡེང་ཕུར་བུ་བཞི་བཙུགས་ལ་༎ ཚོན་སྐུད་ཁ་དོག་སྣ་ལྔ་ཡིས་༎ འཁོར་བར་དམ་དུ་དཀྲི་བར་བྱ་༎
 evaṃ kṛte likhed vipra yad icchet siddhim ātmanaḥ ||	གལ་ཏེ་བདག་འགྲུབ་འདོད་ན་ནི་༎ བྲམ་ཟེ་དེ་ལྟར་བྱས་ནས་བྲི་༎
 śuklabhojanabhuktena likhitavyaṃ sukhaiṣiṇā |	ཁ་ཟས་དཀར་པོ་ཟོས་ནས་སུ་༎ ཕན་པར་འདོད་པས་བྲི་བར་བྱ་༎
 paṭṭe vā vastrabhūrje vānyatra vā yatra kutracit ||	དར་རམ་རས་སམ་གྲོ་ག་འམ་༎ ཅི་ཡང་རུང་བ་གཞན་ལ་བྲི་༎
 likhet strīṣu ca putrārthī samyaggorocanena vai |	བུད་མེད་དག་ལ་བུ་འདོད་ན་༎ གི་ཝང་གིས་ནི་ལེགས་པར་བྲི་༎
 madhye ca dārakaṃ kuryāt sarvālaṃkārabhūṣitam ||	དབུས་སུ་ཁྱེའུ་ཞིག་བྲིས་ནས་ནི༏་༏རྒྱན་རྣམས་ཀུན་གྱིས་རྣམ་པར་བརྒྱན་༎
 ratnapūrṇaṃ tathā pātraṃ vāmahastena dhārayet |	དེ་བཞིན་རིན་ཆེན་གང་བའི་སྣོད་༎ ལག་པ་ག-ཡོན་ན་ཐོགས་པར་བྱ་༎
 kārye padme niṣaṇṇo saupraphullitavibhūṣite ||	པདམ་རབ་ཏུ་རྒྱས་གྱུར་ཅིང་༎ བརྒྱན་པ་ལ་ནི་དེ་འདུག་བྱ་༎
 maṇihārasuvarṇaṃ ca nānāratnaviśeṣataḥ |	ནོར་བུ་དོ་ཤལ་གསེར་དག་དང་༎ རིན་ཆེན་སྣ་ཚོགས་རྣམས་ཀྱིས་བརྒྱན་༎ གདུལ་བར་ཤིན་ཏུ་དཀའ་བ་བྲི་༎
 pravarṣaś cāpi kartavyāś catuḥ koṇeṣu parvatāḥ ||	གྲ་བཞི་དག་ཏུ་རི་བོ་བྲི་༎
 evaṃ likhet prayatnena yad icched jīvitaṃ sukham |	གལ་ཏེ་བདེ་བར་འཚོ་འདོད་ན་༎ རབ་ཏུ་བསྒྲིམས་ཏེ་དེ་ལྟར་བྲི་༎ བྱེ་བྲག་ཏུ་ནི་སྐྱེས་པ་རྣམས་༎
 kuṅkumena likhet prājñaḥ puruṣāṇāṃ viśeṣataḥ ||	གུར་གུམ་གྱིས་ནི་བྲི་བར་བྱ་༎
 tasyepsitāni kāryāṇi sidhyante nātra saṃśayaḥ | nānārūpāś ca kartavyā mudrācihnaś ca padminī ||	དེ་ཡི་དགོས་པ་འདོད་པ་རྣམས་༎ འགྲུབ་འགྱུར་འདི་ལ་ཐེ་ཚོམ་མེད་༎
 dve padme athavā trīṇi catvāri pañca vā likhet |	པདམ་གཉིས་སམ་ཡང་ན་གསུམ༏་༏བཞི་འམ་ཡང་ན་ལྔ་བྲིས་ཏེ་༎ པདམ་ལ་ནི་ཕྱག་རྒྱའི་མཚན་༎ རྣམ་པ་སྣ་ཚོགས་གཟུགས་སུ་བྲི་༎
 padmānāṃ ca tathā kuryāt keśarāṇi samantataḥ ||	དེ་བཞིན་དུ་ནི་པདམ་རྣམས་༎ ཟེ་བས་ཀུན་ཏུ་འཁོར་བར་བྲི་༎
 supuṣpitaṃ padmaṃ kurvīta sadaṇḍaṃ paṭṭabaddhakam |	པདམ་འདབ་༄༧༦བ་མ་རབ་རྒྱས་ལ་༎ སྡོང་བུ་དར་གྱིས་བཅིངས་པར་བྲི་༎
 triśūlaṃ padme kurvītātha koṇaṃ paṭṭabaddhakam ||	པདམ་ལ་ནི་རྩེ་གསུམ་པ་༎ ཟུར་བརྒྱད་ལ་ནི་དར་དབྱངས་བྲི་༎ དེ་བཞིན་པདམ་དགྲ་སྟར་བཅས་༎
 parśuṃ kuryāt tathā padme atha patre samantataḥ |	འདབ་མ་བརྒྱད་དང་ལྡན་པར་བྲི་༎
 sakhaṅgaṃ padmaṃ kurvīta tat padmaṃ śitam eva ca ||	པདམར་བཅས་པའི་རལ་གྲི་བྲི་༎ པདམ་དེ་ནི་དཀར་པོར་བྱ་༎
 śaṅkhaṃ padme tathā kuryāt sarvatra vidhivistaram |	པདམའི་སྟེང་དུ་དུང་ཡང་བྲི་༎ ཐམས་ཅད་དུ་ཡང་རྒྱས་པར་བྱ་༎
 sarvatra vidhicihnāni kārayet suvicakṣaṇaḥ ||	ཀུན་ཏུ་ཆོ་གའི་མཚན་མ་རྣམས་༎ མཁས་པ་དག་གིས་བྲི་བར་བྱ་༎
 varjayed bālarūpāṇi yatra cittaṃ praduṣyati |	གང་ལ་གནོད་པའི་སེམས་འབྱུང་བ་༎ བྱིས་པའི་གཟུགས་རྣམས་མི་བྲིའོ་༎
 devarūpāś ca kartavyā nānālaṃkārabhūṣitā ||	སྣ་ཚོགས་རྒྱན་གྱིས་བརྒྱན་པ་ཡི་༎ ལྷ་ཡི་གཟུགས་ནི་བྲི་བར་བྱ་༎
 bhikṣuṃ vajradharaṃ kuryād duṣṭatarjanaṃ tat param |	དགེ་སློང་ཕྱིར་ནི་རྡོ་རྗེ་འཆང་༎ གནོད་སྦྱིན་བསྡིགས་པར་བརྩོན་པར་བྲི་༎
 caturaś ca mahārājāṃś catuḥ pārśveṣu saṃlikhet ||	རྒྱལ་པོ་ཆེན་པོ་བཞི་རྣམས་ཀྱང་༎ ངོས་བཞི་རྣམས་སུ་བྲི་བར་བྱ་༎
 brāhmaṇeṣv īśvaro lekhyaḥ kṣatriyeṣu maheśvaraḥ |	བྲམ་ཟེའི་ཕྱིར་ནི་དབང་ལྡན་ནོ་༎ རྒྱལ་རིགས་ལ་ནི་དབང་ཕྱུག་ཆེ་༎ དམངས་རིགས་ཕྱིར་ནི་རྟག་ཞི་བ་༎
 śūdreṣu ca sadā saumyaṃ cakrasvāminam ālikhet ||	ཁྱབ་འཇུག་ལེགས་པར་བྲི་བར་བྱ་༎ རྗེའུ་རིགས་ཕྱིར་ནི་རྣམ་ཐོས་བུ་༎
 vaiśyeṣu ca vaiśramaṇam indraś caiva sureśvaraḥ |	ལྷ་ཡི་དབང་ཕྱུག་དབང་པོ་བྲི་༎ ཁྱེའུ་ཡི་ཕྱིར་ནི་སྐྱེ་རྒུའི་བདག་།
 dārakebhyaḥ sadā lekhyaḥ prajāpatir mahāmatiḥ ||	བློ་གྲོས་ཆེན་པོ་བྲི་བར་བྱ༏་༏སྔོ་བསངས་མདོག་ནི་གང་ཡིན་པ་༎
 syāmavarṇā bhaved yātu raudraṃ tasyā samālikhet |	དེ་ཡི་ཆེད་དུ་ཁྲོས་པ་བྲི་༎ དཀར་མོའི་ཕྱིར་ནི་གྲགས་ལྡན་པ་༎ ཕུན་སུམ་ཚོགས་པའི་གཟུགས་སུ་བྲི་༎ སྦོམ་མའི་ཕྱིར་ནི་ནོར་བུ་བཟང་༎
 gaurāyā rūpasaṃpanno likhen nityaṃ yaśasvinaḥ || sthūlāyā māṇibhadraś ca likhitavyaṃ prayatnataḥ |	རབ་ཏུ་བསྒྲིམས་ཏེ་བྲི་བར་བྱ་༎ སྐེམ་མོའི་ཕྱིར་ནི་གང་བ་བཟང་༎
 kṛṣāyāḥ pūrṇabhadras tu mayā hy uktaṃ svayaṃbhuvā ||	རང་བྱུང་ང་ཡིས་བསྟན་པར་བྲི་༎ སྦྲུམ་མའི་ཕྱིར་ནི་ནག་པོ་ཆེ་༎
 gulviṇyāś ca mahākālo likhec ca brahmadevatān |	ཚངས་ལྷ་རྣམས་ཀྱང་བྲི་བར་བྱ་༎
 anyāś cāpi yathāpūrvaṃ vibhinoktaṃ samālikhet ||	གཞན་ཡང་ཇི་ལྟར་༄༧༧ཨ་༌༎ ཆོ་ག་ལས་༎ གོང་དུ་བཤད་པ་བཞིན་དུ་བྲི་༎
 likhitvaiva prayatnena vidhidṛṣṭena karmaṇā |	ལས་ཀྱི་ཆོ་ག་མཐོང་ནས་ནི་༎ རབ་ཏུ་བསྒྲིམས་ཏེ་དེ་བཞིན་བྲི་༎
 dhārayet satataṃ kaṇṭhe bhadraṃ tasya bhaviṣyati ||	རྟག་ཏུ་མགུལ་དུ་བཏགས་ན་ནི་༎ དེ་ནི་བདེ་བར་འགྱུར་བ་ཡིན་༎
 dvārāgre cintāmaṇiṃ kuryād dhvajāgre padmasaṃsthitam |	རྒྱལ་མཚན་རྩེ་མོའི་པདམ་ལ་༎ ཡིད་བཞིན་ནོར་བུ་འབར་བ་བྲི་༎
 padmasya keśare pāśaṃ cakraṃ cāpi tathāparam ||	པདམའི་སྙིང་པོར་ཞགས་པ་དང་༎ དེ་བཞིན་འཁོར་ལོའང་བྲི་བར་བྱ་༎
 vajraṃ padme tathā likhyaṃ mudgalaṃ padmasaṃsthitam |	པདམའི་སྟེང་དུ་རྡོ་རྗེ་དང་༎ པདམའི་སྙིང་པོར་ཐོ་བ་བྲི་༎ ཆོ་ག་ལས་ནི་འབྱུང་བ་བཞིན་༎
 śaktiṃ likhet tathā padme yathāvidhiṣu dṛṣyate ||	པདམའི་སྟེང་དུ་མདུང་ཐུང་བྲི་༎ ཆོ་ག་ལས་ནི་བརྗོད་པ་བཞིན་༎
 dvārāgramaṇayaḥ sarve visphuliṅgāḥ samākulāḥ |	ནོར་བུ་ཐམས་ཅད་རྩེ་མོ་འབར་༎
 paṭṭabaddhāś ca kartavyā yathāvidhiṣu kīrtitāḥ ||	འོད་ཟེར་འཕྲོ་བས་རྒྱས་པ་དང་༎ དར་གྱིས་བཅིངས་པ་བྲི་བར་བྱ་༎
 nāgāś ca phalinaḥ kāryāmaṇidvārā navaśīrṣakāḥ |	ཀླུ་མགོ་གདེངས་ཀ་དགུ་ཡོད་ལ་༎ ནོར་བུ་རབ་ཏུ་འབར་བ་དང་༎ དེ་དག་ཀུན་གྱི་སྙིང་གར་ཡང་༎
 te 'pi sarve prayatnena hṛdi vajraprasthitāḥ ||	རྡོ་རྗེ་གནས་པར་བསྒྲིམས་ཏེ་བྲི་༎
 pārthivānāṃ balaṃ nityaṃ sārthavāhaṃ likhed budhaḥ |	རྒྱལ་པོ་རྣམས་ཕྱིར་སྟོབས་ཅན་དང་༎ དེད་དཔོན་མཁས་པས་རྟག་ཏུ་བྲི་༎ རིག་པ་འཛིན་པ་ཐམས་ཅད་བྲི་༎
 vidyādharāṇāṃ sarveṣāṃ divyādevīṃ samālikhet ||	རིག་པའི་ལྷ་མོ་རྣམས་ཀྱང་བྲི་༎
 candrasūryau hi nakṣatrau rāhuketugrahāṣṭakam |	ཟླ་བ་ཉི་མ་རྒྱུ་སྐར་བཅས་༎
 likhec ca khaṇḍāṃ pāṇḍānāṃ putralābho bhaviṣyati ||	སྒྲ་གཅན་མཇུག་རིང་གཟའ་བརྒྱད་བྲི་༎
 niścayād vidhinā likhya śāstradṛṣṭena karmaṇā | tasmāt sarvaprayatnena dhārayet matimān naraḥ ||	ཆོ་ག་བཞིན་དུ་ངེས་བྲིས་ལ་༎ བློ་གྲོས་ལྡན་པའི་མིས་སེལ་ན་༎ ཟ་མ་རྣམས་ནི་མ་ནིང་ཡང་༎ བུ་ཕོ་རྙེད་པར་འགྱུར་བ་ཡིན་༎
 sarvasiddhikaraṃ hy etad maṅgalyaṃ pāpanāśanam |	འདིས་ནི་ཐམས་ཅད་འགྲུབ་པར་བྱེད་༎ ཤིས་ཤིང་སྡིག་པ་ཞི་བར་བྱེད་༎ རང་བྱུང་གི་ནི་བཀའ་བཞིན་དུ་༎
 prāpnoti paramaṃ sthānaṃ svayaṃbhū vacanaṃ yathā ||	གནས་ཀྱི་དམ་པ་ཐོབ་པར་འགྱུར་༎
 loke 'smin paramaṃ saukhyaṃ paraloke paraṃ sukham |	༄༧༧བ་འཇིག་རྟེན་འདི་ནའང་མཆོག་ཏུ་བདེ་༎ འཇིག་རྟེན་ཕ་རོལ་ཤིན་ཏུ་བདེ་༎
 trayastriṃśadbhavanādau sthānaṃ tasya surālaye ||	སུམ་ཅུ་རྩ་གསུམ་གནས་ལ་སོགས་༎ ལྷ་གནས་དེ་ཡི་གནས་སུ་འགྱུར་༎ འཛམ་གླིང་བཟང་ཞིང་ཉམས་དགའ་བར༏་༏ཁྱད་པར་ཅན་རིགས་གྲགས་པ་དང་༎ རྒྱལ་རིགས་ཁྱད་པར་འཕགས་པ་དང་༎ བྲམ་ཟེ་ཁྱད་པར་འཕགས་རྣམས་སུ་༎ བདག་ཉིད་ཆེན་པོ་དེ་སྐྱེས་ཏེ་༎
 jambudvīpe śubhe ramye vidyāsaukhyaṃ ca nityaśaḥ |	རྟག་ཏུ་རིག་དང་བདེ་བར་འགྱུར་༎ སོ་སོར་འབྲང་མ་འཆང་བའི་མིས་༎ བསོད་ནམས་ཐོབ་པ་གང་ཡིན་པ་༎
 sarvabuddhair na śakyaṃ hi puṇyaskandhaprakīrtitām || yat puṇyaṃ samavāpnoti pratisarādhārako naraḥ |	སངས་རྒྱས་དག་ནི་ཐམས་ཅད་ཀྱིས་༎ བསོད་ནམས་ཕུང་པོ་བརྗོད་མི་ནུས་༎
 narakadvārā pithitāḥ svargadvārā apāvṛtāḥ ||	སེམས་ཅན་དམྱལ་བའི་སྒོ་རྣམས་བཅད་༎ མཐོ་རིས་སྒོ་རྣམས་རབ་ཏུ་ཕྱེ་༎
 sukhaṃ saṃpattisaṃpanno bhaviṣyati mahāmatiḥ |	བདེ་བ་ཕུན་སུམ་ཚོགས་པ་དང་༎ བློ་གྲོས་ཆེན་པོར་འགྱུར་བ་ཡིན་༎
 buddhāś ca bodhisatvāś ca āśvāsayanti nityaśaḥ ||	སངས་རྒྱས་བྱང་ཆུབ་སེམས་དཔས་ཀྱང་༎ རྟག་ཏུ་དབུགས་ནི་འབྱིན་པར་འགྱུར་༎
 kāyena sukhasaṃpanno balena mahatā bhavet |	ལུས་ཀྱི་བདེ་བ་ཕུན་སུམ་ཚོགས་༎ སྟོབས་ཀྱང་ཆེ་བར་འགྱུར་བ་ཡིན་༎
 yathā tathaiva jitendroktaṃ cakravartī bhaviṣyati ||	རྒྱལ་བས་ཇི་སྐད་གསུངས་པ་ལྟར་༎ འཁོར་ལོས་བསྒྱུར་བར་འགྱུར་བ་ཡིན༏་༏མི་དང་ལྷ་རྣམས་དབུགས་འབྱིན་ཏེ་༎
 āśvāsanaṃ nṛdevānāṃ trāsanaṃ duṣṭacetasām |	གནོད་པར་སེམས་པ་སྐྲག་པར་བྱེད་༎
 bhaviṣyati cireṇāsau yasya vidyā subhāṣitā ||	གང་ཕྱིར་རིག་པ་ལེགས་བཤད་པ་༎ དེ་ནི་རིང་པོ་མི་ཐོགས་སོ་༎
 nāsau hanyati śastreṇa na viṣeṇa nāgninā |	དེ་ནི་མཚོན་གྱིས་མི་ཚུགས་ཏེ༏་༏དུག་དང་མེས་ཀྱང་ཚུགས་མི་འགྱུར་༎
 nākālamaraṇaṃ cāsya dūre gacchanti pāpakāḥ ||	དུས་མིན་འཆི་བའི་སྡིག་བ་ཡང་༎ དེ་ལས་ཐག་ནི་རིང་དུ་འགྲོ་༎ རྣམ་པ་ཀུན་ཏུ་ཉན་པ་འམ་༎
 darśanāt sparśanāc caiva śravaṇād eva sarvataḥ |	མཐོང་བ་དང་ནི་རེག་པའང་རུང་༎ འབྱུང་༄༧༨ཨ་༌༎
 bhūtagrahavivādāś ca udakāgnibhayaṃ tathā || mṛgāvyāḍāhayānāgāvyādhayaś ca sudāruṇāḥ |	པོ་གདོན་དང་རྩོད་པ་དང་༎ ཆུ་དང་མེ་ཡིས་འཇིགས་པ་དང་༎ གཅན་གཟན་སྦྲུལ་དང་སེངྒེ་དང་༎ ཀླུ་དང་ནད་ནི་མི་བཟད་རྣམས་༎
 te sarve na bhaviṣyanti yeṣāṃ vidyā subhāṣitā || sarvathā sarvamārais tu śṛṇu vakṣāmi tatvataḥ |	གང་ལ་རིག་པ་ལེགས་བཤད་པ་༎ དེ་ལ་དེ་དག་ཀུན་མི་འབྱུང་༎ དེ་དག་སེམས་ཅན་ཀུན་མཆོག་འགྱུར་༎
 pūjanīyā bhaviṣyanti sarvasatvottamā hiteti ||	བདུད་རྣམས་ཀུན་གྱིས་ཐམས་ཅད་དུ་༎ མཆོད་པར་འགྱུར་བའི་འོས་ཡིན་ཏེ་༎ ཡང་དག་བཤད་ཀྱིས་མཉན་པར་བྱོས་༎
 āryamahāvidyārājño mahāpratisarāyāḥ prathamakalpaḥ samāptaḥ ||	རིག་པའི་རྒྱལ་མོ་སོ་སོར་འབྲང་བ་ཆེན་མོའི་ཆོ་ག་རྫོགས་སོ་༎༎
 athāto vidyāvarasya rakṣāvidhānakalpaṃ vyākhyāsyāmi sarvasatvānukampakayā |	དེ་ནས་སེམས་ཅན་ཐམས་ཅད་ལ་སྙིང་བརྩེ་བའི་ཕྱིར་རིག་སྔགས་འཆང་སྲུང་བའི་ཚུལ་གྱི་ཆོ་ག་བཤད་པར་བྱའོ་༎ སྲུང་བའི་ཆོ་ག་གང་ཞིག་གིས་༎
 janarakṣāvidhānena mahāsiddhir bhaviṣyati |	དངོས་གྲུབ་ཆེན་པོ་འགྲུབ་འགྱུར་བ་༎
 yatra yatra kṛtā rakṣā bhavaty abaddho na saṃśayaḥ ||	གང་དང་གང་དུ་བསྲུངས་བྱས་ནས་༎ དོན་ཡོད་འགྱུར་ཏེ་ཐེ་ཚོམ་མེད་༎ འཇིགས་མེད་རིམས་ཀྱིས་མི་འདེབས་ཏེ་༎
 nirbhayaṃ nirjvalaṃ caiva sarvagrahanivāraṇam |	གཟའ་རྣམས་ཐམས་ཅད་ཟློག་པར་བྱེད་༎ རྒྱུ་སྐར་རྣམས་ཀྱང་མཐུན་པར་འགྱུར་༎
 sunakṣatrānukūlaṃ ca karmasaṅkalacchedanam ||	ལས་ཀྱི་ལུ་གུ་རྒྱུད་ཀྱང་གཅོད་༎
 durbhuktaṃ dullaṅghitaṃ caiva sarvaśatrugaṇaiḥ kṛtam | duṣprekṣitaṃ dullikhitaṃ kākhordā ye ca dāruṇāḥ || cūrṇamantrakṛtaṃ caiva viṣabhuktaṃ tathā garam |	བཟའ་ཉེས་པ་དང་སྒོམ་ཉེས་དང་༎ དགྲ་ཚོགས་ཀུན་གྱིས་བྱས་པ་དང་༎ གནོད་པར་བལྟས་དང་བྲི་ཉེས་དང་༎ བྱད་དང་གང་ཡང་མི་བཟད་དང་༎ ཕྱེ་མ་སྔགས་ཀྱིས་བཏབ་པ་དང་༎ དུག་འཐུངས་པ་དང་སྦྱོར་བའི་དུག་། གང་ཞིག་སྲུང་བ་འཆང་དེ་ལ་༎
 sarve tasya praśāmyanti rakṣāṃ dhāvayate tu yaḥ ||	དེ་དག་ཐམས་ཅད་ཞི་བར་འགྱུར་༎
 pratyaṅgirā vipacyante yo vidyāṃ samatikramet |	གང་ཞིག་རིག་ལས་འགལ་བྱེད་པ་༎ ཡན་ལག་༄༧༨བ་རྣམས་ལ་རྣམ་པར་སྨིན་༎ སོ་སོར་འབྲང་བའི་དམོད་བསྡིགས་ན་༎
 paracakradāruṇā ye 'pi pratyamitrā mahābhayāḥ ||	ཕ་རོལ་འཁོར་ནི་མི་བཟད་དང་༎ འཇིགས་པ་ཆེན་པོ་དགྲ་ཡི་རྣམས་༎
 sarve te pralapaṃ yānti pratisarā sāpatarjitāḥ |	དེ་དག་ཐམས་ཅད་རབ་ཏུ་འབྲོས་༎
 buddhā rakṣanti sarvajñā bodhisatvāś ca pūratāḥ ||	སངས་རྒྱས་ཐམས་ཅད་མཁྱེན་པ་དང་༎ བྱང་ཆུབ་སེམས་དཔའ་དེས་པས་སྲུང་༎
 rakṣanti pratyekabuddhāḥ śrāvakāś ca mahābhayāḥ |	ཉན་ཐོས་དཀའ་ཐུབ་ཆེན་པོ་དང་༎ རང་སངས་རྒྱས་ཀྱིས་སྲུང་བར་འགྱུར་༎
 anye ca bahuvidhā bhūyo devā nāgā mahārddhikāḥ ||	གཞན་ཡང་རྣམ་པ་མང་པོ་ཡི་༎ ལྷ་ཀླུ་རྫུ་འཕྲུལ་ཆེན་པོ་རྣམས་༎ འདི་ལ་རྟག་ཏུ་བརྩོན་བྱེད་པ་༎
 rakṣāṃ kurvanti tasyeme cāsmin yuktasya nityaśaḥ |	དེ་ལ་སྲུང་བ་བྱེད་པར་འགྱུར་༎
 asyāḥ śravaṇamātreṇa vidyārājñā narottamāḥ ||	རིག་པ་ཡི་ནི་རྒྱལ་མོ་འདི་༎ ཐོས་པ་ཙམ་གྱིས་མི་མཆོག་རྣམས་༎
 nirbhayo bhavati sarvatra ity evaṃ munir abravīt |	ཀུན་ཏུ་འཇིགས་པ་མེད་འགྱུར་ཞེས་༎ ཐུབ་པ་ཡིས་ནི་དེ་སྐད་གསུངས་༎
 duḥsvapnā duṣkṛtā ye ca upasargā ye ca dāruṇā || vyādhispṛṣṭā mahārogā ye grastā rājajanmanā |	རྨི་ལམ་ངན་དང་ངན་བྱས་དང་༎ གང་ཡང་ནད་འགོ་མི་བཟད་དང་༎ ནད་ཀྱིས་བཏབ་དང་ནད་ཆེན་གྱིས་༎
 anye ca bahuvidhā rogā gaṇḍalūtāvicarcikāḥ || itayo dāruṇā ye ca grasante mānuṣīṃ prajām |	གང་དག་ཟིན་ཅིང་ཁྲག་སྐྱུག་དང་༎ གཞན་ཡང་རྣམ་པ་མང་པོའི་ནད་༎ འབྲས་དང་ཤུ་བ་སྐམ་པོ་དང་༎ གང་ཡང་གནོད་པ་མི་བཟད་པས་༎
 manuṣyāṇāṃ vināśārthaṃ hiṃsakāś ca sudāruṇāḥ ||	མི་ཡི་སྐྱེ་རྒུ་ཟིན་པ་དང་༎ མི་རྣམས་མ་རུངས་བྱ་བའི་ཕྱིར་༎ མཆོག་ཏུ་མི་བཟད་གནོད་བྱེད་རྣམས་༎
 sarve te pralapaṃ yānti rakṣā yatra mahābalāḥ |	སྲུང་བ་སྟོབས་ཆེན་ག་ལ་བར་༎ དེ་དག་ཐམས་ཅད་མི་འབྱུང་ངོ་༎ འདི་ལས་སྲུང་བ་བྱས་ན་ནི་༎
 anayā kṛtarakṣas tu vadhyaprāpto mucyate ||	བཅིངས་པ་ངག་ཀྱང་གྲོལ་བར་འགྱུར་༎ སོ་སོར་འབྲང་བ་བྲིས་པས་ཀྱང་༎
 yadi grastakālapāśena nītaś cāpi yamālayam |	གལ་ཏེ་དུས་ཀྱི་ཞགས་པ་ཡིས་༎ བཟུང་ནས་གཤིན་རྗེའི་གནས་ཁྲིད་པ་༎
 āyus tasya vivardheta pratisarālikhanād api ||	དེ་ཡི་ཚེ་ནི་རྣམ་པར་འཕེལ་༎
 parikṣīṇāyuṣo yas tu saptāhamṛta eva ca |	གང་ཞིག་ཚེ་ནི་ཟད་གྱུར་ཏམ་༎ ཞག་བདུན་༄༧༩ཨ་༌༎ ན་ནི་འཆི་འགྱུར་བ་༎
 yāval likhitamātreṇa sa jīvati na saṃśayaḥ ||	ཡི་གེ་བྲིས་པའི་བར་ཙམ་གྱིས་༎ འཚོ་བར་གྱུར་ཏེ་ཐེ་ཚོམ་མེད་༎ ཆོ་ག་བཞིན་དུ་སྲུང་བ་བྱས་༎
 atha śravaṇamātreṇa kṛtarakṣā vidhānataḥ |	ཡང་ན་ཐོས་པ་ཙམ་གྱིས་ཀྱང་༎ ཀུན་ཏུ་དགེ་བ་ཐོབ་པར་འགྱུར་༎
 svasti prāpnoti sarvatra sukhaṃ jīvati cepsayā ||	འདོད་པ་བཞིན་དུ་བདེ་བར་འཚོ་༎
 aṣṭaṣaṣṭhisahasrāṇi koṭīniyutaśatāni ca | trāyastriṃśāś ca ye devā sarve śakrapurogamāḥ ||	གང་དག་སུམ་ཅུ་རྩ་གསུམ་ལྷ་༎ སྟོང་ཕྲག་དྲུག་ཅུ་རྩ་བརྒྱད་དང་༎ བྱེ་བ་ཁྲག་ཁྲིག་ཕྲག་བརྒྱ་དང་༎ བརྒྱ་བྱིན་མདུན་ནས་འགྲོ་བ་ཀུན་༎
 rakṣārthaṃ tasya satvasya pṛṣṭhataḥ samupasthitaḥ |	སེམས་ཅན་དེ་ལ་བསྲུང་བའི་ཕྱིར་༎ ཕྱི་བཞིན་འབྲང་ཞིང་གནས་པར་བྱེད་༎
 catvāro lokapālāś ca vajrapāṇir mahābalaḥ ||	འཇིག་རྟེན་སྐྱོང་བ་བཞི་པོ་དང་༎ ལག་ན་རྡོ་རྗེ་སྟོབས་ཆེན་ཡང་༎
 vidyā kulaśataiḥ sārdhaṃ rakṣāṃ kurvanti nityaśaḥ |	རིག་པའི་རིགས་ནི་བརྒྱ་དག་དང་༎ ལྷན་ཅིག་རྟག་ཏུ་སྲུང་བར་བྱེད་༎
 somaḥ sumatāḥ sūryaś ca brahmā viṣṇur maheśvarāḥ ||	ཟླ་བ་ཡིད་བཟང་ཉི་མ་དང་༎ ཚངས་པ་ཁྱབ་འཇུག་དབང་ཕྱུག་ཆེ་༎
 yamaś ca māṇibhadraś ca baladevo mahābalaḥ | pūrṇabhadro mahāvīro hārītī ca saputrikā ||	ནོར་བུ་བཟང་དང་གཤིན་རྗེ་དང་༎ སྟོབས་ཀྱི་ལྷ་ནི་སྟོབས་ཆེན་དང་༎ གང་བ་བཟང་པོ་དཔལ་ཆེན་དང་༎ འཕྲོག་མ་བུ་དང་བཅས་པ་དང་༎ ལྔ་འཛིན་པ་དང་ལྔས་རྩེན་དང་༎ སྨིན་དྲུག་བུ་དང་ཚོགས་དབང་དང་༎ ལྷ་མོ་ཆེན་མོ་དཔལ་ཅན་དང་༎ རྣམ་ཐོས་བུ་དང་དབྱངས་ཅན་དང་༎ དུང་ཅན་དང་ནི་མེ་ཏོག་སོ་༎
 pāñcālaḥ pāñcikaś caiva kārtikeyo gaṇeśvaraḥ | śrīr api ca mahādevī vaiśramaṇaḥ sarasvatī || śaṅkhinī kūṭadantī ca tathaikajaṭāpi ca |	དེ་བཞིན་རལ་པ་གཅིག་པ་དང་༎ གནོད་སྦྱིན་ཆེན་མོ་དཔལ་ཡོན་ཅན་༎
 dhanyā etā mahābhāgā rakṣāṃ kurvanti nityaśaḥ ||	རྟག་ཏུ་སྲུང་བ་བྱེད་པར་འགྱུར་༎
 ṣaṇḍhānāṃ putrajananī garbhasthānavivardhanī |	ཟ་མ་རྣམས་ཀྱི་བུ་ཡང་སྐྱེད་༎ མངལ་ན་གནས་པ་བདེ་བར་བྱེད་༎
 rakṣeyaṃ mahatī cāsya yāvad jīvaṃ bhaviṣyati ||	དེ་ནི་ཇི་སྲིད་འཚོ་བའི་བར་༎ འདི་ནི་སྲུང་བ་ཆེན་པོར་འགྱུར་༎
 narāṇāṃ jayadā nityaṃ yuddhe saṃgrāmabhairave |	འཇིགས་༄༧༩བ་མེད་འཐབ་མོ་ག-ཡུལ་འགྱེད་པར་༎ དཔའ་བོ་རྣམས་ལ་རྟག་རྒྱལ་སྦྱིན་༎
 anayā varadā bhonti devatā dharmaniścitā ||	ཆོས་ལ་ངེས་པའི་ལྷ་རྣམས་ལ་༎ འདིས་ནི་གནང་བ་སྦྱིན་པར་བྱེད་༎
 atha pāpavināśe tu likhanād eva setsyati |	སྡིག་པ་རྣམ་པར་གཞིག་པའི་ཕྱིར་༎ གུས་པར་བྱས་ཏེ་བྲིས་ན་ནི་༎
 tathāgatā vilokyanti bodhisatvās tathaiva ca ||	དེ་བཞིན་གཤེགས་དང་དེ་བཞིན་དུ་༎ བྱང་ཆུབ་སེམས་དཔའང་ལྟ་བར་འགྱུར་༎
 yaśaś ca vardhate tasya puṇyam āyuś ca vardhate |	དེ་ཡི་གྲགས་པ་རྣམ་པར་འཕེལ་༎ བསོད་ནམས་དང་ནི་ཚེ་ཡང་འཕེལ་༎
 dhanadhānyaṃ samṛddhiś ca bhaviṣyati na saṃśayaḥ ||	ནོར་རྣམས་དང་ནི་འབྲུ་དག་ཀྱང་༎ འབྱོར་པར་འགྱུར་ཏེ་ཐེ་ཚོམ་མེད་༎
 sukhaṃ svapiti medhāvī sukhaṃ ca pratibudhyate |	བདེ་བར་གཉིད་ཀྱིས་ལོག་པ་དང་༎ བདེ་བར་རབ་ཏུ་སད་པར་འགྱུར་༎
 adhṛṣyaḥ sarvaśatrūṇāṃ sarvabhūtagaṇair api ||	འབྱུང་པོའི་ཚོགས་རྣམས་ཐམས་ཅད་དང་༎ དགྲ་ཀུན་གྱིས་ཀྱང་མི་རྫིའོ་༎
 saṃgrāme vartamānasya jayo bhavati nityaśaḥ |	ག-ཡུལ་འགྱེད་པ་ཡི་ཚེ་ན་ཡང་༎
 vidyāyāṃ sādhyamānāyām iyaṃ rakṣā anuttarā ||	རིག་པ་སྒྲུབ་པ་བྱས་ན་ནི་༎ སྲུང་བ་བླ་ན་མེད་པ་འདིས་༎ རྟག་ཏུ་རྒྱལ་བར་འགྱུར་བར་བྱེད་༎
 sukhaṃ sādhayate vidyāṃ vighno 'sya na bhaviṣyati |	བདེ་བར་རིག་པ་སྒྲུབ་བྱེད་ཅིང་༎ དེ་ལ་བགེགས་ནི་འབྱུང་མི་འགྱུར་༎
 sidhyanti sarvakalpāś ca praviṣṭaḥ sarvamaṇḍale ||	དེ་ཡིས་བསམ་པ་ཐམས་ཅད་འགྲུབ་༎ དཀྱིལ་འཁོར་ཀུན་ཏུ་ཞུགས་པ་ཡིན་༎
 kṣipraṃ ca samayajño 'sau bhavet sarvatra jātiṣu |	སྐྱེ་བ་དག་ནི་ཐམས་ཅད་དུ་༎ དེ་ནི་མྱུར་དུ་དམ་ཚིག་ཤེས་༎
 vaisvāsikaś ca sa bhavej jinānāṃ guṇadhāraṇaiḥ ||	རྒྱལ་བའི་ཡོན་ཏན་འཛིན་པའི་ཕྱིར་༎ དེ་ནི་ཡིད་བརྟན་འོས་ཡིན་ནོ་༎
 sarvamaṅgalasaṃpannaḥ sarvasiddhir manorathaḥ |	བཀྲ་ཤིས་ཐམས་ཅད་རབ་ཏུ་རྫོགས་༎ བསམ་པ་ཐམས་ཅད་གྲུབ་པར་བྱེད་༎
 asyāṃ likhitamātrāyāṃ sarvasaukhyaṃ samṛdhyati ||	འདི་ནི་བྲིས་པ་ཙམ་གྱིས་ཀྱང་༎ བདེ་བ་ཐམས་ཅད་འབྱོར་པར་འགྱུར་༎
 sukhaṃ kālakriyāṃ kṛtvā bhavet svargaparāyaṇaḥ |	བདེ་བར་འཆི་བའི་དུས་བྱས་ནས་༎ མཐོ་རིས་སུ་ནི་འགྲོ་བར་འགྱུར་༎
 vivāde kalahe caiva vigrahe paramadāruṇe ||	འཐབ་པ་དང་ནི་རྩོད་པ་དང་༎ ༄༨༠ཨ་༌༎ འབྱེད་པ་མཆོག་ཏུ་མི་བཟད་པར་༎
 sarvabhayavinirmukto jinoktavacanaṃ yathā |	འཇིགས་པ་ཀུན་ལས་གྲོལ་འགྱུར་ཏེ་༎ རྒྱལ་བས་ཇི་སྐད་གསུངས་བཞིན་ནོ་༎
 nityaṃ jātismarā bhonti jātau na saṃśayaḥ ||	སྐྱེ་བ་རྣམས་སུ་སྐྱེ་བ་ནི་༎ རྟག་ཏུ་སྐྱེ་དྲན་ཐེ་ཚོམ་མེད་༎
 rājāno vaśagās tasya cāntaḥpuramahājanāḥ |	རྒྱལ་པོ་བཙུན་མོ་འཁོར་བཅས་པ་༎ འདི་ཡི་དབང་དུ་འགྱུར་བ་ཡིན་༎ འཇིག་རྟེན་དགེ་བར་གྲགས་པ་ཡིན་༎ རྟག་ཏུ་ཐུན་མོང་འགྱུར་བ་ཡིན་༎
 sāmātyaś ca bhaven nityaṃ sādhubhir lokasamataiḥ ||	དེ་ནི་ཀུན་ལ་སྡུག་པར་འགྱུར་༎
 sarveṣāṃ ca priyo bhonti ye devā ye ca mānuṣāḥ |	ལྷ་དང་མི་ནི་གང་ཡང་རུང་༎
 rakṣāṃ tasya kariṣyanti divā rātrau ca nityaśaḥ ||	ཉིན་དང་མཚན་རྣམས་རྟག་པར་ཡང་༎ དེ་ལ་སྲུང་བ་བདེ་བར་འགྱུར་༎
 atra mantrapadāḥ siddhāḥ samyaksaṃbuddhabhāṣitāḥ |	ཡང་དག་རྫོགས་པའི་སངས་རྒྱས་གསུངས་༎ སྔགས་ཚིག་འདི་དག་འདིར་འགྲུབ་བོ་༎
 namo buddhāya |	སངས་རྒྱས་ལ་ཕྱག་འཚལ་ལོ་༎
 namo dharmāya |	ཆོས་ལ་ཕྱག་འཚལ་ལོ་༎
 namaḥ saṃghāya ||	དགེ་འདུན་ལ་ཕྱག་འཚལ་ལོ་༎
 namo bhagavate śākyamunaye mahākāruṇikāya tathāgatāyārhate samyaksaṃbuddhāya |	བཅོམ་ལྡན་འདས་དེ་བཞིན་གཤེགས་པ་དགྲ་བཅོམ་པ་ཡང་དག་པར་རྫོགས་པའི་སངས་རྒྱས་ཐུགས་རྗེ་ཆེན་པོ་དང་ལྡན་པ་ཤའཀྱ་ཐུབ་པ་ལ་ཕྱག་འཚལ་ལོ་༎ 
 namaḥ samantebhyaḥ samyaksaṃbuddhebhyaḥ ||	ཡང་དག་པར་རྫོགས་པའི་སངས་རྒྱས་ཐམས་ཅད་ལ་ཕྱག་འཚལ་ལོ་༎
 bhāvanaitāṃ namaskṛtya buddhaśāsanavṛddhaye | aham idānīṃ pravakṣāmi satvānukaṃpayā ||	སངས་རྒྱས་བསྟན་པ་འཕེལ་བྱའི་ཕྱིར་༎ དེ་ལ་གུས་པས་ཕྱག་འཚལ་ནས་༎ སེམས་ཅན་ཀུན་ལ་སྙིང་བརྩེའི་ཕྱིར་༎ ད་ནི་ང་ཡིས་བརྗོད་པར་བྱ༏་༏རིག་པ་གཟི་བརྗིད་ཆེན་མོ་འདི་༎
 imāṃ vidyāṃ mahātejāṃ mahābalaparākramām | yasyāṃ bhāṣitamātrāyāṃ muninā vajrapāśane ||	སྟོབས་ཆེན་ཕ་རོལ་གནོན་པ་སྟེ་༎ རྡོ་རྗེ་གདན་ལ་ཐུག་པ་ཡིས་༎ འདི་ནི་གསུངས་མ་ཐག་ཏུ་ཡང་༎
 mārāś ca mārakāyāś ca grahāḥ sarve vināyakāḥ | vighnāś ca santi ye kecit tatkṣaṇād vilapaṃ gatāḥ ||	བདུད་དང་བདུད་ཀྱི་རིགས་༄༨༠བ་རྣམས་དང་༎ གཟའ་དང་ལོག་པར་འདྲེན་པ་དང་༎ བགེགས་རྣམས་ཇི་སྙེད་གང་ཡོད་པ་༎ ཐམས་ཅད་དེ་ཡི་མོད་ལ་འབྱེར་༎ ཏདྱ་ཐའ་།
 tadyathā | oṃ giri 2 giriṇi 2 girivati guṇavati ākāśavati |	ཨཨོམ་གི་རི་གི་རི་། གི་རི་ནི་གི་རི་ནི་། གི་རི་བ་ཏི་། གུ་ན་བ་ཏི་། ཨའ་ཀའ་ཤ་བ་ཏི་།
 ākāśaviśuddhe |	ཨའ་ཀའ་ཤ་བི་ཤུདདྷེ་། སརབབ་པའ་པམ་བི་ག་ཏེ་།
 ākāśe | gagaṇatale |	ཨའ་ཀའ་ཤ་ག་ག་ན་ཏ་ལེ་།
 ākāśavicāriṇi |	ཨའ་ཀའ་ཤ་བི་ཙ་རི་ནི་།
 jvalitaśikhare |	ཛབ༹འ་ལི་ཏ་ཤི་ཁ་རེ་། མ་ནི་མོཨོ་ག་ཏི་།
 (mp_30) maṇimauktikhacitamaulivare sukeśe |	ཁ་ཙི་ཏ་མོཨོ་ལི་དྷ་རེ་།
 suveśe |	སུ་ཀེ་ཤེ་།
 suvaktre sunetre |	སུ་བཀཏེ༏་སུ་ནེ་ཏྲེ་།
 suvarṇe suvarṇagaure |	སུ་བརནནེ་། སུ་བརྣ་གོཨོ་རེ་།
 atīte |	ཨཨ་ཏའི་ཏེ་།
 anāgate | pratyutpanne | namaḥ sarveṣāṃ buddhānāṃ jvalitatejasām | buddhe subuddhe |	ཨཨ་ནའ་ག་ཏེ་། པྲ་ཏྱུད་པནནེ་ན་མ་།
 bhagavati surakṣaṇi |	ན་མ༔སརབབེ་ཤའམ། བུདདྷའ་ནའན་ཛབ༹་ལ་ཏི་། ཏེ་ཛ་སའམ། བུདདྷེ་།
 sukṣeme suprabhe | sudame sudānte |	སུ་བུདདྷེ་། བྷ་ག་བ་ཏི་། སུ་རུཀཤ་ནི་། སུཀཤ་མེ་།
 vare varade |	སུ་པྲ་ཕེ་། སུ་ད་མེ༏་སུ་དའནཏེ་།
 bhagavati bhadravati |	བ་རེ་བ་རེ་ཏེ་། བྷ་ག་བ་ཏེ་། བྷ་དྲ་བ་ཏི་།
 bhadre subhadre |	བྷ་དྲེ་སུ་བྷ་དྲེ་།
 vimale jayabhadre |	བི་མ་ལེ་། ཛ་ཡ་བྷ་དྲེ་། ཙནདི་ཙནདི་། པྲ་ཙནདེ་། པྲ་ཙནདེ་། བཛྲ་ཙནདེ་། མཧའ་ཙནདེ་། གོཨོ་རི་། གའམ་དྷའ་རི་། གོཨོ་རི་།
 caṇḍe pracaṇḍe |	ཙོཨོ་རི་།
 caṇḍi 2 vajracaṇḍe ghori gandhāri gauri caṇḍāli mātaṅgi varcasi |	ཙནད་ལི༏་མའ་ཏམ་གི་།
 sumati |	བརྩ་སི་།
 pukkasi |	པུཀཀ་སི་། སུ་མ་ཏི་། ཤའ་བ་རི་། ཤའ་བ་རི་།
 śavari śāvari |	ཤམ་ཀ་རི་།
 śaṃkari dramiḍi drāmiḍi raudriṇi |	དྲ་མི་དི་། དརའ་མི་དི་། རོཨོ་དྲི་ནི་། སརྦ་གྲ་ཧ་བི་དའ་རི་ནི་།
 sarvārthasādhani |	སརབབ་ཨཨརཐ་སའ་དྷའ་ནི་༎ པ་ར་མའརཐ་སའ་དྷའ་ནི་། ཧ་ན་ཧ་ན་། སརབབ་ཤ་ཏརའུམ༏་ད་ཧ་ད་ཧ་།
 hana 2 sarvaśatrūn |	སརབབ་དུཤཏའམ། པྲེ་ཏ་བི་ཤ་ཙ་དའ་ཀི་ནའི་ནའི་། མ་ནུམ་ཤའ་། ཨཨ་མ་ནུ་ཤྱ་ནའཉཙ་། པ་ཙ་པ་ཙ་། ཧྲི་ད་ཡན་།
 daha 2 sarvaduṣṭān pretapiśācaḍākinīnāṃ manuṣyāmanuṣyāṇāṃ ca |	གདོན་མ་རུངས་པ་རྣམས་ཀྱི་སྲོག་གཞོམ་དུ་གསོལ་། བཅོམ་ལྡན་འདས་མ་།
 paca 2 hṛdayaṃ vidhvaṃsaya jīvitaṃ sarvaduṣṭagrahāṇāṃ nāśaya sarvapāpāni me bhagavati |	བདག་གི་སྡིག་པ་ཐམས་ཅད་གཞིག་ཏུ་གསོལ་། གཞིག་ཏུ་གསོལ་།
 rakṣa 2 māṃ saparivāraṃ sarvasatvāṃś ca sarvatra sarvadā sarvabhayopadravebhyaḥ sarvaduṣṭānāṃ bandhanaṃ kuru 2 sarvakilbiṣanāśani |	ཐམས་ཅད་དུ་འཇིགས་པ་དང་། གནོད་པ་ཐམས་ཅད་ལས་བདག་ལ་སྲུང་དུ་གསོལ་། སྲུང་དུ་༄༨༡ཨ་༌༎ གསོལ༏་མ་རུངས་པ་ཐམས་ཅད་བཅིང་དུ་གསོལ་། སརབབ་ཀི་ཝི་ཤ་ནའ་ཤ་ནི་། མའརྟནད་། མྲི་ཏྱུ་དནད་ནི་བའ་ར་ནི་མའ་ན་ནི་། དནད་མའ་ན་ནི་། མ་ཧའ་མའ་ན་ནི་། མ་ནི་དྷ་རི་ནི་།
 mārtaṇḍe mṛtyudaṇḍanivāriṇi mānini |	མའརྟ་ད་ནེ་མ་ནི་ནི་མརྟ་ནི་མྲིཏ་དནདེ་།
 cale vicale |	ཙ་ལེ་ཙ་ལེ་བི་མ་ལེ་།
 ciṭi 2 viṭi 2 niṭi nituṭe |	ཙི་ཏི་ཙི་ཏི་། བི་ཏི་བི་ཏི་། ནི་ཏི་ནི་ཏི་། ཏི་ཏི་ཏི་ཏི་། ན་ཏུ་ཏི་།
 ghoriṇi vīriṇi |	གྷ་རི་ནི་གྷ་རི་ནི་། ནི་མི་ནི་། པའི་རི་ནའི་། བའིརྱི་ནི་པྲ་བ་རེ་།
 pravarasavare |	པྲ་བ་ར་ས་མ་རེ་།
 caṇḍāli |	ཙནད་ལི་།
 mātaṅgi |	མའ་ཏམ་གི་།
 rundhasi |	རུནདྷ་སི་།
 varcasi |	ཀ་ར་སི་། ས་རི་། བརྩ་སི་། སུ་མ་ཏི་།
 sumati pukkasi |	བུཀཀ་སི་། ཤ་བ་རི་། ཤའ་བ་རི་།
 śavari śāvari |	ཤམ་ཀ་རི་། དྲ་མི་དི་།
 śaṃkari dramiḍi drāmiḍi |	དྲ་མི་དི་།
 dahani |	ད་ཧ་ནི་།
 pacani pācani |	པ་ཙ་ནི་། མ་ཐ་ནི་།
 mardani |	མརྡ་ནི་།
 sarale 2 saralaṃbhe |	ས་ར་ལི༏་ས་ར་ལེ་། ས་ར་ལམ་བྷེ་།
 hīnamadhyotkṛṣṭavidāriṇi |	ཧའི་ན་མ་དྷྱོད་ཀྲིཤཏ་། བི་དྷའ་ར་ནི་། བི་དྷའ་རི་ནི་།
 mahile 2 mahāmahile |	མ་ཧི་ལེ་། མ་ཧི་ལེ་། མ་ཧའ་མ་ཧི་ལེ་། ནི་ག་ད་།
 nigaḍe 2 nigaḍabhañje |	ནི་ག་ད་། བྷཉཛ་། མཏཏི་།
 matte |	མཏཏེ་། མཏཏི་ནི་། དའནཏི་།
 maṭṭini | dānte |	ཙཀྲེ་།
 cakre cakravākini |	ཙཀྲ་བའ་ཀི་ནི་།
 jvale 2 jvālini |	ཛབ༹་ལེ་ཛབ༹་ལེ་། ཛབ༹འ་ལེ་ཛབ༹འ་ལེ་། ཛབ༹འ་ལ་ནི་། ཤ་བ་རི་ཤ་བ་རི་། ཤའ་བ་རི་ཤའ་བ་རི་།
 śavari śāvari sarvavyādhiharaṇi |	སརབབ་བཡའ་དྷི་ཧ་ར་ནི་། མུ་ནི་མུ་ནི་།
 cūḍi 2 cūḍini 2 mahācūḍini |	ཙའུ་དི་ཙའུ་དི་། ཙའུ་ད་ནི་ཙའུ་ད་ནི་། མ་ཧའ་ཙུ་དི་ནི་།
 nimi 2 nimindhari |	ནི་མི་ནི་མི༏་ནི་མིནདྷ་རི་། ཏྲེཨེ་ལོ་ཀ་།
 trilokadahani |	ད་ཧ་ནི་།
 trilokālokakari | traidhātukavyavalokani |	ཏྲེཨེ་ལོ་ཀ་ཨའ་ལོ་ཀ་ཀ་རི་།
 vajraparaśupāśamuṅgarāsicakratriśūlacintāmaṇimahāvidyādhāriṇi |	ཏྲེཨེ་དྷའ་ཏུ་ཀ་བཡའ་བ་ལོ་ཀི་ནི་། བཛྲེ་། བ་ར་ཤུ་། པའ་ཤ་། མུངྒ་ར་། གངྒ་། ཤམ་ཁ་། ཙཀྲ་། ཏྲི་ཤའུ་ལ་། ཙིནཏའ་མ་ནི་།
 rakṣa 2 māṃ sarvasthānagataṃ sarvaduṣṭabhayebhyaḥ sarvamanuṣyāmanuṣyabhayebhyaḥ sarvabhayebhyaḥ sarvavyādhibhyaḥ |	མ་ཧའ་བིདཡའ་དྷ་ར་ནི་། བདག་ཐམས་ཅད་དུ་གནས་ཐམས་ཅད་ན་གནས་པ་ན་མ་རུངས་པ་ཐམས་ཅད་དང་། མི་དང་མི་མ་ཡིན་པའི་འཇིགས་པ་ཐམས་ཅད་དང་། ༄༨༡བ་ནད་ཐམས་ཅད་དང་། འཇིགས་པ་ཐམས་ཅད་ལས་སྲུང་དུ་གསོལ་། སྲུང་དུ་གསོལ་།
 vajre vajravati vajrapāṇidhare |	བཛྲེ་བཛྲེ་བཛྲ་པ་ཏི་། བཛྲ་པའ་ནི་དྷ་རེ་། ཧི་ལི་ཧི་ལི་།
 hili 2 mili 2 kili 2 cili 2 sili 2 vara 2 varade |	མི་ལི་མི་ལི་། ཀི་ལི་ཀི་ལི་། ཙི་ལི་ཙི་ལ་བི་ལི་བི་ལི་། སི་ལི་སི་ལི་། བ་ར་བ་ར་། བ་ར་དེ་།
 sarvatra jayalabdhe svāhā |	སརབབ་ཏྲ་། ཛ་ཡ་ལབདྷེ་སབ༹འཧའ་།
 sarvapāpavidāriṇi svāhā |	སརབབ་བའ་པམ། བི་དའ་རི་ནི་སབ༹འཧའ་། སརབབ་ཏྲ་།
 sarvavyādhihariṇi svāhā | saṃbharaṇi svāha |	སརབབ་བཡའ་དྷི་ཧ་ར་ན་སབ༹འཧའ་།
 sarvaśatrubhayahariṇi svāhā |	སརབབ་ཏྲ་། སརབབ་ཤ་ཏརའུམ་བྷ་ཡ་ཧར་ནི་སབ༹འཧའ་། སརབབ་བྷ་ར་ནི་སབ༹འཧའ་།
 svastir bhavatu mama sarvasatvānāṃ ca svāhā |	སབ༹སྟི་རབྷ་པ་ཏུ་མའམ་སབ༹འཧའ་།
 śāntiṃkari svāhā |	ཤའནཏིམ་ཀ་རི་སབ༹འཧའ་།
 puṣṭiṃkari svāhā |	པུཤཏིམ་ཀ་རི་སབ༹འཧའ་།
 balavardhani svāhā |	བ་ལ་བརདྷ་རི་ནི་སབ༹འཧའ་། ཛ་ཡ་ཏུ་།
 oṃ jayatu jaye (mp_31)	ཛ་ཡེ་ཛ་ཡེ་། ཛ་ཡ་བ་ཏི་། ཀ་མ་ལེ་།
 jayavati kamale vimale svāhā |	བི་མ་ལེ་།
 vipule svāhā | sarvatathāgatamūrte svāhā |	བི་པུ་ལེ་སབ༹འཧའ༏་སརབབ་ཏ་ཐའ་ག་ཏ་མའུརྟེ་སབ༹འཧའ་།
 oṃ bhūri mahāśānti svāhā |	ཨཨོམ་བྷུ་རི་མ་ཧའ་ཤའནཏི་སབ༹འཧའ་།
 oṃ bhūri 2 vajravati sarvatathāgatahṛdayapūraṇi āyuḥsaṃdhāraṇi | bala 2 balavati jaya vidye hūṃ hūṃ phaṭ phaṭ svāhā | oṃ maṇidhari vajriṇi |	ཨཨོམ་བྷུ་རི་བྷུ་རི་། བཛྲ་པ་ཧི་། སརབབ་ཏ་ཐའ་ག་ཏ་ཧྲི་ད་ཡ་། པའུ་ར་ནི་། ཨའ་ཡུ༔སནདྷ་ར་ནི་། བ་ལ་བ་ལ་། བ་ལ་བ་ཏི་།
 mahāpratisare hūṃ hūṃ phaṭ phaṭ svāhā ||	ཛ་ཡ་བི་ཛྱེ་། ཧའུམ་ཧའུམ་ཕཏ་ཕཏ་སབ༹འཧའ་། བྲམ་ཟེ་ཆེན་པོ་།
 yasya kasyacit mahābrāhmaṇa anayā tathāgatamūrtyā vidyāmantrapadadhāriṇyā rakṣā kṛtā guptiḥ paritrāṇaṃ parigrahaṃ paripālanaṃ śāntiḥ svastyayanaṃ daṇḍaparihāraḥ śastraparihāro viṣadūṣaṇaṃ viṣanāśanaṃ kṛto bhavet |	གང་ལ་ལ་ཞིག་གིས་དེ་བཞིན་གཤེགས་པའི་སྐུ་རིག་པའི་གསང་སྔགས་ཀྱི་གཞི་གཟུངས་འདིས་ཡོངས་སུ་སྲུང་བ་བྱས་ཤིང་ཡོངས་སུ་བསྐྱབ་པ་དང་། ཡོངས་སུ་གཟུང་བ་དང་། ཡོངས་སུ་བསྐྱང་བ་དང་། ཞི་བ་དང་བདེ་ལེགས་སུ་འགྱུར་བ་དང་། དབྱུག་པ་སྤང་བ་དང་། མཚོན་ཆ་སྤང་བ་བྱས་ན་།
 tasya parīkṣīṇām āyuḥ punar eva vivardhate | suciraṃ sukhaṃ jīvati smṛtisaṃpannaś ca bhavati ||	དེ་ཚེ་ཡོངས་སུ་ཟད་པ་ལས་ཀྱང་རྣམ་པར་འཕེལ་ཏེ་རིང་དུ་བདེ་བར་འཚོ་བར་འགྱུར་རོ་༎ དྲན་པ་ཕུན་སུམ་ཚོགས་པར་འགྱུར་རོ་༎
 uccāraṇamātreṇa vajrāvamarjanena vā akālamaraṇāt mahāvyādhibhyaś ca parimucyate |	བསྐྲད་པ་ཙམ་དང་། རྡོ་རྗེས་བྱབས་༄༨༢ཨ་༌༎ པ་ཙམ་གྱིས་དུས་མ་ཡིན་པར་འཆི་བ་དང་། ནད་ཆེན་པོ་ལས་ཡོངས་སུ་ཐར་པར་འགྱུར་རོ་༎
 sarvarogāś cāsya praśāmyanti | dīrghamlānāny avamārjanamātreṇa praśamaṃ gacchanti |	དེའི་ནད་ཐམས་ཅད་ཀྱང་རབ་ཏུ་ཞི་བར་འགྱུར་རོ༏་༏རྒྱུན་རིང་དུ་ན་བ་ལ་ཡང་བྱབས་པ་ཙམ་གྱིས་རབ་ཏུ་ཞི་བར་འགྱུར་རོ་༎
 dine dine svādhyāyaṃ kuryān mahāprājño bhavati |	ཉིན་གཅིག་བཞིན་དུ་ཁ་ཏོན་དུ་བཏོན་ན་། ཤེས་རབ་ཆེན་པོར་འགྱུར་རོ་༎
 ojobalavīryapratibhānasaṃpanno bhavati |	གཟི་བརྗིད་དང༏་སྟོབས་དང་། བརྩོན་འགྲུས་དང་། སྤོབས་པ་ཕུན་སུམ་ཚོགས་པར་འགྱུར་རོ་༎
 sarvakarmāvaraṇāni cāsya niyatavedanīyāni niravaśeyaṃ parikṣayaṃ gacchanti |	དེའི་སྡིག་པ་དང་ལས་ཀྱི་སྒྲིབ་པ་གདོན་མི་ཟ་བར་མྱོང་བར་འགྱུར་བ་ཐམས་ཅད་ཀྱང་མ་ལུས་པར་ཡོངས་སུ་ཟད་པར་འགྱུར་རོ་༎
 sarvabuddhabodhisatvadevanāgayakṣādīni cāsya ojobalavīryaṃ kāye prakṣepsyanti |	སངས་རྒྱས་དང་། བྱང་ཆུབ་སེམས་དཔའ་དང་། ལྷ་དང་། ཀླུ་དང་། གནོད་སྦྱིན་ལ་སོགས་པ་ཐམས་ཅད་ཀྱང་དེའི་ལུས་ལ་གཟི་བརྗིད་དང་། སྟོབས་དང་། བརྩོན་འགྲུས་སྣོན་པར་འགྱུར་རོ་༎
 mahāprītir bahulo bhaviṣyati |	དགའ་བ་ཆེན་པོ་མང་བར་འགྱུར་རོ་༎
 antaśo mahābrāhmaṇa iyaṃ mahāvidyāmantrapadarakṣā tiryagyonigatānām api mṛgapakṣiṇāṃ yeṣāṃ karṇapuṭe vipatite sarve vaivarttikā bhaviṣyanty anuttarāyāṃ samyaksaṃbodhau |	བྲམ་ཟེ་ཆེན་པོ་། ཐ་ན་རིག་པ་ཆེན་མོའི་གསང་སྔགས་ཀྱི་གཞི་འདི་དུད་འགྲོའི་སྐྱེ་གནས་སུ་སོང་བ་རི་དབ༹གས་དང་། བྱའི་རྣ་ལམ་དུ་ཐོས་ན་ཡང་དེ་དག་ཐམས་ཅད་བླ་ན་མེད་པ་ཡང་དག་པར་རྫོགས་པའི་བྱང་ཆུབ་ལས་ཕྱིར་མི་ལྡོག་པར་འགྱུར་དང་། ན་། 
 kaḥ punar vādo ya imāṃ mahāpratisarāṃ dhāraṇīṃ śrāddhaḥ kulaputro vā kuladuhitā vā	སོ་སོར་འབྲང་བ་ཆེན་མོའི་གཟུངས་འདི་ལ་དད་པའི་རིགས་ཀྱི་བུའམ་། རིགས་ཀྱི་བུ་མོའམ་། དགེ་སློང་ངམ་། དགེ་སློང་མའམ་། དགེ་༄༨༢བ་བསྙེན་ནམ་།
 bhikṣur vā bhikṣuṇī vā upāsako vā upāsikā vā rājā vā rājaputro vā rājāmātyo vā brāhmaṇo	དགེ་བསྙེན་མའམ་། རྒྱལ་པོའམ་། རྒྱལ་པོའི་བློན་པོའམ་། བྲམ་ཟེའམ་།
 vā kṣatriyo vā tad anyo vā yaḥ kaścic chrokṣati śrutvā ca mahatyā śraddhayā gauraveṇādhyāśayena	རྒྱལ་རིགས་སམ་། དེ་ལས་གཞན་པ་འགའ་ཞིག་གིས་ལན་གཅིག་ཐོས་ཏེ་། ཐོས་ནས་ཀྱང་དད་པ་ཆེན་པོ་དང་། གུས་པ་དང་། ལྷག་པའི་བསམ་པས་ཡི་གེར་འབྲིའམ་།
 likhiṣyati likhāpayiṣyati dhārayiṣyati vācayiṣyati |	ཡི་གེར་འབྲིར་འཇུག་གམ་། འཆང་ངམ་། ཀློག་གམ་།
 tīvreṇa manasā bhāvayiṣyati |	ཡིད་དྲག་པོས་སྒོམ་མམ་།
 parebhyaś ca vistareṇa saṃprakāśayiṣyati |	གཞན་ལ་རྒྱ་ཆེར་ཡང་དག་པར་རབ་ཏུ་སྟོན་པ་ལྟ་ཅི་སྨོས་ཏེ་།
 tasya mahābrāhmaṇāṣṭau akālamaraṇāni pratikāṃkṣitavyāni na prabhavanti |	བྲམ་ཟེ་ཆེན་པོ་། དེ་ལ་དུས་མ་ཡིན་པར་འཆི་བ་བརྒྱད་རྣམ་པ་ཐམས་ཅད་དུ་འབྱུང་དུ་མ་དོགས་ཤིག་།
 na cāsya kāye mahāvyādhayo bhaviṣyanti |	དེའི་ལུས་ལ་ནད་ཆེན་པོ་རྣམས་འབྱུང་བར་མི་འགྱུར་རོ་༎ དེའི་ལུས་ལ་མེས་མི་ཚུགས་། དུག་གིས་མ་ཡིན་།
 nāgnir na viṣaṃ na śastraṃ na garaṃ (mp_32)	མཚོན་གྱིས་མ་ཡིན་། དུག་སྦྱར་མས་མ་ཡིན་། བྱད་ཀྱིས་མ་ཡིན་། ག-ཡེང་བྱེད་ཀྱིས་མ་ཡིན་། སྔགས་ཀྱི་ལས་ཀྱིས་མ་ཡིན་།
 na kākhordā na kiraṇā na mantrakarmaṇaṃ na cūrṇayogo nāṅgaśūlaṃ na śirovarti ekāhikaṃ dvaitīyakaṃ cāturthakaṃ saptāhikā vā jvālā na kramiṣyanti	ཕྱེ་མའི་སྦྱོར་བས་མ་ཡིན་། ཡན་ལག་ན་བར་མི་འགྱུར་། རིམས་ཀྱིས་བཏབ་པར་མི་འགྱུར་། ཀླད་པ་ན་བ་དང་། ཉིན་གཅིག་པ་དང་། ཉིན་གཉིས་པ་དང་། ཉིན་གསུམ་པ་དང་། ཉིན་བཞི་པ་དང་། ཉིན་བདུན་པའི་རིམས་རྣམས་དེའི་ལུས་ལ་འབྱུང་བར་མི་འགྱུར་རོ་༎
 sa smṛta eva sukhaṃ svastinā svapiti | smṛta eva vibudhyate |	དྲན་བཞིན་དུ་བདེ་བར་གཉིད་ལོག་ཅིང་དྲན་བཞིན་དུ་བདེ་བར་སད་པར་འགྱུར་རོ་༎
 mahāparinirvāṇalābhī bhaviṣyati |	ཡོངས་སུ་མྱ་ངན་ལས་འདས་པ་ཆེན་པོ་ཡང་འཐོབ་པར་འགྱུར་རོ་༎
 sakṛtsahadharmeṇa mahad aiśvaryaṃ cādhigacchanti |	ལན་གཅིག་གིས་ཆོས་དང་ལྡན་པའི་དབང་༄༨༣ཨ་༌༎ ཕྱུག་ཆེན་པོ་ཐོབ་པར་འགྱུར་རོ་༎
 sa yatrayatropapadyate tatratatra jātau jātau jātismaro bhaviṣyati |	དེ་གང་དང་གང་དུ་སྐྱེ་བའི་སྐྱེ་བ་དེ་དང་དེར་སྐྱེ་བ་དྲན་པར་འགྱུར་རོ་༎
 sarvasatvānāṃ ca priyo bhaviṣyati |	སེམས་ཅན་ཐམས་ཅད་ཀྱང་བྱམས་པར་འགྱུར༏་ཕྱག་བྱ་བའི་གནས་སུ་འགྱུར་༎
 vandanīyaś ca pudgalo bhaviṣyati | sarvanarakagatitiryagyonigatigaṇapretopapattibhyaś ca parimukto bhaviṣyati |	སེམས་ཅན་དམྱལ་བ་དང་། དུད་འགྲོའི་སྐྱེ་གནས་ཀྱི་འགྲོ་བ་ཐིབས་པོ་ཀུན་དང་། ཡི་དབ༹གས་སུ་སྐྱེ་བ་རྣམས་ལས་ཡོངས་སུ་ཐར་པར་འགྱུར་རོ་༎
 yathā cārkamaṇḍalaṃ sarvasatvānāṃ tathā raśmyāvabhāsakaro bhaviṣyati |	ཇི་ལྟར་ཉི་མའི་དཀྱིལ་འཁོར་སེམས་ཅན་ཐམས་ཅད་ལ་སྣང་བར་བྱེད་པ་དེ་བཞིན་དུ་འོད་ཟེར་གྱིས་སྣང་བ་བྱེད་པར་འགྱུར་རོ་༎
 yathā candramaṇḍalam amṛtena prabhavatā sarvasatvānāṃ kāyaṃ prahradayati tathā dharmāmṛtena sarvasatvānāṃ cittasantānāni prahradayiṣyati |	ཇི་ལྟར་ཟླ་བའི་དཀྱིལ་འཁོར་བདུད་རྩིའི་མཐུས་སེམས་ཅན་ཐམས་ཅད་ཀྱི་ལུས་སིམ་པར་བྱེད་པ་དེ་བཞིན་དུ་ཆོས་ཀྱི་བདུད་རྩིས་སེམས་ཅན་ཐམས་ཅད་ཀྱི་རྒྱུད་ཚིམ་པར་བྱེད་པར་འགྱུར་རོ་༎
 sarvaduṣṭayakṣarākṣasabhūtapretapiśāconmādāpasmāraḍākinīgrahavighnavināśakādayaḥ sarve 'sya mahāpratisarāyā mahāvidyāyāḥ prabhāvena na śaktā viheṭhanāṃ kartum |	རིག་པའི་རྒྱལ་མོ་ཆེན་མོ་སོ་སོར་འབྲད་བ་ཆེན་མོའི་མཐུས་དེ་ལ་གནོད་སྦྱིན་དང་། སྲིན་པོ་དང་། འབྱུང་པོ་དང་། ཡི་དབ༹གས་དང་། ཤ་ཟ་དང་། སྐེམ་བྱེད་དང་། བརྗེད་བྱེད་དང་། མཁའ་འགྲོ་མ་དང་། གདོན་མ་རུངས་པ་ཐམས་ཅད་དང་། བགེགས་དང་། ལོག་འདྲེན་ལ་སོགས་པ་ཐམས་ཅད་ཀྱིས་གཙེ་བར་མི་ནུས་སོ་༎
 upasaṃkrāmatāṃ ca teṣām iyaṃ mahāvidyārājñī smartavyā |	དེ་དག་འོངས་ན་ཡང་རིག་པའི་རྒྱལ་མོ་ཆེན་མོ་འདི་དྲན་པར་བྱའོ་༎ འོན་ཀྱང་འདི་ལྟ་སྟེ་།
 tatas te sarve duṣṭacittā vidyādharasya vaśyā ājñayā śravaṇavidheyā bhaviṣyanti |	རིག་པའི་རྒྱལ་མོ་ཆེན་མོ་སོ་སོར་འབྲང་བ་ཆེན་མོ་འདི་ཉིད་ཀྱི་མཐུས་མ་རུངས་པ་དེ་དག་ཐམས་ཅད་རིག་པ་འཛིན་པའི་༄༨༣བ་དབང་དུ་འགྱུར་ཏེ་། བསྒོ་བ་བཞིན་དུ་ངག་ཉན་པར་འགྱུར་རོ་༎
 asyā evānubhāvena yad uta mahāpratisarāyā mahāvidyārājño na cāsya śatrubhayaṃ bhaviṣyati |	དེ་ལ་དགའི་འཇིགས་པ་མི་འབྱུང་ངོ་༎
 anatikramanīyaś ca bhaviṣyati | sarvaśatrugaṇai rājamahārājāmātyabrāhmaṇagṛhapatibhiś ca |	དགྲའི་ཚོགས་ཐམས་ཅད་དང་། རྒྱལ་པོ་དང་། རྒྱལ་པོའི་བློན་པོ་དང་། བྲམ་ཟེ་དང་། ཁྱིམ་བདག་རྣམས་ཀྱང་འགལ་བར་བྱེད་པར་མི་འགྱུར་རོ་༎
 antaśo vadhyārho 'pi vadhakapuruṣair ucchritāny api śastrāṇi khaṇḍaṃ khaṇḍaṃ gacchanti pāṃśumayānīva viśīryas tataś ca samaye sarvadharmā asyābhimukhī bhaviṣyanti |	ཐ་ན་གསད་པར་འོས་པ་ཞིག་ལ་གཤེད་མའི་མི་རྣམས་ཀྱིས་མཚོན་གདབ་པར་གཟས་ན་ཡང་མཚོན་རྣམས་རྡུལ་བཞིན་དུ་དུམ་བུ་དུམ་བུར་ཆག་པར་འགྱུར་རོ་༎ དེ་ཉིད་ཀྱི་དུས་ན་དེ་ལ་ཆོས་ཐམས་ཅད་མངོན་སུམ་དུ་འགྱུར་རོ་༎
 mahac cāsya smṛtibalaṃ bhaviṣyanti |	དེའི་དྲན་པའི་སྟོབས་ཀྱང་ཆར་འགྱུར་རོ་༎ འདི་ནི་སྲིན་པོ་འཇོམས་པའི་མཆོག་།
 rakṣoghnaṃ paramaṃ hy etat pavitraṃ pāpanāśanam |	གཙང་ཞིང་སྡིག་པ་འཇིག་པར་བྱེད་༎ དཔལ་དུ་བྱེད་ཅིང་བློ་ཡང་བྱེད་༎
 śrīkaraṃ dhīkaraṃ caiva sarvaguṇavivardhanam ||	ཡོན་ཏན་ཐམས་ཅད་རྣམ་པར་འཕེལ་༎
 sarvamaṅgalakarī hy eṣāṃ sarvāmaṅgalavināśanī |	འདི་ནི་བཀྲ་ཤིས་ཐམས་ཅད་བྱེད་༎ བཀྲ་ཤིས་མ་ཡིན་རྣམ་པར་འཇིག་།
 susvapnadarśanī cāpi duḥsvapnasya vināśanī ||	རྨི་ལམ་བཟང་པོ་རྨི་བར་བྱེད་༎ རྨི་ལམ་ངན་པ་རྣམ་པར་འཇིག་།
 strīpuṃsayoḥ parārakṣāvidyeyaṃ hi mahābalā |	རིག་པ་མཐུ་སྟོབས་ཆེན་མོ་འདི་༎ སྐྱེས་པ་བུད་མེད་སྲུང་བའི་མཆོག་།
 aṭavīkāntāradurgeṣu nityaṃ mucyanti tatkṣaṇāt ||	འབྲོག་དགོན་དང་ནི་མྱ་ངན་ལས་༎ རྟག་ཏུ་དེ་ཡི་མོད་ལ་ཐར་༎ རྫོགས་པའི་སངས་རྒྱས་བཀའ་བཞིན་དུ་༎
 sarvakāmāṃś ca labhate buddhasya vacane yathā ||	འདོད་པ་དག་ནི་ཀུན་ཀྱང་རྙེད་༎
 patha utpatham āpannā eṣāṃ vidyām anusmaret ||	ལམ་ལས་ལམ་གོལ་ཞུགས་ན་ཡང་༎ རིག་པ་འདི་ནི་རྗེས་དྲན་ན་༎
 panthānaṃ labhate śīghraṃ bhojanaṃ pānam uttamam |	མྱུར་དུ་ལམ་དང་བཟའ་བ་དང་༎ བཏུང་བ་མཆོག་ཀྱང་རྙེད་པར་འགྱུར་༎
 karmaṇā manasā vācā yat kṛtaṃ pūrvajanmasu ||	ལུས་དང་ངག་དང་ཡིད་རྣམས་ཀྱིས་༎ མི་དགེ་མང་པོ་གང་ཡང་རུང་༎ ཚེ་རབས་སྔ་མར་ཅི་བྱས་པ་༎
 aśubhaṃ bahuvidhā kiṃcit sarvaṃ kṣayayiṣyati |	༄༨༤ཨ་༌༎ དེ་དག་ཐམས་ཅད་བྱང་བར་འགྱུར་༎
 smaraṇād dhāraṇāc caiva udgrahāl likhanād api || paṭhanād vacanāc caiva jayanāt paradeśanāt |	དྲན་པ་དང་ནི་འཆང་བ་དང་༎ འཛིན་དང་ཡི་གེར་འབྲི་བ་དང་༎ ཚིག་ཏུ་འདོན་ནམ་ཀློག་པ་དང་༎ བཟླས་བརྗོད་བྱེད་དམ་གཞན་སྟོན་ན་༎
 bhaviṣyaty acireṇāsau sarvadharmagatiṃ gataḥ ||	དེ་ནི་རིང་པོར་མི་ཐོགས་པར་༎ ཆོས་ཀུན་རྟོགས་པར་ཁོང་དུ་ཆུད་༎
 evaṃ hi dharmarase prāpte pāpā gacchanti saṃkṣayam |	དེ་ལྟར་ཆོས་ཀྱི་རོ་རྙེད་ན་༎ སྡིག་པ་རྣམས་ནི་ཟད་པར་འགྱུར་༎
 sidhyante sarvakarmāṇi manasā yad yad īpsitam ||	ཡིད་ཀྱིས་ཅི་དང་ཅི་འདོད་པ་༎ དགོས་པ་ཐམས་ཅད་འགྲུབ་པར་བྱེད་༎
 sarvamṛtyubhaye caiṣāṃ trāṇaṃ tasya bhaviṣyati | rājāgnir udakaṃ caiva vidyud vā taskaro 'pi vā ||	འཆི་བའི་འཇིགས་པ་ཐམས་ཅད་དང་༎ རྒྱལ་པོ་དང་ནི་མེ་དང་ཆུ་༎ གློག་དང་དེ་བཞིན་ཀུན་འཇོམས་ལས་༎ འདི་ནི་དེ་ལས་སྐྱོབ་པར་འགྱུར་༎ རིག་པ་འབུམ་དུ་བཟླས་ན་ནི་༎
 yuddhasaṃgrāmakalahā daṃṣṭriṇo ye ca dāruṇāḥ |	ག-ཡུལ་འགྱེད་པ་དང་རྩོད་པ་དང་༎ གང་ཡང་གཅན་གཟན་མ་རུངས་པ་༎
 sarve te pralapaṃ yānti vidyāyā lakṣajāyātaḥ ||	དེ་དག་ཐམས་ཅད་འབྲོས་པར་འགྱུར་༎
 vidyemāṃ paramāṃ siddhāṃ sarvabuddhair hi deśitā |	སངས་རྒྱས་ཀུན་གྱིས་གསུངས་པ་ཡི་༎ དངོས་གྲུབ་མཆོག་གི་རིག་པ་འདི་༎ བརྗོད་ན་སྒྱིད་ལུག་མི་འགྱུར་བར་༎
 kīrtimānā na sīdanti bodhisaṃbhārapūraye || sarveṣu caiva sthāneṣu imāṃ vidyāṃ prayojayet |	བྱང་ཆུབ་ཚོགས་རྣམས་རྫོགས་པར་བྱེད་༎
 yāni cecchanti kāryāṇi svaparārthaprasiddhaye ||	བདག་དང་གཞན་གྱི་དོན་སྒྲུབ་ཕྱིར་༎ གནས་ཀྱི་རྣམ་པ་ཐམས་ཅད་དུ་༎ རིག་པ་འདི་ལ་སྦྱོར་ན་ནི་༎ འདོད་པའི་ལས་རྣམས་གང་ཡིན་པ་༎ སྒྲིམ་མི་དགོས་པར་རིག་འདི་ལས་༎
 sidhyanti ayatnatasthāni vidyāto nātra saṃśayaḥ | namaḥ sarvatathāgatebhyo ye 'pi tiṣṭhanti daśasu dikṣu || oṃ maṇivajre hṛdayavaire mārasainyavidāriṇi hana 2 sarvaśatrūn rakṣa 2 mama śarīraṃ sarvasatvānāṃ ca vajre 2 vajragarbhe 2 | trāsaya 2 sarvamārabhavanāni hūṃ hūṃ phaṭ phaṭ svāhā || buddhamaitrīsarvatathāgatavajrakalpādhiṣṭhite sarvakarmāvaraṇāny apanaya svāhā ||	འགྲུབ་འགྱུར་འདི་ལ་ཐེ་ཚོམ་མེད་༎ ནད་པ་རྣམས་ནི་གསོ་བྱ་བ་༎
 tad idānīṃ pravakṣāmy āturāṇāṃ cikitsānam |	ད་ནི་རབ་ཏུ་བཤད་པར་བྱ་༎
 caturaśraṃ maṇḍalakaṃ kuryāt mṛdgomayasamanvitam ||	ས་དང་ལྕི་བ་བསྲེས་པ་ཡིས་༎ དཀྱིལ་འཁོར་གྲུ་བཞི་ལྷམ་པར་བྱ་༎
 pañcaraṅgikacūrṇena citrayed maṇḍalaṃ śubham |	ཚོན་གྱི་ཕྱེ་མ་སྣ་ལྔ་ཡིས་༎ ༄༨༤བ་དཀྱིལ་འཁོར་སྡུག་གུར་བྲི་བར་བྱ་༎ མཁས་པ་རྣམས་ཀྱིས་ཆོ་ག་བཞིན་༎
 caturaḥ pūrṇakuṃbhāṃś ca sthāpayed vidhinā budhaḥ ||	བུམ་པ་གང་བ་བཞི་ཡང་གཞག་།
 puṣpāṇy avakiret tatra dhūpayed dhūpam uttamam | balikarmaṃ ca kurvīta mahāsāhasrapramardanam ||	དེ་ལ་མེ་ཏོག་སིལ་མས་གཏོར་༎ བདུག་པ་མཆོག་གིས་བདུག་པར་བྱ༏་༏སེམས་ཅན་ཆེན་པོ་གདུལ་བའི་ཕྱིར་༎
 pūrvavad gandhapuṣpādīn dadyāc cātra vidhānataḥ |	གཏོར་མ་ཡིས་ནི་ལས་ཀྱང་བྱ་༎ སྔ་མ་བཞིན་དུ་མེ་ཏོག་སྤོས་༎ ཆོ་ག་བཞིན་དུ་འདི་ལ་མཆོད་༎
 caturas tīrikāḥ sthāpyāḥ sarvāś ca paṭṭabaddhakāḥ ||	དར་གྱིས་བཅིངས་པའི་མདའ་བཞི་ཡང་༎ དཀྱིལ་འཁོར་གྲ་བཞིར་གཟུགས་པར་བྱ་༎ དེ་ཡི་འོག་ཏུ་ནད་པ་ཡང་༎
 sthāpayitvāturaṃ paścāc chucivastrasamāvṛtam |	དྲི་ཞིམ་སྤོས་ཀྱིས་ལུས་བསྐུས་ཏེ་༎
 śubhagandhānuliptāṅgaṃ praveśayet madhyamaṇḍale ||	གཙང་མའི་གོས་རྣམས་བསྐོན་ནས་ནི་༎ དཀྱིལ་འཁོར་དབུས་སུ་གཞག་པར་བྱ་༎ དེ་ནས་ཤར་ཕྱོགས་ཁ་བསྟན་ཏེ་༎ རིག་པ་འདི་ནི་བརྗོད་པར་བྱ་༎
 pūrvāmukhaṃ niṣadyaitāṃ etāṃ vidyāṃ udāharet |	ལན་བདུན་བཟླས་བརྗོད་བྱས་ནས་སུ་༎
 saptaso japtayā cāsya rakṣāṃ kuryād vicakṣaṇaḥ ||	མཁས་པས་དེ་ལ་བསྲུང་བར་བྱ་༎ དེ་ནས་ནད་པའི་དོན་གྱི་ཕྱིར་༎
 āturasya tato 'rthāya vārāṃś cāpy ekaviṃśati |	ལན་གྲངས་ཉི་ཤུ་རྩ་གཅིག་ཏུ་༎ རིག་པ་འདི་ནི་བརྗོད་བྱས་ནས་༎
 udāhared imāṃ vidyāṃ sarvarogopaśāntaye ||	དེ་ནི་ནད་ཀུན་ཞི་བར་འགྱུར་༎ དེ་ནས་གཏོར་མའི་བུམ་པ་ལ་༎
 bhūyaś ca saptavārān vai varikumbhaṃ sumantritam |	ལན་བདུན་ལེགས་པར་སྔགས་ཀྱིས་གདབ་༎ དེ་ནས་བཤོས་ཀྱང་བཤོས་གདབ་སྟེ་༎
 paścān niveśayed mantrī varipuṣpaṃ yathāvidhiḥ ||	གཏོར་མ་མེ་ཏོག་ཆོ་ག་བཞིན་༎
 ity evaṃ dakṣiṇe pārśve prakṣipet sapta eva tu |	དེ་ལྟར་ལྷོ་ཕྱོགས་ངོས་སུ་ནི་༎ ལན་བདུན་ཁོ་ནར་གཏོར་བར་བྱ་༎
 paścimā yāntu saptaiva uttarāyāṃ tathā diśi ||	ནུབ་ཕྱོགས་སུ་ཡང་བདུན་ཉིད་དེ༏་༏བྱང་ཕྱོགས་སུ་ཡང་དེ་བཞིན་ནོ་༎
 adha ūrdhvaṃ tu saptaiva kṛtā rakṣā bhaviṣyati |	འོག་དང་སྟེང་དུའང་ལན་བདུན་ཏེ་༎ སྲུང་བ་བྱས་པར་འགྱུར་བ་ཡིན་༎
 evaṃ kṛte dvijaśreṣṭha sarvaduḥkhāt parimucyate ||	བྲམ་ཟེ་དམ་པ་དེ་ལྟ་བུར་༎ བྱས་ན་སྡུག་བསྔལ་ཀུན་ལས་༄༨༥ཨ་༌༎ གྲོལ༏་༏སྐྱོབ་པ་ཤའཀྱ་སེངྒེ་ཡིས་༎
 eṣā rakṣā mayā khyātā śākyasiṃhena bhāṣitā |	སྲུང་བ་འདི་ནི་ཡང་དག་བཤད་༎
 nāsty asyāḥ parā kācid rakṣā vidyā tridhātuke ||	འདི་མ་གཏོགས་པར་ཁམས་གསུམ་ན་༎ སྲུང་བའི་རིག་པ་གཞན་མེད་དོ་༎
 na tasya mṛtyur na jarā na rogo na ca priyair jātuviyogabhāvaḥ | na cāpriyais tasya hi saṃprayogo bhaved dhiyo bhāvitacittasaṃtatiḥ |	དེ་ནི་མི་འཆི་མི་རྒས་ཏེ་༎ ནད་ཀྱིས་མི་བཏབ་མི་སྡུག་མིན་༎ སྡུག་པ་དང་ནི་འབྲལ་མི་འགྱུར་༎ རིག་པ་འདི་ནི་བདག་གི་ལུས་༎ ཤིན་ཏུ་བསྒོམ་པ་བྱས་ན་ནི་༎ དེ་ལ་འཆི་བདག་ཚོགས་ཀྱིས་མཆོད་༎
 yamo 'pi tasya varadharmarājā kariṣyate pūjāṃ sagauraveṇa |	ཆོས་ཀྱི་རྒྱལ་པོ་དམ་པ་གཤིན་རྗེ་ཡང་༎ གུས་དང་བཅས་པས་དེ་ལ་མཆོད་པར་འགྱུར་༎
 kathayiṣyate devasuraṃ hi gacha kṣaṇikaṃ mamedaṃ narakapurajvāriṃ kariṣyasi |	སྐད་ཅིག་ང་ཡི་སེམས་དམྱལ་འདི་བྱོས་ལ་༎ ལྷ་ཡི་གྲོང་ཁྱེར་སོང་ཞེས་སྨྲ་བར་འགྱུར་༎
 tato vimānaiḥ subahuprakārarir maharddhiko yāti surālayaṃ śubham |	དེ་ནས་གཞལ་མེད་ཁང་པ་རྣམ་མང་པོས་༎ རྫུ་འཕྲུལ་ཆེན་པོ་ལྷ་གནས་བཟང་པོར་འགྲོ་༎
 evaṃ hy asau naramarudyakṣarākṣasaiḥ saṃpūjitas tatra sadā bhaviṣyati |	དེ་ལྟར་དེར་ནི་ལྷ་མི་གནོད་སྦྱིན་དང་༎ སྲིན་པོ་རྣམས་ཀྱིས་དེ་ལ་རྟག་མཆོད་འགྱུར་༎
 vajrapāṇiś ca yakṣendra indra caiva śacīpatiḥ |	ལག་ན་རྡོ་རྗེ་གནོད་སྦྱིན་དབང་༎
 hārītī pāñcikaś caiva lokapālā mahārddhikāḥ ||	བདེ་སོགས་བདག་པོ་དབང་པོ་དང་༎ འཕྲོག་མ་དང་ནི་ལྔས་རྩེན་དང་༎ འཇིག་རྟེན་སྐྱོང་བ་རྫུ་འཕྲུལ་ཆེ་༎
 candrasūryau sanakṣatrau ye grahāḥ paramadāruṇāḥ |	ཟླ་བ་ཉི་མ་རྒྱུ་སྐར་བཅས་༎
 te ca sarve mahānāgā devatā ṛṣayas tathā || asurā garuḍā gandharvāḥ kinnarāś ca mahoragāḥ | nityānubuddhārakṣārthaṃ yasya vidyāmahābalāḥ ||	མཆོག་ཏུ་མི་བཟད་གཟའ་རྣམས་དང་༎ གང་ཡང་ཀླུ་ཆེན་ཐམས་ཅད་དང་༎ ལྷ་དང་དེ་བཞིན་དྲང་སྲོང་དང་༎ ལྷ་མིན་མཁའ་ལྡིང་དྲི་ཟ་དང་༎ མིའམ་ཅི་དང་ལྟོ་འཕྱེ་ཆེ་༎ སྲུང་ཕྱིར་རྟག་ཏུ་འབྲང་བར་བྱེད་༎ གང་གིས་རིག་པ་སྟོབས་ཆེན་མོ་༎
 likhitāṃ dhārayet prājño bāhau baddhvā maharddhikāḥ |	རྫུ་འཕྲུལ་ཆེན་མོ་བྲིས་ནས་ནི་༎ ཤེས་རབ་ཅན་གྱི་ལག་ལ་གདགས་༎ མཆོད་པ་ཆེན་པོ་༄༨༥བ་འཐོབ་པར་འགྱུར་༎
 mahatīṃ labhate pūjāṃ saṃpadaṃ cāpi nityaśa iti ||	རྟག་ཏུ་ཕུན་སུམ་ཚོགས་པར་འོང་༎
