skt	tib
 namo bhagavatyai āryamahāpratisarāyai || natvā pratisarāṃ bhaktyā sarvabuddhābhinanditām |	༄༢༢༤བ་༅་༎ རྒྱ་གར་སྐད་དུ་། ཨའརྱ་མ་ཧའ་པྲ་ཏི་སའ་རའ་ཡེཨེ་བིདཡའ་བི་དྷི་ནའ་མ་། བོད་སྐད་དུ་། འཕགས་མ་སོ་སོར་འབྲང་མ་ཆེན་མོའི་རིག་པའི་ཆོ་ག་ཞེས་བྱ་བ་། འཕགས་མ་སོ་སོར་འབྲང་མ་ཆེན་མོ་ལ་ཕྱག་འཚལ་ལོ་༎ སངས་རྒྱས་ཐམས་ཅད་མངོན་དགའ་བའི་༎ ཕྱག་འཚལ་སོ་སོར་འབྲང་མ་བཤད་༎ སེམས་ཅན་ཐམས་ཅད་རྣམ་འབྱུང་བའི་༎
 vibhūtyai sarvasattvānāṃ taccakraṃ likhyate mayā ||	དེ་ཡི་འཁོར་ལོ་བདག་གིས་བྲི་༎
 śuciḥ samāhitaḥ san balyādikaṃ dattvā nirmuṣṭihastapramāṇāṃ bhūrjatvacaṃ vastraṃ vā samādāya prathamaṃ tāvac caturaṅgulapramāṇaṃ puṭam ekaṃ likhet || tanmadhye 'rdhendubindubhūṣitaṃ hūṃkārāṣṭakaveṣṭitaṃ praiṃkāram |	གཙང་མ་མཉམ་པར་གཞག་ཅིང་གཏོར་མ་ལ་སོགས་བྱིན་ལ་། བསྐུམ་ཁྲུ་གང་གི་ཚད་ཀྱི་གྲོ་གའམ་རས་ལ་སོགས་པའི་གཞི་ལ་། དང་པོ་རེ་ཞིག་སོར་བཞིའི་ཚད་ཀྱི་རིམ་པ་གཅིག་བྲིའོ་༎ དེའི་དབུས་སུ་ཟླ་ཚེས་ཐིག་ལེས་བརྒྱན་པའི་ཧའུམ་བརྒྱད་ཀྱིས་བསྐོར་བའི་པྲམ་ཡིག་གོ་༎
 tanmadhye mantram |	དེའི་ནང་དུ་སྔགས་།
 oṃ maṇidhari vajriṇi mahāpratisare dhārakasya rakṣaṃ śāntipuṣṭiṃ kuru hūṃ 2 phaṭ 2 svāhā || tato bāhye 'rdhāṅgulapuṭadvayam || tatra prathame puṭe mantram oṃ maṇītipūrvakam eva |	ཨཨོམ་མ་ནི་དྷ་རི་བཛྲི་ནི་མ་ཧའ་པྲ་ཏི་སའ་རེ་དྷ་རེ་ཀསྱམ་རཀཤམ་ཀུ་རུ་ཤའནཏི་པུཤཏིམ་ཀུ་རུ་ཧའུམ་ཧའུམ་ཕཏ་ཕཏ་སབ༹འ་ཧའ་། དེའི་ཕྱིར་སོར་ཕྱེད་ཀྱི་རིམ་པ་གཉིས་ལ་། དེ་ལ་དང་པོ་རིམ་པ་གཅིག་གི་སྔགས་ནི་། ཨཨོམ་མ་ནི་ཞེས་པ་སྔར་གྱི་གཅིག་གོ་༎
 dvitīye tathaiva dvidhā |	གཉིས་བ་ནི་དེ་ལྟར་རིམ་པར་བྱའོ་༎
 tato bāhye tryaṅgulapuṭam ekam |	དེའི་ཕྱི་རོལ་དུ་སོར་གསུམ་གྱི་རིམ་པ་གཅིག་གོ་༎
 tatra caturdikṣu catuḥpadmadale rekhādvitaya saṃdhau pūrvādidikkrameṇa mantraṃ likhet ||	དེ་ལ་ཕྱོགས་བཞིར་རི་མོ་གཉིས་པ་པདམ་འདབ་མ་བཞི་པའི་མདུན་ལ་སོགས་པའི་ཕྱོགས་ཀྱི་རིམ་པར་རི་མོ་གཉིས་ཀྱི་མཚམས་སུ་སྔགས་ནི་།
 oṃ vimale vipule jayavare amṛte dhārakasya rakṣāṃ kuru hūṃ 2 phaṭ 2 svāhā || dakṣiṇe ||	༄༢༢༥ཨ་༌་༎ ཨཨོམ་བི་མ་ལེ་བི་པུ་ལེ་ཛ་ཡ་བ་རེ་ཨཨ་མྲི་ཏེ་དྷ་ར་རཀཤ་ཤའནཏིམ་པུཤཏིམ་ཀུ་རུ་ཧའུམ་ཧའུམ་ཕཏ་ཕཏ་སབ༹འ་ཧའ་།
 oṃ amṛtavilokini garbhasaṃrakṣaṇi ākarṣaṇi dhārakasya rakṣāṃ śāntipuṣṭiṃ kuru hūṃ 2 phaṭ 2 svāhā | [mpvv, page 477] paścime ||	ག-ཡས་སུ་ཨཨོམ་ཨཨ་མྲི་ཏེ་བི་ལོ་ཀི་ནི་གརབྷ་སམ་རཀཤ་ནི་ཨའ་ཀརཤ་ནི་དྷ་ར་ར་ཀ་སྱ་རཀཤ་ཤའནཏིམ་པུཤཏིམ་ཀུ་རུ་ཧའུམ་ཧའུམ་ཕཏ་ཕཏ་སབ༹འ་ཧའ་། རྒྱབ་ཏུ་། ཨཨོམ་བྷའ་ར་བྷའ་ར་། སམ་བྷའ་ར་སམ་བྷའ་ར་། ཨཻནདརའི་ཡ་བ་ལ་བི་ཤོ་དྷ་ནི་དྷ་ར་ཀ་སྱ་རཀཤམ་ཤའནཏིམ་པུཤཏིམ་ཀུ་རུ་ཧའུམ་ཧའུམ་ཕཏ་ཕཏ་སབ༹འ་ཧའ་། 
 oṃ bhara 2 saṃbhara 2 indriyabalaviśodhani dhārakasya rakṣāṃ kuru hūṃ 2 phaṭ 2 ruru cale svāhā || uttare || oṃ amṛtavare vara vara pravaraviśuddhe dhārakasya rakṣāṃ śāntipuṣṭiṃ kuru hūṃ 2 phaṭ 2 svāhā ||	ག-ཡོན་དུ་ཨཨོམ་ཨཨ་མྲི་ཏ་བ་རེ་བ་ར་བ་ར་པྲ་བ་ར་བི་ཤུདདྷེ་ར་ཀ་སྱ་རཀཤ་ཤའནཏིམ་པུཤཏིམ་ཀུ་རུ་ཧའམ་ཧའུམ་ཕཏ་ཕཏ་སབ༹འ་ཧའ་།
 dalānāṃ madhye hūṃkārāṣṭakaveṣṭitapraiṃkāramadhye maṇidharītyādi mantraṃ likhet ||	འདབ་མ་རྣམས་ཀྱི་དབུས་སུ་ཧའུམ་ཡིག་བརྒྱད་ཀྱིས་བསྐོར་བའི་པྲམ་ཡིག་གི་ནང་དུ་།
 caturvidikṣu catustriśūkavajrārdhagarbhe āgneyādikoṇakrameṇa mantraṃ likhet ||	ཨཨོམ་མ་ནི་དྷུ་རི་ཞེས་པ་ལ་སོགས་པའི་སྔགས་བྲི་བར་བྱའོ་༏་། ཕྱོགས་བྲལ་བཞིར་རྩེ་གསུམ་པའི་རྡོ་རྗེ་ཕྱེད་པའི་ནང་གི་མེ་ལ་སོགས་པའི་མཚམས་ཀྱི་རིམ་པར་སྔགས་ནི་། 
 oṃ visphoṭavajriṇi dhārakasya rakṣāṃ kuru hūṃ 2 phaṭ 2 svāhā || nairṛtye ||	ཨཨོམ་བི་སཕོ་ཏ་བཛྲི་ནི་དྷ་ར་ཀ་སྱ་རཀཤ་ཤའིནཏམ་པུཤཏིམ་ཀུ་རུ་ཧའུམ་ཧའུམ་ཕཏ་ཕཏ་སབ༹འ་ཧའ་། བདེན་བྲལ་དུ་།
 oṃ amṛtavare dhārakasya rakṣāṃ kuru hūṃ 2 phaṭ 2 svāhā || vāyavye |	ཨཨོམ་ཨཨ་མྲི་ཏ་བའ་རེ་དྷ་ར་ཀ་སྱ་རཀཤམ་ཤའནཏིམ་པུཤཏི་ཀུ་རུ་ཧའུམ་ཧའུམ་ཕཏ་ཕཏ་སབ༹འ་ཧའ་། རླུང་དུ་།
 oṃ vimale dhārakasya rakṣāṃ kuru hūṃ 2 phaṭ 2 svāhā || aiśāne |	ཨཨོམ་བི་མ་ལེ་དྷ་ར་ཀ་སྱ་རཀཤམ་ཤའནཏིམ་པུཤཏིམ་ཀུ་རུ་ཧའུམ་ཧའུམ་ཕཏ་ཕཏ་སབ༹འ་ཧའ་། དབང་ལྡན་དུ་།
 oṃ jayavare dhārakasya rakṣāṃ kuru hūṃ 2 phaṭ 2 svāhā || padmadalatriśūkavajrārdhayor aṣṭasaṃdhiṣu āgneyādidikkrameṇa | oṃ niśumbhavajriṇi dhārakasya rakṣāṃ kuru hūṃ 2 phaṭ 2 svāhā ||	ཨཨོམ་ཛ་ཡ་བའ་རེ་དྷ་ར་ཀ་སྱ་རཀཤམ་ཤའིནཏམ་པུཤཏིམ་ཀུ་རུ་ཧའུམ་ཧའུམ་ཕཏ་ཕཏ་སབ༹འ་ཧའ་། པདམའི་འདབ་མ་དང་རྡོ་རྗེ་ཕྱེད་མ་རྣམས་ཀྱི་མཚམས་བརྒྱད་རྣམས་སུ་། མེའི་ཕྱོགས་ཀྱི་རིམ་པར་སྔགས་ནི་།
 oṃ śumbhavajriṇi dhārakasya rakṣāṃ kuru hūṃ 2 phaṭ 2 svāhā || iti mantradvayam ekāntaritaṃ likhet ||	ཨཨོམ་སུམ་བྷ་བཛྲི་ནི་དྷ་ར་ཀ་སྱ་རཀཤམ་ཤའནཏིམ་པུཤཏིམ་ཀུ་རུ་ཧའུམ་ཧའུམ་ཕཏ་ཕཏ་སབ༹འ་ཧའ་། ཞེས་པའི་སྔགས་གཉིས་སམ་གཅིག་ནང་དུ་བྲི་བར་བྱའོ་༎
 tato bāhye 'rdhāṅgulapramāṇapuṭacatuṣṭayaṃ kuryāt |	དེའི་ཕྱི་རུ་སོར་ཕྱེད་དང་གསུམ་གྱི་ཚད་ལ་རིམ་པ་བཞི་བྱའོ་༎
 tataḥ prathame puṭe hrīḥkārapaṅktim ekāṃ likhet || || dvitīye | [mpvv, page 478] oṃ aparājite mahādevi traṭ | oṃ kālakarṇi kṛt |	དེ་ལ་རིམ་པ་དང་པོ་ལ་ཧརའི༔་ཡི་གེ་ཕྲེང་གཅིག་བྲིའོ་༎ དེའི་ཕྱིའི་རིམ་པ་ལ་། ཨཨོམ་ཨཨ་པ་རའ་ཛི་ཏེ་མ་ཧའ་དེ་བི་ཏྲཏ་།
 oṃ padmakuṇḍali paṃ |	ཨཨོམ་ཀའ་ལ་ཀནད་ཀྲི་ཏ་། པདམ་ཀུནད་ལི་པམ་།
 oṃ puṣpadantini hūṃ ||	ཨཨོམ་པུཤཔ་དནཏི་ནི་ཧའུམ་།
 oṃ maṇyaṅkuśi hūṃ || oṃ vajraśṛṅkhale phuṃ |	ཨཨོམ་མ་ལྱམ་ཀུ་ཤི་ཧའུམ་། ཨཨོམ་བཛྲ་སྲིམ་ཁ་ལེ་ཧའུམ་།
 oṃ śvete vaṃ | oṃ mahāśvete phaṃ | oṃ mahākāli hrīḥ |	ཨཨོམ་ཤབེ༹་ཏེ་བམ་།
 oṃ vajrarati kṛt | oṃ vajrakāli hrīḥ | oṃ vajrapāśi pheḥ |	ཨཨོམ་མ་ཧའ་ཀའ་ལི་ཧརའི༔་ཨཨོམ་བཛྲ་པའ་ནི་ཧེ་།
 oṃ vajrapāśi bhṛt ||	ཨཨོམ་བཛྲ་པའ་ནི་བྲི་ཏ་།
 oṃ vajrapāṇi mahābale dhīḥ |	ཨཨོམ་བཛྲ་པའ་ནི་མ་ཧའ་བ་ལེ་དྷི༔།
 oṃ vajramāle māṃ |	ཨཨོམ་བཛྲ་མའ་ལེ་མམ་། ཨཨོམ་ཨཨ་མྲི་ཏ་ཀུནད་ལ་སབ༹འ་ཧའ་།
 oṃ amṛtakuṇḍali svāhā | oṃ jvala 2 hūṃ phaṭ svaḥ |	ཨཨོམ་ཛབ༹་ལ་ཛབ༹་ལ་ཧའུམ་ཕཏ་སབ༹འ་ཧའ་།
 oṃ ṭakki hūm jaḥ svāhā || || tṛtīye | oṃ cūḍe hrīḥ |	ཨཨོམ་ཏཀཀི་ཧའུམ་ཛ༔་སབ༹འ་ཧའ་། དེའི་ཕྱིའི་རིམ་པ་ལ་ཨཨོམ་ཙུནདི་ཧརའི༔།
 oṃ suvarṇakeśi kṛt ||	ཨཨོམ་སུརནན་ཀེ་ཤི་ཀྲི་ཏ་།
 oṃ piṅgale laṃ ||	ཨཨོམ་པིམ་ག་ལེ་ལམ་།
 oṃ vidyunmālini jaḥ hūṃ |	ཨཨོམ་བི་དྱུནམའ་ལི་ནི་ཛ༔་ཧའུམ་།
 oṃ śāntikari hūṃ | oṃ puṣṭibalavardhani haḥ |	ཨཨོམ་ཤའནཏིམ་ཀ་རི་ཧའུམ་། ཨཨོམ་པུཤཏིམ་བ་ལ་བརྟ་ནི་ཧ༔།
 oṃ śumbhakari hūṃ |	ཨཨོམ་སུམབྷ་ཀ་རི་ཧའུམ་།
 oṃ maṇidhari hūṃ ||	ཨཨོམ་མ་ནི་དྷ་རི་ཧའུམ་།
 oṃ ratnamakuṭamālādhari hrīḥ |	ཨཨོམ་རཏན་མུ་ཀུ་ཏ་། མའ་ལ་དྷ་རི་ཧརའི༔།
 oṃ mahāpratisare praṃ |	ཨཨོམ་མ་ཧའ་པྲ་ཏི་ས་རི་པྲ་།
 oṃ dhuru 2 muru 2 huru 2 meru 2 hūṃ 2 |	ཨཨོམ་དྷུ་རུ་དྷུ་རུ་། མུ་རུ་མུ་རུ་། ཧུ་རུ་ཧུ་རུ་། མེ་རུ་མེ་རུ་། ཧའུམ་ཧའུམ་།
 oṃ balavardhani hoḥ |	ཨཨོམ་བ་ལ་བརདྷ་ནི་༄༢༢༥བ་ཧོ༔།
 oṃ ruru cale hūṃ 2 phaṭ 2 svāhā |	ཨཨོམ་རུ་རུ་ཙ་ལེ་ཧའུམ་ཧའུམ་ཕཏ་ཕཏ་།
 oṃ maṇidhari mahāpratisare dhārakasya rakṣāṃ śāntiṃ puṣṭiṃ kuru hūṃ 2 phaṭ 2 svāhā || || caturthe | oṃ tāre tām aḥ | oṃ muḥ | oṃ āḥ rākṣasy ekajaṭe jnāṃ || oṃ buddhe kṣitike he hūṃ || oṃ kāpālini hūṃ || oṃ laṅkeśvari khaṃ || oṃ dhanye laṃ || oṃ keśini aṃ | oṃ laṅkeśvari muḥ | oṃ hārīti hāṃ hrīṃ || oṃ pāñcike keṃ || oṃ śaṅkhini saṃ kaṭ || oṃ kūṭadantini kaṭ || oṃ śriyādevi śrīḥ |	ཨཨོམ་མ་ནི་དྷ་རི་བཛྲི་ནི་མ་ཧའ་པྲ་ཏི་ས་རེ་དྷའ་ར་ཀ་སཡའ་རཀཤམ་ཤའནཏིམ་པུཤཏིམ་ཀུ་རུ་ཧའུམ་ཧའུམ་ཕཏ་ཕཏ་སབ༹འ་ཧའ་། དེའི་ཕྱིའི་རིམ་པར་ཨཨོམ་ཏ་རེ་ཏའམ་ཨའ༔།
 oṃ sarasvati baṃ | oṃ rakṣa 2 dhārakaṃ [mpvv, page 479] sarvabhayebhyaḥ dhīḥ |	ཨཨོམ་ཨཨོམ་མུ་ཨཨོམ་ཨཨ་རཀཤ་སྱ་ཀ་ཛ་དེཤཏམ་། ཨཨོམ་བུདདྷ་རཀཤ་ཏི་ཀེ་ཧེ་ཧའུམ་། ཨཨོམ་རཀཤ་ར་ཀམ་སརྦ་བྷ་ཡེ་བྱདྷི༔།
 oṃ devi śrīḥ |	ཨཨོམ་དེ་བའི་ཤརའི་། 
 oṃ padme paṃ |	ཨཨོམ་པདམོ་པམ་།
 oṃ maṇidhari vajriṇi hūṃ ||	ཨཨོམ་མ་ནི་དྷ་རི་བཛྲི་ནི་ཧའུམ་།
 oṃ locane lāṃ | oṃ māmaki māṃ |	ཨཨོམ་ལོ་ཙ་ནེ་ལའམ་། ཨཨོམ་མའ་མ་ཀའི་མའམ་།
 oṃ pāṇḍare pāṃ |	ཨཨོམ་པནད་རེ་པམ་།
 oṃ vasudhāre vaṃ ||	ཨཨོམ་བ་སུ་དྷ་རེ་བམ་།
 oṃ kurukulle hrīḥ | oṃ bhṛkuṭi bhṛṃ |	ཨཨོམ་ཀུ་རུ་ཀུལླེ་ཧརའི༔། ཨཨོམ་བྷྲི་ཀུ་ཏི་བྷྲིམ་།
 oṃ bhrūṃ hūṃ bhrūṃ āḥ || || tato bāhye dvyaṅgulapramāṇaṃ puṭam ekaṃ kuryāt ||	ཨཨོམ་བྷརའུམ་ཧའུམ་བྷརའུམ་ཨཨ༔། དེའི་ཕྱི་རུ་སོང་གཉིས་ཀྱི་རིམ་པ་གཅིག་བྱའོ་༎
 tatra ūrdhvaśiraskāny aṣṭacatvāriṃśad vajrāṇi paṅktyā saṃlikhet || vajradvitayasaṃdhau paścimādidikkrameṇa laṃ kṣuṃ kīṃ klūṃ īṃ bhrūṃ phaṃ maḥ khaṃ haḥ yāṃ jrīṃ āṃ hrīḥ rīṃ ḍrīṃ līṃ hīṃ suṃ kraṃ jaḥ dhāṃ proṃ hoḥ hūṃ āḥ phaṭ jaṃ smaṃ laṃ kaṃ baṃ ṛṃ plūṃ treṃ bhoṃ bhraṃ oṃ aṃ bhrāṃ kṣīṃ vīṃ heḥ jīṃ ruṃ rūṃ aṃ saṃ | 48 ||	དེར་མགོ་གྱེན་དུ་བསྟན་པའི་རྡོ་རྗེ་བཞི་བཅུ་རྩ་བརྒྱད་ཀྱི་ཕྲེང་སྐུ་དུ་བྲིའོ་༎ རྡོ་རྗེ་གཉིས་ཀྱི་མཚམས་ནུབ་ལ་སོགས་པའི་ཕྱོགས་ཀྱི་རི་མ་པར་། ལམ་། ཀཤའུམ་། ཀའམ་བྷྲམ་། ཨཻམ་བྷརའུམ་། ཧམ་ཀ༔། ཁམ་ཧ༔། པའམ་ཛའ༔། ཨའམ་། ཧརའི༔། ལའི༔། ཧརའི༔། པུམ་། ཀྲུམ་། ཛ༔། དྷའི་། ཧོ་བྲམ་། ཧའུམ་ཨའ༔། ཕཏ་ཛམ་། སྨམ་མམ་། ཀམ་། བམ་། རམ་། པུམ་། ཏྲེམ་། བྷོཨོམ་། བྷམ་། ཨཨོམ་། ཨཨ་། བྷམ་། ཀཤའིམ་། དྷི་ཧེ༔། ཛམ་། རའུམ་། རའུམ་། ཨཨམ་། སེམ་། ར་།
 tato bāhye tryaṅgulapramāṇaṃ puṭam ekaṃ kuryāt ||	དེའི་ཕྱི་རུ་སོར་གཉིས་ཀྱི་རིམ་པ་གཅིག་གི་ཚད་གཅིག་བྱའོ་༎
 tatra vikasitāṣṭadalasakesarapaṭṭabaddhadaṇḍapadmāni likhed aṣṭacatvāriṃśat ||	དེར་པདམ་བཞི་བཅུ་རྩ་བཞི་འདབ་མ་དང་གེ་སར་རྒྱས་པ་དབྱུག་པ་ལ་དར་དཔྱངས་བཅིངས་པ་བྲི་བར་བྱའོ་༎ 
 tadupari aṣṭacatvāriṃśac cihnāni likhet || cakram | khaḍgam | dhanum | śaram | vajram | mudgaram | dakṣiṇāvartaśaṅkham | vajradhvajam | cintāmaṇiratnam | pāśam | paraśum | triśūlam | aṅkuśam | chatram || padmam | śaktim || 16 || iti triguṇīkṛtya likhet || sarvāṇy akṣarāṇi bāhyaśiraskāni likhanīyānīti ||	དེའི་སྟེང་དུ་མཚན་མ་བཞི་བཅུ་རྩ་བརྒྱད་བྲི་བར་བྱའོ་༎ འཁོར་ལོ་དང་། རལ་གྲི་དང་། གཞུ་དང་། མདའ་དང་། རྡོ་རྗེ་དང་། ཐོ་བ་དང་། ག-ཡས་སྐོར་དུ་དུང་དང་། རྡོ་རྗེ་དང་། རྒྱལ་མཚན་དང་། ཡིད་བཞིན་ནོར་བུ་དང་། ཞགས་པ་དང་། དགྲ་སྟ་དང་། རྟེ་གསུམ་དང་། ལྕགས་ཀྱུ་དང་། གདུགས་དང་། པདམ་དང་། མདུང་ཐུང་ངོ་༎ དེ་རྣམས་སོར་གསུམ་གྱི་ས་ལ་བྲིའོ་༎ ཡི་གེ་ཐམས་ཅད་ཀྱི་མགོ་ཕྱིར་བསྟན་པར་བྲིའོ༎
