skt	tib
 oṃ namo maitreyanāthāya ||	༄༡བ་༅་༎ རྒྱ་གར་སྐད་དུ་། ཨཨ་བྷི་ས་མ་ཡ་ཨཨ་ལམ་ཀའ་ར་ནའ་མ་པྲཛཉའ་པའ་ར་མི་ཏོ་བ་དེ་ཤ་ཤའ་སྟྲ་ཀའ་རི་ཀའ་། བོད་སྐད་དུ་། ཤེས་རབ་ཀྱི་ཕ་རོལ་ཏུ་ཕྱིན་པའི་མན་ངག་གི་བསྟན་བཅོས་dd་མངོན་པར་རྟོགས་པའི་རྒྱན་ཞེས་བྱ་བའི་ཚིག་ལེའུར་བྱས་པ་། སངས་རྒྱས་དང་བྱང་ཆུབ་སེམས་དཔའ་ཐམས་ཅད་ལ་ཕྱག་འཚལ་ལོ་༎
 yā sarvajñatayā nayatyupaśamaṃ śāntaiṣiṇaḥ śravakān yā mārgajñatayā jagaddhitakritāṃ lokārthasaṃpādikā |	ཉན་ཐོས་ཞི་བ་ཚོལ་རྣམས་ཀུན་ཤེས་ཉིད་ཀྱིས་ཉེར་ཞིར་འཁྲིད་མཛད་གང་ཡིན་དང་༎ འགྲོ་ལ་ཕན་པར་བྱེད་རྣམས་ལམ་ཤེས་ཉིད་ཀྱིས་འཇིག་རྟེན་དོན་སྒྲུབ་མཛད་པ་གང་༎
 savārkāramidaṃ vadanti munayo viśvaṃ yayā saṃgatā	གང་དང་ཡང་དག་ལྡན་པས་ཐུབ་རྣམས་རྣམ་པ་ཀུན་ལྡན་སྣ་ཚོགས་འདི་གསུངས་པ་༎
 stasyai śrāvakabodhisattvagaṇino buddhasya manne namaḥ ||	ཉན་ཐོས་བྱང་ཆུབ་སེམས་དཔའི་ཚོགས་བཅས་སངས་རྒྱས་ཀྱི་ནི་ཡུམ་དེ་ལ་ཕྱག་འཚལ་༎
 sarvākārajñatāmārgaḥ śāsitrā yo 'tra deśita | dhīmantī vīkṣīṣīraṃstamanālīḍhaṃ parairiti || abhs_1|1 ||	རྣམ་པ་ཐམས་ཅད་མཁྱེན་ཉིད་ལམ་༎ སྟོན་པས་འདི་རྣམས་བཤད་པ་གང་༎ གཞན་གྱིས་མྱོང་བ་མ་ཡིན་ཏེ་༎
 smṛtau cādhāya sūtrārthaṃ dharmacaryā daśātmikā |	ཆོས་སྤྱོད་བཅུ་ཡི་བདག་ཉིད་ཀྱི་༎ མདོ་དོན་དྲན་པ་ལ་བཞག་ནས་༎ བློ་དང་ལྡན་པས་མཐོང་འགྱུར་ཕྱིར་༎ བདེ་བླག་ཏུ་ནི་རྟོགས་པ་༄༢ཨ་༌་༎
 sūkhena pratipatsīrannityārambhaprayojanam || abhs_1|2 ||	ཞེས་༏་། བྱ་བ་རྩམ་པའི་དགོས་པ་ཡིན་༎
 prajñāpāramitāṣṭābhīḥ padārthaiḥ samudīritā |	ཤེས་རབ་ཕ་རོལ་ཕྱིན་པ་ནི་༎ དངོས་པོ་བརྒྱད་ཀྱིས་ཡང་དག་བཤད་༎
 sarvākārajñatā mārgajñatā sarvajñatā tataḥ || abhs_1|3 ||	རྣམ་ཀུན་མཁྱེན་ཉིད་ལམ་ཤེས་ཉིད་༎ དེ་ནས་ཐམས་ཅད་ཤེས་པ་ཉིད་༎
 sarvākārābhisaṃbodho murdhaprārpto 'nupūrvikaḥ |	རྣམ་ཀུན་མངོན་རྫོགས་རྟོགས་པ་དང་༎ རྩེ་མོར་ཕྱིན་དང་མཐར་གྱིས་པ་༎
 ekakṣaṇabhisaṃbodho dharmakāyaśca te 'ṣṭadhā || abhs_1|4 ||	སྐད་ཅིག་གཅིག་མངོན་རྫོགས་བྱང་ཆུབ་༎ ཆོས་ཀྱི་སྐུ་དང་དེ་རྣམ་བརྒྱད་༎
 cittotpādo 'vavādaśca nirvedhāṅgaṃ caturvidhaṃ |	སེམས་བསྐྱེད་པ་དང་གདམས་ངག་དང་༎ ངེས་འབྱེད་ཡན་ལག་རྣམ་བཞི་དང་༎ སྒྲུབ་པ་ཡི་ནི་རྟེན་གྱུར་པ་༎
 ādhāraḥ pratipatteśca dharmadhātusvabhāvakaḥ || abhs_1|5 ||	ཆོས་ཀྱི་དབྱིངས་ཀྱི་རང་བཞིན་དང་༎ དམིགས་པ་དག་དང་ཆེད་དང་ནི་༎
 ālambanaṃ samuddeśaḥ saṃnāhaprasthitikriye |	གོ་ཆ་འཇུག་པའི་བྱ་བ་དང་༎ ཚོགས་ནི་ངེས་པར་འབྱུང་བཅས་རྣམས་༎
 saṃbhārāśca saniryāṇāḥ sarvākārajñatā muneḥ || abhs_1|6 ||	ཐུབ་པའི་རྣམ་ཀུན་མཁྱེན་པ་ཉིད་༎
 dhyāmīkaraṇatādīni śiṣyakhaṅgapathau ca yau |	མོག་མོག་པོར་བྱེད་ལ་སོགས་དང་༏་། སློབ་མ་བསེ་རུའི་ལམ་གང་དང་༎ འདི་དང་གཞན་པའི་ཡོན་ཏན་གྱིས་༎
 mahānuśaṃso dṛṅmārga aihikāmutrikairguṇaiḥ || abhs_1|7 ||	ཕན་ཡོན་ཆེ་བ་མཐོང་བའི་ལམ་༎
 kāritramadhimuktiśca stutastobhitaśaṃsitāḥ |	བྱེད་པ་དང་ནི་མོས་ཕ་དང་༎ བསྟོད་དང་བཀུར་དང་བསྔགས་པ་དང་༎ བསྔོ་དང་རྗེས་སུ་ཡི་རང་བ་༎
 pariṇāme 'numode ca manaskārāvanuttamau || abhs_1|8 ||	།
 nirhāraḥ śuddhiratyantāmityayaṃ bhāvanāpathaḥ |	བྱ་བ་འདི་ནི་སྒོམ་པའི་ལམ་༎
 vijñānāṃ bodhisattvānāmiti mārgajñatoditā || abhs_1|9 ||	བྱང་ཆུབ་སེམས་དཔའ་མཁས་རྣམས་ཀྱི་༎ ལམ་ཤེས་ཉིད་ནི་དེ་འདྲར་བཤད་༎
 prajñayā na bhave sthānaṃ kṛpayā na śame sthitiḥ |	ཤེས་པས་སྲིད་ལ་མི་གནས་ཤིང་༎
 anupāyena dūratvamupāyenāvidūratā || abhs_1|10 ||	སྙིང་རྗེས་ཞི་ལ་མི་གནས་དང་༎ ༄༢བ་ཐབས་མ་ཡིན་པས་རིང་བ་དང་༎ ཐབས་ཀྱིས་རིང་བ་མ་ཡིན་ཉིད་༎
 vipakṣapratipakṣau ca prayogaḥ samatāsya ca | dṛṅmārgaḥ śrāvakādīnāmiti sarvajñateṣyate || abhs_1|11 ||	མི་མཐུན་གཉེན་པོའི་ཕྱོགས་དག་དང་༎ སྦྱོར་དང་དེ་ཡི་མཉམ་ཉིད་དང་༎ ཉན་ཐོས་ལ་སོགས་མཐོང་བའི་ལམ་༎ དེ་འདྲ་ཀུན་ཤེས་ཉིད་དུ་འདོད་༎
 ākārāḥ saprayogāśca guṇā doṣāḥ salakṣaṇāḥ |	རྣམ་པ་སྦྱོར་བར་བཅས་རྣམས་དང་༎ ཡོན་ཏན་སྐྱོན་ནི་མཚན་ཉིད་བཅས་༎
 mokṣanirvedhabhāgīye śaikṣo 'vaivartiko gaṇaḥ || abhs_1|12 ||	ཐར་དང་ངེས་འབྱེད་ཆ་མཐུན་དང་༎ སློབ་པ་ཕྱིར་མི་ལྡོག་པའི་ཚོགས་༎
 samatābhavaśāntyośca kṣetraśuddhiranuttarā |	སྲིད་དང་ཞི་བ་མཉམ་ཉིད་དང་༎ ཞིང་དག་བླ་ན་མེད་པ་ནི་༎
 sarvākārābhisaṃbodha eṣa sopāyakauśalaḥ || abhs_1|13 ||	རྣམ་ཀུན་མངོན་རྫོགས་པ་སྟེ་༎ འདི་ནི་ཐབས་མཁས་བཅས་པ་ཡིན་༎
 liṅgaṃ tasya vivṛddhiśca nirūḍhiścittasaṃsthitiḥ |	དེ་ཡི་རྟགས་དང་རྣམ་འཕེལ་དང༎ བརྟན་དང་སེམས་ཀུན་གནས་པ་དང་༎ མཐོང་ཞེས་བྱ་དང་སྒོམ་པ་ཞེས་༎ བྱ་བའི་ལམ་ནི་སོ་སོ་ལ་༎
 caturdhā ca vikalpasya pratipakṣaścaturvidhaḥ || abhs_1|14 || pratyekaṃ darsanākhye ca bhāvanākhye ca vartmani |	རྣམ་པར་རྟོག་པ་རྣམ་བཞི་ཡི་༎ གཉེན་པོ་རྣམ་པ་བཞི་དང་ནི་༎
 ānantaryasamādhiśca saha vipratipattibhiḥ || abhs_1|15 ||	བར་ཆད་མེད་པའི་ཏིང་ངེ་འཛིན་༎ ལོག་པར་སྒྲུབ་དང་བཅས་པ་ནི་༎
 mūrdhābhisamayaḥ tredhā daśadhā cānupūrvikaḥ |	རྩེ་མོའི་མངོན་རྟོགས་མཐར་གྱིས་པ་༏་། རྣམ་གསུམ་རྣམ་བཅུ་སྐད་ཅིག་མ་༎
 ekakṣaṇābhisaṃbodho lakṣaṇena caturvidhiḥ || abhs_1|16 ||	གཅིག་གིས་མངོན་རྫོགས་བྱང་ཆུབ་པ་༎ མཚན་ཉིད་ཀྱིས་ནི་རྣམ་པ་བཞི་༎
 svābhāvikaḥ sasāṃbhogo nairmāṇiko 'parastathā |	ངོ་བོ་ཉིད་ལོངས་རྫོགས་བཅས་པ་དང་༎ དེ་བཞིན་གཞན་པ་སྤྲུལ་པ་ནི་༎
 dharmakāyaḥ sakāritraścaturdhā samudīritaḥ || abhs_1|17 ||	ཆོས་སྐུ་མཛད་པ་དང་བཅས་པ་༎ རྣམ་པ་བཞིར་ནི་ཡང་དག་བརྗོད་༎
 cittotpādaḥ parārthāya sammyaksaṃbodhikāmatā |	སེམས་བསྐྱེད་པ་ནི་གཞན་དོན་ཕྱིར་༎ ཡང་དག་རྫོགས་པའི་བྱང་ཆུབ་འདོད་༎ དེ་དང་དེ་ནི་མ་དོ་བཞིན་དུ་༎
 samāsavyāsataḥ sā ca yathāsutraṃ sa cocyate || abhs_1|18 ||	བསྡུས་དང་རྒྱས་པའི་སྒོ་ནས་བརྗོད་༎ དེ་ཡང་ས་གསེར་ཟླ་བ་མེ་༎
 bhūhemacandrajvalanairnidhiratnākarārṇavaiḥ |	གཏེར་དང་རིན་ཆེན་འབྱུང་གནས་མཚོ་༎
 vajrācalauṣadhīmitraiścintāmaṇyarkagītibhiḥ || abhs_1|19 ||	རྡོ་རྗེ་རི་སྨན་བཤེས་གཉེན་དང་༎ ཡིད་བཞིན་ནོར་བུ་ཉི་མ་གླུ་༎ རྒྱལ་པོ་མཛོད་དང་ལམ་པོ་ཆེ་༎ བཞོན་པ་བཀོད་མའི་ཆུ་དང་ནི་༎
 nṛpagañjamahāmārgayānaprasravaṇodakaiḥ |	སྒྲ་བརྙན་ཆུ་བོ་སྤྲིན་རྣམས་ཀྱིས་༎
 ānandoktinadīmeghairdvāviṃśatividhaḥ sa ca || abhs_1|20 ||	རྣམ་པ་ཉི་ཤུ་རྩ་གཉིས་སོ་༎
 pratipattau ca satyeṣu buddharatnādiṣu triṣu |	སྒྲུབ་དང་བདེན་པ་རྣམས་དང་ནི་༎ སངས་རྒྱས་ལ་སོགས་དཀོན་མཆོག་གསུམ་༎
 asaktāvapariśrāntau pratipatsaṃparigrahe || abhs_1|21 ||	མ་ཞེན་ཡོངས་སུ་མིང་ལ་དང༎
 cakṣuḥṣu pañcasu jñeyaḥ ṣaṭsvabhijñāguṇeṣu ca |	ལམ་ནི་ཡོངས་སུ་འཛིན་པ་དང་༎ སྤྱན་ལྔ་དང་ནི་མངོན་ཤེས་ཀྱི་༎
 dṛṅmārge bhāvanākhye cetyavavādo daśātmakaḥ || abhs_1|22 ||	ཡོན་ཏན་དྲུག་དང་མཐོང་ལམ་དང་༎ བསྒོམ་ཞེས་བྱ་ལ་གདམས་ངག་ནི་༎ བཅུ་ཡི་བདག་ཉིད་ཤེས་པར་བྱ་༎
 mṛdutikṣṇendriyau śraddhādṛṣṭiprāptau kulaṃkulau |	དབང་པོ་རྟུལ་དང་རྣོན་པོ་དང་༎ དད་དང་མཐོང་ཐོབ་རིགས་ནས་རིགས་༎ བར་ཆད་གཅིག་པར་༄༣ཨ་༌་༎
 ekavīcyantarotpadya kārākārākaniṣṭhagāḥ || abhs_1|23 ||	སྐྱེས་ནས་དང་༎ བྱེད་དང་བྱེད་མིན་འོག་མིན་འགྲོ་༎
 plutāstrayo bhavasyāgraparamo rūparāgaha |	འཕར་གསུམ་སྲིད་རྩེའི་མཐར་ཐུག་འགྲོ་༎ གཟུགས་ཀྱི་ཆགས་བཅོམ་ལྡན་མཐོང་བ་ཡི་༎
 dṛṣṭadharmaśamaḥ kāyasākṣī khaṅgaśca viṃśatiḥ || abhs_1|24 ||	ཆོས་ལ་ཞི་ལུས་མངོན་སུམ་བྱེད་༎ བསེ་རུ་དང་ནི་ཉི་ཤུའོ་༎
 ālambanata ākārāddhetutvātsaṃparigrahāt |	དམིགས་པ་དང་ནི་རྣམ་པ་དང་༎ སྐྱུ་དང་ཡོངས་སུ་འཛིན་པ་ཡིས་༎ བྱང་ཆུབ་སེམས་དཔའ་སྐྱོབ་པ་ཡི་༎ དྲོད་སོགས་བདག་ཉིད་ཇི་བཞིན་དུ་༎
 caturvikalpasaṃyogaṃ yathāsvaṃ bhajatāṃ satām || abhs_1|25 || śrāvakebhyaḥ sakhaḍgebhyo bodhisattvasya tāyinaḥ |	རྣམ་རྟོག་བཞི་པོ་ལྡན་བརྟེན་པ་༎
 mṛdumadhyādhimātrāṇāmūṣmādīnāṃ viśiṣṭatā || abhs_1|26 ||	ཆུང་དང་འབྲིང་དང་ཆེན་པོ་རྣམས་༎ ཉན་ཐོས་བསེ་རུ་ལྟ་བུ་དང་༎ བཅས་པ་དག་ལས་ཁྱད་པར་འཕགས་༎
 ālambanamanityādi satyādhāraṃ tadākṛtiḥ |	དམིགས་པ་མི་རྟག་ལ་སོགས་པ་༎ བདེན་པའི་རྟེན་ཅན་དེ་ཡི་ནི་༎ རྣམ་པ་མངོན་ཞེན་ལ་སོགས་འགོག་། 
 niṣedho 'miniveśāderheturyānatrayāptaye || abhs_1|27 ||	ཐེག་པ་གསུམ་ཆར་འཐོབ་པའི་རྒྱུ་༎
 rūpādyāyavyayau viṣṭhāsthitī prajñaptyavācyate |	གཟུགས་སོགས་འདུ་འགོད་གནས་བྲལ་དང་༎ གནས་དང་བརྟགས་དང་བརྗོད་དུ་མེད་༎
 rūpādāvasthitisteṣāṃ tadbhāvenāsvabhāvatā || abhs_1|28 ||	གཟུགས་སོགས་མི་གནས་དེ་དག་ནི་༎ དེ་ཡི་ངོ་བོ་རང་བཞིན་མེད་༎
 tayormithaḥsvabhāvatvaṃ tadanityādyasaṃsthitiḥ |	།
 tāsāṃ tadbhāvaśūnyatvaṃ mithaḥ svabhāvyametayoḥ || abhs_1|29 ||	དེ་རྣམས་དེ་ཡི་ངོ་བོས་སྟོང་༎ དེ་དག་གཅིག་གི་རང་བཞིན་གཅིག་། 
 anudgraho yo dharmāṇāṃ tannimittāsamīkṣaṇam |	ཆོས་རྣམས་མི་འཛིན་གང་ཡིན་དང་༎ དེ་དག་མཚན་མར་མཐོང་ཕྱིར་༎
 parīkṣaṇaṃ ca prajñāyāḥ sarvasyānupalambhataḥ || abhs_1|30 ||	ཤེས་རབ་ཀྱིས་ནི་ཡོངས་རྟོགས་པ་༎ ཐམས་ཅད་དམིགས་སུ་མེད་པར་རོ་༎
 rūpāderasvabhavāvatvaṃ tadabhāvasvabhāvatā |	གཟུགས་སོགས་ངོ་བོ་ཉིད་མེད་ཉིད་༎ དེ་མེད་པ་ཉིད་ངོ་བོ་ཉིད་༎ དེ་དག་སྐྱེ་མེད་ངེས་འབྱུང་མེད་༎
 tadajātiraniryāṇaṃ śuddhistadanimittatā || abhs_1|31 ||	དག་དང་དེ་དག་མཚན་མ་མེད་༎ དེ་ཡི་མཚན་མར་མི་བརྟེན་པས་༎
 tannimittānadhiṣṭhānānadhimuktirasaṃjñatā |	མོས་མིན་འདུ་ཤེས་མེད་པ་ཡིན་༎
 samādhistasya kāritraṃ vyākṛtirmananākṣayaḥ || abhs_1|32 ||	ཏིང་འཛིན་དེ་ཡི་བྱེད་པ་ཉིད་༎ ལུང་སྟོན་པ་དང་རློམ་པ་ཟད་༎ གསུམ་པོ་ཕན་ཚུན་ངོ་བོ་གཅིག་། 
 mithastrikasya svābhāvyaṃ samādheravikalpanā |	ཏིང་འཛིན་རྣམ་པར་མི་རྟོག་པ་༎
 iti nirvedhabhāgīyaṃ mṛdumadhyādhimātrataḥ || abhs_1|33 ||	དེ་ལྟར་ངེས་འབྱེད་ཆ་མཐུན་ནི་༎ ཆུང་དང་འབྲིང་དང་ཆེན་པོ་ཡིན་༎ གཞིག་དེ་ཡི་གཉེར་པོ་ཡིས་༎
 dvaividhyaṃ grāhyakalpasya vastutatpratipakṣataḥ |	གཟུགས་བར་རྟོག་པ་རྣམ་པ་གཉིས་༎
 moharāśyādibhedena pratyekaṃ navadhā tu saḥ || abhs_1|34 ||	རྨོངས་དང་ཕུང་སོགས་བྱེ་བྲག་གིས་༎ དེ་ནི་སོ་སོར་རྣམ་པ་དགུ་༎
 dravyaprajñaptyadhiṣṭhāno dvividho grāhako mataḥ |	རྫས་དང་བརྟགས་པའི་རྟེན་ཅན་གྱིས་༎ འཛིན་པའང་རྣམ་གཉིས་སུ་འདོད་༎
 svatantrātmādirūpeṇa skandhādyāśrayatastathā || abhs_1|35 ||	རང་དབང་བདག་སོགས་ངོ་བོ་དང་༎ ཕུང་སོགས་རྟེན་ལས་དེ་བཞིན་ནོ་༎ སེམས་མི་འགོང་བ་ཉིད་ལ་སོགས་༎
 cittānavalīnatvādi naīḥsvābhāvyādideśakaḥ |	ངོ་བོ་ཉིད་མེད་སོགས་སྟོན་བྱེད་༎
 tadvipakṣaparityāgaḥ sarvathā saṃparigrahaḥ || abhs_1|36 ||	དེ་ཡི་མི་མཐུན་༄༣བ་ཕྱོགས་བོར་བ་༎ རྣམ་པ་ཀུན་ཏུ་ཡོངས་འཛིན་ཡིན་༎
 ṣoḍhādhigamadharmasya pratipakṣaprahāṇayoḥ | tayoḥ paryupayogasya prajñāyāḥ kṛpayā saha || abhs_1|37 || śiṣyāsādhāraṇatvasya parārthānukramasya ca |	རྟོགས་པ་ཡིན་ནི་ཆོས་དྲུག་དང་༎ གཉེན་པོ་དང་ནི་སྤོང་བ་དང་༎ དེ་དག་ཡོངས་སུ་གཏུགས་པ་དང་༎ ཤེས་རབ་སྙིང་བརྩེར་བཅས་པ་དང་༎ སློབ་མ་མཐུན་མོང་མིན་ཉིད་དང་༎ གཞན་གྱི་དོན་གྱི་གོ་རིམས་དང་༎ ཡེ་ཤེས་རྩོལ་བ་མི་མའང་བར་༎
 jñānasyāyatnavṛtteśca pratiṣṭhā gotramucyate || abhs_1|38 ||	འཇུག་པའི་རྟེན་ལ་རིགས་ཤེས་བྱ་༎
 dharmadhātorasaṃbhedādgotrabhedo na yujyate |	ཆོས་ཀྱི་དབྱིངས་ལ་དབྱེར་མེད་ཕྱིར་༎ རིགས་ནི་ཐ་དད་རུང་མ་ཡིན་༎
 ādheyadharmabhedāttu tadbhedaḥ parigīyate || abhs_1|39 ||	རྟེན་པའི་ཆོས་ཀྱི་བྱེ་བྲག་གིས་༎ དེ་ཡི་དབྱེ་བ་ཡོངས་སུ་བརྗོད་༎
 ālambanaṃ sarvadharmāste punaḥ kuśalādayaḥ |	དམིགས་པ་ཆོས་རྣམས་ཐམས་ཅད་དེ་༎ དེ་ཡང་དགེ་ལ་སོགས་པ་ཡིན་༎
 laukikādhigamākhyāścaṃ ye ca lokettarā matāḥ || abhs_1|40 || sāsravānāsravā dharmāḥ saṃskṛtāsaṃskṛtāśca ye |	འཇིག་རྟེན་པ་ཡི་རྟོགས་པ་དང་༎ གང་དག་འཇིག་རྟེན་འདས་འདོད་དང་༎ ཟག་བཅས་ཟག་པ་མེད་ཆོས་དང་༎ གང་དག་འདུས་བྱས་འདུས་མ་བྱས་༎
 śiṣyasādhāraṇā dharmā ye cāsādhāranā muneḥ || abhs_1|41 ||	སློབ་མཐུན་མོང་ཆོས་རྣམས་དང་༎ གང་དག་ཐུབ་པའི་ཐུན་མོང་མིན་༎
 sarvasattvāgratā cittaprahāṇādhigamatraye |	སེམས་ཅན་ཀུན་མཆོག་ཉིད་སེམས་དང་༎ སྤངས་དང་རྟོགས་དང་གསུམ་པོ་ལ་༎ ཆེན་པོ་གསུམ་གྱི་རང་བྱུང་གི་། 
 tribhirmahattvairūddeśo vijñeyo 'ya svayaṃbhuvām || abhs_1|42 ||	ཆེད་དུ་བྱ་བ་འདི་ཤེས་བྱ་༎
 dānādau ṣaḍvidha teṣāṃ pratyekaṃ saṃgraheṇa yā |	དེ་དག་སོ་སོར་སྦྱིན་ལ་སོགས་༎ རྣམ་པ་དྲུག་ཏུ་བསྡུས་པ་ཡིས་༎
 saṃnāhapratipattiḥ sā ṣaḍbhiḥ ṣaṭkairyathodithā || abhs_1|43 ||	གོ་ཆའི་སྒྲུབ་པ་གང་ཡིན་དེ་༎ དྲུག་ཚན་དྲུག་གིས་ཇི་བཞིན་བཤད་༎
 dyānārūpyeṣu dānādau mārge maitryādikeṣu ca | gatopalambhayoge ca trimaṇḍalaviśuddhiṣu || abhs_1|44 ||	བསམ་གཏན་གཟུགས་མེད་སྤྱིན་སོགས་དང་༎ ལམ་དང་བྱམས་ལ་སོགས་པ་དང་༎ དམིགས་པ་མེད་དང་ལྡན་པ་དང་༎ འཁོར་གསུམ་རྣམ་པར་དག་པ་དང་༎ ཆེད་དུ་བྱ་དང་མངོན་ཤེས་དྲུག་། 
 uddeśe ṣaṭsvabhijñāsu sarvākārajñatānaye |	རྣམ་ཀུན་མཁྱེན་པའི་ཚུལ་ལ་ནི་༎
 prasthānapratipajjñeyā mahāyānādhirohiṇī || abhs_1|45 ||	འཇུག་པའི་སྒྲུབ་པ་ཐེག་ཆེན་ལ་༎ འཛེགས་པ་ཡིན་པར་ཤེས་པར་བྱ་༎
 dayā dānādikaṃ ṣaṭkaṃ śamathaḥ savidarśanaḥ |	བརྩེ་དང་སྤྱིན་ལ་སོགས་པ་དྲུག་། 
 yuganaddhaśca yo mārga upāye yacca kauśalam || abhs_1|46 || jñānaṃ puṇyaṃ ca mārgaśca dhāraṇī bhūmayo daśa |	ཞི་གནས་ལྷ་ག་མཐོང་བཅས་པ་དང་༎ ཟུང་དུ་འབྲེལ་བའི་ལམ་གང་དང་༎ ཐབས་ལ་མཁས་པ་གང་ཡིན་དང་༎ ཡེ་ཤེས་དང་ནི་བསོད་ནམས་དང་༎ ལམ་དང་གཟུངས་དང་ས་བཅུ་དང་༎ གཉེན་པ་ཚོགས་ཀྱི་སྒྲུབ་པ་ཡི་༎
 pratipakṣaśca vijñeyaḥ saṃbhārapratipatkramaḥ || abhs_1|47 ||	རིམ་པ་ཡིན་པར་ཤེས་པར་བྱ་༎
 labhyate prathamā bhumirdaśadhā parikarmaṇā |	ཡོངས་སུ་སྤྱོང་བ་རྣམ་བཅུ་ཡིས་༎ ས་ནི་དང་པོ་འཐོབ་འགྱུར་ཏེ་༎
 āśayo hitavastutvaṃ sattveṣu samacittatā || abhs_1|48 ||	བསམ་དང་ཕན་པའི་དངོས་ཉིད་དང་༎ སེམས་ཅན་རྣམས་ལ་སེམས་མཉམ་ཉིད་༎ གཏོང་དང་བཤེས་གཉེན་༄༤ཨ་༌་༎
 tyāgaḥ sevā ca mitrāṇāṃ saddharmālambanaiṣaṇā | sadā naiṣkramyacittatvaṃ buddhakāyagatā spṛhā || abhs_1|49 ||	བསྟེན་པ་དང་༎ དམ་ཆོས་དམིགས་པ་ཚོལ་བ་དང་༎ རྟག་ཏུ་ངེས་འབྱུང་སེམས་ཉིད་དང་༎ སངས་རྒྱས་སྐུར་འདོད་དགའ་བ་དང་༎ ཆོས་སྟོན་པ་དང་བདེན་པ་ཡི་༎
 dharmasya deśanā satyaṃ daśamaṃ vākyamiṣyate |	ཚིག་ནི་བཅུ་པ་ཡིན་པར་འདོད་༎
 jñeyam ca pārikarmaiṣāṃ svabhāvānupalambhataḥ || abhs_1|50 ||	འདི་དག་རང་བཞིན་མི་དམིགས་པས་༎ ཡོངས་སུ་སྦྱོང་བར་ཤེས་པར་བྱ་༎
 śīlaṃ kṛtajñatā kṣāntiḥ pramodyaṃ mahatī kṛpā |	ཚུལ་ཁྲིམས་བྱས་པ་གཟོ་དང་བཟོད་༎ རབ་ཏུ་དགའ་དང་སྙིང་བརྩེ་ཆེ་༎
 gauravaṃ guruśuśrūṣā vīryaṃ dānādike 'ṣṭamam || abhs_1|51 ||	བཀུར་སྟི་བླ་མ་ལ་གུས་ཉན་༎ བརྒྱད་པ་སྤྱིན་ལ་སོགས་ལ་བརྩོན་༎
 atṛptatā śrute dānaṃ dharmasya ca nirāmiṣam |	ཐོས་པ་མི་ངོམས་ཉིད་དང་ནི་༎
 buddhakṣetrasya saṃśuddhiḥ saṃsārāparikheditā || abhs_1|52 ||	ཟང་ཟིང་མེད་པར་ཆོས་སྦྱིན་དང་༎ སངས་རྒྱས་ཞིང་ཀུན་སྦྱོང་བ་དང་༎ འཁོར་བས་ཡོངས་སུ་མི་སྐྱོ་དང་༎ ངོ་ཚ་ཁྲེལ་ཡོད་ཅེས་བྱ་བ་༎
 hrīrapatrāpyamityetat pañcadhā mananātmakam |	རློམ་མེད་བདག་ཉིད་དེ་རྣམ་ལྔ་༎
 vanāśālpecchatā tuṣṭirdhūtasaṃlekhasevanam || abhs_1|53 || śikṣāyā aparityāgaḥ kāmānāṃ vijugupsanam |	ངས་གནས་འདོད་ཆུང་ཆོག་ཤེས་དང་༎ སྦྱངས་པ་ཡང་དག་སྡོམ་བསྟེན་དང་༎ བསླབ་པ་ཡོངས་སུ་མི་གཏོང་དང་༎ འདོད་པ་རྣམས་ལ་སྨོད་པ་དང་༎ མྱ་ངན་འདས་དང་བདོག་ཀུན་གཏོང་༎
 nirvitsarvāstisaṃtyāgo 'navalinānapekṣate || abhs_1|54 ||	མི་ཞུམ་པ་དང་ལྟ་བ་མེད་༎
 saṃstavaṃ kulamātsaryaṃ sthānaṃ saṃgaṇikāvaham |	འདྲིས་དང་ཁྱིམ་ལ་འཁྲེན་པ་དང་༎ འདུ་འཛིར་གྱུར་པའི་གནས་དང་ནི་༎
 ātmotkarṣaparāvajñe karmamārgān daśāśubhān || abhs_1|55 ||	བདག་བསྟོད་གཞན་ལ་བརྙས་པ་དང་༎ མི་དགེའི་ལས་ཀྱི་ལམ་བཅུ་དང་༎ རློམ་པས་ཁེངས་དང་ཕྱིན་ཅི་ལོག་། 
 mānaṃ stambhaṃ viparyāsaṃ vimatiṃ kleśamarṣaṇam |	བློ་ངན་དང་ནི་ཉོན་མོངས་བཟོད་༎
 vivarjayan samāpneti daśaitān pañcamīṃ bhuvam || abhs_1|56 ||	བཅུ་པོ་འདི་ནི་རྣམ་སྤངས་ན་༎ ས་ལྔ་པ་ནི་ཡང་དག་འཐོབ་༎
 dānaśīlakṣamāvīryadhyānaprajñāprapūraṇāt |	སྦྱིན་དང་ཚུལ་ཁྲིམས་བཟོད་བརྩོན་འགྲུས་༎ བསམ་གཏན་ཤེས་རབ་རབ་རྫོགས་པས་༎ སློབ་མ་དང་ནི་བས་རུ་ལ་༎
 śiṣyakhaḍgaspṛhātrāsacetasāṃ parivarjakaḥ || abhs_1|57 ||	དགའ་དང་སྐྲག་པའི་སེམས་སྤངས་པ་༎
 yācito 'navalinaśca sarvatyāge 'pyadurmanāḥ |	བསླངས་ན་མི་ཞུམ་བདོག་པ་ཀུན་༎ བཏང་ཡང་མི་དགའ་མེད་པ་དང་༎ དབུལ་ཡང་སློང་བ་མི་སྤོད་བས་༎
 kṛśo 'pi nārthināṃ kṣeptā ṣaṣṭhīṃ bhūmiṃ samaśrute || abhs_1|58 ||	ས་ནི་དྲུག་པ་ཡང་དག་འཐོབ་༎
 ātmasattvagraho jīvapudgalocchedaśāśvataḥ | nimittahetvoḥ skandheṣu dhātuṣvāyataneṣu ca || abhs_1|59 ||	བདག་དང་སེམས་ཅན་འཛིན་པ་དང་༎ སྲོག་དང་གང་ཟག་ཆད་རྟག་དང་༎ མཚན་མ་རྒྱུ་དང་ཕུང་པོ་དང་༎ ཁམས་དང་སྐྱེ་མཆེད་དག་དང་ནི་༎
 traidhātuke pratiṣṭhānaṃ saktirālīnacittatā |	ཁམས་གསུམ་པོ་ལ་གནས་དང་ཆགས་༎ སེམས་ནི་ཀུན་ཏུ་ཞུམ་པ་དང་༎ དཀོན་མཆོག་གསུམ་དང་ཚུལ་ཁྲིམས་ལ་༎
 ratnatritayaśīleṣu taddṛṣṭyabhiniveśitā || abhs_1|60 || śūnyatāyāṃ vivadaśca tadvirodhaśca viṃśatiḥ |	དེར་ལྟ་བ་ཡི་མངོན་ཞེན་དང་༎ སྟོང་པ་ཉིད་ལ་རྩོད་པ་དང་༎ དེ་དང་འགལ་བའི་ཉེས་པ་ནི་༎
 kalaṅkā yasya vicchinnāḥ saptamīmetyasau bhuvam || abhs_1|61 ||	ཉི་ཤུ་གང་ལ་རྣམ་ཆད་པ་༎ དེ་ཡིས་ས་ནི་བདུན་པ་འཐོབ་༎
 trivimokṣamukhajñānaṃ trimaṇḍalaviśuddhatā | karūṇāmananā dharmasamataikanayajñatā || abhs_1|62 ||	རྣམ་ཐར་སྒོ་༄༤བ་གསུམ་ཤེས་པ་དང་༎ འཁོར་གསུམ་རྣམ་པར་དག་ཉིད་དང་༎ སྙིང་རྗེ་དང་ནི་རློམ་མེད་དང་༎ ཆོས་མཉམ་ཉིད་དང་ཚུལ་གཅིག་ཤེས་༎
 anutpādakṣamājñānaṃ dharmāṇāmekadheraṇā |	མི་སྐྱེ་བ་དང་བཟོད་ཤེས་དང་༎ ཆོས་རྣམས་པ་གཅིག་ཏུ་སྟོན་༎
 kalpanāyāḥ samuddhātaḥ saṃjñādṛkkleśavarjanam || abhs_1|63 || śamathasya ca nidhyaptiḥ kauśalaṃ ca vidarśane |	རྟོག་པ་ཀུན་ཏུ་འཇོམས་པ་དང་༎ འདུ་ཤེས་ལྟ་དང་ཉོན་མོངས་སྤོང་༏་། ཞི་གནས་ངེས་པར་སེམས་པ་དང་༎ ལྷག་མཐོང་ལ་ནི་མཁས་པ་དང་༎ སེམས་དུལ་བ་དང་ཐམས་ཅད་ལ་༎
 cittasya dāntatā jñānaṃ sarvatrāpratighāti ca || abhs_1|64 ||	ཐོགས་པ་མེད་པའི་ཡེ་ཤེས་དང་༎ ཆགས་པའི་ས་མིན་གར་འདོད་པར་༎
 sakterabhūmiryatrecchaṃ kṣetrāntaragatiḥ samam |	ཞིང་གཞན་དུ་ནི་མཉམ་འགྲོ་དང་༎ ཀུན་ཏུ་བདག་གི་ངོ་བོ་ནི་༎
 sarvatra svātmabhāvasya darśanaṃ ceti viṃśatiḥ || abhs_1|65 ||	སྟོན་པ་ཉིད་དང་ཉི་ཤུའོ་༎
 sarvasattvamanojñānamabhijñākrīḍanaṃ śubhā | buddhakṣetrasya niṣpattirbuddhasevāparīkṣaṇe || abhs_1|66 ||	སེམས་ཅན་ཀུན་ཡིད་ཤེས་པ་དང་༎ མངོན་པར་ཤེས་པས་བརྩེ་བ་དང་༎ སངས་རྒྱས་ཞིང་བཟང་སྒྲུབ་པ་དང་༎ ཡོངས་སུ་བརྟག་ཕྱིར་སངས་རྒྱས་བརྟེན་༎
 akṣajñānaṃ jinakṣetraśuddhirmāyopamā sthitiḥ |	དབང་པོ་ཤེས་དང་རྒྱལ་བ་ཡི་༎
 saṃcintya ca bhavādānamidaṃ karmāṣṭadhoditam || abhs_1|67 ||	ཞིང་སྦྱོང་སྒྱུ་མ་ལྟར་གནས་དང་༎ བསམས་བཞིན་སྲིད་པ་ལེན་པ་དང་༎ ལས་ནི་རྣམ་པ་འདི་བརྒྱད་བཤད་༎
 praṇidhānānyanantāni devādīnāṃ rūtajñatā | nadīva pratibhānānāṃ garbhāvakrāntirūttamā || abhs_1|68 ||	སྨོན་ལམ་དག་ནི་མཐའ་ཡས་དང་༎ ལྷ་ལ་སོགས་པའི་སྐད་ཤེས་དང་༎ སྤོབས་པ་ཆུ་བོ་ལྟ་བུ་དང་༎ མངལ་དུ་འཇུག་པ་མཆོག་དང་ནི་༎
 kulajātyośca gotrasya parivārasya janmanaḥ |	རིགས་དང་རུས་དང་ཆོ་འབྲང་དང་༎ འཁོར་དང་སྐྱེ་བ་དག་དང་ནི་༎
 naiṣkramyabodhivṛkṣāṇāṃ guṇapūreśca saṃpadaḥ || abhs_1|69 ||	ངེས་འབྱུང་བྱང་ཆུབ་ཤིང་རྣམས་དང་༎ ཡོན་ཏན་བུན་སུམ་ཚོགས་པ་ཡིན་༎
 nava bhūmīratikramya buddhabhūmau pratiṣṭhate |	ས་དགུ་འདས་ནས་ཡེ་ཤེས་ནི་༎ གང་གིས་སངས་རྒྱས་སར་གནས་པ་༎
 yena jñānena sā jñeyā daśamī bodhisattvabhūḥ || abhs_1|70 ||	དེ་ནི་བྱང་ཆུབ་སེམས་དཔའི་ས་༎ བཅུ་པ་ཡིན་པར་ཤེས་པར་བྱ་༎
 pratipakṣo 'ṣṭadhā jñeyo darṣanābhyāsamārgayoḥ |	མཐོང་དང་སྒོམ་པའི་ལམ་དག་ལ་༎
 grāhyagrāhakavikalpānāmaṣṭānāmupaśāntaye || abhs_1|71 ||	གཟུང་དང་འཛིན་པའི་རྣམ་རྟོག་རྣམས་༎ ཉེ་བར་ཞི་བར་བྱ་བའི་ཕྱིར་༎ གཉེར་པོ་རྣམ་པ་བརྒྱད་ཅེས་བྱ་༎
 uddeśe samatāyāṃ ca sattvārthe yatnavarjane | atyantāya ca niryāṇaṃ niryāṇaṃ prāptilakṣaṇam || abhs_1|72 || sarvākārajñatayāṃ ca niryāṇaṃ mārgagocaram |	ཆེད་དུ་བྱ་དང་མཉམ་ཉིད་དང་༎ སེམས་ཅན་དོན་དང་འབད་མེད་དང་༎ མཐའ་ལས་འདས་པར་ངེས་འབྱུང་དང་༎ ཐོབ་པའི་མཚན་ཉིད་ངེས་འབྱུང་དང་༎ རྣམ་པ་ཐམས་ཅད་མཁྱེན་ཉིད་དང་༎ ལམ་གྱི་ཡུལ་ཅན་ངེས་འབྱུང་སྟེ་༎ རྣམ་པ་བརྒྱད་ཀྱི་བདག་ཉིད་འདི་༎
 niryāṇapratipajjñeyā seyamaṣṭavidhātmikā || abhs_1|73 ||	ངེས་འབྱུང་སྒྲུབ་པ་ཡིན་ཞེས་བྱ་༎
 || abhisamayālaṅkāre prajñāpāramitopadeśaśāstre sarvākārajñatādhikāraḥ prathamaḥ ||	ཤེས་རབ་ཀྱི་ཕ་རོལ་ཏུ་ཕྱིན་པའི་མན་ངག་གི་བསྟན་བཅོས་མངོན་པར་རྟོགས་པའི་རྒྱན་གྱི་ཚིག་ལེའུར་བྱས་པ་ལས་༎ སྐབས་དང་༄༥ཨ་༌་༎ པོའོ་།
 dhyāmīkaraṇatā bhābhirdevānāṃ yogyatāṃ prati |	༎ ། ལྷ་རྣམས་རུང་བར་བྱ་བའི་ཕྱིར་༎
 viṣayo niyato vyāptiḥ svabhāvastasya karma ca || abhs_2|1 ||	འོད་ཀྱིས་མགོ་མོག་པར་མཛད་དང་༎ ཡུལ་ངེས་པ་དང་ཁྱབ་པ་དང་༎ རང་བཞིན་དང་ནི་དེ་ཡི་ལས་༎ ལམ་ཤེས་ཉིད་ཀྱི་ཚུལ་ལ་ནི་༎
 caturṇamāryasatyānāmākārānupalambhataḥ |	འཕགས་པའི་བདེན་པ་བཞི་དག་གི་༎ རྣམ་པ་མི་དམིགས་སྒོ་ནས་ནི་༎
 śrāvakāṇāmayaṃ mārgo jñeyo mārgajñatānaye || abhs_2|2 ||	ཉན་ཐོས་ལམ་འདི་ཤེས་པར་བྱ་༎ འཕགས་པ་ཉན་ཐོས་ལམ་ལ་ནི་༎
 rūpādiskandhaśūnyatvācchūnyatānāmabhedataḥ |	གཟུགས་ལ་སོགས་པ་སྟོང་པའི་ཕྱིར་༎ སྟོང་པ་ཉིད་རྣམས་དབྱེར་མེད་པས་༎
 uṣmāṇaḥ anupalambhena teṣāṃ murdhagataṃ matam || abhs_2|3 ||	དྲོ་བ་དེ་དག་མི་དམིགས་པས་༎ རྩེ་མོར་གྱུར་པ་དག་ཏུ་འདོད་༎
 kṣāntayasteṣu nityādiyogasthānaniṣedhataḥ |	དེ་ལ་རྟག་ལ་སོགས་ཚུལ་གྱིས་༏་། གནས་པ་བཀག་པས་བཟོད་པ་རྣམས་༎
 daśa bhūmīḥ samārabhya vistarāsthānadeśanat || abhs_2|4 ||	ས་བཅུ་དག་ལས་བརྩམས་ནས་ནི་༎ མི་གནས་རྒྱས་པར་བསྟན་པ་ཡིས་༎
 agradharmagataṃ proktamāryaśrāvakavartmani |	ཆོས་ཀྱི་མཆོག་ཏུ་འགྱུར་བཤད་དེ་༎ ཅི་ཕྱིར་ཞེ་ན་སངས་རྒྱས་ཀྱིས་༎
 tatkasya hetorbuddhena buddhvā dharmāsamīkṣaṇāt || abhs_2|5 ||	མཁྱེན་ནས་ཆོས་རྣམས་མ་གཟིགས་ཕྱིར་༎
 paropadeśavaiyarthyaṃ svayaṃbodhāt svayaṃbhuvām |	རང་བྱུང་བདག་ཉིད་རྟོགས་པའི་ཕྱིར་༎ གཞན་གྱིས་བསྟན་ཡང་མི་དགོས་ལ་༎ བསེ་རུ་ལྟ་བུའི་ཡེ་ཤེས་ནི་༎
 gambhīratā ca jñānasya khaḍgānāmabhidhīyate || abhs_2|6 ||	ཟབ་པ་ཉིད་དུ་མངོན་པར་བརྗོད་༎
 śuśrūṣā yasya yasyārthe yatra yatra yathā yathā |	གང་གང་དོན་ནི་གང་གང་ལ་༎ ཇི་ལྟར་ཇི་ལྟར་ཉན་འདོད་པ་༎
 sa so 'rthaḥ khyātyaśabdo 'pi tasya tasya tathā tathā || abhs_2|7 ||	དེ་དེ་ལ་དོན་དང་དེ་༎ སྒྲ་མེད་ཀྱང་དེ་དེ་ལྟར་སྣང་༎
 grahyārthakalpanāhānādgrāhakasyāprahāṇataḥ |	གཟུང་དོན་རྟོག་པ་སྤོང་ཕྱིར་དང་༎ འཛིན་པ་མི་སྤོང་ཕྱིར་དང་ནི་༎ རྟེན་གྱིས་བསེ་རུ་ལྟ་བུའི་ལམ་༎
 ādhārataśca vijñeyaḥ khaḍgamārgasya saṃgrahaḥ || abhs_2|8 ||	ཡང་དག་བསྡུས་པར་ཤེས་པར་བྱ་༎
 prajñapteravirodhena dharmatāsūcanākṛtiḥ |	བཏགས་པའི་ཆོས་ཉིད་མི་འགལ་བར་༎ སྟོན་པའི་རྣམ་པ་དྲོར་གྱུར་པ་༎
 usṣmagam mūrdhagaṃ rūpādyahānādiprabhāvitam || abhs_2|9 ||	རྩེ་མོར་གྱུར་པ་གཟུགས་ལ་སོགས་༎ འགྲིབ་པ་མེད་ལ་སོགས་པས་ཕྱེ་༎
 adyātmaśūnyatādyābhī rūpāderaparigrahāt |	ནང་སྟོང་ཉིད་ལ་སོགས་པ་ཡིས་༎
 kṣāntiḥ rūpādyanutpādādyākārairagradharmatā || abhs_2|10 ||	གཟུགས་སོགས་མི་འཛིན་ཕྱིར་བཟོད་པ་༎ གཟུགས་སོགས་སྐྱེ་བ་མེད་སོགས་ཀྱི་༎ རྣམ་པ་ཅན་ནི་ཆོས་ཀྱི་མཆོག་། 
 kṣāntijñānakṣaṇaiḥ satyasatyaṃ prati caturvidhaiḥ |	བདེན་དང་བདེན་ན་ལ་བཟོད་པ་དང་༎ ཤེས་པའི་སྐད་ཅིག་རྣམ་བཞི་ཡིས་༎
 mārgajñatāyāṃ dṛṅmārgaḥ sānuśaṃso 'yamucyate || abhs_2|11 ||	ལམ་ཤེས་ཉིད་ལ་མཐོང་བའི་ལམ་༎ ཕན་ཡོན་བཅས་པ་འདི་བཤད་དོ་༎
 ādhārādheyatābhāvāttathatābuddhayormithaḥ |	།
 paryāyeṇānanujñānaṃ mahattā sāpramāṇatā || abhs_2|12 || parimāṇāntatābhāvo rūpāderavadhāraṇam |	རྣམ་གྲངས་ཁས་མི་ལེན་པ་དང་༎ ཆེན་པོ་ཚད་མ་མེད་བཅས་དང་༎ ཚད་མེད་པ་དང་མཐའ་མེད་དང་༎ དེར་གནས་གཟུགས་ལ་སོགས་པ་ལ་༎
 tasyāṃ sthitasya buddhatve 'nugrahātyāgatādayaḥ || abhs_2|13 ||	སངས་རྒྱས་ཉིད་དུ་ངེས་འཛིན་དང༎
 maītryādi śūnyatā prāptirbuddhatvasya parigrahaḥ | sarvasya vyavadānasya sarvādhivyādhiśātanam || abhs_2|14 ||	༄༥བ་བླང་མེད་དོར་བ་མེད་སོགས་དང་༎ བྱམས་ལ་སོགས་པ་སྟོང་ཉིད་དང་༎ སངས་རྒྱས་ཉིད་ནི་འཐོབ་པ་དང་༎ རྣམ་པར་བྱང་ཀུན་ཡོངས་བསྡུས་དང་༎ ཉམ་ང་བ་དང་ནད་ཀུན་སེལ་༎
 nirvāṇagrāhaśāntatvaṃ buddhebho rakṣaṇādikam |	མྱང་འདས་འཛིན་ཞི་ཉིད་དང་༎ སངས་རྒྱས་རྣམས་ཀྱིས་བསྲུང་ལ་སོགས་༎ སྲོག་མི་གཅོད་པ་ལ་སོགས་པ་༎
 aprāṇivadhamārabhya sarvākārajñatānaye || abhs_2|15 ||	རྣམ་པ་ཀུན་མཁྱེན་ཚུལ་ལ་ནི་༎
 svayaṃ sthitasya sattvānāṃ sthāpanaṃ pariṇāmanam |	བདག་ཉིད་གནས་ཏེ་སེམས་ཅན་དག་།འགོད་དང་སྤྱིན་པ་ལ་སོགས་པ་༎ རྫོགས་པའི་བྱང་ཆུབ་ཏུ་བསྔོ་བ་༎
 danādīnāṃ ca saṃbodhāviti mārgajñatākṣaṇāḥ || abhs_2|16 ||	ལམ་ཤེས་ཉིད་ཀྱི་སྐད་ཅིག་མ་༎
 sarvato damanaṃ nāma sarvataḥ kleśanirjayaḥ |	ཀུན་ནས་ཞི་དང་ཐམས་ཅད་ལ་༎
 upamakrāviṣahyatvaṃ bodhirādhārapūjyatā || abhs_2|17 ||	བདུད་དང་ཉོན་མོངས་ལས་རྒྱལ་དང་༎ གནོད་པས་བརྫི་བ་མེད་ཉིད་དང་༎ བྱང་ཆུབ་དང་ནི་རྟེན་མཆོད་ཉིད་༎
 adhimuktistridhā jñeyā svārthā ca svaparārthakā |	མོས་པ་རང་གི་དོན་དང་ནི་༎
 parārthikaivetyeṣa ca pratyekaṃ trividheṣyate || abhs_2|18 ||	རང་གཞན་དོན་དང་གཞན་དོན་དང་༎ རྣམ་གསུམ་ཤེས་བྱ་དེ་ཡང་ནི་༎
 mṛdvī madhyādhimātrā ca mṛdumṛdvādibhedataḥ |	ཆུང་དང་འབྲིང་དང་ཆེན་པོ་སྟེ་༎ སོ་སོར་རྣམ་པ་གསུམ་དུ་འདོད་༎ ཆུང་དུའི་ཆུང་སོགས་དབྱེ་བ་ཡིས་༎
 sā punastrividhetyevaṃ saptaviṃśatidhā matā || abhs_2|19 || stutiḥ stobhaḥ praśaṃsā ca prajñāparamitāṃ prati |	དེ་ཡང་རྣམ་གསུམ་དེ་ལྟར་ན་༎ རྣམ་པ་ཉི་ཤུ་བདུན་དུ་འདོད་༎ ཤེས་རབ་ཕ་རོལ་ཕྱིན་པ་ལ་༎
 adhimokṣasya mātrāṇāṃ navakaistribhiriṣyate || abhs_2|20 ||	མོས་པའི་གནས་སྐབས་རྣམས་ལ་ནི་༎ དགུ་ཚན་གསུམ་གྱིས་བསྟོད་པ་དང་༎ བཀུར་བ་དང་ནི་བསྔགས་པར་འདོད་༎
 viśeṣaḥ pariṇāmastu tasya kāritramuttamam |	ཡོངས་སུ་བསྔོ་བ་ཁྱད་པར་ཅན་༎ དེ་ཡི་བྱེད་པ་མཆོག་ཡིན་ནོ་༎
 nopalambhākṛtiścāsāvaviparyāsalakṣaṇaḥ || abhs_2|21 ||	དེ་ནི་དམིགས་མེད་རྣམ་པ་ཅན་༎ ཕྱིན་ཅི་མ་ལོག་མཚན་ཉིད་དོ་༎
 vivikto buddhapuṇyaughasvabhāvasmṛtigocaraḥ |	བདེན་དང་སངས་རྒྱས་བསོད་ནམས་ཚོགས་༎ རང་བཞིན་དྲན་པའི་སྤྱོད་ཡུལ་ཅན་༎
 sopāyaścānimittaśca buddhairabhyanumoditaḥ || abhs_2|22 ||	ཐབས་བཅས་མཚན་མ་མེད་པ་དང་༎ སངས་རྒྱས་རྗེས་སུ་ཡི་རང་དང་༎ ཁམས་གསུམ་རྟོགས་པ་མ་ཡིན་དང་༏་། ཆུང་དང་འབྲིང་དང་ཆེན་པོ་ཡི་༎
 traidhātukāprapannaśca pariṇāmo 'parastridhā |	བསྔོ་བ་གཞན་ནི་རྣམ་གསུམ་པོ་༎
 mṛdurmadhyo 'dhimātraśca mahāpuṇyodayātmakaḥ || abhs_2|23 ||	བསོད་ནམས་ཆེ་འབྱུང་བདག་ཉིད་དོ་༎
 upāyānupalambābhyāṃ śubhamūlānumodanā |	ཐབས་དང་མི་དམིགས་པ་དག་གིས་༎ དགེ་བའི་རྩ་ལ་ཡི་རང་བ་༎
 anumode manaskārabhāvaneha vidhīyate || abhs_2|24 ||	རྗེས་སུ་ཡི་རང་ཡིད་བྱེད་པ་༎ བསྒོམ་པ་ཡིན་པར་འདིར་བརྗོད་དོ་༎
 svabhāvaḥ śreṣṭhatā tasya sarvasyānabhisaṃskṛtiḥ |	དེ་ཡི་ངོ་བོ་ཉིད་མཆོག་ཉིད་༎ ཀུན་ལ་མངོན་པར་འདུ་མི་བྱེད་༎
 nopalambhena dharmāṇāmarpaṇā ca mahārthatā || abhs_2|25 ||	ཆོས་རྣམས་དམིགས་སུ་མེད་པར་ནི་༎ གཏོད་པར་བྱེད་པ་དོན་ཆེན་ཉིད་༎
 buddhasevā ca dānādirūpāye yacca kauśalam |	སངས་རྒྱས་བསྟེན་དང་སྤྱིན་སོགས་དང་༎ ཐབས་ལ་མཁས་པ་གང་ཡིན་པ་༎ འདི་ལ་མོས་པའི་རྒྱུ་དག་ཡིན་༎
 hetavo 'trādhimokṣasya dharmavyasanahetavaḥ || abhs_2|26 || mārādhiṣṭhānagambhīradharmatānadhimuktate |	ཆོས་ཀྱིས་ཕོངས་པའི་རྒྱུ་༄༦ཨ་༌་༎ དག་ནི་༎
 skandhādyabhiniveśaśca pāpamitraparigrahaḥ || abhs_2|27 ||	བདུད་ཀྱི་ཐིབས་ཀྱིས་ནོན་པ་དང་༎ ཐབ་མོའི་ཆོས་ལ་མ་མོས་དང་༎ ཕུང་པོ་ལ་སོགས་མངོན་ཞེན་དང་༎ སྡིག་པའི་གྲོགས་པོས་ཡོངས་ཟིན་པའོ་༎
 phalaśuddhiśca rūpādiśuddhireva tayordvayoḥ |	འབྲས་བུ་དག་པ་གཟུགས་ལ་སོགས་༎ དག་པ་ཉིད་དེ་གང་གི་ཕྱིར་༎
 abhinnācchinnatā yasmāditi śuddhirudīritā || abhs_2|28 ||	དེ་གཉིས་ཐ་དད་མ་ཡིན་ཞིང་༎ བཅད་དུ་མེད་པས་དག་པར་བརྗོད་༎ ཉོན་མོངས་ཤེས་བྱ་ལམ་གསུམ་གྱི་༎
 kleśajñeyatrimārgasya śiṣyakhaḍgajinaurasām | hānādviśuddhirātyantikī tu buddhasya sarvathā || abhs_2|29 ||	ཉམས་ཕྱིར་སློབ་མ་བསེ་རུ་དང་༎ རྒྱལ་སྲས་རྣམས་ཀྱི་དག་པ་སྟེ་༎ སངས་རྒྱས་རྣམ་ཀུན་ན་ཤིན་ཏུ་བ་༎
 mṛdumṛdvādiko mārgaḥ śuddhirnavasu bhūmiṣu |	ས་དགུ་ལ་ནི་ཆེན་པོ་ཡི་༎
 adhimātrādhimātrādermalasya pratipakṣataḥ || abhs_2|30 ||	ཆེན་པོ་ལ་སོགས་དྲི་མ་ཡི་༎ གཉེན་པོ་ཆུང་དུའི་ཆུང་དུ་ལ་༎ སོགས་པའི་ལམ་ནི་དག་པ་ཡིན་༎ དེ་ལ་ཀླན་ཀ་སྤངས་པ་ཡིས་༎ ལམ་ནི་འཇལ་དང་གཞལ་བྱ་དག་། 
 tridhātupratipakṣatvaṃ samatā manameyayoḥ | mārgasya ceṣyate tasya parihārataḥ || abhs_2|31 ||	མཉམ་པ་ཉིད་ཀྱིས་ཁམས་གསུམ་གྱི་༎
 || abhisamayālaṅkāre prajñāpāramitopadeśaśāstre	གཉེན་པོ་ཉིད་དུ་འདོད་པ་ཡིན་༎ ཤེས་རབ་ཀྱི་ཕ་རོལ་ཏུ་ཕྱིན་པའི་མན་ངག་གི་བསྟན་བཅོས་མངོན་པར་རྟོགས་པའི་རྒྱན་གྱི་ཚིག་ལེའུར་བྱས་པ་ལས་།
 mārgajñatādhikāro dvitīyaḥ ||	སྐབས་གཉིས་པའོ་།
 nāpare na pare tīre nāntarāle tathoḥ sthitā |	༎ ། ཚུ་རོལ་ཕ་རོལ་མཐའ་ལ་མིན་༎ དེ་དག་བར་ན་མི་གནས་པ་༎
 adhvanāṃ samatājñānāt prajñāpāramitāmatā || abhs_3|1 ||	དུས་རྣམས་མཉམ་པ་ཉིད་ཤེས་ཕྱིར་༎ ཤེས་རབ་ཕ་རོལ་ཕྱིན་པར་འདོད་༎
 anupāyena dūraṃ sā sanimittopalambhataḥ |	དེ་ནི་མཚན་མར་དམིགས་སྒོ་ནས་༎ ཐབས་མ་ཡིན་པས་རིང་བ་སྟེ་༎
 upāyakauśalenāsyāḥ samyagāsannatoditā || abhs_3|2 ||	དེ་ནི་ཐབས་ལ་མཁས་པ་ཡིས་༎ ཡང་དག་ཉེ་བ་ཉིད་དུ་བཤད་༎
 rūpādiskandhaśūnyatve dharmeṣu tryadhvageṣu ca |	གཟུགས་སོགས་ཕུང་པོ་སྟོང་ཉིད་དང་༎ དུས་གསུམ་རྟོགས་པའི་ཆོས་རྣམས་དང་༎ སྦྱིན་སོགས་བྱང་ཆུབ་ཕྱོགས་རྣམས་ལ་༎
 dānādau bodhipakṣeṣu caryāsaṃjñā vipakṣatā || abhs_3|3 ||	སྤྱོད་པའི་འདུ་ཤེས་མི་མཐུན་ཕྱོགས་༎
 dānādiṣvanahaṃkāraḥ pareṣāṃ tanniyojanam |	སྦྱིན་ལ་སོགས་ལ་ངར་འཛིན་མེད་༎ གཞན་དག་དེ་ལ་འཛུད་བྱེད་པ་༎ དེ་ནི་ཆགས་པའི་མཐའ་འགོག་པས་༎
 saṅgakoṭīniṣedho 'yaṃ sukṣmaḥ saṅgo jinādiṣu || abhs_3|4 ||	རྒྱལ་ལ་སོགས་ལ་ཆགས་པ་ཕྲ་༎ ཆོས་ཀྱི་ལམ་ནི་རང་བཞིན་གྱིས་༎
 tadgāmbīryaṃ prakṛtyaiva vivekāddharmapaddhateḥ *iti* |	དབེན་པའི་ཕྱིར་ན་དེ་ཟབ་ཉིད་༎
 ekaprakṛtikaṃ jñānaṃ dharmāṇāṃ saṅgavarjanam || abhs_3|5 ||	ཆོས་རྣམས་རང་བཞིན་གཅིག་པར་ནི་༎ ཤེས་པས་ཆགས་པ་སྦོང་བ་ཡིན༎
 dṛṣṭādipratiṣedhena tasyā durbodhatoditā *iti* |	མཐོང་བ་ལ་སོགས་བཀག་པ་ཡིས་༎ དེ་ནི་རྟོགས་པར་དཀའ་བར་བཤད་༎
 rūpādibhiravijñānāttadacintyatvamiṣyate || abhs_3|6 ||	གཟུགས་ལ་སོགས་པར་མི་ཤེས་ཕྱིར་༎ དེ་ནི་བསམ་མི་ཁྱབ་པར་འདོད་༎
 evaṃ kṛtvā yathokto vai jñeyaḥ sarvajñatānaye |	དེ་ལྟར་ཀུན་ཤེས་ཉིད་ལུགས་ལ་༎
 ayaṃ vibhāgo niḥśoṣo vipakṣapratipakṣayoḥ || abhs_3|7 ||	མི་མཐུན་གཉེན་པོའི་ཕྱོགས་དག་གི་། རྣམ་པར་དབྱེ་བ་མ་ལུས་པ་༎ ཇི་སྐད་བཤད་པ་འདིར་༄༦བ་ཤེས་བྱ་༎
 rūpādau tadanityādau tadapuriprapūrayoḥ |	གཟུགས་སོགས་དེ་མི་རྟག་སོགས་དང་༎ དེ་མ་རྫོགས་དང་རབ་རྫོགས་དང་༎ དེ་ལ་ཆགས་པ་མེད་ཉིད་ལ་༎
 tadasaṅgatve caryāyā: prayogaḥ pratiṣedhataḥ || abhs_3|8 || avikāro na kartā ca prayogo duṣkarastridhā |	སྤྱོད་པ་བཀག་པའི་སྦྱོར་བ་དང་༎ མི་འགྱུར་བྱེད་པོ་མེད་ཉིད་དང་༎ བྱ་དཀའ་རྣམ་གསུམ་སྦྱོར་བ་དང་༎ སྐལ་བ་ཇི་བཞིན་འབྲས་ཐོབ་པས་༎
 yathābhavyaṃ phalaprāpteravandhyo 'bhimataśca saḥ || abhs_3|9 ||	འབྲས་ཡོད་འདོད་པ་དེ་དང་ནི་༎
 aparapratyayo yaśca saptadhā khyātivedakaḥ |	གཞན་ལ་རག་ལས་མེད་གང་དང་༎ སྣང་བ་རྣམ་བདུན་ཤེས་བྱེད་དོ་༎
 caturdhā mananā tasya rūpādau samatā matā || abhs_3|10 ||	གཟུགས་ལ་སོགས་ལ་རློམ་མེད་པ་༎ རྣམ་བཞི་དེ་ཡི་མཉམ་པ་ཉིད་༎
 dharmajñānānvayajñānakṣāntijñānakṣaṇātmakaḥ |	སྡུག་བསྔལ་ལ་སོགས་བདེན་པ་ལ་༎ ཆོས་ཤེས་རྗེས་སུ་ཤེས་པ་དང་༎ བཟོད་ཤེས་སྐད་ཅིག་བདག་ཉིད་འདི་༎
 duḥkhādisatye dṛṅmārga eṣa sarvajñatānaye || abhs_3|11 ||	ཀུན་ཤེས་ཚུལ་ལ་མཐོང་བའི་ལམ་༎
 rūpaṃ na nityaṃ nānityamatitāntaṃ viśuddhakam |	གཟུགས་རྟག་མ་ཡིན་མི་རྟག་མིན་༎
 anutpannāniruddhādi vyomābhaṃ lepavarjitam || abhs_3|12 || parigraheṇa nirmuktamavyāhāraṃ svabhāvataḥ | pravyāhāreṇa nāsyārthaḥ pareṣu prāpyate yataḥ || abhs_3|13 ||	མཐའ་ལས་འདས་དང་རྣམ་དག་དང་༎ མ་སྐྱེས་མ་འགགས་ལ་སོགས་དང་༎ མཁའ་འདྲ་ཆགས་པ་སྤངས་པ་དང་༎ ཡོངས་སུ་འཛིན་ལས་གྲོལ་བ་དང་༎ ངོ་བོ་ཉིད་ཀྱིས་བརྗོད་མེད་དང་༎ གང་ཕྱིར་འདི་དོན་བརྗོད་པ་ཡིས་༎
 nopalambhakṛdatyantaviśuddhirvyādhyasaṃbhavaḥ |	གཞན་ལ་སྦྱིན་དུ་མེད་པ་དང་༎ དམིགས་པ་མེད་པར་བྱེད་པ་དང་༎ ཤིན་ཏུ་རྣམ་དག་ནད་མི་འབྱུང་༎
 apāyocchittyakalpatve phalasākṣātkriyāṃ prati || abhs_3|14 ||	ངན་སོང་ཆད་དང་འབྲས་བུ་ནི་༎ མངོན་དུ་བྱ་ལ་མི་རྟོག་ཉིད་༎
 asaṃsargo nimittaiśca vastuni vyañjane dvaye |	མཚན་མ་དག་དང་མ་འབྲེལ་དང་༎ དངོས་དང་མིང་དང་གཉིས་པོ་ལ་༏་། ཤེས་པ་སྐྱེ་བ་མེད་པ་ནི་༎
 jñānasya yā cānutpattiriti sarvajñatākṣaṇāḥ || abhs_3|15 ||	ཀུན་ཤེས་ཉིད་ཀྱི་སྐད་ཅིག་མ་༎
 iti seyaṃ punaḥ seyaṃ seyaṃ khalu punastridhā |	དེ་ལྟར་འདི་དང་ཡང་འདི་དང་༎ ཡང་འདི་ཡིན་ཏེ་རྣམ་གསུམ་པོ་༎
 adhikāratrayasyaiṣā samāptiḥ paridīpitā || abhs_3|16 ||	།
 || abhisamayālaṅkāre prajñāpāramitopadeśaśāstre sarvajñatādhikāras tṛtīyaḥ ||	ཤེས་རབ་ཀྱི་ཕ་རོལ་ཏུ་ཕྱིན་པའི་མན་ངག་གི་བསྟན་བཅོས་མངོན་པར་རྟོགས་པའི་རྒྱན་གྱི་ཚིག་ལེའུར་བྱས་པ་ལས་། སྐབས་གསུམ་པའོ་།
 vastujñānaprakārāṇāmākārā iti lakṣaṇam |	༎ ། གཞི་ཤེས་པ་ཡི་བྱེ་བྲག་རྣམས་༎ རྣམ་པ་ཞེས་བྱ་མཚན་ཉིད་དེ་༎
 sarvajñatānāṃ traividyāt trividhā eva te matāḥ || abhs_4|1 ||	ཀུན་མཁྱེན་ཉིད་ནི་རྣམ་གསུམ་ཕྱིར་༎ དེ་ནི་རྣམ་པ་གསུམ་དུ་འདོད་༎ མེད་པའི་རྣམ་པ་ནས་བཟུང་སྟེ་༎
 asadākāramārabhya yāvanniścalatākṛtiḥ |	མི་ག-ཡོ་བ་ཡི་རྣམ་པའི་བར་༎
 catvāraḥ pratisatyaṃ te mārge pañcadaśa smṛtāḥ || abhs_4|2 ||	བདེན་པ་སོ་སོ་ལ་བཞི་དང་༎ ལམ་ལ་དེ་ནི་བཅོ་ལྔར་བཤད་༎
 hetau mārge ca duḥkhe ca nirodhe ca yathākramam |	རྒྱུ་དང་ལམ་དང་སྡུག་བསྔལ་དང་༎ འགོག་པ་ལ་ནི་གོ་རིམས་བཞིན་༎
 aṣṭau te sapta pañceti ṣoḍaśeti ca kīrtitāḥ || abhs_4|3 ||	དེ་དག་བརྒྱད་དང་བདུན་དང་ནི་༎ ལྔ་དང་བཅུ་དྲུག་ཅེས་བསྒྲགས་སོ་༎
 smṛtyupasthānamārabhya buddhatvākārapaścimāḥ |	༄༧ཨ་༌་༎ དྲན་པ་ཉེར་གཞག་ནས་བཟུང་སྟེ་༎ སངས་རྒྱས་རྣམ་པའི་མཐར་ཐུག་རྣམས་༎ ལམ་གྱི་བདེན་པའི་རྗེས་མཐུན་པར་༎ ཀུན་མཁྱེན་གསུམ་དུ་ཕྱེ་བས་ན་༎
 śiṣyāṇāṃ bodhisattvānāṃ buddhānāṃ ca yathākramam || abhs_4|4 ||	སློབ་མ་བྱང་ཆུབ་སེམས་དཔའ་དང་༎ སངས་རྒྱས་རྣམས་ལ་རིམ་བཞིན་དུ་༎
 saptatriṃśaccatustriṃśattriṃśannava ca te matāḥ | trisarvajñatvabhedena mārgasatyānurodhataḥ || abhs_4|5 ||	སུམ་ཅུ་བདུན་དང་སུམ་ཅུ་བཞི་༎ སུམ་ཅུ་རྩ་དགུ་དག་ཏུ་བཞེད་༎ སངས་རྒྱས་རྣམས་ལ་ལྷག་པར་བྱས་༎
 kṛtādhikārā buddheṣu teṣūptaśubhamūlakāḥ |	དེ་ལ་དགེ་བའི་རྩ་བ་བསྐྲུན་༎
 mitraiḥ sanāthāḥ kalyāṇairasyāḥ śravaṇabhājanam || abhs_4|6 ||	དགེ་བའི་བཤེས་ཀྱི་མགོན་བཅས་པ་༎ འདི་མཉན་པ་ཡི་སྣོད་ཡིན་ནོ་༎
 buddhopāsanasaṃpraśnadānaśīlādicaryayā |	སངས་རྒྱས་བསྟན་དང་ཀུན་འདྲི་དང་༎ སྦྱིན་དང་ཚུལ་ཁྲིམས་སོགས་སྤྱོད་པས་༎
 udgrahadhāraṇādīnāṃ bhājanatvaṃ satāṃ matam || abhs_4|7 ||	ལེན་དང་འཛིན་ལ་སོགས་པ་ཡི་༎ སྣོད་དུ་དམ་པ་རྣམས་བཞེད་དོ་༎
 rūpādiṣvanavasthānātteṣu yoganiṣedhataḥ |	གཟུགས་ལ་སོགས་ལ་མི་གནས་ཕྱིར་༎ དེ་ལ་སྦྱོར་བ་བཀག་པའི་ཕྱིར་༎
 tattathatāgambhīratvātteṣāṃ duravagāhataḥ || abhs_4|8 ||	དེ་ཡི་དེ་བཞིན་ཉིད་ཟབ་ཕྱིར་༎ དེ་རྣམས་གཏིང་དཔག་དཀའ་བའི་ཕྱིར་༎
 tadaprāmāṇyataḥ kṛcchāccireṇa pratibodhataḥ |	དེ་དག་ཚད་ནི་མེད་ཕྱིར་དང་༎ ཚེགས་ཆེན་ཡུན་རིང་རྟོགས་པའི་ཕྱིར་༎
 vyākṛtāvavivartyatve niryāṇe sanirantare || abhs_4|9 || āsannabodhe kṣipraṃ ca parārthe 'vṛddhyahānitaḥ |	ལུང་བསྟན་ཕྱིར་མི་ལྡོག་ཉིད་དང་༎ ངེས་འབྱུང་བར་ཆད་མེད་བཅས་དང་༎ བྱང་ཆུབ་ཉེ་དང་མྱུར་བ་དང་༎ གཞན་དོན་འཕེལ་མེད་འགྲིབ་མེད་ཕྱིར་༎
 dharmādharmādyadṛṣṭau ca rupācintyādyadarśane || abhs_4|10 ||	ཆོས་དང་ཆོས་མིན་སོགས་མི་མཐོང་༎ གཟུགས་སོགས་བསམ་མི་ཁྱབ་མི་མཐོང་༎
 rūpādestannimittasya tadbhāvasyāvikalpakaḥ | phalaratnapradātā ca śuddhakaḥ sāvadhiśca saḥ || abhs_4|11 ||	གཟུགས་སོགས་དེ་ཡི་མཚན་མ་དང་༎ དེ་ཡི་ངོ་བོར་རྣམ་མི་རྟོག་།འབྲས་བུ་རིན་ཆེན་སྦྱིན་བྱེད་དང་༎ དེ་ནི་དག་པ་མཚམས་དང་བཅས་༎ བདུད་ཀྱི་མཐུ་བཅོམ་ལ་སོགས་པ་༎
 mārāṇāṃ śaktihānyādiścaturdaśavidho guṇaḥ |	ཡོན་ཏན་རྣམ་པ་བཅུ་བཞིའོ་༎
 doṣāśca ṣaḍviboddhavyāścaturbhirdaśakaiḥ saha || abhs_4|12 ||	སྐྱོན་ནི་བཅུ་ཚན་བཞིར་བཅས་པ་༎ དྲུག་ཏུ་ངེས་པར་རྟོགས་པར་བྱ་༎
 lakṣyate yena tajjñeyaṃ lakṣaṇaṃ trividhaṃ ca tat |	གང་གི་མཚོན་ཏེ་མཚན་ཉིད་དུ་༎ ཤེས་བྱ་དེ་ཡང་རྣམ་པ་གསུམ་༎
 jñānaṃ viśeṣaḥ kāritraṃ svabhāvo yaśca lakṣyate || abhs_4|13 ||	ཤེས་པ་ཁྱད་པར་བྱེད་པ་སྟེ་༎ ངོ་བོ་ཉིད་གང་མཚོན་བྱ་ཡང་༎
 tathāgatasya nirvṛttau loke cālujyanātmake | sattvānāṃ cittacaryāsu tatsaṃkṣepe bahirgatau || abhs_4|14 || akṣayākāratāyāṃ ca sarāgādau pravistṛte | mahadgate 'pramāṇe ca vijñāne cānidarśane || abhs_4|15 ||	དེ་བཞིན་གཤེགས་པ་འབྱུང་བ་དང་༎ འཇིག་རྟེན་འཇིག་མེད་བདག་ཉིད་དང་༎ སེམས་ཅན་སེམས་ཀྱི་སྤྱོད་པ་དང་༎ དེ་བསྡུས་པ་དང་ཕྱིར་ལྟས་དང་༎ མི་བཟད་པ་ཡི་རྣམ་པ་དང་༎ ཆགས་བཅས་སོགས་དང་རྒྱ་ཆེན་དང་༎ ཆེན་པོར་གྱུར་དང་ཚད་མེད་དང་༎ རྣམ་ཤེས་བསྟན་དུ་མེད་པ་དང་༎ སེམས་བལྟར་མེད་དང་ཤེས་པ་དེ་༎
 adṛśyacitajñāne ca tadunmiñjādisaṃjñakam |	༄༧བ་ག-ཡོ་བ་ལ་སོགས་ཤེས་བྱ་དང་༎ དེ་ལས་གཞན་ཡང་དེ་དག་ནི་༎
 punastathatākāreṇa teṣāṃ jñānamataḥ param || abhs_4|16 ||	དེ་བཞིན་ཉིད་ཀྱི་རྣམ་པར་ཤེས་༎ ཐུབ་པས་དེ་བཞིན་ཉིད་རྟོགས་ཏེ་༎
 tathatāyāṃ munerbodhe tatparākhyānamityayam |	གཞན་ལ་བསྟན་པ་ཞེས་བྱ་འདི་༎
 sarvajñatādhikāreṇa jñānalakṣaṇasaṃgrahaḥ || abhs_4|17 ||	ཐམས་ཅད་ཤེས་པ་ཉིད་སྐབས་ཀྱི་༎ ཤེས་པའི་མཚན་ཉིད་བསྡུས་པ་ཡིན་༎
 śūnyatve sānimitte c praṇidhānavivarjite | anutpādanirodhādau dharmatāyā akopane || abhs_4|18 ||	སྟོང་ཉིད་མཚན་མེད་བཅས་པ་དང་༎ སྨོན་པ་རྣམ་པར་སྤངས་པ་དང་༎ སྐྱེ་མེད་འགག་པ་མེད་སོགས་དང་༎ ཆོས་ཉིད་རྣམ་པར་འཁྲུག་མེད་དང་༎ འདུ་མི་བྱེད་དང་རྣམ་མི་རྟོག་། 
 asaṃskare 'vikalpe ca prabhedālakṣaṇatvayoḥ |	རབ་དབྱེ་མཚན་ཉིད་མེད་ཉིད་ལ་༎
 mārgajñatādhikāreṇa jñānalakṣaṇamiṣyate || abhs_4|19 ||	ལམ་ཤེས་ཉིད་ཀྱི་སྐབས་ཀྱིས་ནི་༎ ཤེས་པའི་མཚན་ཉིད་ཡིན་པར་བཞེད་༎ དེ་ནི་ཉིད་ཀྱི་ཆོས་བསྟེན་ནས་༎
 svadharmamupaniśritya vihāre tasya satkṛtau | gurūtve mānanāyāṃ ca tatpūjākṛtakatvayoḥ || abhs_4|20 || sarvatra vṛttimajjñānamadṛṣṭasya ca darśakam | lokasya śūnyatākārasūcakajñāpakākṣagam || abhs_4|21 ||	གནས་དང་གུས་པར་བྱ་བ་དང་༎ བླ་མ་ཉིད་དང་མཉེས་པ་དང་༎ དེ་ལ་མཆོད་དང་བྱེད་མེད་དང་༎ ཀུན་ཏུ་འཇུག་མཁྱེན་གང་ཡིན་དང་༎ མ་མཐོང་སྟོན་པར་མཛད་པ་དང་༎ འཇིག་རྟེན་སྟོང་ཉིད་རྣམ་པ་དང་༎ བརྗོད་དང་ཤེས་མཛད་མངོན་སུམ་མཛད་༎
 acintyaśāntatādarśi lokasaṃjñānirodhi ca |	བསམ་མི་ཁྱབ་དང་ཞི་ཉིད་སྟོན་༎ འཇིག་རྟེན་འདུ་ཤེས་འགོག་པ་ལ་༎
 jñānalakṣaṇamityuktaṃ sarvākārajñatānaye || abhs_4|22 ||	རྣམ་པ་ཀུན་མཁྱེན་ཚུལ་ལ་ནི་༎ ཤེས་པའི་མཚན་ཉིད་ཅེས་བཤད་དོ་༎
 acityādiviśeṣeṇa viśiṣṭaiḥ satyagocaraiḥ |	བསམ་མི་ཁྱབ་སོགས་ཁྱད་པར་གྱིས་༎ ཁྱད་ཞུགས་བདེན་པའི་སྤྱོད་ཡུལ་ཅན་༎
 viśeṣalakṣaṇaṃ ṣaḍbhirdaśabhiścoditaṃ kṣaṇaiḥ || abhs_4|23 ||	སྐད་ཅིག་མ་ནི་བཅུ་དྲུག་གིས་༏་། ཁྱད་པར་མཚན་ཉིད་བཤད་པ་ཡིན་༎
 acintyātulyate meyasaṃkhyeyāsamatikramau |	བསམ་མི་ཁྱབ་དང་མི་མཉམ་དང་༎ གཞལ་དང་བགྲང་ལས་ཡང་དག་འདས་༎
 sarvāryasaṃgraho vijñavedyāsādhāraṇajñate || abhs_4|24 ||	འཕགས་པ་ཀུན་བསྡུས་མཁས་པ་ཡིས་༎ རིག་བྱ་ཐུན་མོང་མིན་ཤེས་ཉིད་༎
 kṣiprajñānyunapūrṇatve pratipatsamudāgamau | ālambanaṃ ca sādhāraṃ sākalyaṃ saṃparigrahaḥ || abhs_4|25 ||	ཤེས་མྱུར་བྲི་དང་གང་མེད་དང་༎ སྒྲུབ་དང་ཡང་དག་འགྲུབ་པ་དང་༎ དམིགས་པ་བརྟན་དང་བཅས་པ་དང་༎ མཐའ་དག་པ་དང་ཡོངས་འཛིན་དང་༎ རོ་མྱང་མེད་དང་ཁྱད་པར་ནི་༎
 anāsvādaśca vijñeyo viśeṣaḥ ṣoḍaśātmakaḥ |	བཅུ་དྲུག་བདག་ཉིད་ཅེས་བྱ་སྟེ་༎
 viśeṣamārgā mārgebhyo yenānyebhyo viśiṣyate || abhs_4|26 ||	གང་གིས་ལམ་ནི་གཞན་དག་ལས་༎ ཁྱད་དུ་འཕགས་པས་ཁྱད་པར་ལམ་༎
 hitaṃ sukhaṃ ca trāṇaṃ ca śaraṇaṃ layanaṃ nṛṇām | parāyaṇaṃ ca dvīpaṃ ca pariṇāyakasaṃjñakam || abhs_4|27 ||	ཕན་དང་བདེ་དང་སྐྱོབ་པ་དང་༏་། མི་རྣམས་ཀྱི་ནི་སྐྱབས་དག་དང་༎ གནས་དང་དཔུང་གཉེན་གླིང་དང་ནི་༎
 anābhogaṃ tribhiryānaiḥ phalāsākṣātkriyātmakam |	ཡོངས་འདྲེན་པ་ཞེས་བྱ་བ་དང་༎ ལྷུན་གྱིས་གྲུབ་དང་ཐེག་གསུམ་གྱིས་༎ འབྲས་བུ་མངོན་སུམ་མི་བྱེད་དག་། ཐ་མ་རྟེན་གྱི་མཛད་པ་སྟེ་༎
 paścimaṃ gatikāritramidaṃ kāritralakṣaṇam || abhs_4|28 ||	འདི་ནི་བྱེད་པའི་མཚན་ཉིད་ཡིན་༎
 kleśaliṅganimittānāṃ vipakṣapratipakṣayoḥ |	ཉོན་༄༨ཨ་༌་༎ མོངས་རྟགས་དང་མཚན་མ་དང་༎ མི་མཐུན་ཕྱོགས་དང་གཉེན་པོ་དག་། 
 viveko duṣkaraikāntāvuddeśo 'nupalambhakaḥ || abhs_4|29 || niṣiddhābhiniveśaśca yaścālambanasaṃjñakaḥ | vipratyayo 'vighātī ca so 'padāgatyajātikaḥ || abhs_4|30 ||	དབེན་དང་དཀའ་དང་ངེས་པ་དང་༎ ཆེད་དུ་བྱ་དང་མི་དམིགས་དང་༎ མངོན་པར་ཞེན་པ་བཀག་པ་དང་༎ དམིགས་པ་ཞེས་བྱ་གང་ཡིན་དང་༎ མི་མཐུན་ཐོགས་པ་མེད་དང་དེ་༎
 tathatānupalambhaśca svabhāvaḥ ṣoḍaśātmakaḥ |	གཞི་མེད་འགྲོ་མེད་སྐྱེ་མེད་དང་༎ དེ་བཞིན་ཉིད་ནི་མི་དམིགས་དང་༎ ངོ་བོ་ཉིད་བཅུ་དྲུག་བདག་ཉིད་༎
 lakṣmeva lakṣyate ceticaturthaṃ lakṣaṇaṃ matam || abhs_4|31 ||	མཚོན་བྱ་ལྟ་བུར་མཚོན་པས་ན་༎ མཚན་ཉིད་བཞི་པར་བཞེད་པ་ཡིན་༎
 animittapradānādisamudāgamakauśalam |	མཚན་མེད་རབ་ཏུ་སྦྱིན་ལ་སོགས་༎ ཡང་དག་སྒྲུབ་ལ་མཁས་པ་ནི་༎
 sarvākārāvabodhe 'smin mokṣabhagīyamiṣyate || abhs_4|32 ||	རྣམ་པ་ཐམས་ཅད་རྟོགས་འདི་ལ་༎ ཐར་པའི་ཆ་དང་མཐུན་པར་འདོད་༎
 buddhādyālambanā śraddhā vīryaṃ dānādigocaram | smṛtirāśayasaṃpattiḥ samādhiravikalpanā || abhs_4|33 ||	སངས་རྒྱས་སོགས་དམིགས་དད་པ་དང་༎ སྦྱིན་སོགས་སྤྱོད་ཡུལ་བརྩོན་འགྲུས་དང་༎ བསམ་པ་ཕུན་ཚོགས་དྲན་པ་དང་༎ རྣམ་པར་མི་རྟོག་ཏིང་འཛིན་དང་༎ ཆོས་རྣམས་རྣམ་པ་ཐམས་ཅད་དུ་༎
 dharmeṣu sarvairākārairjñānaṃ prajñeti pañcadhā |	ཤེས་པའི་ཤེས་རབ་དང་རྣམ་ལྔ་༎
 tīkṣṇai subodhā saṃbodhirdurbodhā mṛdubhirmatā || abhs_4|34 ||	རྫོགས་པའི་བྱང་ཆུབ་རྣོན་པོ་ཡིས་༎ རྟོགས་སླ་རྟུལ་པོས་རྟོགས་དཀར་བཞེད་༎
 ālambanaṃ sarvasattvā ūṣmaṇāmiha śakyate |	དྲོ་བ་རྣམས་ཀྱི་དམིགས་པ་འདིར་༎ སེམས་ཅན་ཐམས་ཅད་ཡིན་པར་བསྔགས་༎
 samacittādirākārasteṣveva daśadhoditaḥ || abhs_4|35 ||	དེ་དག་ཉིད་ལ་སེམས་མཉམ་སོགས་༎ རྣམ་པ་དག་ནི་བཅུར་བཤད་དོ་༎
 svayaṃ pāpānnivṛttasya dānādyeṣu sthitasya ca |	བདག་ཉིད་སྡིག་པ་ལས་ལྡོག་ཅིང་༎ སྦྱིན་ལ་སོགས་ལ་གནས་པས་གཞན་༎
 tayorniyojanānyeṣāṃ varṇavādānukulate || abhs_4|36 ||	དེ་དག་ལ་ནི་འགོད་པ་དང་༎ བསྔགས་པ་བརྗོད་དང་མཐུན་པ་ཉིད་༎ རྩེར་གྱུར་དེ་བཞིན་བཟོད་པ་ནི་༎
 mūrdhagam svaparādhāraṃ satyajñānaṃ tathā kṣamā |	རང་གཞན་རྟེན་ཅན་བདེན་ཤེས་པ་༎
 tathāgradharmā vijñeyāḥ sattvānāṃ pācanādibhiḥ || abhs_4|37 ||	ཆོས་མཆོག་དེ་བཞིན་སེམས་ཅན་རྣམས་༎ སྨིན་བྱེད་སོགས་ཀྱིས་ཤེས་པར་བྱ་༎
 nirvedhaṅgānyupādaya darśanābhyāsamārgayoḥ |	ངེས་འབྱེད་ཡན་ལག་ནས་བཟུང་སྟེ་༎ མཐོང་དང་སྒོམ་པའི་ལམ་དག་ལ་༎
 ye bodhisattvā vartante so 'trāvaivartiko gaṇaḥ || abhs_4|38 ||	བྱང་ཆུབ་སེམས་དཔའ་གང་དག་གནས་༎ དེ་འདིར་མི་ལྡོག་པ་ཡི་ཚོགས་༎
 rūpādibhyo nivṛttyādyairliṅgairviṃśatidheritaiḥ |	གཟུགས་ལ་སོགས་ལས་ལྡོག་སོགས་རྟགས་༎ རྣམ་པ་ཉི་ཤུར་བརྗོད་པ་ཡིས་༎
 nirvedhāṅgasthitasyedamavaivartikalakṣaṇam || abhs_4|39 ||	ངེས་འབྱེད་ཡན་ལག་ལ་གནས་པའི་༎ ཕྱིར་མི་ལྡོག་པའི་མཚན་ཉིད་འདི་༎
 rūpādibhyo nivṛttiśca vicikitsākṣaṇakṣayau |	གཟུགས་ལ་སོགས་ལས་ལྡོག་པ་དང་༎ ཟེ་ཆོམ་མི་ངལ་ཟད་པ་དང་༎ བདག་ཉིད་དགེ་བ་ལ་གནས་ཤིང་༎
 ātmanaḥ kuśalasthasya pareṣāṃ tanniyojanam || abhs_4|40 || parādhāraṃ ca dānādi gambhire 'rthe 'pyakāṅkṣaṇam |	གཞན་དག་ངེ་ལ་འགོད་པ་དང་༎ གཞན་གྱི་རྟེན་ཅན་སྦྱིན་སོགས་དང་༎ ཟབ་མོའི་༄༨བ་དོན་ལ་འང་སོམ་ཉི་མེད་༎
 maitraṃ kāyādyasaṃvāsaḥ pañcadhāvaraṇena ca || abhs_4|41 ||	བྱམས་ལུས་སོགས་དང་སྒྲིབ་པ་ནི་༎
 sarvānuśayahānaṃ ca smṛtisaṃprajñatā suci | civarādiśarīre ca kṛmīṇāmasamudbhavaḥ || abhs_4|42 ||	རྣམ་པ་ལྔ་དང་མི་འགྲོགས་དང་༎ བག་ལ་ཉལ་ཀུན་འཇོམས་པ་དང་༎ དྲན་པ་དང་ནི་ཤེས་བཞིན་དང་༎ གོས་ལ་སོགས་པ་གཙང་བ་དང་༎ ལུས་ལ་སྲིན་བུ་རྣམས་མི་འབྱུང་༎ གྱ་གྱུ་མེད་སེམས་སྦྱངས་པ་ནི་༎
 cittākauṭilyamādānaṃ dhūtasyāmatsarāditā | dharmatāyuktagāmitvaṃ lokārthaṃ narakaiṣaṇā || abhs_4|43 || parairaneyatā mārasyānyamārgopadeśinaḥ |	ལེན་དང་སེར་སྣ་མེད་སོགས་དང་༎ ཆོས་ཉིད་ལྡན་པར་འགྲོ་ཉིད་དང་༎ སེམས་ཅན་དོན་དུ་དམྱལ་ཚོལ་དང་༎ གཞན་གྱིས་བཀྲི་བར་མི་བཏུབ་དང་༎ ལམ་གཞན་ཉེ་བར་སྟོན་བདུད་ལ་༎
 māra ityavabodhaśca caryā buddhānumoditā || abhs_4|44 ||	བདུད་ཅེས་བྱ་བར་རྟོགས་པ་དང་༎ སངས་རྒྱས་དགྱེས་པའི་སྤྱོད་པ་སྟེ་༎ རྟགས་ནི་ཉི་ཤུ་དེ་དག་གིས་༎
 ūṣmamūrdhasu sa kṣāntiṣvagradharmeṣvavasthitaḥ |	དྲོད་དང་རྩེ་མོ་བཟོད་བཅས་དང་༎ ཆོས་མཆོག་རྣམས་ལ་གནས་པ་ནི་༎
 liṅgairamībhirviśatyā saṃbodherna vivartate || abhs_4|45 ||	རྫོགས་པའི་བྱང་ཆུབ་ལས་མི་ལྡོག་། 
 kṣāntijñānakṣaṇaḥ ṣaṭ ca pañca pañca ca dṛkpathe |	མཐོང་བའི་ལམ་ལ་བཟོད་པ་དང་༎ ཤེས་པའི་སྐད་ཅིག་བཅུ་དྲུག་ནི་༎ བྱང་ཆུབ་སེམས་དཔའ་མེ་ལྡོག་པའི་༎
 bodhisattvasya vijñeyamavaivartikalakṣaṇam || abhs_4|46 ||	མཚན་ཉིད་ཡིན་པར་ཤེས་པར་བྱ་༎
 rūpādisaṃjñāvyāvṛttirdārḍhyaṃ cittasya hinayoḥ |	གཟུགས་སོགས་འདུ་ཤེས་ལྡོག་པ་དང་༎ སེམས་བརྟེན་ཐེག་པ་དམན་དག་ལས་༎
 yānayorvinivṛttiśca dhyānādyaṅgaparikṣayaḥ || abhs_4|47 ||	རྣམ་ལོག་བསམ་གཏན་ལ་སོགས་པའི་༎ ཡན་ལག་ཡོངས་སུ་ཟད་པ་དང་༎ ལུས་སེམས་ཡང་བ་ཉིད་དང་ནི་༎
 kāyacetolaghutvaṃ ca kāmasevābhyupāyikī | sadaiva brahmacāritvamājīvasya viśuddhatā || abhs_4|48 || skandhādavantarāyeṣu saṃbhāre sendriyādike |	འདོད་ལ་སྤྱོད་ལ་ཐབས་མཁས་དང་༎ རྟག་ཏུ་ཚངས་པར་སྤྱོད་ཉིད་དང་༎ འཚོ་བ་རྣམ་པར་དག་ཉིད་དང་༎ ཕུང་སོགས་པར་ཆད་བྱེད་རྣམས་དང་༎ ཚོགས་དང་དབང་སོགས་བཅས་པ་ཡི་༎ ག-ཡུལ་འགྱེད་སེར་སྣ་ལ་སོགས་ལ་༎
 samare matsarādau ca neti yogānuyogayoḥ || abhs_4|49 ||	སྦྱོར་དང་རྗེས་སུ་སྦྱོར་བ་ཡི་༎
 vihārapratiṣedhaśca dharmasyāṇoralabdhatā |	གནས་པ་སོ་སོར་བཀག་པ་དང་༎ ཆོས་ནི་རྡུལ་ཙམ་མི་དམིགས་ཉིད་༎
 niścitatvaṃ svabhumau ca bhūmitritayasaṃsthitiḥ || abhs_4|50 ||	རང་གི་སལ་ངེས་པ་ཉིད་༎ ས་གསུམ་ལ་ནི་གནས་པ་དང་༎ ཆོས་ཀྱི་དོན་དུ་སྲོག་གཏོང་བ་༎
 dharmārthaṃ jīvitatyāga ityamī ṣoḍaśa kṣaṇāḥ |	དེ་འདྲའི་སྐད་ཅིག་བཅུ་དྲུག་ནི་༎
 avaivartikaliṅgāni dṛṅmārgasthasya dhīmataḥ || abhs_4|51 ||	བློ་ལྡན་མཐོང་བའི་ལམ་གནས་པའི་༎ ཕྱིར་མི་ལྡོག་པའི་རྟགས་དག་ཡིན་༎
 gambhiro bhāvanāmārgo gāmbhīryaṃ śunyatādikam |	སྒོམ་པའི་ལམ་ནི་ཟབ་པ་སྟེ་༎ ཟབ་མོ་སྟོང་པ་ཉིད་ལ་སོགས་༎
 samāropāpavādāntamuktatā sā gabhīratā || abhs_4|52 || cintātulananidhyānānyabhīkṣṇaṃ bhāvanāpathaḥ |	ཟབ་པ་དེ་ནི་སྒྲོ་འདོགས་དང་༎ སྐུར་པའི་མཐའ་ལས་གྲོལ་བ་ཉིད་༎
 nirvedhāṅgeṣu dṛṅmārge bhāvanāmārga eva ca || abhs_4|53 ||	ངེས་འབྱེད་ཡན་ལག་དང་མཐོང་བའི་༎ ལམ་དང་སྒོམ་པའི་ལམ་ཉིད་ལ་༎ ཡང་དང་ཡང་དུ་སེམས་པ་དང་༎ འཇལ་དང་༄༩ཨ་༌་༎
 prābandhakatvādiṣṭo 'sau navadhā ca prakārataḥ |	ངེས་རྟོག་སྒོམ་པའི་ལམ་༎ དེ་ནི་རྒྱུན་ཆགས་ཡིན་པའི་ཕྱིར་༎
 mṛdumadhyādhimātrāṇāṃ punarmṛdvādibhedataḥ || abhs_4|54 ||	ཆུང་དང་འབྲིང་དང་ཆེན་པོ་རྣམས་༎ ཆུང་དུའི་ཆུང་སོགས་དབྱེ་བ་ཡིས་༎ རྣམ་པས་རྣམ་པ་དགུར་བཞེད་དོ་༎
 asaṃkhyeyādinirdeśāḥ paramārthena na kṣamāḥ |	གྲངས་མེད་ལ་སོགས་བསྟན་པ་རྣམས་༎ དམ་པའི་དོན་དུ་བཟོད་མ་ཡིན་༎
 kṛpāniṣyandabhūtāste saṃvṛtyābhimatā muneḥ || abhs_4|55 ||	ཀུན་རྫོབ་ཏུ་ནི་ཐུགས་བརྩེ་བས་༎ རྒྱུ་མཐུན་དེ་དག་ཐུབ་པ་བཞེད་༎ དངོས་པོ་བརྗོད་དུ་མེད་པ་ལ་༎
 hānivṛddhī na yujyete nirālāpasya vastunaḥ |	ཉམས་པ་དང་ནི་འཕེལ་མི་རུང་༎ སྒོམ་ཞེས་བྱ་བའི་ལམ་གྱིས་ནི་༎
 bhāvanākhyena kiṃ hinaṃ vartmanā kimudāgatam || abhs_4|56 ||	ཅི་ཞིག་ཉམས་ཤིང་ཅི་ཞིག་འཐོབ་༎
 yathā bodhistathaivāsāviṣṭasyārthasya sādhakaḥ |	བྱང་ཆུབ་ཇི་ལྟ་དེ་བཞིན་དུ་༎ འདི་ནི་འདོད་པའི་དོན་སྒྲུབ་བྱེད་༏་། བྱང་ཆུབ་དེ་བཞིན་ཉིད་མཚན་ཉིད་༎
 tathatālakṣaṇā bodhiḥ so 'pi tallakṣaṇo mataḥ || abhs_4|57 ||	དེ་ཡང་དེ་ཡི་མཚན་ཉིད་བཞེད་༎
 pūrveṇa bodhirno yuktā manasā paścimena vā |	སེམས་ནི་སྔ་མས་བྱང་ཆུབ་པར་༎ རིགས་མིན་ཕྱི་མས་ཀྱང་ནི་མིན་༎
 dīpadṛṣṭāntayogenagambhīrā dharmatāṣṭadhā || abhs_4|58 ||	མར་མེའི་དཔེ་ཡི་ཚུལ་གྱིས་ནི་༎ ཟབ་མོའི་ཆོས་ཉིད་རྣམ་པ་བརྒྱད་༎
 utpāde ca nirodhe ca tathatāyāṃ gabhīratā | jñeye dāne ca caryāyāmadvayopāyakauśale ca || abhs_4|59 ||	སྐྱེ་བ་དང་ནི་འགག་པ་དང་༎ དེ་བཞིན་ཉིད་དང་ཤེས་བྱ་དང་༎ ཤེས་དང་སྤྱོད་དང་གཉིས་མེད་དང་༎ ཐབས་མཁས་པ་ལ་ཟབ་པ་ཉིད་༎
 svapnopamatvāddharmāṇāṃ bhavaśāntyorakalpanā |	ཆོས་རྣམས་རྨི་ལམ་འདྲ་བའི་ཕྱིར་༎ སྲིད་དང་ཞི་བར་མི་རྟོག་པ་༎
 karmābhāvādicodyānāṃ parihārā yathoditāḥ || abhs_4|60 ||	ལས་མེད་ལ་སོགས་ཀླན་ཀ་ཡི་༎ ལན་ནི་ཇི་སྐད་བཤད་པར་ཟད་༎ སེམས་ཅན་འཇིག་རྟེན་དེ་བཞིན་དུ་༎ སྣོད་ཀྱི་འཇིག་རྟེན་མ་དག་པ་༎
 sattvalokasya yā śuddhistasyāḥ suddhyupahārataḥ |	དེ་ལ་དག་པར་སྒྲུབ་པ་ཡིས་༎
 tathā bhājanalokasya buddhakṣetrasya śuddhatā || abhs_4|61 ||	སངས་རྒྱས་ཞིང་ནི་དག་པ་ཉིད་༎
 viṣayo 'sya prayogaśca śātravāṇāmatikramaḥ |	ཡུལ་དང་སྦྱོར་བ་ཅན་འདི་ནི་༎ དགྲ་རྣམས་ལས་ནི་འདས་པ་དང་༎ མི་ཤེས་ཇི་བཞིན་ཤུགས་དང་ནི་༎
 apratiṣṭho yathāvedhamasādhāraṇalakṣaṇaḥ || abhs_4|62 || asakto 'nupalambhaśca nimittapraṇidhikṣataḥ | lalliṅgaścāpramāṇaśca daśadhopāyakauśalam || abhs_4|63 ||	ཐུན་མོང་མ་ཡིན་མཚན་ཉིད་དང་༎ མ་ཆགས་པ་དང་མི་དམིགས་དང་༎ མཚན་མ་སྨོན་ལམ་ཟད་པ་དང་༎ དེ་ཡི་རྟགས་དང་ཚད་མེད་པ་༎
 || abhisamayālaṅkāre prajñāpāramitopadeśaśāstre	ཐབས་ལ་མཁས་པ་རྣམ་པ་བཅུ་༎ ཤེས་རབ་ཀྱི་ཕ་རོལ་ཏུ་ཕྱིན་པའི་མན་ངག་གི་བསྟན་བཅོས་མངོན་པར་རྟོགས་པའི་རྒྱན་གྱི་ཚིག་ལེའུར་བྱས་པ་ལས་།
 sarvākārābhisaṃbodhādhikāraś caturthaḥ ||	སྐབས་བཞི་པའོ་། ༎ ། རྨི་ལམ་ན་ཡང་ཆོས་རྣམས་ཀུན་༎
 svapnāntare 'pi svapnābhasarvadharmekṣaṇādikam |	རྨི་ལམ་ལྟ་བུར་ལྟ་ལ་སོགས་༎ རྩེ་མོར་ཕྱིན་པར་སྦྱོར་བའི་རྟགས་༎
 murdhaprāptasya yogasya liṅgaṃ dvādaśadhā matam || abhs_5|1 ||	རྣམ་པ་བཅུ་གཉིས་དག་ཏུ་བཞེད་༎
 jambudvipajaneyattābuddhapūjāśubhādikām |	འཛམ་བུའི་གླིང་གི་སྐྱེ་བོ་རྙེད་༎ སངས་རྒྱས་མཆོད་པའི་དགེ་ལ་སོགས་༎
 upamāṃ bahudhā kṛtvā vivṛddhiḥ ṣoḍaśātmikā || abhs_5|2 ||	རྣམ་མང་དུ་ནི་དཔེར་མཛད་ནས་༎ རྣམ་འཕེལ་བཅུ་༄༩བ་དྲུག་བདག་ཉིད་དོ་༎
 trisarvajñatvadharmāṇāṃ paripuriranuttarā |	ཀུན་མཁྱེན་ཉིད་གསུམ་ཆོས་རྣམས་ཀྱི་༎ ཡོངས་སུ་རྫོགས་པ་བླ་མེད་པ་༎
 aparityaktasattvārthā nirūḍhirabhidhīyate || abhs_5|3 ||	སེམས་ཅན་དོན་ཡོངས་མི་གཏོང་བ་༎ བསྟན་པ་ཞེས་ནི་མངོན་པར་བརྗོད་༎
 caturdvipakasāhasradvitrisāhasrakopamaḥ |	གླིང་བཞི་པ་དང་སྟོང་དག་དང་༎ སྟོང་གཉིས་གསུམ་དག་དཔེར་མཛད་ནས་༎
 kṛtvā puṇyabahutvena samādhiḥ parikīrtitaḥ || abhs_5|4 ||	བསོད་ནམས་མང་པོ་ཉིད་ཀྱིས་ནི་༎ ཏིང་འཛིན་ཡོངས་སུ་བསྒྲགས་པ་ཡིན་༎
 pravṛttau ca nivṛttau ca pratyekaṃ tau navātmakau |	འཇུག་པ་དང་ནི་ལྡོག་པ་ལ་༎
 grāhyau vikalpau vijñeyāvayāthāviṣayātmakau || abhs_5|5 ||	གཟུང་བའི་རྣམ་རྟོག་སོ་སོར་དེ་༎ དགུ་ཡི་བདག་ཉིད་ཇི་བཞིན་ཡུལ་༎ མི་ན་པའི་བདག་ཉིད་དག་ཤེས་བྱ་༎ སོ་སོའི་སྐྱེ་བོ་འཕགས་དབྱེ་བས་༎
 dravyaprajñaptisatsattvavikalpau grāhakau matau |	སེམས་ཅན་རྫས་དང་བཏགས་ཡོད་པར་༎ རྣམ་རྟོག་འཛིན་པ་དག་ཏུ་འདོད་༎
 pṛthagjanāryabhedena pratyekaṃ tau navātmakau || abhs_5|6 ||	དེ་དག་སོ་སོར་དགུ་བདག་ཉིད་༎ གལ་ཏེ་གཟུང་དོན་དེ་བཞིན་མེད་༎
 grāhyau cenna tathā sto 'rthau kasya tau grāhakau matau |	དེ་དག་གང་གི་འཛིན་པར་འདོད་༎ དེ་ལྟར་དེ་དག་འཛིན་པ་ཡི་༎
 iti grāhakabhāvena śunyatālakṣaṇaṃ tayoḥ || abhs_5|7 ||	ངོ་བོས་སྟོང་པའི་མཚན་ཉིད་དོ་༎
 eṣa svabhāve gotre ca pratipatsamudāgame |	ངོ་བོ་ཉིད་དང་རིགས་དང་ནི་༎
 jñānasyālambanābhrāntau pratipakṣavipakṣayoḥ || abhs_5|8 || svasminnadhigame kartṛtatkāritrakriyāphale |	ལམ་ནི་ཡང་དག་འགྲུབ་པ་དང་༎ ཤེས་པའི་དམིགས་པ་མ་འཁྲུལ་དང་༎ མི་མཐུན་ཕྱོགས་དང་གཉེན་པོ་དང་༎ རང་གིས་རྟོགས་དང་བྱེད་པ་དང་༎ དེ་ཡི་ལས་བྱའི་འབྲས་བུལ་༎
 pravṛttipakṣādhiṣṭhāno vikalpo navadhā mataḥ || abhs_5|9 ||	འཇུག་པའི་ཕྱོགས་ཀྱི་རྟེན་ཅན་གྱི་༎ རྣམ་རྟོག་དེ་ནི་རྣམ་དགུར་འདོད་༎
 bhavaśāntiprapātitvānnyūnatve 'dhigamasya ca |	སྲིད་དང་ཞི་བར་ལྟུང་བའི་ཕྱིར་༎ རྟོགས་པ་དམན་པ་ཉིད་དང་ནི་༎
 parigrahasyābhāve ca vaikalye pratipadgate || abhs_5|10 ||	ཡོངས་སུ་འཛིན་པ་མེད་པ་དང་༎ ལམ་གྱི་རྣམ་པ་མ་ཚང་དང་༎ གཞན་གྱི་རྐྱེན་གྱིས་འགྲོ་བ་དང་༎ ཆེད་དུ་བྱ་བ་ལོག་པ་དང་༎ ཉི་ཚེ་བ་དང་སྣ་ཚོགས་ཉིད་༎
 parapratyayagāmitve samuddeśanivartane | prādeśikatve nānātve sthānaprasthānamohayoḥ || abhs_5|11 ||	གནས་དང་འཇུག་ལ་རྨོངས་པ་དང་༎ རྗེས་ལ་འགྲོ་ཞེས་བྱ་བ་ལ་༎
 pṛṣṭhato gamane ceti vikalpo 'yaṃ navātmakaḥ |	རྣམ་རྟོག་དགུ་ཡི་བདག་ཉིད་འདི་༎
 nivṛttipakṣādhiṣṭhānaḥ śrāvakādimanobhavaḥ || abhs_5|12 ||	ལྡོག་པའི་ཕྱོགས་ཀྱི་རྟེན་ཅན་ཏེ་༎ ཉན་ཐོས་ལ་སོགས་ཡིད་ལ་འབྱུང་༎
 grāhakaḥ prathamo jñeyo gragaṇapratimokṣaṇe | manaskriyāyāṃ dhātūnāmupaśleṣe trayasya ca || abhs_5|13 ||	འཛིན་པ་དང་ནི་འདོར་བ་དང་༎ ཡིད་ལ་བྱེད་དང་ཁམས་རྣམས་ནི་༎
 sthāne cābhiniveśe ca prajñaptau dharmavastunaḥ | saktau ca pratipakṣe ca yathecchaṃ ca gatikṣatau || abhs_5|14 ||	གསུམ་པོ་དག་དང་ཉེ་འབྲེལ་དང་༎ གནས་དང་མངོན་པར་ཞེན་པ་དང་༎ ཆོས་ཀྱི་དངོས་པོ་བརྟགས་པ་དང་༎ ཆགས་པ་དང་ནི་གཉེན་པོ་དང་༎ ཇི་ལྟར་འདོད་བཞིན་འགྲོ་ཉམས་ལ་༎ འཛིན་པ་དང་པོར་ཤེས་པར་བྱ་༎
 yathoddeśamaniryāṇe mārgāmārgāvadhāraṇe | sanirodhe samutpāde vastuyogaviyogayoḥ || abhs_5|15 ||	ཆེད་བཞིན་ངེས་པར་མི་འབྱུང་དང་༎ ལམ་ལ་ལམ་མིན་ངེས་འཛིན་དང་༎ འགག་དང་བཅས་པའི་སྐྱེ་བ་དང་༎ དངོས་༄༡༠ཨ་༌་༎
 sthāne gotrasya nāśe ca prārthanāhetvabhāvayoḥ |	པོ་ལྡན་དང་མི་ལྡན་དང་༎ གནས་དང་རིགས་ནི་འཛིན་པ་དང་༎ དོན་དུ་གཉེར་དང་རྒྱུ་མེད་དང་༎ ཕྱིར་རྒལ་བ་ནི་དམིགས་པ་ལ་༎
 pratyarthikopalambhe ca vikalpo grāhako 'paraḥ || abhs_5|16 ||	འཛིན་པའི་རྣམ་རྟོག་གཞན་ཡིན་ནོ་༎
 bodhau sandarśanānyeṣāṃ taddhetośca parindanā |	བྱང་ཆུབ་ལ་གཞན་སྟོན་པ་དང་༎ དེ་ཡི་རྒྱུ་ནི་ཡོངས་གཏོད་དང་༎ དེ་ཐོབ་པར་ཆད་མེད་པའི་རྒྱུ་༎
 tatprāptyanantaro hetuḥ puṇyabāhulyalakṣaṇaḥ || abhs_5|17 ||	བསོད་ནམས་མང་པོའི་མཚན་ཉིད་དོ་༎
 kṣayānutpādayorjñāne malānāṃ bodhirūcyate |	དྲི་མ་ཟད་དང་མི་སྐྱེ་བའི་༎ ཡེ་ཤེས་བྱང་ཆུབ་ཅེས་བརྗོད་དོ་༎
 kṣayābhāvādanutpādātte hi jñeye yathākramam || abhs_5|18 ||	ཟད་མེད་སྐྱེ་མེད་ཕྱིར་དེ་དག་། གོ་རིམས་བཞིན་དུ་ཤེས་པར་བྱ་༎ འགོག་པ་མེད་པའི་རང་བཞིན་ལ་༎
 prakṛtāvaniruddhāyāṃ darśanākhyena vartmanā |	མཐོང་ཞེས་བྱ་བའི་ལམ་གྱིས་ནི༎
 vikalpajātaṃ kiṃ kṣīṇaṃ vānutpattimāgatam || abhs_5|19 ||	རྣམ་པར་རྟོག་རིགས་ཅི་ཞིག་ཟད་༎ སྐྱེ་མེད་རྣམ་པ་ཅི་ཞིག་འཐོབ་༎ གཞན་གྱིས་ཆོས་རྣམས་ཀྱང་ཡོད་ལ་༎
 sattā ca nāma dharmāṇāṃ jñeye cāvaraṇakṣayaḥ |	ཤེས་བྱ་ལ་ཡང་སྟོན་པ་ཡི་༎ སྒྲིབ་པ་ཟད་པར་བརྗོད་པ་གང་༎
 kathyate yatparaiḥ śāsturatra vismīyate mayā || abhs_5|20 ||	དེ་ལ་ཁོ་བོས་མཚར་དུ་བརྩིས་༎
 nāpaneyamataḥ kiṃcitprakṣeptavyaṃ na kiṃcana |	འདི་ལས་བསལ་བྱ་ཅི་ཡང་མེད་༎ གཞག་པར་བྱ་བ་ཅུང་ཟད་མེད་༎ ཡང་དག་ཉིད་ལ་ཡང་དག་ལྟ་༎
 draṣṭavyaṃ bhūtato bhūtaṃ bhūtadarśī vimucyate || abhs_5|21 ||	ཡང་དག་མཐོང་ན་རྣམ་པར་གྲོལ་༎
 ekaikasyaiva dānādau teṣāṃ yaḥ saṃgraho mithaḥ |	སྦྱིན་པ་ལ་སོགས་རེ་རེར་ནི་༎ དེ་དག་ཕན་ཚུན་བསྡུས་པ་གང་༎
 sa ekakṣaṇikaḥ kṣāntisaṃgṛhīto 'tra dṛkpathe || abhs_5|22 ||	སྐད་ཅིག་གཅིག་པའི་བཟོད་པ་ཡིས་༎ བསྡུས་པ་དེ་འདིར་མཐོང་བའི་ལམ་༎
 sa samādhiṃ samāpadya tataḥ siṃhavijṛmbhitam |	དེ་ནས་སེང་གེ་རྣམ་བསྒྱིངས་པའི་༎ ཏིང་ངེ་འཛིན་ལ་སྙོམས་ཞུགས་ནས་༎
 anulomaṃ vilomaṃ pratītyotpādamīkṣate || abhs_5|23 ||	རྟེན་ཅིང་འབྲེལ་འབྱུང་ལུགས་མཐུན་དང་༎ ལུགས་མི་མཐུན་ལ་རྟོག་པར་བྱེད་༎ འགོག་དང་བཅས་པའི་སྙོམས་འཇུག་དགུར་༎
 kāmāptamavadhīkṛtya vijñānamasamāhitam |	རྣམ་པ་གཉིས་སུ་སོང་འོངས་ནས་༎ འདོད་པར་གཏོགས་པའི་རྣམ་པར་ཤེས་༎ མཉམ་གཞག་མིན་པའི་མཚམས་བཟུང་སྟེ་༎
 sanirodhāḥ samāpattīrgatvāgamya nava dvidhā || abhs_5|24 ||	ཐོད་རྒལ་དུ་ནི་སྙོམས་འཇུག་པ་༎
 ekadvitricatuḥpañcaṣaṭsaptāṣṭavyatikramāt |	གཅིག་དང་གཉིས་གསུམ་བཞི་དང་ལྔ་༎ དྲུག་དང་བདུན་དང་བརྒྱད་རྒལ་ནས་༎
 avaskandasamāpattirāniroodhamatulyatā || abhs_5|25 ||	འགོག་པའི་བར་དུ་མི་འདྲར་འགྲོ་༎
 saṃkṣepe vistare buddhaiḥ sanāthyenāparigrahe |	མདོར་བསྡུས་རྒྱས་དང་སངས་རྒྱས་ཀྱི་༎
 traikālike guṇābhāve śreyasastrividhe pathi || abhs_5|26 ||	བསྟང་བས་ཡོངས་སུ་མ་བཟུང་དང་༎ དུས་གསུམ་ཡོན་ཏན་མེད་པ་དང་༎ ལེགས་པའི་ལམ་ནི་རྣམ་གསུམ་ལ་༎
 eko grāhyavikalpo 'yaṃ prayogākāragocaraḥ |	བཟུང་བའི་རྣམ་རྟོག་འདི་གཅིག་སྟེ་༎ སྒྱོར་བའི་རྣམ་པའི་སྤྱོད་ཡུལ་ཅན་༎
 dvitīyaścittacaittānāṃ pravṛttiviṣayo mataḥ || abhs_5|27 ||	གཉིས་པ་སེམས་དང་སེམས་བྱུང་རྣམས་༎ འཇུག་པའི་ཡུལ་ཅན་ཡིན་བཞེད་དེ་༎
 anutpādastu cittasya bodhimaṇḍāmanaskriyā |	སེམས་༄༡༠བ་མི་སྐྱེ་དང་བྱང་ཆུབ་ཀྱི་༎
 hīnayānamanaskārau saṃbodheramanaskṛtiḥ || abhs_5|28 ||	སྙིང་པོ་ཡིད་ལ་མི་བྱེད་དང་༎ ཐེག་པ་དམན་པ་ཡིད་བྱེད་དང་༎ རྫོགས་པའི་བྱང་ཆུབ་ཡིད་མི་བྱེད་༎
 bhāvane 'bhāvane caiva tadviparyaya eva ca | ayathārthaśca vijñeyo vikalpo bhāvanāpathe || abhs_5|29 ||	སྒོམ་དང་སྒོམ་པ་མེད་པ་དང་༎ དེ་དག་ལས་ནི་བཟློག་ཉིད་དང་༎ ཇི་བཞིན་དོན་མིན་རྣམ་རྟོག་པ་༎
 grāhakaḥ prathamo jñeyaḥ sattvaprajñaptigocaraḥ | dharmaprajñaptyaśūnyatve saktipravicayātmakaḥ || abhs_5|30 ||	སྒོམ་པའི་ལམ་ལ་ཤེས་པར་བྱ་༏་། སེམས་ཅན་བཏགས་པའི་སྤྱོད་ཡུལ་དང་༎ ཆོས་བཏགས་པ་དང་སྟོང་མིན་ཉིད་༎
 kṛtena vastuno yānatritaye ca sa kīrtitaḥ | dakṣiṇāyā aśuddhau ca caryāyāśca vikopane || abhs_5|31 ||	ཆགས་དང་རབ་འབྱེད་བདག་ཉིད་དང་༎ དངོས་པོར་བྱེད་དང་ཐེག་གསུམ་དང་༎ ཡོན་ནི་དག་པ་མ་ཡིན་དང་༎ སྤྱོད་པ་རྣམ་པར་འཁྲུག་པ་ལ་༎ འཛིན་པར་བྱེད་པ་དང་པོར་ཏེ་༎ ཤེས་པར་བྱ་བ་བསྒྲགས་པ་ཡིན་༎
 sattvaprajñaptitaddhetuviṣayo navadhāparaḥ |	སེམས་ཅན་བཏགས་དང་དེའི་རྒྱུ་ཡི་༎
 bhāvanāmārgasaṃbuddho vipakṣastadvighātataḥ || abhs_5|32 ||	ཡུལ་ཅན་དེ་ཡིས་རྣམ་འཇོམས་པས་༎ སྒོམ་པའི་ལམ་དང་འབྲེལ་པ་ཡི་༎ མི་མཐུན་ཕྱོགས་གཞན་རྣམ་པ་དགུ་༎ བདག་ཉིད་ཇི་བཞིན་ཀུན་མཁྱེན་ནི་༎
 sarvajñatānāṃ tisr^īṇāṃ yathāsvaṃ trividhāvṛtau | śāntimārge tathatādisaṃprayogaviyogayoḥ || abhs_5|33 || asamatve ca duḥkhādau kleśānāṃ prakṛtāvapi |	གསུམ་གྱི་སྒྲིབ་པ་རྣམ་གསུམ་དང་༎ ཞི་ལམ་དེ་བཞིན་ཉིད་སོགས་དང་༎ མཚུངས་པར་ལྡན་དང་མི་ལྡན་དང་༎ མི་མཉམ་སྡུག་བསྔལ་ལ་སོགས་དང་༎ ཉོན་མོངས་རྣམས་ཀྱི་རང་བཞིན་དང་༎ གཉིས་སུ་མེད་དང་ཀུན་རྨོངས་ལ་༎
 dvayābhāve ca saṃmohe vikalpaḥ paścimo mataḥ || abhs_5|34 ||	རྣམ་པར་རྟོག་པ་ཐ་མར་བཞེད་༎ ཡམས་ནད་འདི་རྣམས་ཟད་ནས་ནི་༎
 āsāṃ kṣaye satītīnāṃ cirāyocchvasitā iva |	ཡུན་རིང་ལོན་ནས་དབུགས་ཕྱིན་ལྟར་༎
 sarvākārajagatsaukhyasādhanā guṇasaṃpadaḥ || abhs_5|35 ||	རྣམ་པ་ཀུན་ཏུ་འགྲོ་བ་ཡི་༎ བདེ་སྒྲུབ་ཡོན་ཏན་ཕུན་ཚོགས་ཀུན་༎ རྒྱ་མཚོ་ཆེ་ལ་ཆུ་བོ་བཞིན་༎
 sarvāḥ sarvābhisāreṇa nikāmaphalaśālinam |	འབྲས་བུ་མཆོག་གིས་སྦ་བ་ཡིས་༎
 bhajante taṃ mahāsattvaṃ mahodadhimivāpagāḥ || abhs_5|36 ||	སེམས་དཔའ་ཆེན་པོ་དེ་ལ་ནི་༎ རྣམ་པ་ཀུན་དུ་རྟེན་པར་བྱེད་༎
 trisāhasrajanaṃ śiṣyakhaḍgādhigamasaṃpadi |	སྟོང་གསུམ་སྐྱེ་བོ་ཉན་ཐོས་དང་༎ བསེ་རུའི་རྟོགས་པ་ཕུན་ཚོགས་དང་༎ བྱང་ཆུབ་སེམས་དཔའི་སྐྱོན་མེད་ལ་༎
 bodhisattvasya ca nyāmo pratiṣṭāpya śubhopamāḥ || abhs_5|37 ||	བཀོད་པའི་དགེ་བ་དཔེར་མཛད་ནས་༎
 kṛtvā puṇyabahutvena buddhatvapteranantaraḥ |	བསོད་ནམས་མང་པོ་ཉིད་ཀྱིས་ནི་༎ སངས་རྒྱས་ཉིད་ཀྱི་བར་མེད་དེ་༎
 ānantaryasamādhiḥ sa sarvākārajñatā ca tat || abhs_5|38 ||	བར་ཆད་མེད་པའི་ཏིང་ངེ་འཛིན་༎ དེ་ནི་རྣམ་པ་ཀུན་མཁྱེན་ཉིད་༎
 ālambanamabhāvo 'sya smṛtiścādhipatirmataḥ |	འདི་ཡི་དམིགས་པ་དངོས་མེད་དེ་༎ བདག་པོ་དྲན་པ་ཡིན་པར་བཞེད་༎
 ākāraḥ śāntatā cātra jalpājalpipravādinām || abhs_5|39 ||	རྣམ་པ་ཞི་ཉིད་འདི་ལ་ནི་༎ རབ་ཏུ་སྨྲ་རྣམས་བརྒྱུད་པར་རྒོལ་༎
 ālambanopapattau ca tatsvabhāvāvadhārraṇe |	དམིགས་པ་འཐད་དང་དེ་ཡི་ནི་༎ ངོ་བོ་ཉིད་ངེས་བཟུང་བ་༄༡༡ཨ་༌་༎
 sarvākārajñatājñāne paramārthe sasaṃvṛtau || abhs_5|40 || prayoge triṣu ratneṣu sopāye samaye muneḥ | viparyāse samārge ca pratipakṣavipakṣayoḥ || abhs_5|41 || lakṣaṇe bhāvanāyāṃ ca matā vipratipattayaḥ |	དང་༎ རྣམ་ཀུན་མཁྱེན་ཉིད་ཡེ་ཤེས་དང་༎ དམ་པའི་དོན་དང་ཀུན་རྫོབ་དང་༎ སྦྱོར་དང་དཀོན་མཆོག་གསུམ་པོ་དང་༎ ཐབས་བཅས་ཐུབ་པའི་རྟོགས་པ་དང་༎ ཕྱིན་ཅི་ལོག་ནི་ལམ་བཅས་དང་༎ གཉེན་པོ་མི་མཐུན་ཕྱོགས་དག་དང་༎ མཚན་ཉིད་དང་ནི་སྒོམ་པ་ལ་༎ སྨྲ་བ་རྣམས་ཀྱིས་ལོག་རྟོག་པ་༎
 sarvākārajñatādhārā ṣoḍhā daśa ca cādinām || abhs_5|42 ||	རྣམ་པ་ཀུན་མཁྱེན་ཉིད་རྟེན་ཅན་༎ རྣམ་པ་བཅུ་དྲུག་དག་ཏུ་བཞེད་༎
 || abhisamayālaṅkāre prajñāpāramitopadeśaśāstre	ཤེས་རབ་ཀྱི་ཕ་རོལ་ཏུ་ཕྱིན་པའི་མན་ངག་གི་བསྟན་བཅོས་མངོན་པར་རྟོགས་པའི་རྒྱན་གྱི་ཚིག་ལེའུར་བྱས་པ་ལས་།
 mūrdhābhisamayādhikāraḥ pañcamaḥ ||	སྐབས་ལྔ་པའོ་།
 dānena prajñayā yāvadbuddhādau smṛtibhiśca sā |	༎ ། སྦྱིན་པ་ཤེས་རབ་བར་དག་དང་༎ སངས་རྒྱས་ལ་སོགས་དྲན་དང་ཆོས་༎
 dharmābhāvasvabhāvenetyanupūrvakriyā matā || abhs_6|1 ||	དངོས་མེད་ངོ་བོ་ཉིད་ཀྱིས་དེ་༎
 || abhisamayālaṅkāre prajñāpāramitopadeśaśāstre	མཐར་གྱིས་པ་ཡི་བྱ་བར་བཞེད་༎ ཤེས་རབ་ཀྱི་ཕ་རོལ་ཏུ་ཕྱིན་པའི་མན་ངག་གི་བསྟན་བཅོས་མངོན་པར་རྟོགས་པའི་རྒྱན་གྱི་ཚིག་ལེའུར་བྱས་པ་ལས་།
 anupurvābhisamayādhikāraḥ ṣaṣṭhaḥ ||	སྐབས་དྲུག་པའོ་། ༎ ། སྦྱིན་པ་ལ་སོགས་རེ་རེས་ཀྱང་༎
 anūsravāṇāṃ sarveṣāmekaikenāpi saṃgrahāt |	ཟག་མད་ཆོས་ཀུན་བསྡུས་པའི་ཕྱིར་༎
 ekakṣaṇāvabodho 'yaṃ jñeyo dānādinā muneḥ || abhs_7|1 ||	ཐུབ་པའི་སྐད་ཅིག་གཅིག་པ་ཡིས་༎ རྟོགས་པ་འདི་ནི་ཤེས་པར་བྱ་༎
 aradhaṭṭaṃ yathaikāpi padikā purūṣeritā |	ཇི་ལྟར་སྐྱེས་བུས་ཟོ་ཆུན་རྒྱུད་༎ རྡོག་ཐབས་གཅིག་གིས་བསྐྱོད་པ་ན་༎
 sakṛtsarvaṃ calayati jñānamekakṣaṇe tathā || abhs_7|2 ||	ཐམས་ཅད་ཅིག་ཅར་འགུལ་བ་ལྟར་༎ སྐད་ཅིག་གཅིག་ཤེས་དེ་བཞིན་ནོ་༎ གང་ཚེ་ཆོས་དཀར་ཐམས་ཅད་ཀྱི་༎
 vipākadharmatāvasthā sarvaśuklamayī yadā |	རང་བཞིན་ཤེས་རབ་ཕ་རོལ་ཕྱིན་༎ རྣམ་སྨིན་ཆོས་ཉིད་གནས་སྐབས་སྐྱེས་༎
 prajñāpāramitā jātā jñānamekakṣaṇe tadā || abhs_7|3 ||	དེ་ཚེ་སྐད་ཅིག་གཅིག་ཡེ་ཤེས་༎
 svapnopameṣu dharmeṣu sthitvā dānādicaryā |	སྦྱིན་ལ་སོགས་པའི་སྤྱོད་པ་ཡིས་༎ ཆོས་ཀུན་རྨི་ལམ་འདྲར་གནས་ནས་༎ ཆོས་རྣམས་མཚན་ཉིད་མེད་པ་ཉིད་༎
 alakṣatvaṃ dharmāṇāṃ kṣaṇenaikena vindati || abhs_7|4 ||	སྐད་ཅིག་མ་ནི་གཅིག་གིས་རྟོགས་༎
 svapnaṃ taddarśinaṃ caiva dvayayogena nekṣate |	རྨི་ལམ་དང་ནི་དེ་མཐོང་ཉིད་༎ གཉིས་ཀྱི་ཚུལ་དུ་མི་མཐོང་ལྟར་༎
 dharmāṇāmadvayaṃ tattvaṃ kṣaṇenaikenapaṣyati || abhs_7|5 ||	ཆོས་རྣམས་གཉིས་སུ་མེད་པ་ཡི་༎ དེ་ཉིད་སྐད་ཅིག་གཅིག་གིས་མཐོང༎
 || abhisamayālaṅkāre prajñāpāramitopadeśaśāstre	ཤེས་རབ་ཀྱི་ཕ་རོལ་ཏུ་ཕྱིན་པའི་མན་ངག་གི་བསྟན་བཅོས་མངོན་པར་རྟོགས་པའི་རྒྱན་གྱི་ཚིག་ལེའུར་བྱས་པ་ལས་།
 ekakṣaṇābhisamayādhikāraḥ saptamaḥ ||	སྐབས་བདུན་པའོ་། ༎ ། ཐུབ་པའི་ངོ་བོ་ཉིད་སྐུ་ནི་༎
 sarvākārāṃ viśuddhiṃ ye dharmāḥ prāptā nirāsravāḥ |	།
 svābhāvikomuneḥ kāyasteśāṃ prakṛtilakṣaṇaḥ || abhs_8|1 ||	དེ་དག་༄༡༡བ་རང་བཞིན་མཚན་ཉིད་ཅན་༎
 bodhipakṣāpramāṇāni vimokṣā anūpurvaśaḥ |	བྱང་ཆུབ་ཕྱོགས་མཐུན་ཚད་མེད་དང་༎ རྣམ་པར་ཐར་དང་མཐར་གྱིས་ནི་༎
 navātmikā samāpattiḥ kṛtsnaṃ daśavidhātmikam || abhs_8|2 || abhibhvāyatanānyaṣṭaprakārāṇi prabhedataḥ |	སྙོམས་འཇུག་དགུ་ཡི་བདག་ཉིད་དང་༎ ཟད་པར་བཅུ་ཡི་བདག་ཉིད་དང་༎ ཟིལ་གྱིས་གནོན་པའི་སྐྱ་མཆེད་ནི་༎
 araṇā praṇidhijñānamabhijñāḥ pratisaṃvidaḥ || abhs_8|3 ||	རབ་ཏུ་དབྱེ་བས་རྣམ་བརྒྱད་དང་༎ ཉོན་མོངས་མེད་དང་སྨོན་མཁྱེན་དང་༎ མངོན་ཤེས་སོ་སོ་ཡང་དག་རིག་། 
 sarvākārāścatasno 'thaśuddhayo vaśitā daśa || balāni daśa catvāri vaiśāradyānyārakṣaṇam || abhs_8|4 || trividhaṃ smṛtyupasthānaṃ tridhāsaṃmoṣadharmatā | vāsanāyāḥ samuddhāto mahati karūṇā jane || abhs_8|5 ||	རྣམ་པ་ཐམས་ཅད་དག་བཞི་དང་༎ དབང་བཅུ་དང་ནི་སྟོབས་བཅུ་དང་༎ མི་འཇིགས་པ་ནི་བཞི་དག་དང་༎ བསྲུང་བ་མེད་པ་རྣམ་གསུམ་དང་༎ དྲན་པ་ཉེར་གཞག་རྣམ་གསུམ་དང་༎ བསྙེལ་བ་མི་མངའི་ཆོས་ཉིད་དང་༎ བག་ཆགས་ཡང་དག་བཅོམ་པ་དང་༎ སྐྱེ་ལ་ཐུགས་རྗེ་ཆེན་པོ་དང་༎ ཐུབ་པ་ཁོ་ནའི་མ་འདྲེས་ཆོས་༎
 āveṇikā munereva dharmā ye 'ṣṭādaśeritāḥ | sarvākārajñatā ceti dharmakāyo 'bhidhīyate || abhs_8|6 ||	བཅོ་བརྒྱད་བཤད་པ་གང་ཡིན་དང་༎ རྣམ་པ་ཐམས་ཅད་མཁྱེན་ཉིད་དང་༎ ཆོས་ཀྱི་སྐུ་ཞེས་བརྗོད་པ་ཡིན་༎ ཉན་ཐོས་ཉོན་མོངས་མེད་པའི་ལྟ་༎
 śravakasyāraṇādṛṣṭernṛkleśaparihāritā |	ཉན་ཐོས་ཉོན་མོངས་ཡོངས་སྤོང་ཉིད་༎
 tatkleśasrotaucchittyai grāmādiṣu jināraṇā || abhs_8|7 ||	གྲོང་སོགས་སུ་དེའི་ཉོན་མོངས་རྣམས་༎
 anābhogamanāsaṅmavyāghātaṃ sadā sthitam |	རྒྱུན་གཅོད་རྒྱལ་བའི་ཉོན་མོངས་མེད་༎
 sarvapraśnāpanudvauddhaṃ praṇidhijñānamiṣyate || abhs_8|8 ||	སངས་རྒྱས་སྨོན་ནས་མཁྱེན་པ་ནི་༎ ལྷུན་གྱིས་གྲུབ་དང་ཆགས་སྤངས་དང་༎ ཐོགས་པ་མེད་དང་རྟག་གནས་དང་༎ དྲི་བ་ཀུན་ལན་འདེབས་པར་བཞེད་༎
 paripākaṃ gate hetau yasya yasya yadā yadā |	རྒྱུ་ནི་ཡོངས་སུ་སྨིན་གྱུར་ནས་༎ གང་དང་གང་ལ་གང་དང་ནི་༎ གང་ཚེ་བྱ་བ་ཕན་གྱུར་པ་༎
 hitaṃ bhavati kartavyaṃ prathate tasya tasya saḥ || abhs_8|9 ||	དེ་དང་དེ་ལ་དེ་སྣང་ངོ་༎ ལྷ་ཡི་རྒྱལ་པོས་ཆར་ཕབ་ཀྱང་༎
 varṣatyapi hi parjanye naiva bījaṃ prarohati |	ས་བོན་མི་རུང་མི་འཁྲུངས་ལྟར་༎
 samutpāde 'pi buddhānāṃ nābhavyo bhadramaśrute || abhs_8|10 ||	སངས་རྒྱས་རྣམས་ནི་བྱུང་གྱུར་ཀྱང་༎ སྐལ་བ་མེད་པས་བཟང་མི་མྱོང་༎ དེ་ལྟར་མཛད་པ་རྒྱ་ཆེའི་ཕྱིར་༎
 iti kāritravaipulyāt buddho vyāpī nirūcyate |	སངས་རྒྱས་ཁྱབ་པར་ངེས་པར་བརྗོད་༎
 akṣayatvācca tasyaiva nitya ityapi kathyate || abhs_8|11 ||	དེ་ཉིད་ཟད་པ་མེད་པའི་ཕྱིར་༎ རྟག་པ་ཞེས་ཀྱང་བརྗོད་པ་ཡིན་༎
 dvātriṃśallakṣaṇāśītivyañjanātmā munerayam |	མཚན་ནི་སུམ་ཅུ་རྩ་གཉིས་དང་༎ དཔེ་བྱད་བརྒྱད་ཅུའི་བདག་ཉིད་འདི་༎ ཐེག་ཆེན་ཉེ་བར་ལོངས་སྤྱོད་ཕྱིར་༎
 sāṃbhogiko mataḥ kāyo mahāyānopabhogataḥ || abhs_8|12 ||	ཐུབ་པའི་ལོངས་སྤྱོད་རྫོགས་སྐུར་བཞེད་༎
 cakrāṅkahastaḥ krākurmapādo jālāvāddhāṅgulipāṇipādaḥ |	ཕྱག་ཞབས་འཁོར་ལོའི་མཚན་དང་རུས་སྦལ་ཞབས་༎ ཕྱག་དང་ཞབས་སོར་དྲ་༄༡༢ཨ་༌་༎
 karau sapādau tarūṇau mṛdū ca mamutsadaiḥ saptabhirāśrayo 'sya || abhs_8|13 ||	བས་འབྲེལ་པ་དང་༎ ཕྱག་ནི་ཞབས་བཅས་འཇམ་ཞིང་གཞོན་ཤ་ཆགས་༎
 dīrghāṅgulirvyāyatapārṣṇigātraṃ prājyaṃ tvṛjucchaṅkhapadordhvaromā |	འདི་ཡི་སྐུ་ནི་བདུན་དག་མཐོ་བ་དང་༎ སོར་མོ་རིང་དང་རྟིང་ཡངས་སྐུ་ཆེ་དྲང་༎ ཞབས་འབུར་མི་མངོན་སྤུ་ནི་གྱེན་དུ་ཕྱོགས་༎ བྱིན་པ་ཨཨེ་ན་ཡའི་འདྲ་ཕྱག་རིད་མཛེས་༎
 eṇeyajaṅghaśca paṭūrūbāhuḥ kośāvanaddhottamabastiguhyaḥ || abhs_8|14 ||	མདོམས་ཀྱི་སྦ་བ་སྦུབས་སུ་ནུབ་པའི་མཆོག་། 
 suvarṇavarṇḥ pratanucchaviśca pradakṣiṇaikaikasujātromā |	པགས་པ་གསེར་མདོག་པགས་པ་སྲབ་པ་དང་༎ སྦུ་ནི་རེ་རེ་ནས་ག-ཡས་ལེགས་འཁྲུངས་དང་༎ ཞལ་མཛོད་སྦུས་བརྒྱན་རོ་སྟོད་སེང་གེ་འདྲ་༎
 ūūrṇāṅkitāsyo haripūrvakāyaḥ skandhau vṛtāvasya citāntarāṃsaḥ || abhs_8|15 ||	འདི་ཡི་དཔུང་པའི་མགོ་ཟླུམ་ཐལ་གོང་རྒྱས་༎
 hīno rasaḥ khyāti rasottamo 'sya nyagrodhavanmāṇḍalatulyamūrtiḥ |	འདི་ལ་རོ་མི་ཞིམ་པ་རོ་མཆོག་སྣང་༎ སྐུ་ནི་ཉ་གྲོ་དྷ་ལྟར་ཆུ་ཞེང་གབ་༎
 uṣīṣamūrdhā pṛthucārūjihvo brahmasvaraḥ siṃhahanuḥ suśuklāḥ || abhs_8|16 ||	གཙུག་ཏོར་དབུར་ལྡན་ལྗགས་རིང་མཛེས་པ་དང་༎ ཚངས་དབྱངས་འགྲམ་པ་སེང་གེའི་འདྲ་དང་ཚེམས་༎
 tulyāḥ pramāṇe 'viralāsca dantā anyūnasaṃkhyā daśikāścatasraḥ | nīlekśaṇe govṛṣapakṣmanetro dvātriṃśadetāni hi lakṣaṇāni || abhs_8|17 ||	ཤིན་ཏུ་དཀར་དང་ཚེད་?་མཉམ་ཐགས་བཟང་དང་༎ གྲངས་ནི་བཞི་བཅུ་ཐམས་པར་ཚང་བ་དང་༎ སྤྱན་ནི་མཐོན་མཐིང་སྤྱན་རྫི་བ་མཆོག་གི་།འདྲ་བ་འདི་དག་གསུམ་ཅུ་རྩ་གཉིས་མཚན་༎
 yasya yasyātra yo heturlakṣaṇasya prasādhakaḥ |	འདི་ལ་མཚན་ནི་གང་གང་གིས་༎ སྒྲུབ་པར་བྱེད་པའི་རྒྱུ་གང་ཡིན་༎
 tasya tasya prapūryāyaṃ samudāgamalakṣaṇaḥ || abhs_8|18 ||	དེ་དང་དེ་ནི་རབ་རྫོགས་པས་༎ མཚན་ནི་འདི་དག་ཡང་དག་འགྲུབ་༎
 gurūṇāmanuyānādirdṛḍhatā saṃvaraṃ prati | saṃgrahāsevanaṃ dānaṃ praṇitasya ca vastunaḥ || abhs_8|19 ||	བླ་མ་སྐྱེལ་ལ་སོགས་པ་དང་༎ ཡང་དག་བླངས་པ་བརྟན་པ་དང་༎ བསྡུ་བ་བསྟེན་དང་གྱ་ནོམ་པའི་༎ དངོས་པོ་སྦྱིན་དང་གསད་བྱ་བ་༎
 vadhyamokṣasamādānāṃ vivr6iddhiḥ kuśalasya ca |	ཐར་བར་བྱེད་དང་དགེ་བ་ནི་༎ ཡང་དག་བླངས་པ་སྤེལ་ལ་སོགས་༎
 ityādiko yathāsutraṃ heturlakṣaṇasādhakaḥ || abhs_8|20 ||	སྒྲུབ་བྱེད་རྒྱུ་ཡི་མཚན་ཉིད་དེ་༏་། མདོ་ལས་ཇི་སྐད་འབྱུང་བ་བཞིན་༎
 tāmrāḥ snigdhāśca tuṅgāśca nakhā aṅgulayo muneḥ |	ཐུབ་པའི་སེན་མོ་ཟང་མདོག་དང་༎ མདོག་སྣུམ་མཐོ་དང་སོར་མོ་རྣམས་༎ ཟླུམ་རྒྱས་བྱིན་གྱིས་ཕྲ་བ་དང་༎ རྩ་མེ་མངོན་དང་མདུད་པ་མེད་༎
 vṛttāścitānupūrvāśca guḍhā nirgranthyaḥ śirāḥ || abhs_8|21 || guḍhau gulphau samau pādau siṃhebhadvijagopateḥ |	ལོང་བུ་མི་མངོན་ཞབས་མཉམ་དང་༎ སེང་གེ་གླང་ཆེན་བྱ་དང་ནི་༎
 vikrāntaṃ dakṣiṇaṃ cārūgamanamṛjuvṛttatā || abhs_8|22 ||	ཁྱུ་མཆོག་སྟབས་གཤེགས་ག-ཡས་ཕྱོགས་དང་༎ མཛེས་གཤེགས་དྲང་དང་འཁྲིལ་བག་ཆགས་༎ བྱེ་དོར་བྱས་འདྲ་རིམ་པར་འཚམ་༎
 mṛṣṭānupūrte medhyamṛdutve śuddhagātratā |	གཙང་དང་འཇམ་དང་དག་པའི་སྐུ་༎
 pūrṇavyañjanatā cārupṛthumaṇḍalagāratā || abhs_8|23 ||	མཚན་ནི་ཡོངས་སུ་རྫོགས་པ་དང་༎ ༄༡༢བ་སྐུ་ཡི་ཁོ་ལག་ཡངས་ཤིང་བཟང་༎
 samakramatvaṃ śuddhatvaṃ netrayoḥ sukumāratā |	གོམ་སྙོམས་པ་དང་སྤྱན་གཉིས་ནི་༎
 adīnossadagātratve susaṃhatanagātratā || abhs_8|24 || suvibhaktāṅgatā dhvāntapradhvastālokaśuddhatā |	དག་དང་གཞོན་ཤ་ཅན་ཉིད་དང་༎ སྐུ་ཞུམ་མེད་དང་རྒྱས་པ་དང་༎ ཤིན་ཏུ་གྲིམས་པའི་སྐུ་ཉིད་དང་༎ ཡན་ལག་ཤིན་ཏུ་རྣམ་འབྱེས་དང་༎ གཟིགས་པ་སྒྲིབ་མེད་དག་པ་དང་༎ དཀུ་ཟླུམ་སྐབས་ཕྱིན་མ་རྙོངས་དང་༎ ཕྱང་ངེ་བ་དང་ལྟེ་བ་ནི་༎
 vṛttamṛṣṭākṣāmakukṣitāśca gabhiratā || abhs_8|25 || dakṣiṇāvartatā nābheḥ samantaddarśanīyatā | samācāraḥ śuciḥ kālatilakāpagatā tanuḥ || abhs_8|26 || karau tulamṛdūsnigdhagambhīrāyatalekhatā |	ཟབ་དང་ག-ཡས་ཕྱོགས་འཁྱིལ་བ་དང་༎ ཀུན་ནས་བལྟ་ན་སྡུག་པ་དང་༎ ཀུན་སྤྱོད་གཙང་དང་སྐུ་ལ་ནི་༎
 nātyāyataṃ vaco bimbapratibimbopamauṣṭhatā || abhs_8|27 || mṛdvī tanvī ca raktā ca jihvā jimūtaghoṣatā | cārūmañjasvaro daṃṣṭrā vṛttāstīkṣṇāḥ sitāḥ samāḥ || abhs_8|28 ||	སྨེ་བ་གནག་བག་མེད་པ་དང་༎ ཕྱག་ནི་ཤིང་བལ་ལྟར་འཇམ་དང་༎ ཕྱག་རིས་མདངས་ཡོད་ཟབ་རིང་དང་༎ ཞལ་ནི་ཧ་ཅང་མི་རིང་དང་༎ མཆུ་ནི་བིམཔ་ལྟར་དམར་དང་༎ ལྗགས་མཉེན་པ་དང་སྲབ་པ་དང་༎ དམར་དང་འབྲུག་གི་སྒྲ་ཉིད་དང་༎ གསུངས་མཉེན་འཇམ་དང་མཆེ་བ་ཟླུམ་༎
 anupurvī gatāstuṅgā nāsikā paraṃ śuciḥ |	རྣོ་དང་དཀར་དང་མཉམ་པ་དང་༎ བྱིན་གྱིས་ཕྲ་དང་ཤངས་མཐོ་དང་༎ མཆོག་ཏུ་དག་པ་དག་དང་ནི་༎
 viśale nayane pakṣmacitaṃ padmadalākṣitā || abhs_8|29 || āyataślakṣṇasusnigdhasamaromnau bhruvau bhujau | pīnāyatau samau karṇāvupaghātavivarjitau || abhs_8|30 ||	སྤྱན་ཡངས་པ་དང་རྫི་མ་སྟུག་། 
 lalāṭamaparimlānaṃ prṛthupūrṇottamāṅgatā | bhramarābhāścitāḥ ślakṣṇā asaṃlulitamūrtayaḥ || abhs_8|31 || keśā aparuṣāḥ puṃsāṃ saurabhyānyapahāriṇaḥ |	པདམའི་འདབ་བ་འདྲ་བ་དང་༎ སྨིན་ཚུགས་རིང་དང་འཇམ་པ་དང་༎ སྣུམ་དང་སྤུ་ནི་མཉམ་པ་དང་༎ ཕྱག་རིང་རྒྱས་དང་སྙན་མཉམ་དང་༎ ཉམས་པ་རྣམ་པར་སྤངས་པ་དང་༎ དཔྲལ་བ་ལེགས་པར་འབྱེས་པ་དང་༎ དབྱེས་ཆེ་བ་དང་དབུ་རྒྱས་དང་༎ དབུ་སྐྲ་བུང་བ་ལྟར་གནག་དང་༎ སྟུག་དང་འཇམ་དང་མ་འཛིངས་དང་༎ མི་བཤོར་དྲི་ཞིམ་སྐྱེས་བུ་ཡི་༏་། ཡིད་ནི་འཕྲོག་པར་བྱེད་པ་དང་༎ དཔལ་གྱི་བེའུ་དང་བཀྲ་ཤིས་ནི་༎ ག-ཡུང་དྲུང་འཁྱིལ་བས་བརྒྱན་པ་སྟེ་༎
 śrīvatsaḥ svastikaṃ ceti buddhānuvyañjanaṃ matam || abhs_8|32 ||	སངས་རྒྱས་དཔེ་བྱད་བཟང་པོར་བཞེད་༎ གང་གི་སྲིད་པ་ཇི་སྲིད་པར་༎
 karoti yena citrāṇi hitāni jagataḥ samam |	།
 ā bhavātso 'nupacchinnaḥ kayo nairmāṇiko muneḥ || abhs_8|33 ||	ཐུབ་པའི་སྦྲུལ་སྐུ་རྒྱུན་མི་འཆད་༎ ད་བཞིན་འཁོར་བ་ཇི་སྲིད་འདིའི་༎
 tathā karmāpyanucchinnamasyāsaṃsāramiṣyate |	ལས་ནི་རྒྱུན་མི་འཆད་པར་འདོད་༎
 gatīnāṃ śamanaṃ karma saṃgrahe ca caturvidhe || abhs_8|34 ||	འགྲོ་རྣམས་ཞི་བའི་ལས་དང་ནི་༎ བསྡུ་རྣམ་བཞི་ལ་འགོད་པ་དང་༎ ཀུན་ནས་ཉོན་མོངས་བཅས་པ་ཡི་༎
 niveśanaṃ sasaṃkleśe vyavadānāvabodhane |	རྣམ་པར་བྱང་བ་༄༡༣ཨ་༌་༎
 sattvānāmarthayāthātmye ṣaṭsu pāramitāsu ca || abhs_8|35 ||	རྟོགས་པ་དང་༎ སེམས་ཅན་རྣམས་དོན་ཇི་བཞིན་གྱི་༎ དོན་དང་ཕ་རོལ་ཕྱིན་དྲུག་དང་༎ སངས་རྒྱས་ལམ་དང་རང་བཞིན་གྱིས་༎
 buddhamārge prakṛtyaivaśunyatāyāṃ dvayakṣaye | saṃkete 'nupalambhe ca paripāke ca hehinām || abhs_8|36 ||	སྟོང་པ་ཉིད་དང་གཉིས་ཟད་དང་༎ བརྡ་དང་དམིགས་པ་མེད་པ་དང་༎ ལུས་ཅན་རྣམས་ནི་ཡོངས་སྨིན་དང་༏་། བྱང་ཆུབ་སེམས་དཔའི་ལམ་དང་ནི་༎
 bodhisattvasya mārge 'bhiniveśasya nivāraṇe | bodhiprāptu jinakṣetraviśuddhau niyatiṃ prati || abhs_8|37 ||	མངོན་པར་ཞེན་པ་ཟློག་པ་དང་༎ བྱང་ཆུབ་ཐོབ་དང་སངས་རྒྱས་ཞིང་༎
 aprameye ca sattvarthe buddhasevādike guṇe |	རྣམ་པར་དག་དང་ངེས་པ་དང་༎ སེམས་ཅན་དོན་ནི་ཚད་མེད་དང་༎ སངས་རྒྱས་རྟེན་སོགས་ཡོན་ཏན་དང་༎ བྱང་ཆུབ་ཡན་ལག་ལས་རྣམས་ནི་༎
 bodheraṅgeṣvanāśe ca karmaṇāṃ satyadarśane || abhs_8|38 || viparyāsaprahāṇe ca tadavastukatānaye |	ཆུད་མི་ཟ་དང་བདེན་མཐོང་དང་༎ ཕྱིན་ཅི་ལོག་ནི་སྤངས་པ་དང་༎ དེ་གཞི་མེད་པའི་ཚུལ་དང་ནི་༎
 vyavadāne sasaṃbhāre saṃskṛtāsaṃskṛte prati || abhs_8|39 ||	རྣམ་པར་བྱང་དང་ཚོགས་དང་ནི་༎ འདུས་བྱས་འདུས་མ་བྱས་པ་ལ་༎
 vyatibhedāparijñāne virnāṇe ca niveśanam |	ཐ་དད་ཡོངས་སུ་མི་ཤེས་དང་༎ མྱ་ངན་འདས་ལ་འགོད་པ་སྟེ་༏་། ཆོས་ཀྱི་སྐུ་ཡི་ཕྲིན་ལས་ནི་༎
 dharmakāyasya karmedaṃ saptavimśatidhā matam || abhs_8|40 ||	རྣམ་པ་ཉི་ཤུ་བདུན་དུ་བཞེད་༎
 || abhisamayālaṅkāre prajñāpāramitopadeśaśāstre	ཤེས་རབ་ཀྱི་ཕ་རོལ་ཏུ་ཕྱིན་པའི་མན་ངག་གི་བསྟན་བཅོས་མངོན་པར་རྟོགས་པའི་རྒྱན་གྱི་ཚིག་ལེའུར་བྱས་པ་ལས་།
 dharmakāyādhikāro 'ṣṭamaḥ ||	སྐབས་བརྒྱད་པའོ་།
 lakṣaṇaṃ tatprayogastatprakarṣastadanukramaḥ |	༎ ། མཚན་ཉིད་དེ་ཡི་སྦྱོར་བ་དང༎ དེ་རབ་དེ་ཡི་གོ་རིམས་དང་༎ དེ་མཐའ་དེ་ཡི་རྣམ་སྨིན་ནི་༎
 tanniṣṭā tadvipākascotyanyaḥ ṣeḍhārthasaṃgrahaḥ || 1 ||	དོན་བསྡུས་གཞན་དེ་རྣམ་པ་དྲུག་། 
 viṣayastritayo hetuḥ prayogaścaturātmakaḥ |	ཡུལ་ནི་རྣམ་པ་གསུམ་པོ་རྒྱུ་༎
 dharmakāyaḥ phalaṃ karmetyanyastredhārthasaṃgrahaḥ || 2 ||	སྦྱོར་བ་བཞི་ཡི་བདག་ཉིད་དང་༎ ཆོས་སྐུ་ཕྲིན་ལས་འབྲས་བུ་ནི་༎ དོན་བསྡུས་གཞན་ཏེ་རྣམ་པ་གསུམ་༎
 abhisamayālaṅkāraṃ nāma prajñāpāramitopadeśaśāstraṃ samāptam ||	འཕགས་པ་ཤེས་རབ་ཀྱི་ཕ་རོལ་ཏུ་ཕྱིན་པའི་མན་ངག་གི་བསྟན་བཅོས་མངོན་པར་རྟོགས་པའི་རྒྱན་ཞེས་བྱ་བའི་ཚིག་ལེའུར་བྱས་པ་རྫོགས་སོ་།
