skt	tib
 namo mañjuśriye kumārabhūtāya āryamaitreyanāthaviracitam abhisamayālaṅkāro nāma prajñāpāramitopadeśaśāstram sarvākārajñātādhikāraḥ prathamaḥ	༄༡བ་༅་༎ རྒྱ་གར་སྐད་དུ་། ཨཨ་བྷི་ས་མ་ཡ་ཨཨ་ལམ་ཀའ་ར་ནའ་མ་པྲཛཉའ་པའ་ར་མི་ཏོ་བ་དེ་ཤ་ཤའ་སྟྲ་ཀའ་རི་ཀའ་། བོད་སྐད་དུ་། ཤེས་རབ་ཀྱི་ཕ་རོལ་ཏུ་ཕྱིན་པའི་མན་ངག་གི་བསྟན་བཅོས་dd་མངོན་པར་རྟོགས་པའི་རྒྱན་ཞེས་བྱ་བའི་ཚིག་ལེའུར་བྱས་པ་། སངས་རྒྱས་དང་བྱང་ཆུབ་སེམས་དཔའ་ཐམས་ཅད་ལ་ཕྱག་འཚལ་ལོ་༎
 maṅgālācaraṇam yā sarvajñatayā nayatyupaśamaṃ śāntaiṣiṇaḥ śrāvakān yā mārgajñatayā jagaddhitakṛtāṃ lokārthasampādikā |	ཉན་ཐོས་ཞི་བ་ཚོལ་རྣམས་ཀུན་ཤེས་ཉིད་ཀྱིས་ཉེར་ཞིར་འཁྲིད་མཛད་གང་ཡིན་དང་༎ འགྲོ་ལ་ཕན་པར་བྱེད་རྣམས་ལམ་ཤེས་ཉིད་ཀྱིས་འཇིག་རྟེན་དོན་སྒྲུབ་མཛད་པ་གང་༎
 sarvākāramidaṃ vadanti munayo viśvaṃ yayā saṃgatās	གང་དང་ཡང་དག་ལྡན་པས་ཐུབ་རྣམས་རྣམ་པ་ཀུན་ལྡན་སྣ་ཚོགས་འདི་གསུངས་པ་༎
 tasyai śrāvakabodhisattvagaṇino buddhasya mātre namaḥ || asa_1|1 ||	ཉན་ཐོས་བྱང་ཆུབ་སེམས་དཔའི་ཚོགས་བཅས་སངས་རྒྱས་ཀྱི་ནི་ཡུམ་དེ་ལ་ཕྱག་འཚལ་༎
 grānthārambhaprayojanam sarvākārajñatāmārgaḥ śāsitrā yo 'tra deśitaḥ |	རྣམ་པ་ཐམས་ཅད་མཁྱེན་ཉིད་ལམ་༎ སྟོན་པས་འདི་རྣམས་བཤད་པ་གང་༎
 dhīmanto vīkṣiṣiraṃstamanālīḍhaṃ parairiti || asa_1|2 ||	གཞན་གྱིས་མྱོང་བ་མ་ཡིན་ཏེ་༎ ཆོས་སྤྱོད་བཅུ་ཡི་བདག་ཉིད་ཀྱི་༎
 smṛtau cādhāya sūtrārthaṃ dharmacaryāṃ daśātmikām |	མདོ་དོན་དྲན་པ་ལ་བཞག་ནས་༎ བློ་དང་ལྡན་པས་མཐོང་འགྱུར་ཕྱིར་༎ བདེ་བླག་ཏུ་ནི་རྟོགས་པ་༄༢ཨ་༌་༎
 sukhena pratipatsīrannityārambhaprayojanam || asa_1|3 || prajñāpāramitāyāḥ kāyikavyavasthāpanam	ཞེས་༏་། བྱ་བ་རྩམ་པའི་དགོས་པ་ཡིན་༎
 prajñāpāramitāṣṭābhiḥ padārthaiḥ samudīritā |	ཤེས་རབ་ཕ་རོལ་ཕྱིན་པ་ནི་༎ དངོས་པོ་བརྒྱད་ཀྱིས་ཡང་དག་བཤད་༎
 sarvākārajñatā mārgajñatā sarvajñatā tataḥ || asa_1|4 ||	རྣམ་ཀུན་མཁྱེན་ཉིད་ལམ་ཤེས་ཉིད་༎ དེ་ནས་ཐམས་ཅད་ཤེས་པ་ཉིད་༎
 sarvākārābhisambodho mūrdhaprāpto 'nupūrvikaḥ |	རྣམ་ཀུན་མངོན་རྫོགས་རྟོགས་པ་དང་༎ རྩེ་མོར་ཕྱིན་དང་མཐར་གྱིས་པ་༎
 ekakṣaṇābhisambodho dharmakāyaśca te 'ṣṭadhā || asa_1|5 ||	སྐད་ཅིག་གཅིག་མངོན་རྫོགས་བྱང་ཆུབ་༎ ཆོས་ཀྱི་སྐུ་དང་དེ་རྣམ་བརྒྱད་༎
 cittotpādo 'vavādaśca nirvedhāṅgaṃ caturvidham |	སེམས་བསྐྱེད་པ་དང་གདམས་ངག་དང་༎ ངེས་འབྱེད་ཡན་ལག་རྣམ་བཞི་དང་༎ སྒྲུབ་པ་ཡི་ནི་རྟེན་གྱུར་པ་༎
 ādhāraḥ pratipatteśca dharmadhātusvabhāvakaḥ || asa_1|6 ||	ཆོས་ཀྱི་དབྱིངས་ཀྱི་རང་བཞིན་དང་༎ དམིགས་པ་དག་དང་ཆེད་དང་ནི་༎
 ālambanaṃ samuddeśaḥ sannāhaprasthitikriye |	གོ་ཆ་འཇུག་པའི་བྱ་བ་དང་༎ ཚོགས་ནི་ངེས་པར་འབྱུང་བཅས་རྣམས་༎
 sambhārāśca saniryāṇāḥ sarvākārajñatā muneḥ || asa_1|7 ||	ཐུབ་པའི་རྣམ་ཀུན་མཁྱེན་པ་ཉིད་༎
 dhyāmīkaraṇatādīni śiṣyakhaḍgapathau ca yau |	མོག་མོག་པོར་བྱེད་ལ་སོགས་དང་༏་། སློབ་མ་བསེ་རུའི་ལམ་གང་དང་༎ འདི་དང་གཞན་པའི་ཡོན་ཏན་གྱིས་༎
 mahānuśaṃso dṛṅmārga ehikāmutrikairguṇaiḥ || asa_1|8 ||	ཕན་ཡོན་ཆེ་བ་མཐོང་བའི་ལམ་༎
 kāritramadhimuktiśca stutastobhitaśaṃsitāḥ |	བྱེད་པ་དང་ནི་མོས་ཕ་དང་༎ བསྟོད་དང་བཀུར་དང་བསྔགས་པ་དང་༎ བསྔོ་དང་རྗེས་སུ་ཡི་རང་བ་༎
 pariṇāme 'numode ca manaskārāvanuttamau || asa_1|9 ||	ཡིད་ལ་བྱེད་པ་བླ་མེད་དག་། 
 nirhāraḥ śuddhiratyantamityayaṃ bhāvanāpathaḥ |	སྒྲུབ་དང་ཤིན་ཏུ་དག་པ་ཞེས་༎ བྱ་བ་འདི་ནི་སྒོམ་པའི་ལམ་༎
 vijñānāṃ bodhisattvānāmiti mārgajñatoditā || asa_1|10 ||	བྱང་ཆུབ་སེམས་དཔའ་མཁས་རྣམས་ཀྱི་༎ ལམ་ཤེས་ཉིད་ནི་དེ་འདྲར་བཤད་༎
 prajñayā na bhave sthānaṃ kṛpayā na śame sthitiḥ |	ཤེས་པས་སྲིད་ལ་མི་གནས་ཤིང་༎
 anupāyena dūratvam upāyenāvidūratā || asa_1|11 ||	སྙིང་རྗེས་ཞི་ལ་མི་གནས་དང་༎ ༄༢བ་ཐབས་མ་ཡིན་པས་རིང་བ་དང་༎ ཐབས་ཀྱིས་རིང་བ་མ་ཡིན་ཉིད་༎
 vipakṣapratipakṣau ca prayogaḥ samatāsya ca | dṛṅmārgaḥ śrāvakādīnāmiti sarvajñateṣyate || asa_1|12 ||	མི་མཐུན་གཉེན་པོའི་ཕྱོགས་དག་དང་༎ སྦྱོར་དང་དེ་ཡི་མཉམ་ཉིད་དང་༎ ཉན་ཐོས་ལ་སོགས་མཐོང་བའི་ལམ་༎ དེ་འདྲ་ཀུན་ཤེས་ཉིད་དུ་འདོད་༎
 ākārāḥ saprayogāśca guṇā doṣāḥ salakṣaṇāḥ |	རྣམ་པ་སྦྱོར་བར་བཅས་རྣམས་དང་༎ ཡོན་ཏན་སྐྱོན་ནི་མཚན་ཉིད་བཅས་༎
 mokṣanirvedhabhāgīye śaikṣo 'vaivartiko gaṇaḥ || asa_1|13 ||	ཐར་དང་ངེས་འབྱེད་ཆ་མཐུན་དང་༎ སློབ་པ་ཕྱིར་མི་ལྡོག་པའི་ཚོགས་༎
 samatā bhavaśāntyośca kṣetraśuddhiranuttarā |	སྲིད་དང་ཞི་བ་མཉམ་ཉིད་དང་༎ ཞིང་དག་བླ་ན་མེད་པ་ནི་༎
 sarvākārābhisambodha eṣa sopāyakauśalaḥ || asa_1|14 ||	རྣམ་ཀུན་མངོན་རྫོགས་པ་སྟེ་༎ འདི་ནི་ཐབས་མཁས་བཅས་པ་ཡིན་༎
 liṅgaṃ tasya vivṛddhiśca nirūḍhiścittasaṃsthitiḥ |	དེ་ཡི་རྟགས་དང་རྣམ་འཕེལ་དང༎ བརྟན་དང་སེམས་ཀུན་གནས་པ་དང་༎ མཐོང་ཞེས་བྱ་དང་སྒོམ་པ་ཞེས་༎ བྱ་བའི་ལམ་ནི་སོ་སོ་ལ་༎
 caturdhā ca vikalpasya pratipakṣaścaturvidhaḥ || asa_1|15 || pratyekaṃ darśanākhye ca bhāvanākhye ca vartmani |	རྣམ་པར་རྟོག་པ་རྣམ་བཞི་ཡི་༎ གཉེན་པོ་རྣམ་པ་བཞི་དང་ནི་༎
 ānantaryasamādhiśca saha vipratipattibhiḥ || asa_1|16 ||	བར་ཆད་མེད་པའི་ཏིང་ངེ་འཛིན་༎ ལོག་པར་སྒྲུབ་དང་བཅས་པ་ནི་༎
 mūrdhābhisamayastredhā daśadhā cānupūrvikaḥ |	རྩེ་མོའི་མངོན་རྟོགས་མཐར་གྱིས་པ་༏་། རྣམ་གསུམ་རྣམ་བཅུ་སྐད་ཅིག་མ་༎
 ekakṣaṇābhisambodho lakṣaṇena caturvidhaḥ || asa_1|17 ||	གཅིག་གིས་མངོན་རྫོགས་བྱང་ཆུབ་པ་༎ མཚན་ཉིད་ཀྱིས་ནི་རྣམ་པ་བཞི་༎
 svābhāvikaḥ sasāmbhogo nairmāṇiko 'parastathā |	ངོ་བོ་ཉིད་ལོངས་རྫོགས་བཅས་པ་དང་༎ དེ་བཞིན་གཞན་པ་སྤྲུལ་པ་ནི་༎
 dharmakāyaḥ sakāritraścaturdhā samudīritaḥ || asa_1|18 || sarvākārajñatā 1 - cittotpādaḥ	ཆོས་སྐུ་མཛད་པ་དང་བཅས་པ་༎ རྣམ་པ་བཞིར་ནི་ཡང་དག་བརྗོད་༎
 cittotpādaḥ parārthāya samyaksambodhikāmatā |	སེམས་བསྐྱེད་པ་ནི་གཞན་དོན་ཕྱིར་༎ ཡང་དག་རྫོགས་པའི་བྱང་ཆུབ་འདོད་༎ དེ་དང་དེ་ནི་མ་དོ་བཞིན་དུ་༎
 samāsavyāsataḥ sā ca yathāsūtraṃ sa cocyate || asa_1|19 ||	བསྡུས་དང་རྒྱས་པའི་སྒོ་ནས་བརྗོད་༎ དེ་ཡང་ས་གསེར་ཟླ་བ་མེ་༎
 bhūhemacandrajvalanairnidhiratnākarārṇavaiḥ |	གཏེར་དང་རིན་ཆེན་འབྱུང་གནས་མཚོ་༎
 vajrācalauṣadhīmitraiścintāmaṇyarkagītibhiḥ || asa_1|20 ||	རྡོ་རྗེ་རི་སྨན་བཤེས་གཉེན་དང་༎ ཡིད་བཞིན་ནོར་བུ་ཉི་མ་གླུ་༎ རྒྱལ་པོ་མཛོད་དང་ལམ་པོ་ཆེ་༎ བཞོན་པ་བཀོད་མའི་ཆུ་དང་ནི་༎
 nṛpagañjamahāmārgayānaprasravaṇodakaiḥ |	སྒྲ་བརྙན་ཆུ་བོ་སྤྲིན་རྣམས་ཀྱིས་༎
 ānandoktinadīmevairdvāviṃśatividhaḥ sa ca || asa_1|21 || 2 - avavādaḥ	རྣམ་པ་ཉི་ཤུ་རྩ་གཉིས་སོ་༎ སྒྲུབ་དང་བདེན་པ་རྣམས་དང་ནི་༎
 pratipattau ca satyeṣu buddharatnādiṣu triṣu |	སངས་རྒྱས་ལ་སོགས་དཀོན་མཆོག་གསུམ་༎
 asaktāvapariśrānto pratipatsamparigrahe || asa_1|22 ||	མ་ཞེན་ཡོངས་སུ་མིང་ལ་དང༎
 cakṣuḥṣu pañcasu jñeyaḥ ṣaṭsvabhijñāguṇeṣu ca |	ལམ་ནི་ཡོངས་སུ་འཛིན་པ་དང་༎ སྤྱན་ལྔ་དང་ནི་མངོན་ཤེས་ཀྱི་༎
 dṛṅmārge bhāvanākhye cetyavavādo daśātmakaḥ || asa_1|23 ||	ཡོན་ཏན་དྲུག་དང་མཐོང་ལམ་དང་༎ བསྒོམ་ཞེས་བྱ་ལ་གདམས་ངག་ནི་༎ བཅུ་ཡི་བདག་ཉིད་ཤེས་པར་བྱ་༎
 mṛdutīkṣṇendriyau śraddhādṛṣṭiprāptau kulaṅkalau |	དབང་པོ་རྟུལ་དང་རྣོན་པོ་དང་༎ དད་དང་མཐོང་ཐོབ་རིགས་ནས་རིགས་༎
 ekavīcyantarotpadya kārākārākaniṣṭhagāḥ || asa_1|24 ||	བར་ཆད་གཅིག་པར་༄༣ཨ་༌་༎ སྐྱེས་ནས་དང་༎ བྱེད་དང་བྱེད་མིན་འོག་མིན་འགྲོ་༎
 plutāstrayo bhavasyāgraparamo rūparāgahā |	འཕར་གསུམ་སྲིད་རྩེའི་མཐར་ཐུག་འགྲོ་༎ གཟུགས་ཀྱི་ཆགས་བཅོམ་ལྡན་མཐོང་བ་ཡི་༎
 dṛṣṭadharmaśamaḥ kāyasākṣī khaḍgaśca viṃśatiḥ || asa_1|25 || 3 - nirvedhāṅgam	ཆོས་ལ་ཞི་ལུས་མངོན་སུམ་བྱེད་༎ བསེ་རུ་དང་ནི་ཉི་ཤུའོ་༎
 ālambanata ākārāddhetutvāt samparigrahāt |	དམིགས་པ་དང་ནི་རྣམ་པ་དང་༎ སྐྱུ་དང་ཡོངས་སུ་འཛིན་པ་ཡིས་༎ བྱང་ཆུབ་སེམས་དཔའ་སྐྱོབ་པ་ཡི་༎ དྲོད་སོགས་བདག་ཉིད་ཇི་བཞིན་དུ་༎
 caturvikalpasaṃyogaṃ yathāsvaṃ bhajatāṃ satām || asa_1|26 || śrāvakebhyaḥ sakhaḍgebhyo bodhisattvasya tāyinaḥ |	རྣམ་རྟོག་བཞི་པོ་ལྡན་བརྟེན་པ་༎
 mṛdumadhyādhimātrāṇāmūṣmādīnāṃ viśiṣṭatā || asa_1|27 ||	ཆུང་དང་འབྲིང་དང་ཆེན་པོ་རྣམས་༎ ཉན་ཐོས་བསེ་རུ་ལྟ་བུ་དང་༎ བཅས་པ་དག་ལས་ཁྱད་པར་འཕགས་༎
 ālambanamanityādi satyādhāraṃ tadākṛtiḥ |	དམིགས་པ་མི་རྟག་ལ་སོགས་པ་༎ བདེན་པའི་རྟེན་ཅན་དེ་ཡི་ནི་༎ རྣམ་པ་མངོན་ཞེན་ལ་སོགས་འགོག་། 
 niṣedho 'bhiniveśāderheturyānatrayāptaye || asa_1|28 ||	ཐེག་པ་གསུམ་ཆར་འཐོབ་པའི་རྒྱུ་༎
 rūpādyāyavyayau viṣṭhāsthiti prajñaptyavācyate |	གཟུགས་སོགས་འདུ་འགོད་གནས་བྲལ་དང་༎ གནས་དང་བརྟགས་དང་བརྗོད་དུ་མེད་༎ གཟུགས་སོགས་མི་གནས་དེ་དག་ནི་༎
 rūpāvādavasthitisteṣāṃ tadbhāvenāsvabhāvatā || asa_1|29 ||	དེ་ཡི་ངོ་བོ་རང་བཞིན་མེད་༎
 tayormithaḥ svabhāvatvaṃ tadanityādyasaṃsthitiḥ |	།
 tāsāṃ tadbhāvaśūnyatvaṃ mithaḥ svābhāvyametayoḥ || asa_1|30 ||	དེ་རྣམས་དེ་ཡི་ངོ་བོས་སྟོང་༎ དེ་དག་གཅིག་གི་རང་བཞིན་གཅིག་། 
 anudgraho yo dharmāṇāṃ tannimittāsamīkṣaṇam |	ཆོས་རྣམས་མི་འཛིན་གང་ཡིན་དང་༎ དེ་དག་མཚན་མར་མཐོང་ཕྱིར་༎
 parīkṣaṇaṃ ca prajñāyāḥ sarvasyānupalambhataḥ || asa_1|31 ||	ཤེས་རབ་ཀྱིས་ནི་ཡོངས་རྟོགས་པ་༎ ཐམས་ཅད་དམིགས་སུ་མེད་པར་རོ་༎
 rūpāderasvabhāvatvaṃ tadabhāvasvabhāvatā |	གཟུགས་སོགས་ངོ་བོ་ཉིད་མེད་ཉིད་༎ དེ་མེད་པ་ཉིད་ངོ་བོ་ཉིད་༎ དེ་དག་སྐྱེ་མེད་ངེས་འབྱུང་མེད་༎
 tadajātiraniryāṇaṃ śuddhistadanimittatā || asa_1|32 ||	དག་དང་དེ་དག་མཚན་མ་མེད་༎
 tannimittānadhiṣṭhānānadhimuktirasaṃjñatā |	དེ་ཡི་མཚན་མར་མི་བརྟེན་པས་༎ མོས་མིན་འདུ་ཤེས་མེད་པ་ཡིན་༎
 samādhistasya kāritraṃ vyākṛtirmananākṣayaḥ || asa_1|33 ||	ཏིང་འཛིན་དེ་ཡི་བྱེད་པ་ཉིད་༎ ལུང་སྟོན་པ་དང་རློམ་པ་ཟད་༎ གསུམ་པོ་ཕན་ཚུན་ངོ་བོ་གཅིག་། 
 mithastrikasya svābhāvyaṃ samādheravikalpanā |	ཏིང་འཛིན་རྣམ་པར་མི་རྟོག་པ་༎
 iti nirvedhabhāgīyaṃ mṛdumadhyādhimātrataḥ || asa_1|34 ||	དེ་ལྟར་ངེས་འབྱེད་ཆ་མཐུན་ནི་༎ ཆུང་དང་འབྲིང་དང་ཆེན་པོ་ཡིན་༎ གཞིག་དེ་ཡི་གཉེར་པོ་ཡིས་༎
 dvaividhyaṃ grāhyakalpasya vastutatpratipakṣataḥ |	གཟུགས་བར་རྟོག་པ་རྣམ་པ་གཉིས་༎
 moharāśyādibhedena pratyekaṃ navadhā tu saḥ || asa_1|35 ||	རྨོངས་དང་ཕུང་སོགས་བྱེ་བྲག་གིས་༎ དེ་ནི་སོ་སོར་རྣམ་པ་དགུ་༎
 dravyaprajñaptyadhiṣṭhāno dvividho grāhako mataḥ |	རྫས་དང་བརྟགས་པའི་རྟེན་ཅན་གྱིས་༎ འཛིན་པའང་རྣམ་གཉིས་སུ་འདོད་༎
 svatantrātmādirūpeṇa skandhādyāśrayatastathā || asa_1|36 || cittānavalīnatvādinaiḥsvābhāvyādideśakaḥ |	རང་དབང་བདག་སོགས་ངོ་བོ་དང་༎ ཕུང་སོགས་རྟེན་ལས་དེ་བཞིན་ནོ་༎ སེམས་མི་འགོང་བ་ཉིད་ལ་སོགས་༎ ངོ་བོ་ཉིད་མེད་སོགས་སྟོན་བྱེད་༎
 tadvipakṣaparityāgaḥ sarvathā samparigrahaḥ || asa_1|37 ||	དེ་ཡི་མི་མཐུན་༄༣བ་ཕྱོགས་བོར་བ་༎ རྣམ་པ་ཀུན་ཏུ་ཡོངས་འཛིན་ཡིན་༎
 4 - pratipatterādhāraḥ ṣoḍhādhigamadharmasya pratipakṣaprahāṇayoḥ | tayoḥ paryupayogasya prajñāyāḥ kṛpayā saha || asa_1|38 || śiṣyāsādhāraṇatvasya parārthānukramasya ca |	རྟོགས་པ་ཡིན་ནི་ཆོས་དྲུག་དང་༎ གཉེན་པོ་དང་ནི་སྤོང་བ་དང་༎ དེ་དག་ཡོངས་སུ་གཏུགས་པ་དང་༎ ཤེས་རབ་སྙིང་བརྩེར་བཅས་པ་དང་༎ སློབ་མ་མཐུན་མོང་མིན་ཉིད་དང་༎ གཞན་གྱི་དོན་གྱི་གོ་རིམས་དང་༎ ཡེ་ཤེས་རྩོལ་བ་མི་མའང་བར་༎
 jñānasyāyatnavṛtteśca pratiṣṭhā gotramucyate || asa_1|39 ||	འཇུག་པའི་རྟེན་ལ་རིགས་ཤེས་བྱ་༎
 dharmadhātorasambhedād gotrabhedo na yujyate |	ཆོས་ཀྱི་དབྱིངས་ལ་དབྱེར་མེད་ཕྱིར་༎ རིགས་ནི་ཐ་དད་རུང་མ་ཡིན་༎
 ādheyadharmabhedāttu tadbhedaḥ parigīyate || asa_1|40 ||	རྟེན་པའི་ཆོས་ཀྱི་བྱེ་བྲག་གིས་༎ དེ་ཡི་དབྱེ་བ་ཡོངས་སུ་བརྗོད་༎
 5 - ālambanam ālambanaṃ sarvadharmāste punaḥ kuśalādayaḥ |	དམིགས་པ་ཆོས་རྣམས་ཐམས་ཅད་དེ་༎
 laukikādhigamākhyāśca ye ca lokottarā matāḥ || asa_1|41 || sāsravānāsravā dharmāḥ saṃskṛtāsaṃskṛtāśca ye |	དེ་ཡང་དགེ་ལ་སོགས་པ་ཡིན་༎ འཇིག་རྟེན་པ་ཡི་རྟོགས་པ་དང་༎ གང་དག་འཇིག་རྟེན་འདས་འདོད་དང་༎ ཟག་བཅས་ཟག་པ་མེད་ཆོས་དང་༎ གང་དག་འདུས་བྱས་འདུས་མ་བྱས་༎
 śiṣyasādhāraṇā dharmā ye cāsādhāraṇā muneḥ || asa_1|42 || 6 - samuddeśaḥ	སློབ་མཐུན་མོང་ཆོས་རྣམས་དང་༎ གང་དག་ཐུབ་པའི་ཐུན་མོང་མིན་༎
 sarvasattvāgratācittaprahāṇādhigamatraye |	སེམས་ཅན་ཀུན་མཆོག་ཉིད་སེམས་དང་༎ སྤངས་དང་རྟོགས་དང་གསུམ་པོ་ལ་༎ ཆེན་པོ་གསུམ་གྱི་རང་བྱུང་གི་། 
 tribhirmahattvairuddeśo vijñeyo 'yaṃ svayambhuvām || asa_1|43 || 7 - sannāhapratipattiḥ	ཆེད་དུ་བྱ་བ་འདི་ཤེས་བྱ་༎
 dānādau ṣaḍvidhe teṣāṃ pratyekaṃ saṃgraheṇa yā |	དེ་དག་སོ་སོར་སྦྱིན་ལ་སོགས་༎ རྣམ་པ་དྲུག་ཏུ་བསྡུས་པ་ཡིས་༎
 sannāhapratipattiḥ sā ṣaḍbhiḥ ṣaṭkairyathoditā || asa_1|44 || 8 - prasthānapratipattiḥ	གོ་ཆའི་སྒྲུབ་པ་གང་ཡིན་དེ་༎ དྲུག་ཚན་དྲུག་གིས་ཇི་བཞིན་བཤད་༎
 dhyānārūpyeṣu dānādau mārge maitryādikeṣu ca | gatopalambhayoge ca trimaṇḍalaviśuddhiṣu || asa_1|45 ||	བསམ་གཏན་གཟུགས་མེད་སྤྱིན་སོགས་དང་༎ ལམ་དང་བྱམས་ལ་སོགས་པ་དང་༎ དམིགས་པ་མེད་དང་ལྡན་པ་དང་༎ འཁོར་གསུམ་རྣམ་པར་དག་པ་དང་༎ ཆེད་དུ་བྱ་དང་མངོན་ཤེས་དྲུག་། 
 uddeśe ṣaṭsvabhijñāsu sarvākārajñatānaye |	རྣམ་ཀུན་མཁྱེན་པའི་ཚུལ་ལ་ནི་༎
 prasthānapratipajjñeyā mahāyānādhirohiṇī || asa_1|46 || 9 - sambhārapratipattiḥ	འཇུག་པའི་སྒྲུབ་པ་ཐེག་ཆེན་ལ་༎ འཛེགས་པ་ཡིན་པར་ཤེས་པར་བྱ་༎
 dayā dānādikaṃ ṣaṭkaṃ śamathaḥ savidarśanaḥ |	བརྩེ་དང་སྤྱིན་ལ་སོགས་པ་དྲུག་། 
 yuganaddhaśca yo mārga upāye yacca kauśalam || asa_1|47 || jñānaṃ puṇyaṃ ca mārgaśca dhāraṇī bhūmayo daśa |	ཞི་གནས་ལྷ་ག་མཐོང་བཅས་པ་དང་༎ ཟུང་དུ་འབྲེལ་བའི་ལམ་གང་དང་༎ ཐབས་ལ་མཁས་པ་གང་ཡིན་དང་༎ ཡེ་ཤེས་དང་ནི་བསོད་ནམས་དང་༎ ལམ་དང་གཟུངས་དང་ས་བཅུ་དང་༎ གཉེན་པ་ཚོགས་ཀྱི་སྒྲུབ་པ་ཡི་༎
 pratipakṣaśca vijñeyaḥ sambhārapratipatkramaḥ || asa_1|48 || 1| pramuditā bhūmiḥ	རིམ་པ་ཡིན་པར་ཤེས་པར་བྱ་༎
 labhyate prathamā bhūmirdaśadhā parikarmaṇā	ཡོངས་སུ་སྤྱོང་བ་རྣམ་བཅུ་ཡིས་༎ ས་ནི་དང་པོ་འཐོབ་འགྱུར་ཏེ་༎
 āśayo hitavastutvaṃ sattveṣu samacittatā || asa_1|49 ||	བསམ་དང་ཕན་པའི་དངོས་ཉིད་དང་༎ སེམས་ཅན་རྣམས་ལ་སེམས་མཉམ་ཉིད་༎ གཏོང་དང་བཤེས་གཉེན་༄༤ཨ་༌་༎
 tyāgaḥ sevā ca mitrāṇāṃ saddharmālambanaiṣaṇā | sadā naiṣkramyacittatvaṃ buddhakāyagatā spṛhā || asa_1|50 ||	བསྟེན་པ་དང་༎ དམ་ཆོས་དམིགས་པ་ཚོལ་བ་དང་༎ རྟག་ཏུ་ངེས་འབྱུང་སེམས་ཉིད་དང་༎ སངས་རྒྱས་སྐུར་འདོད་དགའ་བ་དང་༎ ཆོས་སྟོན་པ་དང་བདེན་པ་ཡི་༎
 dharmasya deśanā satyaṃ daśamaṃ vākyamiṣyate |	ཚིག་ནི་བཅུ་པ་ཡིན་པར་འདོད་༎
 jñeyaṃ ca parikarmaiṣāṃ svabhāvānupalambhataḥ || asa_1|51 || 2| vimalā bhūmiḥ	འདི་དག་རང་བཞིན་མི་དམིགས་པས་༎ ཡོངས་སུ་སྦྱོང་བར་ཤེས་པར་བྱ་༎
 śīlaṃ kṛtajñatā kṣāntiḥ prāmodyaṃ mahatī kṛpā |	ཚུལ་ཁྲིམས་བྱས་པ་གཟོ་དང་བཟོད་༎ རབ་ཏུ་དགའ་དང་སྙིང་བརྩེ་ཆེ་༎
 gauravaṃ guruśuśrūṣā vīryaṃ dānādike 'ṣṭamam || asa_1|52 || 3| prabhākarī bhūmiḥ	བཀུར་སྟི་བླ་མ་ལ་གུས་ཉན་༎ བརྒྱད་པ་སྤྱིན་ལ་སོགས་ལ་བརྩོན་༎
 atṛptatā śrute dānaṃ dharmasya ca nirāmiṣam |	ཐོས་པ་མི་ངོམས་ཉིད་དང་ནི་༎
 buddhakṣetrasya saṃśuddhiḥ saṃsārāparikheditā || asa_1|53 ||	ཟང་ཟིང་མེད་པར་ཆོས་སྦྱིན་དང་༎ སངས་རྒྱས་ཞིང་ཀུན་སྦྱོང་བ་དང་༎ འཁོར་བས་ཡོངས་སུ་མི་སྐྱོ་དང་༎ ངོ་ཚ་ཁྲེལ་ཡོད་ཅེས་བྱ་བ་༎
 hrīrapatrāpyamityetat pañcadhā mananātmakam | 4| arciṣmatī bhūmiḥ	རློམ་མེད་བདག་ཉིད་དེ་རྣམ་ལྔ་༎
 vanāśālpecchatā tuṣṭirdhūtasaṃlekhasevanam || asa_1|54 || śikṣāyā aparityāgaḥ kāmānāṃ vijugupsanam |	ངས་གནས་འདོད་ཆུང་ཆོག་ཤེས་དང་༎ སྦྱངས་པ་ཡང་དག་སྡོམ་བསྟེན་དང་༎ བསླབ་པ་ཡོངས་སུ་མི་གཏོང་དང་༎ འདོད་པ་རྣམས་ལ་སྨོད་པ་དང་༎ མྱ་ངན་འདས་དང་བདོག་ཀུན་གཏོང་༎
 nirvitsarvāstisantyāgo 'navalīnānapekṣate || asa_1|55 || 5| sudurjayā bhūmiḥ	མི་ཞུམ་པ་དང་ལྟ་བ་མེད་༎
 saṃstavaṃ kulamātsaryaṃ sthānaṃ saṅgaṇikāvaham |	འདྲིས་དང་ཁྱིམ་ལ་འཁྲེན་པ་དང་༎ འདུ་འཛིར་གྱུར་པའི་གནས་དང་ནི་༎
 ātmotkarṣaparāvajñe karmamārgān daśāśubhān || asa_1|56 ||	བདག་བསྟོད་གཞན་ལ་བརྙས་པ་དང་༎ མི་དགེའི་ལས་ཀྱི་ལམ་བཅུ་དང་༎ རློམ་པས་ཁེངས་དང་ཕྱིན་ཅི་ལོག་། 
 mānaṃ stambhaṃ viparyāsaṃ vimatiṃ kleśamarṣaṇam |	བློ་ངན་དང་ནི་ཉོན་མོངས་བཟོད་༎
 vivarjayan samāpnoti daśaitān pañcamī bhuvam || asa_1|57 || 6| abhimukhī bhūmiḥ	བཅུ་པོ་འདི་ནི་རྣམ་སྤངས་ན་༎ ས་ལྔ་པ་ནི་ཡང་དག་འཐོབ་༎
 dānaśīlakṣamāvīryadhyānaprajñāprapūraṇāt |	སྦྱིན་དང་ཚུལ་ཁྲིམས་བཟོད་བརྩོན་འགྲུས་༎ བསམ་གཏན་ཤེས་རབ་རབ་རྫོགས་པས་༎ སློབ་མ་དང་ནི་བས་རུ་ལ་༎
 śiṣyakhaḍgaspṛhātrāsacetasāṃ parivarjakaḥ || asa_1|58 ||	དགའ་དང་སྐྲག་པའི་སེམས་སྤངས་པ་༎ བསླངས་ན་མི་ཞུམ་བདོག་པ་ཀུན་༎
 yācito 'navalīnaśca sarvatyāge 'pyadurmanāḥ |	བཏང་ཡང་མི་དགའ་མེད་པ་དང་༎ དབུལ་ཡང་སློང་བ་མི་སྤོད་བས་༎
 kṛśo 'pi nārthināṃ kṣeptā ṣaṣṭhīṃ bhūmiṃ samaśnute || asa_1|59 || 7|	ས་ནི་དྲུག་པ་ཡང་དག་འཐོབ་༎
 dūraṅgamā bhūmiḥ ātmasattvagraho jīvapudgalocchedaśāśvataḥ | nimittahetvoḥ skandheṣu dhātuṣvāyataneṣu ca || asa_1|60 ||	བདག་དང་སེམས་ཅན་འཛིན་པ་དང་༎ སྲོག་དང་གང་ཟག་ཆད་རྟག་དང་༎ མཚན་མ་རྒྱུ་དང་ཕུང་པོ་དང་༎ ཁམས་དང་སྐྱེ་མཆེད་དག་དང་ནི་༎
 traidhātuke pratiṣṭhānaṃ saktirālīnacittatā |	ཁམས་གསུམ་པོ་ལ་གནས་དང་ཆགས་༎
 ratnatritayaśīleṣu taddṛṣṭayabhiniveśitā || asa_1|61 ||	སེམས་ནི་ཀུན་ཏུ་ཞུམ་པ་དང་༎ དཀོན་མཆོག་གསུམ་དང་ཚུལ་ཁྲིམས་ལ་༎
 śūnyatāyāṃ vivādaśca tadvirodhaśca viṃśatiḥ |	དེར་ལྟ་བ་ཡི་མངོན་ཞེན་དང་༎ སྟོང་པ་ཉིད་ལ་རྩོད་པ་དང་༎ དེ་དང་འགལ་བའི་ཉེས་པ་ནི་༎
 kalaṅkā yasya vicchinnāḥ saptamīmetyasau bhuvam || asa_1|62 ||	ཉི་ཤུ་གང་ལ་རྣམ་ཆད་པ་༎ དེ་ཡིས་ས་ནི་བདུན་པ་འཐོབ་༎
 trivimokṣamukhajñānaṃ trimaṇḍalaviśuddhatā | karuṇāmananā dharmasamataikanayajñatā || asa_1|63 ||	རྣམ་ཐར་སྒོ་༄༤བ་གསུམ་ཤེས་པ་དང་༎ འཁོར་གསུམ་རྣམ་པར་དག་ཉིད་དང་༎ སྙིང་རྗེ་དང་ནི་རློམ་མེད་དང་༎ ཆོས་མཉམ་ཉིད་དང་ཚུལ་གཅིག་ཤེས་༎
 anutpādakṣamājñānaṃ dharmāṇāmekadheraṇā |	མི་སྐྱེ་བ་དང་བཟོད་ཤེས་དང་༎ ཆོས་རྣམས་པ་གཅིག་ཏུ་སྟོན་༎
 kalpanāyāḥ samudghātaḥ saṃjñādṛkkleśavarjanam || asa_1|64 || śamathasya ca nidhyaptiḥ kauśalaṃ ca vidarśane |	རྟོག་པ་ཀུན་ཏུ་འཇོམས་པ་དང་༎ འདུ་ཤེས་ལྟ་དང་ཉོན་མོངས་སྤོང་༏་། ཞི་གནས་ངེས་པར་སེམས་པ་དང་༎ ལྷག་མཐོང་ལ་ནི་མཁས་པ་དང་༎ སེམས་དུལ་བ་དང་ཐམས་ཅད་ལ་༎
 cittasya dāntatā jñānaṃ sarvatrapratighāti ca || asa_1|65 ||	ཐོགས་པ་མེད་པའི་ཡེ་ཤེས་དང་༎ ཆགས་པའི་ས་མིན་གར་འདོད་པར་༎
 sakterabhūmiryatrecchaṃ kṣetrāntaragatiḥ samam |	ཞིང་གཞན་དུ་ནི་མཉམ་འགྲོ་དང་༎ ཀུན་ཏུ་བདག་གི་ངོ་བོ་ནི་༎
 sarvatra svātmabhāvasya darśanaṃ ceti viṃśatiḥ || asa_1|66 || 8| acalā bhūmiḥ	སྟོན་པ་ཉིད་དང་ཉི་ཤུའོ་༎
 sarvasattvamanojñānamabhijñākrīḍanaṃ śubhā | buddhakṣetrasya niṣpattirbuddhasevāparīkṣaṇe || asa_1|67 ||	སེམས་ཅན་ཀུན་ཡིད་ཤེས་པ་དང་༎ མངོན་པར་ཤེས་པས་བརྩེ་བ་དང་༎ སངས་རྒྱས་ཞིང་བཟང་སྒྲུབ་པ་དང་༎ ཡོངས་སུ་བརྟག་ཕྱིར་སངས་རྒྱས་བརྟེན་༎
 akṣajñānaṃ jinakṣetraśuddhirmāyopamā sthitiḥ |	དབང་པོ་ཤེས་དང་རྒྱལ་བ་ཡི་༎
 saṃcintya ca bhavādānamidaṃ karmāṣṭadhoditam || asa_1|68 || 9| sādhumato bhūmiḥ	ཞིང་སྦྱོང་སྒྱུ་མ་ལྟར་གནས་དང་༎ བསམས་བཞིན་སྲིད་པ་ལེན་པ་དང་༎ ལས་ནི་རྣམ་པ་འདི་བརྒྱད་བཤད་༎
 praṇidhānānyanantāni devādīnāṃ rūtajñatā | nadīva pratibhānānāṃ garbhāvakrāntiruttamā || asa_1|69 ||	སྨོན་ལམ་དག་ནི་མཐའ་ཡས་དང་༎ ལྷ་ལ་སོགས་པའི་སྐད་ཤེས་དང་༎ སྤོབས་པ་ཆུ་བོ་ལྟ་བུ་དང་༎ མངལ་དུ་འཇུག་པ་མཆོག་དང་ནི་༎
 kulajātyośca gotraśca parivārasya janmanaḥ |	རིགས་དང་རུས་དང་ཆོ་འབྲང་དང་༎ འཁོར་དང་སྐྱེ་བ་དག་དང་ནི་༎
 naiṣkramyabodhivṛkṣāṇāṃ guṇapūre svasampadaḥ || asa_1|70 || 10| dharmamedhā bhūmiḥ	ངེས་འབྱུང་བྱང་ཆུབ་ཤིང་རྣམས་དང་༎ ཡོན་ཏན་བུན་སུམ་ཚོགས་པ་ཡིན་༎
 navabhūmīratikramya buddhabhūmau pratiṣṭhate |	ས་དགུ་འདས་ནས་ཡེ་ཤེས་ནི་༎ གང་གིས་སངས་རྒྱས་སར་གནས་པ་༎
 yena jñānena sā jñeyā daśamī bodhisattvabhūḥ || asa_1|71 ||	དེ་ནི་བྱང་ཆུབ་སེམས་དཔའི་ས་༎ བཅུ་པ་ཡིན་པར་ཤེས་པར་བྱ་༎
 [pratipakṣasambhāraḥ] pratipakṣo 'ṣṭadhā jñeyo darśanābhyāsamārgayoḥ |	མཐོང་དང་སྒོམ་པའི་ལམ་དག་ལ་༎
 grāhyagrāhakavikalpānāmaṣṭānāmupaśāntaye || asa_1|72 || 20 - niryāṇapratipattiḥ	གཟུང་དང་འཛིན་པའི་རྣམ་རྟོག་རྣམས་༎ ཉེ་བར་ཞི་བར་བྱ་བའི་ཕྱིར་༎ གཉེར་པོ་རྣམ་པ་བརྒྱད་ཅེས་བྱ་༎
 uddeśe samatāyāṃ ca sattvārthe yatnavarjane | atyantāya ca niryāṇaṃ niryāṇaṃ prāptilakṣaṇam || asa_1|73 || sarvākārajñatāyāṃ ca niryāṇaṃ mārgagocaram |	ཆེད་དུ་བྱ་དང་མཉམ་ཉིད་དང་༎ སེམས་ཅན་དོན་དང་འབད་མེད་དང་༎ མཐའ་ལས་འདས་པར་ངེས་འབྱུང་དང་༎ ཐོབ་པའི་མཚན་ཉིད་ངེས་འབྱུང་དང་༎ རྣམ་པ་ཐམས་ཅད་མཁྱེན་ཉིད་དང་༎ ལམ་གྱི་ཡུལ་ཅན་ངེས་འབྱུང་སྟེ་༎ རྣམ་པ་བརྒྱད་ཀྱི་བདག་ཉིད་འདི་༎
 niryāṇapratipajjñeyā seyamaṣṭavidhātmikā || asa_1|74 ||	ངེས་འབྱུང་སྒྲུབ་པ་ཡིན་ཞེས་བྱ་༎
 ityabhisamayālaṅkāre nāma prajñāpāramitopadeśaśāstre prathamādhikāraḥ | 2 mārgajñatādhikāraḥ dvitīyaḥ	ཤེས་རབ་ཀྱི་ཕ་རོལ་ཏུ་ཕྱིན་པའི་མན་ངག་གི་བསྟན་བཅོས་མངོན་པར་རྟོགས་པའི་རྒྱན་གྱི་ཚིག་ལེའུར་བྱས་པ་ལས་༎ སྐབས་དང་༄༥ཨ་༌་༎
 1 - dhyāmīkaraṇatādīni	པོའོ་།
 dhyāmīkaraṇatā bhābhirdevānāṃ yogyatāṃ prati |	༎ ། ལྷ་རྣམས་རུང་བར་བྱ་བའི་ཕྱིར་༎
 viṣayo niyato vyāptiḥ svabhāvastasya karma ca || asa_2|1 || 2 - śrāvakamārgaḥ	འོད་ཀྱིས་མགོ་མོག་པར་མཛད་དང་༎ ཡུལ་ངེས་པ་དང་ཁྱབ་པ་དང་༎ རང་བཞིན་དང་ནི་དེ་ཡི་ལས་༎ ལམ་ཤེས་ཉིད་ཀྱི་ཚུལ་ལ་ནི་༎
 caturṇāmāryasatyānāmākārānupalambhataḥ |	འཕགས་པའི་བདེན་པ་བཞི་དག་གི་༎ རྣམ་པ་མི་དམིགས་སྒོ་ནས་ནི་༎
 śrāvakāṇāmayaṃ mārgo jñeyo mārgajñatānaye || asa_2|2 ||	ཉན་ཐོས་ལམ་འདི་ཤེས་པར་བྱ་༎ འཕགས་པ་ཉན་ཐོས་ལམ་ལ་ནི་༎
 rūpādiskandhaśūnyatvācchūnyatānāmabhedataḥ |	གཟུགས་ལ་སོགས་པ་སྟོང་པའི་ཕྱིར་༎ སྟོང་པ་ཉིད་རྣམས་དབྱེར་མེད་པས་༎
 ūsmāṇau 'nupalambhena teṣāṃ mūrdhagataṃ matam || asa_2|3 ||	དྲོ་བ་དེ་དག་མི་དམིགས་པས་༎ རྩེ་མོར་གྱུར་པ་དག་ཏུ་འདོད་༎
 kṣāntayasteṣu nityādiyogasthānaniṣedhataḥ |	དེ་ལ་རྟག་ལ་སོགས་ཚུལ་གྱིས་༏་། གནས་པ་བཀག་པས་བཟོད་པ་རྣམས་༎
 daśa bhūmīḥ samārabhya vistarāsthānadeśanāt || asa_2|4 ||	ས་བཅུ་དག་ལས་བརྩམས་ནས་ནི་༎ མི་གནས་རྒྱས་པར་བསྟན་པ་ཡིས་༎
 agradharmagataṃ proktamāryaśrāvakartmani |	ཆོས་ཀྱི་མཆོག་ཏུ་འགྱུར་བཤད་དེ་༎
 tatkasya hetorbuddhena buddhvā dharmāsamīkṣaṇāt || asa_2|5 || 3 - pratyekabuddhamārgaḥ	ཅི་ཕྱིར་ཞེ་ན་སངས་རྒྱས་ཀྱིས་༎ མཁྱེན་ནས་ཆོས་རྣམས་མ་གཟིགས་ཕྱིར་༎
 paropadeśavaiyarthyaṃ svayambodhāt svayambhuvām |	རང་བྱུང་བདག་ཉིད་རྟོགས་པའི་ཕྱིར་༎ གཞན་གྱིས་བསྟན་ཡང་མི་དགོས་ལ་༎ བསེ་རུ་ལྟ་བུའི་ཡེ་ཤེས་ནི་༎
 gambhīratā ca jñānasya khaḍgānāmabhidhīyate || asa_2|6 ||	ཟབ་པ་ཉིད་དུ་མངོན་པར་བརྗོད་༎
 śuśrūṣā yasyā yasyārthe yatra yatra yathā yathā |	གང་གང་དོན་ནི་གང་གང་ལ་༎ ཇི་ལྟར་ཇི་ལྟར་ཉན་འདོད་པ་༎
 sa so 'rthaḥ khyātyaśabdo 'pi tasya tasya tathā tathā || asa_2|7 ||	དེ་དེ་ལ་དོན་དང་དེ་༎ སྒྲ་མེད་ཀྱང་དེ་དེ་ལྟར་སྣང་༎
 grāhyārthakalpanāhānād grāhakasyāprahāṇataḥ |	གཟུང་དོན་རྟོག་པ་སྤོང་ཕྱིར་དང་༎ འཛིན་པ་མི་སྤོང་ཕྱིར་དང་ནི་༎ རྟེན་གྱིས་བསེ་རུ་ལྟ་བུའི་ལམ་༎
 ādhārataśca vijñeyaḥ khaḍgamārgasya saṃgrahaḥ || asa_2|8 ||	ཡང་དག་བསྡུས་པར་ཤེས་པར་བྱ་༎
 prajñapteravirodhena dharmatāsūcanākṛtiḥ |	བཏགས་པའི་ཆོས་ཉིད་མི་འགལ་བར་༎ སྟོན་པའི་རྣམ་པ་དྲོར་གྱུར་པ་༎
 ūṣmagaṃ mūrdhagaṃ rūpādyahānādiprabhāvitam || asa_2|9 ||	རྩེ་མོར་གྱུར་པ་གཟུགས་ལ་སོགས་༎ འགྲིབ་པ་མེད་ལ་སོགས་པས་ཕྱེ་༎
 adhyātmaśūnyatādyābhī rūpāderaparigrāhāt |	ནང་སྟོང་ཉིད་ལ་སོགས་པ་ཡིས་༎
 kṣāntī rūpādyanutpādādyākārairagradharmatā || asa_2|10 ||	གཟུགས་སོགས་མི་འཛིན་ཕྱིར་བཟོད་པ་༎ གཟུགས་སོགས་སྐྱེ་བ་མེད་སོགས་ཀྱི་༎ རྣམ་པ་ཅན་ནི་ཆོས་ཀྱི་མཆོག་། 
 4 - bodhisattvamārgaḥ kṣāntijñānakṣaṇaiḥ satyaṃ satyaṃ prati caturvidhaiḥ |	བདེན་དང་བདེན་ན་ལ་བཟོད་པ་དང་༎ ཤེས་པའི་སྐད་ཅིག་རྣམ་བཞི་ཡིས་༎
 mārgajñatāyāṃ dṛṅmārgaḥ sānuśaṃso 'yamucyate || asa_2|11 ||	ལམ་ཤེས་ཉིད་ལ་མཐོང་བའི་ལམ་༎ ཕན་ཡོན་བཅས་པ་འདི་བཤད་དོ་༎
 ādhārādheyatābhāvāttathatābuddhayormithaḥ |	།
 paryāyeṇānanujñānaṃ mahattā sāpramāṇatā || asa_2|12 ||	རྣམ་གྲངས་ཁས་མི་ལེན་པ་དང་༎ ཆེན་པོ་ཚད་མ་མེད་བཅས་དང་༎ ཚད་མེད་པ་དང་མཐའ་མེད་དང་༎ དེར་གནས་གཟུགས་ལ་སོགས་པ་ལ་༎
 parimāṇāntatābhāvo rūpāderavadhāraṇam |	སངས་རྒྱས་ཉིད་དུ་ངེས་འཛིན་དང༎
 tasyāṃ sthitasya buddhatve 'nudgrahātyāgatādayaḥ || asa_2|13 || maitryādi śūnyatā prāptirbuddhatvasya parigrahaḥ | sarvasya vyavadānasya sarvādhivyādhiśātanam || asa_2|14 ||	༄༥བ་བླང་མེད་དོར་བ་མེད་སོགས་དང་༎ བྱམས་ལ་སོགས་པ་སྟོང་ཉིད་དང་༎ སངས་རྒྱས་ཉིད་ནི་འཐོབ་པ་དང་༎ རྣམ་པར་བྱང་ཀུན་ཡོངས་བསྡུས་དང་༎ ཉམ་ང་བ་དང་ནད་ཀུན་སེལ་༎
 nirvāṇagrāhaśāntatvaṃ buddhebhyo rakṣaṇādikam |	མྱང་འདས་འཛིན་ཞི་ཉིད་དང་༎ སངས་རྒྱས་རྣམས་ཀྱིས་བསྲུང་ལ་སོགས་༎ སྲོག་མི་གཅོད་པ་ལ་སོགས་པ་༎
 aprāṇivadhamārabhya sarvākārajñatānaye || asa_2|15 ||	རྣམ་པ་ཀུན་མཁྱེན་ཚུལ་ལ་ནི་༎
 svayaṃ sthitasya sattvānāṃ sthāpanaṃ pariṇāmanam |	བདག་ཉིད་གནས་ཏེ་སེམས་ཅན་དག་།འགོད་དང་སྤྱིན་པ་ལ་སོགས་པ་༎
 dānādīnāṃ ca sambodhāviti mārgajñatākṣaṇāḥ || asa_2|16 || 5 - bhāvanāmārgakāritram	རྫོགས་པའི་བྱང་ཆུབ་ཏུ་བསྔོ་བ་༎ ལམ་ཤེས་ཉིད་ཀྱི་སྐད་ཅིག་མ་༎
 sarvato damanaṃ nāma sarvataḥ kleśanirjayaḥ |	ཀུན་ནས་ཞི་དང་ཐམས་ཅད་ལ་༎
 upakramāviṣahyatvaṃ bodhirādhārapūjyatā || asa_2|17 || sāsravo bhāvanāmārgaḥ 6 - bhāvanāmārgādhimuktiḥ	བདུད་དང་ཉོན་མོངས་ལས་རྒྱལ་དང་༎ གནོད་པས་བརྫི་བ་མེད་ཉིད་དང་༎ བྱང་ཆུབ་དང་ནི་རྟེན་མཆོད་ཉིད་༎
 adhimuktistridhā jñeyā svārthā ca svaparārthikā |	མོས་པ་རང་གི་དོན་དང་ནི་༎
 parārthikaivetyeṣā ca pratyekaṃ trividheṣyate || asa_2|18 ||	རང་གཞན་དོན་དང་གཞན་དོན་དང་༎ རྣམ་གསུམ་ཤེས་བྱ་དེ་ཡང་ནི་༎
 mṛdvī madhyādhimātrā ca mṛdumṛdvādibhedataḥ |	ཆུང་དང་འབྲིང་དང་ཆེན་པོ་སྟེ་༎ སོ་སོར་རྣམ་པ་གསུམ་དུ་འདོད་༎ ཆུང་དུའི་ཆུང་སོགས་དབྱེ་བ་ཡིས་༎
 sā punastribidhetyevaṃ saptaviṃśatidhā matā || asa_2|19 ||	དེ་ཡང་རྣམ་གསུམ་དེ་ལྟར་ན་༎ རྣམ་པ་ཉི་ཤུ་བདུན་དུ་འདོད་༎ ཤེས་རབ་ཕ་རོལ་ཕྱིན་པ་ལ་༎ མོས་པའི་གནས་སྐབས་རྣམས་ལ་ནི་༎
 7 - bhāvanāmārgādhimuktasya stutiḥ stobhaḥ praśaṃsā ca stutiḥ stobhaḥ praśaṃsā ca prajñāpāramitāṃ prati | adhimokṣasya mātrāṇāṃ navakaistribhiriṣyate || asa_2|20 ||	དགུ་ཚན་གསུམ་གྱིས་བསྟོད་པ་དང་༎ བཀུར་བ་དང་ནི་བསྔགས་པར་འདོད་༎
 8 - pariṇāmanā	ཡོངས་སུ་བསྔོ་བ་ཁྱད་པར་ཅན་༎
 viśeṣaḥ pariṇāmastu tasya kāritramuttamam |	དེ་ཡི་བྱེད་པ་མཆོག་ཡིན་ནོ་༎
 nopalambhākṛtiścāsāvaviparyāsalakṣaṇaḥ || asa_2|21 ||	དེ་ནི་དམིགས་མེད་རྣམ་པ་ཅན་༎ ཕྱིན་ཅི་མ་ལོག་མཚན་ཉིད་དོ་༎
 vivikto buddhapuṇyaughasvabhāvasmṛtigocaraḥ |	བདེན་དང་སངས་རྒྱས་བསོད་ནམས་ཚོགས་༎ རང་བཞིན་དྲན་པའི་སྤྱོད་ཡུལ་ཅན་༎
 sopāyaścānimittaśca buddhairabhyanumoditaḥ || asa_2|22 ||	ཐབས་བཅས་མཚན་མ་མེད་པ་དང་༎ སངས་རྒྱས་རྗེས་སུ་ཡི་རང་དང་༎ ཁམས་གསུམ་རྟོགས་པ་མ་ཡིན་དང་༏་། ཆུང་དང་འབྲིང་དང་ཆེན་པོ་ཡི་༎
 traidhātukāprapannaśca pariṇāmo 'parastridhā |	བསྔོ་བ་གཞན་ནི་རྣམ་གསུམ་པོ་༎
 mṛdurmadhyo 'dhimātraśca mahāpuṇyodayātmakaḥ || asa_2|23 || 9 - anumodanā	བསོད་ནམས་ཆེ་འབྱུང་བདག་ཉིད་དོ་༎
 upāyānupalambhābhyāṃ śubhamūlānumodanā |	ཐབས་དང་མི་དམིགས་པ་དག་གིས་༎ དགེ་བའི་རྩ་ལ་ཡི་རང་བ་༎
 anumode manaskārabhāvaneha vidhīyate || asa_2|24 || anāsravo bhāvanāmārgaḥ 10 - abhinirhāraḥ	རྗེས་སུ་ཡི་རང་ཡིད་བྱེད་པ་༎ བསྒོམ་པ་ཡིན་པར་འདིར་བརྗོད་དོ་༎
 svabhāvaḥ śreṣṭhatā tasya sarvasyānabhisaṃskṛtiḥ |	དེ་ཡི་ངོ་བོ་ཉིད་མཆོག་ཉིད་༎ ཀུན་ལ་མངོན་པར་འདུ་མི་བྱེད་༎
 nopalambhena dharmāṇāmarpaṇā ca mahārthatā || asa_2|25 || 11 - atyantaviśuddhiḥ	ཆོས་རྣམས་དམིགས་སུ་མེད་པར་ནི་༎ གཏོད་པར་བྱེད་པ་དོན་ཆེན་ཉིད་༎
 buddhasevā ca dānādirupāye yacca kauśalam |	སངས་རྒྱས་བསྟེན་དང་སྤྱིན་སོགས་དང་༎ ཐབས་ལ་མཁས་པ་གང་ཡིན་པ་༎ འདི་ལ་མོས་པའི་རྒྱུ་དག་ཡིན་༎
 hetavo 'trādhimokṣasya dharmavyasanahetavaḥ || asa_2|26 || mārādhiṣṭhānagambhīradharmatānadhimuktate |	ཆོས་ཀྱིས་ཕོངས་པའི་རྒྱུ་༄༦ཨ་༌་༎ དག་ནི་༎
 skandhādyabhiniveśaśca pāpamitraparigrahaḥ || asa_2|27 ||	བདུད་ཀྱི་ཐིབས་ཀྱིས་ནོན་པ་དང་༎ ཐབ་མོའི་ཆོས་ལ་མ་མོས་དང་༎ ཕུང་པོ་ལ་སོགས་མངོན་ཞེན་དང་༎ སྡིག་པའི་གྲོགས་པོས་ཡོངས་ཟིན་པའོ་༎
 phalaśuddhiśca rūpādiśuddhireva tayordvayoḥ |	འབྲས་བུ་དག་པ་གཟུགས་ལ་སོགས་༎ དག་པ་ཉིད་དེ་གང་གི་ཕྱིར་༎
 abhinnācchinnatā yasmāditi śuddhirudīritā || asa_2|28 ||	དེ་གཉིས་ཐ་དད་མ་ཡིན་ཞིང་༎ བཅད་དུ་མེད་པས་དག་པར་བརྗོད་༎ ཉོན་མོངས་ཤེས་བྱ་ལམ་གསུམ་གྱི་༎
 kleśajñeyatrimārgasya śiṣyakhaḍgajinaurasām | hānād viśuddhirātyantikī tu buddhasya sarvathā || asa_2|29 ||	ཉམས་ཕྱིར་སློབ་མ་བསེ་རུ་དང་༎ རྒྱལ་སྲས་རྣམས་ཀྱི་དག་པ་སྟེ་༎ སངས་རྒྱས་རྣམ་ཀུན་ན་ཤིན་ཏུ་བ་༎
 mṛdumṛdvādiko mārgaḥ śuddhirnavasu bhūmiṣu |	ས་དགུ་ལ་ནི་ཆེན་པོ་ཡི་༎
 adhimātrādhimātrādermalasya pratipakṣataḥ || asa_2|30 ||	ཆེན་པོ་ལ་སོགས་དྲི་མ་ཡི་༎ གཉེན་པོ་ཆུང་དུའི་ཆུང་དུ་ལ་༎ སོགས་པའི་ལམ་ནི་དག་པ་ཡིན་༎ དེ་ལ་ཀླན་ཀ་སྤངས་པ་ཡིས་༎
 tridhātupratipakṣatvaṃ samatā mānameyayoḥ | mārgasya ceṣyate tasya codyasya parihārataḥ || asa_2|31 ||	ལམ་ནི་འཇལ་དང་གཞལ་བྱ་དག་། མཉམ་པ་ཉིད་ཀྱིས་ཁམས་གསུམ་གྱི་༎ གཉེན་པོ་ཉིད་དུ་འདོད་པ་ཡིན་༎
 ityabhisamayālaṅkāre nāma prajñāpāramitopadeśaśāstre dvitīyādhikāraḥ |	ཤེས་རབ་ཀྱི་ཕ་རོལ་ཏུ་ཕྱིན་པའི་མན་ངག་གི་བསྟན་བཅོས་མངོན་པར་རྟོགས་པའི་རྒྱན་གྱི་ཚིག་ལེའུར་བྱས་པ་ལས་།
 3 sarvajñatādhikāraḥ tṛtīyaḥ 1 - prajñayā na bhave sthānam 2 - kṛpayā na śame sthitiḥ	སྐབས་གཉིས་པའོ་།
 nāpare na pare tīre nāntarāle tayoḥ sthitā |	༎ ། ཚུ་རོལ་ཕ་རོལ་མཐའ་ལ་མིན་༎ དེ་དག་བར་ན་མི་གནས་པ་༎
 adhvanāṃ samatājñānāt prajñāpāramitā matā || asa_3|1 || 3 - anupāyena dūratvam 4 - upāyenāvidūratā	དུས་རྣམས་མཉམ་པ་ཉིད་ཤེས་ཕྱིར་༎ ཤེས་རབ་ཕ་རོལ་ཕྱིན་པར་འདོད་༎
 anupāyena dūraṃ sā sanimittopalambhataḥ |	དེ་ནི་མཚན་མར་དམིགས་སྒོ་ནས་༎ ཐབས་མ་ཡིན་པས་རིང་བ་སྟེ་༎
 upāyakauśalenāsyāḥ samyagāsannatoditā || asa_3|2 || 5 - vipakṣaḥ	དེ་ནི་ཐབས་ལ་མཁས་པ་ཡིས་༎ ཡང་དག་ཉེ་བ་ཉིད་དུ་བཤད་༎
 rupādiskandhaśūnyatve dharmeṣu tryadhvageṣu ca |	གཟུགས་སོགས་ཕུང་པོ་སྟོང་ཉིད་དང་༎ དུས་གསུམ་རྟོགས་པའི་ཆོས་རྣམས་དང་༎ སྦྱིན་སོགས་བྱང་ཆུབ་ཕྱོགས་རྣམས་ལ་༎
 dānādau bodhipakṣeṣu caryāsaṃjñā vipakṣatā || asa_3|3 || 6 - pratipakṣaḥ	སྤྱོད་པའི་འདུ་ཤེས་མི་མཐུན་ཕྱོགས་༎
 dānādiṣvanahaṃkāraḥ pareṣāṃ tanniyojanam |	སྦྱིན་ལ་སོགས་ལ་ངར་འཛིན་མེད་༎ གཞན་དག་དེ་ལ་འཛུད་བྱེད་པ་༎ དེ་ནི་ཆགས་པའི་མཐའ་འགོག་པས་༎
 saṅgakoṭiniṣedho 'yaṃ sūkṣmaḥ saṅgo jinādiṣu || asa_3|4 ||	རྒྱལ་ལ་སོགས་ལ་ཆགས་པ་ཕྲ་༎ ཆོས་ཀྱི་ལམ་ནི་རང་བཞིན་གྱིས་༎
 tadgāmbhīrya prakṛtyaiva vivekād dharmapaddhateḥ |	དབེན་པའི་ཕྱིར་ན་དེ་ཟབ་ཉིད་༎
 ekaprakṛtikaṃ jñānaṃ dharmāṇāṃ saṅgavarjanam || asa_3|5 ||	ཆོས་རྣམས་རང་བཞིན་གཅིག་པར་ནི་༎ ཤེས་པས་ཆགས་པ་སྦོང་བ་ཡིན༎
 dṛṣṭādipratiṣedhena tasyā durbodhatoditā |	མཐོང་བ་ལ་སོགས་བཀག་པ་ཡིས་༎ དེ་ནི་རྟོགས་པར་དཀའ་བར་བཤད་༎
 rūpādibhiravijñānāt tadacintyatvamiṣyate || asa_3|6 ||	གཟུགས་ལ་སོགས་པར་མི་ཤེས་ཕྱིར་༎ དེ་ནི་བསམ་མི་ཁྱབ་པར་འདོད་༎
 evaṃ kṛtvā yathokto vai jñeyaḥ sarvajñatānaye |	དེ་ལྟར་ཀུན་ཤེས་ཉིད་ལུགས་ལ་༎
 ayaṃ vibhāgo niḥśeṣo vipakṣapratipakṣayoḥ || asa_3|7 || 7 - prayogaḥ	མི་མཐུན་གཉེན་པོའི་ཕྱོགས་དག་གི་། རྣམ་པར་དབྱེ་བ་མ་ལུས་པ་༎ ཇི་སྐད་བཤད་པ་འདིར་༄༦བ་ཤེས་བྱ་༎
 rupādau tadanityādau tadapūriprapūrayoḥ |	གཟུགས་སོགས་དེ་མི་རྟག་སོགས་དང་༎ དེ་མ་རྫོགས་དང་རབ་རྫོགས་དང་༎ དེ་ལ་ཆགས་པ་མེད་ཉིད་ལ་༎
 tadasaṅgatve caryāyāḥ prayogaḥ pratiṣedhataḥ || asa_3|8 || avikāro na karttā ca prayogo duṣkarastridhā |	སྤྱོད་པ་བཀག་པའི་སྦྱོར་བ་དང་༎ མི་འགྱུར་བྱེད་པོ་མེད་ཉིད་དང་༎ བྱ་དཀའ་རྣམ་གསུམ་སྦྱོར་བ་དང་༎ སྐལ་བ་ཇི་བཞིན་འབྲས་ཐོབ་པས་༎
 yathābhavya phalaprāpteravandhyo 'bhimataśca saḥ || asa_3|9 ||	འབྲས་ཡོད་འདོད་པ་དེ་དང་ནི་༎
 aparapratyayo yaśca saptadhā khyātivedakaḥ | 8 - samatā	གཞན་ལ་རག་ལས་མེད་གང་དང་༎ སྣང་བ་རྣམ་བདུན་ཤེས་བྱེད་དོ་༎
 caturdhāmananā tasya rūpādau samatā matā || asa_3|10 || 9 - darśanamārgaḥ	གཟུགས་ལ་སོགས་ལ་རློམ་མེད་པ་༎ རྣམ་བཞི་དེ་ཡི་མཉམ་པ་ཉིད་༎
 dharmajñānānvayajñānakṣāntijñānakṣaṇātmakaḥ |	སྡུག་བསྔལ་ལ་སོགས་བདེན་པ་ལ་༎ ཆོས་ཤེས་རྗེས་སུ་ཤེས་པ་དང་༎ བཟོད་ཤེས་སྐད་ཅིག་བདག་ཉིད་འདི་༎
 duḥkhādisatye dṛṅmārga eṣa sarvajñatānaya || asa_3|11 ||	ཀུན་ཤེས་ཚུལ་ལ་མཐོང་བའི་ལམ་༎
 rūpaṃ na nityaṃ nānityamatītāntaṃ viśuddhakam |	གཟུགས་རྟག་མ་ཡིན་མི་རྟག་མིན་༎
 anutpannāniruddhādi vyomābhaṃ lepavarjitam || asa_3|12 || parigraheṇa nirmuktamavyāhāraṃ svabhāvataḥ | pravyāhāreṇa nāsyārthaḥ pareṣu prāpyate yataḥ || asa_3|13 ||	མཐའ་ལས་འདས་དང་རྣམ་དག་དང་༎ མ་སྐྱེས་མ་འགགས་ལ་སོགས་དང་༎ མཁའ་འདྲ་ཆགས་པ་སྤངས་པ་དང་༎ ཡོངས་སུ་འཛིན་ལས་གྲོལ་བ་དང་༎ ངོ་བོ་ཉིད་ཀྱིས་བརྗོད་མེད་དང་༎ གང་ཕྱིར་འདི་དོན་བརྗོད་པ་ཡིས་༎
 nopalambhakṛdatyantaviśuddhirvyādhyasambhavaḥ |	གཞན་ལ་སྦྱིན་དུ་མེད་པ་དང་༎ དམིགས་པ་མེད་པར་བྱེད་པ་དང་༎ ཤིན་ཏུ་རྣམ་དག་ནད་མི་འབྱུང་༎
 apāyocchittyakalpatve phalasākṣātkriyāṃ prati || asa_3|14 ||	ངན་སོང་ཆད་དང་འབྲས་བུ་ནི་༎ མངོན་དུ་བྱ་ལ་མི་རྟོག་ཉིད་༎
 asaṃsargo nimittaiśca vastuni vyañjane dvaye |	མཚན་མ་དག་དང་མ་འབྲེལ་དང་༎ དངོས་དང་མིང་དང་གཉིས་པོ་ལ་༏་། ཤེས་པ་སྐྱེ་བ་མེད་པ་ནི་༎
 jñānasya yā cānutpattiriti sarvajñatākṣaṇāḥ || asa_3|15 ||	ཀུན་ཤེས་ཉིད་ཀྱི་སྐད་ཅིག་མ་༎
 iti seyaṃ punaḥ seyaṃ seyaṃ khalu punastridhā |	དེ་ལྟར་འདི་དང་ཡང་འདི་དང་༎ ཡང་འདི་ཡིན་ཏེ་རྣམ་གསུམ་པོ་༎
 adhikāratrayasyaiṣā samāptiḥ paridīpitā || asa_3|16 ||	།
 ityabhisamayālaṅkāre nāma prajñāpāramitopadeśaśāstre tṛtīyādhikāraḥ | 4 sarvākārābhisambodhādhikāraḥ caturthaḥ 1 - ākārāḥ	ཤེས་རབ་ཀྱི་ཕ་རོལ་ཏུ་ཕྱིན་པའི་མན་ངག་གི་བསྟན་བཅོས་མངོན་པར་རྟོགས་པའི་རྒྱན་གྱི་ཚིག་ལེའུར་བྱས་པ་ལས་། སྐབས་གསུམ་པའོ་།
 vastujñānaprakārāṇāmākārā iti lakṣaṇam |	༎ ། གཞི་ཤེས་པ་ཡི་བྱེ་བྲག་རྣམས་༎ རྣམ་པ་ཞེས་བྱ་མཚན་ཉིད་དེ་༎
 sarvajñatānāṃ traividhyāt trividhā eva te matāḥ || asa_4|1 ||	ཀུན་མཁྱེན་ཉིད་ནི་རྣམ་གསུམ་ཕྱིར་༎ དེ་ནི་རྣམ་པ་གསུམ་དུ་འདོད་༎ མེད་པའི་རྣམ་པ་ནས་བཟུང་སྟེ་༎
 asadākāramārabhya yāvanniścalatākṛtiḥ |	མི་ག-ཡོ་བ་ཡི་རྣམ་པའི་བར་༎
 catvāraḥ pratisatyaṃ te mārge pañcadaśa smṛtāḥ || asa_4|2 ||	བདེན་པ་སོ་སོ་ལ་བཞི་དང་༎ ལམ་ལ་དེ་ནི་བཅོ་ལྔར་བཤད་༎
 hetau mārge ca duḥkhe ca nirodhe ca yathākramam |	རྒྱུ་དང་ལམ་དང་སྡུག་བསྔལ་དང་༎ འགོག་པ་ལ་ནི་གོ་རིམས་བཞིན་༎
 aṣṭau te sapta pañceti ṣoḍaśeti ca kīrtitāḥ || asa_4|3 ||	དེ་དག་བརྒྱད་དང་བདུན་དང་ནི་༎ ལྔ་དང་བཅུ་དྲུག་ཅེས་བསྒྲགས་སོ་༎
 smṛtyupasthānamārabhya buddhatvākārapaścimāḥ |	༄༧ཨ་༌་༎ དྲན་པ་ཉེར་གཞག་ནས་བཟུང་སྟེ་༎ སངས་རྒྱས་རྣམ་པའི་མཐར་ཐུག་རྣམས་༎ ལམ་གྱི་བདེན་པའི་རྗེས་མཐུན་པར་༎ ཀུན་མཁྱེན་གསུམ་དུ་ཕྱེ་བས་ན་༎
 śiṣyāṇāṃ bodhisattvānāṃ buddhānāṃ ca yathākramam || asa_4|4 ||	སློབ་མ་བྱང་ཆུབ་སེམས་དཔའ་དང་༎ སངས་རྒྱས་རྣམས་ལ་རིམ་བཞིན་དུ་༎
 saptatriṃśaccatustriṃśattriṃśannava ca te matāḥ | trisarvajñatvabhedena mārgasatyānurodhataḥ || asa_4|5 ||	སུམ་ཅུ་བདུན་དང་སུམ་ཅུ་བཞི་༎ སུམ་ཅུ་རྩ་དགུ་དག་ཏུ་བཞེད་༎ སངས་རྒྱས་རྣམས་ལ་ལྷག་པར་བྱས་༎
 kṛtādhikārā buddheṣu teṣūptaśubhamūlakāḥ |	དེ་ལ་དགེ་བའི་རྩ་བ་བསྐྲུན་༎
 mitraiḥ sanāthāḥ kalyāṇairasyāḥ śravaṇabhājanam || asa_4|6 ||	དགེ་བའི་བཤེས་ཀྱི་མགོན་བཅས་པ་༎ འདི་མཉན་པ་ཡི་སྣོད་ཡིན་ནོ་༎
 buddhopāsanasampraśnadānaśīlādicaryayā |	སངས་རྒྱས་བསྟན་དང་ཀུན་འདྲི་དང་༎ སྦྱིན་དང་ཚུལ་ཁྲིམས་སོགས་སྤྱོད་པས་༎
 udgrahadhāraṇādīnāṃ bhājanatvaṃ satāṃ matam || asa_4|7 || 2 - prayogāḥ	ལེན་དང་འཛིན་ལ་སོགས་པ་ཡི་༎ སྣོད་དུ་དམ་པ་རྣམས་བཞེད་དོ་༎
 rūpādiṣvanavasthānāt teṣu yoganiṣedhataḥ |	གཟུགས་ལ་སོགས་ལ་མི་གནས་ཕྱིར་༎ དེ་ལ་སྦྱོར་བ་བཀག་པའི་ཕྱིར་༎
 tattathatāgambhīratvāt teṣāṃ duravagāhataḥ || asa_4|8 ||	དེ་ཡི་དེ་བཞིན་ཉིད་ཟབ་ཕྱིར་༎ དེ་རྣམས་གཏིང་དཔག་དཀའ་བའི་ཕྱིར་༎
 tadaprāmāṇyataḥ kṛcchrāccireṇa pratibodhataḥ |	དེ་དག་ཚད་ནི་མེད་ཕྱིར་དང་༎ ཚེགས་ཆེན་ཡུན་རིང་རྟོགས་པའི་ཕྱིར་༎
 vyākṛtāvavivartyatve niryāṇe sanirantare || asa_4|9 || āsannabodhe kṣipraṃ ca parārthe 'vṛddhayahānitaḥ |	ལུང་བསྟན་ཕྱིར་མི་ལྡོག་ཉིད་དང་༎ ངེས་འབྱུང་བར་ཆད་མེད་བཅས་དང་༎ བྱང་ཆུབ་ཉེ་དང་མྱུར་བ་དང་༎ གཞན་དོན་འཕེལ་མེད་འགྲིབ་མེད་ཕྱིར་༎
 dharmādharmādyadṛṣṭau ca rūpācintyādyadarśane || asa_4|10 ||	ཆོས་དང་ཆོས་མིན་སོགས་མི་མཐོང་༎ གཟུགས་སོགས་བསམ་མི་ཁྱབ་མི་མཐོང་༎
 rūpādestannimittasya tadbhāvasyāvikalpakaḥ | phalaratnapradātā ca śuddhakaḥ sāvadhiśca saḥ || asa_4|11 || 3 - guṇāḥ	གཟུགས་སོགས་དེ་ཡི་མཚན་མ་དང་༎ དེ་ཡི་ངོ་བོར་རྣམ་མི་རྟོག་།འབྲས་བུ་རིན་ཆེན་སྦྱིན་བྱེད་དང་༎ དེ་ནི་དག་པ་མཚམས་དང་བཅས་༎ བདུད་ཀྱི་མཐུ་བཅོམ་ལ་སོགས་པ་༎
 mārāṇāṃ śaktihānyādiścaturdaśavidho guṇaḥ | 4 - doṣāḥ	ཡོན་ཏན་རྣམ་པ་བཅུ་བཞིའོ་༎
 doṣāśca ṣaḍ viboddhavyāścaturbhirdaśakaiḥ saha || asa_4|12 || 5 - lakṣaṇāni	སྐྱོན་ནི་བཅུ་ཚན་བཞིར་བཅས་པ་༎ དྲུག་ཏུ་ངེས་པར་རྟོགས་པར་བྱ་༎
 lakṣyate yena tajjñeyaṃ lakṣaṇaṃ trividhaṃ ca tat |	གང་གི་མཚོན་ཏེ་མཚན་ཉིད་དུ་༎ ཤེས་བྱ་དེ་ཡང་རྣམ་པ་གསུམ་༎
 jñānaṃ viśeṣaḥ kāritraṃ svabhāvo yaśca lakṣyate || asa_4|13 || tathāgatasya nirvṛttau loke cālujyanātmake |	ཤེས་པ་ཁྱད་པར་བྱེད་པ་སྟེ་༎ ངོ་བོ་ཉིད་གང་མཚོན་བྱ་ཡང་༎
 sattvānāṃ cittacaryāsu tatsaṃkṣepe bahirgatau || asa_4|14 || akṣayākāratāyāṃ ca sarāgādau pravistṛte | mahadgate 'pramāṇe ca vijñāne cānidarśane || asa_4|15 ||	དེ་བཞིན་གཤེགས་པ་འབྱུང་བ་དང་༎ འཇིག་རྟེན་འཇིག་མེད་བདག་ཉིད་དང་༎ སེམས་ཅན་སེམས་ཀྱི་སྤྱོད་པ་དང་༎ དེ་བསྡུས་པ་དང་ཕྱིར་ལྟས་དང་༎ མི་བཟད་པ་ཡི་རྣམ་པ་དང་༎ ཆགས་བཅས་སོགས་དང་རྒྱ་ཆེན་དང་༎ ཆེན་པོར་གྱུར་དང་ཚད་མེད་དང་༎ རྣམ་ཤེས་བསྟན་དུ་མེད་པ་དང་༎ སེམས་བལྟར་མེད་དང་ཤེས་པ་དེ་༎
 adṛśyacittajñāne ca tadunmiñjādisaṃjñakam |	༄༧བ་ག-ཡོ་བ་ལ་སོགས་ཤེས་བྱ་དང་༎ དེ་ལས་གཞན་ཡང་དེ་དག་ནི་༎
 punastathatākāreṇa teṣāṃ jñānamataḥ param || asa_4|16 ||	དེ་བཞིན་ཉིད་ཀྱི་རྣམ་པར་ཤེས་༎ ཐུབ་པས་དེ་བཞིན་ཉིད་རྟོགས་ཏེ་༎
 tathatāyāṃ munerbodhatatparākhyānamityayam |	གཞན་ལ་བསྟན་པ་ཞེས་བྱ་འདི་༎
 sarvajñatādhikāreṇa jñānalakṣaṇasaṃgrahaḥ || asa_4|17 ||	ཐམས་ཅད་ཤེས་པ་ཉིད་སྐབས་ཀྱི་༎ ཤེས་པའི་མཚན་ཉིད་བསྡུས་པ་ཡིན་༎
 śūnyatve sānimitte ca praṇīdhānavivarjite | anutpādānirodhādau dharmatāyā akopane || asa_4|18 ||	སྟོང་ཉིད་མཚན་མེད་བཅས་པ་དང་༎ སྨོན་པ་རྣམ་པར་སྤངས་པ་དང་༎ སྐྱེ་མེད་འགག་པ་མེད་སོགས་དང་༎ ཆོས་ཉིད་རྣམ་པར་འཁྲུག་མེད་དང་༎ འདུ་མི་བྱེད་དང་རྣམ་མི་རྟོག་། 
 asaṃskāre 'vikalpe ca prabhedālakṣaṇatvayoḥ |	རབ་དབྱེ་མཚན་ཉིད་མེད་ཉིད་ལ་༎
 mārgajñatādhikāreṇa jñānalakṣaṇamiṣyate || asa_4|19 ||	ལམ་ཤེས་ཉིད་ཀྱི་སྐབས་ཀྱིས་ནི་༎ ཤེས་པའི་མཚན་ཉིད་ཡིན་པར་བཞེད་༎ དེ་ནི་ཉིད་ཀྱི་ཆོས་བསྟེན་ནས་༎
 svadharmamupaniśritya vihāre tasya satkṛtau | gurutve mānanāyāṃ ca tatpūjākṛtakatvayoḥ || asa_4|20 || sarvatra vṛttimajjñānamadṛṣṭasya ca darśakam | lokasya śūnyatākāraśūcakajñāpakākṣagam || asa_4|21 ||	གནས་དང་གུས་པར་བྱ་བ་དང་༎ བླ་མ་ཉིད་དང་མཉེས་པ་དང་༎ དེ་ལ་མཆོད་དང་བྱེད་མེད་དང་༎ ཀུན་ཏུ་འཇུག་མཁྱེན་གང་ཡིན་དང་༎ མ་མཐོང་སྟོན་པར་མཛད་པ་དང་༎ འཇིག་རྟེན་སྟོང་ཉིད་རྣམ་པ་དང་༎ བརྗོད་དང་ཤེས་མཛད་མངོན་སུམ་མཛད་༎
 acintyaśāntatādarśi lokasaṃjñanirodhi ca |	བསམ་མི་ཁྱབ་དང་ཞི་ཉིད་སྟོན་༎ འཇིག་རྟེན་འདུ་ཤེས་འགོག་པ་ལ་༎
 jñānalakṣaṇamityuktaṃ sarvākārajñatānaye || asa_4|22 ||	རྣམ་པ་ཀུན་མཁྱེན་ཚུལ་ལ་ནི་༎ ཤེས་པའི་མཚན་ཉིད་ཅེས་བཤད་དོ་༎
 acintyādiviśeṣeṇa viśiṣṭaiḥ satyagocaraiḥ |	བསམ་མི་ཁྱབ་སོགས་ཁྱད་པར་གྱིས་༎ ཁྱད་ཞུགས་བདེན་པའི་སྤྱོད་ཡུལ་ཅན་༎
 viśeṣalakṣaṇaṃ ṣaḍbhirdaśabhiścoditaṃ kṣaṇaiḥ || asa_4|23 ||	སྐད་ཅིག་མ་ནི་བཅུ་དྲུག་གིས་༏་། ཁྱད་པར་མཚན་ཉིད་བཤད་པ་ཡིན་༎
 acintyātulyate meyasaṃkhyayoḥ samatikramau |	བསམ་མི་ཁྱབ་དང་མི་མཉམ་དང་༎ གཞལ་དང་བགྲང་ལས་ཡང་དག་འདས་༎
 sarvāryasaṃgraho vijñavedyāsādhāraṇajñate || asa_4|24 ||	འཕགས་པ་ཀུན་བསྡུས་མཁས་པ་ཡིས་༎ རིག་བྱ་ཐུན་མོང་མིན་ཤེས་ཉིད་༎
 kṣiprajñānyūnapūrṇatve pratipatsamudāgamau | ālambanaṃ ca sādhāraṃ sākalyaṃ samparigrahaḥ || asa_4|25 ||	ཤེས་མྱུར་བྲི་དང་གང་མེད་དང་༎ སྒྲུབ་དང་ཡང་དག་འགྲུབ་པ་དང་༎ དམིགས་པ་བརྟན་དང་བཅས་པ་དང་༎ མཐའ་དག་པ་དང་ཡོངས་འཛིན་དང་༎ རོ་མྱང་མེད་དང་ཁྱད་པར་ནི་༎
 anāsvādaśca vijñeyo viśeṣaḥ ṣoḍaśātmakaḥ |	བཅུ་དྲུག་བདག་ཉིད་ཅེས་བྱ་སྟེ་༎
 viśeṣamārgo mārgebhyo yenānyebhyo viśiṣyate || asa_4|26 ||	གང་གིས་ལམ་ནི་གཞན་དག་ལས་༎ ཁྱད་དུ་འཕགས་པས་ཁྱད་པར་ལམ་༎
 hitaṃ sukhaṃ ca trāṇaṃ ca śaraṇaṃ layanaṃ nṛṇām | parāyaṇaṃ ca dvīpaṃ ca pariṇāyakasaṃjñakam || asa_4|27 ||	ཕན་དང་བདེ་དང་སྐྱོབ་པ་དང་༏་། མི་རྣམས་ཀྱི་ནི་སྐྱབས་དག་དང་༎ གནས་དང་དཔུང་གཉེན་གླིང་དང་ནི་༎
 anābhogaṃ tribhiryānaiḥ phalāsākṣātkriyātmakam |	ཡོངས་འདྲེན་པ་ཞེས་བྱ་བ་དང་༎ ལྷུན་གྱིས་གྲུབ་དང་ཐེག་གསུམ་གྱིས་༎ འབྲས་བུ་མངོན་སུམ་མི་བྱེད་དག་། ཐ་མ་རྟེན་གྱི་མཛད་པ་སྟེ་༎
 paścimaṃ gatikāritramidaṃ kāritralakṣaṇam || asa_4|28 ||	འདི་ནི་བྱེད་པའི་མཚན་ཉིད་ཡིན་༎
 kleśaliṅganimittānāṃ vipakṣapratipakṣayoḥ |	ཉོན་༄༨ཨ་༌་༎ མོངས་རྟགས་དང་མཚན་མ་དང་༎ མི་མཐུན་ཕྱོགས་དང་གཉེན་པོ་དག་། 
 viveko duṣkaraikāntāvuddeśo 'nupalambhakaḥ || asa_4|29 || niṣiddhābhiniveśaśca yaścālambanasaṃjñakaḥ | vipratyayo 'vighātī ca so 'padāgatyajātikaḥ || asa_4|30 ||	དབེན་དང་དཀའ་དང་ངེས་པ་དང་༎ ཆེད་དུ་བྱ་དང་མི་དམིགས་དང་༎ མངོན་པར་ཞེན་པ་བཀག་པ་དང་༎ དམིགས་པ་ཞེས་བྱ་གང་ཡིན་དང་༎ མི་མཐུན་ཐོགས་པ་མེད་དང་དེ་༎
 tathatānupalambhaśca svabhāvaḥ ṣoḍaśātmakaḥ |	གཞི་མེད་འགྲོ་མེད་སྐྱེ་མེད་དང་༎ དེ་བཞིན་ཉིད་ནི་མི་དམིགས་དང་༎ ངོ་བོ་ཉིད་བཅུ་དྲུག་བདག་ཉིད་༎
 lakṣīva lakṣyate ceti caturthaṃ lakṣaṇaṃ matam || asa_4|31 || 6 - mokṣabhāgīyam	མཚོན་བྱ་ལྟ་བུར་མཚོན་པས་ན་༎ མཚན་ཉིད་བཞི་པར་བཞེད་པ་ཡིན་༎
 animittapradānādisamudāgamakauśalam |	མཚན་མེད་རབ་ཏུ་སྦྱིན་ལ་སོགས་༎ ཡང་དག་སྒྲུབ་ལ་མཁས་པ་ནི་༎
 sarvākārāvabodhe 'smin mokṣabhāgīyamiṣyate || asa_4|32 ||	རྣམ་པ་ཐམས་ཅད་རྟོགས་འདི་ལ་༎ ཐར་པའི་ཆ་དང་མཐུན་པར་འདོད་༎
 buddhādyālambanā śraddhā vīryaṃ dānādigocaram | smṛtirāśayasampattiḥ samādhiravikalpanā || asa_4|33 ||	སངས་རྒྱས་སོགས་དམིགས་དད་པ་དང་༎ སྦྱིན་སོགས་སྤྱོད་ཡུལ་བརྩོན་འགྲུས་དང་༎ བསམ་པ་ཕུན་ཚོགས་དྲན་པ་དང་༎ རྣམ་པར་མི་རྟོག་ཏིང་འཛིན་དང་༎ ཆོས་རྣམས་རྣམ་པ་ཐམས་ཅད་དུ་༎
 dharmeṣu sarvairākārairjñānaṃ prajñeti pañcadhā |	ཤེས་པའི་ཤེས་རབ་དང་རྣམ་ལྔ་༎
 tīkṣṇaiḥ subodhā sambodhirdurbodhā mṛdubhirmatā || asa_4|34 || 7 - virvedhabhāgīyam	རྫོགས་པའི་བྱང་ཆུབ་རྣོན་པོ་ཡིས་༎ རྟོགས་སླ་རྟུལ་པོས་རྟོགས་དཀར་བཞེད་༎
 ālambanaṃ sarvasattvā ūṣmaṇāmiha śasyate |	དྲོ་བ་རྣམས་ཀྱི་དམིགས་པ་འདིར་༎ སེམས་ཅན་ཐམས་ཅད་ཡིན་པར་བསྔགས་༎
 samacittādirākārasteṣveva daśadhoditaḥ || asa_4|35 ||	དེ་དག་ཉིད་ལ་སེམས་མཉམ་སོགས་༎ རྣམ་པ་དག་ནི་བཅུར་བཤད་དོ་༎
 svayaṃ pāpānnivṛttasya dānādyeṣu sthitasya ca |	བདག་ཉིད་སྡིག་པ་ལས་ལྡོག་ཅིང་༎ སྦྱིན་ལ་སོགས་ལ་གནས་པས་གཞན་༎
 tayorniyojanānyeṣāṃ varṇavādānukūlate || asa_4|36 ||	དེ་དག་ལ་ནི་འགོད་པ་དང་༎ བསྔགས་པ་བརྗོད་དང་མཐུན་པ་ཉིད་༎ རྩེར་གྱུར་དེ་བཞིན་བཟོད་པ་ནི་༎
 mūrdhagaṃ svaparādhāraṃ satyajñānaṃ tathā kṣamā |	རང་གཞན་རྟེན་ཅན་བདེན་ཤེས་པ་༎
 tathāgradharmā vijñeyāḥ sattvānāṃ pācanādibhiḥ || asa_4|37 || 8 - avaivartiko gaṇaḥ	ཆོས་མཆོག་དེ་བཞིན་སེམས་ཅན་རྣམས་༎ སྨིན་བྱེད་སོགས་ཀྱིས་ཤེས་པར་བྱ་༎
 nirvedhāṅgānyupādāya darśanābhyāsamārgayoḥ |	ངེས་འབྱེད་ཡན་ལག་ནས་བཟུང་སྟེ་༎ མཐོང་དང་སྒོམ་པའི་ལམ་དག་ལ་༎
 ye bodhisattvā vartante so 'trāvaivartiko gaṇaḥ || asa_4|38 ||	བྱང་ཆུབ་སེམས་དཔའ་གང་དག་གནས་༎ དེ་འདིར་མི་ལྡོག་པ་ཡི་ཚོགས་༎
 rūpādibhyo nivṛttyādyairliṅgairviśatidheritaiḥ |	གཟུགས་ལ་སོགས་ལས་ལྡོག་སོགས་རྟགས་༎ རྣམ་པ་ཉི་ཤུར་བརྗོད་པ་ཡིས་༎
 nirvedhāṅgaśitasyedamakvairtikalakṣaṇam || asa_4|39 ||	ངེས་འབྱེད་ཡན་ལག་ལ་གནས་པའི་༎ ཕྱིར་མི་ལྡོག་པའི་མཚན་ཉིད་འདི་༎
 rūpādibhyo nivṛttiśca vicikitsākṣaṇakṣayo |	གཟུགས་ལ་སོགས་ལས་ལྡོག་པ་དང་༎ ཟེ་ཆོམ་མི་ངལ་ཟད་པ་དང་༎ བདག་ཉིད་དགེ་བ་ལ་གནས་ཤིང་༎
 ātmanaḥ kuśalasthasya pareṣāṃ tanniyojanam || asa_4|40 || parādhāraṃ ca dānādi gambhīre 'rthe 'pyakāṃkṣaṇam |	གཞན་དག་ངེ་ལ་འགོད་པ་དང་༎ གཞན་གྱི་རྟེན་ཅན་སྦྱིན་སོགས་དང་༎ ཟབ་མོའི་༄༨བ་དོན་ལ་འང་སོམ་ཉི་མེད་༎
 maitraṃ kāyādyasaṃvāsaḥ paṃcadhāvaraṇena ca || asa_4|41 ||	བྱམས་ལུས་སོགས་དང་སྒྲིབ་པ་ནི་༎
 sarvānuśayahānaṃ ca smṛtisamprajñatā śuci | cīvarādi śarīre ca kṛmīṇāmasamudbhavaḥ || asa_4|42 ||	རྣམ་པ་ལྔ་དང་མི་འགྲོགས་དང་༎ བག་ལ་ཉལ་ཀུན་འཇོམས་པ་དང་༎ དྲན་པ་དང་ནི་ཤེས་བཞིན་དང་༎ གོས་ལ་སོགས་པ་གཙང་བ་དང་༎ ལུས་ལ་སྲིན་བུ་རྣམས་མི་འབྱུང་༎ གྱ་གྱུ་མེད་སེམས་སྦྱངས་པ་ནི་༎
 cittākauṭilyamādānaṃ dhūtasyāmatsarāditā | dharmatāyuktagāmitvaṃ lokārthaṃ narakaiṣaṇā || asa_4|43 || parairaneyatā mārasyānyamārgopadeśinaḥ |	ལེན་དང་སེར་སྣ་མེད་སོགས་དང་༎ ཆོས་ཉིད་ལྡན་པར་འགྲོ་ཉིད་དང་༎ སེམས་ཅན་དོན་དུ་དམྱལ་ཚོལ་དང་༎ གཞན་གྱིས་བཀྲི་བར་མི་བཏུབ་དང་༎ ལམ་གཞན་ཉེ་བར་སྟོན་བདུད་ལ་༎
 māra ityeva bodhaśca caryā buddhānumoditā || asa_4|44 ||	བདུད་ཅེས་བྱ་བར་རྟོགས་པ་དང་༎ སངས་རྒྱས་དགྱེས་པའི་སྤྱོད་པ་སྟེ་༎ རྟགས་ནི་ཉི་ཤུ་དེ་དག་གིས་༎
 ūṣmamūrdhasu sakṣāntiṣvagradharmeṣvavasthitaḥ |	དྲོད་དང་རྩེ་མོ་བཟོད་བཅས་དང་༎ ཆོས་མཆོག་རྣམས་ལ་གནས་པ་ནི་༎
 liṅgairamībhirviśatyā sambodherna nivartatte || asa_4|45 ||	རྫོགས་པའི་བྱང་ཆུབ་ལས་མི་ལྡོག་། 
 kṣāntijñānakṣaṇāḥ ṣaṭ ca pañca pañca ca dṛkpathe |	མཐོང་བའི་ལམ་ལ་བཟོད་པ་དང་༎ ཤེས་པའི་སྐད་ཅིག་བཅུ་དྲུག་ནི་༎ བྱང་ཆུབ་སེམས་དཔའ་མེ་ལྡོག་པའི་༎
 bodhisattvasya vijñeyamavaivartikalakṣaṇam || asa_4|46 ||	མཚན་ཉིད་ཡིན་པར་ཤེས་པར་བྱ་༎
 rūpādisaṃjñāvyāvṛttirdāḍharyaṃ cittasya hīnayoḥ |	གཟུགས་སོགས་འདུ་ཤེས་ལྡོག་པ་དང་༎ སེམས་བརྟེན་ཐེག་པ་དམན་དག་ལས་༎
 yānayorvinivṛttiśca dhyānādyaṅgaparikṣayaḥ || asa_4|47 ||	རྣམ་ལོག་བསམ་གཏན་ལ་སོགས་པའི་༎ ཡན་ལག་ཡོངས་སུ་ཟད་པ་དང་༎ ལུས་སེམས་ཡང་བ་ཉིད་དང་ནི་༎
 kāyacetolaghutvaṃ ca kāmasevābhyupāyikī | sadaiva brahmacāritvamājīvasya viśuddhatā || asa_4|48 || skandhādāvantarāyeṣu sambhāre sendriyādike |	འདོད་ལ་སྤྱོད་ལ་ཐབས་མཁས་དང་༎ རྟག་ཏུ་ཚངས་པར་སྤྱོད་ཉིད་དང་༎ འཚོ་བ་རྣམ་པར་དག་ཉིད་དང་༎ ཕུང་སོགས་པར་ཆད་བྱེད་རྣམས་དང་༎ ཚོགས་དང་དབང་སོགས་བཅས་པ་ཡི་༎ ག-ཡུལ་འགྱེད་སེར་སྣ་ལ་སོགས་ལ་༎
 samare matsarādau ca neti yogānuyogayoḥ || asa_4|49 ||	སྦྱོར་དང་རྗེས་སུ་སྦྱོར་བ་ཡི་༎
 vihārapratiṣedhaśca dharmasyāṇoralabdhatā |	གནས་པ་སོ་སོར་བཀག་པ་དང་༎ ཆོས་ནི་རྡུལ་ཙམ་མི་དམིགས་ཉིད་༎
 niścitattvaṃ svabhūmau ca bhūmitritayasaṃsthitiḥ || asa_4|50 ||	རང་གི་སལ་ངེས་པ་ཉིད་༎ ས་གསུམ་ལ་ནི་གནས་པ་དང་༎ ཆོས་ཀྱི་དོན་དུ་སྲོག་གཏོང་བ་༎
 dharmārthaḥ jīvitatyāga ityamī ṣoḍaśa kṣaṇāḥ |	དེ་འདྲའི་སྐད་ཅིག་བཅུ་དྲུག་ནི་༎
 avaivartikaliṅgāni dṛṅmārgasthasya dhīmataḥ || asa_4|51 ||	བློ་ལྡན་མཐོང་བའི་ལམ་གནས་པའི་༎ ཕྱིར་མི་ལྡོག་པའི་རྟགས་དག་ཡིན་༎
 gambhīro bhāvanāmārgo gāmbhīryaṃ śūnyatādikam |	སྒོམ་པའི་ལམ་ནི་ཟབ་པ་སྟེ་༎ ཟབ་མོ་སྟོང་པ་ཉིད་ལ་སོགས་༎
 samāropāpavādāntamuktatā sā gabhīratā || asa_4|52 || cintātulananidhyānānyabhīkṣṇaṃ bhāvanāpathaḥ |	ཟབ་པ་དེ་ནི་སྒྲོ་འདོགས་དང་༎ སྐུར་པའི་མཐའ་ལས་གྲོལ་བ་ཉིད་༎
 nirvedhāṅgeṣu dṛṅmārge bhāvanāmārga eva ca || asa_4|53 ||	ངེས་འབྱེད་ཡན་ལག་དང་མཐོང་བའི་༎ ལམ་དང་སྒོམ་པའི་ལམ་ཉིད་ལ་༎ ཡང་དང་ཡང་དུ་སེམས་པ་དང་༎ འཇལ་དང་༄༩ཨ་༌་༎ ངེས་རྟོག་སྒོམ་པའི་ལམ་༎
 prābandhikatvādiṣṭo 'sau navadhā ca prakārataḥ |	དེ་ནི་རྒྱུན་ཆགས་ཡིན་པའི་ཕྱིར་༎
 mṛdumadhyādhimātrāṇāṃ punarmṛddhādibhedataḥ || asa_4|54 ||	ཆུང་དང་འབྲིང་དང་ཆེན་པོ་རྣམས་༎ ཆུང་དུའི་ཆུང་སོགས་དབྱེ་བ་ཡིས་༎ རྣམ་པས་རྣམ་པ་དགུར་བཞེད་དོ་༎
 asaṃkhyeyādinirdeśāḥ paramārthena na kṣamāḥ |	གྲངས་མེད་ལ་སོགས་བསྟན་པ་རྣམས་༎ དམ་པའི་དོན་དུ་བཟོད་མ་ཡིན་༎
 kṛpāniṣyandabhūtāste saṃvṛtyābhimatā muneḥ || asa_4|55 ||	ཀུན་རྫོབ་ཏུ་ནི་ཐུགས་བརྩེ་བས་༎ རྒྱུ་མཐུན་དེ་དག་ཐུབ་པ་བཞེད་༎ དངོས་པོ་བརྗོད་དུ་མེད་པ་ལ་༎
 hānivṛddhī na yujyete nirālāpasya vastunaḥ |	ཉམས་པ་དང་ནི་འཕེལ་མི་རུང་༎ སྒོམ་ཞེས་བྱ་བའི་ལམ་གྱིས་ནི་༎
 bhāvanākhyena kiṃ hīnaṃ vartmanā kimupadāgatam || asa_4|56 ||	ཅི་ཞིག་ཉམས་ཤིང་ཅི་ཞིག་འཐོབ་༎
 yathā bodhistathaivāsāviṣṭasyārthasya sādhakaḥ |	བྱང་ཆུབ་ཇི་ལྟ་དེ་བཞིན་དུ་༎ འདི་ནི་འདོད་པའི་དོན་སྒྲུབ་བྱེད་༏་། བྱང་ཆུབ་དེ་བཞིན་ཉིད་མཚན་ཉིད་༎
 tathatālakṣaṇā bodhiḥ so 'pi tallakṣaṇo mataḥ || asa_4|57 ||	དེ་ཡང་དེ་ཡི་མཚན་ཉིད་བཞེད་༎
 pūrveṇa bodhirno yuktā manasā paścimena vā |	སེམས་ནི་སྔ་མས་བྱང་ཆུབ་པར་༎ རིགས་མིན་ཕྱི་མས་ཀྱང་ནི་མིན་༎
 dīpadṛṣṭāntayogena gambhīrā dharmatāṣṭadhā || asa_4|58 ||	མར་མེའི་དཔེ་ཡི་ཚུལ་གྱིས་ནི་༎ ཟབ་མོའི་ཆོས་ཉིད་རྣམ་པ་བརྒྱད་༎
 utpāde ca nirodhe ca tathatāyāṃ gabhīratā | jñeye jñāne ca caryāyāmadvayopāyakauśale || asa_4|59 || 9 - bhavaśāntyoḥ samatā	སྐྱེ་བ་དང་ནི་འགག་པ་དང་༎ དེ་བཞིན་ཉིད་དང་ཤེས་བྱ་དང་༎ ཤེས་དང་སྤྱོད་དང་གཉིས་མེད་དང་༎ ཐབས་མཁས་པ་ལ་ཟབ་པ་ཉིད་༎
 svapnopamatvād dharmāṇāṃ bhavaśāntyorakalpanā |	ཆོས་རྣམས་རྨི་ལམ་འདྲ་བའི་ཕྱིར་༎ སྲིད་དང་ཞི་བར་མི་རྟོག་པ་༎
 karmābhāvādicodyānāṃ parihārā yathoditāḥ || asa_4|60 ||	ལས་མེད་ལ་སོགས་ཀླན་ཀ་ཡི་༎ ལན་ནི་ཇི་སྐད་བཤད་པར་ཟད་༎ སེམས་ཅན་འཇིག་རྟེན་དེ་བཞིན་དུ་༎
 10 - anuttarā kṣetraśuddhiḥ	སྣོད་ཀྱི་འཇིག་རྟེན་མ་དག་པ་༎
 sattvalokasya yāśuddhistasyāḥ śuddhyupahārataḥ |	དེ་ལ་དག་པར་སྒྲུབ་པ་ཡིས་༎
 tathā bhājanalokasya buddhakṣetrasya śuddhatā || asa_4|61 || 11 - upāyakauśalam	སངས་རྒྱས་ཞིང་ནི་དག་པ་ཉིད་༎
 viṣayo 'sya prayogasya śātravāṇāmatikramaḥ |	ཡུལ་དང་སྦྱོར་བ་ཅན་འདི་ནི་༎ དགྲ་རྣམས་ལས་ནི་འདས་པ་དང་༎ མི་ཤེས་ཇི་བཞིན་ཤུགས་དང་ནི་༎
 apratiṣṭho yathāvedhamasādhāraṇalakṣaṇaḥ || asa_4|62 || asakto 'nupalambhaśca nimittapranidhikṣataḥ | talliṅgaṃ cāpramāṇaṃ ca daśadhopāyakauśalam || asa_4|63 ||	ཐུན་མོང་མ་ཡིན་མཚན་ཉིད་དང་༎ མ་ཆགས་པ་དང་མི་དམིགས་དང་༎ མཚན་མ་སྨོན་ལམ་ཟད་པ་དང་༎ དེ་ཡི་རྟགས་དང་ཚད་མེད་པ་༎ ཐབས་ལ་མཁས་པ་རྣམ་པ་བཅུ་༎
 ityabhisamayālaṅkāre nāma prajñāpāramitopadeśaśāstre caturthādhikāraḥ || mūrdhābhisamayādhikāraḥ pañcamaḥ 1 - liṅgama(ūṣmā murdhaprayogaḥ)	ཤེས་རབ་ཀྱི་ཕ་རོལ་ཏུ་ཕྱིན་པའི་མན་ངག་གི་བསྟན་བཅོས་མངོན་པར་རྟོགས་པའི་རྒྱན་གྱི་ཚིག་ལེའུར་བྱས་པ་ལས་། སྐབས་བཞི་པའོ་། ༎ ། རྨི་ལམ་ན་ཡང་ཆོས་རྣམས་ཀུན་༎
 svapnāntare 'pi svapnābhasarvadharmekṣaṇādikam |	རྨི་ལམ་ལྟ་བུར་ལྟ་ལ་སོགས་༎
 mūrdhaprāptasya yogasya liṅgaṃ dvādaśadhā matam || asa_5|1 ||	རྩེ་མོར་ཕྱིན་པར་སྦྱོར་བའི་རྟགས་༎
 2 - vivṛddhiḥ(mūrdhā mūrdhaprayogaḥ)	རྣམ་པ་བཅུ་གཉིས་དག་ཏུ་བཞེད་༎
 jambudvipajaneyattābuddhapūjāśubhādikām |	འཛམ་བུའི་གླིང་གི་སྐྱེ་བོ་རྙེད་༎ སངས་རྒྱས་མཆོད་པའི་དགེ་ལ་སོགས་༎
 upamāṃ bahudhā kṛtvā vivṛddhiḥ ṣoḍaśātmikā || asa_5|2 || 3 - nirudhiḥ(kṣāntiḥ mūrdhaprayogaḥ)	རྣམ་མང་དུ་ནི་དཔེར་མཛད་ནས་༎ རྣམ་འཕེལ་བཅུ་༄༩བ་དྲུག་བདག་ཉིད་དོ་༎
 trisarvajñatvadharmāṇāṃ paripuriranuttarā |	ཀུན་མཁྱེན་ཉིད་གསུམ་ཆོས་རྣམས་ཀྱི་༎ ཡོངས་སུ་རྫོགས་པ་བླ་མེད་པ་༎
 aparityaktasattvārthā nirūḍhirabhidhīyate || asa_5|3 || 4 - cittasaṃsthitiḥ(agradharmākhyaḥ mūrdhaprayogaḥ)	སེམས་ཅན་དོན་ཡོངས་མི་གཏོང་བ་༎ བསྟན་པ་ཞེས་ནི་མངོན་པར་བརྗོད་༎
 caturdvīpakasāhasradvitrisāhasrakopamaḥ |	གླིང་བཞི་པ་དང་སྟོང་དག་དང་༎ སྟོང་གཉིས་གསུམ་དག་དཔེར་མཛད་ནས་༎
 kṛtvā puṇyabahutvena samādhiḥ parikīrtitaḥ || asa_5|4 || 5 - darśanamārgaḥ(mūrdhaprayogaḥ)	བསོད་ནམས་མང་པོ་ཉིད་ཀྱིས་ནི་༎ ཏིང་འཛིན་ཡོངས་སུ་བསྒྲགས་པ་ཡིན་༎
 pravṛttau ca nivṛttau ca pratyekaṃ tau navātmakau |	འཇུག་པ་དང་ནི་ལྡོག་པ་ལ་༎
 grāhyau vikalpau vijñeyāvayathāviṣayātmakau || asa_5|5 ||	གཟུང་བའི་རྣམ་རྟོག་སོ་སོར་དེ་༎ དགུ་ཡི་བདག་ཉིད་ཇི་བཞིན་ཡུལ་༎ མི་ན་པའི་བདག་ཉིད་དག་ཤེས་བྱ་༎ སོ་སོའི་སྐྱེ་བོ་འཕགས་དབྱེ་བས་༎
 dravyaprajñaptisatsattvavikalpau grāhakau matau |	སེམས་ཅན་རྫས་དང་བཏགས་ཡོད་པར་༎ རྣམ་རྟོག་འཛིན་པ་དག་ཏུ་འདོད་༎
 pṛthagjanāryabhedena pratyekaṃ tau navātmakau || asa_5|6 ||	དེ་དག་སོ་སོར་དགུ་བདག་ཉིད་༎ གལ་ཏེ་གཟུང་དོན་དེ་བཞིན་མེད་༎
 grāhyau cenna tathā sto 'rthau kasya tau grāhakau matau |	དེ་དག་གང་གི་འཛིན་པར་འདོད་༎
 iti grāhakabhāvena śūnyatālakṣaṇaṃ tayoḥ || asa_5|7 || eṣa svabhāve gotre ca pratipatsamudāgame |	དེ་ལྟར་དེ་དག་འཛིན་པ་ཡི་༎ ངོ་བོས་སྟོང་པའི་མཚན་ཉིད་དོ་༎ ངོ་བོ་ཉིད་དང་རིགས་དང་ནི་༎
 jñānasyālambanābhrāntau pratipakṣavipakṣayoḥ || asa_5|8 || svasminnadhigame kartṛtatkāritrakriyāphale |	ལམ་ནི་ཡང་དག་འགྲུབ་པ་དང་༎ ཤེས་པའི་དམིགས་པ་མ་འཁྲུལ་དང་༎ མི་མཐུན་ཕྱོགས་དང་གཉེན་པོ་དང་༎ རང་གིས་རྟོགས་དང་བྱེད་པ་དང་༎ དེ་ཡི་ལས་བྱའི་འབྲས་བུལ་༎
 pravṛttipakṣādhiṣṭhāno vikalpo navadhā mataḥ || asa_5|9 ||	འཇུག་པའི་ཕྱོགས་ཀྱི་རྟེན་ཅན་གྱི་༎ རྣམ་རྟོག་དེ་ནི་རྣམ་དགུར་འདོད་༎
 bhavaśāntiprapātitvānnyūnatve 'dhigamasya ca |	སྲིད་དང་ཞི་བར་ལྟུང་བའི་ཕྱིར་༎ རྟོགས་པ་དམན་པ་ཉིད་དང་ནི་༎
 parigrahasyābhāve ca vaikalye pratipadgate || asa_5|10 ||	ཡོངས་སུ་འཛིན་པ་མེད་པ་དང་༎ ལམ་གྱི་རྣམ་པ་མ་ཚང་དང་༎ གཞན་གྱི་རྐྱེན་གྱིས་འགྲོ་བ་དང་༎ ཆེད་དུ་བྱ་བ་ལོག་པ་དང་༎ ཉི་ཚེ་བ་དང་སྣ་ཚོགས་ཉིད་༎
 parapratyagāmitve samuddeśanivartane | prādeśikatve nānātve sthānaprasthānamohayoḥ || asa_5|11 ||	གནས་དང་འཇུག་ལ་རྨོངས་པ་དང་༎ རྗེས་ལ་འགྲོ་ཞེས་བྱ་བ་ལ་༎
 pṛṣṭhato gamane ceti vikalpo 'yaṃ navātmakaḥ |	རྣམ་རྟོག་དགུ་ཡི་བདག་ཉིད་འདི་༎
 nivṛttipakṣādhiṣṭhānaḥ śrāvakādimanobhavaḥ || asa_5|12 ||	ལྡོག་པའི་ཕྱོགས་ཀྱི་རྟེན་ཅན་ཏེ་༎ ཉན་ཐོས་ལ་སོགས་ཡིད་ལ་འབྱུང་༎
 grāhakaḥ prathamo jñeyo grahaṇapratimokṣaṇe | manaskriyāyāṃ dhātūnāmupaśleṣe trayasya ca || asa_5|13 ||	འཛིན་པ་དང་ནི་འདོར་བ་དང་༎ ཡིད་ལ་བྱེད་དང་ཁམས་རྣམས་ནི་༎
 sthāne cābhiniveśe ca prajñaptau dharmavastunaḥ | saktau ca pratipakṣe ca yathecchaṃ ca gatikṣatau || asa_5|14 ||	གསུམ་པོ་དག་དང་ཉེ་འབྲེལ་དང་༎ གནས་དང་མངོན་པར་ཞེན་པ་དང་༎ ཆོས་ཀྱི་དངོས་པོ་བརྟགས་པ་དང་༎ ཆགས་པ་དང་ནི་གཉེན་པོ་དང་༎ ཇི་ལྟར་འདོད་བཞིན་འགྲོ་ཉམས་ལ་༎ འཛིན་པ་དང་པོར་ཤེས་པར་བྱ་༎
 yathoddeśamaniryāṇe mārgāmārgāvadhāraṇe | sanirodhe samutpāde vastuyogaviyogayoḥ || asa_5|15 ||	ཆེད་བཞིན་ངེས་པར་མི་འབྱུང་དང་༎ ལམ་ལ་ལམ་མིན་ངེས་འཛིན་དང་༎ འགག་དང་བཅས་པའི་སྐྱེ་བ་དང་༎ དངོས་༄༡༠ཨ་༌་༎
 sthāne gotrasya nāśe ca prārthanāhetvabhāvayoḥ |	པོ་ལྡན་དང་མི་ལྡན་དང་༎ གནས་དང་རིགས་ནི་འཛིན་པ་དང་༎ དོན་དུ་གཉེར་དང་རྒྱུ་མེད་དང་༎ ཕྱིར་རྒལ་བ་ནི་དམིགས་པ་ལ་༎
 pratyarthikopalambhe ca vikalpo grāhako 'paraḥ || asa_5|16 ||	འཛིན་པའི་རྣམ་རྟོག་གཞན་ཡིན་ནོ་༎
 bodhau sandarśanānyeṣāṃ taddhetośca parīndanā |	བྱང་ཆུབ་ལ་གཞན་སྟོན་པ་དང་༎ དེ་ཡི་རྒྱུ་ནི་ཡོངས་གཏོད་དང་༎ དེ་ཐོབ་པར་ཆད་མེད་པའི་རྒྱུ་༎
 tatprāptyanantaro hetuḥ puṇyabāhulyalakṣaṇaḥ || asa_5|17 ||	བསོད་ནམས་མང་པོའི་མཚན་ཉིད་དོ་༎
 kṣayānutpādayorjñāne malānāṃ bodhirucyate |	དྲི་མ་ཟད་དང་མི་སྐྱེ་བའི་༎ ཡེ་ཤེས་བྱང་ཆུབ་ཅེས་བརྗོད་དོ་༎
 kṣayābhāvādanutpādātte hi jñeye yathākramam || asa_5|18 ||	ཟད་མེད་སྐྱེ་མེད་ཕྱིར་དེ་དག་། གོ་རིམས་བཞིན་དུ་ཤེས་པར་བྱ་༎ འགོག་པ་མེད་པའི་རང་བཞིན་ལ་༎
 prakṛtāvaniruddhāyāṃ darśanākhyena vartmanā |	མཐོང་ཞེས་བྱ་བའི་ལམ་གྱིས་ནི༎
 vikalpajātaṃ ki kṣīṇaṃ kiṃ vānatpattimāgatam || asa_5|19 ||	རྣམ་པར་རྟོག་རིགས་ཅི་ཞིག་ཟད་༎ སྐྱེ་མེད་རྣམ་པ་ཅི་ཞིག་འཐོབ་༎
 sattā ca nāma dharmāṇāṃ jñeye cāvaraṇakṣayaḥ |	གཞན་གྱིས་ཆོས་རྣམས་ཀྱང་ཡོད་ལ་༎ ཤེས་བྱ་ལ་ཡང་སྟོན་པ་ཡི་༎ སྒྲིབ་པ་ཟད་པར་བརྗོད་པ་གང་༎
 kathyate yatparaiḥ śāsturatra vismīyate mayā || asa_5|20 ||	དེ་ལ་ཁོ་བོས་མཚར་དུ་བརྩིས་༎
 nāpaneyamataḥ kiñcit prakṣeptavyaṃ na kiṃcana |	འདི་ལས་བསལ་བྱ་ཅི་ཡང་མེད་༎ གཞག་པར་བྱ་བ་ཅུང་ཟད་མེད་༎
 draṣṭavyaṃ bhūtato bhūtaṃ bhūtadarśī vimucyate || asa_5|21 ||	ཡང་དག་ཉིད་ལ་ཡང་དག་ལྟ་༎ ཡང་དག་མཐོང་ན་རྣམ་པར་གྲོལ་༎
 ekaikasyaiva dānādau teṣāṃ yaḥ saṃgraho mithaḥ |	སྦྱིན་པ་ལ་སོགས་རེ་རེར་ནི་༎ དེ་དག་ཕན་ཚུན་བསྡུས་པ་གང་༎
 sa ekakṣaṇikaḥ kṣāntisaṃgṛhīto 'tra dṛkpathaḥ || asa_5|22 ||	སྐད་ཅིག་གཅིག་པའི་བཟོད་པ་ཡིས་༎ བསྡུས་པ་དེ་འདིར་མཐོང་བའི་ལམ་༎
 sa samādhiṃ samāpadya tataḥ siṃhavijṛmbhitam |	དེ་ནས་སེང་གེ་རྣམ་བསྒྱིངས་པའི་༎ ཏིང་ངེ་འཛིན་ལ་སྙོམས་ཞུགས་ནས་༎
 anulomaṃ vilomaṃ ca pratītyotpādamīkṣate || asa_5|23 ||	རྟེན་ཅིང་འབྲེལ་འབྱུང་ལུགས་མཐུན་དང་༎ ལུགས་མི་མཐུན་ལ་རྟོག་པར་བྱེད་༎
 6 - bhāvanāmārgaḥ(mūrdhaprayogaḥ)	འགོག་དང་བཅས་པའི་སྙོམས་འཇུག་དགུར་༎ རྣམ་པ་གཉིས་སུ་སོང་འོངས་ནས་༎
 kāmāptamabadhīkṛtya vijñānamasamāhitam |	འདོད་པར་གཏོགས་པའི་རྣམ་པར་ཤེས་༎ མཉམ་གཞག་མིན་པའི་མཚམས་བཟུང་སྟེ་༎
 sanirodhāḥ samapattīrgattvāgamya nava dvidhā || asa_5|24 ||	ཐོད་རྒལ་དུ་ནི་སྙོམས་འཇུག་པ་༎
 ekadvitricatuḥpañcaṣaṭsaptāṣṭavyatikramāt |	གཅིག་དང་གཉིས་གསུམ་བཞི་དང་ལྔ་༎ དྲུག་དང་བདུན་དང་བརྒྱད་རྒལ་ནས་༎
 avaskandasamāpattiranirodhamatulyatā || asa_5|25 ||	འགོག་པའི་བར་དུ་མི་འདྲར་འགྲོ་༎
 saṃkṣepe vistare buddhaiḥ sānāthyenāparigrahe |	མདོར་བསྡུས་རྒྱས་དང་སངས་རྒྱས་ཀྱི་༎
 traikālike guṇābhāve śreyasastrividhe pathi || asa_5|26 ||	བསྟང་བས་ཡོངས་སུ་མ་བཟུང་དང་༎ དུས་གསུམ་ཡོན་ཏན་མེད་པ་དང་༎ ལེགས་པའི་ལམ་ནི་རྣམ་གསུམ་ལ་༎
 eko grāhyavikalpo 'yaṃ prayogākāragocaraḥ |	བཟུང་བའི་རྣམ་རྟོག་འདི་གཅིག་སྟེ་༎ སྒྱོར་བའི་རྣམ་པའི་སྤྱོད་ཡུལ་ཅན་༎
 dvitīyaścittacaittānāṃ pravṛttiviṣayo mataḥ || asa_5|27 ||	གཉིས་པ་སེམས་དང་སེམས་བྱུང་རྣམས་༎ འཇུག་པའི་ཡུལ་ཅན་ཡིན་བཞེད་དེ་༎
 anutpādastu cittasya bodhimaṇḍāmanaskriyā |	སེམས་༄༡༠བ་མི་སྐྱེ་དང་བྱང་ཆུབ་ཀྱི་༎
 hīnayānamanaskārau sambodheramanaskṛtiḥ || asa_5|28 ||	སྙིང་པོ་ཡིད་ལ་མི་བྱེད་དང་༎ ཐེག་པ་དམན་པ་ཡིད་བྱེད་དང་༎ རྫོགས་པའི་བྱང་ཆུབ་ཡིད་མི་བྱེད་༎
 bhāvane 'bhāvane caiva tadviparyaya eva ca | ayathārthaśca vijñeyo vikalpo bhāvanāpathe || asa_5|29 ||	སྒོམ་དང་སྒོམ་པ་མེད་པ་དང་༎ དེ་དག་ལས་ནི་བཟློག་ཉིད་དང་༎ ཇི་བཞིན་དོན་མིན་རྣམ་རྟོག་པ་༎
 grāhakaḥ prathamo jñeyaḥ sattvaprajñaptigocaraḥ | dharmapratyaśūnyatvasaktipravicayātmakaḥ || asa_5|30 ||	སྒོམ་པའི་ལམ་ལ་ཤེས་པར་བྱ་༏་། སེམས་ཅན་བཏགས་པའི་སྤྱོད་ཡུལ་དང་༎ ཆོས་བཏགས་པ་དང་སྟོང་མིན་ཉིད་༎
 kṛte ca vastuno yānatritaye ca sa kīrttitaḥ | dakṣiṇāyā aśuddhau vā caryāyāśca vikopane || asa_5|31 ||	ཆགས་དང་རབ་འབྱེད་བདག་ཉིད་དང་༎ དངོས་པོར་བྱེད་དང་ཐེག་གསུམ་དང་༎ ཡོན་ནི་དག་པ་མ་ཡིན་དང་༎ སྤྱོད་པ་རྣམ་པར་འཁྲུག་པ་ལ་༎ འཛིན་པར་བྱེད་པ་དང་པོར་ཏེ་༎ ཤེས་པར་བྱ་བ་བསྒྲགས་པ་ཡིན་༎
 sattvaprajñaptitaddhetuviṣayo navadhāparaḥ |	སེམས་ཅན་བཏགས་དང་དེའི་རྒྱུ་ཡི་༎
 bhāvanāmārgasambaddho vipakṣastad vighātataḥ || asa_5|32 ||	ཡུལ་ཅན་དེ་ཡིས་རྣམ་འཇོམས་པས་༎ སྒོམ་པའི་ལམ་དང་འབྲེལ་པ་ཡི་༎ མི་མཐུན་ཕྱོགས་གཞན་རྣམ་པ་དགུ་༎ བདག་ཉིད་ཇི་བཞིན་ཀུན་མཁྱེན་ནི་༎
 sarvajñatānāṃ tisṛṇāṃ yathāsvaṃ trividhāvṛttau | śāntimārgatathatādisamprayogaviyogayoḥ || asa_5|33 || asamatve ca duḥkhādau kleśānāṃ prakṛtāvapi |	གསུམ་གྱི་སྒྲིབ་པ་རྣམ་གསུམ་དང་༎ ཞི་ལམ་དེ་བཞིན་ཉིད་སོགས་དང་༎ མཚུངས་པར་ལྡན་དང་མི་ལྡན་དང་༎ མི་མཉམ་སྡུག་བསྔལ་ལ་སོགས་དང་༎ ཉོན་མོངས་རྣམས་ཀྱི་རང་བཞིན་དང་༎ གཉིས་སུ་མེད་དང་ཀུན་རྨོངས་ལ་༎
 dvayābhāve ca saṃmohe vikalpaḥ paścimo mataḥ || asa_5|34 ||	རྣམ་པར་རྟོག་པ་ཐ་མར་བཞེད་༎ ཡམས་ནད་འདི་རྣམས་ཟད་ནས་ནི་༎
 āsāṃ kṣaye satītīnāṃ cirāyocchvasitā iva |	ཡུན་རིང་ལོན་ནས་དབུགས་ཕྱིན་ལྟར་༎
 sarvākārajagatsaukhyasādhanā guṇasampadaḥ || asa_5|35 ||	རྣམ་པ་ཀུན་ཏུ་འགྲོ་བ་ཡི་༎ བདེ་སྒྲུབ་ཡོན་ཏན་ཕུན་ཚོགས་ཀུན་༎ རྒྱ་མཚོ་ཆེ་ལ་ཆུ་བོ་བཞིན་༎
 sarvāḥ sarvābhisāreṇa nikāmaphalaśālinam |	འབྲས་བུ་མཆོག་གིས་སྦ་བ་ཡིས་༎
 bhajante taṃ mahāsattvaṃ mahodadhimivāpagāḥ || asa_5|36 || 7 - ānantaryasamādhiḥ(mūrdhaprayogaḥ)	སེམས་དཔའ་ཆེན་པོ་དེ་ལ་ནི་༎ རྣམ་པ་ཀུན་དུ་རྟེན་པར་བྱེད་༎
 trisāhasrajanaṃ śiṣyakhaḍgādhigamasampadi |	སྟོང་གསུམ་སྐྱེ་བོ་ཉན་ཐོས་དང་༎ བསེ་རུའི་རྟོགས་པ་ཕུན་ཚོགས་དང་༎ བྱང་ཆུབ་སེམས་དཔའི་སྐྱོན་མེད་ལ་༎
 bodhisattvasya ca nyāme pratiṣṭhāpya śubhopamāḥ || asa_5|37 ||	བཀོད་པའི་དགེ་བ་དཔེར་མཛད་ནས་༎
 kṛtvā puṇyabahutvena buddhatvāpteranantaraḥ |	བསོད་ནམས་མང་པོ་ཉིད་ཀྱིས་ནི་༎ སངས་རྒྱས་ཉིད་ཀྱི་བར་མེད་དེ་༎
 ānantaryasamādhiḥ sa sarvākārajñatā ca tat || asa_5|38 ||	བར་ཆད་མེད་པའི་ཏིང་ངེ་འཛིན་༎ དེ་ནི་རྣམ་པ་ཀུན་མཁྱེན་ཉིད་༎
 ālambanamabhāvo 'sya smṛtiścādhipatirmataḥ |	འདི་ཡི་དམིགས་པ་དངོས་མེད་དེ་༎ བདག་པོ་དྲན་པ་ཡིན་པར་བཞེད་༎
 ākāraḥ śāntatā cātra jalpājalpipravādinām || asa_5|39 ||	རྣམ་པ་ཞི་ཉིད་འདི་ལ་ནི་༎ རབ་ཏུ་སྨྲ་རྣམས་བརྒྱུད་པར་རྒོལ་༎
 ālambanopapattau ca tatsvabhāvāvadhāraṇe |	དམིགས་པ་འཐད་དང་དེ་ཡི་ནི་༎ ངོ་བོ་ཉིད་ངེས་བཟུང་བ་༄༡༡ཨ་༌་༎
 sarvākarajñatājñāne paramārthe sasaṃvṛttau || asa_5|40 || prayoge triṣu ratneṣu sopāye samaye muneḥ | viparyāse samārge ca pratipakṣavipakṣayoḥ || asa_5|41 || lakṣaṇe bhāvanāyāṃ ca matā vipratipattayaḥ |	དང་༎ རྣམ་ཀུན་མཁྱེན་ཉིད་ཡེ་ཤེས་དང་༎ དམ་པའི་དོན་དང་ཀུན་རྫོབ་དང་༎ སྦྱོར་དང་དཀོན་མཆོག་གསུམ་པོ་དང་༎ ཐབས་བཅས་ཐུབ་པའི་རྟོགས་པ་དང་༎ ཕྱིན་ཅི་ལོག་ནི་ལམ་བཅས་དང་༎ གཉེན་པོ་མི་མཐུན་ཕྱོགས་དག་དང་༎ མཚན་ཉིད་དང་ནི་སྒོམ་པ་ལ་༎ སྨྲ་བ་རྣམས་ཀྱིས་ལོག་རྟོག་པ་༎
 sarvākārajñatādhārā ṣoḍhā daśa ca vādinām || asa_5|42 ||	རྣམ་པ་ཀུན་མཁྱེན་ཉིད་རྟེན་ཅན་༎ རྣམ་པ་བཅུ་དྲུག་དག་ཏུ་བཞེད་༎
 ityabhisamayālaṅkāre nāma prajñāpāramitopadeśaśāstre paṃcamādhikāraḥ |	ཤེས་རབ་ཀྱི་ཕ་རོལ་ཏུ་ཕྱིན་པའི་མན་ངག་གི་བསྟན་བཅོས་མངོན་པར་རྟོགས་པའི་རྒྱན་གྱི་ཚིག་ལེའུར་བྱས་པ་ལས་།
 ānupūrvikādhikāraḥ ṣaṣṭhaḥ	སྐབས་ལྔ་པའོ་།
 dānena prajñayā yāvad buddhādau smṛtibhiśca sā |	༎ ། སྦྱིན་པ་ཤེས་རབ་བར་དག་དང་༎ སངས་རྒྱས་ལ་སོགས་དྲན་དང་ཆོས་༎
 dharmābhāvasvabhāvenetyanupūrvakriyā matā || asa_6|1 ||	དངོས་མེད་ངོ་བོ་ཉིད་ཀྱིས་དེ་༎
 ityabhisamāyālaṅkāre nāma prajñāpāramitopadeśaśāstre ṣaṣṭhādhikāraḥ |	མཐར་གྱིས་པ་ཡི་བྱ་བར་བཞེད་༎ ཤེས་རབ་ཀྱི་ཕ་རོལ་ཏུ་ཕྱིན་པའི་མན་ངག་གི་བསྟན་བཅོས་མངོན་པར་རྟོགས་པའི་རྒྱན་གྱི་ཚིག་ལེའུར་བྱས་པ་ལས་།
 ekakṣaṇābhisambodhādhikāraḥ saptamaḥ 1 - avipākalalakṣaṇaḥ	སྐབས་དྲུག་པའོ་། ༎ ། སྦྱིན་པ་ལ་སོགས་རེ་རེས་ཀྱང་༎
 anāsravāṇāṃ sarveṣāmekaikenāpi saṃgrahāt |	ཟག་མད་ཆོས་ཀུན་བསྡུས་པའི་ཕྱིར་༎
 ekakṣaṇāvabodho 'yaṃ jñeyo dānādinā muneḥ || asa_7|1 ||	ཐུབ་པའི་སྐད་ཅིག་གཅིག་པ་ཡིས་༎ རྟོགས་པ་འདི་ནི་ཤེས་པར་བྱ་༎
 araghaṭṭaṃ yathaikāpi padikā puruṣeritā |	ཇི་ལྟར་སྐྱེས་བུས་ཟོ་ཆུན་རྒྱུད་༎ རྡོག་ཐབས་གཅིག་གིས་བསྐྱོད་པ་ན་༎
 sakṛt sarvaṃ cālayati jñānamekakṣaṇe tathā || asa_7|2 ||	ཐམས་ཅད་ཅིག་ཅར་འགུལ་བ་ལྟར་༎ སྐད་ཅིག་གཅིག་ཤེས་དེ་བཞིན་ནོ་༎ གང་ཚེ་ཆོས་དཀར་ཐམས་ཅད་ཀྱི་༎ རང་བཞིན་ཤེས་རབ་ཕ་རོལ་ཕྱིན་༎
 2 - vipākalakṣaṇaḥ vipākadharmatāvasthā sarvaśuklamayī yadā |	རྣམ་སྨིན་ཆོས་ཉིད་གནས་སྐབས་སྐྱེས་༎
 prajñāpāramitā jātā jñānamekakṣaṇe tadā || asa_7|3 || 3 - alakṣaṇalakṣaṇaḥ	དེ་ཚེ་སྐད་ཅིག་གཅིག་ཡེ་ཤེས་༎
 svapnopameṣu dharmeṣu sthitvā dānādicaryayā |	སྦྱིན་ལ་སོགས་པའི་སྤྱོད་པ་ཡིས་༎ ཆོས་ཀུན་རྨི་ལམ་འདྲར་གནས་ནས་༎ ཆོས་རྣམས་མཚན་ཉིད་མེད་པ་ཉིད་༎
 alakṣaṇatvaṃ dharmāṇāṃ kṣaṇenaikena vindati || asa_7|4 || 4 - advayalakṣaṇaḥ	སྐད་ཅིག་མ་ནི་གཅིག་གིས་རྟོགས་༎
 svapnaṃ taddarśinaṃ caiva dvayayogena nekṣate |	རྨི་ལམ་དང་ནི་དེ་མཐོང་ཉིད་༎ གཉིས་ཀྱི་ཚུལ་དུ་མི་མཐོང་ལྟར་༎
 dharmāṇāmadvayaṃ tattvaṃ kṣaṇenaikena paśyati || asa_7|5 ||	ཆོས་རྣམས་གཉིས་སུ་མེད་པ་ཡི་༎ དེ་ཉིད་སྐད་ཅིག་གཅིག་གིས་མཐོང༎
 ityabhisamayālaṅkāre nāma prajñāpāramitopadeśaśāstre saptamādhikāraḥ |	ཤེས་རབ་ཀྱི་ཕ་རོལ་ཏུ་ཕྱིན་པའི་མན་ངག་གི་བསྟན་བཅོས་མངོན་པར་རྟོགས་པའི་རྒྱན་གྱི་ཚིག་ལེའུར་བྱས་པ་ལས་།
 dharmakāyādhikāraḥ aṣṭamaḥ	སྐབས་བདུན་པའོ་།
 1 - svabhāvakāyaḥ	༎ ། ཐུབ་པའི་ངོ་བོ་ཉིད་སྐུ་ནི་༎
 sarvākārāṃ viśuddhiṃ ye dharmāḥ prāptā nirāsravāḥ |	།
 svābhāviko muneḥ kāyasteṣāṃ prakṛtilakṣaṇaḥ || asa_8|1 || 2 - jñānadharmakāyaḥ	དེ་དག་༄༡༡བ་རང་བཞིན་མཚན་ཉིད་ཅན་༎
 bodhipakṣāpramāṇāni vimokṣā anupūrvaśaḥ |	བྱང་ཆུབ་ཕྱོགས་མཐུན་ཚད་མེད་དང་༎ རྣམ་པར་ཐར་དང་མཐར་གྱིས་ནི་༎
 navātmikā samāpattiḥ kṛtsnaṃ daśavidhātmakam || asa_8|2 || abhibhvāyatanānyaṣṭaprakārāṇi prabhedataḥ |	སྙོམས་འཇུག་དགུ་ཡི་བདག་ཉིད་དང་༎ ཟད་པར་བཅུ་ཡི་བདག་ཉིད་དང་༎ ཟིལ་གྱིས་གནོན་པའི་སྐྱ་མཆེད་ནི་༎
 araṇā praṇidhijñānamabhijñāḥ pratisaṃvidaḥ || asa_8|3 ||	རབ་ཏུ་དབྱེ་བས་རྣམ་བརྒྱད་དང་༎ ཉོན་མོངས་མེད་དང་སྨོན་མཁྱེན་དང་༎ མངོན་ཤེས་སོ་སོ་ཡང་དག་རིག་། 
 sarvākārāścatastro 'tha śuddhayo vaśitā daśa | balāni daśa catvāri vaiśāradyānyarakṣaṇam || asa_8|4 || trividhaṃ smutyupasthānaṃ tridhāsaṃmoṣadharmatā | vāsanāyāḥ samudghāto mahatī karuṇā jane || asa_8|5 ||	རྣམ་པ་ཐམས་ཅད་དག་བཞི་དང་༎ དབང་བཅུ་དང་ནི་སྟོབས་བཅུ་དང་༎ མི་འཇིགས་པ་ནི་བཞི་དག་དང་༎ བསྲུང་བ་མེད་པ་རྣམ་གསུམ་དང་༎ དྲན་པ་ཉེར་གཞག་རྣམ་གསུམ་དང་༎ བསྙེལ་བ་མི་མངའི་ཆོས་ཉིད་དང་༎ བག་ཆགས་ཡང་དག་བཅོམ་པ་དང་༎ སྐྱེ་ལ་ཐུགས་རྗེ་ཆེན་པོ་དང་༎ ཐུབ་པ་ཁོ་ནའི་མ་འདྲེས་ཆོས་༎
 āveṇikā munereva dharmā ye 'ṣṭādaśeritāḥ | sarvākārajñatā ceti dharmakāyo 'bhidhīyate || asa_8|6 ||	བཅོ་བརྒྱད་བཤད་པ་གང་ཡིན་དང་༎ རྣམ་པ་ཐམས་ཅད་མཁྱེན་ཉིད་དང་༎ ཆོས་ཀྱི་སྐུ་ཞེས་བརྗོད་པ་ཡིན་༎ ཉན་ཐོས་ཉོན་མོངས་མེད་པའི་ལྟ་༎
 śrāvakasyāraṇādṛṣṭernṛkleśaparihāritā |	ཉན་ཐོས་ཉོན་མོངས་ཡོངས་སྤོང་ཉིད་༎
 tatkleśastrotaucchittyai grāmādiṣu jināraṇā || asa_8|7 ||	གྲོང་སོགས་སུ་དེའི་ཉོན་མོངས་རྣམས་༎
 anābhogamanāsaṅgamavyāghātaṃ sadā sthitam |	རྒྱུན་གཅོད་རྒྱལ་བའི་ཉོན་མོངས་མེད་༎
 sarvapraśnāpanud bauddhaṃ praṇidhijñānamiṣyate || asa_8|8 ||	སངས་རྒྱས་སྨོན་ནས་མཁྱེན་པ་ནི་༎ ལྷུན་གྱིས་གྲུབ་དང་ཆགས་སྤངས་དང་༎ ཐོགས་པ་མེད་དང་རྟག་གནས་དང་༎ དྲི་བ་ཀུན་ལན་འདེབས་པར་བཞེད་༎
 paripākaṃ gate hetau yasya yasya yadā yadā |	རྒྱུ་ནི་ཡོངས་སུ་སྨིན་གྱུར་ནས་༎ གང་དང་གང་ལ་གང་དང་ནི་༎ གང་ཚེ་བྱ་བ་ཕན་གྱུར་པ་༎
 hitaṃ bhavati karttavyaṃ prathate tasya tasya saḥ || asa_8|9 ||	དེ་དང་དེ་ལ་དེ་སྣང་ངོ་༎ ལྷ་ཡི་རྒྱལ་པོས་ཆར་ཕབ་ཀྱང་༎
 varṣatyapi hi parjanye naiva bījaṃ prarohati |	ས་བོན་མི་རུང་མི་འཁྲུངས་ལྟར་༎
 samutpāde 'pi buddhānāṃ nābhavyo bhadramaśnute || asa_8|10 ||	སངས་རྒྱས་རྣམས་ནི་བྱུང་གྱུར་ཀྱང་༎ སྐལ་བ་མེད་པས་བཟང་མི་མྱོང་༎
 iti kāritravaipulyād buddho vyāpī nirucyate |	དེ་ལྟར་མཛད་པ་རྒྱ་ཆེའི་ཕྱིར་༎ སངས་རྒྱས་ཁྱབ་པར་ངེས་པར་བརྗོད་༎
 akṣayatvācca tasyaiva nitya ityapi kathyate || asa_8|11 || 3 - sambhogakāyaḥ	དེ་ཉིད་ཟད་པ་མེད་པའི་ཕྱིར་༎ རྟག་པ་ཞེས་ཀྱང་བརྗོད་པ་ཡིན་༎
 dvātriṃśallakṣaṇāśītivyañjanātmā munerayam |	མཚན་ནི་སུམ་ཅུ་རྩ་གཉིས་དང་༎ དཔེ་བྱད་བརྒྱད་ཅུའི་བདག་ཉིད་འདི་༎
 sāmbhogiko mataḥ kāyo mahāyānopabhogataḥ || asa_8|12 ||	ཐེག་ཆེན་ཉེ་བར་ལོངས་སྤྱོད་ཕྱིར་༎ ཐུབ་པའི་ལོངས་སྤྱོད་རྫོགས་སྐུར་བཞེད་༎
 cakrāṅkahastaḥ kramakūrmapādo jālāvanaddhāṅgulipāṇipādaḥ |	ཕྱག་ཞབས་འཁོར་ལོའི་མཚན་དང་རུས་སྦལ་ཞབས་༎ ཕྱག་དང་ཞབས་སོར་དྲ་༄༡༢ཨ་༌་༎
 karau sapādau taruṇau mṛdū ca samutsadai saptabhirāśrayo 'sya || asa_8|13 ||	བས་འབྲེལ་པ་དང་༎ ཕྱག་ནི་ཞབས་བཅས་འཇམ་ཞིང་གཞོན་ཤ་ཆགས་༎
 dīrghāṅgulirvyāyatapārṣṇigātraṃ prājyaṃ tvṛjūcchaṅkhapadordhvaromā |	འདི་ཡི་སྐུ་ནི་བདུན་དག་མཐོ་བ་དང་༎ སོར་མོ་རིང་དང་རྟིང་ཡངས་སྐུ་ཆེ་དྲང་༎ ཞབས་འབུར་མི་མངོན་སྤུ་ནི་གྱེན་དུ་ཕྱོགས་༎ བྱིན་པ་ཨཨེ་ན་ཡའི་འདྲ་ཕྱག་རིད་མཛེས་༎
 eṇeyajaṅghaśca paṭūrubāhuḥ kośāvanaddhottamabastiguhyaḥ || asa_8|14 ||	མདོམས་ཀྱི་སྦ་བ་སྦུབས་སུ་ནུབ་པའི་མཆོག་། 
 suvarṇavarṇaḥ pratanūcchaviśca pradakṣiṇaikaikasujātaromā |	པགས་པ་གསེར་མདོག་པགས་པ་སྲབ་པ་དང་༎ སྦུ་ནི་རེ་རེ་ནས་ག-ཡས་ལེགས་འཁྲུངས་དང་༎ ཞལ་མཛོད་སྦུས་བརྒྱན་རོ་སྟོད་སེང་གེ་འདྲ་༎
 ūrṇāṅkitāsyo haripūrvakāyaḥ skandhau vṛtāvasya citāntarāṃsaḥ || asa_8|15 ||	འདི་ཡི་དཔུང་པའི་མགོ་ཟླུམ་ཐལ་གོང་རྒྱས་༎
 hīno rasaḥ khyāti rasottamo 'sya nyagrodhavanmaṇḍalatulyamūrtiḥ |	འདི་ལ་རོ་མི་ཞིམ་པ་རོ་མཆོག་སྣང་༎ སྐུ་ནི་ཉ་གྲོ་དྷ་ལྟར་ཆུ་ཞེང་གབ་༎
 uṣṇīṣamūrdhā pṛthucārujivho brahmasvaraḥ siṃhahanuḥ suśuklāḥ || asa_8|16 ||	གཙུག་ཏོར་དབུར་ལྡན་ལྗགས་རིང་མཛེས་པ་དང་༎ ཚངས་དབྱངས་འགྲམ་པ་སེང་གེའི་འདྲ་དང་ཚེམས་༎
 tulyāḥ pramāṇe 'viralāśca dantā anyūnasaṃkhyā daśikāścatasraḥ | nīlekṣaṇo govṛṣapakṣmanetro dvātriṃśadetāni hi lakṣaṇāni || asa_8|17 ||	ཤིན་ཏུ་དཀར་དང་ཚེད་?་མཉམ་ཐགས་བཟང་དང་༎ གྲངས་ནི་བཞི་བཅུ་ཐམས་པར་ཚང་བ་དང་༎ སྤྱན་ནི་མཐོན་མཐིང་སྤྱན་རྫི་བ་མཆོག་གི་།འདྲ་བ་འདི་དག་གསུམ་ཅུ་རྩ་གཉིས་མཚན་༎
 yasya yasyātra yo heturlakṣaṇasya prasādhakaḥ |	འདི་ལ་མཚན་ནི་གང་གང་གིས་༎ སྒྲུབ་པར་བྱེད་པའི་རྒྱུ་གང་ཡིན་༎
 tasya tasya prapūryāyaṃ samudāgamalakṣaṇaḥ || asa_8|18 ||	དེ་དང་དེ་ནི་རབ་རྫོགས་པས་༎ མཚན་ནི་འདི་དག་ཡང་དག་འགྲུབ་༎
 gurūṇāmanuyānādirdṛḍhatā saṃvaraṃ prati | saṃgrahāsevanaṃ dānaṃ praṇītasya ca vastunaḥ || asa_8|19 ||	བླ་མ་སྐྱེལ་ལ་སོགས་པ་དང་༎ ཡང་དག་བླངས་པ་བརྟན་པ་དང་༎ བསྡུ་བ་བསྟེན་དང་གྱ་ནོམ་པའི་༎ དངོས་པོ་སྦྱིན་དང་གསད་བྱ་བ་༎
 vadhyamokṣasamādānaṃ vivṛddhiḥ kuśalasya ca |	ཐར་བར་བྱེད་དང་དགེ་བ་ནི་༎ ཡང་དག་བླངས་པ་སྤེལ་ལ་སོགས་༎
 ityādiko yathāsūtraṃ heturlakṣaṇasādhakaḥ || asa_8|20 ||	སྒྲུབ་བྱེད་རྒྱུ་ཡི་མཚན་ཉིད་དེ་༏་། མདོ་ལས་ཇི་སྐད་འབྱུང་བ་བཞིན་༎
 tāmrāḥ snigdhāśca tuṅgāśca nakhā aṅgulayo muneḥ |	ཐུབ་པའི་སེན་མོ་ཟང་མདོག་དང་༎ མདོག་སྣུམ་མཐོ་དང་སོར་མོ་རྣམས་༎ ཟླུམ་རྒྱས་བྱིན་གྱིས་ཕྲ་བ་དང་༎ རྩ་མེ་མངོན་དང་མདུད་པ་མེད་༎
 vṛttāścitānupūrvāśca gūḍhā nirgranthayaḥ śirāḥ || asa_8|21 || gūḍhau gulphau samau pādau siṃhebhadvijagopateḥ |	ལོང་བུ་མི་མངོན་ཞབས་མཉམ་དང་༎ སེང་གེ་གླང་ཆེན་བྱ་དང་ནི་༎
 vikrāntaṃ dakṣiṇaṃ cārugamanamṛjuvṛttatā || asa_8|22 ||	ཁྱུ་མཆོག་སྟབས་གཤེགས་ག-ཡས་ཕྱོགས་དང་༎ མཛེས་གཤེགས་དྲང་དང་འཁྲིལ་བག་ཆགས་༎ བྱེ་དོར་བྱས་འདྲ་རིམ་པར་འཚམ་༎
 muṣṭānupūrvate medhyamṛdutve śuddhagātratā |	གཙང་དང་འཇམ་དང་དག་པའི་སྐུ་༎
 pūrvavyañjanatā cārupṛthumaṇḍalagātratā || asa_8|23 ||	མཚན་ནི་ཡོངས་སུ་རྫོགས་པ་དང་༎ ༄༡༢བ་སྐུ་ཡི་ཁོ་ལག་ཡངས་ཤིང་བཟང་༎
 samakramatvaṃ śuddhatvaṃ netrayoḥ sukumāratā |	གོམ་སྙོམས་པ་དང་སྤྱན་གཉིས་ནི་༎
 adīnotsadagātratve susaṃhatanagātratā || asa_8|24 || suvibhaktāṅgatā dhvāntapradhvastālokaśuddhatā |	དག་དང་གཞོན་ཤ་ཅན་ཉིད་དང་༎ སྐུ་ཞུམ་མེད་དང་རྒྱས་པ་དང་༎ ཤིན་ཏུ་གྲིམས་པའི་སྐུ་ཉིད་དང་༎ ཡན་ལག་ཤིན་ཏུ་རྣམ་འབྱེས་དང་༎ གཟིགས་པ་སྒྲིབ་མེད་དག་པ་དང་༎ དཀུ་ཟླུམ་སྐབས་ཕྱིན་མ་རྙོངས་དང་༎ ཕྱང་ངེ་བ་དང་ལྟེ་བ་ནི་༎
 vṛttamṛṣṭākṣatākṣāmakukṣitāśca gabhīratā || asa_8|25 || dakṣiṇāvartatā nābheḥ samantād darśanīyatā | samācāraḥ śuciḥ kālatilakāpagatā tanuḥ || asa_8|26 || karau tulamṛdū snigdhagambhīrāyatalekhatā |	ཟབ་དང་ག-ཡས་ཕྱོགས་འཁྱིལ་བ་དང་༎ ཀུན་ནས་བལྟ་ན་སྡུག་པ་དང་༎ ཀུན་སྤྱོད་གཙང་དང་སྐུ་ལ་ནི་༎
 nātyāyataṃ vaco bimbapratibimbaupamauṣṭhatā || asa_8|27 || mṛdvī tanvī ca raktā ca jivhā jīmūtaghoṣatā | cārūmañjusvaro daṃṣṭrā vṛttāstīkṣṇāḥ sitāḥ samāḥ || asa_8|28 ||	སྨེ་བ་གནག་བག་མེད་པ་དང་༎ ཕྱག་ནི་ཤིང་བལ་ལྟར་འཇམ་དང་༎ ཕྱག་རིས་མདངས་ཡོད་ཟབ་རིང་དང་༎ ཞལ་ནི་ཧ་ཅང་མི་རིང་དང་༎ མཆུ་ནི་བིམཔ་ལྟར་དམར་དང་༎ ལྗགས་མཉེན་པ་དང་སྲབ་པ་དང་༎ དམར་དང་འབྲུག་གི་སྒྲ་ཉིད་དང་༎ གསུངས་མཉེན་འཇམ་དང་མཆེ་བ་ཟླུམ་༎
 anupūrvī gatāstuṅgā nāsikā paramaṃ śuciḥ |	རྣོ་དང་དཀར་དང་མཉམ་པ་དང་༎ བྱིན་གྱིས་ཕྲ་དང་ཤངས་མཐོ་དང་༎ མཆོག་ཏུ་དག་པ་དག་དང་ནི་༎
 viśāle nayane pakṣmacitaṃ padmadalākṣitā || asa_8|29 ||	སྤྱན་ཡངས་པ་དང་རྫི་མ་སྟུག་། 
 āyataślakṣṇasusnigdhasamaromnau bhruvau bhujau | pīnāyatau samau karṇāvupaghātavivarjitau || asa_8|30 || lalāṭamaparimlānaṃ pṛthupūrṇottamāṅgatā |	པདམའི་འདབ་བ་འདྲ་བ་དང་༎ སྨིན་ཚུགས་རིང་དང་འཇམ་པ་དང་༎ སྣུམ་དང་སྤུ་ནི་མཉམ་པ་དང་༎ ཕྱག་རིང་རྒྱས་དང་སྙན་མཉམ་དང་༎ ཉམས་པ་རྣམ་པར་སྤངས་པ་དང་༎ དཔྲལ་བ་ལེགས་པར་འབྱེས་པ་དང་༎ དབྱེས་ཆེ་བ་དང་དབུ་རྒྱས་དང་༎ དབུ་སྐྲ་བུང་བ་ལྟར་གནག་དང་༎ སྟུག་དང་འཇམ་དང་མ་འཛིངས་དང་༎ མི་བཤོར་དྲི་ཞིམ་སྐྱེས་བུ་ཡི་༏་། ཡིད་ནི་འཕྲོག་པར་བྱེད་པ་དང་༎ དཔལ་གྱི་བེའུ་དང་བཀྲ་ཤིས་ནི་༎
 bhrabharābhāścitāḥ ślakṣṇā asaṃlulitamurtayaḥ || asa_8|31 || keśā aparuṣāḥ pusāṃ saurabhyādapahāriṇaḥ |	ག-ཡུང་དྲུང་འཁྱིལ་བས་བརྒྱན་པ་སྟེ་༎
 śrīvatsaḥ svastikaṃ ceti buddhānuvyañjanaṃ matam || asa_8|32 || 4 - nairmāṇikakāyaḥ	སངས་རྒྱས་དཔེ་བྱད་བཟང་པོར་བཞེད་༎ གང་གི་སྲིད་པ་ཇི་སྲིད་པར་༎
 karoti yena citrāṇi hitāni jagataḥ samam |	འགྲོ་ལ་ཕན་པ་སྣ་ཚོགས་དག་། 
 ābhavāt so 'nupacchinnaḥ kāyo nairmāṇiko muneḥ || asa_8|33 ||	མཉམ་དུ་མཛད་པའི་སྐུ་དེ་ནི་༎ ཐུབ་པའི་སྦྲུལ་སྐུ་རྒྱུན་མི་འཆད་༎ ད་བཞིན་འཁོར་བ་ཇི་སྲིད་འདིའི་༎
 buddhakāritrāṇi tathā karmāpyanucchinnamasyāsaṃsāramiṣyate |	ལས་ནི་རྒྱུན་མི་འཆད་པར་འདོད་༎
 gatīnāṃ śamanaṃ karma saṃgrahe ca caturvidhe || asa_8|34 ||	འགྲོ་རྣམས་ཞི་བའི་ལས་དང་ནི་༎ བསྡུ་རྣམ་བཞི་ལ་འགོད་པ་དང་༎ ཀུན་ནས་ཉོན་མོངས་བཅས་པ་ཡི་༎
 niveśanaṃ sasaṃkleśe vyavadānāvabodhane |	རྣམ་པར་བྱང་བ་༄༡༣ཨ་༌་༎
 sattvānāmarthayāthātmye ṣaṭsu pāramitāsu ca || asa_8|35 ||	རྟོགས་པ་དང་༎ སེམས་ཅན་རྣམས་དོན་ཇི་བཞིན་གྱི་༎ དོན་དང་ཕ་རོལ་ཕྱིན་དྲུག་དང་༎ སངས་རྒྱས་ལམ་དང་རང་བཞིན་གྱིས་༎
 buddhamārge prakṛtyaiva śūnyatāyāṃ dvayakṣaye | saṃkete 'nupalambhe ca paripāke ca dehinām || asa_8|36 ||	སྟོང་པ་ཉིད་དང་གཉིས་ཟད་དང་༎ བརྡ་དང་དམིགས་པ་མེད་པ་དང་༎ ལུས་ཅན་རྣམས་ནི་ཡོངས་སྨིན་དང་༏་། བྱང་ཆུབ་སེམས་དཔའི་ལམ་དང་ནི་༎
 bodhisattvasya mārge 'bhiniveśasya nivāraṇe | bodhiprāptau jinakṣetraviśuddhau niyatiṃ prati || asa_8|37 ||	མངོན་པར་ཞེན་པ་ཟློག་པ་དང་༎ བྱང་ཆུབ་ཐོབ་དང་སངས་རྒྱས་ཞིང་༎
 aprameye ca sattvārthe buddhasevādike guṇe |	རྣམ་པར་དག་དང་ངེས་པ་དང་༎ སེམས་ཅན་དོན་ནི་ཚད་མེད་དང་༎ སངས་རྒྱས་རྟེན་སོགས་ཡོན་ཏན་དང་༎ བྱང་ཆུབ་ཡན་ལག་ལས་རྣམས་ནི་༎
 bodheraṅgeṣvanāśe ca karmaṇāṃ satyadarśane || asa_8|38 || viparyāsaprahāṇe ca tadavastukatānaye |	ཆུད་མི་ཟ་དང་བདེན་མཐོང་དང་༎ ཕྱིན་ཅི་ལོག་ནི་སྤངས་པ་དང་༎ དེ་གཞི་མེད་པའི་ཚུལ་དང་ནི་༎ རྣམ་པར་བྱང་དང་ཚོགས་དང་ནི་༎
 vyavadāne sasambhāre saṃskṛtāsaṃskṛte prati || asa_8|39 ||	འདུས་བྱས་འདུས་མ་བྱས་པ་ལ་༎
 vyatibhedāparijñāne nirvāṇe ca niveśanam |	ཐ་དད་ཡོངས་སུ་མི་ཤེས་དང་༎ མྱ་ངན་འདས་ལ་འགོད་པ་སྟེ་༏་། ཆོས་ཀྱི་སྐུ་ཡི་ཕྲིན་ལས་ནི་༎
 dharmakāyasya karmedaṃ saptaviṃśatidhā matam || asa_8|40 ||	རྣམ་པ་ཉི་ཤུ་བདུན་དུ་བཞེད་༎
