skt	tib
 cittotpādasaṃvaravidhikramaḥ namo mañjuśriye kumārabhūtāya	༄༢༤༥ཨ་༅༎ རྒྱ་གར་སྐད་དུ་། ཙིཏཏ་ཨཽཏཔའ་ད་སམབ་ར་བི་དྷི་ཀྲ་མ་། བོད་སྐད་དུ་། སེམས་བསྐྱེད་པ་དང་སྡོམ་པའི་ཆོ་གའི་རིམ་པ་། འཇམ་དཔལ་གཞོན་ནུར་གྱུར་པ་ལ་ཕྱག་འཚལ་ལོ་༎
 sarvadurgatito hīnaṃ sarvāvaraṇavarjitam |	ངན་སོང་ཐམས་ཅད་འཇིག་པ་དང་༎ སྒྲིབ་པ་ཐམས་ཅད་ལས་གྲོལ་ཞིང་༎
 bodhicittaṃ namasyāmi sambuddhapadadāyakam || 1 ||	རྫོགས་སངས་གོ་འཕང་སྩོལ་མཛད་པ་༎ བྱང་ཆུབ་སེམས་ལ་ཕྱག་འཚལ་ལོ་༎
 sambuddhaṃ cāpi saddharma bodhisattvagaṇānapi |	རྫོགས་སངས་རྒྱས་དང་དམ་པའི་ཆོས་༎ བྱང་ཆུབ་སེམས་དཔའི་ཚོགས་ལ་ཡང་༎ དེ་བཞིན་བྱང་ཆུབ་སེམས་དཔའ་ཡི་༎
 likhāmi bodhisattvānāṃ yathāvad saṃvarakramam || 2 ||	སྡོམ་པའི་རིམ་པ་བྲི་བར་བྱ་༎
 tatra prathamaṃ sarvabuddha-bodhisattvavandanā-pūjādi-vidhipūrvakam,	དེ་ལ་དང་པོ་སངས་རྒྱས་དང་བྱང་ཆུབ་སེམས་དཔའ་ཐམས་ཅད་ལ་ཕྱག་འཚལ་བ་དང་། མཆོད་པའི་ཆོ་ག་ལ་སོགས་པ་སྔོན་དུ་སོང་བས་།
 kalyāṇamitre śāstṛsaṃjñām utpādya evam adhyeṣitavyam- yathā pūrvatathāgatārhat-samyaksambuddhaiḥ	དགེ་བའི་བཤེས་གཉེན་ལ་སྟོན་པའི་འདུ་ཤེས་བསྐྱེད་ནས་། འདི་སྐད་ཅེས་གསོལ་བ་གདབ་པར་བྱ་སྟེ་།
 mahābhūmisthitabodhisattvaiśca pūrvam anuttarasamyaksambodhau cittotpādaḥ kṛtaḥ tathā evaṃ nāmno mamāpi ācāryo 'nuttarasamyaksambodhau cittam utpādayed iti triḥ vadet |	ཇི་ལྟར་སྔོན་གྱི་དེ་བཞིན་གཤེགས་པ་དགྲ་བཅོམ་པ་ཡང་དག་པར་རྫོགས་པའི་སངས་རྒྱས་རྣམས་དང་། བྱང་ཆུབ་སེམས་དཔའ་ས་ཆེན་པོ་ལ་བཞུགས་པ་རྣམས་ཀྱིས་དང་པོར་བླ་ན་མེད་པ་ཡང་དག་པར་རྫོགས་པའི་བྱང་ཆུབ་ཏུ་ཐུགས་བསྐྱེད་པ་དེ་བཞིན་དུ་བདག་མིང་འདི་ཞེས་བགྱི་བ་ཡང་སློབ་དཔོན་གྱིས་བླ་ན་མེད་པ་ཡང་དག་པར་རྫོགས་པའི་བྱང་ཆུབ་ཏུ་སེམས་བསྐྱེད་དུ་གསོལ་ཞེས་ལན་གསུམ་གྱི་བར་དུ་བརྗོད་དོ་༎
 evam adhyeṣya triśaraṇagamanam- samanvāhara ācārya |	དེ་ལྟར་གསོལ་བ་བཏབ་ནས་དཀོན་མཆོག་གསུམ་ལ་སྐྱབས་སུ་འགྲོ་བ་ནི་། སློབ་དཔོན་དགོངས་སུ་གསོལ་།
 ahamevaṃnāmā etatkālaprabhṛti yāvadbodhimaṇḍaṃ dvipadānāṃ śreṣṭhaṃ buddhaṃ bhagavantaṃ śaraṇaṃ gacchāmi | samanvāhara ācārya |	བདག་མིང་འདི་ཞེས་བགྱི་བས་དུས་འདི་ནས་བཟུང་ནས་། ཇི་སྲིད་བྱང་ཆུབ་སྙིང་པོ་ལ་མཆིས་ཀྱི་བར་དུ་། རྐང་གཉིས་རྣམས་ཀྱི་མཆོག་སངས་རྒྱས་བཅོམ་ལྡན་འདས་རྣམས་ལ་སྐྱབས་སུ་མཆིའོ་༎ སློབ་དཔོན་དགོངས་སུ་གསོལ་།
 ahamevaṃnāmā etatkālaprabhṛti yāvadbodhimaṇḍaṃ dharmāṇāmuttamaṃ śāntavirāgaṃ dharma śaraṇaṃ gacchāmi | samanvāhara ācārya |	༄༢༤༥བ་བདག་མིང་འདི་ཞེས་བགྱི་བ་དུས་འདི་ནས་བཟུང་ནས་། ཇི་སྲིད་བྱང་ཆུབ་སྙིང་པོ་ལ་མཆིས་ཀྱི་བར་དུ་ཆོས་རྣམས་ཀྱི་མཆོག་ཞི་བ་འདོད་ཆགས་དང་བྲལ་བའི་ཆོག་རྣམས་ལ་སྐྱབས་སུ་མཆིའོ་༎ སློབ་དཔོན་དགོངས་སུ་གསོལ་༎
 ahamevaṃnāmā etatkālaprabhṛti yāvadbodhimaṇḍaṃ gaṇānāmuttamaṃ āryabodhisattvāvaivartikabodhisattvasaṃghaṃ śaraṇaṃ gacchāmi iti triḥ vadet |	བདག་མིང་འདི་ཞེས་བགྱི་བ་དུས་འདི་ནས་བཟུང་ནས་། ཇི་སྲིད་བྱང་ཆུབ་སྙིང་པོ་ལ་མཆིས་ཀྱི་བར་དུ་ཚོགས་རྣམས་ཀྱི་མཆོག་འཕགས་པ་བྱང་ཆུབ་སེམས་དཔའ་ཕྱིར་མི་ལྡོག་པའི་བྱང་ཆུབ་སེམས་དཔའི་དགེ་འདུན་རྣམས་ལ་སྐྱབས་སུ་མཆིའོ་ཞེས་ལན་གསུམ་དུ་བརྗོད་དོ་༎ 
 evaṃ viśiṣṭaṃ śaraṇagamanaṃ kṛttvā bhagavantaṃ śākyamuniṃ,	དེ་ལྟར་སྐྱབས་སུ་འགྲོ་བ་ཁྱད་པར་ཅན་བྱས་ནས་།
 daśadiśāṃ sarvabuddhān bodhisattvāṃśca manasā ālambya praṇamanaṃ yathālabdhaṃ pūjādikaṃ ca kuryāt |	བཅོམ་ལྡན་འདས་ཤའཀྱ་ཐུབ་པ་དང་ཕྱོགས་བཅུའི་སངས་རྒྱས་དང་བྱང་ཆུབ་སེམས་དཔའ་ཐམས་ཅད་ཡིད་ཀྱིས་དམིགས་ཏེ་། ཕྱག་བཙལ་བ་དང་། ཅི་འབྱོར་བའི་མཆོད་པ་ལ་སོགས་པ་བྱས་ལ་།
 ācāryam sammukhaṃ kṛtvā dakṣiṇaṃ jānumaṇḍalaṃ pṛthivyāṃ pratiṣṭhāpya utkuṭukāsano 'pi vā kṛtāñjaliḥ cittam utpādayet |	སློབ་དཔོན་མདུན་དུ་བྱས་ཏེ་པུས་མོ་ག-ཡས་པའི་ལྷ་ང་ས་ལ་བཙུགས་པའམ་ཙོག་པུར་ཡང་རུང་བས་འདུག་སྟེ་། ཐལ་མོ་སྦྱར་བས་སེམས་བསྐྱེད་པར་བྱ་སྟེ་།
 daśadigavasthitāḥ sarve buddhabodhisattvāḥ| mām samanvāharata | ācārya| samanvāhara |	ཕྱོགས་བཅུ་རྣམས་ན་བཞུགས་པའི་སངས་རྒྱས་དང་བྱང་ཆུབ་སེམས་དཔའ་ཐམས་ཅད་བདག་ལ་དགོངས་སུ་གསོལ་༎ སློབ་དཔོན་དགོངས་སུ་གསོལ་།
 ahamevaṃnāmā- asyāṃ jātāvanyāsu vā jātiṣvanavarāgre vā dāna-śīla-bhāvanāyaṃ kuśalamūlaṃ	བདག་མིང་འདི་ཞེས་བགྱི་བས་སྐྱེ་བ་འདི་དང་སྐྱེ་བ་གཞན་དང་གཞན་དག་ཏུ་སྦྱིན་པའི་རང་བཞིན་དང་། 
 mayā kṛtaṃ syāt kāritaṃ kriyamāṇaṃ vā anumoditaṃ bhavet taiḥ kuśalamūlaiḥ yathā pūrvakaiḥ	ཚུལ་ཁྲིམས་ཀྱི་རང་བཞིན་དང་། བསྒོམ་པའི་རང་བཞིན་གྱི་དགེ་བའི་རྩ་བ་བདག་གིས་བགྱིས་པ་དང་། བགྱིད་དུ་སྩལ་བ་དང་། བགྱིད་པ་ལ་རྗེས་སུ་ཡི་རང་བའི་དགེ་བའི་རྩ་བ་དེས་།
 tathāgatārhatsamyaksambuddhaiḥ mahābhūmipraviṣṭaiḥ mahābodhisattvaiśca anuttarasaṃyaksambodhau	ཇི་ལྟར་སྔོན་གྱི་དེ་བཞིན་གཤེགས་པ་དགྲ་བཅོམ་པ་ཡང་དག་པར་རྫོགས་པའི་སངས་རྒྱས་རྣམས་དང་། ས་ཆེན་པོ་ལ་རབ་ཏུ་བཞུགས་པའི་བྱང་ཆུབ་སེམས་དཔའ་ཆེན་པོ་རྣམས་ཀྱིས་།
 cittamutpāditaṃ tathā evaṃnāmā ahamapi etatkālaprabhṛti yāvadbodhimaṇḍaṃ anuttarasamyakmahāsambodhau cittam utpādayeyam |	བླ་ན་མེད་པ་ཡང་དག་པར་རྫོགས་པའི་བྱང་ཆུབ་ཏུ་ཐུགས་བསྐྱེད་པར་མཛད་པ་དེ་བཞིན་དུ་། བདག་མིང་འདི་ཞེས་བགྱི་བས་ཀྱང་དུས་འདི་ནས་བཟུང་ནས་ཇི་སྲིད་བྱང་ཆུབ་སྙིང་པོ་ལ་མཆིས་ཀྱི་བར་དུ་བླ་ན་མེད་པ་ཡང་དག་པར་རྫོགས་པའི་བྱང་ཆུབ་ཆེན་པོ་ལ་སེམས་བསྐྱེད་། པར་བྱའོ་༎ 
 atīrṇān sattvān tārayeyam |	སེམས་ཅན་མ་བརྒལ་བ་རྣམས་བསྒྲལ་བར་བགྱིའོ་༎
 amuktasattvān mocayeyam |	མ་གྲོལ་བ་རྣམས་དགྲོལ་བར་བགྱིའོ་༎
 anāśvastān āśvāsayeyam |	དབུགས་མ་ཕྱིན་པ་རྣམས་དབུགས་དབྱུང་བར་བགྱིའོ་༎
 aparinirvṛtān parinirvāpayeyam |	ཡོངས་སུ་མྱ་ངན་ལས་མ་འདས་པ་རྣམས་ཡོངས་༄༢༤༦ཨ་༌་༎
 evaṃ triḥ vadet |	སུ་མྱ་ངན་ལས་བཟླ་བར་བགྱིའོ་ཞེས་ལན་གསུམ་དུ་བརྗོད་པར་བྱའོ་༎ དེ་ལྟར་སློབ་དཔོན་མེད་ཀྱང་བདག་ཉིད་བྱང་ཆུབ་ཏུ་སེམས་བསྐྱེད་པའི་ཆོག་ནི་།
 tathaiva ācāryābhāve 'pi svayaṃ bodhicittotpādavidhiḥ- tathāgataśākyamuniṃ daśadiksarvatathāgatāṃśca manasā vicintya vandanā-pūjādividhiṃ ca kṛtvā adhyeṣaṇāsahitamācāryapadavirahitaśaraṇagamanādikramaṃ pūrvavad niṣpādayet |	དེ་བཞིན་གཤེགས་པ་ཤའཀྱ་ཐུབ་པ་དང་ཕྱོགས་བཅུའི་དེ་བཞིན་གཤེགས་པ་ཐམས་ཅད་ཡིད་ལ་བསམས་ཏེ་། ཕྱག་འཚལ་བ་དང་། མཆོད་པའི་ཆོ་ག་ལ་སོགས་པ་བྱས་ནས་། གསོལ་བ་གདབ་པ་དང་སློབ་དཔོན་ཞེས་པའི་ཚིག་སྤངས་པའི་སྐྱབས་སུ་འགྲོ་བ་ལ་སོགས་པའི་གོ་རིམས་གོང་མ་བཞིན་དུ་བྱའོ་༎
 evaṃ utpannacittaḥ pudgalaḥ bodhicittavṛddhyartha antaśo divā trivāraṃ rātrau ca trivāraṃ-	དེ་ལྟར་སེམས་བསྐྱེད་པའི་གང་ཟག་གིས་བྱང་ཆུབ་ཀྱི་སེམས་སྤེལ་བར་བྱ་བའི་ཕྱིར་ཐ་ན་ཉིན་ལན་གསུམ་མཚན་ལན་གསུམ་དུ་།
 buddhaṃ ca dharmañca gaṇottamaṃ ca yāvaddhi bodhiṃ śaraṇaṃ gato 'smi |	སངས་རྒྱས་ཆོས་དང་ཚོགས་ཀྱི་མཆོག་རྣམས་ལ་༎ བྱང་ཆུབ་བར་དུ་བདག་ནི་སྐྱབས་སུ་མཆི་༎
 dānādikṛtyaiśca kṛtairmayaibhiḥ buddho bhaveyaṃ jagato hitāya || 3 ||	བདག་གིས་སྦྱིན་སོགས་བགྱིས་པ་འདི་དག་གིས་༎ འགྲོ་ལ་ཕན་ཕྱིར་སངས་རྒྱས་འགྲུབ་པར་ཤོག་། 
 iti bodhicittamutpādayet |	ཅེས་བྱང་ཆུབ་ཏུ་སེམས་བསྐྱེད་པར་བྱའོ་༎
 bodhicittavyāghātakebhyaścaturbhyo rdharmebhyo vyāvṛtto bhavet |	བྱང་ཆུབ་ཀྱི་སེམས་ཉམས་པར་བྱེད་པའི་ཆོས་བཞི་ལས་ལྡོག་པར་བྱ་སྟེ་།
 katame catvāraḥ?	བཞི་གང་ཞེ་ན་།
 gurudakṣiṇīyavisaṃvādanam, pareṣu akaukṛtyasthānīyeṣu kaukṛtyopādanam, utpannacittebhyo bodhisattvebhyo dveṣeṇa avarṇabhāṣaṇam,	བླ་མ་དང་མཆོད་པར་འོས་པ་སླུ་བ་དང་། གཞན་འགྱོད་པའི་གནས་མ་ཡིན་པ་ལ་འགྱོད་པ་བསྐྱེད་པ་དང་། སེམས་བསྐྱེད་པའི་བྱང་ཆུབ་སེམས་དཔའ་ལ་ཞེ་སྡང་གིས་ཚིགས་སུ་བཅད་པ་མ་ཡིན་པ་བརྗོད་པ་དང་། 
 sarvasattveṣu māyāśāṭhyācaraṇañca |	སེམས་ཅན་ཐམས་ཅད་ལ་ག-ཡོ་དང་སྒྱུས་སྤྱོད་པའོ་༎
 bodhicittāvyāghātakān caturdharmān śikṣeta |	བྱང་ཆུབ་ཀྱི་སེམས་མི་ཉམས་པར་བྱེད་པའི་ཆོས་བཞི་ལ་བསླབ་པར་བྱ་སྟེ་།
 katamāṃścaturaḥ?	བཞི་གང་ཞེ་ན་།
 jīvitasyāpi hetoḥ prajānan amṛṣāvādam, sarvasattveṣu adhyāśayaviśuddhyā sthitiḥ na māyāśāṭhyena,	སྲོག་གི་ཕྱིར་ཡང་བསམས་བཞིན་དུ་བརྫུན་མི་སྨྲ་བ་དང་། སེམས་ཅན་ཐམས་ཅད་ལྷག་པའི་བསམ་པ་རྣམ་པར་དག་པས་གནས་པར་བྱའི་ག-ཡོ་དང་སྒྱུས་མ་ཡིན་པ་དང་། 
 utpannacitteṣu bodhisattveṣu śāstṛsaṃjñāmutpādya daśasu dikṣu samyagguṇākhyānam, ye sattvāḥ kuśale sthāpitāḥ teṣām anuttarasamyaksambodhau sthāpanaṃ na tu śrāvakapratyekabuddhatveṣviti |	སེམས་བསྐྱེད་པའི་བྱང་ཆུབ་སེམས་དཔའ་ལ་སྟོན་པའི་འདུ་ཤེས་བསྐྱེད་ཅིང་ཕྱོགས་བཅུར་ཡང་དག་པའི་ཡོན་ཏན་བརྗོད་པར་བྱ་བ་དང་། སེམས་ཅན་འགའ་ཞིག་དགེ་བ་ལ་འགོད་པ་དེ་དག་བླ་ན་མེད་པ་ཡང་དག་པར་རྫོགས་པའི་བྱང་ཆུབ་ལ་འགོད་ཀྱི་ཉན་ཐོས་དང་རང་སངས་རྒྱས་ལ་ནི་མ་ཡིན་ནོ་༎
 viśeṣeṇābhijñāṃ śīghraṃ labdhukāmo bodhisattvaḥ ārya-avalokiteśvara-paripṛcchā-saptadharmaka-nāma-mahāyānasūtraṃ śikṣeta |	ཁྱད་པར་དུ་མངོན་པར་ཤེས་པ་མྱུར་དུ་ཐོབ་པར་འདོད་པའི་བྱང་ཆུབ་སེམས་དཔའ་འཕགས་པ་སྤྱན་རས་གཟིགས་དབང་ཕྱུག་གིས་ཞུས་པའི་ཆོས་བདུན་པ་ཞེས་བྱ་བའི་ཐེག་པ་ཆེན་པོའི་མདོ་ལ་བསླབ་༄༢༤༦བ་པར་བྱའོ་༎ 
 bodhicittotpādānuśaṃsā tu “gaṇḍavyūhasūtrā“-dibhyo jñātavyā |	བྱང་ཆུབ་ཏུ་སེམས་བསྐྱེད་པའི་ཕན་ཡོན་ནི་། སྡོང་པོ་བཀོད་པའི་མདོ་ལ་སོགས་པ་ལས་ཤེས་པར་བྱའོ་༎
 tatra prathamaṃ vidhivad utpannabodhicittasya bodhisattvasya sarvabodhisattvaśīlaśikṣāṃ suśikṣitukāmanayā bodhisattvaṃ bodhisattvasaṃvarasthitaṃ,	དེ་ལ་དང་པོར་ཆོ་ག་བཞིན་དུ་བྱང་ཆུབ་ཏུ་སེམས་བསྐྱེད་པའི་བྱང་ཆུབ་སེམས་དཔས་བྱང་ཆུབ་སེམས་དཔའ་ཐམས་ཅད་ཀྱི་ཚུལ་ཁྲིམས་ཀྱི་བསླབ་པ་ལ་ལེགས་པར་སློབ་པར་འདོད་པས་།
 bodhisattvasaṃvaravidhijñaṃ bodhisattvasaṃvarapradānena śiṣyānugrahasamartha kalyāṇamitraṃ namaskṛtya taccaraṇe nipatya adhyeṣaṇā- “ācārya|	བྱང་ཆུབ་སེམས་དཔའ་བྱང་ཆུབ་སེམས་དཔའི་སྡོམ་པ་ལ་གནས་པ་དང་། བྱང་ཆུབ་སེམས་དཔའི་སྡོམ་པའི་ཆོ་ག་ཤེས་པ་དང་། བྱང་ཆུབ་སེམས་དཔའི་སྡོམ་པ་འབོགས་པའི་སྒོ་ནས་སློབ་མ་རྗེས་སུ་གཟུང་བར་ནུས་པའི་དགེ་བའི་བཤེས་གཉེན་ལ་ཕྱག་བྱས་ཏེ་། དེའི་རྐང་པ་ལ་གཏུགས་ནས་གསོལ་བ་གདབ་པ་ནི་།
 tavāhaṃ bodhisattvaśīlasaṃvarasamādānamākāṃkṣāmyādātuṃ tadarhasyanuparodhena muhūrtamasmākamanukampayā dātuṃ śrotuñca“, “ityevaṃ trivāraṃ adhyeṣitavyam |	སློབ་དཔོན་ཁྱོད་ལས་བདག་བྱང་ཆུབ་སེམས་དཔའི་ཚུལ་ཁྲིམས་ཀྱི་སྡོམ་པ་ཡང་དག་པར་བླང་བ་དེ་ལན་བར་འཚལ་གྱིས་། དེ་ལ་གནོད་པ་མ་མཆིས་ན་བདག་ལ་ཐུགས་བརྩེ་བའི་སླད་དུ་ཅུང་ཟད་ཅིག་གསན་ཅིང་སྩལ་བའི་རིགས་སོ་ཞེས་དེ་ལྟར་ལན་གསུམ་གྱི་བར་དུ་གསོལ་བ་གདབ་པར་བྱའོ་༎
 “kulaputra| tvaṃ śrṛṇu | tvam evaṃ sattvān anuttīrṇān uttārya, amuktān mocayitvā, anāśvatān āśvāsya, aparinirvṛttān parinirvāpya, buddhavaṃśānucchedam icchasi?	རིགས་ཀྱི་བུ་ཁྱོད་ཉོན་ཅིག་། ཁྱོད་འདི་ལྟར་སེམས་ཅན་མ་བརྒལ་བ་རྣམས་བསྒྲལ་བ་དང་། མ་གྲོལ་བ་རྣམས་དགྲོལ་བ་དང་། དབུགས་མ་ཕྱུང་བ་རྣམས་དབུགས་དབྱུང་བ་དང་། ཡོངས་སུ་མྱ་ངན་ལས་མ་འདས་པ་རྣམས་ཡོངས་སུ་མྱ་ངན་ལས་བཟླ་བ་དང་། སངས་རྒྱས་ཀྱི་གདུང་རྒྱུན་མི་འཆད་པར་འདོད་དམ་།
 tatastvaṃ cittotpādadārḍhya samādānadārḍhyañca kuru | “na tvanyaiḥ saha pratispardhāhetave |	དེ་ལས་ཁྱོད་ཀྱིས་སེམས་བསྐྱེད་པ་བརྟན་པ་དང་ཡི་དམ་བརྟན་པར་བྱའོ་༎
 nānyairbalād grāhito 'si?	གཞན་དང་འགྲན་པའི་ཆེད་དུ་མ་ཡིན་ནམ་།
 evaṃ pṛcchet |	གཞན་གྱི་ནན་གྱིས་ལན་དུ་བཅུག་པ་མ་ཡིན་ནམ་ཞེས་འདྲིའོ་༎
 tatpaścāt tathāgataśākyamuneḥ niṣiktāṃ pratimāṃ paṭacitram vā purato 'vasthāpya tathāgataśākyamunyādīn daśadiksarvalokadhātvavasthitān sarvabuddhabodhisattvān purato bhāvayet |	དེའི་འོག་ཏུ་དེ་བཞིན་གཤེགས་པ་ཤའཀྱ་ཐུབ་པའི་ལུགས་སྐུའམ་རས་རིས་ལ་སོགས་པ་མདུན་དུ་བཞུགས་པ་དང་། དེ་བཞིན་གཤེགས་པ་ཤའཀྱ་ཐུབ་པ་ལ་སོགས་པ་ཕྱོགས་བཅུའི་འཇིག་རྟེན་གྱི་ཁམས་ཐམས་ཅད་ན་བཞུགས་པའི་སངས་རྒྱས་དང་བྱང་ཆུབ་སེམས་དཔའ་ཐམས་ཅད་མདུན་དུ་བསམ་ལ་།
 yathāśakti bāhyapañcapūjayā pūjāṃ vandanaṃ ca kuryāt |	ཅི་ནུས་པའི་ཕྱིའི་མཆོད་པ་ལྔས་མཆོད་པ་དང་ཕྱག་བྱས་ལ་།
 tadanantaraṃ kalyāṇamitram uccāsanasthitaṃ śāstṛsaṃjñayā namaskṛtya dakṣiṇaṃ jānumaṇḍalaṃ	དེ་མ་ཐག་ཏུ་དགེ་བའི་བཤེས་གཉེན་སྟན་མཐོན་པོ་ལ་འདུག་པ་ལ་སྟོན་པའི་འདུ་ཤེས་ཀྱིས་ཕྱག་བྱས་ཏེ་། 
 pṛthivyāṃ pratiṣṭhāpya utkuṭukāsanena vāpi kṛtāñjaliḥ kalyāṇamitraṃ bodhisattvasaṃvaragrahaṇāya evam adhyeṣayet-	པུས་མོ་ག-ཡས་པའི་ལྷ་ང་ས་ལ་བཙུགས་པའམ་ཙོག་ཙོག་པོར་འདུག་སྟེ་ཐལ་མོ་སྦྱར་ནས་དགེ་བའི་༄༢༤༧ཨ་༌་༎ བཤེས་གཉེན་ལ་བྱང་ཆུབ་སེམས་དཔའི་སྡོམ་པ་ནོད་པས་འདི་ལྟར་བསྐུལ་བར་བྱ་སྟེ་།
 “ācāryo bodhisattvaśīlasaṃvarasamādānaṃ me śīghraṃ dadātu” ityevaṃ trivāraṃ kalyāṇamitram adhyeṣeta |	སློབ་དཔོན་གྱིས་བྱང་ཆུབ་སེམས་དཔའི་ཚུལ་ཁྲིམས་ཀྱི་སྡོམ་པ་ཡང་དག་པར་བླངས་པ་བདག་ལ་མྱུར་དུ་སྩལ་དུ་གསོལ་ཞེས་དེ་ལྟར་ལན་གསུམ་དུ་དགེ་བའི་བཤེས་གཉེན་ལ་བསྐུལ་ནས་།
 tataḥ kalyāṇamitra upaviṣṭa utthito vāpi saḥ bodhisattvasaṃvaragrāhakaṃ taṃ evaṃ paripṛcchet- “evaṃnāmā tvaṃ bodhisattvo 'si bodhau ca kṛtapraṇidhānaḥ	དེ་ནས་དགེ་བའི་བཤེས་གཉེན་འདུག་པའམ་ལངས་པ་ཡང་རུང་སྟེ་། དེས་བྱང་ཆུབ་སེམས་དཔའི་སྡོམ་པ་ནོད་པ་དེ་དག་ལ་འདི་སྐད་ཅེས་དྲི་བ་བྱ་སྟེ་། མིང་འདི་ཞེས་བྱ་བ་ཁྱོད་བྱང་ཆུབ་སེམས་དཔའ་ཡིན་ནམ་། བྱང་ཆུབ་ཏུ་སྨོན་ལམ་བཏབ་བམ་ཞེས་དྲིས་པ་ན་།
 evaṃ pṛṣṭe sati tena grāhakabodhisattvenāpi āmeti pratijñātavyam” |	ལེན་པའི་བྱང་ཆུབ་སེམས་དཔའ་དེས་ཀྱང་བཏབ་ལགས་སོ་ཞེས་ཁས་བླང་བར་བྱའོ་༎
 tataḥ 'akṣayāprameyānuttarapuṇyamahānidhibhūtaḥ sarvabuddhaguṇaratnākaro bodhisattvasaṃvaro 'cireṇa adhigamyata' iti cintayan cittaprasādāt saharṣa tūṣṇībhūya kṛtāñjalistiṣṭhet |	དེ་ནས་མི་ཟད་པ་དཔག་ཏུ་མེད་པ་བླ་ན་མེད་པའི་བསོད་ནམས་ཀྱི་གཏེར་ཆེན་པོར་གྱུར་པ་སངས་རྒྱས་ཐམས་ཅད་ཀྱི་ཡོན་ཏན་རིན་པོ་ཆེའི་འབྱུང་གནས་བྱང་ཆུབ་སེམས་དཔའི་སྡོམ་པ་རིང་པོར་མི་ཐོགས་པར་ཐོབ་པར་འགྱུར་རོ་ཞེས་སྙམ་དུ་བསམ་ཞིང་སེམས་རབ་ཏུ་དང་བར་གྱུར་པས་དགའ་བ་དང་བཅས་པས་ཅང་མི་སྨྲ་བར་ཐལ་མོ་སྦྱར་ཏེ་འདུག་པར་བྱའོ་༎
 atha sa kalyāṇamitraḥ trikālasarvabodhisattvasarvaśikṣāpadāni sarvañca śīlaṃsaṃvaraśīlaṃ , kuśaladharmasaṅgrāhakaśīlaṃ,	དེ་ནས་དགེ་བའི་བཤེས་གཉེན་དེས་དུས་གསུམ་གྱི་བྱང་ཆུབ་སེམས་དཔའ་ཐམས་ཅད་ཀྱི་བསླབ་པའི་གཞི་ཐམས་ཅད་དང་ཚུལ་ཁྲིམས་ཐམས་ཅད་དེ་། སྡོམ་པའི་ཚུལ་ཁྲིམས་དང་། དགེ་བ་ཆོས་སྡུད་པའི་ཚུལ་ཁྲིམས་དང་། སེམས་ཅན་གྱི་དོན་བྱེད་པའི་ཚུལ་ཁྲིམས་མདོར་བསྡུས་པ་སློབ་མ་ལ་གོ་བར་བྱས་ཏེ་།
 sattvārthakriyāśīlañca samāsataḥ śiṣyam ababodhya- “sarvabodhisattvaśikṣāpadāni tāni ca sarvabodhisattvaśīlāni kiṃ mattaḥ gṛhītukāmo 'si” evaṃ śiṣyaṃ pṛcchet |	བྱང་ཆུབ་སེམས་དཔའ་ཐམས་ཅད་ཀྱི་སློབ་པའི་གཞི་རྣམས་དང་། བྱང་ཆུབ་སེམས་དཔའ་ཐམས་ཅད་ཀྱི་ཚུལ་ཁྲིམས་དེ་དག་ཅི་བདག་ལས་ལེན་པར་འདོད་དམ་ཞེས་སློབ་མ་ལ་འདྲི་བར་བྱའོ་༎
 tasmin tathā “gṛhītukāmo 'smi” iti pratijñāte sati bodhisattvasaṃvaro dātavyaḥ |	དེས་དེ་ལྟར་ལེན་པར་འཚལ་ལོ་ཞེས་ཁས་ལེན་པར་གྱུར་ན་། བྱང་ཆུབ་སེམས་དཔའི་སྡོམ་པ་སྦྱིན་པར་བྱ་སྟེ་། བཙུན་པའམ་།
 tvamevaṃnāmā bhadanta āyuṣmān kulaputro vā mat bodhisattva ityeva saṃjñakāt “sarvāṇi	ཚེ་དང་ལྡན་པའམ་། རིགས་ཀྱི་བུ་མིང་འདི་ཞེས་བྱ་བ་ཁྱོད་བདག་བྱང་ཆུབ་སེམས་དཔའ་མིང་འདི་ཞེས་བྱ་བ་ལས་། འདས་པའི་བྱང་ཆུབ་སེམས་དཔའ་ཐམས་ཅད་ཀྱི་བསླབ་པའི་གཞིར་གྱུར་པ་གང་ཡིན་པ་དང་། ཚུལ་ཁྲིམས་སུ་གྱུར་པ་གང་ཡིན་པ་དང་། མ་བྱོན་པའི་བྱང་ཆུབ་སེམས་དཔའ་ཐམས་ཅད་ཀྱི་བསླབ་པའི་གཞིར་གྱུར་པ་གང་ཡིན་པ་དང་། ཚུལ་ཁྲིམས་སུ་གྱུར་པ་གང་ཡིན་པ་དང་། ད་ལྟར་ཕྱོགས་བཅུའི་འཇིག་རྟེན་ན་ད་ལྟར་བྱུང་བའི་བྱང་༄༢༤༧བ་ཆུབ་སེམས་དཔའ་ཐམས་ཅད་ཀྱི་བསླབ་པའི་གཞིར་གྱུར་པ་གང་ཡིན་པ་དང་། ཚུལ་ཁྲིམས་སུ་གྱུར་པ་གང་ཡིན་པའི་བསླབ་པའི་གཞི་གང་དག་དང་ཚུལ་ཁྲིམས་གང་དག་ལ་། འདས་པའི་བྱང་ཆུབ་སེམས་དཔའ་ཐམས་ཅད་ཀྱིས་བསླབ་པར་གྱུར་པ་དང་། མ་བྱོན་པའི་བྱང་ཆུབ་སེམས་དཔའ་ཐམས་ཅད་ཀྱིས་སློབ་པར་འགྱུར་བ་དང་། ཕྱོགས་བཅུ་བདག་ན་ད་ལྟར་བྱུང་བའི་བྱང་ཆུབ་སེམས་དཔའ་ཐམས་ཅད་ད་ལྟར་སློབ་པའི་བྱང་ཆུབ་སེམས་དཔའི་བསླབ་པའི་གཞི་ཐམས་ཅད་དང་བྱང་ཆུབ་སེམས་དཔའི་ཚུལ་ཁྲིམས་ཐམས་ཅད་དེ་།
 bodhisattvaśikṣāpadāni sarvañca bodhisattvaśīlaṃ saṃvaraśīlaṃ kuśaladharmasaṃgrāhakaśīlaṃ sattvārthakriyāśīlañca | yāni śikṣāpadāni yacchīlamatītānāṃ sarvabodhisattvānāmabhūt | yāni śikṣāpadāni yacchīlamanāgatānāṃ sarvabodhisattvānāṃ bhaviṣyati | yāni śikṣāpadāni yacchīlametarhi daśasu dikṣu pratyutpannānāṃ sarvabodhisattvānāṃ bhavati | yeṣu śikṣāpadeśu yacchīle 'tītāḥ sarvabodhisattvāḥ śikṣitavantaḥ | anāgatāḥ sarvabodhisattvāḥ śikṣiṣyante | pratyutpannāḥ sarvabodhisattvāḥ śikṣante |	སྡོམ་པའི་ཚུལ་ཁྲིམས་དང་དགེ་བ་ཆོས་སྡུད་པའི་ཚུལ་ཁྲིམས་དང་། སེམས་ཅན་གྱི་དོན་བྱ་བའི་ཚུལ་ཁྲིམས་ནོད་དམ་ཞེས་སྨྲོས་ཤིག་། 
 tena pratigṛhṇāmīti pratijñātavyam” |	དེས་ཀྱང་ནོད་ལགས་སོ་ཞེས་སྨྲོས་ཤིག་། 
 evam ācāryeṇa trivāraṃ “grahīṣyasi kiṃ” iti uktvā śiṣyeṇa “ām sugṛhīṣyāmi” iti trivāraṃ abhihite saṃvaraṃ samādadyāt |	དེ་ལྟར་སློབ་དཔོན་གྱིས་ལན་གསུམ་གྱི་བར་དུ་ལེན་ནམ་ཞེས་བརྗོད་ཅིང་སློབ་མས་རབ་ཏུ་ལེན་ལགས་སོ་ཞེས་ལན་གསུམ་བརྗོད་པས་སྡོམ་པ་བླངས་པར་འགྱུར་རོ་༎ དེ་ནས་དགེ་བའི་བཤེས་གཉེན་དེས་། སློབ་མ་ལ་བྱང་ཆུབ་སེམས་དཔའི་སྡོམ་པ་བྱིན་ནས་།
 tataḥ sa kalyāṇamitraḥ śiṣyāya bodhisattvasaṃvaraṃ sattvā daśadiksarvabuddhabodhisattvebhyaḥ pañcāṅganamaskārapūrva kṛtāñjaliḥ evaṃ trivāraṃ vadet- “pratīgṛhītamanena evaṃnāmnā	ཕྱོགས་བཅུའི་སང་རྒྱས་དང་བྱང་ཆུབ་སེམས་དཔའ་ཐམས་ཅད་ལ་ཡན་ལག་ལྔས་ཕྱག་འཚལ་བ་སྔོན་དུ་འགྲོ་བས་ཐལ་མོ་སྦྱར་ཏེ་། འདི་སྐད་ཅེས་ལན་གསུམ་བརྗོད་པར་བྱ་སྟེ་། བྱང་ཆུབ་སེམས་དཔའ་མིང་འདི་ཞེས་བྱ་བས་།
 bodhisattvena mama evaṃnāmno bodhisattvasyāntikād yāvat trirapi bodhisattvaśīlasaṃvarasamādānam |	བདག་བྱང་ཆུབ་སེམས་དཔའ་མིང་འདི་ཞེས་བྱ་བ་ལས་། བྱང་ཆུབ་སེམས་དཔའི་ཚུལ་ཁྲིམས་ཀྱི་སྡོམ་པ་ཡང་དག་པར་བླང་བར་བྱ་བ་ལན་གསུམ་གྱི་བར་དུ་མནོས་ལགས་ཏེ་། བྱང་ཆུབ་སེམས་དཔའ་མིང་འདི་ཞེས་བྱ་བ་འདིས་། བྱང་ཆུབ་སེམས་དཔའི་ཚུལ་ཁྲིམས་ཀྱི་སྡོམ་པ་ཡང་དག་པར་བླངས་པ་ལ་།
 so 'hamevaṃnāmātmānaṃ sākṣibhūtamasyaitannāmno bodhisattvasya paramāryāṇāṃ viparokṣāṇāmapi	བདག་མིང་འདི་ཞེས་བགྱི་བ་དཔང་དུ་གྱུར་པར་འཕགས་པའི་མཆོག་ལྐོག་ཏུ་གྱུར་ཀྱང་།
 sarvatra sarvasattvāviparokṣabuddhīnāṃ daśasu dikṣvanantāparyanteṣu lokadhātuṣvārocayāmyasmin bodhisattvaśīlasaṃvarasamādānam” | iti trivāraṃ daśadiksabuddhabodhisattvebhya uktvā,	ཕྱོགས་བཅུའི་འཇིག་རྟེན་གྱི་ཁམས་མཐས་གཏུགས་པའི་ཆོས་ཐམས་ཅད་ལྐོག་ཏུ་མ་གྱུར་པའི་ཐུགས་མངའ་བ་ཐམས་ཅད་ལ་མཁྱེན་པར་གསོལ་ལོ་ཞེས་ལན་གསུམ་གྱི་བར་དུ་ཕྱོགས་བཅུའི་སངས་རྒྱས་དང་བྱང་ཆུབ་སེམས་དཔའ་རྣམས་ལ་བརྗོད་དེ་།
 namaskṛtya ca guruśiṣyau uttiṣṭhetām |“	ཕྱག་བཙལ་ནས་བླ་མ་དང་སློབ་མ་ལྡང་བར་བྱའོ་༎
 tata utthāya kalyāṇamitraḥ bodhisattvasaṃvaragrāhakaṃ bodhisattvam evaṃ brūyāt- “evaṃnāma bodhisattva|	དེ་ནས་ལངས་ལ་དགེ་བའི་བཤེས་གཉེན་གྱིས་བྱང་ཆུབ་སེམས་དཔའི་སྡོམ་པ་མནོས་པའི་བྱང་ཆུབ་སེམས་དཔའ་དེ་ལ་འདི་སྐད་༄༢༤༨ཨ་༌་༎ ཅེས་བརྗོད་པར་བྱ་སྟེ་།
 tvaṃ śṛṇu- iyaṃ hi dharmatā |	བྱང་ཆུབ་སེམས་དཔའ་མིང་འདི་ཞེས་བྱ་བ་ཁྱོད་ཉོན་ཅིག་།འདི་ནི་ཆོས་ཉིད་ཡིན་ཏེ་།
 yadā bodhisattvena bodhisattvasaṃvarasamādānakarmavācanā parisampādyate tadā daśadiksarvabuddhakṣetreṣu buddhabodhisattveṣu etādṛṅnimittāni prādurbhavanti |	གང་གི་ཚེ་བྱང་ཆུབ་སེམས་དཔའ་བྱང་ཆུབ་སེམས་དཔའི་སྡོམ་པ་ཡང་དག་པར་ལེན་པའི་ལས་བརྗོད་པ་རྫོགས་པ་དེའི་ཚེ་ཕྱོགས་བཅུའི་སངས་རྒྱས་ཀྱི་ཞིང་ཐམས་ཅད་དུ་། སངས་རྒྱས་དང་བྱང་ཆུབ་སེམས་དཔའ་རྣམས་ལ་འདི་ལྟ་བུའི་ལྟས་འབྱུང་བར་འགྱུར་ཏེ་།
 te buddhabodhisattvā evaṃ kasmiṃścid buddhakṣetre evaṃnāmā bodhisattva evaṃnāmno bodhisattvād bodhisattvasaṃvarasamādānaṃ gṛhṇāti iti saṃjānanti”	སངས་རྒྱས་དང་བྱང་ཆུབ་སེམས་དཔའ་དེ་དག་གིས་འདི་ལྟར་སངས་རྒྱས་ཀྱི་ཞིང་ག་གེ་མོ་ཞིག་ན་། བྱང་ཆུབ་སེམས་དཔའ་མིང་འདི་ཞེས་བྱ་བས་བྱང་ཆུབ་སེམས་དཔའ་མིང་འདི་ཞེས་བྱ་བ་ལས་བྱང་ཆུབ་སེམས་དཔའི་སྡོམ་པ་ཡང་དག་པར་བླངས་པ་མནོས་སོ་ཞེས་ཡང་དག་པར་མཁྱེན་པར་ན་། འགྱུར་རོ་༎ 
 ataḥ te bhagavanto buddhā te ca bodhisattvā dharmasnehāt putrān bhrātṛkāniva sandadhate | tathā sandhānāt puṇyajñānasambhāravṛddhirbhaviṣyatīti vaktavyam |	དེ་ལ་སངས་རྒྱས་བཅོམ་ལྡན་འདས་དེ་དག་དང་བྱང་ཆུབ་སེམས་དཔའ་དེ་རྣམས་ཀྱིས་ཆོས་ཀྱི་བརྩེ་བས་བུ་དང་སྤུན་ཟླའི་དགོངས་པ་མཛད་ལ་དེ་ལྟར་དགོངས་པ་མཛད་པས་བསོད་ནམས་དང་ཡེ་ཤེས་ཀྱི་ཚོགས་འཕེལ་བར་འགྱུར་རོ་ཞེས་བྱ་བ་བརྗོད་པར་བྱའོ་༎
 atha tena kalyāṇamitreṇa sa bodhisattva evaṃ vaktvyaḥ |	དེ་ནས་དགེ་བའི་བཤེས་གཉེན་དེས་བྱང་ཆུབ་སེམས་དཔའ་དེ་ལ་འདི་སྐད་ཅེས་བརྗོད་པར་བྱའོ་༎
 evaṃnāmabodhisattva | tvaṃ śṛṇu |	བྱང་ཆུབ་སེམས་དཔའ་མིང་འདི་ཞེས་བྱ་བ་ཁྱོད་ཉོན་ཅིག་། བྱང་ཆུབ་སེམས་དཔའི་སྡོམ་པ་ཡང་དག་པར་བླངས་པ་འདི་དད་པ་མེད་པ་རྣམས་ཀྱི་མདུན་དུ་སྨྲ་བར་མི་བྱ་སྟེ་། གང་གི་ཕྱིར་།
 bodhisattvasaṃvarasamādānamidaṃ aśraddadhānānām agre na vācyam |	དད་པ་མེད་པ་རྣམས་ལ་བྱང་ཆུབ་སེམས་དཔའི་སྡོམ་པ་རབ་ཏུ་བསྟན་ན་།
 yato 'śraddhebhyo bodhisattvasaṃvarapradarśane aśraddadhānā sattvāste bodhisattvasaṃvaraṃ aśraddhayā parityajanti |	དད་པ་མེད་པའི་སེམས་ཅན་དེ་དག་བྱང་ཆུབ་སེམས་དཔའི་སྡོམ་པ་མ་དད་པས་སྤོང་བར་བྱེད་དེ་། 
 ato yāvad bodhisattvo bodhisattvasaṃvarasthitaḥ puṇyarāśiyukto bhavati tāvad aśraddhayā sa tenaiva apuṇyarāśinā ca yukto bhavati |	དེས་ན་ཇི་སྙེད་བྱང་ཆུབ་སེམས་དཔའ་བྱང་ཆུབ་སེམས་དཔའི་སྡོམ་པ་ལ་གནས་པ་ལ་བསོད་ནམས་ཀྱི་ཕུང་པོ་དང་ལྡན་པར་འགྱུར་བ་དེ་སྙེད་ཀྱི་བསོད་ནམས་མ་ཡིན་པའི་ཕུང་པོ་མ་དད་པ་དེ་དང་ལྡན་པར་འགྱུར་རོ་༎
 yato bodhisattvaḥ sattvān sarvaduḥkhebhyaḥ parirakṣati anyāṃśca pāpebhyo nivārayati | ataḥ sakuśalo bodhisattvo gopāyati |	གང་གི་ཕྱིར་བྱང་ཆུབ་སེམས་དཔས་སེམས་ཅན་སྡུག་བསྔལ་ཐམས་ཅད་ལས་ཡོངས་སུ་བསྲུང་བར་བྱ་བ་ཡིན་པས་གཞན་སྡིག་པ་ལས་བཟློག་པར་བྱ་སྟེ་། དེའི་ཕྱིར་མཆོག་ཏུ་དགེ་བའི་བྱང་ཆུབ་སེམས་དཔས་གསང་བར་བྱ་བ་ཡིན་ནོ་༎
 atha śikṣāpadapārājikasthānabhūtān saṃvaranāśahetūn darśayitvā duṣkṛtān kliṣṭākliṣṭān api darśayet |	དེ་ནས་བསླབ་པའི་གཞི་ཕམ་པའི་གནས་སུ་གྱུར་པ་སྡོམ་པ་འཇིག་པའི་རྒྱུ་བསྟན་ཅིང་། ཉེས་བྱས་ཀྱི་ལྟུང་བ་ཉོན་མོངས་པ་ཅན་དང་ཉོན་མོངས་པ་ཅན་མ་༄༢༤༨བ་ཡིན་པ་ཡང་བསྟན་པར་བྱའོ་༎ 
 kalyāṇamitraḥ samāsato 'bodhisattvasaṃvaraviṃśakam' tathā bodhisattvabhūmeḥ śīlaparivarttañca bhāṣeta |	དགེ་བའི་བཤེས་གཉེན་གྱིས་མདོར་བསྡུས་པ་བྱང་ཆུབ་སེམས་དཔའི་སྡོམ་པ་ཉི་ཤུ་པ་པར་བྱའོ་༎ དང་། 
 bodhicittotpāda-bodhisattvasaṃvaravidhirmahācāryadīpaṅkaraśrījñāna-kṛtaḥ samāptaḥ ||	བྱང་ཆུབ་སེམས་དཔའི་སའི་ཚུལ་ཁྲིམས་ཀྱི་ལེའུ་བཤད་པར་བྱའོ་༎ བྱང་ཆུབ་ཏུ་སེམས་བསྐྱེད་པ་དང་བྱང་ཆུབ་སེམས་དཔའི་སྡོམ་པའི་ཆོ་ག་། སློབ་དཔོན་ཆེན་པོ་དཔལ་མར་མེ་མཛད་ཡེ་ཤེས་ཀྱིས་མཛད་པ་རྫོགས་སོ་། 
 tenaiva bhāratīyopādhyāyena mahāsaṃśodhakalokacakṣuṣā bhikṣu-kuśalamatinā (dge vai blo gros) cānūditaḥ ||	༎ ། རྒྱ་གར་གྱི་མཁན་པོ་དེ་ཉིད་དང་། ཞུ་ཆེན་གྱི་ལོ་ཙའ་བ་དགེ་སློང་དགེ་བའི་བློ་གྲོས་ཀྱིས་བསྒྱུར་བ་ལགས་སོ་༎
