skt	tib
 maitreyanāthakṛtā bhavasaṅkrāntiṭīkā	༄༡༥༡བ་༅་༎ རྒྱ་གར་སྐད་དུ་། བྷ་བ་སམ་ཀརའནཏི་ཏའི་ཀ་། བོད་སྐད་དུ་། སྲིད་པ་འཕོ་བའི་ཏབི༹་ཀ་། 
 namaḥ sarvajñāya	ཐམས་ཅད་མཁྱེན་པ་ལ་ཕྱག་འཚལ་ལོ་༎
 bhāvābhāvānna janmāsti iti |	དངོས་པོ་མེད་པས་སྐྱེ་བ་མེད་༎ ཅེས་བྱ་བ་ལ་།
 bījādvīja utpadyamāne ghaṭādapi ghaṭotpattiryujyeta |	ས་བོན་ལས་ས་བོན་འབྱུང་བ་བཞིན་དེ་ལྟར་ཡིན་ན་ནི་བུམ་པ་ལས་ཀྱང་བུམ་པ་འབྱུང་བར་༄༡༥༢ཨ་༌་༎ རིགས་།
 ātmakriyāniṣedhāt [bījāt] bījotpattirna saṃbhavati |	རང་ཉིད་བྱ་བ་འགགས་པས་ས་བོན་འབྱུང་མི་སྲིད་༎
 pañcavidhabhūtapariṇāmadharmatā, pratītyasamutpādadharmatā |	འབྱུང་བ་རྣམ་པ་ལྔས་བསྒྱུར་བའི་ཆོས་ཉིད་ཡིན་པ་རྟེན་འབྲེལ་ཆོས་ཉིད་ཡིན་།
 evaṃ sati śubhāśubhamucchinnabhāraṃ kenacit dṛśyeta |	དེ་ལྟ་ཡིན་ན་དགེ་སྡིག་སུས་ཁུར་ཆད་ལྟར་འགྱུར་།
 tattu mūṣikādantodgīrṇaviṣameghagarjanaglāna [bīja]vannotpannam |	སྐྱེ་བ་དེ་ནི་མ་ཡིན་ནོ་༎ བྱི་བས་སོ་བཏབ་པའི་དུག་འབྲུག་གྲག་ཙ་ན་ན་བ་བཞིན་ནོ་༎
 pratītyasamutpādadharmatā |	རྟེན་འབྲེལ་ལས་སྐྱེས་པའི་ཆོས་ཉིད་དོ་༎
 tena na bhāvādutpattidharmatā ||	དེ་ནས་དངོས་པོ་ལས་སྐྱེས་པ་ཆོས་ཉིད་མ་ཡིན་།
 tasya bhāvasyacāsataḥ |	དངོས་པོ་མེད་པ་དེ་ལ་ནི་༎
 janmādānaṃ saṃbhavati iti |	སྐྱེ་བ་བླངས་པ་སྲིད་པ་ཡིན་༎
 evaṃ sati bhāvāsyāsata utpattau vandhyāsutaḥ gaganakusumaṃ śaśaśṛṅgañca saṃbhavet |	ཞེས་པ་དེ་ལྟར་ཡིན་ན་དངོས་པོ་མེད་པ་ལས་བྱུང་ན་ནི་། མོ་གཤམ་བུ་ནམ་མཁའི་མེ་ཏོག་དང་རི་བོང་གི་རབ༹་ཡང་སྲིད་།
 evamasaṃbhavāt utpattirna saṃbhavati |	དེ་ལྟར་མ་ཡིན་པ་འབྱུང་བས་ན་འབྱུང་མི་སྲིད་།
 nahyagnimadhye nikṣiptabījasya janma saṃbhavati |	མེའི་ནང་དུ་ས་བོན་བཏབ་ན་སྐྱེ་མི་སྲིད་།
 ucyate tu bhāvasya tasyāsato janmopādānaṃ bhavati [iti] |	དངོས་པོ་མེད་པ་དེ་ལ་ནི་༎ སྐྱེ་བ་བླངས་པ་སྲིད་པ་བསྟན་པ་ནི་།
 yathā prasannajalapūrṇasarasi śaivālaṃ padmañcotpadyate |	ཇི་ལྟར་ཆུ་དང་ས་པས་གང་བའི་མཚོ་ལ་ཟིམ་དང་པདམ་སྐྱེས་པ་བཞིན་ནོ་༎
 uttarāraṇyadharāraṇibhyāmagnirutpadyate |	གཙུབ་ཤིང་དང་ལྕགས་མག་ལས་མེ་འབྱུང་བ་བཞིན་ནོ་༎
 utpattau satyāmapi ko doṣaḥ syāt |	བྱུང་མོད་སྐྱོན་ཅི་ཡོད་།
 nityabhāvādutpannātmakamiṣyate |	རྟག་ཏུ་དངོས་པོ་ལས་བྱུང་བར་བདག་འདོད་།
 maivam | bhrānti |	དེ་ལྟར་མ་ཡིན་འཁྲུལ་བ་ཡིན་༎
 indriyairūpalabdhaṃ yattattattvena bhavedyadi |	དབང་པོ་རྣམས་ཀྱིས་གང་རེད་པ་༎ དེ་ནི་དེ་དག་ཉིད་འགྱུར་ན་༎
 bālāstattvavido jātāḥ na jñeyatattvakāraṇam ||	དེ་ཉིད་མཁྱེན་པ་བྱིས་པར་འགྱུར་༎ དེ་ཉིད་ཡེ་ཤེས་བྱ་རྒྱུ་མེད་༎
 [uktaṃ] laṅkāvatārasūtre |	ལང་ཀར་གཤེགས་པའི་མདོ་ལས་།
 astitvaṃ sarvabhāvānāṃ yathā bālairvikalpyate |	དངོས་པོ་ཐམས་ཅད་ཡོད་བསམ་པ་༎ དེ་ལྟར་བྱིས་པས་བརྟགས་པ་བཞིན་༎ གལ་ཏེ་དེ་ལྟར་མཐོང་གྱུར་ན་༎
 yadi te bhavedyathādṛṣṭāḥ sarvesyustattvadarśinaḥ ||	ཐམས་ཅད་དེ་ཉིད་མཁྱེན་པར་འགྱུར་༎
 anyatra uktam |	གཞན་སྟོན་པ་ནི་།
 na cakṣuḥ prekṣate rūpaṃ lokastu parimohataḥ |	མིག་གིས་གཟུགས་མི་མཐོང་བ་བཞིན་༎ འཇིག་རྟེན་པས་ནི་གཏི་མུག་གིས་༎
 pravartate hyakṣamārge svabhāvastasya tādṛśaḥ ||	དབང་པོའི་ལམ་ལས་བྱུང་གྱུར་པ་༎ དེ་ཡི་དཔེ་ནི་འདི་ལྟར་ཡིན་༎
 yathā māyāmarīcisvapnapratiśrutkendradhanurudakacandrabimbanirmitamāyānagaravikalpaḥ |	སྒྱུ་མ་ལྟར་། སྨིག་རྒྱུ་། རྨི་ལམ་། བྲག་ཅ་། འཇའ་ཚོན་། ཆུ་ཟླའི་གཟུགས་པའི་སྒྱུ་མའི་གྲོང་ཁྱེར་རྣམ་རྟོག་བཞིན་ནོ་༎
 śūrapādairapyuktam |	དཔའ་བོའི་ཞབས་ཀྱིས་ཀྱང་གསུངས་སོ་༎ ཡོད་དང་མེད་པ་སྐྱེ་དང་འཆི་༎
 sadasacca mṛtaṃ jātaṃ tannirūddha yadasti na |	དེ་ནི་འགག་པ་གང་མེད་པ་༎
 bhāvotpādakameveti lakṣaṇaṃ bhāvadarśinām ||	དངོས་པོ་སྟོང་པ་ཉིད་ཡིན་ནོ་༎ མཚན་མ་དངོས་པོ་མཐོང་བ་རྣམས་༎
 bhāvadṛṣṭyā khalu bhrāntaṃ yathā khapuṣpacintanam |	དངོས་པོ་མཐོང་བས་འཁྲུལ་པ་ཡིན་༎ ཇི་ལྟར་། ནམ་མཁའི་མེ་ཏོག་བསམ་པ་འདྲ་༎
 dharmatā hi nabhastulyā | iti |	མཁའ་དང་མཉམ་པའི་ཆོས་ཉིད་ལ་༎
 ākāśasamabhāvasya śūnyatvena utpattibhaṅgadoṣamalālepāt dharmatāmātraṃ rūpavedanādayaḥ | te gaganasamāḥ |	ཞེས་པ་ནི་ནམ་༄༡༥༢བ་མཁའ་དང་མཉམ་པ་དངོས་པོ་སྟོང་ཉིད་ཡིན་པས་ན་། སྐྱེ་བ་དང་འཇིག་པའི་སྐྱོན་གྱི་དྲི་མ་སམ་གོས་པས་ན་། ཆོས་ཉིད་ཙམ་ལ་གཟུགས་དང་ཚོར་བ་ལ་སོགས་པ་དེ་རྣམས་ནམ་མཁའ་དང་མཉམ་པའོ་༎
 jananāntare pratītyasamāgamenotpadyante |	གཞན་སྐྱེ་བ་ན་རྟེན་འབྲེལ་འཛོམ་པས་སྐྱེའོ་༎
 tacca sāṃvṛt loke |	དེ་ཡང་ཀུན་རྫོབ་འཇིག་རྟེན་པ་ལ་ཡིན་།
 paramārthasya na virodhi |	དོན་དམ་པ་ལ་མི་མཐུན་མེད་༎
 acintyā māyādharmalakṣaṇatā |	བསམ་གྱིས་མི་ཁྱབ་སྒྱུ་མ་ཆོས་ཀྱི་མཚན་ཉིད་ཡིན་།
 śālistambasūtre |	སའ་ལུ་ལྗང་པའི་མདོ་ལས་།
 [bāhyaḥ] pratītyasamutpādaḥ katamaiḥ pañcabhiḥ kāraṇairdraṣṭavyaḥ | [na] svayaṃ śāśvatato nocchedato na saṃkrāntito na svayaṃbhūhetutaḥ na phalavipākābhinirvṛttitastadvisadṛśānuprabandhata [śceti] |	རྟེན་འབྲེལ་གྱིས་ནི་སྐྱེས་པ་གང་༎ རྒྱུ་ལྔ་རྣམས་ཀྱིས་མཐོང་གྱུར་པ་༎ ཁོ་རང་ངེས་པ་མ་ཡིན་། ཆད་པ་པོ་ཡང་མ་ཡིན་།
 kathaṃ [na] svayaṃ śāśvatataḥ |	འཕོ་བ་པོ་ཡང་མ་ཡིན་། རྒྱུ་རང་འབྱུང་བ་ཡང་མ་ཡིན་། འབྲས་བུ་སྨིན་ནས་བྱུང་བ་ཡང་མ་ཡིན་། དེ་རྣམས་ནི་མཐུན་པར་མི་འབྲེལ་། ཁོ་རང་ངེས་པས་ཡིན་པ་གང་ཞེ་ན་།
 yasmādvījāṅkurau visadṛśau |	ཇི་ལྟར་ས་བོན་དང་མྱུ་གུ་མི་མཐུན་པ་བཞིན་ནོ་༎
 na caivaṃ yadvījaṃ sa evāṅkura [iti] |	མ་ཡིན་ཏེ་དེ་ལྟར་ཡིན་ན་ས་བོན་གང་ཡིན་པ་དེ་ཉིད་མྱུ་གུ་།
 evaṃ hi bījaṃ niruddhyate |	དེ་ལྟར་ཡིན་ན་ས་བོན་འགག་། 
 aṅkura utpadyate |	མྱུ་གུ་སྐྱེས་པ་ན་།
 kathaṃ nocchedataḥ |	ཚད་པ་ཡང་མ་ཡིན་པ་གང་ཞེ་ན་།
 na pūrvaniruddhāddhījādaṅkuro niṣpadyate |	སྔ་མ་ས་བོན་བཀག་པས་མྱུ་གུ་སྐྱེ་བ་མ་ཡིན་།
 niruddhamatrādvījāttu tatsamaye aṅkura utpadyate |	ས་བོན་བཀག་པ་ཙམ་ལས་དེའི་དུས་སུ་མྱུ་གུ་སྐྱེ་བས་ན་།
 tulādaṇḍanāmonnāmavat |	སྲང་ལ་འཇལ་བའི་མཐོ་དམན་བཞིན་ནོ་༎
 kathaṃ na saṅkrāntitaḥ |	འཕོ་བ་པོ་མ་ཡིན་པ་གང་ཞེ་ན་།
 bījavisadṛśo hyaṅkuraḥ |	ས་བོན་ལྟར་མ་ཡིན་མྱུ་གུའོ་༎
 kathaṃ na svayaṃbhūhetutaḥ |	རྒྱུ་རང་བྱུང་བ་མ་ཡིན་པ་གང་ཞེ་ན་།
 ādyaphalasyāsvayaṃbhāvāt |	དང་པོ་འབྲས་བུ་རང་མ་བྱུང་བས་སོ་༎
 kathaṃ na phalavipākābhinirvṛttitaḥ |	འབྲས་བུ་སྨིན་ནས་བྱུང་བ་མ་ཡིན་པ་གང་ཡིན་ན་།
 phalasvarūpaṃ siddhyati |	འབྲས་བུའི་ངོ་བོར་གྲུབ་པ་སྟེ་།
 na hi phalena phalotpattirasti |	འབྲས་བུས་འབྲས་བུ་བསྐྱེད་པ་ནི་མ་ཡིན་ནོ་༎
 kathaṃ visadṛśānuprabandhataḥ |	མི་མཐུན་པར་འབྲེལ་པ་གང་ཞེ་ན་།
 evaṃ pratītya samutpannaistairutpāditaṃ phalam ||	དེ་ལྟར་དུ་རྟེན་འབྲེལ་གྱིས་འབྱུང་བ་སྟེ་དེ་རྣམས་ཀྱིས་བསྐྱེད་པའི་འབྲས་བུའོ་༎
 skandhotpādarītirapiu |	ཕུང་པོ་བསྐྱེད་ལུགས་ཀྱང་།
 avidyayā saṃskāro vijñānaṃ nāmarūpaṃ ṣaḍāyatanaṃ pañcaskandhāśca siddhyanti |	མ་རིག་པས་འདུ་བྱེད་༎ རྣམ་པར་ཤེས་པས་མིང་དང་གཟུགས་༎ སྐྱེ་མཆེད་དྲུག་དང་ལྔ་ཡིས་ཕུང་པོ་གྲུབ་པོ་༎
 śūnyaireva yotpattistadrūpāṇāṃ svarūpakam |	སྟོང་ཉིད་རྣམས་ཀྱི་བྱུང་བ་གང་༎ དེ་གཟུགས་རྣམས་ཀྱི་ངོ་བོ་ནི་༎
 pratītyapratyayotpannamevaṃ siddhyā prasiddhyati ||	རྟེན་འབྲེལ་རྐྱེན་གྱིས་བྱུང་བ་ཡིན་༎ དེ་ལྟར་གྲུབ་པས་རབ་ཏུ་གྲགས་༎
 evaṃ sā śūnyatā svayaṃbhūtvā rūpaṃ samīkṣyate |	དེ་ལྟར་སྟོང་ཉིད་དེ་རང་ནི་༎ སྐྱེས་ནས་གཟུགས་ནི་མཐོང་འགྱུར་བ་༎
 sarvabhāvaḥ śūnyatā hi śūnyataivaṃ pravartate ||	དངོས་པོ་ཐམས་ཅད་སྟོང་ཉིད་ཡིན་༎ དེ་ལྟར་སྟོང་ཉིད་རབ་ཏུ་སྐྱེས་༎
 evaṃ bāhya ādhyātmikaḥ sarvo dharmaḥ śūnyaḥ |	དེ་ལྟར་དུ་ཕྱི་ནང་གི་ཆོས་༄༡༥༣ཨ་༌་༎ ཐམས་ཅད་སྟོང་པའོ་༎
 svabhāvato bhāvo yena hetusaṃbhūtaḥ ataḥ sarvadharma ākāśasamaḥ |	རང་བཞིན་དངོས་པོ་ནི་གང་གི་རྒྱུས་བྱུང་བས་། ཆོས་ཐམས་ཅད་ནམ་མཁའ་དང་མཉམ་།
 evaṃ bhāvo 'bhāvaḥ saṃbhavati ||	དེ་ལྟར་དངོས་པོ་མེད་པ་སྲིད་པ་ཡིན་ནོ་༎ རྒྱུ་མེད་འབྲས་བུ་མེད་པ་དང་༎ ཞེས་པ་ནས་།
 na kāraṇaṃ nāpi kāryam ityādinā eṣa lokaḥ paro 'pi ca iti paryantam |	འཇིག་རྟེན་འདི་དང་ཕ་རོལ་དང་༎ ཞེས་པའི་བར་ལ་།
 kāraṇena īśvareṇa kṛta iṣyate | karmasaṃbhūtaḥ cittamātraṃ vā iṣyate |	རྒྱུ་དབང་ཕྱུག་གིས་བྱས་པར་འདོད་པ་དང་། ལས་ཀྱི་འབྱུང་བ་སེམས་ཙམ་པ་འདོད་པའམ་།
 evaṃ neṣyate cet kaḥ śubhāśubhaṃ vahati |	དེ་ལྟར་མི་འདོད་ན་དགེ་སྡིག་སུས་ཁུར་།
 tīrthikocchedaprasaṅgaḥ |	མུ་སྟེགས་ཆད་པ་པོ་རུ་ཐལ་༎
 tasyottara [mucyate] |	དེའི་ལན་ནི་།
 vastutaḥ satyaṃ na bhavati [lokaḥ] |	དངོས་པོ་ལ་ནི་བདེན་པ་མེད་༎
 karmasaṃbhūto 'pi svapnasadṛśaḥ |	ལས་ཀྱིས་འབྱུང་ཡང་རྨི་ལམ་བཞིན་༎
 bhāva evamabhāvatvādajo 'san tasya vai ciram |	དངོས་པོ་འདི་ལྟར་མེད་པས་ན་༎ མ་སྐྱེས་མེད་པ་དེ་ལ་ནི་༎ ཡུན་རིང་རྟེན་འབྲེལ་འདོད་ཙམ་ན་༎
 pratītyodgamakāle tu karmaṇaḥ phalavedanā ||	དེ་དུས་ལས་ཀྱི་འབྲས་བུ་མྱོང་༎
 āryasamādhirājasūtre |	འཕགས་པ་ཏིང་ངེ་འཛིན་གྱི་རྒྱལ་པོའི་མདོ་ལས་།
 na ca asmi loki mṛti kaści [naro] paraloka saṃkramati gacchati vā | na ca karma naśyati kadāci kṛtaṃ phalu deti [kṛṣṇaśubha] saṃsarato ||	འཇིག་རྟེན་འདི་ལ་འཆི་བ་གང་ཡང་མེད་༎ འཇིག་རྟེན་ཕ་རོལ་དུ་འགྲོ་བ་གང་ཡང་མེད་། ལས་ཀྱིས་མེད་པ་མི་སྲིད་དོ་༎ བྱས་པའི་འབྲས་བུ་སྟེར་བར་བྱེད་༎ ཐོག་མ་མེད་པ་འཁོར་བ་ལ་༎
 laṅkāvatārasūtre |	ལང་ཀར་གཤེགས་པའི་མདོ་ལས་།
 deśemi śūnyatāṃ nityaṃ śāśvatocchedavarjitām |	གང་གིས་རྟག་ཏུ་སྟོང་ཉིད་བཤད་༎ ཡོད་དང་ཆད་པ་སྤངས་པ་ཉིད་༎
 saṃsāraṃ svapnamāyākhyaṃ na ca karma vinaśyati ||	འཁོར་བའི་རྨི་ལམ་སྒྱུ་མ་མིང་༎ ལས་མེད་པར་ནི་མི་འགྲོའོ་༎
 āryākāśasamatāsamādhisūtre |	འཕགས་པ་ནམ་མཁའ་དང་མཉམ་པ་ཏིང་ངེ་འཛིན་གྱི་མདོ་ལས་།
 pūrvaṃ kṛtaṃ tanna kṛtaṃ na kṛtaṃ tacchubhāśubham |	སྔར་བྱས་དེ་ནི་མི་འཛད་དོ་༎ མི་འཛད་པ་དེ་དགེ་མི་དགེ་། བདེ་བར་གཤེགས་ཀྱིས་སྔར་བགྱིས་པ་༎
 sugatasya pūrvākaraṇāt kṛtaṃ tadapi no bhavet ||	དེ་ཡང་འཛད་པར་མི་འགྱུར་རོ་༎
 bodhisattvabodhicittaṃ kṛtaṃ tadapi no bhavet |	བྱང་ཆུབ་སེམས་དཔའི་བྱང་ཆུབ་སེམས་༎ དེ་ཡང་འཛད་པར་མི་འགྱུར་རོ་༎ བརྟན་པ་ཐོབ་པར་བྱས་པ་ཡང་༎
 kṛto nirūḍhilābho 'pi kṛtaḥ so 'pi ca no bhavet ||	དེ་ཡང་འཛད་པར་མི་འགྱུར་རོ་༎
 karmāṇi na praṇaśyanti kalpakoṭyantato 'pi ca |	ལས་ཀྱང་མེད་པར་མི་འགྱུར་རོ་༎ བསྐལ་པ་བྱེ་བའི་བར་དུ་ཡང་༎ རྟེན་འབྲེལ་འཛོམ་པའི་དུས་ལས་ནི་༎
 pratītyāgamakāle tu dehināṃ phalavedanā ||	ལུས་ཅན་རྣམས་ཀྱིས་འབྲས་བུ་མྱོང་༎
 anutpannarūpameva | iti |	སྐྱེ་བ་མེད་པའི་ངོ་བོ་ཉིད་༏་། ཅེས་པ་ལ་།
 yadīśvareṇa kathamapi na nirmitam |	དབང་ཕྱུག་གིས་ཇི་ལྟར་གལ་ཏེ་མ་སྤྲུལ་ན་།
 kathaṃ hi loka utpannaḥ |	འཇིག་རྟེན་པ་ཇི་ལྟར་བྱུང་།
 vandhyāstrītanayasyāpi kastatra janma janayati |	མོ་གཤམ་མོ་ཡི་བུ་ལ་ཡང་༎ དེ་ལ་བུ་སྐྱེས་སྐྱེ་བར་མཛད་༎ འཇིག་རྟེན་པ་འདི་སྔར་མ་སྐྱེས་༎
 lokaḥ prathamato 'jātaḥ ityādi | ādau svayamanutpannaḥ pratītyasamutpanno bhāvaḥ |	ཤེས་པ་ལ་སོགས་པ་ལ་དང་པོར་རང་མ་སྐྱེས་པ་རྟེན་འབྲེལ་ལས་འབྱུང་༄༡༥༣བ་བའི་དངོས་པོ་ཡིན་། 
 tasya ca janma īśvarādinā kenāpi nāvatāritam |	དེ་ལ་དབང་ཕྱུག་ལ་སོགས་པ་སུས་ཀྱང་སྐྱེར་འཇུག་པ་མེད་།
 cetanasyādāvajātatvena īśvaraḥ svayamasiddhaḥ |	སེམས་ཅན་པ་དང་པོ་རང་སྐྱེས་པ་མེད་པས་། དབང་ཕྱུག་ཁོ་རང་མ་གྲུབ་པ་ལ་།
 pratītyasamutpannasya ca janma neśvareṇāvatāritam |	རྟེན་འབྲེལ་ལས་འབྱུང་བའི་དབང་ཕྱུག་གིས་སྐྱེ་རུ་བཅུག་པ་མེད་།
 laṅkāvatārasūtre |	ལང་ཀར་གཤེགས་པའི་མདོ་ལས་༏་སྐྱེ་དང་འཆི་བ་དེ་གཉིས་ནི་༎
 saṃbhavaṃ vibhavañcaiva mohātpaśyanti bāliśāḥ | na saṃbhavaṃ na vibhavaṃ prajñāyukto vipaśyati ||	བྱིས་པ་རྨོངས་པ་མཐོང་བ་ཡིས་༎ སྐྱེ་མེད་འཆི་མེད་དེ་གཉིས་ནི་༎ ཤེས་རབ་ཅན་གྱིས་དེ་ལྟར་མཐོང་༎
 āryasamādhirājasūtre |	འཕགས་པ་ཏིང་ངེ་འཛིན་གྱི་རྒྱལ་པོའི་མདོ་ལས་། ཡོད་པ་མེད་པ་དེ་ལ་ནི་༎ གཉིས་ཀ་མཐའ་ནི་མེད་པ་ཡིན་༎ དག་དང་མ་དག་དེ་ལ་ནི་༎
 astīti nāstīti ubhe 'pi antā śuddhī aśuddhīti ime 'pi antā |	དེ་གཉིས་ལ་ཡང་མཐའ་མེད་དོ་༎
 tasmādubhe anta vivarjayitvā madhye 'pi sthānaṃ na karoti paṇḍitaḥ ||	དེ་གཉིས་སྤངས་པ་དེ་ལ་ནི་༎ དབུས་སུ་གནས་པ་གང་ཡང་མེད་༎ དེ་ལྟར་མཁས་པས་རྟོགས་པར་བྱ་༎
 madhyānte [?]	དབུ་མ་དར་བ་ནས་།
 yena tarkaḥ kalpamātraṃ talliṅgaṃ niṣphalaṃ sthitam |	རྟོག་པ་གང་གིས་རྟོག་ཙམ་ན་༎ དེ་རྟོག་འབྲས་བུ་མེད་པར་འདུག་།
 evaṃ tu viduṣā proktaṃ vikalpādvadhyate 'dhamaḥ ||	དེ་ལྟར་ན་ནི་མཁྱེན་པས་གསུངས་༎ རྣམ་རྟོག་གིས་ནི་ཐ་མལ་བཅིངས་༎ བརྟགས་པ་བྱས་ནས་གྲོལ་བར་བྱེད་༎
 parikṣamaṇo mucyeta jagattatkaraṇena ca |	དེ་བྱེད་པས་ནི་གྲོལ་བ་ཡིན་༎
 yogī saṃprekṣate śūnyaṃ yathā tamisradarśanaḥ ||	རྣལ་འབྱོར་བས་ནི་སྟོང་པར་མཐོང་༎ ཇི་ལྟར་རབ་རིབ་མཐོང་གྱུར་པ་༎ སྨན་གྱི་སྦྱོར་བས་མཐོང་བ་ལྟར་༎
 bhaiṣajyayogādīkṣeta vyutsṛjettimiraṃ ca tat |	རབ་རིབ་དེ་ཡང་གསལ་བར་འགྱུར་༎
 avidyātimirākrāntanetrāḥ saṃbhavaṃ vibhavaṃ dṛḍham ||	མ་རིག་པ་ཡི་རབ་རིབ་ཀྱིས་༎ བསྒྲིབས་པའི་མིག་གིས་སྐྱེ་བ་དང་༎ འཆི་བ་བསྟན་པར་གཟུང་ནས་ཏེ་༎
 gṛhṇanto vāsanāvaśāt muktyanarhāḥ samīritāḥ ||	བག་ཆགས་དབང་གིས་གྲོལ་མ་ནུས་པ་རྣམས་ལ་གསུངས་།
 anarthabhrāntaloko hi ityādyuktam |	དོན་མེད་འཁྱམས་པ་འཇིག་རྟེན་པ་ལ་སོགས་པའི་གསུངས་སོ་༎
 kārakavedayitrādi na kiñcidasti |	བྱེད་པ་པོ་དང་། ཚོར་བ་པོ་ལ་སོགས་པ་གང་ཡང་མེད་པ་ལ་།
 mokṣārthākārake paramārthabhrāntaḥ |	གྲོལ་བའི་དོན་མི་བྱེད་པར་དོན་དམ་པར་འཁྱམས་པའོ་༎
 athavā anarthaṃ bhraman bhavasindhurmāyānagarasadṛśaḥ |	ཡང་ན་དོན་མེད་དུ་འཁྱམས་པ་སྲིད་པའི་རྒྱ་མཚོ་ལས་སྒྱུ་མའི་གྲོང་ཁྱེར་ལྟར་།
 uktamāryadevapādaiḥ |	འཕགས་པ་ལྷའི་ཞབས་ཀྱིས་གསུངས་པ་ནི་༎
 bhāvo 'bhāvo na dvitayaṃ sadasanmiśrito na saḥ |	ཡོད་དམ་མེད་པ་གཉི་ག་མེད་། ཡོད་མེད་གཉིས་བསྲེ་ས་དེ་ཡང་མེད་༎
 nāpi tattadabhāvādi vicāre 'pi ciraṃ kṛte |	དེ་མིན་ལོགས་ན་དེ་ཡང་མེད་༎ བརྟག་པ་ཡུན་རིང་བྱས་ཀྱང་ནི་༎
 tatpadamatidurbhāṣam |	དེ་ལྟ་ཚིག་བརྗོད་ཤིན་ཏུ་དཀའ་༎
 sadasadutpannavinaṣṭayat kiñcidbhāvavarjanadharmanairātmyadeśanā parivartaḥ prathamaḥ ||	དངོས་པོ་ཡོད་པ་དང་། མེད་པ་དང་། སྐྱེ་བ་དང་། འཆི་བ་གང་ཡང་སྤངས་པའི་ཆོས་བདག་མེད་པར་བསྟན་པའི་༄༡༥༤ཨ་༌་༎ ལེའུ་སྟེ་དང་པོའོ་།
 adhunā skandhanairātmyaṃ pratipādayan saṃvṛtisatyamāśrityāha lokotpattirītim |	༎ ། ད་ནི་ཕུང་པོ་བདག་མེད་དུ་སྟོན་པ་ནི་ཀུན་རྫོབ་ལ་བརྟེན་ནས་གསུངས་ཏེ་། འཇིག་རྟེན་པ་ཡི་སྐྱེ་ལུགས་ནི་༎
 vikalpāllokasaṃbhavaḥ iti |	རྣམ་རྟོག་ལས་ནི་འཇིག་རྟེན་འབྱུང་༎ ཞེས་པ་ནི་།
 śubhāśubhakalpanā vikalpaḥ |	རྣམ་རྟོག་ནི་དགེ་བ་དང་མི་དགེ་བའི་རྟོག་པའོ་༎
 tatpratītyasamutpanno lokaḥ |	དེ་ལ་རྟེན་འབྲེལ་གྱིས་བྱུང་བ་འཇིག་རྟེན་པའོ་༎
 śubhāśubhābhyāṃ ṣaṭsu jagadgatiṣu skandhanupādāya loko nāma, vikalpena janitaḥ |	དགེ་བ་དང་མི་དགེ་བས་འགྲོ་བ་རིགས་དྲུག་ཏུ་ཕུང་པོ་བླངས་ཏེ་འཇིག་རྟེན་པའི་མིང་ངོ་༎ རྣམ་རྟོག་གིས་བསྐྱེད་པའོ་༎
 salilaphalādivikalpaśca pratītya gṛhyate |	ཆུ་འམ་འབྲས་བུ་ལ་སོགས་པ་རྣམ་རྟོག་དང་རྟེན་འབྲེལ་གྱིས་བླངས་པ་ཡིན་།
 janmopādānena cittaṃ pravartane |	སྐྱེ་བ་བླངས་པས་སེམས་བྱུང་།
 citte ātmagrahaḥ pravartate |	སེམས་ལས་བདག་འཛིན་བྱུང་།
 tato 'nyadapi pravartate |	དེ་ལས་གཞན་ཡང་འབྱུང་ངོ་༎
 tacca ratnāvalyāmuktam	དེ་ཡང་རིན་པོ་ཆེ་ཕྲེང་བ་ནས་གསུངས་པ་།
 skandhagrāho yāvadasti tāvadevāhamityapi |	ཕུང་པོ་འཇིག་པའི་བར་དུ་ནི་༎ དེ་ལ་བདག་འཛིན་འབྱུང་བར་འགྱུར་༎ བདག་འཛིན་བྱས་པའི་དུས་སུ་ཡང་༎
 ahaṅkāre sati punaḥ karma janma tataḥ punaḥ ||	དེ་ལ་ལས་བྱས་སྐྱེ་བ་ལེན་༎
 trivartmaitadanādyantamadhyaṃ saṃsāramaṇḍalam |	དུས་གསུམ་དུ་ནི་མཐའ་མེད་པར་༎ དབུས་སུ་འཁོར་བའི་འཁོར་ལོ་ནི་༎
 alātamaṇḍalaprakhyaṃ bhramatyanyonyahetukam ||	མགལ་མེའི་འཁོར་ལོ་ལྟར་དུ་འཁོར་༎ རྟེན་འབྲེལ་འཛོམ་པས་འཁོར་བའོ་༎
 cittātkāyo 'pi jāyate | iti |	སེམས་ལས་ལུས་ཀྱང་བྱུང་བ་ལ་༎ ཞེས་པ་ནི་། བདག་ཡོད་པ་ནི་གཞན་འབྱུང་ངོ་༎
 ātmani sati parasaṃjñā svaparavibhāgātparigrahadveṣau |	རང་གཞན་ཆ་ཡིས་ཞེ་སྡང་འབྱུང་༎
 anayoḥ saṃpratibaddhāḥ sarve doṣāḥ prajāyante |	དེ་གཉིས་ཀྱིས་ནི་རབ་བཅིངས་པ་༎ སྐྱོན་རྣམས་ཐམས་ཅད་རབ་ཏུ་སྐྱེས་༎ ལུས་ལ་བརྟག་པར་བགྱིས་ཙམ་ན་༎
 kāye kṛtaparīkṣamātre cittamātramataṃ parīkṣitapūrvavat vidyat |	སེམས་ཙམ་པ་ཡི་འདོད་ལུགས་ལ་༎ སྔར་བརྟགས་པ་བྱས་པ་བཞིན་ཤེས་པར་བྱའོ༎
 bāhyaḥ skandhaḥ parīkṣyate |	ཕྱིའི་ཕུང་པོ་བརྟག་པ་ནི་།
 rūpavedanāsaṃjñāśca iti |	གཟུགས་དང་ཚོར་བ་མིང་དང་ནི་༎ ཞེས་པ་སྟེ་།
 rūpaṃ bhautikaṃ |	གཟུགས་ནི་འབྱུང་བས་འབྱུང་བའོ་༎
 rūpaṃ varṇādyātmakaṃ sadasadubhayānubhayaṃ hetujanitaṃ prajñaptimātram |	གཟུགས་དང་ཁ་རོག་ལ་སོགས་པ་བདག་ཉིད་ཡོད་པ་དང་མེད་པ་དང་། གཉི་ག་དང་། གཉི་ག་མ་ཡིན་པའི་རྒྱུས་སྐྱེས་པ་བརྟགས་པ་ཙམ་ན་།
 asatyatayā tarkākṣamatvāt phenasadṛśaṃ śūnyatā |	མི་བདེན་པས་བརྟགས་མི་ནུས་པས་ལྦུ་བ་དང་འདྲ་སྟེ་སྟོང་ཉིད་དོ་༎
 vedanā sukhaduḥkhātmikā |	ཚོར་བ་ནི་བདེ་སྡུག་གི་བདག་ཉིད་ཅན་དེ་ཡང་།
 sā ca pratītyasamutpannā asatkāraṇā budbudopamā |	རྟེན་འབྲེལ་གྱི་སྐྱེས་པ་མེད་པའི་རྒྱུ་ཆུ་བུར་དང་འདྲའོ་༎
 saṃjñā hi na sadvastu |	འདུ་ཤེས་ནི་དངོས་པོ་ཡོད་པ་མ་ཡིན་ཏེ་།
 sā hi nāmamātram |	དེ་ནི་མིང་ཙམ་ཡིན་ནམ་།
 marīcikāsadṛśī asatī |	སྨིག་རྒྱུ་དང་འདྲ་བར་མེད་པའོ་༎
 saṃskāro 'pi asadvastu,	༄༡༥༤བ་འདུ་བྱེད་ནི་དངོས་པོ་མེད་པ་སྟེ་།
 bhojanapānatṛṣṇāsukhajanitaḥ |	བཟའ་བ་དང་། བཏུང་བ་དང་། སྐོམ་པ་བདེ་བ་སྐྱེད་པ་།
 tacca pṛthivyādibhūtapratyayena |	དེ་ཡང་བ་ལ་སོགས་པའི་འབྱུང་བའི་རྐྱེན་གྱིས་སོ་༎
 sa ca nirvikalpo bhāvaḥ kadalīsamaḥ |	དེ་ཡང་རྣམ་རྟོག་མེད་པའི་དངོས་པོ་ཆུ་ཤིང་ལྟ་བུའོ་༎
 tadvijñānaṃ cittamasvatantrotpannalakṣaṇam |	སེམས་ཏེ་རྣམ་པར་ཤེས་པ་ནི་རང་དབང་མེད་པར་འབྱུང་བའི་མཚན་ཉིད་དོ་༎
 cittaṃ vikalpamātraṃ māyopamaṃ,	སེམས་ནི་རྣམ་པར་རྟོག་པ་ཙམ་སྟེ་སྒྱུ་མ་ལྟ་བུའོ་༎
 paramārthato nāsti |	དོན་དམ་པ་ལ་མེད་པའོ་༎
 [prajñā] pāramitāyāmapyuktam |	ཕ་རོལ་ཏུ་ཕྱིན་པ་ལས་ཀྱང་གསུངས་པ་།
 cittaṃ sadasadanyasvabhāvarahitaṃ śūnyam |	སེམས་ཡོད་པ་དང་། མེད་པ་དང་། གཞན་ཡང་རང་བཞིན་མེད་པར་སྟོང་བའོ་༎
 citena citte dṛṣṭamātre na kiñciddṛśyate, śūnyam ||	སེམས་ཀྱིས་སེམས་ལ་བལྟས་ཙམ་ན་། གང་ཡང་མ་མཐོང་བར་སྟོང་པའོ་༎
 evaṃ sati tathāgataḥ jaḍaḥ syāt |	དེ་ལྟར་ཡིན་ན་བདེ་གཤེགས་བེམ་པོར་འགྱུར་རོ་ཞེ་ན་།
 maivam |	དེ་ལྟ་མ་ཡིན་ཏེ་།
 citavijñānavikalpanivṛttikālamātre dharmakāyo labhyate |	ནམ་སེམས་དང་རྣམ་པར་ཤེས་པ་དང་། རྣམ་རྟོག་ལོག་པའི་དུས་ཙམ་ན་ཆོས་སྐུ་ཐོབ་པའོ་༎
 buddhapadalābha eva jñānakāyaḥ |	སངས་རྒྱས་ཀྱི་གནས་ཐོབ་སྟེ་། ཡེ་ཤེས་ཀྱི་སྐུའོ༎
 sa ca nāsti sa īdṛśo bhāva iti |	དེ་ཡང་༏་འདི་ལྟར་དངོས་པོ་དེ་ཡང་མེད་༎
 na ca evaṃ sa jñeya iti |	ཤེས་བྱ་དེ་ཡང་འདི་ལྟར་མེད་༎
 na ca sthātā |	གནས་པ་པོ་ཡང་མེད་༎
 nāpi sthitiḥ |	གནས་པ་ཡང་མེད་པའོ་༎
 śavabhūtānaṃ pramāṇakṛtāṃ bālānāṃ vikalpaḥ |	རོ་དང་འདྲ་བའི་ཚད་མ་མཁན་བྱིས་པ་རྣམས་ཀྱི་རྣམ་རྟོག་ཡིན་ནོ་༎
 tathāgato hyatītānāgatapratyutpannajñaḥ abhijñācakṣuṣā sarvaṃ paśyati ||	བདེ་གཤེགས་ནི་འདས་པ་དང་། མ་འོངས་པ་དང་། དེ་ལྟར་བ་མཁྱེན་པ་ཡིན་ནོ་༎ མངོན་པར་ཤེས་པའི་སྤྱན་གྱིས་ཐམས་ཅད་གཟིགས་པའོ་༎
 caittaṃ cittavikalpaḥ |	སེམས་ལས་བྱུང་བ་ནི་། སེམས་ཀྱི་རྣམ་རྟོག་གོ་༎
 parīkṣā tu pūrvavat |	བརྟག་པ་ནི་སྔར་བཞིན་ནོ་༎
 phenapiṇḍopamaṃ rūpaṃ vedanā budbudopamā |	གཟུགས་ནི་ལྦུ་བ་བཞིན་ནོ་༎ ཚོར་བ་ཆུ་བུར་བཞིན་ནོ་༎
 marīcisadṛśī saṃjñā saṃskārāḥ kadalīsamāḥ |	འདུ་ཤིས་སྨིག་རྒྱུ་བཞིན་ནོ་༎ འདུ་བྱེད་ནི་ཆུ་ཤིང་བཞིན་ནོ་༎ རྣམ་པར་ཤེས་པ་ནི་སྒྱུ་མ་བཞིན་ནོ་༎
 māyopamaṃ tu vijñāna [muktamādityabandhunā] || skandhanairātmyavijñānairātmyabhāvo vikalpaḥ | siddhaḥ | yato nāsti vandhyāduhitṛbhartṛvat ||	རྣམ་པར་རྟོག་པ་ནི་ཕུང་པོ་བདག་མེད་རྣམ་པར་ཤེས་པ་བདག་མེད་དངོས་པོ་གྲུབ་པ་འདི་ལྟར་མེད་མོ་གཤམ་མོའི་བུའི་དཔོན་བཞིན་ནོ་༎
 skandhanairātmyadeśanaparivarto dvitīyaḥ |	ཕུང་པོ་བདག་མེད་པ་བསྟན་པའི་ལེའུ་སྟེ་གཉིས་པའོ་།
 nairātmyadvayaṃ saṃgṛhya adhunā prajñotpādārthamāha |	༎ ། ད་ནི་ཤེས་རབ་འཕེལ་བར་བྱེད་པའི་དོན་དུ་བདག་མེད་གཉིས་སུ་བསྡུས་ནས་བཤད་པ་སྟེ་། སེམས་མེད་པས་ན་ཆོས་ཀྱང་མེད་༎ ཅེས་པ་ལ་སོགས་པས་༎
 cittābhāvānna dharmo 'pi | ityādi |	ཆོས་ནི་དངོས་པོ་སྟེ་།
 dharmaḥ bhāvaḥ kṛtakākṛtakarāśiḥ |	བྱས་པ་དང་། མ་བྱས་པ་མེད་པའི་ཕུང་པོ་།
 tatha pṛthivīdhātvādirapi |	སའི་ཁམས་ལ་སོགས་པ་ཡང་དེ་༄༡༥༥ཨ་༌་༎ བཞིན་ནོ་༎
 dharmāṇāṃ mūlaṃ cittamiti cittaṃ niṣiddham |	ཆོས་རྣམས་ཀྱི་རྩ་བ་འདི་སེམས་ཡིན་པས་ན་། སེམས་འགོག་པའོ་༎
 caittadharmatāyāmuttaraṃ ākṣepoktikathitam |	གོང་དུ་སེམས་བྱུང་ཆོས་ཉིད་ལས་སེམས་འཁྱོགས་པའི་ཚིག་གསུངས་པ་།
 anyatroktaṃ buddhena |	གཞན་ཡང་སངས་རྒྱས་ཀྱིས་གསུངས་པ་ནི་།
 anakṣarasya tattvasya śrutiḥ kā deśanā ca kā |	ཡི་གེ་མེད་པའི་ཆོས་ཉིད་ལ་༏་། ཐོས་པ་ཅི་ཡོད་བཤད་ཅི་ཡོད་༎ ཐོས་དང་བཤད་དང་དོན་ལ་ནི་༎
 śrūyate deśyate cārthaḥ samatā sāhyanakṣarā ||	མཉམ་པ་ཉིད་དེ་ཡི་གེ་མེད་༎
 apicoktaṃ buddhena |	གཞན་ཡང་སངས་རྒྱས་ཀྱིས་གསུངས་པ་ནི་།
 saṃvṛticaryāṃ naśritya paramārtho na deśyate |	ཀུན་རྫོབ་སྤྱོད་ལ་མ་བརྟེན་པར་༎ དོན་དམ་པ་ལ་བཤད་པ་མེད་༎
 paramārthaṃ tamajñātvā nirvāṇaṃ na pravartate ||	དོན་དམ་པ་དེས་མ་ཤེས་པར་༎ མྱ་ངན་འདས་པ་མི་འབྱུང་ངོ་༎
 kiñcoktaṃ śāstre | yaḥ pratītyasamutpādaḥ śūnyatāṃ tāṃ pracakṣmahe |	གཞན་ཡང་བསྟན་བཅོས་ལས་གསུངས་པ་ནི་། རྟེན་འབྲེལ་རྟེན་ནས་སྐྱེས་པ་གང་༎ དེ་ནི་སྟོང་ཉིད་རབ་ཏུ་བཤད་༎
 pratītya jāyate yaddhi tadjātaṃ svabhāvataḥ ||	རྟེན་འབྲེལ་གྱིས་གང་སྐྱེས་པ་དང་། དེ་ནི་སྐྱེ་མེད་ངོ་བོ་ཡིན་༎
 pratītyopādāya jātaṃ yat[tat] śūnyaṃ hi pracakṣmahe | yaḥ śūnyatāṃ prajānāti so 'pramattastu paṇḍitaḥ ||	རྟེན་འབྲེལ་ལ་རྟེན་གང་འབྱུང་བ་༎ སྟོང་པ་རུ་ནི་རབ་ཏུ་བཤད་༎ སྟོང་ཉིད་ཤེས་པ་གང་ཡིན་པ་༎ བསྙོ་?་མེད་མཁྱེན་པ་དེ་ཡིན་ནོ་༎
 [iti] bahūktirnirarthikā |	མང་དུ་བཤད་པ་དོན་མེད་ཡིན་༎
 evamadvayamārgeṇa sarvajñānaṃ buddhasādhanam |	དེ་ལྟར་གཉིས་སུ་མེད་པའི་ལམ་གྱིས་སངས་རྒྱས་གྲུབ་པ་ཐམས་ཅད་མཁྱེན་པའོ་༎
 tasya mārgamimaṃ niścitya jñānārthaṃ ya advayamārgaḥ sa svayamadvayaḥ |	དེའི་ལམ་དེ་ངེས་པར་ཤེས་པར་བྱ་བའི་དོན་དུ་གཉིས་མེད་ཀྱི་ལམ་གང་ཡིན་པ་དེ་རང་ཉིད་གཉིས་མེད་དོ་༎
 athavā utpattivināśābhāvena sadasannityānityabhāvābhāvādidvayapratītyabhāvāt advayajñānam |	ཡང་ན་སྐྱེ་བ་དང་འཆི་བ་མེད་པས་ན་། ཡོད་པ་དང་མེད་པ་རྟག་པ་དང་མི་རྟག་པ་དང་། དངོས་པོ་ཡོད་པ་དང་མེད་པ་ལ་སོགས་པ་གཉི་ག་རྟོག་པ་མེད་པས་གཉིས་སུ་མེད་པའི་ཡེ་ཤེས་སོ་༎ དེ་ལྟར་ན་གཉིས་མེད་དོ་༎
 evañcādvayaṃ, tadubhayasaṃśayānabhidhānaṃ prajñāpāramitājñānam |	དེ་གཉིས་ཀྱི་ཐེ་ཚོམ་བརྗོད་དུ་མེད་པ་ཤེས་རབ་ཀྱི་ཕ་རོལ་ཏུ་ཕྱིན་པའི་ཡེ་ཤེས་སོ་༎ དེ་ཤེས་ནས་དངོས་སུ་གང་བྱེད་པ་དེ་།
 tat jñātvā yaḥ sākṣātkaroti sa tatvajñānāt buddho bhagavān |	དེ་ཉིད་མཁྱེན་པས་སངས་རྒྱས་བཅོམ་ལྡན་འདས་སོ་༎
 sa buddhaḥ karuṇābalena provāca |	སངས་རྒྱས་དེ་སྙིང་རྗེའི་སྟོབས་ཀྱིས་རབ་ཏུ་གསུངས་སོ་༎
 yāvadavidyāstitvaṃ janmaparigrahaḥ |	མ་རིག་པ་ལ་སོགས་པ་ཡོད་ཀྱི་བར་ལ་སྐྱེ་བ་ལེན་ནོ་༎
 avidyādito nivṛttamatraṃ cet jñānaṃ tattvajñaḥ [syāt] iti ||	མ་རིག་པ་ལ་སོགས་པ་ནམ་འགགས་པ་ཤེས་ཙམ་ན་དེ་ཉིད་མཁྱེན་པའོ་༎
 anādhāramidaṃ sarvam | iti |	འདི་དག་ཐམས་ཅད་རྟེན་མེད་ཡིན་༎
 nirādhārakaruṇāprajñācakṣuṣā nirātmakam |	ཞེས་པ་ནི་རྟེན་མེད་པའི་སྙིང་རྗེ་ཤེས་རབ་ཀྱི་སྤྱན་གྱིས་བདག་མེད་པའོ་༎
 śūnyatākārakavedakavastvādhārābhāvakaruṇāprajñācakṣuṣā nirātmakam |	དངོས་པོ་སྟོང་པ་ཉིད་བྱེད་པ་པོ་དང་ཚོར་བ་པོ་རྟེན་པ་མེད་པའི་སྙིང་རྗེ་༄༡༥༥བ་ཤེས་རབ་ཀྱིས་བདག་མེད་པ་།
 śūnyatākārakavedakavastu ādhāro nāsti |	དངོས་པོ་སྟོང་ཉིད་བྱེད་པ་པོ་དང་ཚོར་བ་པོ་རྟེན་པ་མེད་པའོ་༎
 idaṃ sarvaṃ traidhātukamaśeṣamasat śūnyatā |	འདི་ཐམས་ཅད་ཁམས་གསུམ་མ་ལུས་པ་སྟེ་མེད་པ་སྟོང་པ་ཉིད་དོ་༎
 sa hi paramārthaḥ |	དེ་ནི་དོན་དམ་པའོ་༎
 prajñāpāramitāyāmapyuktam | subhūtimavocat |	ཤེས་རབ་ཀྱི་ཕ་རོལ་ཏུ་ཕྱིན་པ་ལས་ཀྱང་གསུངས་ཏེ་།
 rūpaṃ na prekṣate | ityādi |	གཟུགས་རབ་ཏུ་མི་མཐོང་ངོ་ཞེས་པ་ལ་སོགས་པ་རབ་འབྱོར་ལ་གསུངས་སོ་༎
 dvādaśapratītyasamutpādaniṣedhadharmatāyām |	རྟེན་འབྲེལ་བཅུ་གཉིས་འགག་པའི་ཆོས་ཉིད་ལས་།
 buddhaguṇanītabhāgīyaṃ dharmakāyaṃ śūnyatāvastu pracakṣate |	སངས་རྒྱས་ཀྱི་ཡོན་ཏན་གྱི་ཆ་ངེས་པ་ཆོས་ཀྱི་སྐུ་སྟོང་པ་ཉིད་ཀྱི་དངོས་པོ་རབ་ཏུ་བཤད་དོ་༎ 
 tena hi prajñāpāramitā ||	དེས་ནི་ཤེས་རབ་ཀྱི་ཕ་རོལ་ཏུ་ཕྱིན་པ་བསྟན་ཏོ་༎
 prajñādeśanāparivartastṛtīyaḥ	ཤེས་རབ་བསྟན་པའི་ལེའུ་སྟེ་གསུམ་པའོ་།
 evaṃ prajñāṃ deśayitvā adhunā saṃvṛtāvupāyo deśyate |	༎ ། དེ་ལྟར་ཤེས་རབ་བསྟན་ནས་ད་ནི་ཐབས་བསྟན་ཏེ་ཀུན་རྫོབ་ལ་།
 dānaśīlakṣametyādi |	སྦྱིན་པ་ཚུལ་ཁྲིམས་བཟོད་པ་དང་༎ ཞེས་བྱ་བ་ལ་སོགས་པ་སྟེ་།
 sūrye uditamatre chāyotpattivadupāya uktaḥ |	ཉི་མ་ཤར་ཙམ་ན་གྲི་བ་མ་འབྱུང་བ་ལྟར་ཐབས་བསྟན་ཏོ་༎
 prathamaṃ dānaṃ mūlamidhīyate |	དང་པོ་སྦྱིན་པ་རྩ་བར་བཤད་།
 uktamanyatra |	གཞན་ཡང་གསུངས་པ་། འཇིག་རྟེན་པ་འདི་ཐམས་ཅད་ནི་༎
 ayaṃ hi sakalo lokaḥ sukhamekamabhīpsati |	བདེ་སྐྱིད་གཅིག་པུ་རེ་བ་ཡིན་༎
 nṝṇāṃ bhogavihīnānāṃ sukhāśā labhyate kutaḥ ||	ལོངས་སྤྱོད་མེད་པའི་མི་རྣམས་ལ་༎ བདེ་བ་རེ་ཡང་ག་ན་ཐོབ་༎
 dānotsargeṇa hi bhoga utpadyate |	སྦྱིན་པ་བཏང་བས་ལོངས་སྤྱོད་འབྱུང་༎
 tena dānaṃ mūlamuktam |	དེ་ནས་སྦྱིན་པ་རྩ་བར་བཤད་།
 dānāni catvāri |	སྦྱིན་པ་ལ་ཡང་བཞི་སྟེ་།
 dharmāmiṣābhayamaitrīti |	ཆོས་ཟང་ཟིང་མི་འཇིགས་བྱམས་པའོ་༎
 rājyasvaśiraḥparyantamavaradharmadānam |	རྒྱལ་སྲིད་བདག་གི་མགོ་མཐར་ཐུག་པ་ཚུན་ཆད་སྦྱིན་པའོ་༎ ནོར་འབྲུ་། གསེར་། དངུལ་། རིན་པོ་ཆེ་། མུ་ཏིག་། བྱི་རུ་། ཤིང་རྟ་། གླང་པོ་ཆེ་། ག-ཡོག་། ཁོལ་པོ་། ཁོལ་མོ་༏་གྲོགས་། ཆུང་མ་། བུ་མོ་།
 [tathā hi] dhanaṃ dhānyaṃ suvarṇaṃ rajataṃ maṇiḥ muktā pravālaḥ rathaḥ gajaḥ bhṛtyaḥ dāsaḥ dāsīū priyabhāryā duhitṛsutaḥ pradhānasvaṃ,	བུ་ཕོ་། གཅེས་པའི་ནོར་། མགོ་། རྣ་བ་། སྣ་། ལག་པ་། རྐང་པ་། མིག་། 
 śiraḥ karṇaḥ nāsā pāṇiḥpādaḥ cakṣuḥ svamāṃsaṃ raktaṃ astimajjā medaḥ tvak hṛdayamātmīyaṃ vastu sarvaṃ dadyāt |	རང་གི་ཤ་། ཁྲག་། རུས་པ་། རྐང་མར་། ཚིལ་བུ་། པགས་པ་། སྙིང་གི་དངོས་པོ་ཐམས་ཅད་སྦྱིན་པའོ་༎
 nanvevaṃ sati bodhisattvacaryā nātiduṣkarā?	དེ་ལྟར་ཡིན་ན་བྱང་ཆུབ་སེམས་དཔའི་སྤྱོད་པ་ཤིན་ཏུ་མི་དཀའ་འམ་།
 kuśalopāyo hi buddhalābhakaraḥ |	བདེ་བའི་ཐབས་སངས་རྒྱས་ཐོབ་པར་བྱེད་པ་ལ་།
 buddhasukhañca nistulaṃ sukham |	སངས་རྒྱས་ཀྱི་བདེ་བ་དང་མི་མཉམ་པའི་བདེ་བའོ་༎
 duḥkhaśataiścaryāpi duḥkhaṃ na syāt |	སྡུག་བསྔལ་བརྒྱ་ཕྲག་གིས་སྤྱོད་པ་ཡང་། སྡུག་བསྔལ་དུ་མི་འགྱུར་རོ་༎
 tadyathā ekaputravadhasamaye pitra vikriyate |	དཔེར་ན་བུ་གཅིག་གསོད་པའི་དུས་༄༡༥༦ཨ་༌་༎ སུ་ཕས་རྗེས་པ་ལྟར་རོ་༎
 cittabhyāsamātre tu nāśakathaṃ kiñcidapi |	སེམས་གོམས་ཙམ་ན་མི་ནུས་པ་གང་ཡང་མེད་དེ་།
 mayūrasya śarīrabhedādahiviṣamamṛtaṃ [bhavati] |	ལུས་པོའི་བྱེ་བྲག་གིས་སྤྲུལ་དང་དུག་རྨ་བྱའི་བདུད་རྩིའོ་༎
 viṣañca tadabhyāsāt rasāyanaṃ bhavati |	དེ་གོམས་པས་དུག་ཀྱང་བཅུད་ལེན་དུ་འགྱུར་རོ་༎
 ānandaviśeṣasukhajanakañca |	ཁྱད་པར་དུ་དགའ་བ་དང་བདེ་བ་སྐྱེའོ་༎
 yadabhyastaṃ tadamṛtaṃ bhavati |	གོམས་པ་གང་ཡིན་པ་དེ་བདུད་རྩིར་འགྱུར་བ་ཡིན་པས་ན་།
 tena duḥkhaṃ cittavikalpaḥ ||	སྡུག་བསྔལ་སེམས་ཀྱི་རྣམ་རྟོག་ཡིན་ནོ་༎ ཚུལ་ཁྲིམས་ཀྱི་ཐབས་ནི་།
 śīlopāyaḥ | śīlābhidhā ca caryāsti daśākuśalavarjitā |	ཚུལ་ཁྲིམས་རྐང་པ་སྤྱོད་པ་ཡིན་།
 prātimokṣasaṃvararakṣaṇam, sarvaprāṇyupakāramaitracittavattvam,	མི་དགེ་བ་བཅུ་སྤོངས་པ་དང་། སོ་སོར་ཐར་པའི་སྡོམ་པ་བསྲུང་བ་དང་། སྲོག་ཆགས་ཐམས་ཅད་ལ་ཕན་འདོགས་བྱེད་པ་བྱམས་པའི་སེམས་དང་ལྡན་པ་།
 svabhoge alaṃbuddhiḥ,	རང་གི་ལོངས་སྤྱོད་ལ་ཆོག་ཤེས་པ་།
 abrahmacaryavarjanam,	མི་ཚངས་པར་སྤྱོད་པ་སྤངས་པ་།
 satyavacanamevaṃ karomīti,	བདེན་པར་སྨྲ་བ་། དེ་ལྟར་བྱེད་པའོ་༎
 apāruṣyavacanam,	ཚིག་རྩུབ་མི་སྨྲ་བ་།
 parārādhanam,	གཞན་གཉིས་པར་བྱེད་པ་།
 dharmaśo vinayacaryābhāṇakasya sagauravabhāṣaṇam,	དུལ་བའི་སྤྱོད་པ་ཆོས་བཞིན་དུ་སྨྲ་བ་། གུས་པར་སྨྲ་བ་།
 pareṇātmagrahaṇe alobhaḥ,	གཞན་གྱིས་བདག་ཏུ་བཟུང་བ་ལ་འདོད་སྲེད་མེད་པ་།
 kāmacittānāmanutpādanam,	འདོད་པའི་སེམས་རྣམས་མི་སྐྱེ་བ་།
 yātrādya dbhuta [darśana]varjanam,	ལྟད་མོ་ལ་སོགས་པ་ངོ་མཚར་སྤངས་པ་། དྲང་བ་།
 ākarṣaṇaśāṭhyavirahaḥ,	ག-ཡོ་སྒྱུ་མེད་པ་།
 triṣu buddhadharmasaṅgheṣu adhimukticittatvam, sarveṣāṃ sattvānāṃ buddhakaraṇe mahotsāhaḥ ||	སངས་རྒྱས་དང་། ཆོས་དང་། དགེ་འདུན་གསུམ་ལ་ཤིན་ཏུ་མོས་གུས་ཆེ་བའི་སེམས་དང་། སེམས་ཅན་རྣམས་སངས་རྒྱས་པར་བྱེད་པ་ལ་སྤྲོ་བ་ཆེ་བ་།
 dānaśīlādinā ciramarjite 'pi puṇye yadi kṣāntirnāsti | tadā sadya eva puṇyaṃ naśyet |	སྦྱིན་དང་ཚུལ་ཁྲིམས་ལ་སོགས་ཀྱིས་༎ ཡུན་རིངས་བསོད་ནམས་བསགས་པ་ཡང་༎ གལ་ཏེ་བཟོད་པ་མེད་ན་ནི་༎
 uktañca śāntidevena |	མདོ་ལས་བསོད་ནམས་མེད་པར་གྱུར་ཏེ་༏་ཞི་བ་ལྷས་ཀྱང་གསུངས་པ་། བསྐལ་པ་སྟོང་དུ་བསགས་པ་ཡི་༎
 sarvametatsucaritaṃ dānaṃ sugatapūjanam |	སྦྱིན་དང་བདེ་གཤེགས་མཆོད་ལ་སོགས་༎ ལེགས་སྤྱད་གང་ཡིན་དེ་ཀུན་ཡང་༎
 kṛtaṃ kalpasahasrairyat pratighaḥ pratihanti tat ||	ཁོང་ཁྲོ་གཅིག་གིས་འཇོམས་པར་བྱེད་༎
 na ca dveṣasamaṃ pāpaṃ na ca kṣāntisamaṃ tapaḥ |	ཞེ་སྡང་ལྟ་བུའི་སྡིག་པ་མེད་༎ བཟོད་པ་ལྟ་བུའི་དཀའ་ཐུབ་མེད་༎
 tasmātkṣāntiṃ prayatnena bhāvayedvividhairnayaiḥ ||	དེ་བས་བཟོད་ལ་ནན་ཏན་དུ་༎ སྣ་ཚོགས་ཚུལ་གྱིས་བསྒོམ་པར་བྱའོ་༎
 iti |	ཞེས་གསུངས་སོ་༎
 tisraḥ kṣāntayaḥ |	བཟོད་པ་ལ་གསུམ་སྟེ་།
 duḥkhādhivāsanākṣāntiḥ parābhavamarṣaṇakṣāntiḥ dharmanidhyānakṣāntiśceti | tatra prathamā kasyādhivacanam |	སྡུག་བསྔལ་དང་དུ་ལེན་པའི་བཟོད་པ་དང་། བརྙས་པ་ལ་ཇི་མི་སྙམ་པའི་བཟོད་པ་དང་༎ ཆོས་ལ་ངེས་པར་སེམས་པའི་བཟོད་༄༡༥༦བ་པའོ་༏་། དེ་ལ་དང་པོ་ནི་སུ་དག་གིས་འདི་སྐད་སྨྲ་ན་།
 evaṃ- ahaṃ te anuttaradharma samyaksaṃbuddhalābhaṃ karomi bodhisattvacaryaviśuddhiñca karomi |	འདི་ལྟར་དུ་བདག་གིས་ཁྱེད་ལ་ཆོས་ཀྱིས་བླ་ན་མེད་པ་ཡང་དག་པར་རྫོགས་པའི་སངས་རྒྱས་ཐོབ་པར་བྱེད་པ་ལ་། བྱང་ཆུབ་སེམས་དཔའི་སྤྱོད་པ་དག་པར་བྱེད་པ་ལ་།
 [ityukte kaścidāha]mayoktaṃ śṛṇu |	བདག་གིས་སྨྲས་པ་ཉོན་ཅིག་། 
 no cet jvalanmahāvanhau praviśya prajvala |	མི་ཉན་ན་མེ་ཆེན་པོ་འབར་བའི་ནང་དུ་ཆུག་ལ་སྲེགས་ཤིག་། 
 duḥkhamutpannaṃ kāyo vahatu |	ཤིན་ཏུ་སྡུག་བསྔལ་འབྱུང་བར་ལུས་པོས་ཁུར་ཅིག་། 
 tasyaivamuttaraṃ vadāmi |	དེའི་ལན་ནི་འདི་སྐད་སྨྲའོ་༎
 evaṃ satyapi atyantamutsahe |	དེ་ལྟར་བྱུང་མོད་ཤིན་ཏུ་སྤྲོ་༎
 ahamanuttaradharma [samyak] saṃbuddha[lābha]āya bodhisattvacaryāśodhanāya ca trisāhasramahāsāhasralokadhātau agnijvālā bhūtvā brahmabhavana[paryantaṃ] svataḥ paripācayāmi |	བདག་གཅིག་ཆོས་ཀྱིས་བླ་ན་མེད་པའི་རྫོགས་པའི་སངས་རྒྱས་། བྱང་ཆུབ་སེམས་དཔའི་སྤྱོད་པ་དག་པར་བྱེད་པའི་དོན་དུ་། སྟོང་གསུམ་གྱི་སྟོང་ཆེན་པོའི་འཇིག་རྟེན་གྱི་ཁམས་སུ་མེ་འབར་བ་ཡོད་པ་ལ་། ཚངས་པའི་གནས་རང་ལྷུང་ནས་འཚོད་།
 kaḥpunarvādastvaduktavanhiḥ ||	ཁྱེད་གསུངས་པའི་མེ་ལྟ་བུ་སྨོས་ཀྱང་ཅི་འཚལ་།
 parābhibhavamarṣaṇakṣāntiḥ,	གཞན་གྱིས་བརྙས་པ་ལ་ཇི་མི་སྙམ་པའི་བཟོད་པ་ནི་།
 parīkṣayā [apakāriṣu] apradarśitakopaḥ āyudhena māṃse chinne 'pi adhyadhikāṃ kṣāntiṃ janayitvā ahaṃ śata[dhā] hastacchedakamapi śirasi vahāmi taduparyapi maitracittayuktaḥ | iti ||	རྟགས་པས་ཁྲོ་བ་མ་མཐོང་བར་མཚོན་ནས་ཤག་ཅད་ཅིང་ཡོད་པ་ལ་བླ་ལྷག་བཟོད་པ་བསྐྱེད་ལ་། བདག་གི་ལག་པ་བརྒྱ་ཕྲག་གཅོད་པ་པོ་ཡང་སྤྱི་བོར་འཁུར་རོ་༎ དེའི་ཐོག་ཏུ་ཡང་བྱམས་པའི་སེམས་དང་ལྡན་ནོ་༎
 dharmanidhyānakṣāntiḥ atigambhīre yāne atiśobhane munidharme prathamato labdhe kṣaṇamapi kiñcidasandigdhacittatvam |	ཆོས་ལ་ངེས་པར་སེམས་པའི་བཟོད་པ་ནི་། ཤིན་ཏུ་ཟབ་པའི་ཐེག་པ་ལ་ཤིན་ཏུ་ལེགས་པའི་ཐུབ་པའི་ཆོས་ལ་ཐོག་མ་ནས་རྙེད་པ་ལ་། སྐད་ཅིག་ཀྱང་སེམས་ཐེ་ཚོམ་མི་ཟ་བར་ཁ་ཅིག་ནི་ཆོས་ལ་ངེས་པར་སེམས་པའི་བཟོད་པའི་འདོད་ལུགས་ནི་།
 dharmanidhyānakṣāntividhistu parābhibhavamarṣaṇakṣāntivat |	གཞན་གྱིས་བརྙེས་པ་ལ་ཇི་མི་སྙམ་པའི་བཟོད་པ་བཞིན་དུ་།
 dharmābhāvaścādharo 'tra viśeṣaḥ ||	དེ་ལ་ཁྱེད་ནི་ཆོས་ཀྱི་དངོས་པོ་རང་ལ་བརྟེན་པས་སོ་༎
 vīryaṃ śāntidevenoktam |	བརྩོན་འགྲུས་ནི་ཞི་བ་ལྷས་གསུངས་པ་།
 [evaṃ kṣamo bhajedvīryaṃ] vīrye bodhiryataḥ sthitā |	འདི་ལྟར་བརྩོན་ལ་བྱང་ཆུབ་གནས་༎
 na hi vīryaṃ vinā puṇyaṃ yathā vāyuṃ vinā gatiḥ ||	རླུང་མེད་འགྲོ་བ་མེད་པ་བཞིན་༎ བསོད་ནམས་བརྩོན་འགྲུས་མེད་མེ་འབྱུང་༎
 kiṃ vīryaṃ kuśalotsāhaḥ | iti |	བརྩོན་གང་དགེ་ལ་སྤྲོ་བ་ཡིན་༎ ཞེས་གསུངས་པས་སོ༎
 vīryakaraṇārthadarśī kenacit priyeṇa viyuktaḥ vipriyeṇa ca saṅgataḥ vyādhijarāmaraṇaśokādiduḥkha	བརྩོན་འགྲུས་བྱེད་པའི་དོན་ལྟ་བ་ནི་། ཅིས་ཀྱང་མཛའ་བ་དང་བྲལ་བ་། མི་མཛའ་བ་དང་འགྲོགས་པ་དང་། ནད་དང་རྒས་ངང་འཆི་བ་དང་༎ མྱ་ངན་ལ་སོགས་པའི་སྡུག་བསྔལ་ངན་སོང་ལ་སོགས་པར་ལྷུང་ནས་རྟག་ཏུ་བདེ་བ་སྐད་ཅིག་བདེ་བར་ལྟ་བ་། མི་ཁོམ་པའི་༄༡༥༧ཨ་༌་༎
 durgatau patitaḥ [api] sadā kuśalakṣaṇakuśaladṛṣṭiḥ aṣṭasvakṣanasthāneṣu mokṣakāle	གནས་བརྒྱད་ལས་གྲོལ་བའི་དུས་སུ་།
 ca bodhicaryāṃ saṃpaśyan kausīdyaṃ vihāya dṛḍhīkṛtya vimatihīnaḥ duḥkhaprahāṇāya vīryamārabheta ||	བྱང་ཆུབ་ཀྱི་སྤྱོད་པ་ལ་ཡང་དག་པར་བལྟས་ནས་ལེ་ལོ་སྤངས་ཏེ་། བརྟན་པར་བྱས་ནས་ཐེ་ཚོམ་མེད་པར་སྡུག་བསྔལ་སྤངས་པའི་དོན་དུ་བརྩོན་འགྲུས་བརྩོམ་*rtsom་པར་བྱའོ་༎ བསམ་གཏན་ནི་།
 dhyānam, prajñopāyāvubhau [ekī]kṛtya cittaikāgrīkaraṇaṃ dhyānam ||	ཤེས་རབ་དང་ཐབས་གཉིས་སུ་བྱས་ནས་སེམས་རྩེ་གཅིག་ཏུ་བྱེད་པ་ནི་བསམ་གཏན་ནོ་༎
 prajñā yathā pūrvoktā ||	ཤེས་རབ་ནི་སྔར་བསྟན་པ་བཞིན་ནོ་༎
 dānapāramitādikaṃ dātṛpratigrahītṛyatkiñcidanālambaṃ śūnyatayā prekṣeta |	སྦྱིན་པའི་ཕ་རོལ་ཏུ་ཕྱིན་པ་ལ་སོགས་པ་སྟེར་བ་པོ་དང་། ལེན་པ་པོ་གང་ཡང་མི་དམིགས་པར་སྟོང་པ་ཉིད་དུ་རྟོག་པའོ་༎ ཉི་མ་ཇི་ལྟར་གླིང་རྣམས་ལ་བསྐོར་ནས་བཟློག་པ་བཞིན་དུ་།
 dānapāramitādi prajñāpāramitayā vyāptam | yathā sūryo dvīpān parivartyaṃ nivartate tathā ||	ཤེས་རབ་ཀྱི་ཕ་རོལ་ཏུ་ཕྱིན་པས་སྦྱིན་པའི་ཕ་རོལ་ཏུ་ཕྱིན་པ་ལ་སོགས་པ་ལ་ཁྱབ་པའོ་༎ དེ་ལྟར་ཁྱབ་པའོ་༎
 pāramitāsaṃgrahaḥ |	ཕ་རོལ་ཏུ་ཕྱིན་པ་བསྡུས་པ་ནི་།
 svārthatyāgo dānam |	རང་གི་དོན་རྣམས་སྤངས་པ་ནི་སྦྱིན་པའོ་༎
 parānugrahaḥ śīlam |	གཞན་ལ་ཕན་འདོགས་པ་ནི་ཚུལ་ཁྲིམས་སོ་༎
 gativarjanaṃ kṣamā |	ཁྲོ་བ་སྤངས་པ་ནི་བཟོད་པའོ་༎
 kuśalotsāho vīryam |	དགེ་བ་ལ་བརྩོན་པ་ནི་བརྩོན་འགྲུས་སོ་༎
 malānupalepo dhyānam |	སྡིག་པས་མི་གོས་པ་གཅིག་པུ་ནི་བསམ་གཏན་ནོ་༎
 paramārthasatyadeśanāṃ prajñā |	བདེན་པ་དོན་དམ་པ་བསྟན་པ་ནི་ཤེས་རབ་བོ་༎
 sattveṣu karuṇāvyāptīkaraṇaṃ prajñārasaḥ |	སེམས་ཅན་རྣམས་ལ་སྙིང་རྗེས་ཁྱབ་པར་བྱེད་པ་ནི་ཤེས་རབ་བོ་༎ སངས་རྒྱས་གྲུབ་པར་བྱེད་པ་ནི་།
 buddhasādhakaḥ pitṛmātṛduhitṛbandhu parivārapatnyādirājyabhūmyaiśvaryasaukhyādi [ut] śiṣṭānnavat vihāya mokṣārthaṃ vanaṃ gacchet |	ཕ་དང་། མ་དང་། བུ་མོ་དང་། གཉེན་དང་། འཁོར་དང་། ཆུང་མ་ལ་སོགས་པ་། རྒྱས་པ་དང་། ཕྱུག་པ་དང་། སྐྱིད་པ་ལ་སོགས་པ་ཟན་ལྷག་མ་བཞིན་དུ་སྤངས་ནས་གྲོལ་བའི་དོན་དུ་། ནགས་གསེབ་དུ་འགྲོ་བར་བྱའོ་༎
 dānādikantu na duḥkham,	སྦྱིན་པ་ལ་སོགས་སྡུག་བསྔལ་མ་ཡིན་ཞིང་།
 buddhalābhasukhaviṣamañca ||	སངས་རྒྱས་ཐོབ་པའི་བདེ་བ་དང་མི་མཉམ་མོ་༎
 upāyadeśanāparivartaścaturthaḥ upāyaprajñayostiṣṭham | iti |	ཐབས་བསྟན་པའི་ལེའུ་སྟེ་བཞི་པའོ་། ༎ ། ཐབས་དང་ཤེས་རབ་གནས་པ་ལ་༎ ཞེས་པ་ནི་།
 prajñā yathā pūrvoktā |	ཤེས་རབ་ནི་སྔར་གསུངས་པ་བཞིན་ནོ་༎
 katham, pratītyasamutpādena vastuprajñaptilakṣaṇatā |	ཇི་ལྟར་རྟེན་འབྲེལ་གྱིས་སྐྱེད་པས་དངོས་པོ་རྟོག་པའི་མཚན་ཉིད་དོ་༎
 upāyaḥ pūrvoktavaddānādikriyā |	ཐབས་ནི་སྔར་བཤད་པ་བཞིན་སྦྱིན་པ་ལ་སོགས་པ་བྱེད་དོ་༎
 tāvubhāvekīkṛtya deśako gururnāsti cet, svapne 'pi [na] utpadyate |	དེ་གཉིས་གཅིག་ཏུ་བྱས་ཏེ་བསྟན་པར་བྱེད་པ་ནི་བླ་མ་མེད་ན་རྨི་ལམ་ན་ཡང་འབྱུང་ངོ་༎ 
 evaṃ sati upāyaprajñe dve, tadbhedādvaye jāte punardānādibhede bahavo dāṣāḥ syuriti cet |	དེ་ལྟར་ཡིན་༄༡༥༧བ་ན་ཐབས་དང་ཤེས་རབ་གཉིས་སུ་དེ་ཕྱི་ནས་གཉིས་སུ་བྱུང་ཡང་སྦྱིན་པ་ལ་སོགས་པ་དབྱེ་ན་མང་དུ་འགྱུར་བའི་སྐྱོན་བྱུང་ཞེ་ན་།
 nāmamātramidaṃ sarvam |	འདི་དག་ཐམས་ཅད་མིང་ཙམ་སྟེ་།
 upāyaprajñānidarśanaṃ saṃvṛtimātramāśritya siddhyati |	ཐབས་དང་ཤེས་རབ་དཔེ་ཀུན་རྫོབ་ཙམ་ལ་བརྟེན་ནས་གྲུབ་བོ་༎
 [prajñā]pāramitāyāmapyuktam |	ཕ་རོལ་ཏུ་ཕྱིན་པ་ནས་ཀྱང་གསུངས་སོ་༎
 danapāramitā nāmamātram |	སྦྱིན་པའི་ཕ་རོལ་ཏུ་ཕྱིན་པ་ནི་མིང་ཙམ་མོ་༎
 prajñāpāramitā nāmamātram |	ཤེས་རབ་ཀྱི་ཕ་རོལ་ཏུ་ཕྱིན་པ་ནི་མིང་ཙམ་མོ་༎
 traidhātukamapi nāmamātram || iti |	ཁམས་གསུམ་ཡང་མིང་ཙམ་མོ་༎
 tadubhayaṃ nirākartumāha |	དེ་གཉིས་གསལ་བར་གསུངས་པས་།
 yato 'bhūdyacca nāma tat | ityādi |	གང་ལས་གང་བྱུང་མིང་དེ་ནི་༎ ཞེས་པ་ལ་སོགས་པ་གསུངས་ཏེ་།
 pūrvaṃ parīkṣitavat dharmo nāmamātramucyate | na paramārthato bhāvo 'sti |	སྔར་བརྟག་པ་བཞིན་ཆོས་མིང་ཙམ་དུ་བསྟན་ཏེ་༏་དོན་དམ་པར་དངོས་པོ་མེད་པའོ་༎
 dharmatā na sa dharmo 'stīti | iti |	ཆོས་དེ་མེད་པས་ཆོས་ཉིད་ཡིན་༎ ཞེས་པ་ནི་།
 nāmamātratayā siddhaḥ, vastuśūnyatā |	མིང་ཙམ་དུ་གྲུབ་པ་སྟེ་དངོས་པོ་སྟོང་པ་ཉིད་ཡིན་།
 pratītyasamutpannaḥ saṃvṛtimātram |	རྟེན་འབྲེལ་ལས་བྱུང་བ་ཀུན་རྫོབ་ཙམ་མོ་༎
 abhūtaṃ nāma śūnyatā | ityādi |	མ་བྱུང་མིང་ནི་སྟོང་ཉིད་ཡིན་༎ ཞེས་པ་ལ་སོགས་པ་ནི་།
 saṃvṛtau nāma nimittamātram |	ཀུན་རྫོབ་ཏུ་མིང་བཏགས་པ་ཙམ་ཡིན་ནོ་༎
 śabdavida āhuḥ | śabdātsarvamutpannamiti |	སྒྲ་མཁན་པ་ན་རེ་སྒྲ་ལས་ཐམས་ཅད་བྱུང་ཟེར་བ་ལ་།
 sa svayameva saṃvṛtau nāmamātraṃ siddhaḥ |	དེ་རང་ཡང་ཀུན་རྫོབ་ལ་མིང་ཙམ་དུ་གྲུབ་པའོ་༎
 vikalpo yastathoditaḥ | ityādi |	དེ་ལྟར་རྣམ་རྟོག་གང་བྱུང་བ་༎
 nāmamātram śūnyatā,	ཞེས་པ་སོགས་པ་ནི་མིང་ཙམ་དུ་ཡིན་།
 parīkṣā pūrvavatsugamā |	སྟོང་ཉིད་དུ་བརྟག་པ་སྔར་བཞིན་དུ་གོ་སླའོ་༎
 rūpaṃ taccakṣuṣekṣitam | ityādi |	མིག་གིས་མཐོང་བའི་གཟུགས་དེ་ནི་༎ ཞེས་པ་ལ་སོགས་པ་ནི་།
 cakṣū rūpaṃ paśyatītyādi vyākaraṇaṃ bhagavatā saṃvṛtāvuktam | mithyābhimānalokataḥ | ityādi |	མིག་གིས་གཟུགས་མཐོང་བ་ལ་སོགས་པ་བཅོམ་ལྡན་འདས་ཀྱིས་ལུང་བསྟན་པ་ནི་ཀུན་རྫོབ་པ་ལ་བསྟན་པའོ་༎ བརྫུན་གྱི་ང་རྒྱལ་འཇིག་རྟེན་པ་༎ ཞེས་པ་ལ་སོགས་པ་ལ་།
 abhimānena sattvaṃ deśakālamātrāṃ vāśritya bhagavatā varākisadṛśamuktam |	ང་རྒྱལ་གྱིས་སེམས་ཅན་བརྟེན་ནས་། ཡུལ་དང་དུས་ཚོད་ལ་བརྟེན་ནས་། བཅོམ་ལྡན་འདས་ཀྱིས་བརྫུན་ཅན་ལྟ་བུར་གསུངས་སོ་༎
 paramārthastvavacanaḥ |	དོན་དམ་པ་ལ་བཤད་པ་མེད་དོ་༎
 paramārthaniścayopāyo mṛṣoktaḥ |	དོན་དམ་པའི་གཏན་ལ་འབེབས་པའི་ཐབས་སུ་བརྫུན་དུ་བཤད་དོ་༎
 duḥkhasatyaṃ duḥkhasamudayasatyaṃ nirodhasatyaṃ mārgasatyamityādyāryasatyāni catvāri saṃvṛtau deśitāni |	འཕགས་པའི་བདེན་པ་བཞི་ནི་། སྡུག་བསྔལ་གྱི་བདེན་པ་དང་། ཀུན་འབྱུང་གི་བདེན་པ་དང་། འགོག་པའི་བདེན་པ་དང་། ལམ་གྱི་བདེན་པ་ལ་སོགས་པ་ཀུན་རྫོབ་པ་ལ་བསྟན་ཏོ་༎ རྟེན་འབྲེལ་འཛོམ་པས་མཐོང་བ་གང་༎
 darśanaṃ yatpratītyajam | ityādi |	ཞེས་པ་ལ་སོགས་པ་ནི་།
 nāyako bhagavato vacanam |	འདྲེན་པ་བཅོམ་ལྡན་འདས་ཀྱིས་གསུངས་སོ་༎
 rūpaśabdādisamāgamakāmānāṃ sattvānāṃ prakāśayati |	གཟུགས་སྒྲ་ལ་སོགས་པ་འཛོམ་པར་འདོད་པའི་སེམས་ཅན་རྣམས་ལ་སྣང་བར་བསྟན་ཏོ་༎
 yena yān vividhairūpāyaiḥ sattvān vineyān vinayati,	གང་གིས་གང་ལ་ཐབས་སྣ་ཚོགས་༄༡༥༨ཨ་༌་༎
 tān mocayitvā nayati; tena bhagavān [nāyakaḥ] |	ཀྱི་སྒོ་ནས་སེམས་ཅན་གདུལ་བྱ་བཏུལ་ནས་དེ་རྣམས་གྲོལ་བར་བྱས་ནས་འདྲེན་པས་ན་བཅོམ་ལྡན་འདས་སོ་༎ འཛིན་པ་སྤྱོད་པའི་ས་ཡོད་པར་༎
 upacārāvaniṃ satīm | ityādi |	ཞེས་པ་ལ་སོགས་པ་ལ་།
 saṃvṛtimāśritya prathabhūmyādyucyate |	ཀུན་རྫོབ་ལ་བརྟེན་ནས་ས་དང་པོ་ལ་སོགས་པ་བསྟན་པའོ་༎
 paramārthabhūmistu sūkṣmabuddhyaparyantā | kalpanāvikalaśūnyatāvediprajñā yasyāsti sa buddhimān | sa ca bhagavān |	དོན་དམ་པའི་ས་ནི་བློ་ཤིན་ཏུ་ཕྲ་བ་མཐར་ཐུག་མེད་པ་རྟོག་པ་དང་བྲལ་བ་སྟོང་ཉིད་དུ་མཁྱེན་པའི་ཤེས་རབ་ཅན་གང་ལ་ཡོད་པ་དེ་བློ་ལྡན་ཡིན་ཏེ་དེ་ནི་བཅོམ་ལྡན་འདས་སོ་༎ 
 na cakṣū rūpamīkṣate | ityādi |	མིག་གིས་གཟུགས་ཀྱང་མཐོང་མི་འགྱུར་༎
 taimirika iva cakṣuḥ svayaṃ cakṣū rūpañca na paśyati |	ལ་སོགས་པ་ནི་། རབ་རིབ་ཅན་ལྟ་བུ་མིག་རང་གིས་མིག་དང་གཟུགས་མི་མཐོང་ངོ་༎
 sa cittadharmaśca, - cittena citte dṛṣṭamātre cittaṃ na dṛśyate |	སེམས་ཆོས་དེ་ཡང་སེམས་ཀྱིས་སེམས་ལ་བལྟས་ཙམ་ན་སེམས་མི་མཐོང་ངོ་༎
 tena na bhavet |	དེས་ན་ཡོད་པར་མི་འགྱུར་རོ་༎
 samādhirājasūtre 'pyuktam |	ཏིང་ངེ་འཛིན་གྱི་རྒྱལ་པོའི་མདོ་ལས་ཀྱང་གསུངས་ཏེ་།
 cakṣuḥśrotraghrāṇajivhākāyamanorūpaśabdagandharasaspraṣṭavyadharmā na santi | iti | tannigamayannāha |	མིག་དང་། རྣ་བ་དང་། སྣ་དང་། ལྕེ་དང་། ལུས་དང་། ཡིད་དང་། གཟུགས་དང་། སྒྲ་དང་། དྲི་དང་། རོ་དང་། རེག་བྱ་དང་། ཆོས་མེད་ཅེས་གསུངས་སོ་༏་། དེ་ནི་མཇུག་བསྡུ་བ་གསུངས་པ་ནི་།
 sarvaṃ dṛśyaṃ yat | ityādi |	གང་སྣང་ཐམས་ཅད་ལ་སོགས་པ་སྟེ་།
 pūrvoktamupāyaprajñobhayaikīkaraṇajñānādikamanṛtamucyate |	སྔར་བཤད་པའི་ཐབས་དང་ཤེས་རབ་གཉིས་གཅིག་ཏུ་བྱས་པའི་ཡེ་ཤེས་ལ་སོགས་པ་བརྫུན་དུ་བཤད་པའོ་༎ 
 lokaśca vijahāti yat | iti |	འཇིག་རྟེན་པས་ནི་གང་སྤངས་པ་༎
 tadaviparītaṃ tattvam |	ཞེས་པ་ནི་། ཕྱིན་ཅི་མ་ལོག་པ་དེ་དེ་ཉིད་། འཇིག་རྟེན་པ་ཐ་མལ་པས་། གང་ལ་མ་རྟོགས་པ་གང་ཡིན་གྱི་བསམ་པར་མ་གྱུར་། ཡིད་ཀྱི་བསམ་གྱིས་མི་ཁྱབ་པ་༎
 lokaḥ prākṛtaḥ yadajānānaḥ yat- cintāpadmabhūtaṃ manasā acintyamindriyāviṣayabhūtamajñānapaṭalāndhakārapratiruddhamadṛṣṭaṃ- tyajati |	དབང་པོ་ཡུལ་དུ་མ་གྱུར་པ་༎ མ་རིག་པའི་ལིང་ཐོག་གི་མུན་པས་མ་མཐོང་བ་སྤངས་པ་།
 [sa] paramārthaḥ atitīkṣnendriyaryajñāndṛṣṭigocaraḥ |	དབང་པོ་ཤིན་ཏུ་རྣོན་པོ་འཕགས་པའི་ཡེ་ཤེས་ཀྱིས་མཐོང་བའི་ཡུལ་དོན་དམ་པའོ་༎
 āryaghanavyūhasūtre |	འཕགས་པ་གྷ་ན་བྷའུ་?་ཧའི་མདོ་ལས་།
 tattvamatyantamāścaryaṃ gambhīraṃ tadanantavat |	དེ་ཉིད་ཤིན་ཏུ་ངོ་མཚར་ཅན་༎ ཟབ་པ་དེ་ནི་མཐའ་མེད་པ་༎
 taddhi durlabhamityasmāllokasya kila buddhinā ||	དེ་ནི་རྙེད་པར་དཀའ་བས་ན་༎ འཇིག་རྟེན་པ་ཡི་བློ་ཡིས་ནི་༎
 jñānaṃ tadgocaraṃ nāsti |	དེ་ཡི་སྤྱོད་ཡུལ་ཡེ་ཤེས་མེད་༎
 saṃvṛtiparamārthasatya [deśanā] parivartaḥ pañcamaḥ	ཀུན་རྫོབ་དང་དོན་དམ་པའི་བདེན་པའི་ལེའུ་སྟེ་ལྔ་པའོ་།
 ṣaṭsu jagadgatiṣu bhavasaṅkrāntyupāyo buddhalābhakaropāyaḥ samāptaḥ ||	༎ །འགྲོ་བ་རིགས་དྲུག་ལས་སྲིད་པ་འཕོ་བའི་ཐབས་སངས་རྒྱས་ཐོབ་པར་བྱེད་པའི་ཐབས་རྫོགས་སོ་།
