skt	tib
 || namo buddhaya |	༄༡༢༡ཨ་༅་༎ རྒྱ་གར་སྐད་དུ་། བིགྲ་ཧ་བྱ་བ་རྟ་ནི་བྲི་ཏཏི་། བོད་སྐད་དུ་། རྩོད་པ་བཟློག་པའི་འགྲེལ་པ་། འཇམ་དཔལ་གཞོན་ནུར་གྱུར་པ་ལ་ཕྱག་འཚལ་ལོ་༎
 sarveṣāṃ bhāvānāṃ sarvatra na vidyate svabhāvaś cet |	གལ་ཏེ་དངོས་པོ་ཐམས་ཅད་ཀྱི་༎ རང་བཞིན་ཀུན་ལ་ཡོད་མིན་ན་༎ ཁྱོད་ཀྱི་ཚིག་ཀྱང་རང་བཞིན་མེད་༎
 tvadvacanam asvabhāvaṃ na nivartayitum svabhāvam alaṃ || nagvv_1 ||	རང་བཞིན་བཟློག་པར་མི་ནུས་སོ་༎
 yadi sarveṣāṃ bhāvānāṃ hetau pratyayeṣu ca hetupratyayasāmagrāñ ca pṛthak ca yatra sarvatra svabhāvo na vidyata iti kṛtvā śūnyāḥ sarvabhāvā iti |	གལ་ཏེ་དངོས་པོ་ཐམས་ཅད་ཀྱི་རང་བཞིན་ནི་རྒྱུ་དང་རྐྱེན་དང་། རྒྱུ་དང་རྐྱེན་ཚོགས་པ་དང་ཐ་དད་པ་ཀུན་ལ་ཡོད་པ་མ་ཡིན་པའི་ཕྱིར་དངོས་པོ་ཐམས་ཅད་སྟོང་པ་ཡིན་ཏེ་།
 na hi bije hetubhūte 'ṅkuro sti |	མྱུ་གུ་ནི་རྒྱུ་ས་བོན་དུ་གྱུར་པ་ལ་ཡང་མེད་།
 na pṛthivyaptejovāyvādinām ekekasmin pratyayasaṃjñite |	རྐྱེན་ཞེས་བྱ་བས་དང་ཆུ་དང་མེ་དང་རླུང་ལ་སོགས་པ་རེ་རེ་ལ་ཡང་མེད་།
 na pratyayeṣu samagreṣu na hetupratyayeṣu samagreṣu na hetupratyayasāmagrāṃ na hetupratyayavinirmuktaḥ pṛthag eva vā |	རྐྱེན་འདུས་པ་དག་ལ་ཡང་མེད་། རྒྱུ་དང་རྐྱེན་ཚོགས་པ་དག་ལ་ཡང་མེད་། རྒྱུ་དང་རྐྱེན་ཚོགས་པ་ལས་མ་གཏོགས་པ་ཐ་དད་པ་ལ་ཡང་མེད་དོ་༎
 yasmād atra svabhāvo nāsti tasmān niḥsvabhāvo 'ṅkuraḥ | yasmān niḥsvabhāvaḥ tasmāt śūnyaḥ |	གང་གི་ཕྱིར་རང་བཞིན་འདི་ཐམས་ཅད་ལ་ཡང་མེད་པ་དེའི་ཕྱིར་མྱུ་གུའི་རང་བཞིན་མེད་དེ་དེ་བས་ན་སྟོང་པ་ཡིན་ནོ་༎
 yathā cāyam aṅkuro niḥsvabhāvo niḥsvabhāvāc ca śūnyaḥ tathā sarvabhāvā niḥsvabhāvatvāc chūnya iti | (vv 218) atra vayaṃ brūmaḥ |	ཇི་ལྟར་མྱུ་གུ་རང་བཞིན་མེད་། རང་བཞིན་མེད་པ་ཉིད་ཡིན་པའི་ཕྱིར་། སྟོང་པ་ཡིན་པ་དེ་བཞིན་དུ་དངོས་པོ་ཐམས་ཅད་ཀྱང་རང་བཞིན་མེད་པ་ཉིད་ཡིན་པའི་ཕྱིར་། སྟོང་པ་ཡིན་ནོ་ཞེ་ན་།
 yady evaṃ tavāpi vacanaṃ yady etac chūnyāḥ sarvabhāvā iti tad api śūnyaṃ |	གལ་༄༡༢༡བ་ཏེ་དེ་ལྟ་མ་ཡིན་ན་ནི་དངོས་པོ་ཐམས་ཅད་སྟོང་པ་ཡིན་ནོ་ཞེས་བྱ་བ་གང་ཡིན་པའི་ཁྱོད་ཀྱི་ཚིག་དེ་ཡང་སྟོང་པ་ཡིན་ནོ་༎ ཅིའི་ཕྱིར་ཞེ་ན་།
 kiṃ kāraṇaṃ tad api hetau nāsti | mahābhūteṣu saṃprayukteṣu viprayukteṣu vā pratyayeṣu nāsti |	དེ་ཡང་རྒྱུ་འབྱུང་བ་ཆེན་པོ་རྣམས་དང་མཚུངས་པར་ལྡན་པ་རྣམས་དང་ལྡན་པ་མ་ཡིན་པ་རྣམས་ལ་ཡང་མེད་།
 uraḥkaṇthoṣṭhajihvādantamūlatālunāsikāmūrdhaprabhṛtiṣu yan naivobhayasāmagryām asti |	རྐྱེན་བྲང་དང་། ལྐོག་མ་དང་། མཆུ་དང་། ལྕེ་རྩེ་དང་། སོའི་བྲུན་དང་། རྐན་དང་། སྣ་དང་། སྤྱི་བོ་ལ་སོགས་པ་དང་། འབད་པ་རྣམས་ལ་ཡང་མེད་། གཉི་ག་ཚོགས་པ་ཡང་མེད་། རྒྱུ་དང་རྐྱེན་ཚོགས་པ་ལ་ཡང་མེད་།
 hetupratyayasamagrīvinirmuktaṃ pṛthag eva vā nāsti | yasmād atra sarvatra nāsti |	རྒྱུ་དང་རྐྱེན་ཚོགས་པ་ལས་མ་གཏོགས་པ་ཐ་དད་པ་ཡང་མེད་དོ་༎
 tasmān niḥsvabhāvaṃ |	གང་གི་ཕྱིར་འདི་ཐམས་ཅད་ལ་མེད་པའི་ཕྱིར་འདི་རང་བཞིན་མེད་པ་ཡིན་ཏེ་།
 yasmān niḥsvabhāvaṃ | tasmāc chūnyaṃ |	རང་བཞིན་མེད་པའི་ཕྱིར་སྟོང་པ་ཡིན་ནོ་༎
 tasmād anena sarvabhāvasvabhāvavyavartanam aśakyaṃ kartuṃ | kiṃ kāraṇaṃn |	དེ་ལྟ་བས་ན་འདིས་དངོས་པོ་ཐམས་ཅད་ཟློག་པར་བྱེད་མི་ནུས་སོ་༎
 na hy asadagninā dagdhaṃ |	མེ་མེད་པས་ཀྱང་སྲེག་པར་བྱེད་མི་ནུས་སོ་༎
 nāpy asatā śāstreṇa śakyaṃ chettuṃ |	མཚོན་ཆ་མེད་པས་ཀྱང་གཅད་པར་མི་ནུས་ཤིང་ཆུ་མེད་པས་ཀྱང་བངས་པར་མི་ནུས་པ་དེ་བཞིན་དུ་ཚིག་མེད་པས་ཀྱང་།
 nāsatībhir atbhiḥ śakyaṃ kledayitum evam asattā vacanena śakyaḥ sarvabhāvasvabhāvapratiṣedhaḥ kartuṃ na śakyaḥ sarvabhāvasvabhāvo nivartayituṃ tatra yad uktaṃ sarvabhāvasvabhāvaḥ pratiṣidhaḥ sarvatra bhāvasvabhāvo vinivartata iti | tan na || (vv 220)	དངོས་པོ་ཐམས་ཅད་ཀྱི་རང་བཞིན་ཟློག་པར་བྱེད་མི་ནུས་པས་དེ་ལ་དངོས་པོ་ཐམས་ཅད་ཀྱི་རང་བཞིན་བཀག་གོ་ཞེས་སྨྲས་པ་གང་ཡིན་པ་དེ་མི་རུང་ངོ་༎
 atha sasvabhāvam etad vākyaṃ pūrvā hata pratijñā te |	འོན་ཏེ་ཚིག་དེ་རང་བཞིན་བཅས་༎ ཁྱོད་ཀྱིས་དམ་བཅས་སྔ་མ་ཉམས་༎ མི་འདྲ་ཉིད་དེ་དེ་ཡིན་ན་༎
 vaiṣamikatvaṃ tasmin viśeṣahetuś ca vaktavyaḥ || nagvv_2 ||	གཏན་ཚིགས་ཁྱད་པར་བརྗོད་པར་བྱོས་༎
 athāpi manyase mā bhūd eṣa doṣa iti sasvabhāvam etad vākyaṃ |	འོན་ཏེ་སྐྱོན་དེར་གྱུར་ན་མི་རུང་ངོ་སྙམ་ནས་ངའི་ཚིག་དེ་ནི་རང་བཞིན་དང་བཅས་པ་ཡིན་ཏེ་། 
 sasvabhāvatvāc cāśūnyaṃ |	དེའི་ཕྱིར་སྟོང་པ་མ་ཡིན་ནོ་༎
 tasmād anena sarvabhāvasvabhāvaḥ pratiṣiddhaḥ sarvabhāvasvabhāvo vinivarta iti || atra brūmaḥ |	དེ་བས་ན་འདིས་ནི་དངོས་པོ་ཐམས་ཅད་ཀྱི་རང་བཞིན་བཀག་གོ་སྙམ་དུ་སེམས་ན་།
 yā hi te pratijñā śūnyāḥ svabhāvā iti | hatā śā || kiñcānyat sarvabhāvāntargatañ ca tadvacanam |	འོ་ན་དེ་ལྟར་ཡིན་ན་ནི་དངོས་པོ་ཐམས་ཅད་ནི་སྟོང་པ་ཡིན་ནོ་ཞེས་སྔར་དམ་བཅས་པ་གང་ཡིན་པ་དེ་ཉམས་པ་ཡིན་ནོ་༎ འདི་ལྟར་གཞན་ཡང་ཐམས་ཅད་ཀྱི་ནང་དུ་ནི་ཁྱོད་ཀྱི་ཚིག་ཀྱང་འདུས་པ་ཡིན་ན་།
 kasmāt sarvabhāveṣu tvadvacanam aśūnyaṃ yenāśūnyatvāt sarvabhāvasvabhāvaḥ pratiṣiddhaḥ ||	ཅིའི་ཕྱིར་དངོས་པོ་ཐམས་ཅད་སྟོང་བ་ཡིན་བཞིན་དུ་འདི་ལྟར་སྟོང་པ་ཉིད་མ་ཡིན་པའི་ཕྱིར་དེས་དངོས་པོ་ཐམས་ཅད་རང་བཞིན་བཀག་གོ་ཞེས་བྱ་བའི་ཁྱོད་ཀྱི་ཚིག་སྟོང་པ་མ་ཡིན་པར་འགྱུར་། 
 evaṃ ṣaṭkoṭiko vādaḥ prasaktaḥ |	དེ་ལྟ་ན་ནི་སྨྲས་པ་མུ་དྲུག་ཏུ་ཐལ་བར་འགྱུར་རོ་༎
 sa punaḥ katham iti |	དེ་ཡང་ཇི་ལྟ་བུ་ཞེ་ན་།
 hanta cet punaḥ śūnyāḥ sarvahhāvās tena tvadvacanaṃ śūnyam sarvabhāvāntargatatvāt tvadvacanasya |	འོན་ཀྱང་གལ་ཏེ་དངོས་པོ་ཐམས་ཅད་སྟོང་པ་ཡིན་ནོ་ཞེ་ན་ཁྱོད་ཀྱི་ཚིག་ཀྱང་སྟོང་པ་ཡིན་ཏེ་། ཐམས་ཅད་ཀྱི་ནང་དུ་༄༡༢༢ཨ་༌་༎ འདུས་པའི་ཕྱིར་༎
 tena śūnyena pratiṣedhānupapattiḥ | tatra yaḥ pratiṣedhaḥ śūnyāḥ sarvabhāva iti anupapannaḥ | 1 |	སྟོང་པ་དེས་པ་ནི་དགག་པ་མི་འཐད་པས་དེ་ལ་དངོས་པོ་ཐམས་ཅད་ནི་སྟོང་པ་ཡིན་ནོ་ཞེས་དགག་པ་གང་ཡིན་པ་དེ་འཐད་པ་མ་ཡིན་ནོ་༎ 
 upapannaś cet punaḥ śūnyāḥ sarvabhāvā iti pratiṣedhas tena tvadvacanaśūnyatvād anena pratiṣedho anupapannaḥ | 2 |	གལ་ཏེ་འཐད་པ་ཡིན་ནོ་ཞེ་ན་། དངོས་པོ་ཐམས་ཅད་ནི་སྟོང་པ་ཡིན་ཞེས་བཀག་པས་དེས་ན་ཁྱོད་ཀྱི་ཚིག་ཀྱང་སྟོང་པ་ཡིན་ལ་། སྟོང་པ་ཉིད་ཡིན་པའི་ཕྱིར་དེས་ནི་འགོག་པ་མི་འཐད་དོ་༎
 atha śūnyāḥ sarvabhāvās tvadvacanañ cāśūnyaḥ yena pratiṣedhas tena tvadvacanaṃ sarvatrāsaṃgṛhītaṃ |	གལ་ཏེ་དངོས་པོ་ཐམས་ཅད་ནི་སྟོང་པ་ཡིན་ལ་། གང་གིས་འགོག་པར་བྱེད་པ་ཁྱོད་ཀྱི་ཚིག་ནི་སྟོང་པ་མ་ཡིན་ནོ་ཞེ་ན་། དེས་ན་ཁྱོད་ཀྱི་ཚིག་ཐམས་ཅད་ཀྱི་ནང་དུ་མ་འདུས་པ་ཡིན་ཏེ་།
 (vv 222) tatra dṛṣṭāntavirodhaḥ | 3 |	དེ་ལ་འགལ་བའི་དཔེར་འགྱུར་རོ་༎
 sarvatra cet punaḥ gṛhītaṃ tvadvacanaṃ sarvabhāvāś ca śūnyāḥ |	གལ་ཏེ་ཐམས་ཅད་ཀྱི་ནང་དུ་ཁྱོད་ཀྱི་ཚིག་བསྡུས་སོ་ཞེ་ན་།
 tena tad api śūnyaṃ śūnyatvād anena nāsti pratiṣedhaḥ | 4 |	དངོས་པོ་ཐམས་ཅད་སྟོང་པ་ཡིན་པས་དེས་ན་དེ་ཡང་སྟོང་པ་ཡིན་ནོ་༎ དེའི་ཕྱིར་འདིས་འགོག་པ་མེད་དོ་༎
 atha śūnyam asti vānena pratiṣedhaḥ śūnyaḥ sarvabhāvā iti tena śūnyāpi sarvabhāvāḥ kāryakriyāsamarthā samarthabhaveyuḥ | na caitad iṣṭaṃ | 5 |	གལ་ཏེ་སྟོང་པ་ཡིན་ཡང་དངོས་པོ་ཐམས་ཅད་ནི་སྟོང་པའོ་ཞེས་འདིས་འགོག་པ་ཡོད་དོ་ཞེ་ན་། དེས་ན་དངོས་པོ་ཐམས་ཅད་སྟོང་པ་ཡིན་ཡང་བྱ་བ་བྱེད་ནུས་པར་འགྱུར་ཏེ་དེ་ནི་འདོད་པ་མ་ཡིན་ནོ་༎
 atha śūnyāḥ sarvabhāvāḥ na ca kāryaṃ kriyāsamarthaṃ bhavaṃti mā bhūt dṛṣṭāntavirodha iti kṛtvā śūnyena tvadvacanena sarvabhāvāsvabhāvo pratiṣedho nopapanna iti | 6 | kiñcānyat | evaṃ tadastitvāt vaiṣamikatvaprasaṅgaḥ |	གལ་ཏེ་འགལ་བའི་དཔེར་གྱུར་ནས་མི་རུང་ངོ་སྙམ་ནས་དངོས་པོ་ཐམས་ཅད་སྟོང་པ་ཡིན་ཏེ་བྱ་བ་བྱེད་མི་ནུས་སོ་ཞེ་ན་། ཁྱོད་ཀྱི་ཚིག་སྟོང་བས་ཀྱང་དངོས་པོ་ཐམས་ཅད་ཀྱི་རང་བཞིན་འགོག་པར་མི་འཐད་དོ་༎ ཇི་ལྟར་གཞན་ཡང་དེ་སྐད་ཟེར་ན་ནི་ཁ་ཅིག་ནི་སྟོང་།
 kiñcit śūnyaṃ kiñcid aśūnyam iti | tasmiṃś ca vaisamikatve viśeṣahetur vaktavyaḥ |	ཁ་ཅིག་ནི་མི་སྟོང་ངོ་ཞེས་མི་འདྲ་བ་ཉིད་དུ་ཐལ་བར་འགྱུར་རོ་༎
 yena hi viśeṣahetunā kiñcit śūnyaṃ kiñcid aśūnyaṃ syāt | sa ca nopadiṣṭo hetuḥ | tatra yad uktaṃ śūnyāḥ sarvabhāvā iti tan na || (vv 224)	མི་འདྲ་བ་ཉིད་ཡིན་ན་ནི་གང་གིས་ན་ཁ་ཅིག་ནི་སྟོང་ཁ་ཅིག་ནི་མི་སྟོང་པར་གྱུར་པའི་གཏན་ཚིགས་ཀྱི་ཁྱད་པར་ཡང་སྨྲོས་ཤིག་། གཏན་ཚིགས་དེ་ཡང་མ་བརྟན་པས་དེ་ལ་དངོས་པོ་ཐམས་ཅད་ནི་སྟོང་པའོ་ཞེས་སྨྲས་པ་གང་ཡིན་པ་དེ་མི་རུང་ངོ་༎
 kiñcānyat	འདི་ལྟར་གཞན་ཡང་།
 mā śabdavad ity etat syāt te buddhir na caitad upapannam |	དེ་སྒྲ་མ་འབྱིན་ལྟ་བུའོ་ཞེས་། ཁྱོད་བློ་སེམས་ན་དེ་མི་འཐད་༎
 śabdenātra satā bhaviṣyato vāraṇaṃ tasya || nagvv_3 ||	འདི་ལ་སྒྲ་ནི་ཡོད་པ་ཡིས་༎ འབྱུང་བར་འགྱུར་བ་དེ་བཟློག་ཡིན་༎
 syāt te buddhiḥ yathā nāma kaścit brūyāt mā śabdaṃ kārṣīr mā śabdaṃ kārṣīr iti |	དཔེར་ན་ཁ་ཅིག་ན་རེ་སྒྲ་མ་འབྱིན་ཅིག་ཅེས་བདག་ཉིད་སྒྲ་འབྱིན་ཏེ་།
 tena ca śabdena vyāvartanaṃ kriyate |	སྒྲ་དེས་སྒྲ་ཟློག་པར་བྱེད་དོ་༎
 evam eva śūnyāḥ sarvabhāvā iti | śūnyena vacanena sarvatā sarvabhāvasvabhāvavyāvartanaṃ kriyata iti |	དེ་བཞིན་དུ་དངོས་པོ་ཐམས་ཅད་ནི་སྟོང་པ་ཞེས་སྟོང་པའི་རང་བཞིན་གྱི་ཚིག་གིས་དངོས་པོ་ཐམས་ཅད་ཀྱི་རང་བཞིན་ཟློག་པར་བྱེད་དོ་སྙམ་ན་། 
 atra vayaṃ brūmaḥ |	འདིར་སྨྲས་པ་།
 etad apy anupapannaṃ kiṃ kāraṇaṃ |	དེར་ཡང་འཐད་པ་མ་༄༡༢༢བ་ཡིན་ཏེ་།
 satā hy atra śabdena hy atra bhaviṣyataḥ śabdasya pratiṣedhaḥ kriyate |	འདི་ལ་སྒྲ་ཡོད་པས་སྒྲ་འབྱུང་བར་འགྱུར་བ་འགོག་པར་བྱེད་པ་ཡིན་གྱི་།
 na punar iha bhavataḥ satā vacanena sarvabhāvasvabhāvapratiṣedhaḥ kriyate | tava hi matena vacanam apy asat | sarvabhāvasvabhāvo 'py asat |	འདིར་ནི་ཁྱོད་ཀྱི་ཡོད་པའི་ཚིག་གིས་དངོས་པོ་ཐམས་ཅད་ཀྱི་རང་བཞིན་འགོག་པར་མི་བྱེད་དེ་། ཁྱོད་ཀྱི་ལུགས་ཀྱི་ཚིག་ཀྱང་ཡོད་པ་མ་ཡིན་།
 tasmād ayaṃ mā śabdavad iti viṣayopanyāso 'sann iti || (vv 226) kiñca pratipratiṣedhyo 'py evam iti mataṃ bhavet tad asad eva |	དངོས་པོ་ཐམས་ཅད་ཀྱི་རང་བཞིན་ཡང་ཡོད་པ་མ་ཡིན་པས་དེའི་ཕྱིར་སྒྲ་མ་འབྱིན་ཞེས་པ་ལྟ་བུའོ་ཞེས་བྱ་བ་འདི་ནི་མི་མཐུན་པར་སྒྲ་སྨྲས་པ་ཡིན་ནོ་༎ འགོག་པའི་འགོག་པའང་དེ་ལྟ་ཞེས་༎ འདོད་ན་དེ་ཡང་བཟང་མིན་ཏེ་༎
 evaṃ tava pratijña lakṣaṇato dūṣyate na mama || nagvv_4 ||	དེ་ལྟ་བས་ནའང་ཁྱོད་དམ་བཅས་༎ མཚན་ཉིད་སྐྱོན་ཡོད་ངེད་ལ་མེད་༎ ཁྱོད་ཀྱི་བློ་ལ་རྣམ་།
 syāt te buddhiḥ pratiṣedhaḥ pratiṣedhyo 'py anenaiva kalpenānupapannaḥ |	པ་འདི་ཉིད་ཀྱིས་འགོག་པའི་འགོག་པ་ཡང་མི་འཐད་དེ་།
 tatra yad bhavān sarvabhāvasvabhāvapratiṣedhaśūcanaṃ pratiṣedhayati | tad anupapannam iti |	དེ་ལ་ཁྱོད་ཀྱིས་དངོས་པོ་ཐམས་ཅད་ཀྱི་རང་བཞིན་འགོག་པའི་ཚིག་འགོག་པར་བྱེད་པའི་ཚིག་གང་ཡིན་པ་དེ་ཡང་མི་འཐད་དོ་སྙམ་དུ་སེམས་ན་། 
 atra vayaṃ brūmaḥ | etad aśabdena sad eva |	འདིར་སྨྲ་བར་བྱ་སྟེ་། དེ་ཡང་བཟང་པོ་མ་ཡིན་ཏེ་། དེ་ཅིའི་ཕྱིར་ཞེ་ན་།
 kasmāt tava ca hi pratijñālakṣaṇaprāptam etan na mama bhavān iha bravīti | śūnyāḥ sarvabhāvā iti nāhaṃ | tasmāt tvatpratijñān na(?)payāmi | pūrvakaḥ pakṣo na mama |	ཁྱེད་ལ་ནི་དམ་བཅས་པའི་མཚན་ཉིད་ཀྱིས་འདི་འཐོབ་ཀྱི་།
 tatra yad uktaṃ pratiṣedhaḥ pratiṣedhyo 'py evaṃ matam iti | upapannaṃm iti || tan na | (vv 228) kiñcānyat |	ངེད་ལ་ནི་མེད་པས་དེ་ལྟ་ཡིན་ན་ནི་འགོག་པའི་འགོག་པ་ཡང་འཐད་པ་མ་ཡིན་ནོ་ཞེས་སྨྲས་པ་གང་ཡིན་པ་དེ་མི་རུང་ངོ་༎ འདི་ལྟར་གཞན་ཡང་།
 pratyakṣeṇa hi tāvad yady upalabhya vinivartayasi bhāvān |	རེ་ཞིག་དངོས་རྣམས་མངོན་སུམ་གྱིས་༎ དམིགས་ནས་ཟློག་པར་བྱེད་མིན་ན་༎
 tan nāsti pratyakṣaṃ bhāvā yenopalabhyante || nagvv_5 ||	གང་གིས་དངོས་རྣམས་དམིགས་འགྱུར་བ་༎ མངོན་སུམ་དེ་ནི་མེད་པ་ཡིན་༎
 yadi pratyakṣataḥ sarvabhāvān upalabhya bhavān nivartayati śūnyāḥ sarvabhāvā iti |	གལ་ཏེ་ཁྱོད་ཀྱིས་དངོས་པོ་ཐམས་ཅད་མངོན་སུམ་གྱི་དམིགས་ནས་དངོས་པོ་ཐམས་ཅད་ནི་སྟོང་པའོ་ཞེས་ཟློག་པར་བྱེད་ན་ནི་མི་རུང་ངོ་༎
 tad anupapannaṃ |	དེ་ཡང་འཐད་པ་མ་ཡིན་ཏེ་།
 kasmāt pratyakṣam api hi pramāṇaṃ svabhāvāntargatatvāt śūnyaṃ |	ཅིའི་ཕྱིར་ཞེ་ན་༏་དངོས་པོ་ཐམས་ཅད་ཀྱི་ནང་དུ་ནི་མངོན་སུམ་གྱི་ཚད་མ་ཡང་འདུས་པའི་ཕྱིར་སྟོང་པ་ཡིན་ལ་། 
 yo 'pi sarvabhāvān upalabhate so 'pi śūnyas tasmāt pratyakṣeṇa pramāṇena nopalambhabhāvo anupalabdhasya ca pratiṣedhānupapattiḥ śūnyaḥ sarvabhāvā iti | tad anupapannaṃ (vv 230) syāt te buddhiḥ |	དངོས་པོ་ལ་དམིགས་པར་བྱེད་པ་གང་ཡིན་པ་དེ་ཡང་སྟོང་པ་ཡིན་ནོ་༎ དེའི་ཕྱིར་མངོན་སུམ་གྱི་ཚད་མས་དམིགས་པ་མེད་དོ་༎
 anumānenāgamenopānena vā sarvabhāvān upalabhya sarvabhāvavyāvartanaṃ kriyata iti || atra brūmaḥ |	མི་དམིགས་པ་འགོག་པ་ཡང་མི་འཐད་པས་དེ་ལ་དངོས་པོ་ཐམས་ཅད་ནི་སྟོང་པའོ་ཞེས་སྨྲས་པ་གང་ཡིན་པ་དེ་འཐད་པ་མ་ཡིན་ནོ་༎ འོན་ཏེ་ཁྱོད་ཀྱི་བློ་ལ་རྗེས་སུ་དཔག་པ་དང་ལུང་དང་དཔེས་སེམས་འཇལ་བས་དམིགས་ནས་དངོས་པོ་འདི་ཐམས་ཅད་ཟློག་པར་བྱེད་དོ་སྙམ་དུ་སེམས་ན་འདིར་སྨྲ་བར་བྱ་སྟེ་།
 anumānaṃ pratyuktaṃ pratyakṣeṇāgamopamāne ca |	རྗེས་དཔག་ལུང་དང་༄༡༢༣ཨ་༌་༎
 anumānāgamasādhyā ye 'rthā dṛṣṭāntasādhyāś ca || nagvv_6 ||	དཔེས་འཇལ་དང་༎ རྗེས་དཔག་ལུང་གིས་བསྒྲུབ་བྱ་དང་༎ དཔེས་བསྒྲུབ་བྱ་བའི་དོན་གང་ཡིན་༎
 anumānam apy upamānāgamāś ca pratyakṣeṇa pramāṇena pratyuktāḥ |	མངོན་སུམ་གྱིས་ནི་ལན་བཏབ་པོ་༎ རྗེས་སུ་དཔག་པ་དང་། དཔེས་འཇལ་བ་དང་། ལུང་ཡང་མངོན་སུམ་གྱི་ཚད་མས་ལན་བཏབ་པ་ཡིན་ཏེ་།
 yathā hi pratyakṣaṃ pramāṇaṃ śūnyaṃ sarvabhāvānāṃ śūnyatvāt |	འདི་ལྟར་མངོན་སུམ་གྱི་ཚད་མ་ནི་སྟོང་པ་ཡིན་ཏེ་། དངོས་པོ་ཐམས་ཅད་སྟོང་པ་ཉིད་ཡིན་པའི་ཕྱིར་རོ་༎
 evam anumānamopamāgamāpi śūnyāḥ |	དེ་བཞིན་དུ་རྗེས་སུ་དཔག་པ་དང་། དཔེས་འཇལ་བ་དང་། ལུང་ཡང་སྟོང་པ་ཡིན་ཏེ་།
 sarvabhāvānāṃ śūnyatvāt |	དངོས་པོ་ཐམས་ཅད་སྟོང་པ་ཉིད་ཡིན་པའི་ཕྱིར་རོ་༎
 ye 'py anumānasādhyārthā āgamasādhyā upamānasādhyāś ca |	རྗེས་སུ་དཔག་པས་བསྒྲུབ་པར་བྱ་བའི་དོན་དང་། ལུང་གིས་བསྒྲུབ་པར་བྱ་བ་དང་། དཔེས་བསྒྲུབ་བར་བྱ་བ་གང་ཡིན་པ་དེ་དག་ཀྱང་སྟོང་པ་མ་ཡིན་ཏེ་།
 te 'pi śūnyāḥ sarvabhāvānāṃ śūnyatvāt* anumānopamānāgamaiś ca yo 'pi bhāvān upalabhate so 'pi śūnyaḥ tasmāt bbāvānām upalambhābhāvo 'nupalabdhānāñ ca svabhāvapratiṣedhānupapattiḥ |	དངོས་པོ་ཐམས་ཅད་སྟོང་པ་ཉིད་ཡིན་པའི་ཕྱིར་རོ་༎ རྗེས་སུ་དཔག་པ་དང་། ལུང་དང་། དཔེས་འཇལ་བ་དག་གིས་དངོས་པོ་རྣམས་ལ་དམིགས་པར་བྱེད་པ་གང་ཡིན་པ་དེ་ཡང་སྟོང་པ་ཉིད་ཡིན་ཏེ་། དེའི་ཕྱིར་དངོས་པོ་རྣམས་དམིགས་པ་མེད་དོ་༎
 tatra yad uktaṃ śūnyāḥ sarvabhāvā iti | tan na || (vv 232)	མི་དམིགས་པའི་རང་བཞིན་འགོག་པ་མི་འཐད་པས་དེ་ལ་དངོས་པོ་ཐམས་ཅད་ནི་སྟོང་པའོ་ཞེས་སྨྲས་པ་གང་ཡིན་པ་དེ་མི་རུང་ངོ་༎
 kiñcānyat |	འདི་ལྟར་གཞན་ཡང་།
 kuśalānāṃ dharmāṇāṃ dharmāvasthavidaś ca manyante |	སྐྱེ་བོ་ཆོས་ཀྱི་གནས་སྐབས་མཁས་༎ དགེ་བ་དག་གི་ཆོས་རྣམས་ལ་༎
 kuśalaṃ janasvabhāvaṃ śeṣeṣv apy eṣa viniyogaḥ || nagvv_7 ||	དགེ་བའི་རང་བཞིན་ཡིན་པར་ནི་༎ སེམས་ཤིང་ལྷག་མ་རྣམས་ལ་ཡང་༎
 iha dharmāvasthāvido manyante kuśalānāṃ dharmāṇām ekonaviṃśaṃ śataṃ |	འདི་ལ་སྐྱེ་བོ་ཆོས་ཀྱི་གནས་སྐབས་ལ་མཁས་པ་རྣམས་ནི་དགེ་བའི་ཆོས་རྣམས་ལ་བརྒྱ་རྩ་བཅུ་དགུར་སེམས་ཏེ་།
 tadyathā ekadeśo vijñānasya vedanāyāḥ | saṃjñāyāś cetanāyāḥ |	འདི་ལྟ་སྟེ་།
 sparśasya manasikārasya chandasyādhimokṣasya vīryasya smṛteḥ samādheḥ prajñāyā upekṣāyāḥ prayogasya saṃprayogasya prāpto 'dhyāśayasya prativirateḥ vyavasāyā autsukyasya | unmūrdhe utsāhasya avyārtyasya vasitāyāḥ pratipatter avipratīsārasya dhṛter adhyavasāyasya | anaukṣekasya ananumūḍhyanutsārasya | prāpaṇāyāḥ praṇidheḥ madasya viṣayānāṃ viprayogasya | aniryāṇikatāyā utsādasya | sthiter anityatāyāḥ samarthāgatasya jarāyāḥ paridrāsyatārateḥ | vitarkānāṃ prīteḥ pramādasya aprasrabdheḥ | vyavahāratāyāḥ | prekṣupratikūlasya pradakṣiṇagrāhasya vaiśāradyagauravasya citrīkārasya (vv 234) bhakter abhakteḥ suśrūṣāyāḥ sādarasyānādarasya prasrabdheḥ | hāsasya vācaḥ viṣpandanāyāḥ siddhasyāprasādasya aprasrabdheḥ vyavahāratāyaḥ | dākṣyasya sauratyasya vipratisārasya śokasya | upāyāsāyas vītasya | apradakṣiṇagrāhasya saṃepasya saṃvarāṇāṃ pariśuddher adhyāśayasya rūpasyeti | śraddhā hrīr ārjavam avañcanaṃ | upasama acāmala saprasādamārdavaṃ pratisaṃkhyānaṃ nirveda 'paridāhaḥ | amada alobha adoṣa amoha asarvat* apratiniḥsargaḥ vibhava apatrayā apariśucchadanaṃ mānanaṃ kāruṇyaṃ maitrī adīnatādaritamari|(d) ha + + nupanāhaḥ alī cetaso paryādānaṃ kṣāntiḥ | vyavasadu āsaurakyam iti bhāgānvayaṃ | puṇyaṃ | asaṃjñisamāpattiḥ |	རྣམ་པར་ཤེས་པ་དང་། ཚོར་བ་དང་། འདུ་ཤེས་དང་། སེམས་པ་དང་། རེག་པ་དང་། ཡིད་ལ་བྱེད་པ་དང་། འདུན་པ་དང་། མོས་པ་དང་། བརྩོན་འགྲུས་དང་། དྲན་པ་དང་། ཏིང་ངེ་འཛིན་དང་། ཤེས་རབ་དང་། བཏང་སྙོམས་དང་། སྦྱོར་བ་དང་། ཡང་དག་པར་སྦྱོར་བ་དང་། ཐོབ་པ་དང་། ལྷག་པའི་བསམ་པ་དང་། ཁོང་ཁྲོ་བ་མེད་པ་དང་། དགའ་བ་དང་། འབད་པ་དང་། རྩོལ་བ་དང་། རྨོངས་པ་མེད་པ་དང་། སྤྲོ་བ་དང་། གནོད་པ་མེད་པ་དང་། དབང་དང་ལྡན་པ་དང་། ཁོང་ཁྲོ་དང་། ཡིད་ལ་གཅགས་པ་མེད་པ་དང་། ༄༡༢༣བ་འཛིན་པ་དང་། མི་འཛིན་པ་དང་། དྲན་པ་དང་། བརྟན་པ་དང་། ལྷག་པར་ཞེན་པ་དང་། རྨོངས་འབྲེལ་དང་། སྤྲོ་བ་མེད་པ་དང་། དོན་དུ་གཉེར་བ་དང་། སྨོན་ལམ་དང་། རྒྱགས་པ་དང་། ཡུལ་དང་མི་ལྡན་པ་དང་། ངེས་པར་འབྱིན་པ་མ་ཡིན་པ་དང་། སྐྱེ་བ་དང་། གནས་པ་དང་མི་རྟག་པ་དང་། རྒ་བ་དང་། ལྡན་པ་དང་། ཡོངས་སུ་གདུངས་པ་དང་། མི་དགའ་བ་དང་། རྟོག་པ་དང་། སྡུག་པ་དང་། དང་བ་དང་། འདོད་པ་དང་། མི་མཐུན་པ་དང་། མཐུན་པར་འཛིན་པ་དང་། རྗེས་སུ་མི་མཐུན་པར་བཟུང་བ་དང་། མི་འཇིགས་པ་དང་། ཞེས་དང་། རི་མོར་བྱེད་པ་དང་། དད་པ་དང་། མ་དད་པ་དང་། བསྒོ་བ་བཞིན་བྱེད་པ་དང་། གུས་པ་དང་། མ་གུས་པ་དང་། རྒོད་པ་དང་། ཤིན་ཏུ་སྦྱངས་པ་དང་། ངག་དང་། འགུལ་བ་དང་། གྲུབ་པ་དང་། མ་དང་བ་དང་། ཤིན་ཏུ་མ་སྦྱངས་པ་དང་། རྣམ་པར་བྱང་བ་དང་། བརྟན་པ་དང་། དེས་པ་དང་། ཡིད་ལ་གཅགས་པ་དང་། མྱ་ངན་དང་། འཁྲུགས་པ་དང་། རྒྱགས་པ་དང་། མི་མཐུན་པར་འཛིན་པ་དང་། ཐེ་ཚོམ་དང་། སྡོམ་པ་དང་། ཡོངས་སུ་དག་པ་དང་། ནང་ལེགས་པར་དང་བ་དང་། འཇིགས་པའི་ཕྱོགས་གཅིག་དང་། དད་པ་དང་། ངོ་ཚ་ཤེས་པ་དང་། གནམ་པ་དང་། མི་འདྲིད་པ་དང་། ཉེ་བར་ཞི་བ་དང་། རྟབ་བག་མ་ཡིན་པ་དང་། བག་ཡོད་པ་དང་། བྱམས་པར་ལྟ་བ་དང་། སོ་སོར་བརྟག་པ་དང་། ཡིད་བྱུང་བ་དང་། ཡོངས་སུ་གདུངས་པ་མེད་པ་དང་། རྒྱགས་པ་མེད་པ་དང་། ཆགས་པ་མེད་པ་དང་། ཞེ་སྡང་མེད་པ་དང་། གཏི་མུག་མེད་པ་དང་། ཐམས་ཅད་ཤེས་པ་ཉིད་དང་། མི་གཏོང་བ་དང་། འབྱོར་བ་དང་། ཁྲེལ་ཡོད་པ་དང་། མི་འཆབ་པ་དང་། སྙིང་རྗེ་དང་། སེམས་པ་མི་གཏོང་བ་དང་། བྱམས་པ་དང་། ཞུམ་པ་མེད་པ་དང་། དགའ་བྲལ་བ་དང་། རྫུ་འཕྲུལ་དང་། ཁོན་དུ་མི་འཛིན་པ་དང་། ཕྲག་དོག་མེད་པ་དང་། སེམས་ཡོངས་སུ་གདུག་པ་མེད་པ་དང་། བཟོད་པ་དང་། རྣམ་པར་སྤངས་བ་དང་། དེས་པ་མ་ཡིན་པ་དང་། ཡོངས་སུ་ལོངས་སྤྱོད་པའི་རྗེས་སུ་མཐུན་པ་དང་། བསོད་ནམས་དང་། འདུ་ཤེས་པའི་སྙོམས་པར་འཇུག་པ་དང་། ངེས་པར་འབྱིན་པ་ཉིད་དང་། ཐམས་ཅད་མི་ཤེས་པ་ཉིད་དང་། འདུས་༄༡༢༤ཨ་༌་༎
 nairyāṇikatāsarvajñatāsaṃskṛtā dharmāḥ ity ekonaviṃśaṃ śataṃ kuśalānāṃ kuśalaḥ svabhāvaḥ || (vv 236)	མ་བྱས་པའི་ཆོས་སོ་ཞེས་དེ་ལྟར་དགེ་བའི་ཆོས་རྣམས་ལ་དགེ་བའི་རང་བཞིན་བརྒྱ་རྩ་བཅུ་དགུ་དང་། 
 tathākuśalānām akuśalaḥ svabhāvaḥ | nivṛttāvyākṛtaḥ | prakṛtāvyākṛtānāṃ prakṛtāvyākṛtaḥ | kāmoktānāṃ kāmoktaḥ | rūpoktānāṃ rūpoktaḥ | ārūpyoktānām ārūpyoktaḥ | anāśravāṇām anāśravaḥ | duḥkhoktānāṃ duḥkhoktaḥ | samudayoktānāṃ samudayoktaḥ |	དེ་བཞིན་དུ་མི་དགེ་བའི་ཆོས་རྣམས་པ་མི་དགེ་བའི་རང་བཞིན་དང་། བསྒྲིབས་ལ་ལུང་དུ་མ་བསྟན་པ་རྣམས་ལ་བསྒྲིབས་ལ་ལུང་དུ་མ་བསྟན་པའི་རང་བཞིན་དང་། མ་བསྒྲིབས་ལ་ལུང་དུ་མ་བསྟན་པ་རྣམས་ལ་མ་བསྒྲིབས་ལ་ལུང་དུ་མ་བསྟན་པའི་རང་བཞིན་དང་། 
 nirodhoktānāṃ nirodhoktaḥ | mārgoktānāṃ mārgoktaḥ | bhāvanāprahātavyānāṃ bhāvanāprahātavyaḥ | aprahātavyānām aprahātavyaḥ | prahātavyānāṃ prahātavyaḥ |	འདོད་པར་གསུངས་པ་རྣམས་ལ་འདོད་པར་གསུངས་པ་དང་། གཟུགས་སུ་གསུངས་པ་རྣམས་ལ་གཟུགས་སུ་གསུངས་པ་དང་། གཟུགས་མེད་པར་གསུངས་པ་རྣམས་ལ་གཟུགས་མེད་པར་གསུངས་པ་དང་། ཟག་པ་མེད་པ་རྣམས་ལ་ཟག་པ་མེད་པ་དང་། སྡུག་བསྔལ་དང་། ཀུན་འབྱུང་བ་དང་། འགོག་པ་དང་། ལམ་ཞེས་བྱ་བ་རྣམས་ལ་སྡུག་བསྔལ་དང་། ཀུན་འབྱུང་བ་དང་། འགོག་པ་དང་། ལམ་ཞེས་བྱ་བའི་རང་བཞིན་དང་། བསྒོམས་པས་སྤང་བར་བྱ་བ་རྣམས་ལ་བསྒོམས་པས་སྤང་བར་བྱ་བ་དང་། སྤང་བར་བྱ་བ་མ་ཡིན་པ་རྣམས་ལ་སྤང་བར་བྱ་བ་མ་ཡིན་པའི་རང་བཞིན་དུ་སེམས་ཏེ་། 
 yasmād evam anekaprakāro dharmasvabhāvo dṛṣṭaḥ | tasmād iha yad uktaṃ | niḥsvabhāvāḥ sarvabhāvāḥ niḥsvabhāvatvāt śūnya iti tan na |	དེའི་ཕྱིར་དེ་ལྟར་ན་རྣམ་པ་དུ་མའི་ཆོས་ཀྱི་རང་བཞིན་མཐོང་བས་དེ་བས་ན་དངོས་པོ་ཐམས་ཅད་ནི་རང་བཞིན་མེད་པ་སྟེ་ཏེ་། ། རང་བཞིན་མེད་པ་ཉིད་ཡིན་པའི་ཕྱིར་སྟོང་པའོ་ཞེས་སྨྲས་པ་གང་ཡིན་པ་དེ་ཏེ་། 
 (vv 238)	། མི་རུང་ངོ་༎ 
 kiñcānyat | nairyāṇikasvabhāvo dharmo nairyāṇikāś ca ye teṣāṃ |	འདི་ལྟར་གཞན་ཡང་།
 dharmāvasthoktānām eva ca nairyāṇikādīnāṃ || nagvv_8 ||	ངེས་འབྱིན་ལ་སོགས་རྣམས་ཀྱི་ཆོས་༎ གནས་སྐབས་གསུངས་པ་དེ་རྣམས་ལ་༎
 iha ca dharmo 'vasthoktānāṃ nairyāṇikānāṃ dharmāṇāṃ niryāṇikaḥ svabhāvaḥ |	ངེས་འབྱིན་རང་བཞིན་ཆོས་རྣམས་དང་༎ ངེས་འབྱིན་མིན་གང་ཚུལ་དེ་བཞིན་༎ འདི་ལ་ངེས་པར་འབྱིན་པའི་ཆོས་ཀྱི་གནས་སྐབས་གསུངས་པ་རྣམས་ལ་ངེས་པར་འབྱིན་པའི་རང་བཞིན་དང་། 
 anairyāṇikānām anairyāṇikaḥ |	ངེས་པར་འབྱིན་པ་མ་ཡིན་པ་རྣམས་ལ་ངེས་པར་འབྱིན་པ་མ་ཡིན་པའི་རང་བཞིན་དང་། དང་། 
 bodhyaṅgikānāṃ bodhyaṅgikaḥ | abodhyaṅgikānām abodhyaṅgikaḥ | bodhipākṣikāṇāṃ bodhipākṣikaḥ | abodhipākṣikāṇām abodhipākṣikaḥ |	བྱང་ཆུབ་ཀྱི་ཡན་ལག་དང་ལྡན་པ་རྣམས་ལ་བྱང་ཆུབ་ཀྱི་ཡན་ལག་དང་དང་། དང་། ལྡན་པ་དང་། བྱང་ཆུབ་ཀྱི་ཡན་ལག་དང་མི་ལྡན་པ་རྣམས་ལ་བྱང་ཆུབ་ཀྱི་ཡན་ལག་དང་མི་ལྡན་པ་དང་། བྱང་ཆུབ་ཀྱི་ཕྱོགས་དང་ལྡན་པ་རྣམས་ལ་བྱང་ཆུབ་ཀྱི་ཕྱོགས་དང་ལྡན་པ་དང་། བྱང་ཆུབ་ཀྱི་ཕྱོགས་དང་མི་ལྡན་པ་རྣམས་ལ་བྱང་ཆུབ་ཀྱི་ཕྱོགས་དང་མི་ལྡན་པ་དང་ལྷག་མ་རྣམས་ལ་ཡང་དེ་༄༡༢༤བ་བཞིན་ཏེ་།
 evaṃ śeṣāṇāṃ tad yasmād evam anekaprakāro dharmāṇāṃ svabhāvo dṛṣṭaḥ | yasmād yad uktaṃ niḥsvabhāvāḥ sarvabhāvāḥ | niḥsvabhāvatvāt śūnyā iti na ||	དེའི་ཕྱིར་དེ་ལྟར་རྣམ་པ་དུ་མའི་ཆོས་རྣམས་ཀྱི་རང་བཞིན་མཐོང་བ་དེའི་ཕྱིར་དངོས་པོ་ཐམས་ཅད་ནི་རང་བཞིན་མེད་པ་སྟེ་། དེ་བས་ན་སྟོང་པའོ་ཞེས་སྨྲས་པ་གང་ཡིན་པ་དེ་མི་རུང་ངོ་༎
 kiñcānyat |	འདི་ལྟར་གཞན་ཡང་།
 yadi ca na bhavet svabhāvo dharmāṇāṃ niḥsvabhāva ity evaṃ |	གལ་ཏེ་ཆོས་ཀྱི་རང་བཞིན་མེད་༎ རང་བཞིན་མེད་ཅེས་བྱ་བའི་མིང་༎ མིང་ཡང་དེ་བཞིན་མེད་འགྱུར་ཉིད་༎
 nāmāpi bhavet naivaṃ nāmāpi nirvastukan nāsti || nagvv_9 || yadi ca dharmāṇāṃ svabhāvo bhāvānāṃ svabhāvānāṃ sadbhāvāc cāśūnyaḥ sarvabhāvāḥ |	གཞི་མེད་མིང་ནི་མེད་ཕྱིར་རོ་༎ གལ་ཏེ་ཆོས་ཐམས་ཅད་ཀྱི་རང་བཞིན་མེད་པ་ཡིན་ན་དེ་ལ་ཡང་རང་བཞིན་མེད་དོ་ཞེས་བྱ་བའི་མིང་ཡང་དེ་བཞིན་དུ་མེད་པར་འགྱུར་རོ་༎ ཅིའི་ཕྱིར་ཞེ་ན་། གཞི་མེད་པའི་མིང་ནི་འགའ་ཡང་མེད་པའི་ཕྱིར་རོ་༎ དེ་བས་ན་མི་སྲིད་པའི་ཕྱིར་དངོས་པོ་རྣམས་ཀྱི་རང་བཞིན་ཡོད་དོ་༎
 tatra yad uktaṃ niḥsvabhāvāḥ sarvabhāvā niḥsvabhāvatvāt śūnyā iti tan na || (vv 240) kiñcānyat |	རང་བཞིན་ཡོད་པའི་ཕྱིར་དངོས་པོ་ཐམས་ཅད་སྟོང་པ་མ་ཡིན་ནོ་༎ དེ་བས་ན་ཆོས་ཐམས་ཅད་རང་བཞིན་མེད་པ་སྟེ་། རང་བཞིན་མེད་པ་ཉིད་ཡིན་པའི་ཕྱིར་སྟོང་པའོ་ཞེས་སྨྲས་པ་གང་ཡིན་པ་དེ་རིགས་པ་མ་ཡིན་ནོ་༎ 
 atha vidyate svabhāvaḥ sa ca dharmāṇāṃ na vidyate tasmāt |	འོན་ཏེ་འདི་ལྟར་རང་བཞིན་ཡོད་༎ དེ་ནི་ཆོས་ལ་མེད་ཅེ་ན་༎ ཆོས་རྣམས་མེད་པའི་རང་བཞིན་ཏེ་༎
 dharmair vinā svabhāvaḥ sa yasyāsti tad yuktam upadeṣṭum || nagvv_10 ||	གང་གི་ཡིན་པ་དེ་བསྟན་རིགས་༎
 atha manyase mā bhūd avastukaṃ nāmeti kṛtvāsti svabhāvaḥ |	འོན་ཏེ་གཞི་མེད་པའི་མིང་དུ་གྱུར་ན་མི་རུང་ངོ་སྙམ་ནས་རང་བཞིན་ནི་ཡོད་ལ་།
 sa punar dharmāṇāṃ na saṃbhavati |	དེ་ཡང་ཆོས་ཐམས་ཅད་ལ་ནི་མི་སྲིད་དོ་༎
 evaṃ dharmaśūnyatā ca niḥsvabhāvatvād dharmāṇāṃ siddhā bhaviṣyati |	དེ་ལྟར་ན་ཆོས་རྣམས་རང་བཞིན་མེད་པའི་ཕྱིར་ཆོས་ནི་སྟོང་པར་འགྱུར་ལ་།
 na ca nirvastukan nāmeti |	མིང་གཞི་མེད་པར་ཡང་མ་ཡིན་ནོ་སྙམ་དུ་སེམས་ན་།
 atra vayaṃ brūmaḥ |	འདིར་སྨྲ་བར་བྱ་སྟེ་།
 evaṃ kasyedānīṃ sa svabhāvo dharmavinirmuktasyārthasya tad yuktam upadeṣṭum arthaḥ |	དེ་ལྟ་ཡིན་ན་རང་བཞིན་དེ་ཆོས་ལ་གཏོགས་པའི་དོན་གང་ཡིན་པའི་དོན་དེ་བསྟན་པར་རིགས་སོ་༎ 
 sa ca nopadiṣṭas tasmād yā kalpanāsti svabhāvo na punar dharmāṇām iti sā hīnā ||	དེ་ཡང་མ་བསྟན་པས་དེའི་ཕྱིར་རང་བཞིན་ནི་ཡོད་ལ་། དེ་ཡང་ཆོས་རྣམས་ནི་མེད་དོ་ཅེས་རྟོག་པ་གང་ཡིན་པ་དེ་ཉམས་སོ་༎
 kiñcānyat |	འདི་ལྟར་གཞན་ཡང་། གང་ཕྱིར་ཁྱིམ་ན་བུམ་པ་དེ་༎
 sata eva pratiṣedho nāsti ghaṭo geha ity ayaṃ yasmāt |	།
 dṛṣṭaḥ pratiṣedho yaṃ sataḥ svabhāvasya te tasmāt || nagvv_11 ||	ཡོད་པའི་རང་བཞིན་འགོག་པ་ཡིན་༎
 iha ca sato 'rthasya pratiṣedhaḥ kriyate nāmataḥ |	འདི་ལ་དོན་ཡོད་པ་ལ་འགོག་པར་བྱེད་ཀྱི་།
 tadyathā nāsti ghaṭo geha iti |	མེད་པ་ལ་ནི་མ་ཡིན་ཏེ་། དཔེར་ན་ཁྱིམ་ན་བུམ་པ་མེད་ཅེས་བྱ་བ་ལྟ་བུ་སྟེ་།
 sato ghaṭasya pratiṣedhaḥ kriyate |	བུམ་པ་ཡོད་པ་ལ་འགོག་པ་ཡིན་གྱི་།
 nāsataḥ |	མེད་པ་ལ་ནི་མ་ཡིན་ནོ་༎
 evam eva nasti svabhāvo dharmāṇām iti | sataḥ svabhāvasya pratiṣedhaḥ prāpnoti nāmataḥ |	དེ་བཞིན་དུ་ཆོས་རྣམས་ཀྱི་རང་བཞིན་མེད་དོ་ཞེས་བྱ་བ་ཡང་རང་བཞིན་ཡོད་པ་ལ་འགོག་པར་༄༡༢༥ཨ་༌་༎ འགྱུར་བ་ཡིན་གྱི་།
 tatra yad uktaṃ | niḥsvabhāvāḥ sarvabhāvāḥ niḥsvabhāvatvāt śūnyā iti tan na ||	མེད་པ་ལ་ནི་མ་ཡིན་པས་དེ་ལ་ཆོས་ཐམས་ཅད་ཀྱི་རང་བཞིན་མེད་དོ་ཞེས་སྨྲས་པ་གང་ཡིན་པ་དེ་མི་རུང་ངོ་༎
 pratiṣedhasaṃbhavād eva hi sarvabhāvasvabhāvasvabhāvo 'pratiṣiddhaḥ || (vv 242)	འདི་ལྟར་གཞན་ཡང་འགོག་པ་ཡོད་པ་ཉིད་ཀྱི་ཕྱིར་དངོས་པོ་ཐམས་ཅད་ཀྱི་རང་བཞིན་རབ་ཏུ་གྲུབ་པ་ཡིན་ནོ་༎
 atha nāsti sa svabhāvaḥ kin na pratiṣidhyate tvayānena |	ཇི་ལྟར་རང་བཞིན་དེ་མེད་ན་༎ ཁྱོད་ཀྱི་ཚིག་དེས་ཅི་ཞིག་དགག་། 
 vacanena rte vacanāt pratiṣedhaḥ sidhyate hy asataḥ || nagvv_12 ||	མེད་པ་ཡིན་ན་ཚིག་མེད་པར་༎ འགོག་པར་རབ་ཏུ་གྲུབ་པ་ཡིན་༎ ཇི་སྟེ་རང་བཞིན་དེ་མེད་པ་ཉིད་ཡིན་ན་ནི་།
 nāsty eva svabhāvā ity anena vacanena niḥsvabhāvā bhāvā iti kiṃ bhavatā pratiṣidhyate | asato hi vacād vinā siddhaḥ pratiṣedhaḥ |	དངོས་པོ་ཐམས་ཅད་རང་བཞིན་མེད་དོ་ཞེས་བྱ་བའི་ཚིག་འདིས་ཁྱོད་ཀྱིས་ཅི་ཞིག་འགོག་པར་བྱེད་། འདི་ལྟར་མེད་པ་ལ་ནི་ཚིག་མེད་པར་ཡང་འགོག་པར་འགྲུབ་སྟེ་།
 tadyathāgneḥ śaityasya | ayaṃ sthairyasya |	ཇི་ལྟར་མེ་ལ་གྲང་བ་ཉིད་དང་། ཆུ་ལ་ཚ་བ་ཉིད་ལྟ་བུའོ་༎
 kiñcānyat |	འདི་ལྟར་གཞན་ཡང་། བྱིས་པ་རྣམས་ནི་སྨིག་རྒྱུ་ལ་༎
 bālānām iva mithyā mṛgatṛṣṇāyāṃ yathājalagrāhaḥ |	ཇི་ལྟར་ལོག་པར་ཆུར་འཛིན་ལྟར་༎
 evaṃ mithyāḥ grāhaḥ syāt te pratiṣidhyate hy asataḥ || nagvv_13 ||	དེ་བཞིན་ཁྱོད་ཀྱིས་ལོག་པར་འཛིན་༎ ཡོད་པར་མིན་ལ་དགག་པར་བྱ་༎
 syāt te buddhiḥ yathā bālānāṃ mṛgatṛṣṇāyāṃ mithyājalam iti grāho bhavati |	ཁྱོད་ཀྱི་བློ་ལ་ཇི་ལྟར་བྱིས་པ་རྣམས་སྨིག་རྒྱུ་ལ་ལོག་པར་ཆུར་འཛིན་པ་ན་།
 nanu nirjalā sā mṛgatṛṣṇeti tatra paṇḍitajātīyena puruṣeṇocyate | tasya mithyāgrāhasya vinivartanārtham evan niḥsvabhāveṣu yaḥ svabhāvo grāhaḥ satvānāṃ tasya vyāvartanārthan niḥsvabhāvāḥ sarvabhāvā ity ucyata iti ||	དེ་སྐྱེས་བུ་མཁས་པའི་རང་བཞིན་ཅན་གྱིས་འཛིན་པ་དེ་བཟློག་པའི་ཕྱིར་དེ་ན་ཆུ་མེད་ཀྱི་། དེ་ནི་སྨིག་རྒྱུའོ་ཞེས་ཟེར་བ་དེ་བཞིན་དུ་རང་བཞིན་མེད་པ་རྣམས་ལ་སེམས་ཅན་རྣམས་ཀྱི་རང་བཞིན་དུ་འཛིན་པ་གང་ཡིན་པ་དེ་བཟློག་པའི་ཕྱིར་དངོས་པོ་ཐམས་ཅད་ནི་རང་བཞིན་མེད་པའོ་ཞེས་བྱ་བའོ་སྙམ་དུ་སེམས་ན་།
 atra brūmaḥ |	འདིར་སྨྲ་བར་བྱ་སྟེ་།
 (vv 244) nanv evaṃ saty asti grāho grāhyañ ca tadgrahītā ca | pratiṣedhaḥ pratiṣedhyaṃ pratiṣedhā ceti ṣaṭkaṃ tat || nagvv_14 ||	དེ་ལྟ་ན་ནི་འཛིན་པ་དང་༎ གཟུང་བ་འཛིན་པ་པོ་དེ་དང་༎ འགོག་པ་དགག་བྱ་འགོག་པ་པོ་༎ དེ་དྲུག་ཡོད་པ་མ་ཡིན་ནམ་༎
 yady evaṃ nanv evaṃ saty asti tāvat satvānāṃ mithyāgrāhaḥ | asti grāhyaṃ santi satvā grahītāraḥ | asti pratiṣedhaḥ tasyāpi mithyāgrāhasyāsti pratiṣedhyaṃ yad idaṃ mithyāgrāhyaṃ nāma | santi pratiṣedhāro yuṣmadādayo 'sya mithyāgrāhasyeti siddhaṃ ṣaṭkam |	གལ་ཏེ་དེ་ལྟ་ན་ནི་རེ་ཞིག་སེམས་ཅན་རྣམས་ཀྱི་འཛིན་པ་ཡང་ཡོད་པ་དང་། གཟུང་བ་ཡོད་པ་དང་། དེ་འཛིན་པ་པོ་ཡོད་པ་དང་། ལོག་པར་འཛིན་པ་དེ་འགོག་པ་ཡང་ཡོད་པ་དང་། དགག་པར་བྱ་བ་ལོག་པར་འཛིན་པ་དེ་ཡང་ཡོད་པ་དང་། ཁྱེད་ལ་སོགས་པ་འཛིན་པ་དེ་འགོག་པ་པོ་ཡང་ཡོད་དེ་།
 ṣaṭkasyāsya prasiddhatvāt |	དྲུག་ཏུ་གྲུབ་པ་མ་ཡིན་ནམ་། དེ་དྲུག་ཏུ་གྱུར་ན་ནི་།
 yad uktaṃ śūnyāḥ sarvabhāvā iti tan na ||	མ་བཀག་པ་ཉིད་ཡིན་པའི་ཕྱིར་དང་དངོས་པོ་ཐམས་ཅད་ནི་སྟོང་པའོ་ཞེས་སྨྲས་པ་གང་ཡིན་པ་དེ་མི་རུང་ངོ་༎
 atha naivāsti grāho na ca grāhyaṃ na ca grahītāraḥ |	ཇི་སྟེ་འཛིན་པ་ཡོད་མིན་ཞིང་༎ གཟུང་མེད་འཛིན་པ་པོ་མེད་ན་༎
 pratiṣedhaḥ pratiṣedhyaṃ pratiṣedhāro 'py ata na santi || nagvv_15 ||	འོ་ན་འགོག་༄༡༢༥བ་དང་དགག་བྱ་དང་༎ འགོག་པ་པོ་ཡང་ཡོད་མིན་ཏེ་༎
 atha mā bhūd eṣa doṣa iti kṛtvā naiva grāho 'sti naiva grāhyaṃ na ca grahītāra iti |	ཅི་སྟེ་སྐྱོན་དེར་གྱུར་ན་མི་རུང་ངོ་སྙམ་ནས་འཛིན་པ་ཡང་མེད་། གཟུང་བ་ཡང་མེད་འཛིན་པ་པོ་ཡང་མེད་དོ་ཞེ་ན་།
 evaṃ sati yo 'sau grāhasya pratiṣedhaḥ niḥsvahhāvāḥ sarvabhāvā iti | so 'pi nāsti pratiṣedhyam api nāsti pratiṣedhāro 'pi na santi | (vv 246)	དེ་ལྟ་ན་ནི་དངོས་པོ་ཐམས་ཅད་ནི་རང་བཞིན་མེད་དོ་ཞེས་བྱ་བ་འཛིན་པ་འགོག་པ་གང་ཡིན་པ་དེ་ཡང་མེད་ལ་༏་དགག་པར་བྱ་བ་ཡང་མེད་། འགོག་པ་པོ་ཡང་མེད་པར་འགྱུར་ཏེ་།
 pratiṣedhaḥ pratiṣedhyaṃ pratiṣedhārāaś ca yady uta na santi |	གལ་ཏེ་འགོག་དང་དགག་བྱ་དང་༎ འགོག་པ་པོ་ཡང་ཡོད་མིན་ན་༎
 siddhā hi sarvabhāvā yeṣām evaṃ svabhāvaś ca || nagvv_16 ||	དངོས་པོ་ཀུན་དང་དེ་རྣམས་ཀྱི་༎ རང་བཞིན་ཉིད་ཀྱང་གྲུབ་ཡིན་ན་༎ གལ་ཏེ་འགོག་པ་ཡང་མེད་།
 yadi ca na pratiṣedho na pratiṣedhyaṃ na pratiṣeddhāraḥ santy apratisiddhāḥ sarvabhāvā asti ca sarvabhāvānāṃ svabhāvaḥ ||	དགག་པར་བྱ་བ་ཡང་མེད་། འགོག་པ་པོ་ཡང་མེད་ན་ནི་། དངོས་པོ་ཐམས་ཅད་ཀྱང་མ་བཀག་པར་ཡོད་ལ་། དངོས་པོ་རྣམས་ཀྱི་རང་བཞིན་ཡང་ཡོད་དོ་༎
 kiñcānyat |	འདི་ལྟར་གཞན་ཡང་། ཁྱོད་ལ་གཏན་ཚིགས་མ་གྲུབ་སྟེ་༎
 hetoḥ svato na siddhiḥ naiḥsvābhāvyāt kuto hi te hetuḥ |	རང་བཞིན་མེད་ཕྱིར་ཁྱོད་གཏན་ཚིགས་༎ གང་ལ་ཡོད་དེ་ཁྱོད་དོན་ཏེ་༎
 nirhetukasya siddhir na copapannāsya te 'rthasya || nagvv_17 ||	གཏན་ཚིགས་མེད་ཕྱིར་གྲུབ་མི་འཐད་༎
 niḥsvabhāvāḥ sarvabhāvā ity etasmin arthe te hetor asiddhiḥ |	དངོས་པོ་ཐམས་ཅད་ནི་རང་བཞིན་མེད་དོ་ཞེས་བྱ་བའི་དོན་འདི་ལ་ཁྱོད་ཀྱི་གཏན་ཚིགས་མ་གྲུབ་སྟེ་། དེ་ཅིའི་ཕྱིར་ཞེ་ན་།
 kiṃ kāraṇaṃ niḥsvabhāvatvād dhi sarvabhāvānāṃ śūnyatvān na tato hetuḥ |	དངོས་པོ་ཐམས་ཅད་ནི་རང་བཞིན་མེད་པའི་ཕྱིར་སྟོང་པ་ཉིད་ཡིན་པས་དེའི་ཕྱིར་གཏན་ཚིགས་ག་ལ་ཡོད་། 
 asati hetau nirhetukasyārthasya śūnyāḥ sarvabhāvā iti kuta eva prasiddhiḥ || tatra yad uktaṃ śūnyāḥ sarvabhāvā iti tan na ||	གཏན་ཚིགས་མེད་ན་ནི་གཏན་ཚིགས་མེད་པར་དངོས་པོ་ཐམས་ཅད་སྟོང་པའོ་ཞེས་བྱ་བའི་དོན་གང་ལ་གྲུབ་པས་དེ་ལ་དངོས་པོ་ཐམས་ཅད་སྟོང་པའོ་ཞེས་སྨྲས་པ་གང་ཡིན་པ་དེ་མི་རུང་བོ་༎
 kiñcānyat |	འདི་ལྟར་གཞན་ཡང་། ཁྱོད་ལ་གཏན་ཚིགས་མེད་པར་ཡང་༎
 yadi cāhetoḥ siddhiḥ svabhāvavinivartanasya te bhavati |	རང་བཞིན་བཟློག་པ་གྲུབ་ཡིན་ན་༎ ང་ལ་འང་གཏན་ཚིགས་མེད་པར་ནི་༎
 svābhāvyasyāstitvaṃ mamāpi nirhetukaṃ siddhaṃ || nagvv_18 ||	རང་བཞིན་ཉིད་ནི་ཡོད་པར་འགྲུབ་༎
 atha manyase nairhetukī siddhiḥ niḥsvabhāvatvasya bhāvānām iti |	ཅི་སྟེ་དེ་ལ་གཏན་ཚིགས་མེད་པར་ཡང་དངོས་པོ་རྣམས་ཀྱི་རང་བཞིན་མེད་པར་འགྲུབ་པོ་སྙམ་དུ་སེམས་ན་། 
 yathā tava svabhāvanirvartanaṃ nirhetukaṃ siddhaṃ |	ཇི་ལྟར་ཁྱོད་ལ་གཏན་ཚིགས་མེད་པར་རང་བཞིན་བཟློག་པ་གྲུབ་པ་དེ་བཞིན་དུ་སེམས་ན་། དུ་། 
 tathā mamāpi svabhāvasatbhāvo 'pi nirhetukaḥ siddhaḥ ||	ང་ལ་ཡང་གཏན་ཚིགས་མེད་པར་དངོས་པོའི་རང་བཞིན་ཡོད་པར་འགྲུབ་དུ་སེམས་ན་། 
 (vv 248)	དུ་། བོ་༎ ང་ལ་ཡང་ཞེས་བྱ་བ་ནི་ངེད་ལ་ཡང་ངོ་༎ གལ་ཏེ་གཏན་ཚིགས་ཡོད་ན་དངོས་༎
 atha hetor astitvaṃ bhāvānaiḥsvābhāvyam ity anupapannam |	རང་བཞིན་མེད་ཅེས་བྱ་མི་འཐད་༎ འཇིག་རྟེན་ན་ནི་རང་བཞིན་མེད་༎
 loko naiḥsvabhāvyān na hi kaścana vidyate bhāvaḥ || nagvv_19 ||	དངོས་པོ་འགའ་ཡང་ཡོད་མིན་ནོ་༎ གལ་༄༡༢༦ཨ་༌་༎
 iha yadi hetor astitvaṃ manyase |	ཏེ་དངོས་པོ་རྣམས་ཀྱི་རང་བཞིན་མེད་པ་ཉིད་ཀྱི་གཏན་ཚིགས་ཡོད་པ་ཁོ་ནའོ་སྙམ་དུ་སེམས་ན་། 
 niḥsvabhāvāḥ sarvabhāvā iti tad anupapannaṃ ||	དེ་ལྟ་ན་ནི་དངོས་པོ་ཐམས་ཅད་རང་བཞིན་མེད་དོ་ཞེས་བྱ་བ་མི་འཐད་དོ་ན་། 
 kiṃ karaṇaṃ |	༎ ཅིའི་ཕྱིར་ཞེ་ན་།
 na hi loke niḥsvabhāvaḥ kaścid bhāvo 'sti || kiñcānyat |	འཇིག་རྟེན་ན་རང་བཞིན་མེད་པའི་དངོས་པོ་འགའ་ཡང་ཡོད་པ་མ་ཡིན་ནོ་༎ འདི་ལྟར་རང་བཞིན་ཡོད་མིན་ན་༎
 pūrvaṃ cet pratiṣedhaḥ paścāt pratiṣedhyam iti na copapannam |	གལ་ཏེ་འགོག་སྔ་དགག་ཕྱི་ཞེས་༎ ཟེར་ན་འཐད་པ་མ་ཡིན་ལ་༎
 yaś cānupapanno yugapac ca yataḥ svabhāvo 'san || nagvv_20 ||	འཕྱི་ཞིང་ཅིག་ཅར་འང་མི་འཐད་དོ་༎
 iha pūrvaṃ cet pratiṣedhaḥ paścāc ca pratiṣedhyaṃ | niḥsvabhāvyaṃ nopapannaṃ |	རང་བཞིན་མེད་པ་ཞེས་བྱ་བ་འདིར་གལ་ཏེ་འགོག་པ་ནི་སྔ་ལ་དགག་པར་བྱ་བ་ནི་འཕྱིའོ་ཞེ་ན་། འཐད་པ་མ་ཡིན་ཏེ་།
 asati hi pratiṣedhye kasya pratiṣedhaḥ ||	དགག་པར་བྱ་བ་ཡོད་པ་མ་ཡིན་ན་གང་གི་འགོག་པ་ཡིན་པར་འགྱུར་རོ་༎
 atha paścāt pratiṣedhaḥ pūrvaṃ pratiṣedhyam iti ca nopapannaṃ |	འོན་ཏེ་འགོག་པ་ནི་འཕྱི་ལ་དགག་པར་བྱ་བ་ནི་སྔའོ་ཞེ་ན་། དེ་འཐད་པ་མ་ཡིན་ཏེ་།
 siddhe hi pratiṣedhye kiṃ pratiṣedhaḥ karoti |	དགག་པར་བྱ་བ་གྲུབ་ཟིན་ན་། ཅི་ཞིག་འགོག་པར་བྱེད་།
 atha yugapatpratiṣedhaḥ pratiṣedhye tathāpi na pratiṣedhyaḥ pratiṣedhyasyārthasya kāraṇaṃ prati na pratiṣedhyaḥ |	འོན་ཏེ་འགོག་པ་དང་དགག་པར་བྱ་བ་འགོག་མཉམ་མོ་ཞེ་ན་། དེ་ལྟ་ན་ཡང་འགོག་པ་ནི་དགག་པར་བྱ་བའི་དོན་གྱི་རྒྱུ་མ་ཡིན་ལ་།
 na pratiṣedhasya ca |	དགག་པར་བྱ་བ་ཡང་འགོག་པའི་མ་ཡིན་ཏེ་།
 yathā yugapadutpannayor goviṣāṇayoḥ naiva dakṣiṇaṃ savyasya kāraṇaṃ savyaṃ vā dakṣiṇasya gāraṇaṃ bhavatīti |	དཔེར་ན་རི་བོང་གི་རབ༹་ག-ཡས་ག-ཡོན་གཉིས་མགོ་མཉམ་དུ་སྐྱེས་པ་ལྟ་བུ་སྟེ་། རབ༹་ག-ཡས་པ་ཡང་ག-ཡོན་པའི་རྒྱུ་མ་ཡིན་པ་།
 tatra yad uktaṃ niḥsvabhāvāḥ sarvabhāvā iti tan na |	ག-ཡོན་པ་ཡང་ག-ཡས་པའི་རྒྱུ་མ་ཡིན་པ་ལྟ་བུ་ཡིན་པས་དེ་ལ་དངོས་པོ་ཐམས་ཅད་རང་བཞིན་མེད་དོ་ཞེས་པ་གང་ཡིན་པ་དེ་མི་རུང་ངོ་༎ 
 (vv 250) atrocyate | yat tāvad bhavatoktaṃ	འདིར་བཤད་པ་རེ་ཞིག་ཁྱོད་ཀྱིས་།
 sarveṣāṃ bhāvānāṃ sarvatra na vidyate svabhāvaś cet |	གལ་ཏེ་དངོས་པོ་ཐམས་ཅད་ཀྱི་༎ རང་བཞིན་ཀུན་ལའང་ཡོད་མིན་ན་༎ ཁྱོད་ཀྱི་ཚིགས་ཀྱང་རང་བཞིན་མེད་༎
 tvadvacanam asvabhāvaṃ na nivartayituṃ svabhāvam alam iti | [1]	རང་བཞིན་བཟློག་པར་མི་ནུས་སོ་༎
 atra brūmaḥ |	ཞེས་སྨྲས་པ་གང་ཡིན་པ་དེ་ལ་བཤད་པར་བྱ་སྟེ་།
 hetupratyayasāmagrāṃ pṛthagbhāve 'pi madvaco na yadi |	གལ་ཏེ་ངའི་ཚིག་རྒྱུ་རྐྱེན་དང་༎ ཚོགས་དང་ཐ་དད་པ་ཡང་མེད་༎
 nanu śūnyatvaṃ siddhaṃ bhāvānām asvabhāvatvāt || nagvv_21 ||	འོ་ན་དངོས་རྣམས་སྟོང་གྲུབ་སྟེ་༎ རང་བཞིན་མེད་པ་ཉིད་ཕྱིར་རོ་༎
 yadi madvaco hetau nāsti mahābhūteṣu saṃprayukteṣu viprayukteṣu vā pratyayeṣu nāsti |	གལ་ཏེ་ངའི་ཚིག་རྒྱུ་འབྱུང་བ་ཆེན་པོ་རྣམས་དང་མཚུངས་པར་ལྡན་པ་རྣམས་དང་། ལྡན་པ་མ་ཡིན་པ་རྣམས་ལ་ཡང་མེད་།
 uraḥkaṇthojihvādantatālunāsikamūrdhaprabhṛtiṣu ya + + sāmagryām asti heṃpratyayasāmagrīṃ vinirmuktaṃ pṛthag vāsti |	རྐྱེན་བྲང་དང་། ལྐོག་མ་དང་། མཆུ་དང་། ལྕེ་དང་། སོའི་ཐུན་དང་། རྐན་དང་། སྣ་དང་། སྤྱི་བོ་ལ་སོགས་པ་དང་། འབད་པ་རྣམས་ལ་ཡང་མེད་། གཉི་ག་ཚོགས་པ་ལ་ཡང་མེད་། རྒྱུ་དང་རྐྱེན་ཚོགས་པ་ལ་ཡང་མེད་། རྒྱུ་དང་རྐྱེན་ཚོགས་པ་ལས་མ་༄༡༢༦བ་གཏོགས་པ་ཐ་དད་པ་ཡང་མེད་དོ་༎
 tasmān niḥsvabhāvā niḥsvabhāvatvāc chūnyaṃ | evaṃ |	དེའི་ཕྱིར་རང་བཞིན་མེད་པ་ཡིན་ཏེ་། རང་བཞིན་མེད་པའི་ཕྱིར་སྟོང་པ་ཡིན་ནོ་ཞེ་ན་།
 nanu śūnyatvaṃ siddhaṃ niḥsvabhāvatvād asya madīyavacasaḥ | yathā caitan madvacaṃ niḥsvabhāvatvāc chūnyaṃ |	འོ་ན་ནི་ངའི་ཚིག་དེ་སྟོང་པར་གྲུབ་སྟེ་། རང་བཞིན་མེད་པ་ཉིད་ཡིན་པའི་ཕྱིར་རོ་༎
 tathā sarvabhāvā niḥsvabhāvatvāc chūnyā iti | yad bhavatoktaṃ tvadīyavacasaḥ śūnyatvāt śūnyatā sarvabhāvānāṃ nopapadyata iti tan na || (vv 252)	ཇི་ལྟར་ངའི་ཚིག་དེ་རང་བཞིན་མེད་པ་ཉིད་ཡིན་པའི་ཕྱིར་སྟོང་པ་ཡིན་པ་དེ་བཞིན་དུ་དངོས་པོ་ཐམས་ཅད་ཀྱང་རང་བཞིན་མེད་པ་ཉིད་ཡིན་པའི་ཕྱིར་སྟོང་པ་ཡིན་པས་ན་དེ་ལ་ཁྱོད་ཀྱིས་ཚིག་སྟོང་པ་ཡིན་པའི་ཕྱིར་དངོས་པོ་ཐམས་ཅད་སྟོང་པ་ཉིད་དུ་མི་འཐད་དོ་ཞེས་སྨྲས་པ་གང་ཡིན་པ་དེ་མི་རུང་ངོ་༎
 kiñcānyat |	འདི་ལྟར་གཞན་ཡང་། དངོས་རྣམས་རྟེན་ནས་བྱུང་བ་གང་༎
 yaś ca pratītya bhāvānāṃ śūnyateti taṃ brū + + |	དེ་ནི་སྟོང་ཉིད་ཅེས་བྱ་དང་༎ གང་ཞིག་རྟེན་ནས་འབྱུང་བ་དེ་༎
 yas tu pratītyabhāvo bhavati hi tasyāsvabhāvatvaṃ || nagvv_22 ||	རང་བཞིན་ཉིད་མེད་ཡིན་པར་སྨྲ་༎
 śūnyatārthañ ca bhavān bhāvānām anavasamya śūnyatārtham ajñātvā pravṛtti upālambhaṃ vaktuṃ tvadvacanasya śūnyatvāt tvadvacanasya niḥsvabhāvatvād evaṃ tvadvacanena niḥsvabhāvena	ཁྱོད་ཀྱིས་ནི་དངོས་པོ་རྣམས་ཀྱི་སྟོང་པ་ཉིད་ཀྱི་དོན་ཁོང་དུ་ཆུད་པར་ཁྱོད་ཀྱི་ཚིག་རང་བཞིན་མེད་པ་ཡིན་པའི་ཕྱིར་།
 bhāvānāṃ svabhāvapratiṣedho nopapadyata iti | iha hi yaḥ pratītya bhavānāṃ bhāvaḥ sā śūnyatā |	དངོས་པོ་རྣམས་ཀྱི་རང་བཞིན་འགོག་པ་མི་འཐད་དེ་ཞེས་ཀླན་ཀ་ཚོལ་བ་སྨྲ་བར་བྱེད་དེ་། འདིར་ནི་དངོས་པོ་རྣམས་རྟེན་ནས་འབྱུང་བ་གང་ཡིན་པ་དེ་ནི་སྟོང་པ་ཉིད་ཡིན་ནོ་། ༎ ཅིའི་ཕྱིར་ཞེ་ན་།
 kasmān niḥsvabhāvatvāt |	རང་བཞིན་མེད་པ་ཉིད་ཡིན་པའི་ཕྱིར་རོ་༎
 ye hi pratītyasamutpānnā bhāvās te sa sasvabhāvā bhavanti | svabhāvābhāvāt |	དངོས་པོ་གནག་དག་རྟེན་ཅིང་འབྲེལ་བར་འབྱུང་བ་དེ་དག་ནི་རང་བཞིན་དང་བཅས་པ་མ་ཡིན་ཏེ་༏་རང་བཞིན་མེད་པའི་ཕྱིར་རོ་༎ ཅིའི་ཕྱིར་ཞེ་ན་།
 tasmād dhetupratyayāpekṣatvāt |	རྒྱུ་དང་རྐྱེན་ལ་ལྟོས་པ་དང་བཅས་པའི་ཕྱིར་རོ་༎
 yadi hi svabhāvato bhāvā bhaveyuḥ | pratyākhyāyāpi hetupratyayāṃś ca bhaveyuḥ |	གལ་ཏེ་དངོས་པོ་རྣམས་རང་བཞིན་གྱིས་ཡོད་པ་ནི་རྒྱུ་དང་རྐྱེན་མེད་ཀྱང་ཡོད་པར་འགྱུར་བ་ཞིག་ན་། དེ་ལྟར་ཡང་མ་ཡིན་པས་དེའི་ཕྱིར་རང་བཞིན་མེད་པ་ཡིན་ཏེ་། དེས་ན་སྟོང་པའོ་༎
 na cevaṃ bhavanti |	ཞེས་བྱ་བར་འཐད་དོ་༎ དེ་བཞིན་དུ་ངའི་ཚིག་ཀྱང་རྟེན་ཅིང་འབྲེལ་བར་འབྱུང་བ་ཡིན་ཏེ་།
 tasmān niḥsvabhāvāḥ niḥsvabhāvatvāc chūnyā ity abhidhīyante |	དེའི་ཕྱིར་རང་བཞིན་མེད་དོ་༎
 evaṃ madīyam api vacanaṃ | pratītyasamutpannatvān niḥsvabhāvaṃ niḥsvabhāvatvāt śūnyam ity upapannaṃ | (vv 254)	རང་བཞིན་མེད་པ་ཉིད་ཡིན་པའི་ཕྱིར་སྟོང་པའོ་ཞེས་བྱ་བར་འཐད་པ་ཡིན་ནོ་༎
 yathā ca pratītyasamutpannatvāt svabhāvaśūnyāḥ | rathapaṭaghaṭādayaḥ sveṣu sveṣu kāryeṣu kāṣṭhāhaṇamṛttikaharaṇamadhūdakapayasāṃ dhāraṇā śītavātātapaparitrāṇaprabhṛtiṣu vartante | evam idaṃ madīyavacanaṃ pratyayasamutpannatvān niḥsvabhāvaṃ niḥsvabhāvatvaprasādhanaṃ pratyayabhāvānāṃ vartate |	ཇི་ལྟར་བུམ་པ་དང་སྣམ་བུ་ལ་སོགས་པ་རྟེན་ཅིང་འབྲེལ་བར་འབྱུང་བ་ཉིད་ཡིན་པའི་ཕྱིར་རང་བཞིན་སྟོང་པ་ཡིན་པ་སྦྲང་རྩེ་དང་། ཆུ་དང་། འོ་ཐུག་འཛིན་པ་དང་། ལེན་པ་དང་། གྲང་བ་དང་། རླུང་དང་། ཉི་མས་ཡོངས་སུ་སྐྱོབ་བར་ནུས་པ་དེ་བཞིན་དུ་ངའི་ཚིག་ཀྱང་རྟེན་ཅིང་འབྲེལ་པར་འབྱུང་བ་ཡིན་པའི་ཕྱིར་རང་བཞིན་མེད་པ་ཡིན་ཡང་དངོས་པོ་རྣམས་རང་བཞིན་མེད་པར་རབ་༄༡༢༧ཨ་༌་༎
 tra yad uktaṃ | niḥsvabhavatvāt tvadīyavacanasya śūnyatvaṃ śūnyatvāt tasya ca tena sarvabhāvasvabhāvapratiṣedha upapannam iti tan na || (vv 256)	ཏུ་སྒྲུབ་པར་ནུས་པ་ཡིན་པས་དེ་ལ་ཁྱོད་ཀྱི་ཚིག་རང་བཞིན་མེད་པ་ཉིད་ཡིན་པའི་ཕྱིར་དངོས་པོ་ཐམས་ཅད་ཀྱི་རང་བཞིན་འགོག་པ་འཐད་པ་མ་ཡིན་ནོ་ཞེས་སྨྲས་པ་གང་ཡིན་པ་དེ་མི་རུང་ངོ་༎
 kiñcānyat |	འདི་ལྟར་གཞན་ཡང་།
 nirmitako nirmitakaṃ māyāpuruṣa svamāyayā sṛṣṭam |	སྤྲུལ་པ་ཡིས་ནི་སྤྲུལ་པ་དང་༎ སྒྱུ་མ་ཡིས་ནི་སྐྱེས་བུ་ཡི་༎ སྒྱུ་མས་ཕྱུང་ལ་འགོག་བྱེད་ལྟར་༎
 pratiṣedhayati yadvat pratiṣedho yaṃ tathaiva syāt || nagvv_23 ||	འགོག་པ་དེ་ཡང་དེ་བཞིན་འགྱུར་༎
 yathā nirmitakaḥ puruṣam abhyāpataṃ tu kaścid arthena vartamānaṃ pratiṣedhayet | māyākāreṇa vā sṛṣṭo māyāpurnṣo 'nyaṃ māyāpuruṣa samabhyava tan na kasminścid arthe vartamānaṃ pratiṣedhayet | tatra yo nirmitakaḥ puruṣaḥ pratiṣedhyate sa śūnyaḥ yaḥ pratiṣedhayati so 'pi māyāpuruṣaḥ śūnya evam eva madvacanena śūnyena sarvabhāvānāṃ svabhāvapratiṣedha upapannaḥ ||	ཇི་ལྟར་སྤྲུལ་པའི་སྐྱེས་བུས་སྤྲུལ་པའི་སྐྱེས་བུ་ཞིག་དོན་འགའ་ཞིག་གི་ཕྱིར་འོང་བར་བྱེད་པ་ལ་འགོག་པར་བྱེད་པ་དང་། སྒྱུ་མ་མཁན་གྱིས་ཕྱུང་བའི་སྒྱུ་མའི་སྐྱེས་བུས་སྒྱུ་མའི་སྐྱེས་བུ་གཞན་ཞིག་དོན་འགའ་ཞིག་གི་ཕྱིར་འོང་བར་བྱེད་པ་ལ་འགོག་པར་བྱེད་པ་བཞིན་ཏེ་དེ་ལ་སྤྲུལ་པའི་སྐྱེས་བུ་དགག་པར་བྱ་བ་གང་ཡིན་པ་དེ་ཡང་སྟོང་པ་ཡིན་། འགོག་པར་བྱེད་པ་དེ་ཡང་སྟོང་པ་ཡིན་སྒྱུ་མའི་སྐྱེས་བུ་དགག་པར་བྱ་བ་གང་ཡིན་པ་དེ་ཡང་སྟོང་པ་ཡིན་འགོག་པར་བྱེད་པ་གང་ཡིན་པ་དེ་ཡང་སྟོང་པ་ཡིན་པ་དེ་བཞིན་དུ་ངའི་ཚིག་སྟོང་པས་ཀྱང་དངོས་པོ་ཐམས་ཅད་སྟོང་པ་ཉིད་དུ་དངོས་པོ་ཐམས་ཅད་ཀྱི་རང་བཞིན་འགོག་པ་འཐད་པ་ན་དེ་ལ་ཁྱོད་ཀྱི་ཚིག་སྟོང་པ་ཉིད་ཡིན་པའི་ཕྱིར་དངོས་པོ་ཐམས་ཅད་ཀྱི་རང་བཞིན་འགོག་པ་འཐད་པ་མ་ཡིན་ནོ་ཞེས་སྨྲས་པ་གང་ཡིན་པ་དེ་རུང་བ་མ་ཡིན་ནོ་༎
 tatra yad bhavatoktaṃ |	དེ་ལ་ཁྱོད་ཀྱིས་མུ་དྲུག་ཏུ་སྨྲས་པ་གང་ཡིན་པ་དེ་ཡང་དེ་ཉིད་ཀྱིས་བཀག་པ་ཡིན་ཏེ་། 
 śūnyatvāt tvadvacanasya sarvabhāvasvabhāvapratiṣedho nopapannam iti na tan na |	དེ་ལྟ་ཡིན་ན་ཐམས་ཅད་ཀྱི་ནང་དུ་ངའི་ཚིག་ཀྱང་མ་འདུས་པ་ཡིན་ཞིང་མི་སྟོང་བའང་མ་ཡིན་ལ་།
 ṣaṭkoṭiko vāda uktaḥ sa evaṃ pratisiddhaḥ naiva hy evaṃ sati na sarvabhāvāntargataṃ madvacanaṃ nāpy aśūnyaṃ nāpi sarvabhāvāśūnyāḥ | (vv 258) yat punar bhavatoktam	དངོས་པོ་ཐམས་ཅད་ཀྱང་མི་སྟོང་བ་མ་ཡིན་ནོ་༎
 atha sasvabhāvam etad vākyaṃ pūrvā hatā pratijñā te	ཡང་ཁྱོད་ཀྱིས་༏་འོན་ཏེ་ཚིག་དེ་རང་བཞིན་བཅས་༎ ཁྱོད་ཀྱི་དམ་བཅས་སྔ་མ་ཉམས་༎ མི་འདྲ་ཉིད་དེ་དེ་ཡིན་ན་༎
 vaiṣamikatvaṃ tasmin viśeṣahetuś ca vaktavya ity [2]	གཏན་ཚིག་ཁྱད་པར་བརྗོད་པར་བྱོས་༎
 atrāpi brūmaḥ |	ཞེས་སྨྲས་པ་གང་ཡིན་པ་འདི་ལ་བཤད་པར་བྱ་སྟེ་།
 na svābhāvikam etad vākyaṃ tasmān na vādahānir me |	ངའི་ཚིག་དེ་རང་བཞིན་མེད་༎ དེ་ཕྱིར་སྨྲས་པ་མ་ཉམས་ལ་༎ མི་འདྲ་ཉིད་ཀྱང་མེད་པས་ན་༎
 nāsti ca vaiṣamikatvaṃ viśesahetuś ca na nigadyaḥ || nagvv_24 ||	གཏན་ཚིགས་ཁྱད་པར་བཤད་མི་བྱ་༎
 na tāvad etan mama vacanaṃ pratītyasamutpannatvāt svabhāvopapannaṃ yathā pūrvam uktaṃ |	རེ་ཞིག་ངའི་ཚིག་དེ་ནི་རྟེན་ཅིང་འབྲེལ་པར་འབྱུང་བ་ཡིན་པའི་ཕྱིར་བཞིན་འཐད་པ་མ་ཡིན་ཏེ་། ཇི་སྐད་དུ་།
 svabhāvānupapannatvāt śūnyaṃ |	སྔར་རང་བཞིན་འཐད་པ་མ་ཡིན་པའི་ཕྱིར་སྟོང་པ་ཡིན་ནོ་ཞེས་བཤད་པ་ལྟ་བུའོ་༎
 yasmāc ca idam api madvacanaṃ śūnyaṃ śeṣāpi sarvabhāvāḥ śūnyās tasmān nāsti vaiṣamikatvaṃ |	གང་གི་ཕྱིར་ངའི་ཚིག་དེ་༄༡༢༧བ་ཡང་སྟོང་པ་ཡིན་། དངོས་པོ་ལྷག་མ་རྣམས་ཀྱང་སྟོང་པ་ཡིན་པ་དེའི་ཕྱིར་མི་འདྲ་བ་ཉིད་མེད་དོ་༎
 yadi hi vayaṃ brūmaḥ | idaṃ vacanam aśūnyaṃ śeṣāḥ sarvabhāvāḥ śūnyā iti tato vaiṣamikatvaṃ |	གལ་ཏེ་ང་ན་རེ་ཚིག་དེ་ནི་སྟོང་པ་མ་ཡིན་ལ་དངོས་པོ་ལྷག་མ་ཐམས་ཅད་ནི་སྟོང་པ་ཡིན་ནོ་ཞེས་འཆད་བ་ནི་དེས་ན་མི་འདྲ་བ་ཉིད་དུ་ཡང་འགྱུར་ན་།
 syān na caitad evaṃ tasmān na vaiṣamikatvaṃ |	དེ་ན་དེ་ལྟ་མ་ཡིན་པས་དེའི་ཕྱིར་མི་འདྲ་བ་ཉིད་མེད་དོ་༎
 yasmāc ca vaiṣamikatvaṃ na saṃbhavati idaṃ vacanam aśūnyaṃ śeṣāḥ punaḥ sarvabhāvāḥ śūnyā iti |	གང་གི་ཕྱིར་ཚིག་དེ་ནི་སྟོང་པ་མ་ཡིན་ལ་དངོས་པོ་ལྷག་མ་ཐམས་ཅད་ནི་སྟོང་པ་ཡིན་ནོ་ཞེས་མི་འདྲ་བ་ཉིད་མི་སྲིད་པ་དེའི་ཕྱིར་ཁོ་བོས་གཏན་ཚིགས་དེས་ན་ཚིག་དེ་ནི་སྟོང་པ་མ་ཡིན་ལ་།
 tasmād asmābhir viśeṣahetur api na vaktavyaḥ anena idaṃ vacanaṃ aśūnyaṃ sarvabhāvāḥ punaḥ śūnyā iti |	དངོས་པོ་ཐམས་ཅད་ནི་སྟོང་པ་ཡིན་ནོ་ཞེས་གཏན་ཚིགས་ཀྱི་ཁྱད་པར་བཤད་པར་མི་བྱ་སྟེ་། དེ་ལ་ཁྱེད་ཀྱིས་སྨྲས་པ་ཡང་ཉམས་ལ་།
 tatra yad bhavatoktaṃ vādahānis te vaiṣamikatvaṃ ca viśeṣahetuś ca tvayā vaktavya iti tan na |	མི་འདྲ་བ་ཉིད་ཀྱང་ཡིན་པས་ཁྱད་ཀྱིས་གཏན་ཚིགས་ཁྱད་པར་ཡང་བརྗོད་པར་བྱོས་ཤིག་ཅེས་སྨྲས་པ་གང་ཡིན་པ་དེ་མི་དྲུང་ངོ་༎
 (vv 260)	ཡང་། དེ་སྒྲ་མ་འབྱིན་ལྟ་བུའོ་།
 yat punar bhavatoktaṃ |	ཞེས་༎
 mā śabdavad ity etad asmāt te buddhir na caitad upapannaṃ |	ཁྱོད་བློ་སེམས་ནི་དེ་མི་འཐད་༎
 śabdena hy atra satā bhaviṣyato vāraṇaṃ tasyeti | [3]	འདི་ལ་སྒྲ་ནི་ཡོད་པ་ཡིས་༎ འབྱུང་བར་འགྱུར་བ་དེ་བཟློག་ཡིན་༎
 atra brūmaḥ |	ཞེས་སྨྲས་པ་གང་ཡིན་པ་འདི་ལ་བཤད་པར་བྱ་སྟེ་།
 mā śabdavad iti nāyaṃ dṛṣṭānto yas tvayā mamārahdhaḥ |	སྒྲ་མ་འབྱིན་ཞེས་བྱ་བཞིན་ཞེས་༎ ཁྱོད་ཀྱིས་གང་བརྩམས་དཔེ་འདི་མིན་༎
 śabdena hi tac ca śabdasya vāraṇaṃ naidam eva caḥ || nagvv_25 ||	དེ་ནི་སྒྲ་ཡིས་སྒྲ་བཟློག་པས་༎ འདི་ནི་དེ་ལྟ་མ་ཡིན་ནོ་༎
 nāpy ayam asmākaṃ dṛṣṭāntaḥ |	འདི་ནི་དེད་ཀྱི་དཔེ་མ་ཡིན་ཏེ་། ཇི་ལྟར་འགའ་ཞིག་ན་རེ་།
 yathā kaścin mā śabdaṃ karṣīr iti bruvaṃ śabdam eva karoti śabdañ ca pratiṣedhayati | yadvat śūnyena vacanena śūnyatāṃ pratiṣedhayati |	སྒྲ་མ་འཛིན་ཞེས་དེ་སྐད་ཟེར་བ་ན་སྒྲ་ཉིད་འབྱིན་ཅིང་སྒྲ་ཟློག་པར་བྱེད་པ་ལྟར་ཚིག་སྟོང་པ་དེ་ཉིད་འགོག་པར་མི་བྱེད་དོ་༎
 kiṃ kāraṇaṃ |	ཅིའི་ཕྱིར་ཞེ་ན་།
 atra hi dṛṣṭānte śabdena śabdasya vyāvartanaṃ kriyate | na caitad evaṃ vayaṃ brūmaḥ |	འདི་ལ་དཔེས་སྒྲ་ཟློག་པར་བྱེད་པ་དེ་ལྟར་འདི་ནི་མ་ཡིན་ཏེ་།
 niḥsvabhāvāḥ sarvabhāvāḥ niḥsvabhāvatvāt tad aśūnyām iti |	ངེད་ནི་དངོས་པོ་ཐམས་ཅད་རང་བཞིན་མེད་པ་ཡིན་ཏེ་། རང་བཞིན་མེད་པའི་ཕྱིར་སྟོང་པ་ཡིན་ན་ཞེས་འཆད་དོ་༎
 (vv 262) kiṃ karaṇaṃ	ཅིའི་ཕྱིར་ཞེ་ན་།
 naiḥsvabhāvyānāṃ cen naiḥsvābhāvyena vāraṇaṃ yadi hi |	གལ་ཏེ་རང་བཞིན་མེད་ཉིད་ཀྱིས་༎ ཇི་སྟེ་རང་བཞིན་མེད་ལ་བཟློག་། 
 naiḥsvabhāvyanirvṛttau svabhāvyaṃ hi prasiddhaṃ syāt || nagvv_26 ||	རང་བཞིན་མེད་པ་ཉིད་ལོག་ན་༎ རང་བཞིན་ཉིད་དུ་རབ་གྲུབ་འགྱུར་༎
 yathā mā śabdam iti śabdena śabdasya vyāvartanaṃ kriyate |	ཇི་ལྟར་སྒྲ་མ་འབྱིན་ཅེས་བྱ་བ་ལྟ་བུ་སྒྲས་ཟློག་པར་བྱེད་པ་དེ་བཞིན་དུ་།
 evaṃ yadi naiḥsvabhāvyena vacanena naiḥsvabhāvyānāṃ vyāvartanaṃ kriyate tato 'yaṃ dṛṣṭāntopapannaḥ syāt |	གལ་ཏེ་ཚིག་རང་བཞིན་མེད་པ་ཉིད་ཀྱི་དངོས་པོ་རང་བཞིན་མེད་པ་རྣམས་ལ་ཟློག་པར་བྱེད་ན་ནི་དེས་ན་དཔེ་འདི་འཐད་པར་འགྱུར་བ་ཞིག་ན་། 
 iha tu naiḥsvabhāvyena vacanena bhāvānāṃ svabhāvapratiṣedhaḥ kriyate |	འདིར་ནི་ཚིག་རང་བཞིན་མེད་པ་ཉིད་ཀྱི་དངོས་པོ་རྣམས་ཀྱི་རང་བཞིན་འགོག་པར་ཞིག་ན་། བྱེད་དོ་༎ 
 evaṃ yadi naiḥsvabhāvyena vacanena niḥsvabhāvānāṃ naiḥsvabhāvyapratiṣedhaḥ kriyate |	གལ་ཏེ་ཚིག་རང་བཞིན་མེད་པ་ཉིད་ཀྱིས་དངོས་པོ་རྣམས་ཀྱི་༄༡༢༨ཨ་ཞིག་ན་། བྱེད་དོ་༎ 
 naiḥsvabhavyapratiṣedhād eva sasvabhāvā bhaveyuḥ |	༌་༎ རང་བཞིན་མེད་པ་ཉིད་འགོག་པར་བྱེད་ན་ནི་རང་བཞིན་མེད་པ་ཉིད་བཀག་པའི་ཕྱིར་དངོས་པོ་རྣམས་རང་བཞིན་དང་བཅས་པར་འགྱུར་ལ་།
 sasvabhāvatvād aśūnyāḥ syuḥ |	རང་བཞིན་དང་བཅས་པའི་ཕྱིར་སྟོང་པ་མ་ཡིན་པར་འགྱུར་རོ་༎
 śūnyatāñ ca vayaṃ bhāvānām ācakṣmahe nāśūnyatām ity adṛṣṭānta evāyam iti | (vv 264)	ཁོ་བོ་ཅག་ནི་དངོས་པོ་རྣམས་སྟོང་པ་ཉིད་སྨྲ་ཡི་། སྟོང་པ་ཉིད་མ་ཡིན་པར་ནི་སྨྲ་བ་མ་ཡིན་པས་དཔེ་མ་ཡིན་ནོ་༎ ཡང་ན་ཁ་ཅིག་སྤྲུལ་པ་ཡིས་༎
 atha vā nirmitakāyāṃ yathā striyāṃ striyam ity asatgrāham | nirmitakaḥ pratihanyāt kasyacid evaṃ bhaved ettata || nagvv_27 ||	བུད་མེད་ལ་ནི་བུད་མེད་སྙམ་༎ ལོག་འཛིན་འབྱུང་ལ་སྤྲུལ་པ་ཡིས་༎ འགོག་བྱེད་འདི་ནི་དེ་ལྟ་ཡིན་༎
 atha vā kasyacit puruṣasya nirmitakāyāṃ striyāṃ svabhāvaśūnyāyāṃ paramārthataḥ striyam ity asadgrāhaḥ |	ཡང་ན་ཇི་ལྟར་སྐྱེས་བུ་ཁ་ཅིག་སྤྲུལ་པའི་བུད་མེད་རང་བཞིན་གྱིས་སྟོང་པ་ཡིན་པ་ལ་དོན་དམ་པར་བུད་མེད་དོ་སྙམ་དུ་ལོག་པར་འཛིན་པར་འགྱུར་རོ་༎
 syād eva tasyāṃ tenāsadgrāheṇa rāgam utpādayet |	དེའི་ཕྱིར་དེ་ལོག་པར་འཛིན་པ་དེས་དེའི་འདོད་ཆགས་བསྐྱེད་པ་ལ་དེ་བཞིན་གཤེགས་པའམ་།
 tad yathā tathāgatena vā tacchrāvakeṇa vā nirmitako nirmitaḥ syāt |	དེ་བཞིན་གཤེགས་པའི་ཉན་ཐོས་ཀྱིས་སྤྲུལ་པ་ཞིག་སྤྲུལ་ལ་།
 tathāgatādhiṣṭhānena vā tathāgatasrāvakādhiṣṭhānena vā tasya tam asadgrāhaṃ vinivartayet |	དེས་དེའི་ལོག་པར་འཛིན་པ་དེ་ཟློག་པར་བྱེད་དོ་༎
 evam eva nirmitakopamena śūnyena vacanena nirmitakastrīsadṛśyeṣu niḥsvabhāveṣu yo 'yaṃ svabbāvagrāhaḥ sa nivartyate sa pratiṣidhyate |	དེ་བཞིན་དུ་ངའི་ཚིག་སྟོང་པ་སྤྲུལ་པ་ལྟ་བུས་དངོས་པོ་ཐམས་ཅད་ཀྱི་རང་བཞིན་མེད་པ་སྤྲུལ་པའི་བུད་མེད་དང་འདྲ་བ་དག་ལ་རང་བཞིན་ཡོད་པར་འཛིན་པ་གང་ཡིན་པ་ཟློག་པར་བྱེད་དོ་༎ 
 tasmād ayam atra dṛṣṭāntaḥ śūnyatāprasādhanaṃ pratyupapadyamāno netaraḥ |	དེ་བས་ན་འདིར་སྟོང་པ་ཉིད་དུ་རབ་ཏུ་བསྒྲུབ་པ་ལ་དཔེ་འདི་འཐད་པ་བྱེད་དོ་༎ ཡིན་གྱི་། ཅིག་ཤོས་ནི་མ་ཡིན་ནོ་༎
 (vv 266) atha vā sādhyasamo yaṃ hetur na hi vidyate dhvaneḥ sattā |	ཡང་ན་གང་ཕྱིར་བསྒྲུབ་བྱ་དང་༎ གཏན་ཚིགས་འདི་མཚུངས་སྒྲ་ཡོད་མིན་༎
 saṃvyavahārañ ca vayaṃ nānabhyupagamya kathayāmaḥ || nagvv_28 ||	ཐ་སྙད་ཁས་རྣམས་མ་བླངས་པར་༎ ངེད་ཅག་འཆད་པར་མི་བྱེད་དོ་༎
 mā śabdavad iti sādhyasama evāyaṃ hetuḥ |	བསྒྲུབ་པར་བྱ་བ་དང་། སྒྲ་མ་འབྱིན་ཞེས་བྱ་བ་ལྟ་བུའོ་ཞེས་བྱ་བའི་གཏན་ཚིགས་འདི་མཚུངས་པ་ཁོ་ན་ཡིན་ནོ་༎ ཅིའི་ཕྱིར་ཞེ་ན་།
 kasmāt sarvabhāvānāṃ naiḥsvabhāvyenāviśiṣṭatvāt | na hi tasya dhvaneḥ pratītyasamutpannatvāt | svabhavaṃ sattāḥ vidyate |	དངོས་པོ་ཐམས་ཅད་ནི་རང་བཞིན་མེད་པ་ཉིད་དུ་ཁྱད་པར་མེད་པ་ཉིད་ཀྱི་ཕྱིར་སྒྲ་དེ་ནི་རྟེན་ཅིང་འབྲེལ་པར་འབྱུང་བ་ཉིད་ཡིན་པའི་ཕྱིར་རང་བཞིན་ཡོད་པ་མ་ཡིན་ནོ་༎
 tasyāḥ svabhāvasattāyāḥ avidyamānatvāt | yad uktaṃ	དེ་ལྟ་བས་ན་རང་ཞིན་ཡོད་པ་མ་ཡིན་པ་ཉིད་ཀྱི་ཕྱིར་།
 śabdena hy atra sattā bhaviṣyato vāraṇaṃ tasyeti |	འདི་ལ་སྒྲ་ནི་ཡོད་པ་ཡིས་༎ འབྱུང་བར་གྱུར་པ་དེ་བཟློག་ཡིན༎
 tat vyāhanyate |	ཞེས་སྨྲས་པ་གང་ཡིན་པ་བཟློག་པ་ཡིན་ནོ་༎
 api ca na vayaṃ vyavahārasatyaṃ pratyākhyāya vyavahārasatyam anabhyupagamya kathayāmaḥ | śūnyāḥ sarvabhāvā iti |	གཞན་ཡང་ཐ་སྙད་ཀྱི་བདེན་པ་ཁས་མ་བླངས་ཤིང་མ་བརྟེན་པར་དངོས་པོ་ཐམས་ཅད་སྟོང་པའོ་ཞེས་མི་འཆད་དོ་༎
 na hi vyavahārasatyam anāgamya śakyā dharmadeśanā kartuṃ |	ཐ་སྙད་ཀྱི་བདེན་པ་ཁས་མ་བླངས་པར་ནི་ཆོས་བསྟན་པར་མི་ནུས་ཏེ་།
 yathoktaṃ	ཇི་སྐད་དུ་།
 vyavahāram anāśritya paramārtho na deśyate |	ཐ་སྙད་ལ་ནི་མ་བརྟེན་པར་༎ ༄༡༢༨བ་དམ་པའི་དོན་ལ་མི་སྟོན་ལ་༎
 paramārtham anāgamya nirvāṇaṃ nādhigamyata iti | [= mmk 24|18]	དམ་པའི་དོན་ལ་མ་བརྟེན་པར་༎ མྱ་ངན་འདས་པ་མི་རྟོགས་སོ་༎
 tasmān madvacanavat śūnyāḥ sarvabhāvāḥ sarvabhāvānāñ ca niḥsvabhāvatvam ubhayathopapadyamānam iti ||	ཞེས་གསུངས་པ་ལྟ་བུའོ་༎ དེ་ལྟ་བས་ན་དངོས་པོ་ཐམས་ཅད་ཀྱི་རང་བཞིན་མེད་པ་ཉིད་དུ་གཉི་ག་འཐད་པ་ན་ངའི་ཚིག་བཞིན་དུ་དངོས་པོ་ཐམས་ཅད་སྟོང་པ་ཡིན་ནོ་༎ ཡང་ཁྱོད་ཀྱིས་༏་འགོག་པའི་འགོག་པའང་དེ་ལྟ་ཞེས་༎ འདོད་ན་དེ་ཡང་བཟང་མིན་ཏེ་༎ དེ་ལྟ་ན་ཡང་ཁྱོད་དམ་བཅས་༎ མཚན་ཉིད་སྐྱོན་ཡོད་ངེད་ལ་མེད་༎
 (vv 268) yat punar bhavatoktaṃ | pratiṣedhaḥ pratiṣedhyo 'py evam iti mataṃ bhavet tad asad eva | evaṃ tava pratijñā lakṣaṇato dūṣyeta na mameti | [4] atra brūmaḥ |	ཅེས་སྨྲས་པ་གང་ཡིན་པ་འདི་ལ་བཤད་པར་བྱ་སྟེ་།
 yadi kācana pratijñā tatra syān na me tat* eṣa me bhaved doṣaḥ |	གལ་ཏེ་ངས་དམ་བཅས་འགའ་ཡོད་༎ དེས་ན་ང་ལ་སྐྱོན་དེ་ཡོད་༎
 nāsti ca mama pratijñā tasmān naivāsti me doṣaḥ || nagvv_29 ||	ང་ལ་དམ་བཅས་མེད་པས་ན་༎ ང་ལ་སྐྱོན་མེད་ཁོ་ན་ཡིན་༎ གལ་ཏེ་དམ་བཅས་པ་འགའ་ཞིག་ཡོད་ན་ནི་། དེས་ན་ཁྱོད་ཀྱིས་ཇི་སྐད་སྨྲས་པ་བཞིན་དུ་༎
 yadi ca kācin mama pratijñā syāt tato mama pratijñālakṣaṇaprāptatvāt sa pūrvako doṣaḥ | yathā tvayoktaṃ bhāvāḥ tathā mama syān na ca mama kācid asti pratijñā |	ང་ལ་དམ་བཅས་པའི་མཚན་ཉིད་ཁས་བླངས་པ་སྔོན་དུ་སོང་བའི་སྐྱོན་ཡོད་པ་ཞིག་ན་ང་ལ་དམ་བཅས་པ་འགའ་ཡང་མེད་དོ་༎
 tasmāt sarvahhāveṣu śūnyeṣv atyantopaśānteṣu prakṛtivivikteṣu kutaḥ pratijñālakṣaṇaprāptiḥ kutaḥ pratijñālakṣaṇatāprāptikṛto doṣaḥ |	དེའི་ཕྱིར་དངོས་པོ་ཐམས་ཅད་སྟོང་པ་གཏན་དུ་ཉེ་བར་ཞི་བ་རང་བཞིན་གྱིས་དབེན་པ་དག་ལ་དམ་བཅས་པ་ག་ལ་ཡོད་། དམ་བཅས་པའི་མཚན་ཉིད་ཀྱང་ག་ལ་ཡོད་། དམ་བཅས་པའི་མཚན་ཉིད་ལས་བྱུང་བའི་སྐྱོན་ཡང་ག་ལ་ཡོད་དེ་།
 tatra yat bhavatoktaṃ pratijñālakṣaṇaprāptatvāt tavaiva doṣa iti tan nāsti | (vv 270)	དེ་ལ་ཁྱོད་ལ་དམ་བཅས་པའི་མཚན་ཉིད་ཀྱིས་ཐོབ་པའི་ཕྱིར་ཁྱོད་ལ་སྐྱོན་ཡོད་དོ་ཞེས་སྨྲས་པ་གང་ཡིན་པ་དེ་ཡང་མེད་དོ་༎
 yat punar bhavatoktaṃ	ཡང་ཁྱོད་ཀྱིས་།
 pratyakṣeṇa hi tāvad yady upalabhya nivartayasi bhāvān	རེ་ཞིག་དངོས་རྣམས་མངོན་སུམ་གྱིས་༎ དམིགས་ནས་ཟློག་པར་བྱེད་ཡིན་ན་༎
 tan nāsti pratyakṣaṃ bhāvā yenopalabhyaṃta | [5]	གང་གིས་དངོས་རྣམས་དམིགས་འགྱུར་བ་༎
 anumānaṃ pratyuktaṃ pratyakṣeṇāgamopamāne cānumānāgamasādhyā ye 'rthā dṛṣṭāntasādhyāś ceti | [6]	མངོན་སུམ་དེ་ནི་མེད་པ་ཡིན་༏་། རྗེས་དཔག་ལུང་དང་དཔེས་གཞལ་དང་༎ རྗེས་དཔག་ལུང་གིས་བསྒྲུབ་བྱ་དང་༎ དཔེས་བསྒྲུབ་བྱ་བའི་དོན་གང་ཡིན་༎ མངོན་སུམ་གྱིས་ནི་ལན་བཏབ་པོ་༎
 atra vayaṃ brūmaḥ | yadi kiñcid upalabheyaṃ pravarteyaṃ nivartayeyaṃ vā |	ཞེས་སྨྲས་པ་གང་ཡིན་པ་འདི་ལ་བཤད་པར་བྱ་སྟེ་༎
 pratyakṣādibhir arthais tadabhāvān me 'nupālambhaḥ || nagvv_30 ||	གལ་ཏེ་མངོན་སུམ་ལ་སོགས་པའི་༎ དོན་གྱིས་འགའ་ཞིག་དམིགས་ན་ནི་༎ བསྒྲུབ་པའམ་བཟློག་པར་བྱ་ན་དེ་༎ མེད་ཕྱིར་ང་ལ་ཀླན་ཀ་མེད་༎
 yady ahaṃ kiñcid artham upalabheyaṃ pratyakṣānumānopa + + + + hetubhiḥ pramāṇaiḥ |	གལ་ཏེ་ངས་མངོན་སུམ་དང་། རྗེས་སུ་དཔག་པ་དང་། དཔེས་འཇལ་བ་དང་། ལུང་རྣམས་ཀྱིས་སམ་།
 caturṇāṃ vā pramāṇānāṃ | anyatamānyatamena |	ཚད་མ་བཞི་རྣམས་ལས་གང་ཡང་རུང་བ་ཞིག་གིས་འགའ་ཞིག་དམིགས་ན་ནི་༄༡༢༩ཨ་༌་༎ དེའི་ཕྱིར་སྒྲུབ་པར་བྱེད་པའམ་།
 ata evaṃ pravartayeyaṃ vārtham evāhaṃ kiñcin nopalabhate tasmān na pravartayāmi na nivartayāmi |	དོན་བཟློག་པར་བྱ་ན་ངས་དོན་ཇི་ལྟར་ཡང་མ་དམིགས་པས་དེའི་ཕྱིར་བསྒྲུབ་པར་ཡང་མི་བྱ་། བཟློག་པར་ཡང་མི་བྱ་།
 tatraivaṃ sati yau bhavatopālambhoktaḥ | yadi pratyakṣādīnāṃ pramāṇānām anyatamena upalabhya bhāvān vinivartayasīti |	དེ་ལྟར་གྱུར་དང་དེ་ལ་ཁྱོད་ཀྱིས་གལ་ཏེ་མངོན་སུམ་ལ་སོགས་པ་རྣམས་ལ་ཚད་མ་གང་ཡང་རུང་བ་ཞིག་གིས་དངོས་པོ་རྣམས་དམིགས་ནས་ཟློག་པར་བྱེད་པ་ཡིན་ན་།
 nanu bhavatoktāni pramāṇāni na santi taiś ca pramāṇair api gamyārthā iti sa me bhavaty evānupālambha iti | (vv 272) + + + + |	ཚད་མ་དེ་དག་ཀྱང་མེད་། དེ་དག་གིས་ཁོང་དུ་ཆུད་པར་བྱ་བའི་དོན་ཡང་མེད་པས་ཞེས་ཀླན་ཀ་སྨྲ་བ་གང་ཡིན་པའི་ཀླན་ཀ་དེ་ང་ལ་མི་འབྱུང་ངོ་༎ འདི་ལྟར་གཞན་ཡང་།
 yadi ca pramāṇatas teṣāṃ teṣāṃ prasiddhir arthānām |	གལ་ཏེ་ཁྱོད་ཀྱིས་དོན་དེ་རྣམས་༎ ཚད་མ་ཉིད་ཀྱིས་རབ་གྲུབ་ན་༎
 teṣāṃ punaḥ prasiddhiṃ brūhi kathaṃ teṣāṃ pramāṇānāṃ || nagvv_31 ||	ཁྱོད་ཀྱིས་ཚད་མ་དེ་རྣམས་ཀྱང་༎ ཇི་ལྟར་རབ་ཏུ་འགྲུབ་པར་འགྱུར་༎
 prasiddhir iti yadi ca pramāṇatas teṣāṃ teṣām arthānāṃ prameyānāṃ siddhiṃ manyase yathā mānair meyānāṃ |	གལ་ཏེ་འཇལ་བར་བྱེད་པ་རྣམས་ཀྱིས་གཞལ་བར་བྱ་བ་དག་བཞིན་དུ་ཁྱོད་ཀྱི་དོན་གཞལ་བར་བྱ་བ་དེ་རྣམས་ཚད་མ་ཉིད་ཀྱིས་རབ་ཏུ་འགྲུབ་པ་ཡིན་པར་སེམས་ན་།
 tathā teṣām idānīṃ pratyakṣānumānopamānāgamānāṃ caturṇāṃ pramāṇānāṃ kutaḥ prasiddhiḥ |	འོན་ད་ཚད་མ་རྣམས་པ་བཞི་པོ་མངོན་སུམ་དང་། རྗེས་སུ་དཔག་པ་དང་། དཔེས་གཞལ་བ་དང་། ལུང་དེ་རྣམས་གང་གིས་རབ་ཏུ་འགྲུབ་།
 yadi tāvan niḥpramāṇānāṃ pramāṇaṃ syān nādeḥ siddhis tatrāsti naiva madhyasya nāntasya | yadi punaḥ manyase pramāṇaiḥ prasiddhiḥ pramāṇato 'rthānāṃ prasiddhir iti | hīyate pratijñā |	གལ་ཏེ་རེ་ཞིག་ཚད་མ་དེ་རྣམས་ནི་ཚད་མ་གཞན་རྣམས་ཀྱིས་ཡོད་པར་འགྲུབ་ལ་། དོན་རྣམས་ནི་ཚད་མས་རབ་ཏུ་འགྲུབ་པ་ཡིན་ནོ་ཞེ་ན་། དམ་བཅས་པ་ཉམས་པར་འགྱུར་རོ་༎
 (vv 274) tathāpi	འོན་ཏེ་ཡང་།
 anyaiḥ yadi pramāṇaiḥ pramāṇasidhir bhavaty anavasthā syān | nādeḥ siddhis tatrāsti naiva madhyasya nāntasya || nagvv_32 || yadi punar manyase |	གལ་ཏེ་ཚད་མ་གཞན་རྣམས་ཀྱིས་༎ ཚད་མ་འགྲུབ་ན་ཐུག་པ་མེད་༎
 pramāṇaiḥ prameyāṇāṃ prasiddhis teṣāṃ pramāṇānām anyaiḥ pramāṇaiḥ prasiddhir anavasthāprasaṅgaḥ |	གལ་ཏེ་འདི་སྙམ་དུ་གཞལ་བར་བྱ་བ་ནི་ཚད་མ་རྣམས་ཀྱིས་འགྲུབ་ལ་། ཚད་མ་དེ་རྣམས་ཀྱང་ཚད་མ་གཞན་རྣམས་ཀྱིས་འགྲུབ་པར་སེམས་ན་། དེ་ལྟ་ན་ཡང་ཐུག་པ་མེད་པར་འགྱུར་རོ་༎
 anavasthāprasaṅge ko doṣaḥ |	དེ་ལ་ཐུག་པ་མེད་པར་གྱུར་ན་ཉེས་པ་ཅི་ཡོད་ཅེ་ན་། དེ་ལ་འདི་ལྟར་བཤད་པར་བྱ་སྟེ་།
 nādeḥ siddhis tatrāsti naiva madhyasya nāntasya |	དེ་ལ་དང་པོ་འགྲུབ་མིན་ལ་༎ བར་མ་མིན་ཞིང་ཐ་མའང་མིན་༎ ཐུག་པ་མེད་པར་གྱུར་པ་ན་༎
 asyānavasthāprasaṅge ādeḥ siddhir nāsti |	དང་པོ་འགྲུབ་པར་མི་འགྱུར་རོ་༎
 kiṃ kāraṇaṃ teṣam api hi pramāṇānām anyaiḥ pramāṇaiḥ siddhis teṣām anyair iti nāsty ādiḥ |	ཅིའི་ཕྱིར་ཞེ་ན་། ཚད་མ་དེ་རྣམས་ཀྱང་ཚད་མ་གཞན་རྣམས་ཀྱིས་རབ་ཏུ་འགྲུབ་པ་ཡིན་ལ་། དེ་རྣམས་ཀྱང་གཞན་རྣམས་ཀྱི་ཡིན་པས་འདི་ལ་དང་པོ་མེད་དོ་༎
 āder asadbhāvāt kuto madhyaṃ kuto antaḥ |	དང་པོ་མེད་པའི་ཕྱིར་བར་མ་ཡང་ག་ལ་ཡོད་།
 tasmāt teṣāṃ pramāṇānām anyaiḥ pramāṇaiḥ prasiddhiḥ nopapadyateti | (vv 276)	ཐ་མ་ཡང་ག་ལ་ཡོད་དེ་དེའི་ཕྱིར་ཚད་མ་དེ་རྣམས་ནི་ཚད་མ་གཞན་རྣམས་ཀྱིས་རབ་ཏུ་༄༡༢༩བ་འགྲུབ་པའོ་ཞེས་སྨྲས་པ་གང་ཡིན་པ་དེ་མི་འཐད་དོ་༎
 teṣām atha pramāṇair vinā prasiddhiḥ vihīyate vādaḥ |	འོན་ཏེ་ཚད་མ་མེད་པར་ཡང་༎ དེ་རྣམས་འགྲུབ་ན་སྨྲ་བ་ཉམས་༎ མི་འདྲ་ཉིད་དེ་དེ་ཡིན་ན་༎ གཏན་ཚིགས་ཁྱད་པར་སྨྲ་བར་གྱིས་༎
 vaiṣamikatvaṃ tasmin viśeṣahetuś ca vaktavyaḥ || nagvv_33 || atha manyase teṣāṃ pramāṇānāṃ vinā pramāṇaiḥ prasiddhiḥ prameyānāṃ punar arthānāṃ pramāṇaiḥ prasiddhir iti |	འོན་ཏེ་ཚད་མ་རྣམས་མེད་པར་ཡང་ཚད་མ་དེ་རྣམས་རབ་ཏུ་འགྲུབ་པ་ཡིན་ལ་།
 evaṃ sati yas te vādaḥ pramāṇaiḥ prasiddhir arthānām iti hīyate vaiṣamikatvañ ca bhavati | keṣāñcit | arthānāṃ pramāṇaiḥ prasiddhiḥ keṣāñcin neti viśeṣahetuś ca vaktavyaḥ |	གཞལ་བར་བྱ་བའི་དོན་རྣམས་ནི་ཚད་མ་རྣམས་ཀྱིས་རབ་ཏུ་འགྲུབ་པ་ཡིན་ནོ་སྙམ་དུ་སེམས་ན་དེ་ལྟ་ན་ནི་ཁྱོད་ཀྱི་ཚད་མ་རྣམས་ཀྱིས་དོན་རྣམས་འགྲུབ་པོ་ཞེས་སྨྲས་པ་གང་ཡིན་པ་དེ་ཉམས་པར་འགྱུར་ལ་དོན་ཁ་ཅིག་ནི་ཚད་མ་རྣམས་ཀྱིས་རབ་ཏུ་འགྲུབ་པ་ཡིན་། ཁ་ཅིག་ནི་མ་ཡིན་ནོ་ཞེས་མི་འདྲ་པ་ཉིད་དུ་ཡང་འགྱུར་རོ་༎
 yena hetunā keṣāṃcid arthānāṃ pramāṇaiḥ prasiddhiḥ keṣāñcin neti |	དེ་ལྟ་ན་ནི་གཏན་ཚིགས་གང་གིས་ན་དོན་ཁ་ཅིག་ནི་ཚད་མ་རྣམས་ཀྱིས་རབ་ཏུ་འགྲུབ་པ་ཡིན་ལ་། ཁ་ཅིག་ནི་མ་ཡིན་ནོ་ཞེས་གཏན་ཚིགས་ཀྱི་ཁྱད་པར་ཡང་སྨྲ་བར་བྱ་པ་ཡིན་ལ་། བ་ཡིན་ན་། 
 sā ca nopadiṣṭaḥ tasmād iyam api kalpanā nopapanneti |	དེ་ཡང་མ་བསྟན་པས་དེའི་ཕྱིར་རྟོག་པ་འདི་ཡང་འཐད་པ་མ་ཡིན་ནོ་༎ འདིར་སྨྲས་པ་། ཇི་སྐད་དུ་། ཇི་ལྟར་མེ་ཡིས་གཞན་བདག་ཉིད་༎ གསལ་བྱེད་དེ་བཞིན་རང་ཉིད་ལྟར་༎
 atrāha | pramāṇāny eva mama svātmānaṃ parātmānañ ca prasādhayanti | yathoktaṃ |	དེ་བཞིན་ཚད་མ་རྣམས་ཀྱང་ནི་༎ རང་གཞན་བདག་ཉིད་འགྲུབ་ཅེ་ན་༎ ཞེས་བསྟན་པ་ལྟ་བུར་ཚད་མ་རྣམས་ཀྱིས་རང་གི་བདག་ཉིད་དང་། གཞན་གྱི་བདག་ཉིད་རབ་ཏུ་སྒྲུབ་པར་བྱེད་པ་ཡིན་ཏེ་།
 dyotayati svātmānaṃ yathā hutāsaḥ tathā parātmānaṃ | svaparātmānāv eṣāṃ prasādhayanti pramāṇāni | param iva svātmānaṃ parātmānañ ceti ||	ཇི་ལྟར་མེས་རང་གི་བདག་ཉིད་དང་། གཞན་གྱི་བདག་ཉིད་གསལ་བར་བྱེད་པ་དེ་བཞིན་དུ་ཚད་མ་རྣམས་ཀྱང་རང་གི་བདག་ཉིད་དང་གཞན་གྱི་བདག་ཉིད་རབ་ཏུ་སྒྲུབ་པར་བྱེད་པ་ཡིན་ནོ་ཞེ་ན་།
 (vv 278) atrocyate |	འདིར་བཤད་པ་། སྨྲས་པ་དེ་ནི་མི་མཐུན་ཏེ་༎ མུན་ཁུང་གི་ནི་རྫ་མ་ལྟར༎ དེ་ལ་མི་དམིགས་མ་མཐོང་བས་༎
 viṣamopanyāso 'yaṃ na hy ātmānaṃ prakāśayaty agniḥ |	མེ་ནི་རང་ལ་གསལ་བྱེད་མིན་༎
 na hi tasyānupalabdhiḥ dṛṣṭā tamasīva kumbhasya || nagvv_34 || viṣama evāyam upanyāsaḥ | agnivat pramāṇāni svātmānañ ca prasādhayanti parātmānañ ca prasādhayantīti |	མེ་དང་འདྲ་བར་ཚད་མ་རྣམས་ཀྱང་རང་དང་གཞན་གྱི་བདག་ཉིད་གཉིས་རབ་ཏུ་སྒྲུབ་པར་བྱེད་པ་ཡིན་ནོ་ཞེས་སྨྲས་པ་དེ་ནི་མི་མཐུན་པ་ཉིད་ཡིན་ཏེ་།
 na hy agnir ātmānaṃ prakāśayati |	མེ་ནི་རང་ལས་གསལ་བར་བྱེད་པ་མ་ཡིན་ཏེ་།
 yadi hi yathā prāg evāgninā aprakāśitas tamasi kumbho nopalabhyate |	ཇི་ལྟར་མེ་མི་འབར་བའི་སྔ་རོལ་ན་མུན་ཁུང་ན་བུམ་པ་མི་དམིགས་པ་ལ་། མེས་གསལ་བར་བྱས་ནས་ཕྱིས་དམིགས་པ་དེ་བཞིན་དུ་།
 athottarakālam upalabhyate 'gninā prakāśitaḥ san evam eva yady agninā na prakāśitaḥ prāg agniḥ syād uttarakālam agneḥ prakāśanaṃ syāt | ataḥ svātmānaṃ prakāśayen naitad evaṃ |	གལ་ཏེ་གསལ་བར་མ་བྱས་པའི་སྔ་རོལ་དུ་མེ་མུན་ཁུང་ན་ཡོད་ལ་། ཕྱིས་མེས་གསལ་བར་འགྱུར་ན་ནི་དེའི་ཕྱིར་རང་གི་བདག་ཉིད་གསལ་བར་བྱེད་པ་ཡིན་ན་། དེ་ཡང་དེ་ལྟ་༄༡༣༠ཨ་༌་༎
 tasmād iyam api kalpanā nopapadyanteti | (vv 280)	མ་ཡིན་པས་རྟོག་པ་འདི་ཡང་འཐད་པ་མ་ཡིན་ནོ་༎
 kiñcānyat |	འདི་ལྟར་གཞན་ཡང་།
 yadi ca svātmānam ayaṃ tvadvacanena prakāśayaty agniḥ |	གལ་ཏེ་ཁྱོད་ཀྱི་ཚིག་གིས་ནི་༎ མེ་འདིས་རང་བདག་གསལ་བྱེད་ན་༎ འོན་མེ་ཡིས་གཞན་བཞིན་དུ་༎
 param iva na tv ātmānaṃ paridhakṣyaty api hutāśaḥ || nagvv_35 ||	རང་ལ་སྲེག་པའང་བྱེད་པར་འགྱུར་༎
 yadi ca tvadvacanena yathā parātmānaṃ prakāśayaty agniḥ evam eva svātmānam api prakāśayaty agnir iti |	གལ་ཏེ་ཁྱོད་ཟེར་བ་ཇི་ལྟར་མེས་གཞན་གྱི་རང་བཞིན་གསལ་བར་བྱེད་པ་དེ་བཞིན་དུ་རང་གི་བདག་ཉིད་ལ་ཡང་གསལ་བར་བྱེད་དོ་ཞེ་ན་། 
 nanu yathā parātmānaṃ dahati | evam eva svātmānam api dhakṣyatīti |	འོན་ནི་ཇི་ལྟར་གཞན་གྱི་བདག་ཉིད་སྲེག་པར་བྱེད་པ་དེ་བཞིན་དུ་རང་གི་བདག་ཉིད་ལ་ཡང་སྲེག་པར་འགྱུར་བ་ཞིག་ན་།
 na caitad evaṃ | tatra yad uktaṃ parātmānam iva svātmānaṃ prakāśayaty agnir iti tan na ||	དེ་ནི་དེ་ལྟར་ཡང་མ་ཡིན་པས་དེ་ལ་མེ་ནི་གཞན་གྱི་བདག་ཉིད་ལ་ཡང་གསལ་བར་བྱེད་དོ་ཞེས་སྨྲས་པ་གང་ཡིན་པ་དེ་མི་རུང་ངོ་༎ 
 kiñcānyat |	འདི་ལྟར་གཞན་ཡང་། གལ་ཏེ་ཁྱོད་ཀྱི་ཚིག་གིས་ནི་༎
 yadi ca svaparātmānau tvadvacanena prakāśayaty agniḥ |	མེ་ཡིས་རང་གཞན་བདག་གསལ་བྱེད་༎
 prachādayiṣyati tamaḥ svaparātmānau hutāśa iva || nagvv_36 ||	མེ་བཞིན་དུ་ནི་མུན་པ་ཡང་༎ རང་གཞན་བདག་ལ་བསྒྲིབ་པར་འགྱུར་༎
 yadi ca bhavato bhavato matena svātmāparātmānau prakāśayaty agniḥ |	གལ་ཏེ་ཁྱོད་ཀྱི་ལུགས་ཀྱིས་ནི་མེ་ནི་རང་དང་གཞན་གྱི་བདག་ཉིད་གཉིས་གསལ་བར་བྱེད་པ་ཡིན་ན་། 
 nanv idānīṃ pratipakṣabhūtatamo 'pi svaparātmānau chādayet |	འོན་ནི་ད་གཉེན་པོར་གྱུར་པ་མུན་པ་ཡང་རང་དང་གཞན་གྱི་བདག་ཉིད་གཉིས་བསྒྲིབ་པར་འགྱུར་བ་ཞིག་ན་།
 naitad iṣṭaṃ | tatra yad uktaṃ svaparātmānau prakāśayaty agnir iti tan na || (vv 282)	དེ་ནི་དེ་ལྟར་ཡང་མ་ཡིན་པས་དེ་ལ་མེ་ནི་རང་དང་གཞན་གྱིས་བདག་ཉིད་གཉིས་གསལ་བར་བྱེད་པ་ཡིན་ནོ་ཞེས་སྨྲས་པ་གང་ཡིན་པ་དེ་རུང་བ་མ་ཡིན་ནོ་༎
 kiñcānyat |	འདི་ལྟར་གཞན་ཡང་། གསལ་བྱེད་དེ་ནི་མུན་སེལ་ཏེ་༎
 nāsti tamaś ca jvalane yatra ca tiṣṭhate parātmani jvalanaḥ | kurute kathaṃ prakāśaṃ sa hi prakāśo andhakāravadhaḥ || nagvv_37 ||	མེ་དང་གང་ན་མི་གནས་པ་༎ གཞན་ནའང་མུན་པ་ཡོད་མིན་ན་༎ ཇི་ལྟར་གསལ་བར་བྱེད་པ་ཡིན་༎
 iha cāgnau nāsti tamaḥ |	འདིར་མེ་ལ་ཡང་མུན་པ་མེད་ལ་༎
 nāpi ca yatrāgnis tatrāsti tamaḥ |	གང་ན་མེ་ཡོད་པ་དེ་ན་ཡང་མུན་པ་མེད་དོ་༎ གསལ་བར་བྱེད་པ་ཞེས་བྱ་བ་ནི་མུན་པ་སེལ་བ་ཡིན་པས་དེའི་ཕྱིར་མེ་ལ་ཡང་མུན་པ་མེད་ལ་། 
 prakāśaś ca nāma tamasaḥ pratighātas tatra katham asya tamasaḥ | pratighātam agniḥ karoti | yasya pratighātat svaparātmānau prakāśayatīti ||	གང་ན་མེ་ཡོད་པ་དེ་ན་ཡང་མུན་པ་མེད་ན་མེད་གང་ཞིག་སེལ་བར་རང་དང་གཞན་གྱི་བདག་ཉིད་གཉིས་གསལ་བར་བྱེད་པའི་མེས་མུན་པ་གང་ཞིག་སེལ་བར་བྱེད་པ་མེད་ལ་། 
 āha | yad yasmād evaṃ nāgnau tamo 'sti |	། འདིར་སྨྲས་པ་། འོ་ན་གང་གི་ཕྱིར་མེ་ལ་ཡང་མུན་པ་མེད་།
 nāpi yatrāgnis tatra tamo 'sti | yasmād evaṃ svaparātmānau na prakāśayaty agniḥ |	མེ་གང་ན་ཡོད་པ་དེ་ན་ཡང་མུན་པ་མེད་པ་དེ་ཉིད་ཀྱི་ཕྱིར་མེ་ནི་རང་དང་གཞན་གྱི་བདག་ཉིད་གཉི་ག་གསལ་བར་བྱེད་པ་མ་ཡིན་ནམ་། 
 tena hy utpadyamānenaivāgninā tamasaḥ pratighataḥ kutaḥ tasmān nāgnau tamo 'sti |	མེ་འབྱུང་བ་ཉིད་ན་མེ་དེས་མུན་པ་བསལ་བ་ཡིན་ཏེ་། དེ་ལ་ཡང་མུན་པ་དེ་མེད་།
 nāpi yatrāgniḥ tatra tamo 'sti | yasmād utpadyamāna evobhayaṃ prakāśayaty agniḥ svātmānaṃ parātmānañ ceti | (vv 284)	༄༡༣༠བ་མེ་གང་ན་ཡོད་པ་དེ་ན་ཡང་མུན་པ་མེད་དེ་དེའི་ཕྱིར་མེ་འབྱུང་བ་ཁོ་ན་རང་གི་བདག་ཉིད་དང་། གཞན་གྱི་བདག་ཉིད་གཉི་ག་གསལ་བར་བྱེད་པ་ཡིན་ནོ་ཞེ་ན་།
 atrocyate	འདིར་སྨྲས་པ་། མེ་འབྱུང་བ་ན་གསལ་བྱེད་པ་༎ ཡང་དག་མིན་པར་སྨྲ་བ་སྟེ་༎ མེ་འབྱུང་བ་ན་མུན་པ་དང༎ ཕྲད་པ་མེད་པ་ཁོ་ན་ཡིན་༎
 utpadyamāna eva prakāśayaty agnir ity asadvādaḥ |	མེ་དེ་ནི་འབྱུང་བ་ཁོན་ན་རང་གི་བདག་ཉིད་དང་གཞན་གྱི་བདག་ཉིད་གསལ་བར་བྱེད་དོ་ཞེས་སྨྲ་བ་དེ་ནི་འཐད་པ་མ་ཡིན་ནོ་༎ ཅིའི་ཕྱིར་ཞེ་ན་།
 utpadyamāna eva prāpnoti tamo na hi hutāśaḥ || nagvv_38 ||	མེ་འབྱུང་བ་ཉིད་ན་མུན་པ་དང་ཕྲད་པ་མེད་པ་ཁོ་ན་ཡིན་།
 ayam agnir utpadyamāna eva prakāśayati svātmānaṃ parātmānañ ceti | nāyam upapadyate vādaḥ |	མེ་དེ་ནི་འབྱུང་བ་ཁོ་ན་ན་རང་གི་བདག་ཉིད་དང་གཞན་གྱི་བདག་ཉིད་གསལ་བར་བྱེད་དོ་ཞེས་སྨྲ་བ་དེ་ནི་འཐད་པ་མ་ཡིན་ནོ་༎ ཅིའི་ཕྱིར་ཞེ་ན་།
 kasmān na hy utpadyamāna evāgniḥ tamaḥ prāpnoti |	མེ་འབྱུང་བ་ཉིད་ན་མུན་པ་དང་ཕྲད་པ་མེད་པ་ཡིན་ཏེ་།
 aprāptatvān naivopahanti |	མ་ཕྲད་པའི་ཕྱིར་དེ་སེལ་བར་མི་བྱེད་དོ་༎
 tamasaś cānupaghātān nāsti prakāśaḥ |	མུན་པ་མ་བསལ་བའི་ཕྱིར་གསལ་བར་ཡང་མི་བྱེད་དོ་༎ འདི་ལྟར་གཞན་ཡང་།
 aprāpto 'pi jvalano yadi vā punar andhakāram upahanyāt |	ཡང་ན་མེ་དང་མ་ཕྲད་ཀྱང་༎ མུན་པ་སེལ་བར་བྱེད་ན་ནི་༎ འདི་ན་ཡོད་པ་གང་ཡིན་པས་༎
 sarveṣu lokadhātuṣu tamo 'yam iha saṃsthita upahanyāt || nagvv_39 ||	ཇི་རྟེན་ཁམས་ཀུན་མུན་སེལ་འགྱུར་༎
 athāpi manyase aprāpto 'py agnir andhakāram upahantīti |	འོན་ཏེ་མེ་ནི་མུན་པ་དང་ཕྲད་པར་ཡང་སེལ་བར་བྱེད་དོ་སྙམ་དུ་སེམས་ན་།
 nanv idānīm iha saṃsthito agniḥ sarvalokadhātustham upahaniṣyati tamaḥ tulyāyām aprāpto na caitad evaṃ dṛṣṭaṃ | tasmād aprāpyaivāgnir andhakāram upahantīti yad iṣṭaṃ | tan na | (vv 286)	འོན་ནི་དེ་མ་ཕྲད་པར་འདྲ་བས་འདི་ན་གནས་པའི་མེས་འཇིག་རྟེན་གྱི་ཁམས་ཐམས་ཅད་ན་གནས་པའི་མུན་པ་སེལ་བར་འགྱུར་བ་ཞིག་ན་། དེ་ནི་དེ་ལྟར་ཡང་མ་ཡིན་པས་དེའི་ཕྱིར་མེ་ནི་མུན་པ་དང་མ་ཕྲད་པར་སེལ་བར་བྱེད་པར་འདོད་པ་གང་ཡིན་པ་དེ་མི་། རུང་ངོ་༎ འདི་ལྟར་གཞན་ཡང་།
 yadi ca svataḥ pramāṇasiddhir anapekṣya te prameyāṇi |	གལ་ཏེ་རང་ལས་ཚད་མ་གྲུབ་༎ གཞལ་བྱ་རྣམས་ལ་མ་ལྟོས་པར་༎
 bhavati pramāṇasiddhiḥ nāparāpekṣā hi siddhir iti || nagvv_40 ||	ཁྱོད་ཀྱི་ཚད་མ་འགྲུབ་འགྱུར་འདིར་༎ གཞན་ལ་མི་ལྟོས་རང་འགྲུབ་འགྱུར་༎
 yadi cāgnivat svataḥ pramāṇasiddhir iti manyase |	གལ་ཏེ་མེ་བཞིན་དུ་རང་ལས་ཚད་མ་གྲུབ་པོ་སྙམ་དུ་སེམས་ན་།
 anapekṣāpi prameyāṇi pramāṇānāṃ siddhiḥ bhaviṣyatīti kiṃ kāraṇaṃ | na hi svataḥ param apekṣate |	གཞལ་བར་བྱ་བའི་དོན་རྣམས་ལ་མ་ལྟོས་པར་ཡང་ཚད་མ་རྣམས་རབ་ཏུ་འགྲུབ་པར་འགྱུར་རོ་༎ ཅིའི་ཕྱིར་ཞེ་ན་༏་རང་ལས་གྲུབ་པ་ནི་གཞན་ལ་ལྟོས་པ་མ་ཡིན་ནོ་༎
 athāpekṣyate na svataḥ prasiddhiḥ |	འོན་ཏེ་ལྟོས་ན་ནི་རང་ལས་གྲུབ་པ་མ་ཡིན་ནོ་༎
 atrāha | yadi nāpekṣyante prameyān arthān apramāṇāni ko doṣo bhaviṣyatīti | atrocyate |	འདིར་སྨྲས་པ་། གལ་ཏེ་ཚད་མ་རྣམས་གཞལ་བར་བྱ་པའི་དོན་རྣམས་ལ་ནི་། མི་ལྟོས་ན་སྐྱོན་ཅིར་འགྱུར་ཞེ་ན་། འདིར་བཤད་པ་།
 anāpeksā hi prameyān arthān yadi te pramāṇasaṃsiddhiḥ |	གལ་ཏེ་གཞལ་བྱའི་དོན་རྣམས་ལ་། ༄༡༣༡ཨ་༌་༎ མ་ལྟོས་ཁྱོད་ཀྱི་ཚད་མ་འགྲུབ་༎
 bhavati na bhavanti kasyacid evam imāni pramāṇāni || nagvv_41 ||	ཚད་མ་འདི་རྣམས་ཁོ་ན་ནི་༎ གང་གིའང་ཡིན་པར་མི་འགྱུར་རོ་༎
 yadi prameyān arthān anapekṣya siddhir bhavati pramāṇānām iti | tānīmāni pramāṇāni na kasyacit pramāṇāni bhavanti | evaṃ doṣaḥ ||	གལ་ཏེ་ཚད་མ་རྣམས་གཞལ་བར་བྱ་བ་དོན་རྣམས་ལ་མི་ལྟོས་པར་རབ་ཏུ་འགྲུབ་པ་ཡིན་ནོ་ཞེ་ན་། དེ་ལྟ་ན་ནི་ཁྱོད་ཀྱིས་ཚད་མ་འདི་རྣམས་གང་གི་ཕྱིར་ཚད་མ་ཡང་མ་ཡིན་པའི་སྐྱོན་དེ་ལྟ་བུར་འགྱུར་རོ་༎
 atha kasyacit bhavanti prāmāṇāni |	འོ་ན་ཏེ་ཚད་མ་རྣམས་དོན་འགའ་ཞིག་གི་ཡིན་ནོ་ཞེ་ན་།
 naivedānīm anapekṣya prameyān arthān pramāṇāni bhavanti || (vv 288)	དེ་གཞལ་བར་བྱ་བའི་དོན་རྣམས་ལ་མི་ལྟོས་པར་ཚད་མ་རྣམས་སུ་འགྱུར་བ་མ་ཡིན་ནོ་༎ འོན་ཏེ་ལྟོས་ནས་དེ་རྣམས་འགྲུབ་༎
 atha matam apekṣa siddhis teṣām iti atra bhavati ko doṣaḥ |	འདོད་ན་དེ་ལ་སྐྱོན་ཅིར་འགྱུར་༎
 siddhasya na sādhanaṃ syān nāsiddho pekṣate hy anyat || nagvv_42 ||	མ་གྲུབ་གཞན་ལ་མི་ལྟོས་པས་༎ གྲུབ་པ་སྒྲུབ་པར་བྱེད་པ་ཡིན་༎
 athāpi matam apekṣya prameyān arthān pramāṇānāṃ siddhir bhavatīti | evaṃ te sati siddhasya pramāṇacatuṣṭayasya sādhanaṃ bhavatīti | kiṃ kāraṇaṃ |	འོན་ཏེ་གཞལ་བར་བྱ་བའི་དོན་རྣམས་ལ་ལྟོས་ནས་ཚད་མ་རྣམས་འགྲུབ་པ་ཡིན་པར་འདོད་དོ་ཞེ་ན་། 
 na hy asiddhasyārthasyāpekṣaṇaṃ bhavati |	དེ་ལྟ་ན་ནི་དོན་མ་གྲུབ་པ་ནི་ལྟོས་པ་མེད་པ་ཡིན་ཏེ་།
 na hy asiddho devadattaḥ kañcid artham apekṣate na ca siddhasya sādhanam iṣṭaṃ kṛtasya kāraṇam anupapatter iti ||	ལྷ་སྦྱིན་མ་གྲུབ་པ་ན་ནི་དོན་འགའ་ལ་ཡང་ལྟོས་པ་མ་ཡིན་པས་ཁྱོད་ཀྱིས་ཚད་མ་གཞི་འགྱུར་བ་འགྲུབ་པར་བྱེད་པ་ཡིན་ནོ་༎ གྲུབ་པ་སྒྲུབ་པར་བྱེད་པ་ཡང་འདོད་པ་མ་ཡིན་ཏེ་། བྱས་པ་བྱེད་པར་མི་འཐད་པའི་ཕྱིར་རོ་༎
 kiñcānyat |	འདི་ལྟར་གཞན་ཡང་།
 sidhyanti hi prameyāṇy apekṣya yadi sarvathā pramāṇāni |	གལ་ཏེ་ཡོང་ཡེ་གཞལ་བྱ་ལ་༎ ལྟོས་ནས་ཚད་མ་གྲུབ་ཡིན་ན་༎
 bhavanti prameyasiddhir anapekṣyaiva pramāṇāni || nagvv_43 ||	ཚད་མ་རྣམས་ལ་མ་ལྟོས་པར་༎ གཞལ་བར་བྱ་བ་འགྲུབ་པར་འགྱུར་༎
 yadi prameyāṇy apekṣya pramāṇāni sidhyanti |	གལ་ཏེ་ཚད་མ་རྣམས་ནི་གཞལ་བར་བྱ་བ་རྣམས་ལ་ལྟོས་ནས་སོ་ཞེ་ན་།
 nedānīṃ pramāṇāny apekṣya prameyāṇi sidhyanti |	དེ་ཚད་མ་རྣམས་ལ་ལྟོས་ནས་གཞལ་བར་བྱ་བ་མ་གྲུབ་པར་མི་འགྱུར་རོ་༎ ཅིའི་ཕྱིར་ཞེ་ན་།
 kiṃ kāraṇaṃ na hi sādhyaṃ sādhanaṃ sādhanaṃ sādhayati |	བསྒྲུབ་པར་བྱ་བ་ནི་སྒྲུབ་པར་བྱེད་པ་སྒྲུབ་པར་མི་བྱེད་ལ་།
 sādhanāni ca | kila prameyāṇāṃ pramāṇāni || (vv 290)	ཚད་མ་རྣམས་ཀྱིས་སྒྲུབ་པར་བྱེད་པ་ཡང་གཞལ་བྱ་རྣམས་ཡིན་ནོ་ཞེས་གྲག་གོ་༎
 kiñcānyat |	འདི་ལྟར་གཞན་ཡང་།
 yadi ca prameyasiddhir anapekṣaiva bhavati pramāṇāni |	གལ་ཏེ་ཚད་མ་རྣམས་ལ་ནི་༎ མ་ལྟོས་པར་ཡང་གཞལ་བྱ་འགྲུབ་༎ གང་ཕྱིར་ཁྱོད་ཀྱི་དེ་གྲགས་པ་༎
 kin te pramāṇasiddhyā tāni yad arthaṃ prasiddhaṃ tata || nagvv_44 ||	ཚད་མ་གྲུབ་པས་ཅི་ཞིག་བྱ་༎
 yadi ca manyase 'napekṣyaiva pramāṇāni prameyānāṃ prasiddhir bhavati | kim idānīṃ te pramāṇasiddhyā paryanviṣṭayā kiṃ kāraṇaṃ |	གལ་ཏེ་ཚད་མ་རྣམས་ལ་མ་ལྟོས་པར་གཞལ་བར་བྱ་བ་རྣམས་འགྲུབ་པོ་སྙམ་དུ་སེམས་ན་། ཅི་དེ་ཁྱོད་ཀྱི་ཚད་མ་གྲུབ་པར་ཡོངས་སུ་བརྟག་པས་ཅི་ཞིག་བྱ་༎ ཅིའི་ཕྱིར་ཞེ་ན་།
 yad arthaṃ hi tāni pramāṇāni paryanviṣyeran | te prameyārthā vinā pramāṇaiḥ siddhāḥ tatra kiṃ pramāṇaiḥ kṛtyaṃ |	གང་གི་དོན་དུ་ཁྱོད་ཀྱི་ཚད་མ་དེ་རྣམས་ཡོངས་སུ་བརྟག་པའི་གཞལ་བར་བྱ་བའི་༄༡༣༡བ་དོན་དེ་རྣམས་ནི་ཚད་མ་རྣམས་མེད་པར་ཡང་གྲུབ་པ་ཡིན་པས་དེ་ལ་ཁྱོད་ཀྱི་ཚད་མ་རྣམས་ཀྱིས་ཅི་ཞིག་བྱ་།
 atha tu pramāṇasiddhir bhavaty apekṣyaiva te prameyāṇi |	ཅི་སྟེ་ཁྱོད་ཀྱི་ཚད་མ་རྣམས་༎ གཞལ་བྱ་རྣམས་ལ་ལྟོས་ནས་འགྲུབ་༎ དེ་ལྟར་ཁྱོད་ཀྱི་ཚད་མ་རྣམས་༎ གཞལ་བྱ་ངེས་པར་བཟློག་པར་འགྱུར་༎
 vyatyaya evaṃ sati te dhruvaṃ pramāṇaprameyāṇāṃ || nagvv_45 || athāpi manyase 'pekṣyaiva prameyān arthāna pramāṇani bhavanti | evaṃ te sati mā bhūt pūrvoktadoṣa iti kṛtvā | evaṃ te sati vyatyayaḥ + + + + + yāṇāṃ bhavati |	ཅི་སྟེ་སྔར་སྨྲས་པའི་སྐྱོན་དུ་འགྱུར་བ་ན་མི་རུང་ངོ་སྙམ་ནས་ཚད་མ་རྣམས་ནི་གཞལ་བར་བྱ་བའི་དོན་རྣམས་ལ་ལྟོས་པ་ཡིན་ནོ་སྙམ་དུ་སེམས་ན་དེ་ལྟ་ན་ནི་ཁྱོད་ཀྱི་ཚད་མ་དང་གཞལ་བར་བྱ་བ་རྣམས་བཟློག་པར་འགྱུར་ཏེ་། 
 pramāṇāni te prameyāṇi bhavanti |	ཁྱོད་ཀྱི་ཚད་མ་རྣམས་ཀྱང་གཞལ་བར་བྱ་བར་འགྱུར་རོ་༎
 prameyaiḥ sādhitatvat |	གཞལ་བར་བྱ་བ་རྣམས་ཀྱིས་རབ་ཏུ་བསྒྲུབ་པའི་ཕྱིར་རོ་༎
 pramāṇāni ca prameyāṇi bhavanti |	གཞལ་བར་བྱ་བ་ཡང་ཚད་མ་རྣམས་སུ་འགྱུར་ཏེ་།
 pramāṇānāṃ sādhakatvāt | (vv 292)	ཚད་མ་རྣམས་སྒྲུབ་པར་བྱེད་པ་ཡིན་པའི་ཕྱིར་རོ་༎
 atha te pramāṇasiddhyā prameyasiddhiḥ prameyasiddhyā ca |	འོན་ཏེ་ཁྱོད་ཀྱིས་ཚད་གྲུབ་པས་༎ གཞལ་བར་བྱ་བ་འགྲུབ་འགྱུར་ལ་༎
 bhavati pramāṇasiddhiḥ nāsty ubhayasyāpi te siddhiḥ || nagvv_46 ||	གཞལ་བྱ་གྲུབ་པས་ཚད་གྲུབ་ན་༎ ཁྱོད་ཀྱིས་གཉི་གའང་འགྲུབ་མི་འགྱུར་༎
 atha manyase pramāṇasiddhyā prameyasiddhir bhavati pramāṇāpekṣatvāt |	འོན་ཏེ་ཚད་མ་གྲུབ་པས་གཞལ་བར་བྱ་བ་འགྲུབ་པར་འགྱུར་ཏེ་།
 prameyasiddhyā ca pramāṇasiddhir bhavati prameyāpekṣatvād iti ||	ཚད་མ་ལ་ལྟོས་པའི་ཕྱིར་རོ་༎ གཞལ་བར་བྱ་བ་འགྲུབ་པས་ཀྱང་ཚད་མ་འགྲུབ་པར་འགྱུར་ཏེ་། གཞལ་བར་བྱ་བ་ལ་ལྟོས་པའི་ཕྱིར་རོ་སྙམ་དུ་སེམས་ན་།
 evaṃ saty ubhayasyāpi siddhir na |y| + + + + ṇaṃ	དེ་ལྟ་ན་ནི་ཁྱོད་ཀྱིས་གཉི་ག-ཡང་འགྲུབ་པར་མི་འགྱུར་རོ་༎ ཅིའི་ཕྱིར་ཞེ་ན་།
 sidhyanti hi pramāṇair yadi prameyāṇi tāni tair evā |	གལ་ཏེ་ཚད་མས་གཞལ་བྱ་འགྲུབ་༎ གཞལ་བྱ་དེ་དག་རྣམས་ཀྱིས་ཀྱང་༎ དེ་དག་བསྒྲུབ་པར་བྱ་ཡིན་ན་༎
 sādhyāni ca prameyais tāni kathaṃ sādhayiṣyanti || nagvv_47 ||	དེ་དག་ཇི་ལྟར་བསྒྲུབ་པར་འགྱུར་༎ གལ་ཏེ་ཚད་མ་རྣམས་ཀྱིས་ནི་གཞལ་བར་བྱ་བ་རྣམས་འགྲུབ་པར་བྱེད་ལ་།
 yadi hi pramāṇaiḥ pramayāṇi sidhyanti tāni pramāṇāni tair eva prameyaiḥ sādhayitavyāni |	གཞལ་བར་བྱ་བ་དེ་དག་རྣམས་ཀྱིས་ཀྱང་ཚད་མ་དེ་དག་བསྒྲུབ་པར་བྱ་བ་ཡིན་ནོ་ཞེ་ན་། 
 nanv asiddheṣu prameyeṣu kāraṇasyāsiddhatvād asiddhāni kathaṃ sādhayisyanti prameyāṇīti | (vv 294)	འོན་གཞལ་བར་བྱ་བ་མ་གྲུབ་པ་རྣམས་ཀྱི་རྒྱུ་རབ་ཏུ་མ་གྲུབ་པའི་ཕྱིར་གཞལ་བར་བྱ་བ་མ་གྲུབ་པ་དག་ཇི་ལྟར་བསྒྲུབ་ན་། པར་འགྱུར་། གལ་ཏེ་གཞལ་བྱས་ཚད་མ་འགྲུབ་།
 sidhyanti ca prameyaiḥ yadi pramāṇāni tāni tair eva |	ཚད་མ་དེ་དག་རྣམས་ཀྱིས་ཀྱང་༎ དེ་དག་བསྒྲུབ་པར་བྱ་ཡིན་ན་༎ དེ་དག་ཇི་ལྟར་བསྒྲུབ་པར་འགྱུར་༎
 sādhyāni ca prameyais tāni kathaṃ sādhayiṣyanti || nagvv_48 ||	གལ་ཏེ་ཡང་གཞལ་བར་བྱ་བ་རྣམས་འགྲུབ་པར་འགྱུར་ལ་།
 yadi prameyaiḥ pramāṇāni sidhyanti tāni ca prameyāṇi tair eva pramāṇaiḥ sādhayitavyānīti |	ཚད་མ་དེ་རྣམས་ཀྱིས་ཀྱང་གཞལ་བར་བྱ་བ་དེ་དག་བསྒྲུབ་པར་བྱ་བ་ཡིན་ནོ་ཞེ་ན་། འོན་ཚད་མ་མ་གྲུབ་པ་༄༡༣༢ཨ་༌་༎
 nanv asiddheṣu pramāṇeṣu kāraṇasyāsiddhatvād asiddhāni kathaṃ sādhayiṣyanti pramāṇāni |	རྣམས་ཀྱི་རྒྱུ་ཡིན་ན་རྒྱུ་རབ་ཏུ་མ་གྲུབ་པའི་ཕྱིར་ཚད་མ་མ་གྲུབ་པ་དག་ཇི་ལྟར་བསྒྲུབ་པར་འགྱུར་། 
 pitra yady utpādyaḥ putro yadi tena caiva putreṇa |	གལ་ཏེ་ཕ་ཡིས་བུ་བསྐྱེད་བྱ་༎ གལ་ཏེ་བུ་དེ་ཉིད་ཀྱིས་ཀྱང་༎
 utpādyaḥ sa yadi pitā vada tatrotpādayati kaḥ kaṃ || nagvv_49 || tadyathāpi nāma kaścit brūyāt |	ཅི་སྟེ་ཕ་དེ་བསྐྱེད་བྱ་ན་༎ དེ་ནི་གང་གིས་གང་བསྐྱེད་སྨྲོས་༎ ཇི་ལྟར་འགའ་ཞིག་ན་རེ་ཕས་བུ་བསྐྱེད་པར་བྱ་བ་ཡིན་ལ་།
 pitrā putra utpādanīyaḥ sa ca pitā putreṇotpādanīya iti | tatredānīṃ brūhi kena ka utpādayitavyaḥ | tathaiva khalu bhavān bravīti |	ཕ་དེ་ཡང་བུ་དེ་ཉིད་ཀྱིས་བསྐྱེད་པར་བྱ་བ་ཡིན་ནོ་ཞེས་ཟེར་ན་།
 pramāṇaiḥ prameyāni sādhayitavyāni tāny eva ca punaḥ pramāṇāni taiḥ prameyaiḥ tatredānīṃ tu katamaiḥ katamāni sādhayitavyāni |	ད་དེ་ན་གང་གིས་གང་བསྐྱེད་པར་སྨྲོས་ཤིག་ཅེས་བྱ་བ་དེ་བཞིན་དུ་ཁྱོད་ན་རེ་ཚད་མ་རྣམས་ཀྱིས་གཞལ་བར་བྱ་བ་དག་བསྒྲུབ་པར་བྱ་བ་ཡིན་ལ་། ཚད་མ་དེ་དག་ཉིད་ཀྱང་གཞལ་བར་བྱ་བ་དེ་དག་ཉིད་ཀྱིས་བསྒྲུབ་པར་བྱ་བ་ཡིན་ནོ་ཞེས་ཟེར་བ་། ད་དེ་ན་ཁྱོད་ཀྱིས་གང་དག་གིས་གང་དག་རབ་ཏུ་བསྒྲུབ་པར་བྱ་བ་ཞེས་ཟེར་བ་། 
 (vv 296)	ཡིན་ནོ་༎ དེ་དག་གཉི་གའང་ཕ་དང་བུའི་༎ མཚན་ཉིད་འཛིན་པས་དེ་ཡི་ཕྱིར་༎ དེ་ལ་ཁོ་བོ་ཐེ་ཚོམ་གྱུར་༎
 kaś ca pitā kaḥ putraḥ tatra tvaṃ brūhi kathaṃ tāv ubhāv api ca |	དེ་ན་ཕ་གང་བུ་གང་སྨྲོས་༎
 pitreputralakṣaṇadharau yato nas tatra saṃdehaḥ || nagvv_50 || tayoś ca pūrvopadiṣṭayoḥ pitāputrayoḥ vada kataraḥ putraḥ kataraḥ pitā ubhāv api tāv utpādakatvāt pitṛlakṣaṇadharau |	གང་གི་ཕྱིར་ཕ་དང་བུ་སྔར་བསྟན་པ་དེ་གཉིས་ལས་།
 utpādyatvāc ca putralakṣaṇadharāv atra naḥ sandeho bhavati | kataras tatra pitā kataras tatra putra iti | evam eva yāny etāni bhavati |	བུ་ནི་གང་ཕ་ནི་གང་དེ་གཉི་ག་ཡང་སྐྱེད་པར་བྱེད་པ་ཡིན་པའི་ཕྱིར་ཕའི་མཚན་ཉིད་འཛིན་པར་བྱེད་པ་ཡིན་ལ་། བསྐྱེད་པར་བྱ་བ་ཡིན་པའི་ཕྱིར་བུའི་མཚན་ཉིད་འཛིན་པ་ཡིན་པས་འདི་ལ་ཁོ་བོ་ཐེ་ཚོམ་དུ་གྱུར་ན་དེ་ལ་ཕ་ནི་གང་བུ་ནི་གང་ཞེས་བྱ་བ་དེ་བཞིན་དུ་ཁྱོད་ཀྱིས་ཚད་མ་དང་གཞལ་བར་བྱ་བ་གང་དག་ཡིན་པ་དེ་དག་ཀྱང་དེ་ནི་ཚད་མ་དག་ནི་གང་ཡིན་། 
 pramāṇaprameyaṇi | tatra katarāṇi pramāṇāni katarāṇi prameyāṇi |	གཞལ་བར་བྱ་བ་དག་ནི་གང་ཡིན་། འདི་དག་གཉི་ག་ཡང་རབ་ཏུ་སྒྲུབ་པར་བྱེད་པ་ཡིན་པའི་ཕྱིར་ཚད་མ་དག་ཡིན་ལ་།
 ubhayāny api hy etāni pramāṇāni tāni prameyāṇi sādhyatvāt prameyāṇīti | atra naḥ sandeho bhavati | katarāṇy atra pramāṇāni katarāṇi prameyāṇīti | (vv 298)	བསྒྲུབ་པར་བྱ་བ་དག་ཡིན་པའི་ཕྱིར་གཞལ་བར་བྱ་བ་ཡིན་པས་འདི་ལ་ཁོ་བོ་ཐེ་ཚོམ་དུ་གྱུར་ན་ཚད་མ་དག་ནི་གང་ཡིན་གཞལ་བར་བྱ་བ་དག་ནི་གང་ཡིན་།
 naiva svataḥ prasiddhir na parasparataḥ pramāṇair vā |	ཚད་མ་རྣམས་ནི་རང་ཉིད་ཀྱིས་༎ འགྲུབ་མིན་ཕན་ཚུན་གྱིས་མིན་པའམ་༎
 bhavati na ca prameyaiḥ na cāpy akasmāt pramāṇānāṃ || nagvv_51 ||	ཚད་མ་གཞན་གྱིས་མ་ཡིན་ལ་༎ གཞལ་བྱས་མ་ཡིན་རྒྱུ་མེད་མིན་༎
 na svataḥ prasiddhiḥ pratyakṣasya tenaiva pratyakṣeṇānumānasya tenaivānumāne | upamānasya tenaivopamānena | āgamasya tenaivāgamena ||	རང་གིས་ཏེ་མངོན་སུམ་ནི་མངོན་སུམ་དེ་ཉིད་ཀྱིས་དང་། རྗེས་སུ་དཔག་པ་ནི་རྗེས་སུ་དཔག་པ་དེ་ཉིད་ཀྱིས་དང་། ལུང་ནི་ལུང་དེ་ཉིད་ཀྱིས་དང་། དཔེས་གཞལ་བ་ནི་དཔེས་འཇལ་བ་དེ་ཉིད་ཀྱིས་རབ་ཏུ་མི་འགྲུབ་ལ་ཕན་ཚུན་གྱིས་ཏེ་།
 nāpi parasyāt pratyakṣasyānumānopamānāgamair anumānasya pratyakṣopamānāgamair upamānasya pratyakṣānumānāgamaiḥ | āgamasya pratyakṣānumānopamānaiḥ |	མངོན་སུམ་ནི་རྗེས་སུ་དཔག་པ་དང་། དཔེས་འཇལ་བ་༄༡༣༢བ་དང་༏་ལུང་རྣམས་ཀྱིས་དང་། རྗེས་སུ་དཔག་པ་ནི་མངོན་སུམ་དང་། དཔེ་འཇལ་བ་དང་། ལུང་རྣམས་ཀྱིས་དང་། དཔེས་འཇལ་བ་ནི་མངོན་སུམ་དང་རྗེ་སུ་དཔག་པ་དང་། ལུང་རྣམས་ཀྱིས་དང་། ལུང་ནི་མངོན་སུམ་དང་། རྗེས་སུ་དཔག་པ་དང་། དཔེས་འཇལ་བས་ཀྱང་མ་ཡིན་ལ་། རང་གི་ཇི་ལྟ་བ་བཞིན་དུ་།
 nāpi pratyakṣānumānopamānāgamād anyaiḥ pratyakṣānumānopamānāgamair yathāsvaṃ nāpi prameyaiḥ samastavyastaiḥ svaviṣayaparaviṣatāgṛhītaiḥ nāpy akasmān nāsti samuccayena |	མངོན་སུམ་དང་རྗེས་སུ་དཔག་པ་དང་། དཔེས་འཇལ་བ་དང་། ལུང་རྣམས་ཀྱིས་ནི་མངོན་སུམ་དང་། རྗེས་སུ་དཔག་པ་དང་། དཔེས་འཇལ་བ་དང་། ལུང་གཞན་རྣམས་ཀྱིས་ཀྱང་མ་ཡིན་ལ་། གཞལ་བར་བྱ་བ་རང་དང་གཞན་གྱིས་བསྡུས་པ་མཐའ་དག་དང་། རེ་རེས་ཀྱང་མ་ཡིན་ལ་། རྒྱུ་མེད་པས་ཀྱང་མ་ཡིན་ལ་། ཀུན་བསྡུས་པས་ཀྱང་མ་ཡིན་ནོ་༎
 eteṣāṃ kāraṇānāṃ pūrvoddiṣṭānāṃ viṃśas triṃśac catvāriśat ṣaṭviṃśatir vā tatra yad uktaṃ |	གཏན་ཚིགས་སྔར་བསྟན་པ་དེ་དག་ནི་། ཉི་ཤུའམ་། སུམ་ཅུའམ་། བཞི་བཅུའམ་། སུམ་ཅུ་རྩ་དྲུག་གིས་ཀྱང་མི་བསྒྲུབ་ན་།
 pramāṇādhigamyatvāt prameyāṇāṃ bhāvānāṃ santi tu prameyā bhāvās tāni ca pramāṇāni yais tu pramāṇaiḥ prameyā bhāvāḥ santaś ca bhāvāḥ samādhigatā iti tan na ||	དེ་ལ་གང་ཁྱོད་ཀྱིས་གཞལ་བར་བྱ་བའི་དངོས་པོ་རྣམས་ནི་ཚད་མས་ཁོང་དུ་ཆུད་པར་བྱ་བ་ཡིན་པའི་ཕྱིར་དངོས་པོ་གཞལ་བར་བྱ་བ་དེ་དག་ཀྱང་ཡོད་ལ་། ཁྱོད་ཀྱི་ཚད་མ་གང་དག་གིས་དངོས་པོ་གཞལ་བར་བྱ་བ་དག་ཡང་དག་པར་ཁོང་དུ་ཆུད་པའི་ཚད་མ་དེ་དག་ཀྱང་ཡོད་དོ་ཞེས་སྨྲས་པ་གང་ཡིན་པ་དེ་མི་རུང་ངོ་༎ གཞན་ཡང་ཁྱོད་ཀྱིས་། སྐྱེ་བོ་ཆོས་ཀྱི་གནས་སྐབས་མཁས་༎ དགེ་བ་དག་གི་ཆོས་རྣམས་ལ་༎ དགེ་བའི་རང་བཞིན་ཡིན་པར་ནི་༎ སེམས་ཤིང་ལྷག་མ་རྣམས་དང་ཡང་༎
 (vv 300) yat punar bhavatoktam |	ཞེས་སྨྲས་པ་གང་ཡིན་པ་དེ་ལ་བཤད་པར་བྱ་སྟེ་།
 kuśalānāṃ dharmāṇāṃ dharmāvasthāvidaś ca manyante | kuśalaṃ janasvabhāvaṃ manyante śeṣeṣv apy eṣa viniyogaḥ | [7] atra brūmaḥ |	ཆོས་ཀྱི་གནས་སྐབས་རབ་མཁས་པ་༎ དགེ་བ་ཡིན་ནི་ཆོས་རྣམས་ཀྱི་༎
 kuśalānāṃ dharmāṇāṃ dharmāvasthavido brūvate yat |	དགེ་བའི་རང་བཞིན་སྨྲ་བ་གང་༎
 kuśalasvabhāvam evaṃ pravibhāgenābhidheyaḥ syāt || nagvv_52 ||	དེ་ལྟར་རབ་ཕྱེ་བརྗོད་བྱ་ཡིན་༎
 kuśalānāṃ dharmāṇāṃ dharmāvasthavidaḥ kuśalaṃ janasvabhāvaṃ manyante | sa ca bhavatā pravibhāgenopadeṣṭavyaḥ |	ཆོས་ཀྱི་གནས་སྐབས་ལ་མཁས་པ་དགེ་བའི་ཆོས་ཀྱི་དགེ་བའི་རང་གི་ངོ་བོ་སེམས་པ་དེ་ཡང་ཁྱོད་ཀྱིས་རབ་ཏུ་ཕྱེ་སྟེ་།
 syād ayaṃ sa kuśalaḥ svabhāvaḥ ime te kuśalā dharmā iti |	འདི་ནི་དགེ་པའི་རང་གི་ངོ་བོ་ཡིན་། འདི་དག་ནི་དགོ་བའི་ཆོས་དེ་དག་ཡིན་ཏེ་།
 idaṃ tatkuśalavijñānam ayaṃ kuśalavijñānasvabhāva evaṃ sarveṣāṃ na caitad evaṃ dṛṣṭaṃ |	འདི་ནི་དགེ་བ་དེ་རྣམ་པར་ཤེས་པ་ཡིན་། འདི་ནི་དགེ་བ་དེ་རྣམ་པར་ཤེས་པའི་རང་གི་ངོ་བོ་ཡིན་། དེ་བཞིན་དུ་ཐམས་ཅད་ལ་བསྟན་པར་བྱ་བ་ཡིན་ནོ་།
 tasmād yad uktam upadiṣṭaḥ svabhāvo dharmāṇām iti tan na || (vv 302)	དེ་ཡང་དེ་ལྟར་མ་བསྟན་པས་དེའི་ཕྱིར་རང་༄༡༣༣ཨ་༌་༎ གི་ངོ་བོ་ཇི་ལྟ་བ་བཞིན་དུ་ཆོས་རྣམས་ཀྱི་རང་གི་ངོ་བོ་བསྟན་ཏོ་ཞེས་སྨྲས་པ་གང་ཡིན་པ་དེ་མི་རུང་ངོ་༎
 kiñcānyat |	འདི་ལྟར་གཞན་ཡང་། གལ་ཏེ་དགེ་བའི་ཆོས་རྣམས་ཀྱི་༎
 yadi ca pratītya kuśalaḥ svabhāva utpadyate sa kuśalānām |	དགེ་བའི་རང་གི་ངོ་བོ་དེ་༎ བརྟེན་ནས་སྐྱེ་ན་དེ་ལྟ་ན་༎
 dharmāṇāṃ parabhāvaḥ svabhāva eva kathaṃ bhavati || nagvv_53 ||	གཞན་དངོས་རང་ངོར་ཇི་ལྟར་འགྱུར༎
 yadi ca kuśalānāṃ dharmāṇāṃ svabhāvo hetupratyayasāmagrīṃ pratītyotpadyate |	གལ་ཏེ་དགེ་བའི་ཆོས་རྣམས་ཀྱི་རང་གི་ངོ་བོ་ནི་རྒྱུ་དང་རྐྱེན་ཚོགས་པ་ལ་བརྟེན་ནས་སྐྱེའོ་ཞེ་ན་། 
 parabhāvād utpannaḥ kuśalānāṃ dharmāṇāṃ kathaṃ svabhāvo bhavati |	དེ་གཞན་གྱི་དངོས་པོ་ལ་བརྟེན་ནས་སྐྱེས་པ་ཡིན་ན་། དགེ་བའི་ཆོས་རྣམས་ཀྱི་རང་གི་ངོ་བོར་ཇི་ལྟར་འགྱུར་།
 evam evākuśalaprabhṛtīnāṃ |	མི་དགེ་བ་ལ་སོགས་པ་དག་ལ་ཡང་དེ་བཞིན་དུ་སྦྱར་རོ་༎
 tatra yad uktaṃ | kuśalāvyākṛtānāṃ nā |y| + + + dharmāṇāṃ kuśalaḥ svabhāvopadiṣṭaḥ |	དེ་ལ་གང་གི་ཕྱིར་དགེ་བའི་ཆོས་རྣམས་ཀྱི་དགེ་བའི་རང་གི་ངོ་བོ་ཡང་བསྟན་ལ་།
 evam akuśalānām akuśalādir iti | tan na ||	དེ་བཞིན་དུ་མི་དགེ་བ་ལ་སོགས་པའི་ཆོས་རྣམས་ཀྱི་མི་དགེ་བ་ལ་སོགས་པའི་རང་གི་ངོ་བོ་ཡང་བསྟན་པ་ཡིན་ནོ་ཞེས་སྨྲས་པ་གང་ཡིན་པ་དེ་མི་རུང་ངོ་༎
 kiñcānyat |	འདི་ལྟར་གཞན་ཡང་། འོན་ཏེ་དགེ་བའི་ཆོས་རྣམས་ཀྱི་༎ རང་གི་ངོ་བོ་དེ་འགའ་ལ་འང་༎
 atha na pratītya kiñcit svabhāva utpadyate sa kuśalānām |	མ་བརྟེན་སྐྱེ་ན་དེ་ལྟ་ནའང་༎
 dharmāṇām evaṃ syād vāso na brahmacaryasya || nagvv_54 ||	ཚངས་པར་སྤྱོད་ལ་གནས་མི་འགྱུར་༎
 atha manyase | na kiñcit pratītya kuśalānāṃ dharmāṇāṃ kuśalasvabhāva utpadyate |	འོན་ཏེ་དགེ་བའི་ཆོས་རྣམས་ཀྱི་དགེ་བའི་རང་གི་ངོ་བོ་ནི་འགའ་ལའང་མ་བརྟེན་པར་སྐྱེ་ལ་། 
 evam akuśalānāṃ dharmāṇām akuśalaḥ avyākṛtānām avyākṛta iti |	མི་དགེ་བ་ལ་སོགས་པ་དག་གི་ཡང་དེ་ལྟ་བུ་ཡིན་ནོ་སྙམ་དུ་སེམས་ན་ལ་། 
 evaṃ saty abrahmacaryavāso bhavati kiṃ kāraṇaṃ |	། དེ་ལྟ་ན་ནི་ཚངས་པར་སྤྱོད་པ་ལ་གནས་པར་མི་འགྱུར་རོ་༎ ཅིའི་ཕྱིར་ཞེ་ན་།
 pratītyasamutpādasya hi evaṃ sati pratyākhyānaṃ bhavati |	དེ་ལྟ་ཡིན་ན་ནི་རྟེན་ཅིང་འབྲེལ་པར་འབྱུང་བ་བཏང་བ་ཡིན་ནོ་༎
 pratītyasamutpādasya pratyākhyānāt pratītyasamutpādadarśaṇaṃ pratyākhyānaṃ bhavati |	རྟེན་ཅིང་འབྲེལ་བར་འབྱུང་བ་གཏང་བའི་ཕྱིར་། རྟེན་ཅིང་འབྲེལ་པར་འབྱུང་བ་མཐོང་བ་བཏང་བ་ཡིན་ཏེ་།
 na hy avidyamānasya pratītyasamutpādasya darśanam utpadyamānaṃ bhavati |	རྟེན་ཅིང་འབྲེལ་པར་འབྱུང་བ་ཡོད་པ་མ་ཡིན་པ་ནི་མཐོང་བ་སྟེ་། དམིགས་པར་འཐད་པ་མ་ཡིན་ནོ་༎
 asati pratītyasamutpādadarśane dharmadarśanaṃ na bhavati |	རྟེན་ཅིང་འབྲེལ་པར་འབྱུང་བ་མཐོང་བ་མེད་ན་། ཆོས་མཐོང་བ་མེད་པ་ཡིན་ནོ་༎
 uktaṃ hi | bhagavatā yo hi bhikṣavaḥ pratītyasamutpādaṃ paśyati sa dharmaṃ paśyati |	བཅོམ་ལྡན་འདས་ཀྱིས་ནི་དགེ་སློང་སུས་རྟེན་ཅིང་འབྲེལ་བར་འབྱུང་བ་མཐོང་བ་དེས་ཆོས་མཐོང་ངོ་ཞེས་གསུངས་སོ༎ 
 dharmadarśanābhāvād brahmacaryavāsābhāvaḥ ||	ཆོས་མཐོང་བ་མེད་པའི་ཕྱིར་ཚངས་པར་སྤྱོད་པ་ལ་གནས་པ་མེད་པ་ཡིན་ནོ་ཞེས་གསུངས་སོ༎ ༎ ཡང་ན་རྟེན་ཅིང་འབྲེལ་པར་འབྱུང་བ་བཏང་བས་སྡུག་བསྔལ་ཀུན་འབྱུང་བ་བཏང་ཞེས་གསུངས་སོ༎ 
 (vv 304) athavā pratītyasamutpādapratyākhyānāt | duḥkhasamudāyapratyākhyānaṃ bhavati |	༎ བ་ཡིན་ཏེ་། 
 pratītyasamutpādo hi duḥkhasya samudayaḥ |	སྡུག་བསྔལ་ཀུན་འབྱུང་བ་ནི་རྟེན་ཅིང་འབྲེལ་པར་འབྱུང་བ་ཞེས་གསུངས་སོ༎ ༎ བ་ཡིན་ཏེ་། ཡིན་པས་སོ་༎ 
 duḥkhasamudayasya pratyākhyānād duḥkhapratyākhyānaṃ bhavati |	སྡུག་བསྔལ་ཀུན་འབྱུང་བ་༄༡༣༣བ་བཏང་བས་སྡུག་བསྔལ་བཏང་བ་ཡིན་ཏེ་།
 asati hi samudaye tat kuto duḥkhaṃ samudeṣyati |	ཀུན་འབྱུང་བ་མེད་ན་གང་ལས་སྡུག་བསྔལ་ཀུན་འབྱུང་བར་འགྱུར་།
 duḥkhasamudayapratyākhyānāc ca duḥkhanirodhasya pratyākhyānaṃ |	སྡུག་བསྔལ་གཏང་བའི་ཕྱིར་དང་། ཀུན་འབྱུང་བ་གཏང་བའི་ཕྱིར་དང་། སྡུག་བསྔལ་འགོག་པ་བཏང་བ་ཡིན་ཏེ་།
 asati hi duḥkhasamudaye kasya prahāṇān nirodho bhaviṣyati |	སྡུག་བསྔལ་དང་ཀུན་འབྱུང་བ་གཉིས་མེད་ན་གང་ཞིག་སྤངས་པས་འགོག་པར་འགྱུར་བས་སོ་༎
 asati hi duḥkhanirodhe kasya prāptaye mārgo bhaviṣyati | duḥkhanirodhagāmī |	སྡུག་བསྔལ་འགོག་པ་མེད་ན་གང་ཞིག་ཐོབ་པར་བྱ་བའི་ཕྱིར་སྡུག་བསྔལ་འགོག་པར་འགྱུར་བའི་ལམ་དུ་འགྱུར་། 
 evaṃ caturṇām āryasatyānām abhāvāc chrāmaṇyaphalābhāvaḥ |	དེས་ན་འཕགས་པའི་བདེན་པ་བཞི་དག་མེད་པར་འགྱུར་ཏེ་། དེ་མེད་པའི་ཕྱིར་དགེ་སྦྱོང་གི་ཚུལ་གྱི་འབྲས་བུ་མེད་པར་འགྱུར་ཏེ་།
 satyadarśanādiśramaṇyaphalāni samādhigamyante |	བདེན་པ་མཐོང་བ་ལས་དགེ་སྦྱོང་གི་ཚུལ་གྱི་འབྲས་བུ་རྣམས་ཡང་དག་པར་འཐོབ་པས་སོ་༎
 śrāmaṇyaphalānām abhāvād abrahmacaryavāsa iti || kiñcānyat | nādharmo dharmo vā satyavyavahārāś ca lokikā ni syuḥ |	དགེ་སྦྱོང་གི་ཚུལ་གྱི་འབྲས་བུ་རྣམས་མེད་པས་ཚངས་པར་སྤྱོད་པ་ལ་གནས་པར་མི་འགྱུར་རོ་༎ འདི་ལྟར་གཞན་ཡང་།
 nityāś ca sarvabhāvāḥ syuḥ nityatvād ahetumataḥ || nagvv_55 ||	རྒྱུ་མི་ལྡན་པ་རྟག་པའི་ཕྱིར་༎ ཆོས་རྣམས་ཐམས་ཅད་རྟག་པར་འགྱུར་༎ ཆོས་སམ་ཆོས་མ་ཡིན་མེད་ཅིང་༎ འཇིག་རྟེན་པ་ཡི་ཐ་སྙད་མེད་༎
 (vv 306) evaṃ sati pratītyasamutpādaṃ pratyācakṣaṇasya bhavataḥ ko doṣa prasajyate |	དེ་ལྟ་ཡིན་ན་རྟེན་ཅིང་འབྲེལ་པར་འབྱུང་བ་གཏོང་བ་དེ་ལ་སྐྱོན་ཅིར་འགྱུར་ཞེ་ན་།
 dharmo na bhavati adharmo na bhavati | saṃvyavahārāś ca laukikā na sambhavanti |	ཆོས་མེད་པ་དང་། ཆོས་མ་ཡིན་པ་མེད་པ་དང་། འཇིག་རྟེན་པའི་ཐ་སྙད་རྣམས་མེད་པར་འགྱུར་རོ་༎
 kiṃ kāraṇaṃ pratītyasamutpannaṃ hy etat sarvam asati pratītyasamutpāde kuto bhaviṣyati |	ཅིའི་ཕྱིར་ཞེ་ན་། འདི་ཐམས་ཅད་ནི་རྟེན་ཅིང་འབྲེལ་པར་འབྱུང་བ་ཡིན་ན་རྟེན་ཅིང་འབྲེལ་པར་འབྱུང་བ་དེ་མེད་ན་གང་ལས་འབྱུང་བར་འགྱུར་།
 api ca sasvabhāvo 'pratītyasamutpanno nirhetuko nityaḥ syāt |	གཞན་ཡང་རང་གི་ངོ་བོ་དང་བཅས་པ་དང་། རྟེན་ཅིང་འབྲེལ་པར་འབྱུང་བ་མ་ཡིན་པ་དང་། རྒྱུ་མེད་པ་ལས་བྱུང་བ་དང་རྟག་པར་འགྱུར་ཏེ་།
 kiṃ kāraṇaṃ nirhetukā hi bhāvā nityās tatra sa eva cābrahmacaryavāsaḥ prasajyet svasiddhāntavirodhaś ca |	རྒྱུ་མེད་པ་རྣམས་ནི་རྟག་པ་ཉིད་ཡིན་པའི་ཕྱིར་དང་། དེ་ལ་ཚངས་པར་སྤྱོད་པ་ལ་གནས་པ་མ་ཡིན་པ་དེ་ཉིད་དུ་ཡང་འགྱུར་རོ་༎ གྲུབ་པའི་མཐའ་དང་ཡང་འགལ་ཏེ་། ཅིའི་ཕྱིར་ཞེ་ན་།
 kiṃ kāraṇam anityā hi bhagavatā sarve saṃskārā nirdeṣṭās te svabhāvanityatvān nityā hi bhavanti |	བཅོམ་ལྡན་འདས་ཀྱིས་འདུ་བྱེད་ཐམས་ཅད་ནི་མི་རྟག་པའོ་ཞེས་བཤད་པ་ཡིན་ནོ་༎ དེ་དག་ནི་རང་གི་ངོ་བོ་ཉིད་དང་བཅས་པའི་རྟག་པ་ཉིད་ཀྱིས་རྟག་པ་ཡིན་ནོ་༎
 eṣa cākuśaleṣv avyākṛteṣu nairyāṇādiṣu ca doṣas |	མི་དགེ་བ་དང་ལུང་མ་བསྟན་༎ ངེས་འབྱིན་སྩོགས་ལའང་སྐྱོན་དེ་བཞིན་༎
 tasmāt sarvaṃ saṃskṛtam asaṃskṛtaṃ te bhavaty evaṃ || nagvv_56 ||	དེ་བས་ཁྱོད་ཀྱི་འདུས་བྱས་ཀུན་༎ འདུས་མ་བྱས་པ་ཉིད་དུ་འགྱུར་༎ དགེ་བའི་༄༡༣༤ཨ་༌་༎
 yaś caiṣa kuśaleṣu nirdeṣṭaḥ kalpaḥ sa evākuśaleṣu sa evāvyākṛteṣu sa evānairyāṇikaprabhṛtiṣu doṣas tasmāt sarvam idaṃ saṃskṛtam asaṃskṛtaṃ saṃpadyate ||	ཆོས་རྣམས་ལ་རྟག་པ་དེ་བསྟན་པ་གང་ཡིན་པ་དེ་ཉིད་མི་དགེ་བ་རྣམས་དང་། ལུང་དུ་མ་བསྟན་པ་རྣམས་ལ་ཡང་ཡོད་། དེ་ཉིད་ངེས་པར་འབྱིན་པ་ལ་སོགས་པ་ལ་ཡང་ཡོད་དོ་༎ དེ་བས་ན་ཁྱོད་ཀྱི་འདུས་བྱས་འདི་ཐམས་ཅད་འདུས་མ་བྱས་སུ་འགྱུར་རོ་༏་། ཅིའི་ཕྱིར་ཞེ་ན་།
 kiṃkāraṇaṃ heto hy asaty utpādasthitibhaṅgā na bhavanti |	རྒྱུ་མེད་ན་སྐྱེ་བ་དང་གནས་པ་དང་འཇིག་པ་དག་མེད་པའི་ཕྱིར་རོ་༎
 utpādasthitibhaṅgeṣv asatsu saṃskṛtalakṣaṇābhāvāt | sarvaṃ saṃskṛtam asaṃskṛtaṃ saṃpadyate |	དེ་མེད་ན་འདུས་བྱས་ཀྱི་མཚན་ཉིད་མེད་པའི་ཕྱིར་ཐམས་ཅད་འདུས་མ་བྱས་སུ་འགྱུར་རོ་༎
 tatra yad uktaṃ kuśalādīnāṃ bhāvānāṃ svabhāvasadbhāvād aśūnyāḥ sarvabhāvā iti tan na ||	དེ་ལ་དགེ་བ་ལ་སོགས་པ་དག་གི་དངོས་པོ་དག་གི་རང་གི་ངོ་བོ་ཡོད་པའི་ཕྱིར་དངོས་པོ་ཐམས་ཅད་སྟོང་པ་མ་ཡིན་ནོ་ཞེས་སྨྲས་པ་གང་ཡིན་པ་དེ་མི་རུང་ངོ་༎
 (vv 308) yat punar bhavatoktaṃ |	གཞན་ཡང་ཁྱོད་ཀྱིས་།
 yadi ca na bhavet svabhāvo bhāvānāṃ na svabhāva ity evaṃ	གལ་ཏེ་ཆོས་ཀྱི་རང་བཞིན་མེད་༎ རང་བཞིན་མེད་ཅེས་བྱ་བའི་མིང་༎
 nāmāpi bhaved evaṃ nāma hi nirvastukaṃ nāsti | [9]	དེ་ཡང་དེ་བཞིན་མེད་འགྱུར་ཏེ་༎ གཞི་མེད་མིང་ནི་མེད་པས་སོ་༎ ཞེས་སྨྲས་པ་གང་ཡིན་པ་འདི་ལ་བཤད་པར་བྱ་སྟེ་།
 yaḥ sadbhūtaṃ nāma brūyāt sasvabhāva ity evam |	གང་ཞིག་རང་བཞིན་བཅས་པ་ཞེས་༎ མིང་ནི་ཡོད་པར་སྨྲ་བ་ལ་༎ དེ་ལྟར་མིང་གི་ལན་བཏབ་ཀྱིས་༎
 bhavatā prativaktavyo nāma brūmaś ca na vayaṃ sata || nagvv_57 ||	ང་ནི་མིང་ཡོད་མི་སྨྲའོ་༎
 yo nāma sadbhūtaṃ brūyāt sasvabhāva iti sa bhavatā prativaktavyaḥ syāt |	གང་ཞིག་མིང་འདི་རང་བཞིན་དང་བཅས་པ་ཡིན་ནོ་ཞེས་མིང་ཡོད་པར་སྨྲ་བ་དེ་ལ་ཁྱོད་ཀྱིས་ལན་གདབ་པར་བྱ་བ་ཡིན་གྱི་།
 yasya sadbhūtaṃ nāma svabhāvasya | tasmāt tenāpi svabhāvena sadbhūtena bhavitavyaṃ |	གལ་ཏེ་མིང་ཅན་གྱི་རང་བཞིན་དེ་མེད་ན་།
 na hy asadbhūtasya svabhāvasya sadbhūtaṃ nāma bhavatīti |	དེའི་ཕྱིར་མིང་དེ་ཡང་རང་བཞིན་ཡོད་པ་མ་ཡིན་པར་བྱ་དགོས་ཏེ་།
 na punar vayaṃ nāma sadbhūtaṃ brūmas tad api hi svabhāvasyābhāvān nāma niḥsvabhāvatvāt śūnyaṃ śūnyatvād asadbhūtam |	ཡོད་པ་མ་ཡིན་པ་ལ་ནི་མིང་གི་རང་བཞིན་ཡོད་པར་མི་འགྱུར་བས་ངེད་ཅག་ཀྱང་མིང་གི་རང་བཞིན་ཡོད་པར་མི་སྨྲའོ་༎ དེ་བས་ན་དངོས་པོ་རྣམས་ཀྱི་རང་བཞིན་ཡང་མེད་པའི་ཕྱིར་མིང་གི་རང་བཞིན་ཡང་མེད་པ་ཡིན་ནོ་༎ དེའི་ཕྱིར་སྟོང་པ་ཡིན་ནོ་༎
 tatra yad bhavatoktaṃ nāmasadbhāvāt sadbhūtaḥ svahhāvā iti | tan na ||	སྟོང་པ་ཉིད་ཡིན་པའི་ཕྱིར་ཡོད་པ་མ་ཡིན་པས་དེ་ལ་ཁྱོད་ཀྱིས་མིང་ཡོད་པའི་ཕྱིར་རང་གི་ངོ་བོ་ཡོད་དོ་ཞེས་སྨྲས་པ་གང་ཡིན་པ་དེ་མི་རུང་ངོ་༎
 kiñcānyat | (vv 310)	འདི་ལྟར་གཞན་ཡང་། མེད་ལ་མིང་མེད་ཅེས་གང་འདི་༎
 nāmāsad iti ca yad idaṃ tat kiṃ nu sato bhavaty utāsataḥ |	ཅི་དེ་ཡོད་པའམ་མེད་པ་ཡིན་༎
 yadi hi sato yady asato dvidhāpi te hīyate vādaḥ || nagvv_58 ||	གལ་ཏེ་ཡོད་པའམ་མེད་པ་ཡིན་༎ ཁྱོད་ཀྱིས་སྨྲས་པ་གཉི་གའང་ཉམས་༎
 yac caitan nāmāsad iti tat kiṃ sataḥ asataḥ |	མེད་པ་ལ་མིང་མེད་དོ་ཞེས་བྱ་བ་གང་ཡིན་པ་འདི་ཅི་མིང་མེད་པ་དེ་ཡོད་པ་ཡིན་ནམ་འོན་ཏེ་མེད་པ་ཡིན་། གལ་ཏེ་མིང་དེ་ཡོད་པ་ཞིག་གི་ཡིན་ནམ་།
 yadi hi satas tan nāma yady asata ubhayathāpi pratijñā hīyate |	གལ་ཏེ་༄༡༣༤བ་མེད་པ་ཞིག་གི་ཡིན་ན་དམ་བཅས་པ་གཉི་ག་ཡང་ཉམས་པར་འགྱུར་ཏེ་།
 tatra yadi tāvat sata |	དེ་ལ་གལ་ཏེ་རེ་ཞིག་མིང་མེད་པ་ཞེས་བྱ་བའི་མིང་ཡོད་པ་ཡིན་ནོ་ཞེ་ན་།
 asad iti pratijñā hīyate | na hīdanīṃ tad asad idānīṃ sat* athāsata |	མིང་མེད་དོ་ཞེས་བྱ་བའི་དམ་བཅས་པ་ཉམས་པར་འགྱུར་ཏེ་། ད་ནི་དེ་མེད་པ་མ་ཡིན་ཏེ་།
 asad iti nāma yā pratijñā asadbhūtasya nāma na bhavati astitvasvabhāva iti nāma tasmāt sadbhūtaḥ svabhāva iti | sā hīnā ||	ད་ནི་དེ་ཡོད་པས་སོ་ཅི་སྟེ་མིང་མེད་པ་ཞེས་བྱ་བ་མེད་པ་ཡིན་ནོ་ཞེ་ན་། མེད་པ་ལ་ནི་མིང་མེད་དོ་༎ དེ་བས་ན་མིང་གི་རང་བཞིན་ཡོད་དོ་ཞེས་ཁྱོད་ཀྱིས་དམ་བཅས་པ་གང་ཡིན་པ་དེ་ཉམས་པ་ཡིན་ནོ་༎ 
 kiñcānyat |	འདི་ལྟར་གཞན་ཡང་།
 sarveṣāṃ bhāvānāṃ śūnyatvañ copapāditaṃ pūrvam |	དངོས་པོ་དག་ནི་ཐམས་ཅད་ཀྱི་༎ སྟོང་པ་ཉིད་ནི་སྔར་བསྟན་པས་༎ དེ་ཕྱིར་དམ་བཅས་མེད་པར་ཡང་༎
 sa upālambhaḥ tasmād bhavaty ayañ cāpratijñāyāḥ || nagvv_59 ||	ཀླན་ཀ་གང་ཡིན་དེ་ཚོལ་བྱེད་༎
 iha cāsmābhiḥ pūrvam eva sarveṣāṃ bhāvānaṃ vistarataḥ śūnyatvam upapāditam | tatra prāg nāmano 'pi śūnyatvam uktaṃ saṃbhavā aśūnyatvaṃ parigṛhya pravṛtto vaktuṃ | yadi bhāvānāṃ svābhāvo na syād asvabhāva iti nāmāpīdan na syād iti |	འདིར་ངེད་ཅག་གི་སྔར་དངོས་པོ་ཐམས་ཅད་ཀྱི་སྟོང་པ་ཉིད་རྒྱ་ཆེར་བསྟན་པས་དེར་མིང་ཡང་སྟོང་པ་ཉིད་དུ་བསྟན་པ་ཡིན་ནོ་༎
 tasmād apratijñopālambho yaṃ bhavataḥ saṃpadyate |	དེའི་ཕྱིར་དམ་བཅས་པ་མེད་པར་ཡང་ཁྱོད་ཀླན་ཀ་འདི་ཚོལ་བར་བྱེད་ཀྱི་།
 na hi vayaṃ nāma sadbhūtam iti brūmaḥ || (vv 312) yat punar bhavatoktaṃ |	ངེད་མིང་ཡོད་དོ་ཞེས་མི་སྨྲའོ་༏་གཞན་ཡང་ཁྱོད་ཀྱིས་།
 atha vidyate svabhāvas sa ca dharmāṇāṃ na vidyate sa tasmāt	འོན་ཏེ་འདི་ལྟར་རང་བཞིན་ཡོད་༎ དེ་ནི་ཆོས་ལ་མེད་ཅེ་ན་༎ ཆོས་རྣམས་མེད་པར་རང་བཞིན་ཏེ་༎
 dharmair vinā svabhāvaḥ sa yasya tad yuktam upadeṣṭuṃ | [10]	གང་གི་ཡིན་པར་དེ་བསྟན་རིགས་༎ ཞེས་སྨྲས་པ་གང་ཡིན་པ་འདི་ལ་བཤད་པར་བྱ་སྟེ་།
 atha vidyate svabhāvaḥ sa ca dharmāṇāṃ na vidyatat iti idam |	འོན་ཏེ་རང་བཞིན་ཞིག་ཡོད་ལ་༎ དེ་ནི་ཆོས་ལ་མེད་དོ་ཞེས་༎
 āśaṅkitaṃ yad uktaṃ bhavaty anāśaṅkitaṃ tac ca || nagvv_60 ||	དོགས་པ་བསུ་ན་སྨྲ་བ་འདི་༎ དོགས་པ་གང་ཡིན་དེ་མེད་དོ་༎
 na hi vayaṃ dharmāṇāṃ svabhāvaṃ pratiṣedhayāmaḥ |	ངེད་ནི་ཆོས་རྣམས་ཀྱི་རང་བཞིན་ཡང་འགོག་པར་མི་བྱེད་ལ་།
 dharmavinirmuktasya vā kasyacid arthasya svabhāvam abhyupagacchāmaḥ | nanv evaṃ sati ya upālambho bhavati |	ཆོས་ལས་མ་གཏོགས་པའི་དོན་འགའ་ཞིག་གི་རང་བཞིན་ཡིན་པར་ཡང་ཁས་མི་ལེན་ནོ་༎
 yadi dharmā niḥsvabhāvāḥ kasya khalv idānīm anyasyārthasya dharmavinirmuktasya svabhāvo bhavati | sa yuktam evopadeṣṭam iti | dūrāpakṛṣṭam evaitat bhavati | (vv 314) yat punar bhavatoktaṃ |	དེ་ལྟ་ཡིན་ན་འོན་ཏེ་ཆོས་རྣམས་རང་བཞིན་མེད་པ་ཡིན་ན་། རང་བཞིན་ཏེ་ཆོས་ལས་མ་གཏོགས་པ་དོན་གཞན་གང་ཞིག་གི་ཡིན་པ་དེ་བསྟན་པའི་རིགས་སོ་ཞེས་བྱ་བའི་ཁྱོད་ཀྱི་ཀླན་ཀ་ཐག་བསྲིངས་པ་ཡིན་པས་ཀླན་ཀར་མི་འགྱུར་བ་མ་ཡིན་ནམ་། གཞན་ཡང་ཁྱོད་ཀྱིས་། གང་ཕྱིར་ཁྱིམ་ན་བུམ་པ་དེ་༎
 sata eva pratiṣedho nāsti ghaṭo geha ity ayaṃ yasmāt |	།
 dṛṣṭaḥ pratiṣedho 'yaṃ mataḥ svabhāvasya te tasmāt | [11] ity	ཡོད་པའི་རང་བཞིན་འགོག་པ་ཡིན་༎
 atra brūmaḥ |	ཞེས་སྨྲས་པ་གང་ཡིན་པ་འདི་ལ་བཤད་པར་བྱ་སྟེ་།
 sata eva pratiṣedho yadi śūnyatvaṃ nanv apratisiddham idam |	གལ་ཏེ་ཡོད་ལ་འགོག་ཡིན་ན་༎ འོ་ན་སྟོང་ཉིད་རབ་འགྲུབ་སྟེ་༎ དངོས་རྣམས་རང་བཞིན་མེད་ཉིད་ལ་༎
 pratiṣedhayate hi hhavān bhāvānāṃ niḥsvabhāvatvaṃ || nagvv_61 ||	ཁྱོད་ནི་འགོག་པར་བྱེད་པས་སོ༎
 yadi svata eva pratiṣedho bhavati |	༄༡༣༥ཨ་༌་༎ གལ་ཏེ་ཡོད་པ་ཁོ་ན་ལ་འགོག་པར་བྱེད་པ་ཡིན་གྱི་། མེད་པ་ལ་ནི་མ་ཡིན་ནོ་༎
 nāmato bhāvānāṃ niḥsvabhāvatvaṃ pratiṣedhayati | nanu pratisidhaṃ sarvabhāvānāṃ niḥsvabhāvatvaṃ tvadvacanena |	ཁྱེད་ཀྱང་དངོས་པོ་ཐམས་ཅད་ཀྱི་རང་བཞིན་མེད་པ་ཉིད་འགོག་པར་བྱེད་པ་ཡིན་པས་འོ་ན་དངོས་པོ་ཐམས་ཅད་ཀྱི་རང་བཞིན་མེད་པ་ཉིད་རབ་ཏུ་གྲུབ་པ་མ་ཡིན་ནམ་།
 pratiṣedhayasi tvaṃ sadbhāvāt | niḥsvabhāvatvasya ca sarvabhāvānāṃ pratisidhatvāt |	ཁྱོད་ཀྱི་གཏན་ཚིགས་འགོག་པར་བྱེད་པ་ཡོད་པའི་ཕྱིར་དང་། དངོས་པོ་ཐམས་ཅད་ཀྱི་རང་བཞིན་མེད་པ་ཉིད་བཀག་པའི་ཕྱིར་སྟོང་པ་ཉིད་རབ་ཏུ་གྲུབ་པ་ཡིན་ནོ་༎ 
 pratisiddhā śūnyateti pratiṣedhayase atha tvaṃ śūnyatvaṃ tac ca nāsti śūnyatvam |	སྟོང་ཉིད་གང་ལ་ཁྱོད་འགོག་པའི་༎ སྟོང་ཉིད་དེ་ཡང་མེད་ཡིན་ན་༎
 pratiṣedhaḥ sata iti te nanv eṣa vihīyate vādaḥ || nagvv_62 ||	འོ་ན་ཡོད་ལ་འགོག་ཡིན་ཞེས་༎
 atha śūnyatvaṃ pratiṣedhayasi tvaṃ |	སྨྲས་པ་དེ་ཉམས་མ་ཡིན་ནམ་༏་། ཅི་སྟེ་ཁྱོད་དངོས་པོ་ཐམས་ཅད་ཀྱི་རང་བཞིན་མེད་པ་ཉིད་དེ་།
 sarvabhāvānāṃ niḥsvabhāvatvaṃ śūnyatvaṃ nāsti tac ca śūnyatvam |	སྟོང་པ་ཉིད་འགོག་པར་བྱེད་ལ་སྟོང་པ་དེ་ཡང་མེད་པ་ཡིན་ན་།
 yā tarhi te pratijñā sataḥ pratiṣedho bhavati nāsata iti sā hīnā || (vv 316) kiñcānyat |	འོ་ན་ཡོད་པ་ལ་འགོག་པར་བྱེད་ཀྱི་མེད་པ་ལ་ནི་མ་ཡིན་ནོ་ཞེས་ཁྱོད་ཀྱིས་དམ་བཅས་པ་གང་ཡིན་པ་དེ་ཉམས་པ་ཡིན་ནོ་༎ འདི་ལྟར་གཞན་ཡང་།
 pratiṣedhayāmi nāhaṃ kiñcit pratiṣedhyam asti na ca kiñcit |	དགག་བྱ་ཅི་ཡང་མེད་པས་ན་༎ ད་ནི་ཅི་ཡང་མི་འགོག་གོ་༎ དེ་ཕྱིར་འགོག་པར་བྱེད་དོ་ཞེས་༎ སྐུར་པ་དེ་ནི་ཁྱོད་ཀྱིས་བཏབ་༎
 tasmāt pratiṣedhayasīty adhilaya eva tvayā kriyate || nagvv_63 || evam api tu kṛtvā yady ahaṃ kiñcit pratiṣedhayāmi tato yuktam eva vaktuṃ syāt | na caivahaṃ kiñcit pratiṣedhayāmi tasmān na kiñcit pratiṣedhavyam asti |	གལ་ཏེ་ངས་ཅི་ཞིག་འགོག་པར་བྱེད་ན་ནི་དེའི་ཕྱིར་ཁྱོད་ཀྱིས་དེ་སྐད་ཀྱང་སྨྲ་བའི་རིགས་ན་གང་གི་ཕྱིར་དགག་པར་བྱ་བ་ཅི་ཡང་མེད་པས་ད་ནི་ཅུང་ཟད་ཀྱང་འགོག་པར་མི་བྱེད་དོ་༎ 
 tasmāt śūnyeṣu sarvabhāveṣv avidyamāne pratiṣedhye pratiṣedhayasīty eṣa tvayātra sadbhūto 'dhilayaḥ kriyata iti ||	དེའི་ཕྱིར་དངོས་པོ་ཐམས་ཅད་སྟོང་པ་ཡིན་ཏེ་། དགག་པར་བྱ་བ་དང་། འགོག་པར་བྱེད་པ་ཡོད་པ་མ་ཡིན་པ་ལས་འགོག་པར་བྱེད་དོ་ཞེས་ཁྱོད་ཀྱིས་སྐུར་པ་ཐོག་ཏུ་མ་བབ་པ་དེ་བཏབ་བོ་༎
 yat punar bhavatoktaṃ |	གཞན་ཡང་ཁྱོད་ཀྱིས་།
 atha nāsti sa svabhāvaḥ kin nu pratiṣidhyate tvayānena	ཅི་སྟེ་རང་བཞིན་དེ་མེད་ན་༎ ཁྱོད་ཀྱི་ཚིག་དེས་ཅི་ཞིག་དགག་། 
 vacanena rte vacanāt pratiṣedhaḥ sidhyate hy asataḥ || [12]	མེད་པ་ཡིན་ན་ཚིག་མེད་པར་༎ འགོག་པ་རབ་ཏུ་གྲུབ་པ་ཡིན་༎
 atra brūmaḥ | yac cāhaṃ te vacanād asataḥ pratiṣedhavacanasiddhir iti |	ཞེས་སྨྲས་པ་གང་ཡིན་པ་དེ་འདི་ལ་བཤད་པར་བྱ་སྟེ་། ཚིག་མེད་པར་ཡང་མེད་པ་ཡི་༎ འགོག་པ་འགྲུབ་པར་འགྱུར་ཞེས་པ་༎
 atra jñāpayate vāg asad iti tan na pratinihanti || nagvv_64 || (vv 318) ya ca bhavān bravīti |	དེ་ལ་ཚིག་ནི་མེད་ཅེས་པར་༎ གོ་བར་བྱེད་ཀྱི་སྐྱེ་སེལ་མིན་༎ ཁྱོད་ཀྱི་ཚིག་དག་མེད་པར་ཡང་སྟེ་། ཚིག་མ་གཏོགས་པར་ཡང་མེད་པའི་འགོག་པ་འགྲུབ་ན་།
 sate 'pi vacanād asataḥ pratiṣedhaḥ pratisiddhaḥ tatra kin niḥsvabhāvāḥ sarvabhāvāḥ iti |	དེ་ལ་ཅིའི་དངོས་པོ་ཐམས་ཅད་རང་བཞིན་མེད་པ་ཡིན་ནོ་ཞེས་སྨྲས་པའི་ཁྱོད་ཀྱི་ཚིག་དེས་ཅི་ཞིག་བྱེད་ཅེས་སྨྲས་པ་གང་ཡིན་པ་འདི་ལ་བཤད་པར་བྱ་སྟེ་།
 etad vacanaṃ karotīti || atra brūmaḥ niḥsvabhāvā iti etat khalu vacanaṃ na niḥsvabhāvān sarvabhāvān karoti |	དངོས་པོ་༄༡༣༥བ་ཐམས་ཅད་རང་བཞིན་མེད་པའོ་ཞེས་བྱ་བའི་ཚིག་འདི་ནི་དངོས་པོ་རྣམས་རང་བཞིན་མེད་པ་ཉིད་དུ་བྱེད་པ་མ་ཡིན་གྱི་།
 kintv asata svabhāva bhāvānām asata svabhāvānām iti jñāpayati |	འོན་ཀྱང་རང་བཞིན་མེད་པ་ལ་དངོས་པོ་རྣམས་རང་བཞིན་མེད་པའོ་ཞེས་གོ་བར་བྱེད་པ་ཡིན་ནོ་༎ 
 tatra kaścit brūyād avidyamāhagṛhe devadattas tam asti gṛhe devadatta iti | tatrainaṃ kaścit pratibrūyān nāstīti | na tad| + + + + + devadattasyāsaṃbhavāṃ karoti |	དཔེར་ན་འགའ་ཞིག་ན་རེ་ལྷ་སྦྱིན་ཁྱིམ་ན་མེད་བཞིན་དུ་ལྷ་སྦྱིན་ཁྱིམ་ན་ཡོད་དོ་ཞེས་ཟེར་བ་དང་། དེ་ནི་དེ་ལ་ཁ་ཅིག་ན་རེ་མེད་དོ་ཞེས་ཟེར་བ་ན་།
 kintu jñāpayati kevalam asadbhāvaṃ gṛhe devadattasyeti ||	ཚིག་དེས་ལྷ་སྦྱིན་མེད་པར་མི་བྱེད་ཀྱི་ལྷ་སྦྱིན་ཁྱིམ་ན་མི་སྲིད་པར་སྟོན་པ་འབའ་ཞིག་ཏུ་ཟད་དོ་༎ 
 tadvā nāsti svabhāvo bhāvānām ity etadvacanaṃ na svabhāvānāṃ niḥsvabhāvatvaṃ karoti | bhāveṣu svabhāvasyābhāvaṃ jñāpayati ||	དེ་བཞིན་དུ་དངོས་པོ་རྣམས་ཀྱི་རང་བཞིན་མེད་དོ་ཞེས་བྱ་བའི་ཚིག་དེ་ཡང་དངོས་པོ་རྣམས་ཀྱི་རང་བཞིན་མེད་པ་ཉིད་དུ་བྱེད་པ་མ་ཡིན་གྱི་། འོན་ཀྱང་དངོས་པོ་ཐམས་ཅད་རང་བཞིན་མེད་པ་སྒྱུ་མའི་སྐྱེས་བུ་དང་འདྲ་བར་སྐྱེས་བུ་ཡང་དག་པའི་ངོ་བོ་དང་བྲལ་བ་རྣམས་ལ་རྨོངས་པའི་ཕྱིར་། བྱིས་པ་སྐྱེ་བོ་མ་རིག་པས་རྨོངས་པ་རྣམས་ཀྱི་རང་བཞིན་དང་བཅས་པ་ཉིད་དུ་སྒྲོ་བཏགས་པ་རྣམས་ལ་རང་བཞིན་། ཡོད་པ་མ་ཡིན་པར་གོ་བར་བྱེད་པ་ཡིན་པས་དེ་ལ་རང་བཞིན་ཡོད་པ་མ་ཡིན་ན་ཚིག་མེད་པར་ཡང་སྟེ་ཚིག་མ་གཏོགས་པར་ཡང་རང་བཞིན་ཡོད་པ་མ་ཡིན་པར་རབ་ཏུ་གྲུབ་པ་ཡིན་ནོ་༎ 
 tatra yad bhavatoktaṃ kim asati svabhāve nāsti svabhāva ity etadvacanaṃ karoti | ṛte 'pi vacanāt prasiddhiḥ svabhāvasyābhāva iti | tat te na yuktaṃ (vv 320)	རང་བཞིན་མེད་དོ་ཞེས་བྱ་བའི་ཚིག་དེས་ཅི་ཞིག་བྱེད་ཅེས་ཁྱོད་ཀྱིས་སྨྲས་པ་གང་ཡིན་པ་དེ་རིགས་པ་མ་ཡིན་ནོ་པ་ཡིན་ནོ་༎ 
 yad uktaṃ	༏་། གཞན་ཡང་། བྱིས་པ་རྣམས་ནི་སྨིག་རྒྱུ་ལ་༎
 bālānām iva mṛgatṛṣṇāyāṃ sa yathājalagrāhaḥ |	ཇི་ལྟར་ལོག་པར་ཆུར་འཛིན་ལྟར་༎
 evaṃ mithyāgrāhaḥ syāt te prasidhyate hy asataḥ | [13] yat punar bhavato mṛgātṛṣṇāyām ity atra brūmaḥ |	དེ་བཞིན་ཁྱོད་ཀྱིས་ལོག་པར་འཛིན་༎ ཡོད་པ་ཡིན་ལ་དགག་པར་བྱ་༎ ཞེས་བཤད་པ་ལ་སོགས་པ་ཡང་ཁྱོད་ཀྱིས་ཚིགས་སུ་བཅད་པ་བཞི་སྨྲས་པ་གང་ཡིན་པ་འདི་ལ་བཤད་པར་བྱ་སྟེ་།
 mṛgatṛṣṇādṛṣṭānte yaḥ punar uktaṃ tvayā mahāṃś carcaḥ |	སྨིག་རྒྱུའི་དཔེ་ལ་ཁྱོད་ཀྱིས་ཀྱང་༎ འགྲོ་བ་ཆེན་པོས་སྨྲས་པ་གང་༎
 tatrāpi nirṇayaṃ śṛṇu yathā sa dṛṣṭānta upapannaḥ || nagvv_65 ||	དེར་ཡང་ཅི་ནས་དཔེ་དེ་འཐད་༎ གཏན་ལ་དབབ་ལ་མཉན་པར་གྱིས་༎
 ya eva tvayā mṛgatṛṣṇādṛṣṭānte mahāṃś carca uktaḥ | tatrāpi tayā nirṇayaḥ sa śrūyatāṃ upapanna eva dṛṣṭānto bhavati |	ཁྱོད་ཀྱིས་སྨིག་རྒྱུའི་དཔེ་དེ་ལ་འགྲོ་བ་ཆེན་པོ་སྨྲས་པ་གང་ཡིན་པ་དེར་ཡང་དཔེ་དེ་ཅི་ནས་ཀྱང་འཐད་པ་གཏན་ལ་དབབ་པ་གང་ཡིན་པ་དེ་ཉོན་ཅིག་། 
 sa yadi svabhāvataḥ syād bhāvo na syāt pratītya samudbhūtaḥ |	གལ་ཏེ་འཛིན་དེ་རང་བཞིན་ཡོད་༎ བརྟེན་ནས་འབྱུང་བར་མི་འགྱུར་རོ་༎
 yaś ca pratītya hhavati grāho nanu śūnyatā saiva || nagvv_66 ||	འཛིན་པ་གང་ཞིག་བརྟེན་ནས་འབྱུང་༎ དེ་ཉིད་སྟོང་ཉིད་མ་ཡིན་ནམ་༎
 yadi ca mṛgatṛṣṇāyāṃ sa yathājalagrāhaḥ svabhāvataḥ syāt |	གལ་ཏེ་སྨིག་རྒྱུ་ལ་ཆུའོ་སྙམ་དུ་འཛིན་པ་རང་བཞིན་གྱིས་ཡོད་པ་ཞིག་ཡིན་ན་།
 na syāt pratītyasamutpanno |	རྟེན་ཅིང་འབྲེལ་པར་འབྱུང་བ་ཡིན་པར་མི་འགྱུར་༄༡༣༦ཨ་༌་༎ བ་ཞིག་ན་། གང་གི་ཕྱིར་སྨིག་རྒྱུ་ལ་ཡང་བརྟེན་།
 yato mṛgatṛṣṇāñ ca pratītya viparītañ ca darśanaṃ pratītya yoniśomanaskārañ ca pratītya	ཕྱིན་ཅི་ལོག་གི་ལྟ་བ་དང་། ཚུལ་བཞིན་མ་ཡིན་པའི་ཡིད་ལ་བྱེད་པ་ལ་མ་བརྟེན་ནས་བྱུང་བ་དེའི་ཕྱིར་རྟེན་ཅིང་འབྲེལ་པར་འབྱུང་བ་ཡིན་ནོ་༎
 prādurbhūto ataḥ pratītyasamutpannaḥ yataś ca pratītyasamutpanno 'taḥ svabhāvataḥ śūnya eva | yathā pūrvam uktaṃ tathā (vv 322)	གང་གི་ཕྱིར་རྟེན་ཅིང་འབྲེལ་བར་འབྱུང་བ་ཡིན་པ་དེའི་ཕྱིར་རང་བཞིན་གྱིས་སྟོང་པ་ཡིན་ཏེ་། སྔར་ཇི་སྐད་བསྟན་པ་དེ་དང་འདྲའོ་༎
 kiñcānyat |	འདི་ལྟར་གཞན་ཡང་།
 yadi ca svabhāvataḥ syād grāhaḥ kas taṃ vinivartayed grāham |	གལ་ཏེ་འཛིན་པ་རང་བཞིན་ཡོད་༎ འཛིན་པ་དེ་ལ་སུ་ཞིག་བཟློག་། 
 śeṣeṣv apy eṣa vidhiḥ tasmād eṣo 'nupālambhaḥ || nagvv_67 ||	ལྷག་མ་རྣམས་ལའང་ཚུལ་དེ་ཡིན་༎ དེ་ཕྱིར་ཀླན་ཀ་དེ་མེད་དོ་༎
 yadi ca mṛgatṛṣṇāyāṃ jalagrāhaḥ svabhāvataḥ syāt |	གལ་ཏེ་སྨིག་རྒྱུ་ལ་ཆུར་འཛིན་པ་འདི་རང་བཞིན་གྱིས་ཡོད་པ་ཞིག་ཡིན་ན་།
 ka eva taṃ vinivartayetā |	དེ་ལ་སུས་ཀྱང་བཟློག་པར་མི་འགྱུར་ཏེ་།
 na hi svabhāvaḥ śakyo nivartayituṃ | tathāgner uṣṇatvam apāṃ dravatvam ākāśasya niravavaraṇatvaṃ | dṛṣṭaṃ cāsya vinivartanaṃ |	ཇི་ལྟར་མེའི་ཚ་བ་ཉིད་དང་། ཆུའི་གཤེར་བ་ཉིད་དང་། ནམ་མཁའི་མི་བསྒྲིབ་པ་ཉིད་བཞིན་དུ་རང་བཞིན་ནི་བཟློག་པར་མི་ནུས་པ་ཡིན་ན་དེ་ནི་བཟློག་པར་ཡང་མཐོང་ངོ་༎
 tasmāc chūnyasvabhāvaḥ grāhaḥ |	དེའི་ཕྱིར་འཛིན་པ་དེ་རང་བཞིན་གྱིས་མེད་པ་ཡིན་ནོ་༎
 yadā caitad evaṃ śeṣeṣv api dharmeṣv eṣa kramaḥ pratyavagantavyaḥ grāhyapravṛttiṣu pañcasu | tatra yad bhavato + + + + pād aśūnyāḥ sarvabhāvā iti tan na || (vv 324)	འདི་ཇི་ལྟ་བ་བཞིན་ན་གཟུང་བ་ལ་སོགས་པ་ཆོས་ལྷག་མ་ལྔ་པོ་རྣམས་ལ་ཡང་ཚུལ་དེ་ལྟ་བུར་རྟོགས་པར་བྱ་བ་ཡིན་པས་དེ་ལ་དྲུག་ཚན་དྲུག་ཡོད་པའི་ཕྱིར་དངོས་པོ་ཐམས་ཅད་སྟོང་པ་མ་ཡིན་ནོ་ཞེས་སྨྲ་བ་གང་ཡིན་པ་དེ་མི་རུང་ངོ་༎
 yat punar bhavatoktaṃ |	གཞན་ཡང་།
 hetoś ca te na siddhir naiḥsvabbāvyāt kuto hi te hetuḥ	ཁྱོད་ལ་གཏན་ཚིགས་མ་གྲུབ་སྟེ་༎ རང་བཞིན་མེད་ཕྱིར་ཁྱོད་གཏན་ཚིགས་༎ གང་ལ་ཡོད་དོ་ཁྱོད་དོན་དེ་༎
 nirhetukasya siddhir na copapannāsya te 'rthasya [l7] iti ||	གཏན་ཚིགས་མེད་པར་འགྲུབ་མི་འཐད་༎
 atra brūmaḥ |	ཅེས་བྱ་བ་འདིར་བཤད་པར་བྱ་སྟེ་།
 etena hetvabhāvaḥ pratyuktaḥ pūrvam eva sa samatvāt |	འདི་ལ་སྔ་མས་གཏན་ཚིགས་མེད་༎ ལན་བཏབ་བསྒྲུབ་བྱར་མཚུངས་ཕྱིར་རོ་༎
 mṛgatṛṣṇādṛṣṭāntavyāvṛttividhau ya uktaḥ prāg || nagvv_68 ||	སྔ་མ་སྨིག་རྒྱུའི་དཔེས་བཟློག་པ་༎
 etenaiva cedānīṃ carcena pūrvoktena hetvabhāvo 'pi pratyavagantavyaḥ |	བསྒྲུབ་ཚེ་སྨྲས་པ་གང་ཡིན་པའོ་༎ ད་ལྟར་གྱི་འགྲོ་བ་འདི་དག་དང་སྔར་བསྟན་པས་གཏན་ཚིགས་མེད་པའི་ཡང་ལན་བཏབ་པར་རིགས་པར་བྱ་སྟེ་། 
 ya eva hi carcaḥ pūrvasmin hetāv uktaḥ ṣaṭkapratiṣe + + + + + + hāpi carcayitavyaḥ | (vv 326)	སྔར་གཏན་ཚིགས་བསྟན་པ་དྲུག་ཚན་འགག་པར་བྱེད་པའི་འགྲོ་བ་གང་ཡིན་པ་དེ་ཉིད་འདིར་ཡང་འགྲོ་བར་བྱ་བ་ཡིན་ནོ་པར་བྱ་སྟེ་། 
 yat punar bhavatoktaṃ |	༎ གཞན་ཡང་། འདི་ལྟར་རང་བཞིན་ཡོད་མིན་ན་༎
 pūrvaṃ cet pratiṣedhaḥ paścāt pratiṣedhyam ily anupapannaṃ |	གལ་ཏེ་འགོག་སྔ་དགག་འཕྱི་ཞེས་༎ ཟེར་ན་འཐད་པ་མ་ཡིན་ལ་༎
 paścāc cānupapanno yugapac ca yataḥ svabhāvo 'sana || [20]	འཕྱི་དང་ཅིག་ཅར་མི་འཐད་དོ་༎
 atra brūmaḥ |	ཞེས་སྨྲས་པ་གང་ཡིན་པ་འདི་ལ་བཤད་པར་བྱ་སྟེ་།
 yat traikālye hetuḥ pratyuktaṃ pūrvam eva sa samatvāt |	དུས་གསུམ་གཏན་ཚིགས་གང་ཡོད་སྔར་༎ ལན་བཏབ་༄༡༣༦བ་དེ་དང་མཚུངས་ཕྱིར་རོ་༎
 traikālyapratihetuś ca śūnyabhāvādinā prāptaḥ || nagvv_69 ||	དུས་གསུམ་ཁྱེད་ཀྱི་གཏན་ཚིགས་ནི་༎ སྟོང་ཉིད་སྨྲ་བ་རྣམས་ལ་རུང་༎
 sa eṣa hetuḥ traikālye pratiṣedhavācī sa tūktottaraḥ pratyavamantaḥ | kasmāt sādhyasamatvāt |	གཏན་ཚིགས་དུས་གསུམ་འགོག་པར་བྱེད་པ་ཞེས་བྱ་བ་གང་ཡིན་པ་དེ་ནི་ལན་བཏབ་ཟིན་ཏེ་། གང་གི་ཕྱིར་ཞེ་ན་བསྒྲུབ་པར་བྱ་བ་དང་མཚུངས་པའི་ཕྱིར་རོ་༎
 yathā hi pratiṣedhas traikālye nopapady|e + + + + + + pratiṣedhapratiṣedhe 'pi |	འདི་ལྟར་ཁྱོད་ཀྱི་ཚིག་གིས་འགོག་པ་དུས་གསུམ་དུ་ཡང་མི་འཐད་པར་འགྱུར་བའི་འགོག་པ་བཞིན་དུ་དགག་པར་བྱ་བ་ཡང་དེ་ཡིན་ནོ་༎
 tasmāt pratiṣedhapratiṣedhye 'sati bhavān manyate pratiṣedhaḥ pratisiddha iti tan na |	དེའི་ཕྱིར་འགོག་པ་དང་དགག་པར་བྱ་བ་མེད་ན་འགོག་པ་བཀག་གོ་སྙམ་དུ་ཁྱོད་སེམས་པ་གང་ཡིན་པ་དེ་མི་རུང་ངོ་༎
 yataś caiṣa trikālapratiṣedhavācī hetur eṣa eva śūnyatāvādināṃ prāptaḥ sarvabhāvasvabhāvapratiṣedhakatvān na bhavataḥ |	འགོག་པ་དུས་གསུམ་ལ་ཞེས་བྱ་བའི་གཏན་ཚིགས་དུས་གསུམ་འགོག་པར་བྱེད་པ་ཞེས་བྱ་བ་གང་ཡིན་པ་དེ་ཉིད་ནི་དངོས་པོ་ཐམས་ཅད་འགོག་པར་བྱེད་པ་ཞེས་བྱ་བ་གང་ཡིན་པའི་ཕྱིར་སྟོང་པ་ཉིད་སྨྲ་བ་རྣམས་ལ་ཡོད་པ་ཉིད་ཡིན་གྱི་། ཁྱོད་ལ་ནི་མེད་དོ་༎
 atha vā katham etad uktottaraṃ |	ཡང་ན་འདི་ཇི་ལྟར་ལན་བཏབ་པ་ཡིན་ཞེ་ན་།
 pratiṣedhayāmi nāhaṃ kiñcit pratiṣedhyam asti na ca kiñcit tasmāt pratiṣedhayasīty adhilaya eṣa tvayā kriyata [63] iti ||	དགག་བྱ་ཅི་ཡང་མེད་པས་ན་༏་། ང་ནི་ཅི་ཡང་མི་འགོག་གོ་༎ དེ་ཕྱིར་འགོག་པར་བྱེད་དོ་ཞེས་༎ སྐུར་བ་དེ་ནི་ཁྱོད་ཀྱིས་བཏབ་༎
 (vv 328)	ཅེས་ལན་བཏབ་པ་ཡིན་ནོ་༎
 atha manyase triṣv api kāleṣu + + + + + + + dṛṣṭaḥ pūrvakālīno 'pi hetuḥ uttarakālīno 'pi | yugapatkālīno 'pi hetuḥ | kathaṃ pūrvakalīnaḥ |	འོན་ཏེ་དུས་གསུམ་ཅར་དུ་ཡང་འགོག་པ་གྲུབ་པ་ཡིན་པས་ཏེ་། སྔོན་གྱི་དུས་ཀྱི་རྒྱུ་དང་། ཕྱི་མའི་དུས་ཀྱི་རྒྱུ་དང་། ཅིག་ཅར་གྱི་དུས་ཀྱི་རྒྱུ་ཡང་མཐོང་བས་སོ་༎
 yathā pitā putrasya tvadvacanena paścātkālīnaḥ |	དེ་ལ་སྔོན་གྱི་དུས་ཀྱི་རྒྱུ་ནི་ཇི་ལྟ་བུའི་ཕ་བཞིན་ནོ་༎ ཕྱི་མའི་དུས་ཀྱི་ནི་ཇི་ལྟར་སློབ་དཔོན་གྱིས་སློབ་མ་བཞིན་ནོ་༎
 yathā śiṣyācāryasya yugapatkālīnaḥ yathā pradīpaḥ prakāśasyeti || atra brūmaḥ | na caitad eva yuktā hy etasmiṃ traye pūrvadoṣaḥ || api ca punaḥ yady evaṃ kamaḥ |	ཅིག་ཅར་གྱི་དུས་ཀྱི་ནི་ཇི་ལྟར་སྣང་བའི་སྒྲོན་མ་བཞིན་ནོ་སྙམ་དུ་སེམས་ན་དེ་ནི་དེ་ལྟ་མ་ཡིན་པར་ཚུལ་འདི་ལ་སྐྱོན་སྔར་བསྟན་ཟིན་ཏོ་༎ གཞན་ཡང་གལ་ཏེ་དེ་ལྟ་ཡིན་ན་དགག་པ་སྲིད་པར་ཁྱོད་ཀྱིས་ཁས་བླངས་བསྟན་ཟིན་ཏོ་༎ ལ་། 
 pratiṣedhasadbhāvas tvayābhyupagamyate | pratijñāhāniś ca te bhavati | e + + + + + + + svabhā + + + |edho 'pi si + + bhavatīti |	དེ་ནི་མ་གྲུབ་པས་ཁྱོད་ཀྱིས་དམ་བཅས་པ་ཡང་ཉམས་པ་ཡིན་བསྟན་ཟིན་ཏོ་༎ 
 (vv 330)	།
 prabhavati ca śūnyateyaṃ yasya prabhavanti tasya sarvārthāḥ |	གང་ལ་སྟོང་པ་ཉིད་སྲིད་པ་༎ དེ་ལ་དོན་རྣམས་ཐམས་ཅད་སྲིད་༎
 prabhavati na tasya kinna prabhavati śūnyatā yasyeti || nagvv_70 ||	གང་ལ་སྟོང་ཉིད་མི་སྲིད་པ་༎ དེ་ལ་ཅི་ཡང་མི་སྲིད་དོ་༎
 yasya śūnyateyaṃ prabhavati tasya sarvārthā laukikalokottarāḥ prabhavanti |	གང་ལ་སྟོང་ཉིད་འདི་སྲིད་པ་དེ་ལ་འཇིག་རྟེན་པ་དང་། འཇིག་རྟེན་ལས་འདས་པའི་དོན་ཐམས་ཅད་སྲིད་པ་ཡིན་ནོ་༎
 kiṃ kāraṇaṃ |	ཅིའི་ཕྱིར་ཞེ་ན་།
 yasya hi śūnyatā prabhavati tasya pratītyasamutpādaḥ prabhavati | yasya pratītyasamutpādaḥ prabhavati tasya catvāry āryasatyāni prabhavanti | yasya catvāry āryasatyāni + + + + + + + maṇyaphalāni bhavanti |	གང་ལ་སྲིད་པ་དེ་ལ་རྟེན་ཅིང་འབྲེལ་པར་འབྱུང་བ་དང་། འཕགས་པའི་བདེན་པ་བཞི་དང་། དགེ་༄༡༣༧ཨ་༌་༎
 sarvaviśeṣādhigamaḥ bhavanti |	སྦྱོང་གི་འབྲས་བུ་དང་། ཁྱད་པར་དུ་རྟོགས་པ་ཐམས་ཅད་སྲིད་དོ་༎
 yasya sarvaviśeṣādhigamāḥ prabhavanti |	གང་ལ་ཁྱད་པར་དུ་རྟོགས་པ་ཐམས་ཅད་སྲིད་པ་དེ་ལ་དཀོན་མཆོག་གསུམ་པོ་༎
 tasya trīṇi raṃāṇi buddhadharmasaṃghāḥ prabhavanti |	སངས་རྒྱས་དང་། ཆོས་དང་། དགེ་འདུན་སྲིད་དོ་༎
 yasya pratītyasamutpādaḥ prabhavanti tasya dharmo dharmahetur dharmaphalañ ca prabhavanti |	གང་ལ་རྟེན་ཅིང་འབྲེལ་བར་འབྱུང་པ་སྲིད་པ་དེ་ལ་ཆོས་དང་༏་ཆོས་ཀྱི་རྒྱུ་དང་། ཆོས་ཀྱི་འབྲས་བུ་དང་། ཆོས་མ་ཡིན་པ་དང་། ཆོས་མ་ཡིན་པའི་རྒྱུ་དང་། ཆོས་མ་ཡིན་པའི་འབྲས་བུ་སྲིད་དོ་༎
 tasyādharmo 'dharmahetuś cādharmaphalañ ca prabhavati | tasya kleśaḥ kleśasamudayaḥ kleśavastūni ca prabhavanti | yasyaitat sarvaṃ bhavati pūrvoktaṃ tasya sugatiṃ durgatiṃ vyavasthā + + + + + + + gatidurgatigamanaṃ |	གང་ལ་ཆོས་དང་། ཆོས་མ་ཡིན་པ་དང་། རྒྱུ་དང་འབྲས་བུ་སྲིད་པ་དེ་ལ་ཉོན་མོངས་པ་དང་ཉོན་མོངས་པ་ཀུན་འབྱུང་བ་དང་། ཉོན་མོངས་པའི་གཞི་རྣམས་སྲིད་དོ་༎
 sugatidurgatigāmī mārgaḥ | sugatidurgatigamanavyatikramaṇaṃ sugatidurgativyatikramopāyaḥ sarvasaṃvyavahārāś ca lokikāḥ svayam adhigantavyāḥ | anayā diśā kiñcit śakyaṃ vacanopadeṣṭam iti |	གང་ལ་སྔར་བསྟན་པ་དེ་ཐམས་ཅད་སྲིད་པ་དེ་ལ་བདེ་འགྲོ་དང་། ངན་འགྲོ་རྣམ་པར་གཞག་པ་དང་། བདེ་འགྲོ་དང་། ངན་འགྲོར་འགྲོ་བའི་སེམས་ཅན་དང་། བདེ་འགྲོ་དང་། ངན་འགྲོ་ལས་འདའ་བ་དང་། བདེ་འགྲོ་དང་། ངན་འགྲོ་ལས་འགྲོ་བའི་ཐབས་དང་། འཇིག་རྟེན་པའི་ཐ་སྙད་ཐམས་ཅད་རྣམ་པར་གཞག་པ་ཡིན་ཏེ་ཚིག་གིས་ཇི་སྙེད་ཅིག་བསྟན་པར་ནུས་པས་ཕྱོགས་འདིས་རང་གིས་རྟོགས་པར་བྱའོ་༎
 (vv 332) bhavati cātra yaḥ śūnyatāṃ pratītyasamutpādaṃ madhyamāṃ pratipadam anekārthāṃ nijagāda praṇamāmi tam apratimaṃ tu buddhim iti ||	འདིར་ཡང་། གང་ཞིག་སྟོང་དང་རྟེན་འབྱུང་དག་། དབུ་མའི་ལམ་དུ་དོན་གཅིག་པར་༏་། གསུང་མཆོག་མཚུངས་པ་མེད་པ་ཡི་༎ སངས་རྒྱས་དེ་ལ་ཕྱག་འཚལ་ལོ་༎
 kṛtir iyam ācāryanāgārjunapādānā + + + + + ekatra ślokaśata 450 ||	རྩོད་པ་བཟློག་པའི་རབ་ཏུ་བྱེད་པའི་འགྲེལ་པ་ས་དང་པོ་རབ་ཏུ་དགའ་བ་ལ་བཞུགས་པ་སློབ་དཔོན་འཕགས་པ་ནའ་གའ་རྫུ་ནས་མཛད་པ་རྫོགས་སོ་། ༎ ། ཡོད་དམ་མེད་པའི་རྩོད་པ་སྨྲ་བ་མུན་བསལ་ཏེ་༎ བསྟན་ཟབ་གཉིས་མེད་དེ་བཞིན་ཉིད་ཆོས་སྣང་གྱུར་ནས་༎ སྲིད་པའི་མངལ་དུ་སྐྱེས་པའི་འཇིག་རྟེན་མ་ལུས་པ་༎ ལྷ་དང་མི་དང་ལྷ་མིན་ཐམས་ཅད་དགེ་བར་ཤོག་། དངོས་འཛིན་གདོན་གྱིས་བརླ་མས་པ་ཡི་༎ རིམས་ནད་རྟག་ཏུ་ཟློག་བྱེད་ཅིང་༎ འཇིག་རྟེན་འདི་ཡི་མུན་སེལ་བ་༎ དྲི་མེད་མི་ག-ཡོ་རིགས་འདི་ཡིན་།
