skt	tib
 ācārya vasubandhuviracitam pañcaskandhaprakaraṇam prathamādhikāraḥ - skandhoddeśanirdeśakaḥ	༄༡༡བ་༌་༎ རྒྱ་གར་སྐད་དུ་། པཉཙ་སྐནདྷ་པྲ་ཀ་ར་ན་། བོད་སྐད་དུ་། ཕུང་པོ་ལྔའི་རབ་ཏུ་བྱེད་པ་། འཇམ་དཔལ་གཞོན་ནུར་གྱུར་པ་ལ་ཕྱག་འཚལ་ལོ་༎
 pañcaskandhāḥ rūpaskandhaḥ vedanāskandhaḥ saṃjñāskandhaḥ saṃskāraskandhaḥ vijñānaskandhaśca || 1 || rūpasya dvau bhedau	ཕུང་པོ་ལྔ་ནི་གཟུགས་ཀྱི་ཕུང་པོ་དང་། ཚོར་བའི་ཕུང་པོ་དང་། འདུ་ཤེས་ཀྱི་ཕུང་པོ་དང་། འདུ་བྱེད་ཀྱི་ཕུང་པོ་དང་། རྣམ་པར་ཤེས་པའི་ཕུང་པོའོ་༎
 rūpaṃ katamat |	གཟུགས་གང་ཞེ་ན་།
 yat kiñcid rūpaṃ sarvaṃ taccatvāri mahābhūtāni catvāri ca mahābhūtānyupādāya || 2 || mahābhūtanāmāni	གཟུགས་གང་ཡིན་པ་ཅི་ཡང་རུང་སྟེ་། དེ་དག་ཐམས་ཅད་འབྱུང་བ་ཆེན་པོ་བཞི་དག་དང་། འབྱུང་བ་ཆེན་པོའི་བཞི་དག་རྒྱུར་བྱས་པའོ་༎
 katamāni catvāri mahābhūtāni |	འབྱུང་བ་ཆེན་པོ་བཞི་དག་གང་ཞེ་ན་།
 pṛthivī dhātuḥ abdhātuḥ tejodhātuḥvāyudhātuśca || 3 || mahābhūtalakṣaṇāni	སའི་ཁམས་དང་། ཆུའི་ཁམས་དང་། མེའི་ཁམས་དང་། རླུང་གི་ཁམས་སོ་༎
 tatra pṛthivīdhātuḥ katamaḥ | kaṭhinatā || 4 ||	དེ་ལ་སའི་ཁམས་གང་ཞེ་ན་། སྲ་བ་ཉིད་དོ་༎
 abdhātuḥ katamaḥ | niṣyandatā || 5 ||	ཆུའི་ཁམས་གང་ཞེ་ན་།
 tejodhātuḥ katamaḥ uṣṇatā || 6 ||	གཤེར་བ་ཉིད་དོ་༎ མེའི་ཁམས་གང་ཞེ་ན་། ཚ་བ་ཉིད་དོ་༎
 vāyudhātuḥ katamaḥ |	རླུང་གི་ཁམས་གང་ཞེ་ན་༎
 paunaḥ punyakampanatā || 7 || upādāyarūpanāmāni	ཡང་ཞིང་ག-ཡོ་བ་ཉིད་དོ་༎
 upādayarūpaṃ katamat |	རྒྱུར་བྱས་པའི་གཟུགས་གང་ཞེ་ན་།
 cakṣurindriyam, śrotrendriyam, ghraṇendriyam, jihvendriyam, kāyendriyam, rūpam, śabdaḥ, gandhaḥ,	མིག་གི་དབང་པོ་དང་། རྣ་བའི་དབང་པོ་དང་། སྣའི་དབང་པོ་དང་། ལྕེའི་དབང་བོ་དང་། ལུས་༄༡༢ཨ་༌་༎
 rasaḥ, spraṣṭavyaikadeśaḥ, abijñaptiśca || 8 ||	ཀྱི་དབང་པོ་དང་། གཟུགས་དང་། སྒྲ་དང་། དྲི་དང་། རོ་དང་། རེག་བྱའི་ཕྱོགས་གཅིག་དང་། རྣམ་པར་རིག་བྱེད་མ་ཡིན་པའོ་༎
 upādāyarūpalakṣaṇāni cakṣurindrayaṃ katamat |	དེ་ལ་མིག་གི་དབང་པོ་གང་ཞེ་ན་།
 varṇabiṣayo rūpaprasādaḥ || 9 ||	ཡུལ་ཁ་དོག་གཟུགས་དང་བའོ་༎
 śrotrendrayaṃ katamat |	རྣ་བའི་དབང་པོ་གང་ཞེ་ན་།
 śabdaviṣayo rūpaprasādaḥ || 10 ||	ཡུལ་སྒྲ་གཟུགས་དང་བའོ་༎
 ghrāṇendriyam katamat |	སྣའི་དབང་པོ་གང་ཞེ་ན་།
 gandhaviṣayo rūpaprasādaḥ || 11 ||	ཡུལ་དྲི་གཟུགས་དང་བའོ་༎
 jihvendriyam katamat |	ལྕེའི་དབང་པོ་གང་ཞེ་ན་།
 rasaviṣayo rūpaprasādaḥ || 12 ||	ཡུལ་རོ་གཟུགས་དང་བའོ་༎
 kāyendriyam katamat |	ལུས་ཀྱི་དབང་པོ་གང་ཞེ་ན་།
 spraṣṭavyaviṣayo rūpaprasādaḥ || 13 ||	ཡུལ་རེག་བྱ་གཟུགས་དང་བའོ་༎
 rūpaṃ katamat |	གཟུགས་གང་ཞེ་ན་།
 cakṣurgocaraḥ |	མིག་གི་ཡུལ་ཏེ་།
 varṇaḥ saṃsthānam bijñaptiśca || 14 ||	ཁ་དོག་དང་། དབྱིབས་དང་། རྣམ་པར་རིག་བྱེད་དོ་།
 śabdaḥ katamaḥ |	སྒྲ་གང་ཞེ་ན་།
 śrotragocaraḥ | niṣpannḥ aniṣpannaḥ ubhayaḥ |	རྣ་བའི་ཡུལ་ཏེ་།
 upāttacatumarhābhutahetukaḥ anupāttacaturmahābhūtahetukaḥ ubhayacaturmahābhūtahetukaśca || 15 ||	ཟིན་པ་དང་མ་ཟིན་པ་དང་གཉི་གའི་སྟེ་། འབྱུང་བ་ཆེན་པོ་བཞིའི་རྒྱུ་ལས་བྱུང་བའོ་༎
 gandhaḥ katamaḥ |	དྲི་གང་ཞེ་ན་།
 ghrāṇagocaraḥ |	སྣའི་ཡུལ་ཏེ་།
 surabhiḥ asurabhiḥ tadanyaśca || 16 ||	དྲི་ཞིམ་པ་དང་། དྲིང་བ་དང་། དེ་ལས་གཞན་པའོ་༎
 rasaḥ katamaḥjihvāgocaraḥ |	རོ་གང་ཞེ་ན་། ལྕེའི་ཡུལ་ཏེ་།
 madhuraḥ amalaḥ lavaṇaḥ kaṭuḥ tiktaḥ kaṣāyaśc || 17 ||	མངར་བ་དང་། སྒྱུར་བ་དང་། ལན་ཚབ༹་དང་། ཚ་བ་དང་། ཁ་བ་དང་། བསྐ་བ་ཞེས་བྱའོ་༎
 spraṣṭavyaḥ katamaḥ |	རེག་བྱའི་ཕྱོགས་གཅིག་གང་ཞེ་ན་།
 kāyagocaraḥ |	ལུས་ཀྱི་ཡུལ་ཏེ་།
 mahābhūtānyupādāya ślakṣṇatvam karkasatbam gurutvam laghutvam śītatvam jighatsā pipāsā ca || 18 ||	འབྱུང་བ་ཆེན་པོ་རྣམས་བཞག་སྟེ་། འཇམ་པ་ཉིད་དང་། རྩུབ་པ་ཉིད་དང་། ལྕི་བ་ཉིད་དང་། ཡང་བ་ཉིད་དང་། གྲང་བ་ཉིད་དང་། བཀྲེས་པ་ཉིད་དང་། སྐམ་པའོ་༎
 abijñaptirūpaṃ katamat |	རྣམ་པར་རིག་བྱེད་མ་ཡིན་པ་གང་ཞེ་ན་།
 vijñaptisamādhisaṃbhūtaṃ rūpam anidarśanam apratigham || 19 || rūpaskandhaḥ soniddeśaḥ pariniṣṭhitaḥ |	རྣམ་པར་རིག་བྱེད་དང་། ཏིང་ངེ་འཛིན་ལས་བྱུང་བའི་གཟུགས་ཏེ་། བསྟན་དུ་མེད་ལ་ཐོགས་པ་མེད་པའོ་༎
 atha vedanā salakṣaṇaprabhedā vedanā katamā |	ཚོར་བ་གང་ཞེ་ན་།
 trividho 'nubhavaḥ |	མྱོང་བ་རྣམ་པ་གསུམ་སྟེ་།
 sukhaḥ duḥkhaḥ aduḥkhāsukhaśca || 20 ||	བདེ་བ་དང་སྡུག་བསྔལ་བ་དང་། སྡུག་བསྔལ་ཡང་མ་ཡིན་། བདེ་བ་ཡང་མ་ཡིན་པ་སྟེ་།
 sukho yasmin niruddhe saṃyogecchā jāyate || 21 ||	བདེ་བ་དེ་གང་འགགས་ན་ཕྲད་པར་འདོད་པའོ་༎
 duḥkho yasminnutpanne viyogecchā jāyate || 22 ||	སྡུག་བསྔལ་ནི་གང་བྱུང་ན་བྲལ་བར་འདོད་པའོ་༎
 aduḥkhāsukho yasminnutpanne nobhayecchā jāyane || 23 || vedanaskandhaḥ sonideśanirdeśaḥ parinisṭhataḥ |	བདེ་བ་ཡང་མ་ཡིན་། སྡུག་བསྔལ་བ་ཡང་མ་ཡིན་པ་ནི་གང་བྱུང་ན་གཉིས་ཀར་འདོད་པར་མི་འགྱུར་བའོ་༎
 atha saṃjñā lakṣaṇa prabhedā saṃjñā katamā |	འདུ་ཤེས་གང་ཞེ་ན་།
 viṣayanimittod grahaṇam || 24 ||	ཡུལ་ལ་མཚན་མར་འཛིན་པའོ་༎
 sā tridhā parittā mahadgatā apramāṇā ca || 25 || saṃjñā skandhaḥ soddeśanirdeśaḥ parinisṭhitaḥ | saṃskārāṇāṃ dvaubhedau	དེ་ནི་རྣམ་པ་གསུམ་སྟེ་། ཆུང་དུ་དང་། རྒྱ་ཆེན་པོར་གྱུར་པ་དང་། ཚད་མེད་པའོ་༎
 saṃskārāḥ katame |	འདུ་བྱེད་རྣམས་གང་ཞེ་ན་།
 vedanāsaṃjñābhyāmanye caitāḥ cittaviprayuktāśca || 26 ||	ཚོར་བ་དང་འདུ་ཤེས་ལས་གཞན་པ་སེམས་ལས་བྱུང་བའི་ཆོས་རྣམས་དང་། ༄༡༢བ་སེམས་དང་ལྡན་པ་མ་ཡིན་པ་རྣམས་སོ་༎
 tatra caitadharmāḥ katame |	དེ་ལ་སེམས་ལས་བྱུང་བའི་ཆོས་རྣམས་ཀྱང་གང་ཞེ་ན་།
 ye dharmārścittena saṃprayuktāḥ || 27 ||	ཆོས་གང་དག་སེམས་དང་མཚུངས་པར་ལྡན་པ་རྣམས་སོ་༎ དེ་དག་ཀྱང་གང་ཞེ་ན་།
 caitaparisaṃkhyānam te katame | sparśaḥ manaskāraḥ vedanā saṃjñā cetanā chandaḥ adhimokṣaḥ smṛtiḥ samādhiḥ prajñā śraddhā hrīḥ apatrapā alobhaḥ kuśalamūlam adveṣaḥkuśalamūlam amohaḥkuśalamūlam vīryam praśrabdhiḥ apramādaḥ upekṣā avihiṃsā rāga pratighaḥ mānaḥ avidyā dṛṣṭiḥ vicikitsā krodha upanāhaḥ mrakṣaḥ pradāśaḥ īrṣyā mātsaryarm māyā śāṭhyam madaḥ ahiṃsā āhrikyam anapatrāpyam styānam, auddhatyam, āśraddhyam, kauśīddhyam pramādaḥ muṣitāsmṛti, bikṣepaḥ, aprasajanyam, kaukrityam, middham, vitarkaḥ, vicāraśca || 28 ||	རེག་པ་དང་། ཡིད་ལ་བྱེད་པ་དང་། ཚོར་བ་དང་། འདུ་ཤེས་དང་། སེམས་པ་དང་། འདུན་པ་དང་། མོས་པ་དང་། དྲན་པ་དང་། ཏིང་ངེ་འཛིན་དང་། ཤེས་རབ་དང་། དད་པ་དང་། ངོ་ཚ་ཤེས་པ་དང་། ཁྲེལ་ཡོད་པ་དང་། མ་ཆགས་པའི་དགེ་བའི་རྩ་བ་དང་། ཞེ་སྡང་མེད་པའི་དགེ་བའི་རྩ་བ་དང་། གཏི་མུག་མེད་པའི་དགེ་བའི་རྩ་བ་དང་། བརྩོན་འགྲུས་དང་། ཤིན་ཏུ་སྦྱངས་པ་དང་། བག་ཡོད་པ་དང་། བཏང་སྙོམས་དང་། རྣམ་པར་མི་འཚེ་བ་དང་། འདོད་ཆགས་དང་། ཁོང་ཁྲོ་བ་དང་། ང་རྒྱལ་དང་། མ་རིག་པ་དང་། ལྟ་བ་དང་། ཐེ་ཚོམ་དང་། ཁོ་བ་དང་། ཁོན་དུ་འཛིན་པ་དང་། འཆབ་བ་དང་། འཚིག་པ་དང་། ཕྲག་དོག་དང་། སེར་སྣ་དང་། སྒྱུ་དང་། ག-ཡོ་དང་། རྒྱགས་པ་དང་། རྣམ་པར་འཚེ་བ་དང་། ངོ་ཚ་མེད་པ་དང་། ཁྲེལ་མེད་པ་དང་། རྨུགས་པ་དང་། རྒོད་པ་དང་། མ་དད་པ་དང་། ལེ་ལོ་དང་། བག་མེད་པ་དང་། བརྗེད་ངས་པ་དང་། རྣམ་པར་ག-ཡེངས་པ་དང་། ཤེས་བཞིན་མ་ཡིན་པ་དང་། འགྱོད་པ་དང་། གཉིད་དང་། རྟོག་པ་དང་། དཔྱོད་པའོ་།
 eteśāṃ paśca sarvatragāḥ |	དེ་རྣམས་ལས་ལྔ་ནི་ཀུན་ཏུ་འགྲོ་བའོ་༎
 pañcapratiniyataviṣayā |	ལྔ་ནི་ཡུལ་སོ་སོར་ངེས་པའོ་༎
 ekādaśakuśalāḥ |	བཅུ་གཅིག་ནི་དགེ་བའོ་༎
 ṣaṭkleśāḥ |	དྲུག་ནི་ཉོན་མོངས་པའོ་༎
 śiṣṭā upakleśāḥ |	ལྷག་མ་རྣམས་ནི་ཉེ་བའི་ཉོན་མོངས་པའོ་༎
 catvāro 'nyatrāpi bhavantītyaniyatāḥ || 29 || caittalakṣaṇāni	བཞི་ནི་གཞན་དུ་ཡང་འགྱུར་བའོ་༎
 sparśaḥkatamaḥ |	རེག་པ་གང་ཞེ་ན་།
 trikasaṃnipāte indriyavikāraparicchedaḥ || 30 ||	གསུམ་འདུས་ནས་ཡོངས་སུ་གཅོད་པའོ་༎
 manaskāraḥ katamaḥ |	ཡིད་ལ་བྱེད་པ་གང་ཞེ་ན་།
 cetasa ābhogaḥ || 31 ||	སེམས་ཀྱི་འཇུག་པའོ་༎
 cetanā katamā |	སེམས་པ་གང་ཞེ་ན་།
 guṇadoṣānubhayeṣu cittābhisaṃskāro manaskarma || 32 ||	ཡོན་ཏན་དང་། ཉེས་པ་དང་། གཉི་ག་མ་ཡིན་པ་ཡིན་པ་ལ་སེམས་མངོན་པར་འདུ་བྱེད་པ་ཡིད་ཀྱི་ལས་སོ༎
 chandaḥ katamaḥ |	འདུན་པ་གང་ཞེ་ན་།
 abhiprete vastunyabhilāṣaḥ || 33 ||	བསམ་པའི་དངོས་པོ་ལ་འདོད་པའོ་༎
 adhimokṣaḥ katamaḥ |	མོས་པ་གང་ཞེ་ན་།
 niścite vastuni tathaivāvadhāraṇam || 34 ||	ངེས་པའི་དངོས་པོ་ལ་དེ་བཞིན་དུ་ངེས་པར་འཛིན་པའོ་༎
 smṛtiḥ katamā |	དྲན་པ་གང་ཞེ་ན་།
 saṃstute vastunyasaṃpramoṣaḥ || 35 ||	འདྲིས་པའི་དངོས་པོ་ཉིད་མ་བརྗེད་པ་སྟེ་། སེམས་ཀྱི་མངོན་པར་བརྗོད་པ་ཉིད་དོ་༎
 samādhiḥ katamaḥ |	ཏིང་ངེ་འཛིན་གང་ཞེ་ན་། བརྟག་པའི་༄༡༣ཨ་༌་༎
 upaparīkṣye vastuni cittasyaikāgratā || 36 ||	དངོས་པོ་ལ་སེམས་རྩེ་གཅིག་པ་ཉིད་དོ་༎
 prajñā katamā |	ཤེས་རབ་གང་ཞེ་ན་།
 tatraiva pravicayo yogāyogavihito 'nyathā ca || 37 ||	དེ་དག་ཉིད་ལ་རབ་ཏུ་རྣམ་པར་འབྱེད་པ་སྟེ་། རིགས་པ་དང་། རིགས་པ་མ་ཡིན་པས་བསྐྱེད་པ་དང་། གཞན་པའོ་༎
 śraddā katamā |	དད་པ་གང་ཞེ་ན་།
 karmaphalāsatyaratneṣvabhisaṃpratyayaḥ | cetaso 'bhilāṣaḥ cetasaḥ prasādaḥ || 38 ||	ལས་དང་འབྲས་བུ་དང་། བདེ་ན་པ་དང་། དཀོན་མཆོག་ལ་མངོན་པར་ཡིད་ཆེས་པ་དང་། འདོད་པ་དང་། སེམས་དང་བའོ་༎
 hrīḥ | katamā ātmānaṃ dharmaṃ vādhipatiṃ kṛtvā svayamavayena lajjā || 39 ||	ངོ་ཚ་ཤེས་པ་གང་ཞེ་ན་། བདག་གམ་ཆོས་ཀྱི་དབང་དུ་བྱས་ཏེ་། ཁ་ན་མ་ཐོ་བས་འཛེམ་པའོ་༎
 apatrapā katamā |	ཁྲེལ་ཡོད་བ་གང་ཞེ་ན་།
 lokamadhipatiṃ kṛtvā parato 'vadhena lajjā || 40 ||	འཇིག་རྟེན་གྱི་དབང་དུ་བྱས་ཏེ་ཁ་ན་མ་ཐོ་བས་འཛེམ་པའོ་༎
 alobhaḥ katamaḥ |	མ་ཆགས་པ་གང་ཞེ་ན་།
 lobha pratipakṣaḥ |	ཆགས་པའི་གཉེན་པོ་སྟེ་།
 cetaso dānakṣetrāparigrahaḥ || 41 ||	ཡིད་བྱུང་ཞིང་མི་ལེན་པའོ་༎
 adveṣaḥ katamaḥ |	ཞེ་སྡང་མེད་པ་གང་ཞེ་ན་།
 dveṣapratipakṣaḥ | maitri || 42 ||	ཞེ་སྡང་གི་གཉེན་པོ་སྟེ་བྱམས་པའོ་༎
 amohaḥ katamaḥ |	གཏི་མུག་མེད་པ་གང་ཞེ་ན་།
 mohapratipakṣaḥ |	གཏི་མུག་གི་གཉེན་པོ་སྟེ་།
 yathābhūtasaṃpratipattiḥ || 43 ||	ཡང་དག་པ་ལ་ཡང་དག་པར་རྟོགས་པའོ་༎
 vīryaṃ katamat kausīddyapratipakṣaḥ kuśale cetaso 'bhyutsāhaḥ || 44 ||	བརྩོན་འགྲུས་གང་ཞེ་ན་། ལེ་ལོའི་གཉེན་པོ་སྟེ་། དགེ་བ་ལ་སེམས་མངོན་པར་སྤྲོ་བའོ་༎
 praśrabdhiḥ katamā |	ཤིན་དུ་སྦྱངས་པ་གང་ཞེ་ན་།
 dauṣṭhulyapratipakṣaḥ kāyacittakarmaṇyatā || 45 ||	གནས་ངན་ལེན་གྱི་གཉེན་པོ་སྟེ་། ལུས་དང་སེམས་ལས་སུ་རུང་བ་ཉིད་དོ་༎
 apramādaḥ katamaḥ |	བག་ཡོད་པ་གང་ཞེ་ན་།
 pramādapratipakṣaḥ |	བག་མེད་པའི་གཉེན་པོ་སྟེ་།
 alobhādīn vīryāntān niśritya akuśalānāṃ dharmāṇāṃ prahāṇam |	མ་ཆགས་པ་ནས་བརྩོན་འགྲུས་ཀྱི་བར་དེ་དག་ལ་གནས་ནས་མི་དགེ་བའི་ཆོས་སྤང་ཞིང་།
 tatpratipakṣāṇāṃ kuśalānāṃ dharmāṇāṃ bhāvanā || 46 ||	དེའི་གཉེན་པོ་དགེ་བའི་ཆོས་རྣམས་བསྒོམ་པའོ་༎
 upekṣā katamā |	བཏང་སྙོམས་གང་ཞེ་ན་།
 alobhādīn vīryantān niśritya cittasamatā | cittapraśastā | cittānābhogatā |	མ་ཆགས་པ་ནས་བརྩོན་འགྲུས་ཀྱི་བར་དེ་དག་ཉིད་ལ་གནས་ཤིང་སེམས་མཉམ་པ་ཉིད་དང་། སེམས་རྣལ་དུ་འདུག་པ་དང་། སེམས་ལྷུན་གྱིས་གྲུབ་པ་ཡང་ཐོབ་པ་སྟེ་།
 yayākliṣṭadharmānavakāśenākliṣṭeṣu sthitiḥ || 47 ||	གང་གི་ཉོན་མོངས་པ་ཅན་གྱི་ཆོས་རྣམས་བསལ་ནས་ཉོན་མོངས་པ་ཅན་མེད་པར་གནས་པ་ཉིད་དོ་༎ 
 avihiṃsā katamā |	རྣམ་པར་མི་འཚེ་བ་གང་ཞེ་ན་།
 vihiṃsāpratipakṣaḥ karuṇā || 48 |||	རྣམ་པར་འཚེ་བའི་གཉེན་པོ་སྟེ་། སྙིང་རྗེ་བའོ་༎
 rāgaḥ katamaḥ | upādānaskandheṣvabhyarthanā | adhyavasānam || 49 ||	འདོད་ཆགས་གང་ཞེ་ན་ཉེ་བར་ལེན་པའི་ཕུང་པོ་ལྔ་ལ་མངོན་པར་ཞེན་པ་དང་། ལྷག་པར་ཆགས་པའོ་༎
 pratighaḥ katamaḥ |	ཁོང་ཁྲོ་བ་གང་ཞེ་ན་།
 satveṣvāghātacittatā || 50 ||	སེམས་ཅན་རྣམས་ལ་ཀུན་ནས་མནར་སེམས་པའོ་༎
 mānaḥ katamaḥ |	ང་རྒྱལ་གང་ཞེ་ན་།
 mānaḥ saptavidhaḥ |	ང་རྒྱལ་རྣམ་པ་བདུན་སྟེ་།
 atimānaḥ, mānātimānaḥ asmimānaḥ, abhimānaḥ,	ང་རྒྱལ་དང་། ཆེ་བའི་ང་རྒྱལ་དང་། ང་རྒྱལ་ལས་ཀྱང་ང་རྒྱལ་དང་༎ ངའོ་སྙམ་པའི་ང་རྒྱལ་དང་༎ མངོན་པའི་ང་རྒྱལ་༄༡༣བ་དང་། ཅུང་ཟད་སྙམ་པའི་ང་རྒྱལ་དང་། ལོག་པའི་ང་རྒྱལ་ལོ་༎
 ūnamānaḥ, mithyāmānaśca || 51 ||	ང་རྒྱལ་གང་ཞེ་ན་། ཆུང་དུ་བས་བདག་ཆེ་བའམ་། མཚུངས་པ་དང་མཚུངས་སོ་སྙམ་དུ་སེམས་ཁེངས་པ་གང་ཡིན་པའོ་༎
 atimānaḥ katamaḥ |	ཆེ་བའི་ང་རྒྱལ་གང་ཞེ་ན་།
 hīnāt śreyānahamasmi sadṛśena vā sadṛśo 'smīti cintayato yā cittasyonnatiḥ || 53 ||	མཚུངས་པ་བས་བདག་ཆེ་བའམ་། ཆེ་བ་དང་མཚུངས་སོ་སྙམ་དུ་སེམས་ཁེངས་པ་གང་ཡིན་པའོ་༎
 mānātimānaḥ katamaḥ |	ང་རྒྱལ་ལས་ཀྱང་ང་རྒྱལ་གང་ཞེ་ན་།
 śreyaso 'hameva śreyāniti cintayato yā cittasyonnatiḥ || 54 ||	ཆེ་བ་བས་ཀྱང་བདག་ཆེའི་སྙམ་དུ་སེམས་ཁེངས་པ་གང་ཡིན་པའོ་༎
 asmimānaḥ katamaḥ |	ངའོ་སྙམ་པའི་ང་རྒྱལ་གང་ཞེ་ན་།
 pañcasūpādānaskandheṣvātmānamātmīyaṃ vā paśyato yā cittasyonnati || 55 ||	ཉེ་བར་ལེན་པའི་ཕུང་པོ་ལྔ་པོ་རྣམས་ལ་བདག་གམ་བདག་གིར་ལྟ་བའི་སེམས་ཁེངས་པ་གང་ཡིན་པའོ་༎ 
 abhimānaḥ katamaḥ |	མངོན་པའི་ང་རྒྱལ་གང་ཞེ་ན་།
 aprāpta uttare viśeṣādhigame prāpto mayeti cintayato yā cittasyonnatiḥ || 56 ||	གོང་མའི་ཁྱད་པར་ཐོབ་པར་བྱ་བ་མ་ཐོབ་པར་བདག་གིས་ཐོབ་བོ་སྙམ་དུ་སེམས་ཁེངས་པ་གང་ཡིན་པའོ་༎ 
 ūnamānaḥ katamaḥ |	ཅུང་ཟད་སྙམ་པའི་ང་རྒྱལ་གང་ཞེ་ན་།
 bahṛvantaraviśiṣṭādalpāntarahino 'smīti cintayato yā cittasyonnatiḥ || 57 ||	ཁྱད་པར་ཆེས་འཕགས་པ་བས་བདག་ཅུང་ཟད་ཆུང་ངོ་སྙམ་དུ་སེམས་ཁེངས་པ་གང་ཡིན་བའོ་༎
 mithyāmānaḥ katamaḥ |	ལོག་པའི་ང་རྒྱལ་གང་ཞེ་ན་།
 aguṇavato guṇavānahamasmīti cintayato yā cittasyonnatiḥ || 58 ||	ཡོན་ཏན་མ་ཡིན་པ་དང་ལྡན་པ་ལ་བདག་ཡོན་ཏན་དང་ལྡན་ནོ་སྙམ་དུ་སེམས་ཁེངས་པ་གང་ཡིན་པའོ་༎ 
 aviddhyā katamā |	མ་རིག་པ་གང་ཞེ་ན་།
 karmaphalasatyaratnānāmajñānam |	ལས་དང་འབྲས་བུ་དང་བདེན་པ་དང་། དཀོན་མཆོག་རྣམས་མི་ཤེས་པ་དེ་།
 sā punaḥ sahajā parikalpitā ca || 59 ||	དེ་ཡང་ལྷན་ཅིག་སྐྱེས་པ་དང་། ཀུན་ཏུ་བརྟགས་པའོ་༎
 rāgacaritasya rāgapratighayoḥ rāgacaritasyāviddyāyāścetyakuśalānāṃ trīṇī mūlāni | lobho 'kuśalamūlaṃ ddheṣo 'kuśalamūlaṃ,	འདོད་པ་ན་སྤྱོད་པའི་འདོད་ཆགས་དང་། ཁོང་ཁྲོ་བ་དང་། འདོད་པ་ན་སྤྱོད་པའི་མ་རིག་པ་དེ་དག་ནི་མི་དགེ་བའི་རྩ་བ་གསུམ་སྟེ་།
 moho 'kuśalamūlaṃ ca || 60 ||	ཆགས་པ་དང་ཞེ་སྡང་དང་གཏི་མུག་མི་དགེ་བའི་རྩ་བའོ་༎
 dṛṣṭiḥ katamā pañcadṛṣṭyaḥ - satkāyadṛṣṭiḥ, antargrāhyadṛṣṭiḥ,	ལྟ་བ་གང་ཞེ་ན་། ལྟ་བ་ལྔ་སྟེ་།
 mithyādṛṣṭiḥ, dṛṣṭiparāmarśaḥ, śīlavrataparāmarśaśca || 61 ||	འཇིག་ཚོགས་ལ་ལྟ་བ་དང་། མཐར་འཛིན་པར་ལྟ་བ་དང་། ལོག་པར་ལྟ་བ་དང་། ལྟ་བ་མཆོག་ཏུ་འཛིན་པ་དང་། ཚུལ་ཁྲིམས་དང་། བརྟུལ་ཞུགས་མཆོག་ཏུ་འཛིན་པའོ་༎
 satkāyadṛṣṭiḥ katamā |	འཇིག་ཚོགས་ལ་ལྟ་བ་གང་ཞེ་ན་།
 pañcopādāna - skandhānātmata ātmīyato vā paśyato yā kliṣṭā prajñā || 62 ||	ཉེ་བར་ལེན་པའི་ཕུང་པོ་ལྔ་རྣམས་ལ་བདག་གམ་བདག་གིར་ལྟ་བའི་ཤེས་རབ་ཉོན་མོངས་པ་ཅན་གང་ཡིན་པའོ་།
 antargrāhyadṛṣṭiḥ katamā |	མཐར་འཛིན་པར་ལྟ་བ་གང་ཞེ་ན་།
 tānevādhipatiṃ kṛtvā śāśvatata ucchedato vā paśyato yā kliṣṭā prajñā || 63 ||	དེ་ཉིད་ཀྱི་དབང་དུ་བྱས་ཏེ་། རྟག་པའམ་མཆད་པར་ལྟ་བའི་ཤེས་རབ་ཉོན་མོངས་པ་ཅན་གང་ཡིན་པའོ་༎
 mithyādṛṣṭiḥ katamā |	ལོག་པར་ལྟ་བ་གང་ཞེ་ན་། རྒྱུ་༄༡༤ཨ་༌་༎
 hetuṃ vā phalaṃ vā kriyāṃ vāpavadataḥ sadāvastu vināśayato yā kliṣṭā prajñā || 64 ||	འམ་འབྲས་བུའམ་། བྱེད་པ་ལ་སྐུར་བ་འདེབས་པ་དང་། ཡོད་པའི་དངོས་པོ་ལ་འཇིག་པའི་ཤེས་རབ་ཉོན་མོངས་པ་ཅན་གང་ཡིན་པའོ་༎
 dṛṣṭiparāmarśaḥ katamaḥ |	ལྟ་བ་མཆོག་ཏུ་འཛིན་པ་གང་ཞེ་ན་།
 tā eva tikhro dṛṣṭistadāśrayāṃśca skandhān śreṣṭhataḥ paramataśca paśyato yā kliṣṭā prajñā || 65 ||	ལྟ་བ་རྣམ་པ་གསུམ་པོ་དེ་དག་ཉིད་དང་། དེའི་གནས་ཕུང་པོ་རྣམས་ལ་མཆོག་དང་གཙོ་བོ་དང་ཁྱད་པར་དུ་འཕགས་པ་དང་། དམ་པར་ལྟ་བའི་ཤེས་རབ་ཉོན་མོངས་པ་ཅན་གང་ཡིན་པའོ་༎
 śīlabrataparāmarśaḥ katamaḥ |	ཚུལ་ཁྲིམས་དང་བརྟུལ་ཞུགས་མཆོག་ཏུ་འཛིན་པ་གང་ཞེ་ན་།
 śīlaṃ vrataṃ tadāśrayāṃśca skandhānaśuddhito muktito naiyāṇikataśca paśyato yā kliṣṭā prajñā || 66 ||	ཚུལ་ཁྲིམས་དང་བརྟུལ་ཞུགས་དང་། དེའི་གནས་ཕུང་པོ་རྣམས་ལ་དག་པ་དང་གྲོལ་བ་དང་ངེས་པར་འབྱིན་པར་ལྟ་བའི་ཤེས་རབ་ཉོན་མོངས་པ་ཅན་གང་ཡིན་པའོ་༎
 vicikitsā katamā |	ཐེ་ཚོམ་གང་ཞེ་ན་།
 satyādiṣu yā dvikoṭikā matiḥ || 67 ||	བདེན་པ་ལ་སོགས་པ་ལ་གང་ཡིད་གཉིས་ཟ་བའོ་༎
 eteṣāṃ kleśānāṃ paścimāstistro dṛṣṭayaḥ vīcikitsā ca parikalpitāḥ |	ཉོན་མོངས་བ་དེ་དག་ལས་ལྟ་བ་འོག་མ་གསུམ་དང་། ཐེ་ཚོམ་ནི་ཀུན་ཏུ་བརྟགས་པའོ་།
 śiṣṭāḥ sahajāḥ parikalpitāśca || 68 ||	ལྷག་མ་ནི་ལྷན་ཅིག་སྐྱེས་པ་དང་ཀུན་ཏུ་བརྟགས་པའོ་༎
 krodhaḥ katamaḥ |	ཁྲོ་བ་གང་ཞེ་ན་། འཕྲལ་དུ་གནོད་པ་བྱེད་པ་ལ་གནས་ཏེ་།
 vartaṃmānamapakāramāgamya yā cetasa āghātacetanā || 69 ||	གང་སེམས་ཀྱི་ཀུན་ནས་མནར་སེམས་པའོ་༎
 upanāhaḥ katamaḥ |	ཁོན་དུ་འཛིན་པ་གང་ཞེ་ན་།
 vairānubandha || 70 ||	མདུད་བར་འཛིན་པའོ་༎
 mrakṣaḥ katamaḥ ātmano 'vaddhapracchādanā || 71 ||	འཆབ་པ་གང་ཞེ་ན་། བདག་གི་ཁ་ན་མ་ཐོ་བ་མཁྱུད་པའོ་༎ འཚིག་པ་གང་ཞེ་ན་།
 pradāśaḥ katamaḥ caṇḍavacodāśitā || 72 ||	ཚིག་བརླང་པོས་ཞེར་འདེབས་པ་ཉིད་དོ་༎
 īrṣyā katamā parasaṃpattau cetaso vyāropa || 73 ||	ཕྲག་དོག་གང་ཞེ་ན་། གཞན་གྱི་ཕུན་སུམ་ཚོགས་པ་ལ་སེམས་ཁོང་ནས་འཁྲུག་པའོ་༎
 mātsarya katamat |	སེར་སྣ་གང་ཞེ་ན་།
 dānavirodhī cetasa āgrahaḥ || 74 ||	སྦྱིན་པ་དང་མི་མཐུན་པའི་སེམས་ཀྱིས་ཀུན་ཏུ་འཛིན་པའོ་༎
 māyā katamā |	སྒྱུ་གང་ཞེ་ན་།
 paravaścanābhūtārthasadarśanatā || 75 ||	གཞན་སླུ་བ་ཡང་དག་པ་མ་ཡིན་པའི་དོན་སྟོན་པའོ་༎
 śāṭhyaṃ katamat |	ག-ཡོ་གང་ཞེ་ན་།
 svadoṣapracchādanopāyasaṃgṛhitaṃ cetasaḥ kauṭilyam || 76 ||	བདག་གི་ཉེས་པ་བཅབ་པའི་ཐབས་གཟུང་སྟེ་སེམས་གྱ་གྱུ་བའོ་༎
 madaḥ katamaḥ |	རྒྱགས་པ་གང་ཞེ་ན་།
 svasaṃpattau raktasyoddharṣaḥ | cetasaḥ paryādānam || 77 ||	བདག་གི་ཕུན་སུམ་ཚོགས་པ་ལ་ཆགས་པའི་རབ་ཏུ་དགའ་བ་དེ་སེམས་ཡོངས་སུ་འཛིན་པའོ་།
 vihiṃsā katamā |	རྣམ་པར་འཚེ་བ་གང་ཞེ་ན་།
 satveṣu viheṭhanā || 78 ||	སེམས་ཅན་རྣམས་ལ་རྣམ་པར་ཐོ་འཚམས་པའོ་༎
 āhrīkyaṃ katamat |	ངོ་ཚ་མེད་པ་གང་ཞེ་ན་།
 avadyena svayamalajjā || 79 ||	ཁ་ན་མ་ཐོ་བས་བདག་ལ་མི་འཛེམ་པའོ་༎
 anapatrāp katamat |	ཁྲེལ་མེད་པ་གང་ཞེ་ན་།
 avadyena parato 'lajjā || 80	ཁ་ན་མ་ཐོ་བས་གཞན་ལ་མི་འཛེམ་པའོ་༎
 satyānaṃ katamat |	རྨུགས་པ་གང་ཞེ་ན་།
 cittākarmaṇyatā | staimityam || 81 ||	སེམས་ལས་སུ་མི་རུང་བ་སྟེ་བླང་བ་ཉིད་དོ་༎
 auddhatyaṃ katamat |	༄༡༤བ་རྒོད་པ་གང་ཞེ་ན་།
 cittasyāvyupasamaḥ || 82 ||	སེམས་རྣམ་པར་མ་ཞི་བའོ་༎
 āśraddhyaṃ katamat |	མ་དད་པ་གང་ཞེ་ན་།
 karmaphalasatyaratneṣvanabhisaṃpratyayaḥ |	ལས་དང་འབྲས་བུ་དང་བདེན་པ་དང་། དཀོན་མཆོག་རྣམས་ལ་ཡིད་མི་ཆེས་པ་དང་། སེམས་མ་དད་པ་སྟེ་།
 śraddhāvipakṣaścetaso 'prasādaḥ || 83 ||	དད་པའི་མི་མཐུན་པའི་ཕྱོགས་སོ་༎
 kauśiddyaṃ katamatṃḥ kuśale cetaso 'nabhyutsāho vīryavipakṣa || 84 ||	ལེ་ལོ་གང་ཞེ་ན་། དགེ་བ་ལ་སེམས་མངོན་པར་སྤྲོ་བ་མེད་པ་སྟེ་། བརྩོན་འགྲུས་ཀྱི་མི་མཐུན་པའི་ཕྱོགས་སོ་༎
 pramādaḥ katamaḥ |	བག་མེད་པ་གང་ཞེ་ན་།
 yā lobhadveṣamohekauśīddyaiścitasyānārakṣā kuśalasyābhāvanā || 85 ||	ཆགས་པ་དང་། ཞེ་སྡང་དང་། གཏི་མུག་དང་། ལེ་ལོ་གང་ཡིན་པ་དག་གིས་ཉོན་མོངས་པ་ལས་སེམས་མི་སྲུང་བ་དང་དགེ་བ་མི་བསྒོམ་པའོ་༎ 
 muṣitāsmṛtiḥ katamā |	བརྗེད་ངས་པ་གང་ཞེ་ན་།
 kliṣṭāsmṛtiḥ |	དྲན་པ་ཉོན་མོངས་ཅན་ཏེ་།
 kuśalāpratipatiḥ || 86 ||	དགེ་བ་ལ་མི་གསལ་བའོ་༎
 vikṣepaḥ katamaḥ |	རྣམ་པར་ག-ཡེང་བ་གང་ཞེ་ན་།
 rāgadveṣamohāṃśikaḥ pañcakāmaguṇeṣu cittasya visāraḥ || 87 ||	འདོད་ཆགས་དང་ཞེ་སྡང་དང་གཏི་མུག་གི་ཆ་ཤས་ཀྱིས་འདོད་པའི་ཡོན་ཏན་ལྔ་པོ་དག་ལ་གང་སེམས་རྣམ་པར་འཕྲོ་བའོ་༎
 aprasajanyaṃ katamat kleśasaṃprayuktā prajñā |	ཤེས་བཞིན་མ་ཡིན་པ་གང་ཞེ་ན་། ཉོན་མོངས་པ་དང་མཚུངས་པར་ལྡན་པའི་ཤེས་རབ་སྟེ་།
 tayā kāyavākcittacaryā asaṃviditeva pravartate || 88 ||	དེས་ལུས་དང་ངག་དང་ཡིད་ཀྱི་སྤྱོད་པ་ལ་མི་ཤེས་བཞིན་དུ་འཇུག་པའོ་༎
 kaukṛtyaṃ katamat |	འགྱོད་པ་གང་ཞེ་ན་།
 cetaso vipratisāraḥ || 89 ||	ཡིད་ལ་གཅགས་པའོ་༎
 middhaṃ katamat |	གཉིད་གང་ཞེ་ན་།
 asvataṃtravṛtticetaso 'bhisaṃkṣepaḥ || 90 ||	འཇུག་པ་རང་དབང་མེད་པར་སེམས་སྡུད་པའོ་༎
 vitarkaḥ katamaḥ paryeṣako manojalpaḥ cetanāprajñāviśeṣaḥ yā cittasyaudārikatā || 91 ||	རྟོག་པ་གང་ཞེ་ན་། ཀུན་ཏུ་ཚོལ་བའི་ཡིད་ཀྱིས་བརྗོད་པ་སྟེ་། སེམས་པ་དང་ཤེས་རབ་ཀྱི་བྱེ་བྲག་གང་སེམས་རྩིང་པའོ་༎
 vicāraḥ katamaḥ |	དཔྱོད་པ་གང་ཞེ་ན་།
 paryeṣako manojalpaḥ tathaiva yā cittasya sūkṣmatā || 92 || || ittaviprayuktaparisaṃkhyānam ||	སོ་སོར་རྟོག་པའི་ཡིད་ཀྱིས་བརྗོད་པ་སྟེ་། དེ་བཞིན་དུ་གང་སེམས་ཞིབ་པའོ་༎
 cittaviprayuttasaṃskārāḥ katame |	སེམས་དང་མི་ལྡན་པའི་འདུ་བྱེད་རྣམས་གང་ཞེ་ན་།
 ye rūpacitacaittadhikāre prajñaptāḥ, ta evānyatrāprajñaptāḥ || 93 ||	གང་དག་གཟུགས་དང་སེམས་ལས་བྱུང་བའི་གནས་སྐབས་ལ་གདགས་པ་སྟེ་དེ་ཉིད་དང་གཞན་དུ་མི་གདགས་སོ་༎ 
 te katame | prāpti, asaṃjñisamāpattiḥ, nirodhasamāpattiḥ,	དེ་དག་ཀྱང་གང་ཞེ་ན་།
 āsaṃjñikam, jīvitendriyam, nikāyasabhāgatā, jāti, jarā, sthitiḥ, anityatā, nāmakāyaḥ, padakāyaḥ, vyañjanakāyaḥ, pṛthagjanatvamityevamādibhedasamādānāḥ || 94 || ittaviprayuktalakṣaṇāni ||	ཐོབ་པ་དང་། འདུ་ཤེས་མེད་པའི་སྙོམས་པར་འཇུག་པ་དང་། འགོག་པའི་སྙོམས་པར་འཇུག་པ་དང་། འདུ་ཤེས་མེད་པ་དང་། སྲོག་གི་དབང་པོ་དང་། རིས་མཐུན་པ་དང་། སྐྱེ་བ་དང་། གནས་པ་དང་། མི་རྟག་པ་ཉིད་དང་། མིང་གི་ཚོགས་དང་། ཚིག་གི་ཚོགས་དང་། ཡི་གེའི་ཚོགས་དང་། སོ་སོའི་སྐྱེ་བོ་ཉིད་དང་། དེ་ལྟ་བུའི་ཆ་དང་མཐུན་པ་དག་གོ་༎
 tatra prāptiḥ katamā |	དེ་ལ་ཐོབ་པ་གང་ཞེ་ན་།
 pratilambhaḥ samanvāgamaśca |	རྙེད་པ་དང་ལྡན་པའོ་༎
 bījam, vaśitā, abhimukhībhāvaśca yathāyogam || 95 ||	དེ་ཡང་ས་བོན་དང་། ༄༡༥ཨ་༌་༎ དབང་དང་། མངོན་དུ་གྱུར་པ་དང་ཅི་རིགས་སུ་སྦྱར་རོ་༎
 asaṃjñisamāpattiḥ katamṃ |	འདུ་ཤེས་མེད་པའི་སྙོམས་པར་འཇུག་པ་གང་ཞེ་ན་།
 śubhakṛtsnavītarāgasyoparyavītarāgasya niḥsaraṇasaṃjñāpūrvakeṇa manasikāreṇāvasthāvarāṇāṃ cittacaittadharmāṇāṃ yo nirodhaḥ || 96 ||	དགེ་རྒྱས་ཀྱི་འདོད་ཆགས་དང་བྲལ་ལ་། གོང་མའི་མ་ཡིན་པ་འབྱུང་བའི་འདུ་ཤེས་མངོན་དུ་བཏང་བའི་འདུ་ཤེས་ཡིད་ལ་བྱེད་པས་སེམས་དང་སེམས་ལས་བྱུང་བའི་ཆོས་བརྟན་པ་མ་ཡིན་པ་རྣམས་འགོག་པ་གང་ཡིན་པའོ་༎
 nirodhasamāpattiḥ katamā |	འགོག་པའི་སྙོམས་པར་འཇུག་པ་གང་ཞེ་ན་།
 ākiñcanyāyatanabītarāgasya bhavāgratāduccalitasya śāntavihāra - saṃjñāpūrvakeṇa manasikāreṇāsthāvarāṇāṃ cittacaittadharmāṇāṃ tadekatyānāṃ ca sthāvarāṇāṃ yo nirodhaḥ || 97 ||	ཅི་ཡང་མེད་པའི་སྐྱེ་མཆེད་ཀྱི་འདོད་ཆགས་དང་བྲལ་ལ་། སྲིད་པའི་རྩེ་མོ་ལས་གྱེན་དུ་བསྐྱོད་པའི་གནས་པར་འདུ་ཤེས་སྔོན་དུ་བཏང་བའི་ཡིད་ལ་བྱེད་པས་། སེམས་དང་སེམས་ལས་བྱུང་བའི་ཆོས་བརྟན་པ་མ་ཡིན་པ་རྣམས་དང་། བསྟན་པ་རྣམས་ལས་ཀྱང་ཁ་ཅིག་འགོག་པ་གང་ཡིན་པའོ་༎
 āsaṃjñikaṃ katamat |	འདུ་ཤེས་མེད་པ་གང་ཞེ་ན་།
 asaṃjñisatvanikāyadeveṣupapannasyāsthāvarāṇāṃ cittacaittadharmāṇāṃ nirodhaḥ || 98 ||	འདུ་ཤེས་མེད་པའི་སྙོམས་པར་འཇུག་པའི་འབྲས་བུ་སྟེ་། འདུ་ཤེས་མེད་པའི་སེམས་ཅན་གྱི་ཁྲོད་ཀྱི་ལྷ་རྣམས་ཀྱི་ནང་དུ་བསྐྱེད་པའི་སེམས་དང་། སེམས་ལས་བྱུང་བའི་ཆོས་བརྟན་པ་མ་ཡིན་པ་རྣམས་དང་འགོག་པའོ་༎
 jīvitendriyam katamat |	སྲོག་གི་དབང་པོ་གང་ཞེ་ན་།
 nikāyasabhāgeṣu pūrvakarmānuviddhyeṣu yaḥ saṃskārāṇāṃ sthitikālaniyamaḥ || 99 ||	རིས་མཐུན་པ་རྣམས་སུ་སྔོན་གྱི་ལས་ཀྱིས་འཕངས་པས་། གང་འདུ་བྱེད་རྣམས་ཀྱི་གནས་པའི་དུས་ངེས་པའོ་༎
 nikāyasabhāgaḥ katamaḥ |	རིས་མཐུན་པ་གང་ཞེ་ན་།
 yā satvānāmātmabhāvasadṛśatā || 100 ||	གང་སེམས་ཅན་རྣམས་ཀྱི་ལུས་འདྲ་བའོ་༎
 jātiḥkatamā |	སྐྱེ་བ་གང་ཞེ་ན་།
 nikāyasabhāge saṃskārāṇāmabhūtvā yo bhāṣaḥ || 101 ||	རིས་མཐུན་པར་འདུ་བྱེད་རྣམས་མ་བྱུང་བ་ལས་བྱུང་བ་གང་ཡིན་པའོ་༎
 jarā katamā |	རྒ་བ་གང་ཞེ་ན་།
 tathā teṣāṃ prabandhānyathātvam || 102 ||	དེ་ལྟར་དེ་དག་གི་རྒྱུན་གཞན་དུ་འགྱུར་བའོ་༎
 sthiti katamā |	གནས་པ་གང་ཞེ་ན་།
 tathā teṣāṃ prabandhanvayaḥ || 103 ||	དེ་ལྟར་དེ་དག་གི་རྒྱུན་རྒྱུད་ཆགས་པའོ་༎
 anityatā katamā |	མི་རྟག་པ་ཉིད་གང་ཞེ་ན་།
 tathā teṣāṃ prabandhavināśaḥ || 104 ||	དེ་ལྟར་དེ་དག་གི་རྒྱུན་ཆད་པའོ་༎
 nāmakāyaḥ katamaḥ |	མིང་གི་ཚོགས་གང་ཞེ་ན་།
 dharmāṇāṃ svabhāvādhivacanam || 105 ||	ཆོས་རྣམས་ཀྱི་ངོ་བོ་ཉིད་ཀྱི་ཚིག་བླ་དགས་སོ་༎
 pādakāyaḥ katamaḥ |	ཚིག་གི་ཚོགས་གང་ཞེ་ན་།
 dharmāṇāṃ viśeṣādhivacanam || 106 ||	ཆོས་རྣམས་ཀྱི་ཁྱད་པར་གྱི་ཚིག་བླ་དགས་སོ་༎
 vyañjanakāyaḥ katamaḥ | akṣarāṇi |	ཡི་གེའི་ཚོགས་གང་ཞེ་ན་། ཡི་གེའི་རྣམས་ཏེ་།
 tadubhayābhivyañjanatāmupādāya || 107 ||	དེ་གཉིས་ཀ་གསལ་བར་བྱེད་པའི་ཕྱིར་རོ་༎
 vākyāni tāni |	བརྗོད་པ་ཡང་དེ་དག་ཡིན་ཏེ་།
 nāmapadāśreyeṇārthavacanatāmupādāya || 108 ||	མིང་དང་ཚིག་ལ་བརྟེན་ནས་དོན་བརྗོད་པའི་ཕྱིར་རོ་༎
 akṣaraṃ punaḥ paryāyākṣaraṇatāmupādāya || 109 ||	ཡི་གེ་ཡང་རྣམ་གྲངས་གཞན་དུ་མི་འགྱུར་བའི་ཕྱིར་རོ་༎
 pṛthagjanatvaṃ katamat |	སོ་སོའི་སྐྱེ་བོ་ཉིད་གང་༄༡༥བ་ཞེ་ན་།
 āryadharmāṇāmapratilambhaḥ || 110 ||	འཕགས་པའི་ཆོས་རྣམས་མ་ཐོབ་པའོ་༎
 iti saṃskāraskandho nāma || saṃskāraskandhaḥ soddyeśanirdeśaḥ pariniṣṭhitaḥ || 111 || || vijñānalakṣaṇam ||	འདི་ནི་འདུ་བྱེད་ཀྱི་ཕུང་པོ་ཞེས་བྱའོ་༎
 vijñānaṃ katamat |	རྣམ་པར་ཤེས་པ་གང་ཞེ་ན་།
 ālambanaṃbijñaptiḥ || 112 ||	དམིགས་པ་རྣམ་པར་རིག་པའོ་༎
 cittamanasī vijñānaparyāyau sanirvacano taccitaṃ mano 'pi citrīkāratā manoniśrayatāṃ ca upādāya || 113 || || salakṣaṇacittanirdeśaḥ ||	སེམས་དང་ཡིད་ཀྱང་དེ་ཡིན་ཏེ་༎ སྣ་ཚོགས་པ་དང་ཡིད་རྟེན་བྱེད་པའི་ཕྱིར་རོ་།
 mūlacittamālayavijñānaṃ tadyathedaṃ sarvasaṃskārāṇāṃ saṃcitaṃ bījam || 114 ||	དངོས་སུ་ན་སེམས་ནི་ཀུན་གཞི་རྣམ་པར་ཤེས་པ་སྟེ་། འདི་ལྟར་དེ་ནི་འདུ་བྱེད་ཐམས་ཅད་ཀྱི་ས་བོན་བསགས་པའོ་༎
 tatpunarālambanamapyuparichinnamekasantānavarti |	དེ་ཡང་དམིགས་པ་དང་རྣམ་པ་ཡོངས་སུ་མ་ཆད་པའོ་༎
 yathā nirodhasamāpatyasaṃjñisamāpatyā - saṃjñikebhyovyutthitasyāsmād viṣayavijñaptikaṃ nāma pravṛtti vijñānaṃ jāyate |	རིགས་གཅིག་པ་དང་། རྒྱུན་ཆགས་པར་འཇུག་པའོ་༎ འདི་ལྟར་འགོག་པའི་སྙོམས་པར་འཇུག་པ་དང་། འདུ་ཤེས་མེད་པའི་སྙོམས་བར་འཇུག་པ་དང་། པ་རྣམས་ལངས་ནས་ཡང་ཡུལ་རྣམ་པར་རིག་པ་ཞེས་བྱ་བ་འཇུག་པའི་རྣམ་པར་ཤེས་པ་འབྱུང་བ་དང་། 
 ālambanapratyayamapekṣya bhinnākāreṣu vṛttitāmucchiddya punarjātatāṃ saṃsāre pravṛttinivṛtitāṃ copādāya tadālambanaṃ nāma vijñānam || 115 ||	དམིགས་པའི་རྐྱེན་ལ་ལྟོས་ནས་རྣམ་པ་གཞན་དུ་འཇུག་པ་ཉིད་དང་། ཆད་ནས་ཡང་འབྱུང་བ་ཉིད་དང་། འཁོར་བར་འཇུག་པ་དང་། ལྡོག་པའི་ཕྱིར་རོ་༎
 ālayavijñānaṃ hi sarvabījālayatāmātmabhāvālayahetutāmātmabhāve sthititāṃ copādāya || 116 ||	ཀུན་གཞི་རྣམ་པར་ཤེས་པ་དེ་ཉིད་ནི་ས་བོན་ཐམས་ཅད་ཀྱི་གཞི་ཉིད་དང་། ལུས་ཀྱི་ཀུན་གཞི་དང་། རྒྱུ་ཉིད་དང་། ལུས་ལ་གནས་པ་ཉིད་ཀྱི་ཡང་ཕྱིར་རོ་༎
 ādānavijñānamapi tat |	ལེན་པའི་རྣམ་པར་ཤེས་པ་ཡང་དེ་ཡིན་ཏེ་།
 ātmabhāvādānatāmupādāya || 117 || || salakṣaṇamanonirdeśaḥ ||	ལུས་ལེན་པའི་ཕྱིར་རོ་༎
 mūlamana ālayavijñānamāśritya nityamātmamohātmadṛṣṭyātmamānātmasnehaiḥ saṃprayuktaṃ vijñānamekajātīyasantānavarti arhatvāryamārganirodhasamāpattikāle vyāvartate || 118 || vijñānaskandhaḥ soniddeśanirdeśaḥ pariniṣṭhitaḥ || || skandhanirvacanam ||	དངོས་སུ་ནི་ཡིད་ནི་ཀུན་གཞི་རྣམ་པར་ཤེས་པ་ལ་དམིགས་ཏེ་། རྟག་ཏུ་བདག་ཏུ་རྨོངས་པ་དང་༎ བདག་ཏུ་ལྟ་བ་དང་། བདག་ཏུ་ང་རྒྱལ་དང་། བདག་ལ་ཆགས་པ་ལ་སོགས་པ་དང་མཚུངས་པར་ལྡན་པའི་རྣམ་པར་ཤེས་པ་སྟེ་། རིགས་གཅིག་པ་དང་། རྒྱུན་ཆགས་པར་འཇུག་པ་སྟེ་། དགྲ་བཅོམ་པ་དང་། འཕགས་པའི་ལམ་དང་། འགོག་པའི་སྙོམས་པར་འཇུག་པའི་དུས་མ་གཏོགས་སོ་།
 kimarthaḥ skandhaḥ rāśyarthaḥ |	ཅིའི་ཕྱིར་ཕུང་པོ་ཞེས་བྱ་ཞེ་ན་།
 kālagotrākāragativiṣayabhinnānāṃ rūpādīnāmabhisaṃkṣepatāmupādāya || 119 || skandhoddyeśanirdeśakaḥ prathamādhikāraḥ pariniṣṭhitaḥ || dvitīyādhikāraḥ āyatanoddyeśanirdeśakaḥ dvādaśāyatanāni | cakṣurāyatanam,	སྤུངས་པའི་ཕྱིར་ཏེ་དུས་དང་རྒྱུད་དང་རྣམ་པ་དང་གྲོལ་བ་དང་། ཡུལ་ཐ་དད་པའི་གཟུགས་ལ་སོགས་པ་མདོར་བསྡུས་པ་ཉིད་ཀྱི་ཕྱིར་རོ་༎
 rūpāyatanam, śrotrāyatanam, śabdāyatanam, ghrāṇāyatanam, gandhāyatanam, jihvāyatanam, rasāyatanam,	སྐྱེ་མཆེད་བཅུ་གཉིས་ནི་མིག་གི་སྐྱེ་མཆེད་དང་། གཟུགས་ཀྱི་སྐྱེ་མཆེད་དང་། རྣ་བའི་སྐྱ་མཆེད་དང་། སྒྲའི་སྐྱེ་མཆེད་དང་། སྣའི་སྐྱེ་མཆེད་དང་། དྲིའི་སྐྱེ་མཆེད་དང་། ལྕེའི་སྐྱེ་མཆེད་དང་། རོའི་སྐྱེ་༄༡༦ཨ་༌་༎
 kāyāyatanam, spraṣṭavyāyatanam, mana āyatanam,	མཆེད་དང་། ལུས་ཀྱི་སྐྱེ་མཆེད་དང་། རེག་བྱའི་སྐྱེ་མཆེད་དང་། ཡིད་ཀྱི་སྐྱེ་མཆེད་དང་། ཆོས་ཀྱི་སྐྱེ་མཆེད་དོ་༎
 dharmāyatanaṃ ca || 120 || | 'ayatanānāṃ salakṣaṇaprapañcaḥ || cakṣurādīni rūpaśabdagandharasāyatanāni yathoktapūrvāṇi || 121 ||	མིག་ལ་སོགས་བ་དང་། གཟུགས་དང་སྒྲ་དང་དྲི་དང་རོའི་སྐྱེ་མཆེད་ལ་སོགས་པ་ཡང་སྔ་མ་བཞིན་དུ་བཤད་དོ་༎
 spraṣṭavyāyatanaṃ catvāri mahābhūtāni uktaśca yaḥ spraṣṭabyaikadeśaḥ || 122 ||	རེག་བྱའི་སྐྱེ་མཆེད་ནི་འབྱུང་བ་ཆེན་པོ་བཞི་དག་དང་། གང་རེག་བྱའི་ཕྱོགས་གཅིག་བཤད་པའོ་༎
 mana āyatanaṃ yo vijñānaskandhaḥ || 123 ||	ཡིད་ཀྱི་སྐྱེ་མཆེད་ནི་རྣམ་པར་ཤེས་པའི་ཕུང་པོ་གང་ཡིན་པའོ་༎
 dharmāyatanaṃ vedanā, saṃjñā, saṃskārāḥ, avijñaptiḥ,	ཆོས་ཀྱི་སྐྱེ་མཆེད་ནི་གང་ཚོར་བ་དང་། འདུ་ཤེས་དང་། འདུ་བྱེད་རྣམས་དང་། རྣམ་པར་རིག་བྱེད་མ་ཡིན་པ་དང་། འདུས་མ་བྱས་སོ་༎
 asaṃskṛtāśca || 124 || | 'saṃskṛtāḥ salakṣaṇaprabhedāḥ ||	འདུས་མ་བྱས་གང་ཞེ་ན་།
 asaṃskṛtā katame | ākāśam, apratisaṃkhyānirodhaḥ, pratisaṃkhyānirodhaḥ tathatā ca || 125 ||	ནམ་མཁའ་དང་། སོ་སོར་བརྟགས་པ་མ་ཡིན་པའི་འགོག་པ་དང་། སོ་སོར་བརྟགས་པའི་འགོག་པ་དང་། དེ་བཞིན་ཉིད་དོ་༎
 tatrākāśaṃ katamat |	དེ་ལ་ནམ་མཁའ་གང་ཞེ་ན་།
 rūpāvakāśaḥ || 126 ||	གཟུགས་ཀྱི་གོ་འབྱེད་པའོ་༎
 apratisaṃkhyānirodhaḥ katamaḥ |	སོ་སོར་བརྟགས་པ་མ་ཡིན་པའི་འགོག་པ་གང་ཞེ་ན་།
 yo nirodho na visaṃyogaḥ || 127 ||	གང་འགོག་པ་ལ་བྲལ་བ་མ་ཡིན་པ་སྟེ་།
 sakleśāpratipakṣeṇa skandhānāmātyantiko nirodhaḥ || 128 ||	དེ་ནི་ཉོན་མོངས་པའི་གཉེན་པོ་མེད་པར་ཕུང་པོ་རྣམས་གཏན་དུ་མི་སྐྱེ་བའོ་༎
 pratisaṃkhyānirodhaḥ katamaḥ |	སོ་སོར་བརྟགས་པའི་འགོག་པ་གང་ཞེ་ན་།
 yo nirodho visaṃyogaḥ || 129 ||	གང་འགོག་པ་དེ་ནི་བྲལ་བ་སྟེ་།
 sakleśapratipakṣeṇa skandhānāmātyantiko nirodhaḥ || 130 ||	དེ་ནི་གང་ཉོན་མོངས་པའི་གཉེན་པོས་ཕུང་པོ་རྣམས་གཏན་དུ་མི་སྐྱེ་བའོ་།
 tathatā katamā |	དེ་བཞིན་ཉིད་གང་ཞེ་ན་།
 yā dharmāṇāṃ dharmatā | dharmanairātmyam || 131 || | 'ayatananirvacanam ||	གང་ཆོས་རྣམས་ཀྱི་ཆོས་ཉིད་དང་། ཆོས་བདག་མེད་པ་ཉིད་དོ་༎
 kimupādāyāyatanamiti |	ཅིའི་ཕྱིར་སྐྱེ་མཆེད་ཅེས་བྱ་ཞེ་ན་།
 vijñānotpādadvāratāmupādāya || 132 || āyatanoddyeśanirdeśako dvitīyādhikāraḥ pariniṣṭhitaḥ | tṛtīyādhikāraḥ dhātūddeśanirdeśakaḥ || dhātunāmāni || aṣṭadaśa dhātavaḥ | cakṣurdhātuḥ, rūpadhātuḥ,	རྣམ་པར་ཤེས་པ་སྐྱེ་བའི་སྒོའི་ཕྱིར་རོ་༎
 cakṣurvijñānadhātu, śrotradhātuḥ, śabdadhātuḥ, śrotravijñānadhātuḥ, ghrāṇadhātuḥ, gandhadhātuḥ, ghrāṇavijñānadhātuḥ, jihvādhātuḥ, rasadhātuḥ, jihvāvijñānadhātuḥ, kāyadhātuḥ, spraṣṭavyadhātuḥ, kāyabijñānadhātuḥ, manodhātuḥ, dharmadhātuḥ,	ཁམས་བཅོ་བརྒྱད་ནི་མིག་གི་ཁམས་དང་། གཟུགས་ཀྱི་ཁམས་དང་། མིག་གི་རྣམ་པར་ཤེས་པའི་ཁམས་དང་། རྣ་བའི་ཁམས་དང་། སྒྲའི་ཁམས་དང་། རྣ་བའི་རྣམ་པར་ཤེས་པའི་ཁམས་དང་། སྣའི་ཁམས་དང་། དྲིའི་ཁམས་དང་། སྣའི་རྣམ་པར་ཤེས་པའི་ཁམས་དང་། ལྕེའི་ཁམས་དང་། རོའི་ཁམས་དང་། ལྕེའི་རྣམ་པར་ཤེས་པའི་ཁམས་དང་། ལུས་ཀྱི་ཁམས་དང་། རེག་བྱའི་ཁམས་དང་། ལུས་ཀྱི་རྣམ་པར་ཤེས་པའི་ཁམས་དང་། ཡིད་ཀྱི་ཁམས་དང་། ཆོས་ཀྱི་ཁམས་དང་། ཡིད་ཀྱི་རྣམ་པར་ཤེས་པའི་ཁམས་སོ་༎
 manovijñānadhātuśca || 133 || || dhātuprapaścaḥ || cakṣurādayo dhātavo rūpādayo dhātavaśca yathāyatanāni || 134 ||	མིག་ལ་སོགས་༄༡༦བ་པའི་ཁམས་དང་། གཟུགས་ལ་སོགས་པའི་ཁམས་ནི་སྐྱེ་མཆེད་རྣམས་ཇི་ལྟ་བ་བཞིན་ནོ་༎
 ṣaḍvijñānadhātavaścakṣurāddyāśrayā rūpādyālambanāvijñaptayaḥ || 135 ||	རྣམ་པར་ཤེས་པའི་ཁམས་དྲུག་པོ་དག་ནི་མིག་ལ་སོགས་པ་རྣམས་ལ་བརྟེན་ཏེ་། གཟུགས་ལ་སོགས་པ་ལ་དམིགས་པ་རྣམ་པར་རིག་པའོ་༎
 manodhātusteṣāmeva samanantaranirudhyaṃ ṣaḍvijñānadeśanāśrayatāmupādāya || 136 || || dhātuvyavasthanam ||	ཡིད་ཀྱི་ཁམས་ནི་དེ་དག་ཉིད་འགགས་མ་ཐག་པ་སྟེ་། རྣམ་པར་ཤེས་པ་དྲུག་པའི་གནས་བརྟན་པའི་ཕྱིར་རོ་༎
 ebamaṣṭādaśadhātuvyavasthānam |	དེ་ལྟར་ན་ཁམས་བཅོ་བརྒྱད་དུ་རྣམ་པར་གཞག་གོ་༎
 yo rūpaskandhastāni daśāyatanadhātavaḥ || 137 || dharmāyatanaṃ dharmadhātvekadeśaḥ || 138 ||	གཟུགས་ཀྱི་ཕུང་པོ་གང་ཡིན་བ་དེ་ནི་སྐྱེ་མཆེད་དང་། ཁམས་བཅུ་དང་། ཆོས་ཀྱི་སྐྱེ་མཆེད་དང་། ཁམས་ཀྱི་ཕྱོགས་གཅིག་གོ་༎
 yo vijñānaskandhastanmana āyatanam, saptama manodhātavaśca || 139 ||	རྣམ་པར་ཤེས་པའི་ཕུང་པོ་གང་ཡིན་པ་དེ་ནི་ཡིད་ཀྱི་སྐྱེ་མཆེད་དང་། སེམས་ཀྱི་ཁམས་བདུན་ནོ་༎
 anye ye trayaḥ skandhā rūpadhātvekadeśaśca, te 'saṃskṛtai sahitā dharmāyatanaṃ dharmadhātuśca || 140 || || dhātunirvacanam ||	གཞན་ཕུང་པོ་གསུམ་པོ་གང་ཡིན་པ་དག་དང་། གཟུགས་ཀྱི་ཕུང་པོའི་ཕྱོགས་གཅིག་པོ་དེ་དང་། འདུས་མ་བྱས་དང་བཅས་པ་ནི་ཆོས་ཀྱི་སྐྱེ་མཆེད་དང་། ཆོས་ཀྱི་ཁམས་སོ་༎
 kimupādāya dhātava iti |	ཅིའི་ཕྱིར་ཁམས་ཞེས་བྱ་ཞེ་ན་།
 ākārakātmalakṣaṇadhāraṇatāmupādāya || 141 || || skandhāyatanadhātukrameṇa dharmadeśanāyāḥ prayojanam ||	བྱེད་པ་མེད་ལ་རང་གི་མཚན་ཉིད་འཛིན་པའི་ཕྱིར་རོ་༎
 kimartha skandhādikrameṇa deśanā |	ཅིའི་ཕྱིར་ཕུང་པོ་ལ་སོགས་པ་བཤད་ཅེ་ན་།
 trividhātmagrāhapratipakṣeṇāyaṃ kramaḥ || 142 ||	བདག་ཏུ་འཛིན་པ་རྣམ་པ་གསུམ་གྱི་གཉེན་པོ་གོ་རིམས་བཞིན་ནོ་༎
 ātmagrāhastrividhaḥ ekātmagrāhaḥ, vedakātmagrāhaḥ, kārakātmagrāhaśca || 143 ||	བདག་ཏུ་འཛིན་པ་རྣམ་པ་གསུམ་ནི་གཅིག་པུར་འཛིན་པ་དང་། ཟ་བར་འཛིན་པ་དང་། བྱེད་པར་འཛིན་པའོ་༎
 || 'ṣṭādaśadhātuvikalpāḥ || aṣṭādaśadhātuṣu kati rūpiṇaḥ |	ཁམས་བཅོ་བརྒྱད་ལ་གཟུགས་ཅན་དུ་ཞེ་ན་།
 ye rūpaskandhasvabhāvāḥ || 144 ||	གང་དག་གཟུགས་ཀྱི་ཕུང་པོའི་ངོ་བོ་ཉིད་དོ་༎
 katyarūpiṇaḥ | śiṣṭāḥ || 145 ||	གཟུགས་ཅན་མ་ཡིན་པ་དུ་ཞེ་ན་། ལྷག་མ་རྣམས་སོ་༎
 kati sanidarśanāḥ |	བརྟེན་དུ་ཡོད་པ་དུ་ཞེ་ན་།
 rūpadhāturekaḥ sanidarśanaviṣayaḥ || 146 ||	གཟུགས་ཀྱི་ཁམས་གཅིག་སྟེ་། ཡུལ་བསྟན་དུ་ཡོད་པའོ་༎
 katyanidarśanāḥ | śiṣṭāḥ || 147 ||	བསྟན་དུ་མེད་པ་ནི་དུ་ཞེ་ན་།
 kati sapratidhāḥ |	ལྷག་མ་རྣམས་སོ་༎ ཐོགས་པ་དང་བཅས་པ་དུ་ཞེ་ན་།
 daśa rūpiṇaḥ |	གཟུགས་ཅན་བཅུ་སྟེ་།
 yatra yatpratidhātastatra tat sapratigham || 148 ||	གང་ལ་གང་ཐོགས་པའོ་༎
 katyapratighāḥ | śiṣṭāḥ || 149 ||	ཐོགས་པ་མེད་པ་དུ་ཞེ་ན་།
 kati sāsravāḥ |	ལྷག་མ་རྣམས་སོ་། ཟག་པ་དང་བཅས་པ་དུ་ཞེ་ན་།
 pañcadaśa paścimānāṃ trayāṇāmekadeśaśca |	བཅོ་ལྔ་དང་ཐ་མ་གསུམ་གྱི་ཆའོ་༎
 te kleśotpādapratyakṣacaryāviṣayatāmupādāyaṃ || 150 || katyayanāstravāḥ |	དེ་དག་ཉོན་མོངས་པ་སྐྱེ་བའི་མངོན་སུམ་གྱི་སྤྱོད་ཡུལ་གྱི་ཕྱིར་རོ་༎ ཟག་པ་མེད་པ་དུ་ཞེ་ན་།
 paścimānāṃ trayāṇāmekadeśaḥ || 151 ||	ཐ་མ་གསུམ་གྱི་ཆའོ་༎
 kati kāmapratisaṃyuktāḥ | sarva || 152 ||	འདོད་པ་དང་རབ་ཏུ་ལྡན་པ་དུ་ཞེ་ན་། ཐམས་ཅད་དོ་༎
 kati rūpapratisaṃyuktāḥ |	གཟུགས་དང་རབ་ཏུ་ལྡན་པ་དུ་ཞེ་ན་།
 caturdaśa sthāpayitvā gandharasaghrāṇajihvāvijñānadhātūn || 153 ||	༄༡༧ཨ་༌་༎ བཅུ་བཞི་སྟེ་། དྲི་དང་། རོ་དང་། སྣ་དང་། ལྕེའི་རྣམ་པར་ཤེས་བ་མ་གཏོགས་པའོ་༎
 katyārūpyasaṃprayuktāḥ | paścimāśrayaḥ || 154 ||	གཟུགས་མེད་པ་དང་རབ་ཏུ་ལྡན་པ་དུ་ཞེ་ན་། ཐ་མ་གསུམ་མོ་༎
 katyapratisaṃyuktāḥ |	མི་ལྡན་བ་དུ་ཞེ་ན་།
 trayāṇāmekadeśaḥ || 155 ||	གསུམ་གྱི་ཆའོ་༎
 kati skandhasaṃgrahītāḥ |	ཕུང་པོར་བསྡུས་པ་དུ་ཞེ་ན་།
 asaṃskṛtān sthāpayitvā || 156 ||	འདུས་མ་བྱས་མ་གཏོགས་པའོ་༎
 katyupādānaskandhasaṃgṛhītāḥ ye sāsravāḥ || 157 ||	ཉེ་བར་ལེན་པའི་ཕུང་པོས་བསྡུས་པ་དུ་ཞེན་། གང་ཟག་པ་དང་བཅས་པ་རྣམས་སོ་༎ དགེ་བ་དུ་།
 kati kuśalākuśalāvyākṛtāḥ |	མི་དགེ་བ་དུ་། ལུང་དུ་མ་བསྟན་པ་དུ་ཞེ་ན་།
 daśa trividhāḥ |	བཅུ་ནི་རྣམ་པ་གསུམ་ཆར་ཏེ་༎
 sapta manodhātavaḥ, rūpaśabdadharmadhātavaśca |	སེམས་ཀྱི་ཁམས་བདུན་དང་། གཟུགས་དང་། སྒྲ་དང་། ཆོས་ཀྱི་ཁམས་སོ་༎
 śiṣṭā avyākṛtāḥ || 158 ||	ལྷག་མ་རྣམས་ནི་ལུང་དུ་མ་བསྟན་པའོ་༎
 katyādhyātmikāḥ |	ནང་གི་དུ་ཞེ་ན་།
 dvādaśa |	བཅུ་གཉིས་ཏེ་།
 sthāpayitvā rūpaśabda gandharasaspraṣṭāvyadharmadhātūn || 159 ||	གཟུགས་དང་། སྒྲ་དང་། དྲི་དང་། རོ་དང་། རེག་བྱ་དང་། ཆོས་ཀྱི་ཁམས་མ་གཏོགས་པའོ་༎
 kati bāhyāḥ |	ཕྱི་རོལ་གྱི་དུ་ཞེ་ན་།
 ṣaṭ |	དྲུག་སྟེ་།
 ye sthāpitāḥ || 160 ||	གང་དག་མ་གཏོགས་པ་རྣམས་སོ་༎
 kati sālambanāḥ |	དམིགས་པ་དང་བཅས་པ་དུ་ཞེ་ན་།
 saptacittadhātavaḥ dharmadhātvekadeśo 'pi yaścaittaḥ || 161 ||	སེམས་ཀྱི་ཁམས་བདུན་དང་། ཆོས་ཀྱི་ཕྱོགས་གཅིག་ཀྱང་ཡིན་ཏེ་། གང་སེམས་ལས་བྱུང་བའོ་༎
 katyanālambanāḥ |	དམིགས་པ་མེད་པ་དུ་ཞེ་ན་།
 śiṣṭā daśa dharmadhātvekadeśaśca || 162 ||	ལྷག་མ་བཅུ་དང་། ཆོས་ཀྱི་ཁམས་ཀྱི་ཕྱོགས་སོ་༎
 kati savitarkāḥ |	རྣམ་པར་རྟོག་པ་དང་བཅས་པ་དུ་ཞེ་ན་།
 manodhātuḥ manovijñānadhātuḥ dharmadhātvekadeśaśca || 163 ||	ཡིད་ཀྱི་ཁམས་དང་། ཡིད་ཀྱི་རྣམ་པར་ཤེས་པའི་ཁམས་དང་། ཆོས་ཀྱི་ཁམས་ཀྱི་ཕྱོགས་སོ་༎ རྟོག་པ་མེད་པ་དུ་ཞེ་ན་།
 kati niṣpannāḥ |	ལྷག་མ་རྣམས་སོ་༎ ཟིན་པ་དུ་ཞེ་ན་།
 pañcādhyātmikāḥ | caturṇāmekadeśaḥ || 164 ||	ནང་གི་ལྔ་དང་། བཞིའི་ཕྱོགས་ཏེ་། གཟུགས་དང་། སྒྲ་དང་། དྲི་དང་། རོ་དང་། རེག་བྱ་རྣམས་ཀྱིའོ་༎
 katyaniṣpannāḥ śiṣṭā daśa,	ཟིན་པ་མ་ཡིན་པ་དུ་ཞེ་ན་།
 caturṇāmekadeśaśca || 165 ||	བཞིའི་ཕྱོགས་སོ་༎
 kati sabhāgāḥ |	བསྟན་པ་མཚུངས་པ་དུ་ཞེ་ན་།
 ādhyātmikāḥ pañca rūpiṇaḥ |	ནང་གི་གཟུགས་ཅན་ལྔ་སྟེ་།
 svavijñānasahitaviṣayasadṛśatāmupādāya || 166 ||	རང་གི་རྣམ་པར་ཤེས་པ་དག་དང་ཡུལ་ཐུན་མོང་བ་ཉིད་ཀྱི་ཕྱིར་རོ་༎
 kati tatsabhāgāḥ |	དེ་དག་དང་མཚུངས་པ་དུ་ཞེ་ན་།
 ta eva svavijñānavirahitasvānvayasadṛśatāmupādāya || 167 ||	དེ་དག་ཉིད་རང་གི་རྣམ་པར་ཤེས་པས་སྟོང་པ་སྟེ་། རང་གི་རིགས་དང་མཐུན་པའི་ཕྱིར་རོ་༎
 dhātūddyeśanirdeśakastṛtīyādhikaraḥ pariniṣṭitaḥ | ācāryavasubandhuviracit pañcaskandhaprakaraṇaṃ samāptam | pañcaskandhaprakaraṇaṃ śāstriṇā śāntibhikṣuṇā | bhoṭānuvādamāgamya saṃskṛte punaruddhṛtam yadatra sukṛtaṃ sarva tadācāryasya dhīmataḥ |	ཕུང་པོ་ལྔའི་རབ་ཏུ་བྱེད་པ་སློབ་དཔོན་དབྱིག་གཉེན་གྱིས་མཛད་པ་རྫོགས་སོ་།
