skt	tib
 āryamaitreyapraṇītā madhyāntavibhāgakārikā (mvk) lakṣaṇaparicchedaḥ prathamaḥ	༄༤༠ཨ་༌༎ དབུས་དང་མཐའ་རྣམ་པར་འབྱེད་པའི་ཚིག་ལེའུར་བྱས་པ་བཞུགས་སོ་༎ ༄༤༠བ་༅་༎ རྒྱ་གར་སྐད་དུ་། མ་དྷཡའནཏ་བི་བྷམ་ག་ཀའ་རི་ཀའ་། བོད་སྐད་དུ་། དབུས་དང་མཐའ་རྣམ་པར་འབྱེད་པའི་ཚིག་ལེའུར་བྱས་པ་། འཇམ་དཔལ་གཞོན་ནུར་གྱུར་པ་ལ་ཕྱག་འཚལ་ལོ་༎
 lakṣaṇaṃ hyāvṛtistattvaṃ pratipakṣasya bhāvanā |	མཚན་ཉིད་སྒྲིབ་པ་དེ་ཁོ་ན་༎
 tatrāvasthā phalaprāptiryānānuttaryameva ca || mvk_1|1 ||	གཉེན་པོ་དག་ནི་བསྒོམ་པ་དང་༎ དེ་ཡི་གནས་དང་འབྲས་བུ་འཐོབ་༎ ཐེག་པ་བླ་ན་མེད་པའོ་༎
 abhūtaparikalpo 'sti dvayaṃ tatra na vidyate |	ཡང་དག་མ་ཡིན་ཀུན་རྟོག་ཡོད་༎ དེ་ལ་གཉིས་པོ་ཡོད་མ་ཡིན་༎
 śūnyatā vidyate tvatra tasyāmapi sa vidyate || mvk_1|2 ||	སྟོང་པ་ཉིད་ནི་འདི་ལ་ཡོད་༎ དེ་ལ་ཡང་ནི་དེ་ཡོད་དོ་༎
 na śūnyaṃ nāpi cāśūnyaṃ tasmāt sarvaṃ vidhīyate |	སྟོང་པ་མ་ཡིན་མི་སྟོང་མིན་༎ དེ་ལྟ་བས་ན་ཐམས་ཅད་བཤད་༎
 sattvādasattvāt sattvācca madhyamā pratipacca sā || mvk_1|3 ||	ཡོད་པས་མེད་པས་ཡོད་པས་ན་༎ དེ་ནི་དབུ་མའི་ལམ་ཡིན་ནོ་༎
 arthasattvātmavijñaptipratibhāsaṃ prajāyate |	།
 vijñānaṃ nāsti cāsyārthastadabhāvāttadapyasat || mvk_1|4 ||	རབ་ཏུ་སྐྱེའོ་དེའི་དོན་མེད་༎ དེ་མེད་པས་ན་དེ་ཡང་མེད་༎ ཡང་དག་མ་ཡིན་ཀུན་རྟོག་པ་༎
 abhūtaparikalpatvaṃ siddhamasya bhavatyataḥ |	དེ་ནི་དེ་ཕྱིར་གྲུབ་པ་ཡིན་༎
 na tathā sarvathābhāvāt tatkṣayānmuktiriṣyate || mvk_1|5 ||	དེ་བཞིན་མ་ཡིན་ཡེ་མེད་ཡིན་༎ དེ་ཟད་ནམ་ནི་གྲོལ་བར་འདོད་༎
 kalpitaḥ paratantraśca pariniṣpanna eva ca |	བརྟགས་པ་དག་ནི་གཞན་དབང་དང་༎ ཡོངས་སུ་གྲུབ་པ་ཉིད་ཀྱང་ངོ་༎
 arthādabhūtakalpācca dvayābhāvācca deśitaḥ || mvk_1|6 ||	དོན་ཕྱིར་ཡང་དག་མིན་རྟོག་ཕྱིར་༎ གཉིས་པོ་མེད་པའི་ཕྱིར་བཤད་དོ་༎
 upalabdhiṃ samāśritya nopalabdhiḥ prajāyate |	དམིགས་པ་ལ་ནི་བརྟེན་ནས་སུ་༎ མི་དམིགས་པ་ནི་རབ་ཏུ་སྐྱེ་༎
 nopalabdhiṃ samāśritya nopalabdhiḥ prajāyate || mvk_1|7 ||	མི་དམིགས་པ་ལ་བརྟེན་ནས་སུ་༎
 upalabdhestataḥ siddhā nopalabdhisvabhāvatā |	མི་དམིགས་པ་ནི་རབ་ཏུ་སྐྱེ་༎ དེ་ཡི་ཕྱིར་ན་དམིགས་པ་ནི་༎ མི་དམིགས་ངོ་བོ་ཉིད་དུ་གྲུབ་༎
 tasmācca samatā jñeyā nopalambhopalambhayoḥ || mvk_1|8 ||	དེ་ལྟ་བས་ན་དམིགས་པ་དང་༎ མི་དམིགས་མཉམ་པར་ཤེས་པར་བྱ་༎
 abhūtaparikalpaśca cittacaittāstridhātukāḥ |	ཡང་དག་མ་ཡིན་ཀུན་རྟོག་ནི་༎ སེམས་དང་སེམས་བྱུང་ཁམས་གསུམ་པ་༎
 tatrārthadṛṣṭirvijñānaṃ tadviśeṣe tu caitasāḥ || mvk_1|9 ||	དེ་ལ་དོན་མཐོང་རྣམ་པར་ཤེས་༎ དེ་ཡི་ཁྱད་པར་སེམས་ལས་བྱུང་༎
 evaṃ pratyayavijñānaṃ dvitīyaṃ caupabhogikam |	གཅིག་ནི་རྐྱེན་གྱི་རྣམ་པར་ཤེས་༎ གཉིས་པ་ཉེ་བར་སྤྱོད་པ་ཅན་༎
 upabhogaparicchedaprerakāstatra caitasāḥ || mvk_1|10 ||	ཉེ་བར་སྤྱོད་དང་ཡོངས་གཅོད་དང་༎ དེ་ཡི་འཇུག་བྱེད་སེམས་ལས་བྱུང་༎
 chādanādropaṇāccaiva nayanātsaṃparigrahāt |	སྒྲིབ་པའི་ཕྱིར་དང་འདེབས་པའི་ཕྱིར་༎ ཁྲིད་པའི་ཕྱིར་དང་ཀུན་འཛིན་ཕྱིར་༎
 pūraṇāt triparicchedādupabhogācca karṣaṇāt || mvk_1|11 ||	རྫོགས་བྱེད་ཕྱིར་དང་གསུམ་གཅོད་ཕྱིར་༎ ཉེ་བར་གཅོད་ཕྱིར་སྡུད་པའི་ཕྱིར་༎ སྦྱོར་བའི་ཕྱིར་དང་མངོན་དུའི་ཕྱིར་༎
 nibandhanādābhimakhyād duḥkhanāt kliśyate jagat |	སྡུག་བསྔལ་ཕྱིར་ནི་འགྲོ་ཉོན་མོངས་༎
 tredhā dvedhā ca saṃkleśaḥ saptadhābhūtakalpanāt || mvk_1|12 ||	རྣམ་གསུམ་རྣམ་གཉིས་ཀྱང་ཉོན་མོངས་༎ རྣམ་བདུན་ཡང་དག་མིན་རྟོག་ལས་༎ སྟོང་༄༤༡ཨ་༌་༎ པ་ཉིད་ནི་མདོར་བསྡུ་ན་༎
 lakṣaṇaṃ cātha paryāyastadartho bheda eva ca | sādhanañceti vijñeyaṃ śūnyatāyāḥ samāsataḥ || mvk_1|13 ||	མཚན་ཉིད་དང་ནི་རྣམ་གྲངས་དང་༎ དེ་ཡི་དོན་དང་དབྱེ་བ་དང་༎ སྒྲུབ་པ་དག་སྟེ་ཤེས་པར་བྱ་༎
 dvayābhāvo hyabhāvasya bhāvaḥ śūnyasya lakṣaṇam |	གཉིས་དངོས་མེད་དང་དངོས་མེད་པའི་༎ དངོས་པོ་སྟོང་པའི་མཚན་ཉིད་དོ་༎
 na bhāvo nāpi cābhāvao na pṛthaktvaikalakṣaṇam || mvk_1|14 ||	ཡོད་པ་མ་ཡིན་མེད་པའང་མིན་༎ ཐ་དད་གཅིག་པའི་མཚན་ཉིད་མིན་༎ སྟོང་པ་ཉིད་ནི་མདོར་བསྡུ་ན་༎
 tathatā bhūtakoṭiścānimittaṃ paramārthatā |	དེ་བཞིན་ཉིད་དང་ཡང་དག་མཐའ་༎ མཚན་མ་མེད་དང་དོན་དམ་དང་༎ ཆོས་ཀྱི་དབྱིངས་ནི་རྣམ་གྲངས་སོ་༎ གཞན་མིན་ཕྱིན་ཅི་ལོག་མ་ཡིན་༎
 dharmadhātuśca paryāyāḥ śūnyatāyāḥ samāsataḥ || mvk_1|15 || ananyathāviparyāsatannirodhāryagocaraiḥ | hetutvāccāryadharmaṇāṃ paryāyārtho yathākramam || mvk_1|16 ||	དེ་འགོག་འཕགས་པའི་སྤྱོད་ཡུལ་དང་༎ འཕགས་པའི་ཆོས་ཀྱི་རྒྱུ་ཡི་ཕྱིར་༏་། རྣམ་གྲངས་དོན་ཏེ་གོ་རིམས་བཞིན་༎
 saṃkliṣṭā ca viśuddhā ca samalā nirmalā ca sā |	ཀུན་ནས་ཉོན་མོངས་རྣམ་པར་དག་། དེ་ནི་དྲི་བཅས་དྲི་མ་མེད་༎ ཆུ་ཁམས་གསེར་དང་ནམ་མཁའ་རྣམས་༎
 abdhātukanakākāśaśuddhivacchuddhiriṣyate || mvk_1|17 ||	དག་པ་བཞིན་དུ་དག་པར་འདོད་༎
 bhoktṛbhojanataddhehapratiṣṭhāvastuśūnyatā |	ཟ་བ་བཟའ་དང་དེ་ཡི་ལུས་༎ གནས་ཀྱི་གཞི་ཡི་སྟོང་པ་ཉིད་༎
 tacca yena yathā dṛṣṭaṃ yadarthaṃ tasya śūnyatā || mvk_1|18 ||	དེ་ཡང་གང་གིས་ཇི་ལྟར་མཐོང་༎ གང་ཕྱིར་དེ་ཡང་སྟོང་པ་ཉིད་༎
 śubhadvayasya prāptyartha sadā sattvahitāya ca |	དགེ་གཉིས་ཐོབ་པར་བྱ་བའི་ཕྱིར་༎ རྟག་ཏུ་སེམས་ཅན་ཕན་བྱའི་ཕྱིར་༎
 saṃsārātyajanārthaṃ ca kuśalasyākṣayāya ca || mvk_1|19 ||	འཁོར་བ་གཏང་བར་མི་བྱའི་ཕྱིར་༎ དགེ་བ་མི་ཟད་བྱ་བའི་ཕྱིར་༎
 gotrasya ca viśuddhayarthaṃ lakṣaṇavyañjanāptaye |	རིགས་ཀྱང་རྣམ་པར་དག་བྱའི་ཕྱིར་༎ མཚན་དང་དཔེ་བྱད་ཐོབ་བྱའི་ཕྱིར་༏་། སངས་རྒྱས་ཆོས་རྣམས་དག་བྱའི་ཕྱིར་༎
 śuddhaye bu[ddha]dharmāṇāṃ bodhisattvaḥ prapadyate || mvk_1|20 ||	བྱང་ཆུབ་སེམས་དཔའ་སྒྲུབ་པར་བྱེད་༎
 pudgalasyātha dharmāṇāmabhāvaḥ śūnyatātra hi |	གང་ཟག་དང་ནི་ཆོས་རྣམས་ཀྱི་༎ དངོས་པོ་མེད་འདིར་སྟོང་པ་ཉིད་༎
 tadabhāvasya sadbhāvastasmin sā śūnyatāparā || mvk_1|21 ||	དེ་དངོས་མེད་པའི་དངོས་ཡོད་པ་༎ དེ་ནི་དེ་ལས་སྟོང་ཉིད་གཞན་༎
 saṃkliṣṭā cedbhavennāsau muktāssyuḥ sarvadehinaḥ |	གལ་ཏེ་ཉོན་མོངས་དེ་མ་གྱུར་༎ ལུས་ཅན་ཐམས་ཅད་གྲོལ་བར་གྱུར་༎
 viśuddhā cedbhavennāsau vyāyāmo niṣphalo bhavet || mvk_1|22 ||	གལ་ཏེ་རྣམ་དག་དེ་མ་གྱུར་༎ འབད་པ་འབྲས་བུ་མེད་པར་འགྱུར་༎
 na kliṣṭā nāpi va 'ākliṣṭā śuddhāśuddhā na caiva sā | prabhāsvaratvāccittasya kleśasyāgantukatvataḥ || mvk_1|23 ||	ཉོན་མོངས་མ་ཡིན་མི་རྨོངས་མིན་༎ དེ་ནི་དག་དང་མ་དག་མིན་༎ བསྟན་བཅོས་དབུས་དང་མཐའ་རྣམ་པར་འབྱེད་པ་ལས་།
 || iti lakṣaṇaparicchedaḥ prathamaḥ || āvaraṇaparicchedo dvitīyaḥ	མཚན་ཉིད་ཀྱི་ལེའུར་བཅད་པ་ཞེས་བྱ་བ་སྟེ་དང་པོའོ་།
 vyāpi prādeśikodriktasamādānavivarjanam |	༎ ། ཁྱབ་དང་ཉི་ཚེ་ལྷག་པ་དང་༎ མཉམ་དང་ལེན་དང་སྤོང་བ་ནི་༎
 dvayāvaraṇamākhyātaṃ navadhā kleśalakṣaṇam || mvk_2|1 ||	གཉིས་ཀྱི་སྒྲིབ་པར་བསྟན་པ་ཡིན་༎ ཉོན་མོངས་མཚན་ཉིད་རྣམ་དགུའོ་༎ ཀུན་ཏུ་སྦྱོར་རྣམས་སྒྲིབ་པ་ཡིན་༎
 saṃyojanānyāvaraṇamudvegasamupekṣayoḥ | tattvadṛṣṭeśca satkāyadṛṣṭestadvastuno 'pi ca || mvk_2|2 || nirodhamārgaratneṣu lābhasatkāra eva ca |	སྐྱོ་བ་དང་ནི་བཏང་སྙོམས་དང་༎ དེ་ཁོ་ན་ནི་མཐོང་བ་དང་༎ འཇིག་༄༤༡བ་ཆོགས་ལྟ་དང་དེའི་གཞི་དང་༎ འགོག་དང་ལམ་དང་དཀོན་མཆོག་དང་༎ རྙེད་པ་དང་ནི་བཀུར་སྟི་དང་༎ ཡོ་བྱད་བསྙུངས་པ་ཡོངས་ཤེས་ལ་༎
 saṅkleśasya parijñāne śubhādau daśadhāparam || mvk_2|3 ||	དགེ་ལ་སོགས་པ་བཅུ་ལ་གཞན་༎
 aprayogo 'nāyatane 'yogavihitaśca yaḥ |	སྦྱོར་བ་མེད་དང་སྐྱེ་མཆེད་མིན་༎ རྣལ་འབྱོར་མིན་པས་གང་བསྐྱེད་དང་༎ སྐྱེ་བ་མེད་དང་ཡིད་མི་བྱེད་༎
 notpattiramanaskāraḥ sambhārasyāprapūrṇatā || mvk_2|4 || gotramitrasya vaidhuryaṃ cittasya parikheditā | pratipatteśca vaidhuryaṃ kuduṣṭajanavāsatā || mvk_2|5 ||	ཚོགས་ནི་རབ་ཏུ་མ་རྫོགས་དང་༎ རིགས་དང་བཤེས་གཉེན་མི་ལྡན་དང་༎ སེམས་ནི་ཡོངས་སུ་སྐྱོ་བ་དང་༎ སྒྲུབ་པ་དང་ཡང་མི་ལྡན་དང་༎ སྐྱེ་བོ་ངན་སྡང་འགྲོགས་པ་དང་༎ རང་གི་གནས་ངན་ལེན་གསུམ་ལས་༎
 dauṣṭhulyamavaśiṣṭatvaṃ trayāt prajñāvipakvatā |	ལྷག་མ་ཤེས་རབ་མ་སྨིན་དང་༎ རང་བཞིན་གྱིས་ནི་གནས་ངན་ལེན་༎
 prakṛtyā caiva dauṣṭhulyaṃ kausīdyaṃ ca pramāditā || mvk_2|6 || saktirbhave ca bhoge ca līnacittatvameva ca | aśraddhānadhimuktiśca yathārutavicāraṇā || mvk_2|7 || saddharme 'gauravaṃ lābhe gurutākṛpatā tathā |	ལེ་ལོ་དང་ཡང་བག་མེད་དང་༎ སྲིད་དང་ལོངས་སྤྱོད་ཆགས་པ་དང་༎ སེམས་ནི་ཞུམ་པར་གྱུར་པ་དང་༎ མ་དད་པ་དང་མ་མོས་དང་༎ སྒྲ་བཞིན་དུ་ནི་སྤྱོད་པ་དང་༎ དམ་ཆོས་ཆེད་ཆེར་མི་འཛིན་དང་༎ རྙེད་ལ་གདུ་དང་སྙིང་རྗེ་མེད་༎
 śrutavyasanamalpatvaṃ samādhyaparikarmitā || mvk_2|8 ||	ཐོས་པས་ཕོངས་དང་ཉུང་བ་དང་༎ ཏིང་འཛིན་སྦྱངས་པ་མ་བྱས་པའོ་༎
 śubhaṃ bodhiḥ samādānaṃ dhīmattvābhrāntyanāvṛtī |	དགེ་དང་བྱང་ཆུབ་ཡང་དག་འཛིན་༎ བློ་ལྡན་འཁྲུལ་མེད་སྒྲིབ་པ་མེད་༎
 nṛtyatrāso 'matsaritvaṃ vaśitvañca śubhādayaḥ || mvk_2|9 ||	བསྔོ་དང་མི་སྐྲག་སེར་སྣ་མེད་༎ དབང་ནི་དགེ་ལ་སོགས་པའོ་༎
 trīṇi trīṇi ca eteṣāṃ jñeyānyāvaraṇāni hi |	དེ་དག་གི་ནི་སྒྲིབ་པ་རྣམས་༎ གསུམ་གསུམ་དག་ཏུ་ཤེས་པར་བྱ་༎ བྱེད་རྒྱུ་བཅུ་ནི་སྐྱེ་བ་དང་༎ གནས་པ་རྟེན་དང་བསྟན་བྱ་དང་༎ འགྱུར་དང་འབྲལ་དང་གཞན་དུ་དང་༎ ཡིད་ཆེས་གོ་འབྱེད་འཐོབ་རྣམས་ལ་༎ མིག་དང་ཟས་ས་མར་མེ་དང་༎ མེ་ལ་སོགས་པ་དེ་ཡི་དཔེ་༎ ཟོར་བ་བཟོ་ཤེས་དུ་བ་དང་༎ རྒྱུ་དང་ལམ་ལ་སོགས་པ་གཞན་༎
 pakṣyapāramitābhūmiṣvanyadāvaraṇaṃ punaḥ || mvk_2|10 ||	ཕྱོགས་དང་ཕ་རོལ་ཕྱིན་ས་ལ་༎ སྒྲིབ་པ་དག་ནི་གཞན་ཡིན་ནོ་༎
 vastvakauśalakausīdyaṃ samādherdvayahīnatā | aropaṇātha daurbalyaṃ dṛṣṭidauṣṭhulyaduṣṭatā || mvk_2|11 ||	གཞི་ལ་མི་མཁས་ལེ་ལོ་དང་༎ གཉིས་ཀྱིས་ཏིང་འཛིན་ཉམས་པ་དང་༎ མི་སྐྱེད་པ་དང་ཉམ་ཆུང་དང་༎ ལྟ་དང་གནས་ངན་ལེན་སྐྱོན་ཆགས་༎
 aiśvaryasyātha sugateḥ sattvātyāgasya cāvṛtiḥ | hānivṛddhyośca doṣāṇāṃ guṇānāmavatāraṇe || mvk_2|12 ||	ཕྱུག་པོ་དང་ནི་བདེ་འགྲོ་དང་༎ སེམས་ཅན་མི་གཏོང་སྒྲིབ་པ་དང་༎ ཉེས་པ་དག་དང་ཡོན་ཏན་རྣམས་༎
 vimocane 'kṣayatve ca nairantarye śubhasya ca |	འབྲི་དང་འཕེལ་དང་འཛུད་པ་དང་༎ གྲོལ་བར་བྱེད་དང་མི་ཟད་དང་༎ དགེ་བ་རྒྱུན་མི་འཆད་པ་དང་༎ ངེས་པར་བྱེད་དང་ཆོས་རྣམས་ལ་༎
 niyatīkaraṇe dharmasambhogaparipācane || mvk_2|13 ||	ལོངས་པར་སྤྱོད་དང་ཡོངས་སྨིན་༄༤༢ཨ་༌་༎
 sarvatragārthe agrārthe niṣyandāgrārtha eva ca |	བྱེད་༏་། ཀུན་དུ་འགྲོ་དོན་མཆོག་གི་དོན་༎
 niṣparigrahatārtha ca santānābheda eva ca || mvk_2|14 || nissaṅkleśaviśuddhyarthe 'nānātvārtha eva ca | ahīnānadhikārthe ca caturdhāvaśitāśraye || mvk_2|15 ||	རྒྱུ་མཐུན་དོན་གྱི་མཆོག་ཉིད་དང་༎ ཡོངས་སུ་འཛིན་པ་མེད་དོན་དང་༎ རྒྱུད་རྣམས་ཐ་དད་མེད་དོན་དང་༎ ཉོན་མོངས་རྣམ་དག་མིན་དོན་དང་༎ ཐ་དད་མེད་པའི་དོན་ཉིད་དང་༎ བྲི་མེད་འཕེལ་བ་མེད་དོན་དང་༎ དབང་ནི་རྣམ་པ་བཞི་ཡི་གནས་༎
 dharmadhātāvavidyeyamakliṣṭā daśadhāvṛtiḥ |	ཆོས་ཀྱི་དབྱིངས་ལ་མ་རིག་པ་༎ ཉོན་མོངས་ཅན་མིན་སྒྲིབ་པ་བཅུ་༎
 daśabhūmivipakṣeṇa pratipakṣāstu bhūmayaḥ || mvk_2|16 ||	ས་བཅུའི་མི་མཐུན་ཕྱོགས་རྣམས་ཀྱི་༎ གཉེན་པོ་དག་ནི་ས་ཡིན་ནོ་༎
 kleśāvaraṇamākhyātaṃ jñeyāvaraṇameva ca |	ཉོན་མོངས་པ་ཡི་སྒྲིབ་པ་དང་༎ ཤེས་བྱའི་སྒྲིབ་པ་ཉིད་དུ་བསྟན་༎ དེར་ནི་སྒྲིབ་པ་ཐམས་ཅད་དེ་༎
 sarvāṇyāvaraṇānīha yatkṣayānmuktiriṣyate || mvk_2|17 ||	དེ་ཟད་ནས་ནི་གྲོལ་བར་འདོད་༎ བསྟན་བཅོས་དབུས་དང་མཐའ་རྣམ་པར་འབྱེད་པ་ལས་།
 || ityāvaraṇaparicchedo dvitīyaḥ || tattvaparicchedastṛtīyaḥ	སྒྲིབ་པའི་ལེའུར་བཅད་པ་ཞེས་བྱ་བ་སྟེ་གཉིས་པའོ་།
 mūlalakṣaṇatattvamaviparyāsalakṣaṇam |	༎ ། རྩ་བ་མཚན་ཉིད་དེ་ཁོ་ན་༎ ཕྱིན་ཅི་མ་ལོག་མཚན་ཉིད་དང་༎ འབྲས་བུ་རྒྱུ་ཡི་དེ་ཁོ་ན་༎
 phalahetumayaṃ tattvaṃ sūkṣmaudārikameva ca || mvk_3|1 || prasiddhaṃ śuddhiviṣayaṃ saṅgrāhyaṃ bhedalakṣaṇam |	རགས་པ་དང་ནི་ཕྲ་བ་དང་༎ གྲགས་དང་རྣམ་པར་དག་ཡུལ་དང་༎ བསྡུ་དང་དབྱེ་བའི་མཚན་ཉིད་དང་༎ མཁས་དེ་ཁོ་ན་རྣམ་བཅུ་ནི་༎
 kauśalyatattvaṃ daśadhā ātmadṛṣṭivipakṣataḥ || mvk_3|2 ||	བདག་ཏུ་ལྟ་བའི་གཉེན་པོའོ་༎
 svabhāvastrividho 'sacca nityaṃ saccāpyatattvataḥ |	ངོ་བོ་ཉིད་གསུམ་རྟག་མེད་དང་༎ ཡོད་ཀྱང་ཁོ་ན་མ་ཡིན་དང་༎ ཡོད་དང་མེད་དེ་ཁོ་ན་སྟེ་༎ ངོ་བོ་ཉིད་ནི་གསུམ་དུ་འདོད་༎
 sadasattattvataśceti svabhāvatrayamiṣyate || mvk_3|3 || samāropāpavādasya dharmapudgalayoriha | grāhyagrāhakayoścāpi bhāvābhāve ca darśanam || mvk_3|4 ||	འདི་ལ་ཆོས་དང་གང་ཟག་དང་༎ གཟུང་བ་དག་དང་འཛིན་པ་དང་༎ ཡོད་དང་མེད་པར་སྒྲོ་འདོགས་དང་༎ སྐུར་པ་འདེབས་པར་ལྟ་བ་དག་། 
 yajjñānānna pravarteta taddhi tattvasya lakṣaṇam |	གང་ཤེས་ནས་ནི་མི་འབྱུང་བ་༎ དེ་དེ་ཁོ་ནའི་མཚན་ཉིད་དོ་༎
 asadartho hyanityārtha utpādadavyayalakṣaṇaḥ || mvk_3|5 ||	མི་རྟག་དོན་ནི་མེད་དོན་དང་༎ སྐྱེ་ཞིང་འཇིག་པའི་མཚན་ཉིད་དང་༎ དྲི་བཅས་དྲི་མ་མེད་དོན་ཏེ་༎
 samalāmalabhāvena mūlatattve yathākramam |	རྩ་བའི་ཁོ་ནར་གོ་རིམས་བཞིན་༎
 duḥkhamādānalakṣmākhyaṃ sambandhenāparaṃ matam || mvk_3|6 ||	སྡུག་བསྔལ་ལེན་དང་མཚན་ཉིད་དང་༎ འབྲེལ་པ་གཞན་དུ་འདོད་པ་ཡིན་༎
 abhāvaścāpyatadbhāvaḥ prakṛtiḥ śūnyatā matā |	དངོས་མེད་དེ་དངོས་མ་ཡིན་དང་༎ རང་བཞིན་གྱིས་ནི་སྟོང་པར་འདོད་༎
 alakṣaṇañca nairātmyaṃ tadvilakṣaṇameva ca || mvk_3|7 ||	མཚན་ཉིད་མེད་པས་བདག་མེད་དང་༎ དེ་དང་མི་མཐུན་མཚན་ཉིད་དང་༎ རང་གི་མཚན་ཉིད་བསྟན་པ་ཡིན་༎
 svalakṣaṇañca nirdiṣṭaṃ duḥkhasatyamato matam |	དེ་ཕྱིར་སྡུག་བསྔལ་བདེན་པར་འདོད་༎
 vāsanātha samutthānamavisaṃyoga eva ca || mvk_3|8 ||	བག་ཆགས་དང་ནི་ཀུན་ནས་འབྱུང་༎ མ་བྲལ་པ་ཡང་དེ་བཞིན་ནོ་༎ ངོ་བོ་ཉིད་དང་གཉིས་མི་སྐྱེ་༎
 svabhāvadvayanotpattirmalaśāntidvayaṃ matam |	དྲི་༄༤༢བ་མ་ཞི་བ་གཉིས་སུ་འདོད་༎
 parijñāyāṃ prahāṇe ca prāptisākṣātkṛtāvayam || mvk_3|9 ||	ཡོངས་སུ་ཤེས་དང་སྤང་བ་དང་༎ ཐོབ་པར་མངོན་སུམ་བྱ་བས་ནི་༎
 mārgasatyaṃ samākhyātaṃ prajñaptipratipattitaḥ | tathodbhāvanayaudāraṃ paramārthantu ekataḥ || mvk_3|10 ||	ལམ་གྱི་བདེན་པ་ཡང་དག་བཤད་༎ བཏགས་པ་དང་ནི་ཤེས་པ་དང་༎ དེ་བཞིན་བརྗོད་པ་རགས་པ་ཡིན་༎
 arthaprāptiprapattyā hi paramārthastridhā mataḥ |	དམ་པའི་དོན་ནི་གཅིག་པུའོ་༎ དོན་དང་ཐོབ་དང་སྒྲུབ་པ་ནི་༏་། དོན་དམ་རྣམ་པ་གསུམ་དུ་འདོད་༎
 nirvikārāviparyāsapariniṣpattito dvayam || mvk_3|11 ||	འགྱུར་མེད་ཕྱིན་ཅི་མ་ལོག་པ་༎ ཡོངས་སུ་གྲུབ་པ་རྣམ་པ་གཉིས་༎
 lokaprasiddhamekasmāt trayād yuktiprasiddhakam |	གཅིག་གིས་འཇིག་རྟེན་གྲགས་པ་སྟེ་༎ གསུམ་གྱིས་རིགས་པའི་གྲགས་པའོ་༎
 viśuddhagocaraṃ dvedhā ekasmādeva kīrtitam || mvk_3|12 ||	རྣམ་དག་སྤྱོད་ཡུལ་རྣམ་གཉིས་ཏེ་༎
 nimittasya vikalpasya nāmnaśca dvayasaṅgrahaḥ |	གཅིག་པུ་ཁོ་ནར་བརྗོད་པ་ཡིན་༏་། རྒྱུ་དང་རྣམ་པར་རྟོག་པ་དང་༎ མིང་ནི་རྣམ་པ་གཉིས་སུ་བསྡུ་༎
 samyagjñānasatattvasya ekenaiva ca saṅgrahaḥ || mvk_3|13 ||	ཡང་དག་ཡེ་ཤེས་རབ་ཁོ་ན་༎ གཅིག་པུ་ཁོ་ནས་བསྡུས་པ་ཡིན་༎
 pravṛttitattvaṃ dvividhaṃ sanniveśakupannatā |	འཇུག་དེ་ཁོ་ན་རྣམ་པ་གཉིས་༎ གནས་པ་དང་ནི་ངན་པར་ཞུགས་༎
 ekaṃ lakṣaṇavijñaptiśuddhisamyakprapannatā || mvk_3|14 || ekahetutvabhoktṛtvakartṛtvavaśavartane |	།
 ādhipatyārthanityatve kleśaśuddhyāśraye 'pi ca || mvk_3|15 ||	གཅིག་དང་རྒྱུ་དང་ཟ་བ་དང་༎ བྱེད་པ་དང་ནི་དབང་བསྒྱུར་དང་༎ བདག་པོའི་དོན་དང་རྟག་པ་དང་༎ ཉོན་མོངས་པ་དང་དག་པའི་གནས་༎ རྣལ་འབྱོར་ཅན་དང་མ་གྲོལ་གྲོལ་༎
 yogitvāmuktamuktatve ātmadarśanameṣu hi |	འདི་དག་ལ་ནི་བདག་ཏུ་ལྟ་༎
 parikalpavikalpārthadharmatārthena teṣu te || mvk_3|16 ||	ཀུན་ཏུ་རྟོག་དང་རྣམ་རྟོག་དོན་༎ ཆོས་ཉིད་དོན་གྱིས་དེ་དག་དེར་༎ ཐོག་མ་དུ་མ་ཉིད་དང་ནི་༎
 anekatvābhisaṅkṣepaparicchedārtha āditaḥ |	བསྡུས་དང་ཡོངས་སུ་ཕྱེ་བའི་དོན་༎
 grāhakagrāhyatadgrāhabījārthaścāparo mataḥ || mvk_3|17 ||	འཛིན་དང་གཟུང་དང་དེ་འཛིན་པ་༎ ས་བོན་དོན་ཏེ་གཞན་དུ་འདོ་༎
 veditārthaparicchedabhogāyadvārato 'param |	ཚོར་དང་དོན་རྣམས་ཡོངས་གཅོད་ཀྱི་༎ ཉེར་སྤྱོད་འབྱུང་སྒོ་གཞན་ཡིན་ནོ་༎
 punarhetuphalāyāsānāropānapavādataḥ || mvk_3|18 ||	རྒྱུ་དང་འབྲས་བུ་རྩོལ་བ་ལ་༎ སྒྲོ་འདོགས་མེད་ཅིང་བསྐུར་འདེབས་མེད་༎
 aniṣṭeṣṭaviśuddhīnāṃ samotpattyādhipatyayoḥ |	མི་འདོད་འདོད་དང་རྣམ་དག་དང་༎ མཉམ་དུ་འབྱུང་དང་དབང་བྱེད་དང་༎ འཐོབ་དང་ཀུན་ཏུ་སྤྱོད་པ་དག་། 
 samprāptisamudācārapāratantryārthato 'param || mvk_3|19 ||	གཞན་དབང་ཉིད་ཀྱི་དོན་ཏེ་གཞན་༎
 grahaṇasthānasandhānabhogaśuddhidvayārthataḥ |	འཛིན་དང་གནས་དང་རྒྱུན་མི་འཆད་༎ སྤྱོད་དང་དག་པ་གཉིས་ཀྱི་ཕྱིར་༎
 phalahetūpayogārthanopayogāttathāparam || mvk_3|20 ||	འབྲས་བུ་རྒྱུ་རྣམས་སྤྱད་ཟིན་དང་༎ དེ་བཞིན་མ་སྤྱད་གཞན་ཡིན་ནོ་༎
 vedanāsanimittārthatannimittaprapattitaḥ |	ཚོར་བ་རྒྱུ་དང་བཅས་པའི་དོན་༎ དེ་ཡི་རྒྱུ་ནི་སྒྲུབ་པ་ཡིན་༎
 tacchamapratipakṣārthayogādaparamiṣyate || mvk_3|21 ||	དེ་ཞི་བ་དང་གཉེན་པོའི་དོན་༎ ལྡན་པའི་ཕྱིར་ན་གཞན་དུ་འདོད་༎ དེ་ཡི་རྒྱུ་ནི་སྒྲུབ་པ་ཡིན་༎ ཀུན་འབྱུང་བ་ཡི་བདེན་པ་སྟེ་༎ ཡོན་༄༤༣ཨ་༌་༎ ཏན་སྐྱོན་དང་རྣམ་མི་རྟོག་། 
 guṇadoṣāvikalpena jñānena parataḥ svayam |	ཤེས་པས་གཞན་ལས་བདག་གིས་ནི་༎
 niryāṇādaparaṃ jñeyaṃ saprajñaptisahetukāt || mvk_3|22 || nimittāt praśamāt sārthāt paścimaṃ samudāhṛtam ||	ངེས་པར་འབྱུང་ཕྱིར་གཞན་ཞེས་བྱ་༎ བཏགས་བཅས་རྒྱུར་བཅས་རྒྱུ་མཚན་དང་༎ རབ་ཏུ་ཞི་བ་དོན་བཅས་ནི་༎
 || iti tattvaparicchedastṛtīyaḥ || pratipakṣabhāvanāvasthāphalaparicchedaścaturthaḥ	ཐ་མ་ཉིད་དུ་བཤད་པ་ཡིན་༎ བསྟན་བཅོས་དབུས་དང་མཐའ་རྣམ་པར་འབྱེད་པ་ལས་། དེ་ཁོ་ནའི་ལེའུར་བཅད་པ་ཞེས་བྱ་སྟེ་གསུམ་པའོ་།
 dauṣṭhulyāt tarṣahetutvād vastutvādavimohataḥ |	༎ ། གནས་ངན་ལེན་ཕྱིར་སྲེད་རྒྱུའི་ཕྱིར་༎ གཞི་ཡི་ཕྱིར་དང་མ་རྨོངས་ཕྱིར་༎ བདེན་པ་བཞི་ལ་འཇུག་བྱ་བས་༎
 catussatyāvatārāya smṛtyupasthānabhāvanā || mvk_4|1 ||	དྲན་པ་ཉེ་བར་གཞག་པ་བསྒོམས་༎
 parijñāte vipakṣe ca pratipakṣe ca sarvathā |	མི་མཐུན་ཕྱོགས་དང་གཉེན་པོ་རྣམས་༎ རྣམ་པ་ཐམས་ཅད་ཡོངས་ཤེས་ན་༎
 tadapāyāya vīryaṃ hi caturdhā sampravartate || mvk_4|2 ||	དེ་དག་སྤོང་ཕྱིར་བརྩོན་འགྲུས་ནི་༎ རྣམ་པ་བཞི་དག་རབ་ཏུ་འབྱུང་༎
 karmaṇyatā sthitestatra sarvārthānāṃ samṛddhaye |	དེར་གནས་ལས་སུ་རུང་བ་ཉིད་༎ དོན་རྣམས་ཐམས་ཅད་འབྱོར་པར་འགྱུར་༎
 pañcadoṣaprahāṇāṣṭasaṃskārāsevanānvayā || mvk_4|3 ||	ཉེས་པ་ལྔ་སྤང་འདུ་བྱེད་བརྒྱད་༎
 kausīdyamavavādasya sammoṣo laya uddhavaḥ |	བསྟན་པའི་རྒྱུ་ལས་བྱུང་བའོ་༎ ལེ་ལོ་དང་ནི་གདམས་ངག་རྣམས་༎ བརྗེད་དང་བྱིང་དང་རྒོད་པ་དང་༎ འདུ་མི་བྱེད་དང་འདུ་བྱེད་དེ་༎
 asaṃskāro 'tha saṃskāraḥ pañca doṣā ime matāḥ || mvk_4|4 ||	འདི་དག་ཉེས་པ་ལྔར་འདོད་དོ་༎
 āśrayo 'thāśritastasya nimittaṃ phalameva ca |	གནས་དང་དེ་ལ་གནས་པ་དང་༎ རྒྱུ་དང་འབྲས་བུ་ཉིད་དུའོ་༎
 ālambane 'sammoṣo layauddhatyānubuddhyanā || mvk_4|5 || tadapāyābhisaṃskāraḥ śāntau praśaṭhavāhitā |	དམིགས་པ་བརྗེད་པར་མ་གྱུར་དང་༎ བྱིང་དང་རྒོད་པ་རྟོགས་པ་དང་༎ དེ་སྤོང་མངོན་པར་འདུ་བྱེད་དང་༎ ཞི་ཚེ་རྣལ་དུ་འཇུག་པའོ་༎
 ropite mokṣabhāgīye cchandayogādhipatyataḥ || mvk_4|6 ||	ཐར་པའི་ཆ་དང་མཐུན་བསྐྱེད་ནས་༎
 ālambane 'sammoṣāvisāravicayasya ca |	འདུན་དང་སྦྱོར་བ་དབང་བྱེད་དང་༎ དམིགས་པ་བརྗེད་པར་མ་གྱུར་དང་༎ མི་འཕྲོ་རྣམ་པར་འབྱེད་ཀྱང་ངོ་༎
 vipakṣasya hi saṃlekhāt pūrvasya phalamuttaram || mvk_4|7 ||	མི་མཐུན་ཕྱོགས་ནི་སྲབ་པའི་ཕྱིར་༏་། སྟོབས་ལྡན་འབྲས་བུ་ཕྱི་མ་ཡིན་༎
 dvau dvau nirvedhabhāgīyāvindriyāṇi balāni ca |	དབང་པོ་རྣམས་དང་སྟོབས་རྣམས་ལ་༎ ངེས་འབྱེད་ཆ་མཐུན་གཉིས་གཉིས་སོ་༎
 āśrayāṅgaṃ svabhāvāṅgaṃ niryāṇāṅgaṃ tṛtīyakam || mvk_4|8 ||	།
 caturthamanuśaṃsāṅgaṃ niḥkleśāṅgaṃ tridhā matam |	བཞི་པ་ཕན་ཡོན་ཏན་ལག་ཡིན་༎ རྣམ་གསུམ་ཉོན་མོངས་མེད་ཡན་ལག་།འདི་ལ་གཞི་དང་གནས་དང་ནི་༎
 nidānenāśrayeṇeha svabhāvena ca deśitam || mvk_4|9 ||	ངོ་བོ་ཉིད་དུ་བསྟན་པ་ཡིན་༎
 paricchedo 'tha samprāptiḥ parasambhāvanā tridhā |	ཡོངས་སུ་གཅོད་དང་གོ་བྱེད་དང་༎ རྣམ་གསུམ་གཞན་ཡིད་ཆེས་པར་བྱེད་༎
 vipakṣapratipakṣaśca mārgasyāṅgaṃ tadaṣṭadhā || mvk_4|10 ||	མི་མཐུན་ཕྱོགས་ཀྱི་གཉེན་པོར་ནི་༎ ལམ་གྱི་ཡན་ལག་དེ་བརྒྱད་དོ་༎ ལྟ་དང་ཚུལ་༄༤༣བ་ཁྲིམས་ཡོ་བྱད་བསྙུངས་༎
 dṛṣṭau śīle 'tha saṃlekhe paravijñaptiriṣyate |	གཞན་ལ་རྣམ་པར་རིག་བྱེད་འདོད་༎
 kleśopakleśavaibhutvavipakṣapratipakṣatā || mvk_4|11 ||	ཉོན་མོངས་ཉེ་བའི་ཉོན་མོངས་དབང་༎ མི་མཐུན་ཕྱོགས་ཀྱི་གཉེན་པོའོ་༎
 anukūlā viparyastā sānubandhā viparyayā |	རྗེས་སུ་མཐུན་ལ་ཕྱིན་ཅི་ལོག་། 
 aviparyastaviparyāsānanubandha ca bhāvanā || mvk_4|12 ||	རྗེས་སུ་འབྲེལ་བཅས་བཟློག་པ་དང་༎ ཕྱིན་ཅི་མ་ལོག་ཕྱིན་ཅི་ལོག་། རྗེས་སུ་འབྲེལ་མེད་བསྒོམ་པའོ་༎ བྱང་ཆུབ་སེམས་དཔའ་རྣམས་ཀྱི་ནི་༎
 ālambanamanaskāraprāptitastad viśiṣṭatā |	དམིགས་དང་ཡིད་ལ་བྱེད་པ་དང་༎ འཐོབ་པས་དེ་ནི་ཁྱད་པར་འཕགས་༎
 hetvavasthāvatārākhyā prayogaphalasaṃjñitā || mvk_4|13 || kāryākāryaviśiṣṭā ca uttarānuttarā ca sā |	རྒྱུ་ཡི་གནས་དང་ཞུགས་པ་དང་༎ སྦྱོར་དང་འབྲས་བུ་བརྗོད་པ་དང་༎ བྱ་དང་བྱ་མེད་ཁྱད་པར་དང་༎ དེ་ནི་བླ་མ་བླ་ན་མེད་༎
 adhimuktau praveśe ca niryāṇe vyākṛtāvapi || mvk_4|14 || kathikatve 'bhiṣeke ca samprāptāvanuśaṃsane |	མོས་པ་དང་ནི་འཇུག་པ་དང་༎ ངེས་པར་འབྱུང་དང་ལུང་བསྟན་དང་༎ བརྗོད་པ་དང་ནི་དབང་བསྐུར་དང་༎ ཕྱིན་པ་དང་ནི་ཕན་ཡོན་དང་༎ བྱ་བ་བསྒྲུབ་པ་བསྟན་པའོ་༎
 kṛtyānuṣṭhāna uddiṣṭā dharmādhātau tridhā punaḥ || mvk_4|15 ||	ཆོས་ཀྱི་དབྱིངས་ལ་རྣམ་གསུམ་སྟེ་༎
 aśuddhāśuddhaśuddhā ca viśuddhā ca yathārthataḥ |	མ་དག་མ་དག་དག་པ་དང་༎ རྣམ་པར་དག་པར་ཅི་རིགས་སྦྱར་༎ འདི་ལས་ཇི་ལྟར་འོས་འོས་སུ་༎
 pudgalānāṃ vyavasthānaṃ yathāyogamato matam || mvk_4|16 ||	གང་ཟག་རྣམ་པར་གཞག་པར་འདོད་༎
 bhājanatvaṃ vipākākhyaṃ balantasyādhipatyataḥ |	སྣོད་གྱུར་རྣམ་པར་སྨིན་བརྗོད་དང་༎ དེ་ཡི་དབང་གིས་སྟོབས་དང་ནི་༎
 rucirvṛddhirviśuddhiśca phalametad yathākramam || mvk_4|17 ||	འདོད་དང་འཕེལ་དང་རྣམ་དག་སྟེ་༎ དེ་དག་འབྲས་བུ་གོ་རིམས་བཞིན་༎
 uttarottaramādyañca tadabhyāsat samāptitaḥ |	ཕྱི་མ་ཕྱི་མ་ཐོག་མ་དང་༎ དེ་གོམས་བྱས་དང་རྫོགས་པའོ་༎
 ānukūlyād vipakṣācca visaṃyogād viśeṣataḥ || mvk_4|18 ||	རྗེས་སུ་མཐུན་དང་མི་མཐུན་ཕྱོགས་༎
 uttarānuttaratvācca phalamanyat samāsataḥ |	བྲལ་བ་དང་ནི་ཁྱད་པར་དང་༎ བླ་མ་དང་ནི་བླ་ན་མེད་༎
 || iti pratipakṣabhāvanādiparicchedaścaturthaḥ || 5 yānānuttaryaparicchedaḥ pañcamaḥ	འབྲས་བུ་གཞན་ཏེ་མདོར་བསྡུས་པའོ་༎ བསྟན་བཅོས་དབུས་དང་མཐའ་རྣམ་པར་འབྱེད་པ་ལས་། གཉེན་པོ་བསྒོམ་པའི་ལེའུར་བཅད་པ་ཞེས་བྱ་སྟེ་བཞི་པའོ་།
 ānuttaryaṃprapattau hi punarālambane matam |	༎ ། བླ་མེད་ཉིད་ནི་སྒྲུབ་པ་དང་༎ དམིགས་པ་དང་ནི་ཡང་དག་འགྲུབ་༎
 samudāgama uddiṣṭaṃ pratipattistu ṣaḍ vidhā || mvk_5|1 ||	བསྟན་པ་ཡིན་པར་འདོད་པའོ་༎ སྒྲུབ་པ་དག་ནི་རྣམ་དྲུག་སྟེ་༎ ཕ་རོལ་ཕྱིན་པ་དེ་དག་ལའོ་༎
 paramātha manaskāre anudharme 'ntavarjane |	དམ་པ་དང་ནི་ཡིད་བྱེད་དང་༎ རྗེས་སུ་མཐུན་ཆོས་མཐའ་སྤངས་དང་༎ ཁྱད་པར་ཅན་དང་ཁྱད་པར་མེད་༎
 viśiṣṭā cāviśiṣṭā ca paramā dvādaśātmikā || mvk_5|2 ||	དམ་པ་བཅུ་གཉིས་བདག་ཉིད་དེ་༎
 audāryamāyatatvañca adhikaro 'kṣayātmatā | nairantaryamakṛcchratvaṃ vittatvañca parigrahaḥ || mvk_5|3 ||	རྒྱ་ཆེ་བ་དང་ཡུན་རིང་དང་༎ ཆེད་དུ་བྱ་དང་མི་ཟད་དང་༎ རྒྱུན་མི་འཆད་དང་ཚེགས་མེད་དང་༎ དབང་འབྱོར་བ་དང་ཡོངས་གཟུང་དང་༎ རྩོམ་དང་༄༤༤ཨ་༌་༎
 ārambhaprāptiniṣyandaniṣpattiḥ paramā matā |	འཐོབ་དང་རྒྱུ་མཐུན་དང་༎ འགྲུབ་པ་དམ་པར་འདོད་པ་ཡིན་༎
 tataśca paramārthena daśa pāramitā matāḥ || mvk_5|4 ||	དེ་ཕྱིར་དམ་པའི་དོན་གྱིས་ནི་༎ ཕ་རོལ་ཕྱིན་པ་བཅུར་འདོད་དོ་༎
 dānaṃ śīlaṃ kṣamā vīryaṃ dhyānaṃ prajñā upāyatā |	སྦྱིན་དང་ཚུལ་ཁྲིམས་བཟོད་བརྩོན་འགྲུས་༎ བསམ་གཏན་དང་ནི་ཤེས་རབ་ཐབས་༎
 praṇidhānaṃ balaṃ jñānametāḥ pāramitā daśa || mvk_5|5 ||	སྨོན་ལམ་སྟོབས་དང་ཡེ་ཤེས་དང་༎ འདི་དག་ཕ་རོལ་ཕྱིན་བཅུའོ་༎
 anugraho 'vighātaśca karma tasya ca marṣaṇam |	ལས་ནི་རྗེས་སུ་འཛིན་བྱེད་དང་༎ གནོད་མི་བྱེད་དང་དེ་ལ་བཟོད་༎
 guṇavṛddhiśca sāmarthyamavatāravimocane || mvk_5|6 || akṣayatvaṃ sadā vṛttirniyataṃ bhogapācane |	ཡོན་ཏན་འཕེལ་དང་འཛུད་ནུས་དང་༎ རྣམ་པར་གྲོལ་བར་བྱེད་པ་དང་༎ མི་ཟད་པ་དང་རྟག་འཇུག་དང་༎ ངེས་པར་ལོངས་སྤྱོད་སྨིན་པར་བྱེད་༎ ཐེག་པ་ཆེན་པོར་ཇི་ལྟ་བུར་༎
 yathāprajñaptito dharmamahāyānamanaskriyā || mvk_5|7 ||	།
 bodhisattvasya satataṃ prajñayā triprakārayā |	ཤེས་རབ་གསུམ་གྱིས་ཡིད་བྱེད་པའོ་༎
 dhātupuṣṭayaipraveśāya cārthasiddhyai bhavatyasau || mvk_5|8 ||	ཁམས་རྟས་བྱེད་དང་འཇུག་བྱེད་དང་༎ དེ་ནི་དོན་རྣམས་འགྲུབ་པར་འགྱུར་༎
 saṃyuktā dharmacaritaiḥ sā jñeyā daśabhiḥ punaḥ |	དེ་ནི་ཆོས་སྤྱོད་རྣམ་བཅུ་དང་༎ ཡང་དག་ལྡན་པར་ཤེས་པར་བྱ་༎
 lekhanā pūjanā dānaṃ śravaṇaṃ vācanod grahaḥ || mvk_5|9 || prakāśanātha svādhyāyaścintanā bhāvanā ca tat |	ཡི་གེ་འདྲི་མཆོད་སྦྱིན་པ་དང་༎ ཉན་དང་ཀློག་དང་ལེན་པ་དང་༎ འཆད་དང་ཁ་དོན་བྱེད་པ་དང་༎ དེ་སེམས་པ་དང་བསྒོམ་པའོ་༎
 ameyapuṇyaskandhaṃ hi caritaṃ tad daśātmakam || mvk_5|10 ||	སྤྱོད་པ་དེ་བཅུའི་བདག་ཉིད་ནི་༎ བསོད་ནམས་ཕུང་པོ་དཔག་ཏུ་མེད་༎
 viśeṣādakṣayatvācca parānugrahato 'śamāt |	ཁྱད་པར་ཕྱིར་དང་མི་ཟད་ཕྱིར་༎ གཞན་ལ་ཕན་འདོགས་མ་ཞིའི་ཕྱིར་༎
 avikṣiptāviparyāsapraṇatā cānudhārmikī || mvk_5|11 ||	མི་ག-ཡེང་ཕྱིན་ཅི་མ་ལོག་པར་༎ གྱུར་པ་རྗེས་སུ་མཐུན་པའི་ཆོས་༎
 vyutthānaṃ viṣaye sārastathāsvādalayoddhavaḥ |	ལྡང་དང་ཡུལ་ལ་འཇུག་པ་དང་༎ དེ་བཞིན་རོ་མྱང་བྱིང་དང་རྒོད་༎
 sambhāvanābhisandhiśca manaskāre 'pyahaṃkṛtiḥ || mvk_5|12 ||	ཡིད་ཆེས་པ་ཡི་བསམ་པ་དང་༎ ཡིད་ལ་བྱེད་པ་ངར་འཛིན་དང་༎ ཆུང་ངུའི་སེམས་ནི་ག-ཡེང་བ་སྟེ་༎
 hīnacittañca vikṣepaḥ parijñeyo hi dhīmatā |	བློ་ལྡན་རྣམས་ཀྱིས་ཤེས་པར་བྱ་༎
 vyañjanārthamanaskāre 'visāre lakṣaṇadvaye || mvk_5|13 ||	ཡི་གེ་དོན་དང་ཡིད་བྱེད་དང་༎ མི་འཕྲོ་བ་དང་མཚན་ཉིད་གཉིས་༎
 aśuddhaśuddhāvāgantukatve 'trāsitānunnatau |	མ་དག་དག་དང་གློ་བུར་དང་༎ མི་སྡང་བ་དང་ཁེངས་པ་མེད་༎
 saṃyogāt saṃstavāccaiva viyogādapyasaṃstavāt || mvk_5|14 ||	འབྲེལ་པའི་ཕྱིར་དང་འདྲིས་ཕྱིར་དང་༎ མ་འབྲེལ་ཕྱིར་དང་མ་འདྲིས་ཕྱིར་༎
 arthasattvamasattvañca vyañjane so 'viparyayaḥ |	དོན་ཡོད་པ་དང་མེད་པ་སྟེ་༎ དེ་ནི་ཡི་གེ་མ་ལོག་པའོ་༎
 dvayena pratibhāsatvaṃ tathā cāvidyamānatā || mvk_5|15 ||	གཉིས་སུ་སྣང་བར་གྱུར་པ་ནི་༎ དེ་ལྟར་ཡོད་པ་མ་ཡིན་ཏེ་༎
 arthe sa cāviparyāsaḥ sadasattvena varjitaḥ |	དེ་ནི་དོན་ལ་མ་ལོག་པ་༎ ཡོད་༄༤༤བ་དང་མེད་པ་རྣམ་པར་སྤངས་༎ རྟོག་པ་དེ་ཡིས་བསྒོས་པ་ཡི་༎
 tajjalpabhāvito jalpamanaskārastadāśrayaḥ || mvk_5|16 ||	རྟོག་པ་ཡིད་བྱེད་དེའི་གནས་ནི་༎
 manaskāre 'viparyāso dvayaprakhyānakāraṇe |	ཡིད་ལ་བྱེད་པ་མ་ལོག་པ་༎ གཉིས་སུ་སྣང་བའི་རྒྱུ་ལའོ་༎ དོན་གྱིས་མེད་དང་ཡོད་པ་སྟེ་༎
 māyādivadasattvañca sattvañcārthasya tanmatam || mvk_5|17 ||	སྒྱུ་མ་ལ་སོགས་བཞིན་དུ་འདོད་༎
 so 'visāre 'viparyāso bhāvābhāvāvisārataḥ |	དེ་ནི་མི་འཕྲོ་མ་ལོག་སྟེ་༏་། ཡོད་དང་མེད་པ་མི་འཕྲོ་ཕྱིར་༎
 sarvasya nāmamātratvaṃ sarvakalpāpravṛttaye || mvk_5|18 ||	རྟོག་པ་ཐམས་ཅད་མི་འཇུག་ཕྱིར་༎ ཐམས་ཅད་མིང་ཙམ་ཁོ་ན་སྟེ་༎
 svalakṣaṇe 'viparyāsaḥ paramārthe svalakṣaṇe |	རང་གི་མཚན་ཉིད་མ་ལོག་པའོ་༎ དོན་དམ་རང་གི་མཚན་ཉིད་ལའོ་༎
 dharmadhātuvinirmukto yasmād dharmo na vidyate || mvk_5|19 ||	ཆོས་ཀྱི་དབྱིངས་ནི་མ་གཏོགས་པར་༎ འདི་ལྟར་ཆོས་ཡོད་མ་ཡིན་ཏེ་༎
 sāmānyalakṣaṇantasmāt sa ca tatrāviparyayaḥ |	དེ་ཕྱིར་སྤྱི་ཡི་མཚན་ཉིད་དེར་༎ དེ་ནི་ཕྱིན་ཅི་མ་ལོག་པའོ་༎ ཕྱིན་ཅི་ལོག་གི་ཡིད་ལ་བྱེད་༎
 viparyastamanaskārāvihāniparihāṇitaḥ || mvk_5|20 ||	མ་སྤངས་པ་དང་སྤངས་པ་ལས་༎
 tadaśuddhirviśuddhiśca sa ca tatrāviparyayaḥ |	དེ་ནི་མ་དག་རྣམ་དག་སྟེ་༎ དེ་ཡང་དེ་ལ་མ་ལོག་པའོ་༎
 dharmadhātorviśuddhatvāt prakṛtyā vyomavatpunaḥ || mvk_5|21 ||	ཆོས་ཀྱི་དབྱིངས་ནི་རང་བཞིན་གྱིས་༎ རྣམ་པར་དག་ཕྱིར་ནམ་མཁའ་བཞིན་༎ གཉིས་ནི་གློ་བུར་བྱུང་བ་སྟེ་༎
 dvayasyāgantukatvaṃ hi sa ca tatrāviparyayaḥ |	དེ་ཡང་དེ་ལ་མ་ལོག་པའོ་༎
 saṃkleśaśca viśuddhiśca dharmapudgalayorna hi || mvk_5|22 ||	ཆོས་རྣམས་དང་ནི་གང་ཟག་གི་༎ ཀུན་ནས་ཉོན་མོངས་རྣམ་དག་མེད་༎
 asattvāt trāsatāmānau nātaḥ so 'trāviparyayaḥ |	མེད་ཕྱིར་དེ་བས་སྐྲག་དང་ང་༎ མེད་དེ་དེ་འདིར་མ་ལོག་པའོ་༎ གང་ལ་གང་ཞིག་གང་ལས་འཁྲུལ་༎ མ་འཁྲུལ་གང་ཞིག་གང་ལ་དང་༎ འཁྲུལ་དང་མ་འཁྲུལ་འབྲས་བུ་ཉིད་༎ དེ་གཉིས་ཀྱི་ནི་མཐའ་མའོ་༎ ཡོད་མེད་ཕྱིན་ཅི་མ་ལོག་དང་༎ གནས་དང་སྒྱུ་མ་ལྟ་བུ་ཉིད་༎ མི་རྟོག་པ་དང་རང་བཞིན་གྱིས་༎ རྟག་པར་འོད་གསལ་གཉིད་དང་ནི་༎ ཀུན་ནས་ཉོན་མོངས་རྣམ་བྱང་དང་༎ དེ་བཞིན་ནམ་མཁའ་ལྟ་བུ་ཉིད་༎ འགྲིབ་པ་མེད་དང་ལྷག་མེད་པ་༎ རྡོ་རྗེའི་ཚིག་ནི་བཅུ་ཞེས་བྱ་༎
 pṛthaktvaikatvamantaśca tīrthyaśrāvakayorapi || mvk_5|23 || samāropāpavādānto dvidhā pudgaladharmayoḥ |	ཐ་དད་པ་དང་གཅིག་མཐའ་དང་༎ མུ་སྟེགས་ཉན་ཐོས་གཉི་ག་དང་༎ གང་ཟག་ཆོས་ལ་སྒྲོ་འདོགས་དང་༎ སྐུར་འདེབས་མཐའ་རྣམས་གཉིས་གཉིས་དང་༎ མི་མཐུན་ཕྱོགས་དང་གཉེན་པོའི་མཐའ་༎
 vipakṣapratipakṣāntaḥ śāśvatocchedasaṃjñitaḥ || mvk_5|24 ||	རྟག་དང་ཆད་པར་འདུ་ཤེས་དང་༎ གཟུང་དང་འཛིན་དང་ཀུན་ཉོན་མོངས་༎
 grāhyagrāhakasaṃkleśavyavadāne dvidhā tridhā |	རྣམ་པར་བྱང་ལ་༄༤༥ཨ་༌་༎ གཉིས་དང་གསུམ་༎
 vikalpadvayatāntaśca sa ca saptavidho mataḥ || mvk_5|25 ||	རྣམ་པར་རྟོག་པ་གཉིས་ཀྱི་མཐའ་༎ དེ་ནི་རྣམ་པ་བདུན་དུ་འདོད་༎
 bhāvābhāve praśāmye 'tha śamane trāsyatadbhaye |	དངོས་ཡོད་དངོས་མེད་ཞི་བྱ་དང་༎ ཞི་བྱེད་སྐྲག་བྱ་དེ་ལ་འཇིགས་༎
 grāhyagrāhe 'tha samyaktvamithyātve vyāpṛtau na ca || mvk_5|26 ||	གཟུང་དང་འཛིན་དང་ཡང་དག་ཉིད་༎ ལོག་པ་ཉིད་དང་བྱེད་དང་མིན་༏་། སྐྱེ་བ་མེད་དང་མཉམ་པའི་དུས་༎
 ajanmasamakālatve sa vikalpadvayāntatā |	དེ་ནི་རྣམ་རྟོག་གཉིས་ཀྱི་མཐའ་༎
 viśiṣṭā cāviśiṣṭā ca jñeyā daśasu bhūmiṣu || mvk_5|27 ||	ཁྱད་པར་ཅན་དང་ཁྱད་མེད་ནི་༎ ས་བཅུ་དག་ཏུ་ཤེས་པར་བྱ་༎
 vyavasthānantato dhātuḥ sādhyasādhanadhāraṇā |	རྣམ་པར་གཞག་དང་དེ་བཞིན་དབྱིངས་༎
 avadhārapradhārā ca prativedhaḥ pratānatā || mvk_5|28 ||	སྒྲུབ་དང་སྒྲུབ་དང་འཛིན་པ་དང་༎ ངེས་པར་འཛིན་དང་རབ་ཏུ་འཛིན་༏་། རབ་ཏུ་རྟོགས་དང་རབ་རྒྱས་དང་༎ རྣམ་པར་རྟོག་དང་རྣལ་འདུག་དང་༎ ཕུལ་དུ་བྱུང་བའི་དམིགས་པར་འདོད་༎
 pragamaḥ praśaṭhatvañca prakarṣālambanammatam | avaikalyāpratikṣepo 'vikṣepaśca prapūraṇā || mvk_5|29 || samutpādo nirūḍhiśca karmaṇyatvāpratiṣṭhitā |	མ་ཚང་མེད་དང་མི་སྤོང་དང་༎ མི་ག-ཡེང་བ་དང་རབ་རྫོགས་དང་༎ ཡང་དག་སྐྱེད་དང་འཕེལ་བ་དང་༎ ལས་སུ་རུང་དང་མི་གནས་དང་༎ སྒྲིབ་པ་མེད་པ་ཉིད་དང་དེ་༎
 nirāvaraṇatā tasyāpraśrabdhisamudāgamaḥ || mvk_5|30 ||	རྒྱུན་མི་གཅོད་པ་ཡང་དག་འགྲུབ་༎
 śāstraṃ madhyavibhāgaṃ hi gūḍhasārārthameva ca |	དབུས་རྣམ་འབྱེད་པའི་བསྟན་བཅོས་ཏེ་༎ རྟོགས་པར་དཀའ་དང་སྙིང་པོའི་དོན་༎
 mahārthañcaiva sarvārthaṃ sarvānarthapraṇodanam || mvk_5|31 ||	དོན་ཆེན་དེ་བཞིན་ཀུན་གྱི་དོན་༎ དོན་མེད་ཐམས་ཅད་སེལ་བའོ་༎
 || iti yānānuttarya paricchedaḥ pañcamaḥ ||	བསྟན་བཅོས་དབུས་དང་མཐའ་རྣམ་པར་འབྱེད་པ་ལས་། ཐེག་པ་བླ་ན་མེད་པའི་ལེའུར་བཅད་པ་ཞེས་བྱ་བ་སྟེ་ལྔ་པའོ་།
