skt	tib
 || namaḥ sarvabuddhabodhisattvebhyaḥ || viṃśatikākārikā (vk)	༄༣ཨ་༌་༎ རྒྱ་གར་སྐད་དུ་། བིང་ཤ་ཀ་ཀའ་རི་ཀ་། བོད་སྐད་དུ་། ཉི་ཤུ་པའི་ཚིག་ལེའུར་བྱས་པ་། འཇམ་དཔལ་གཞོན་ནུར་གྱུར་པ་ལ་ཕྱག་འཚལ་ལོ་༎
 vijñaptimātramevaitadasadarthāvabhāsanāt |	འདི་དག་རྣམ་པར་རིག་ཙམ་ཉིད་༎ ཡོད་པ་མ་ཡིན་དོན་སྣང་ཕྱིར་༎
 yathā taimirikasyāsatkeśacandrādidarśanam || vk_1 ||	དཔེར་ན་རབ་རིབ་ཅན་དག་གིས་༎ སྐྲ་ཟླ་ལ་སོགས་མེད་མཐོང་བཞིན་༎
 yadi vijñaptiranarthā niyamo deśakālayoḥ |	གལ་ཏེ་རྣམ་རིག་དོན་མིན་ན་༎ ཡུལ་དང་དུས་ལ་ངེས་མེད་ཅིང་༎ སེམས་ཀྱང་ངེས་མེད་མ་ཡིན་ལ་༎
 santānasyāniyamaśca yuktā kṛtyakriyā na ca || vk_2 ||	བྱ་བ་བྱེད་པའང་མི་རིགས་འགྱུར་༎ ཡུལ་ལ་སོགས་པ་ངེས་འགྲུབ་སྟེ་༎ རྨི་འདྲའོ་སེམས་ཀྱང་དེས་པ་མེད་༎
 deśādiuniyamaḥ siddhaḥ svapnavat pretavat punaḥ |	ཡི་དགས་བཞིན་ཏེ་ཐམས་ཅད་ཀྱིས་༎
 santānāniyamaḥ sarvaiḥ pūyanadyādidarśane || vk_3 ||	ཀླུང་ལ་རྣག་ལ་སོགས་མཐོང་བཞིན་༎
 svapnopaghātavat kṛtyakriyā narakavat punaḥ |	བྱ་བྱེད་རྨི་ལམ་གནོད་པ་འདྲ་༎ ཐམས་ཅད་སེམས་ཅན་དམྱལ་བ་བཞིན་༎
 sarvaṃ narakapālādidarśane taiśca bādhane || vk_4 ||	དམྱལ་བའི་སྲུང་མ་སོགས་མཐོང་དང་༎ དེ་དག་གིས་ནི་གནོད་ཕྱིར་རོ་༎
 tiraścāṃ sambhavaḥ svarge yathā na narake tathā |	ཇི་ལྟར་དུད་འགྲོ་མཐོ་རིས་སུ་༎ འབྱུང་བ་དེ་ལྟར་དམྱལ་བ་མིན་། ཡི་དགས་མིན་ཏེ་འདི་ལྟ་བུར་༎
 na pretānāṃ yatastajjaṃ duḥkhaṃ nānubhavanti te || vk_5 ||	དེ་ཡོད་སྡུག་བསྔལ་དེས་མི་མྱོང་༎
 yadi tatkarmabhistatra bhūtānāṃ sambhavastathā | iṣyate pariṇāmaśca kiṃ vijñānasya neṣyate || vk_6 ||	གལ་ཏེ་དེ་ཡི་ལས་ཀྱིས་དེར་༎ འབྱུང་བ་དག་ནི་འབྱུང་བ་དང་༎ དེ་བཞིན་འགྱུར་བར་འདོད་ན་གོ་༎ རྣམ་པར་ཤེས་པར་ཅིས་མི་འདོད་༎
 karmaṇo vāsanānyatra phalamanyatra kalpyate |	གཞན་ན་ལས་ཀྱི་བག་ཆགས་ལ་༎ འབྲས་བུ་དག་ནི་༄༣བ་གཞན་དུ་རྟོག་། 
 tatraiva neṣyate yatra vāsanā kiṃ nu kāraṇam || vk_7 ||	གང་ན་བག་ཆགས་ཡོད་པ་དེར་༎ ཅི་ཡི་ཕྱིར་ན་འདོད་མི་བྱ་༎
 rūpādyāyatanāstitvaṃ tadvineyajanaṃ prati |	གཟུགས་སོགས་སྐྱེ་མཆེད་ཡོད་པར་ནི་༎ དེས་འདུལ་བ་ཡི་སྐྱེ་བོ་ལ་། 
 abhiprāyavaśāduktamupapādukasattvavat || vk_8 ||	དགོངས་པའི་དབང་གིས་གསུངས་པ་སྟེ་༎ རྫུས་ཏེ་འབྱུང་བའི་སེམས་ཅན་བཞིན་༎
 yataḥ svabījād vijñaptiryadābhāsā pravartate |	རང་གིས་བོན་གང་ལས་སུ་༎ རྣམ་རིག་སྣང་བ་གང་འབྱུང་བ་༎
 dvividhāyatanatvena te tasyā munirabravīt || vk_9 ||	དེ་དག་དེ་ཡི་སྐྱེ་མཆེད་ནི་༎
 tathā pudgalanairātmyapraveśo hi hyanyathā punaḥ |	རྣམ་པ་གཉིས་སུ་ཐུབ་པས་གསུངས་༎ དེ་ལྟར་གང་ཟག་བདག་མེད་པར་༎ འཇུག་པར་འགྱུར་རོ་གཞན་དུ་ཡང་༎
 deśanā dharmanairātmyapraveśaḥ kalpitātmanā || vk_10 ||	བསྟན་པས་ཆོས་ལ་བདག་མེད་པར་༎ འཇུག་འགྱུར་བརྟགས་པའི་བདག་ཉིད་ཀྱིས་༎
 na tadekaṃ na cānekaṃ viṣayaḥ paramāṇuśaḥ |	དེ་ནི་གཅིག་ནའང་ཡུལ་མིན་ལ་༎ ཕྲ་རབ་རྡུལ་དུ་དུ་མའང་མིན་༎
 na ca te saṃhatā yasmāt paramāṇurna sidhyati || vk_11 ||	དེ་དག་འདུས་པའང་མ་ཡིན་ཏེ་༎ འདི་ལྟར་རྡུལ་ཕྲན་མི་འགྲུབ་ཕྱིར་༎
 ṣaṭkena yugapadyogāt paramāṇoḥ ṣaḍaṃśatā |	དྲུག་གིས་ཅིག་ཅར་སྦྱར་བ་ན་༎ ཕྲ་རབ་རྡུལ་ཆ་དྲུག་ཏུ་འགྱུར་༎ དྲུག་པོ་དག་ནི་གོ་གཅིག་ན་༎
 ṣaṇṇāṃ samānadeśatvāt piṇḍaḥ syādaṇumātrakaḥ || vk_12 ||	གོང་བུ་རྡུལ་ཕྲན་ཙམ་དུ་འགྱུར་༎
 paramāṇorasaṃyoge tatsaṅghāte 'sti kasya saḥ |	རྡུལ་ཕྲན་སྦྱོར་བ་མེད་ན་ནི་༎ དེ་འདུས་ཡོད་པ་དེ་གང་གིས་༎
 na cānavayavatvena tatsaṃyogo na sidhyati || vk_13 ||	ཆ་ཤས་ཡོད་པ་མ་ཡིན་པས་། དེ་སྦྱོར་མི་འགྲུབ་མ་ཟེར་ཅིག་། 
 digbhāgabhedo yasyāsti tasyaikatvaṃ na yujyate |	གང་ལ་ཕྱོགས་ཆ་ཐ་དད་ཡོད་༎ དེ་ནི་གཅིག་ཏུ་མི་རུང་ངོ་༎
 chāyāvṛtī kathaṃ vānyo na piṇḍaścenna tasya te || vk_14 ||	གྲིབ་དང་སྒྲིབ་པར་ཇི་ལྟར་འགྱུར་༎ གོང་བུ་གཞན་མིན་དེ་དེའི་མིན་༎ གཅིག་ནི་རིམ་གྱིས་འགྲོ་བ་མེད་༎
 ekatve na krameṇetiryugapanna grahāgrahau |	ཟིན་དང་མ་ཟན་ཅིག་ཅར་མེད་༎
 vicchinnānekavṛttiśca sūkṣmānīkṣā ca no bhavet || vk_15 ||	རིས་ཆད་དུ་མར་གནས་པ་དང་༎ མིག་གིས་མི་སོད་ཕྲ་བའང་མེད་༎
 pratyakṣabuddhiḥ svapnādau yathā sā ca yadā tadā |	མངོན་སུམ་བློ་ནི་རྨི་སོགས་བཞིན་༎ དེ་ཡང་གང་ཚེ་དེ་ཡི་ཚེ་༎
 na so 'rtho dṛśyate tasya pratyakṣatvaṃ kathaṃ matam || vk_16 ||	ཁྱོད་ཀྱི་དོན་དེ་མི་སྣང་ན་༎ དེ་ནི་མངོན་སུམ་ཇི་ལྟར་འདོད་༎
 uktaṃ yathā tadābhāsā vijñaptiḥ smaraṇaṃ tataḥ |	དཔེར་ན་དེར་སྣང་རྣམ་རིག་བཞིན་༎ བཤད་ཟིན་དེ་ལས་དྲན་པར་ཟད་༎
 svapne dṛgviṣayābhāvaṃ nāprabuddho 'vagacchati || vk_17 ||	རྨི་ལམ་མཐོང་བ་ཡུལ་མེད་པར་༎ མ་སད་བར་དུ་རྟོགས་མ་ཡིན་༎
 anyonyādhipatitvena vijñaptiniyamo mithaḥ |	གཅིག་ལ་གཅིག་གི་དབང་གིས་ན་༎ རྣམ་པར་རིག་པ་ཕན་ཚུན་དེས་༎
 middhenopahataṃ cittaṃ svapne tenāsamaṃ phalam || vk_18 ||	སེམས་ནི་གཉིད་ཀྱིས་ནོན་པས་ན་༎ དེ་ཕྱིར་རྨི་དང་འབྲས་མི་མཚུངས་༎
 maraṇaṃ paravijñaptiviśeṣād vikriyā yathā |	འཆི་བ་གཞན་གྱི་རྣམ་རིག་གིས་༎ བྱེ་བྲག་ལས་ཏེ་དཔེར་བྱ་ན་༎
 smṛtilopādikānyeṣāṃ piśācādimanovaśāt || vk_19 || kathaṃ vā daṇḍakāraṇyaśūnyatvamṛṣikopataḥ |	འདྲེ་ལ་སོགས་པའི་ཡིད་དབང་གིས་༎ གཞན་གྱི་དྲན་ཉམས་འགྱུར་སོགས་བཞིན་༎ དྲང་སྲོང་ཁྲོས་པས་དན་ཏ་ཀའི་༎ དགོན་པ་ཇི་ལྟར་སྟོངས་པར་གྱུར་༎
 manodaṇḍo mahāvadyaḥ kathaṃ vā tena sidhyati || vk_20 ||	ཡིད་ཉེས་ཁ་ན་ཐོ་ཆེར་༎ དེ་མིས་ཇི་ལྟར་འགྲུབ་པར་འགྱུར་༎
 paracittavidāṃ jñānamayathārthaṃ kathaṃ yathā |	གཞན་སེམས་རིག་པས་ཤེས་པ་ནི་༎ དོན་བཞིན་མ་ཡིན་ཇི་༄༤ཨ་༌་༎ ལྟར་དཔེར་༎
 svacittajñānamajñānād yathā buddhasya gocaraḥ || vk_21 ||	རང་སེམས་ཤེས་པས་སངས་རྒྱས་ཀྱི་༎ སྤྱོད་ཡུལ་ཇི་བཞིན་མ་ཤེས་ཕྱིར་༎
 vijñaptimātratāsiddhiḥ svaśaktisadṛśī mayā |	རྣམ་རིག་ཙམ་དུ་གྲུབ་པ་འདི་༎ བདག་གིས་བདག་གི་མཐུ་འདྲ་བར་༎ བྱས་ཀྱི་དེ་ཡི་རྣམ་པ་ཀུན་༎
 kṛteyaṃ sarvathā sā tu na cintyā buddhagocaraḥ || vk_22 ||	བསམ་ཡས་སངས་རྒྱས་སྤྱོད་ཡུལ་ལོ་༎
