skt	tib
 namo buddhāya | [abhyarcana]	༄༡བ་༅་༎ རྒྱ་གར་སྐད་དུ་། མ་དྷཡའན་ཏ་བི་བྷ་ག་ཏའི་ཀ་། བོད་སྐད་དུ་། དབུས་དང་མཐའ་རྣམ་པར་འབྱེད་པའི་འགྲེལ་པ་། བམ་པོ་དང་པོ་། འཇམ་དཔལ་གཞོན་ནུར་གྱུར་པ་ལ་ཕྱག་འཚལ་ལོ་༎ བསྟན་བཅོས་འདི་ནི་རབ་dd་མཛད་པ་༎ བདེ་གཤེགས་ཉིད་སྐྱེས་བདག་སོགས་ལ་༎
 śāstrasyāsya praṇetāram abhyarhya sugatātmajaṃ [|]	འཆད་པ་ལ་ཡང་མངོན་མཆོད་ནས་༎
 vaktāraṃ cāsmadādibhyo yatiṣye 'rthavivecane ||	དོན་རྣམས་དབྱེ་ཕྱིར་འབད་པར་བྱ་༎
 [śāstraśarīra] tatrāditaḥ śāstraśarīraṃ vyavasthāpyate |	དེ་ལ་ཐོག་མ་ཁོ་ནར་བསྟན་བཅོས་ཀྱི་ལུས་རྣམ་པར་གཞག་སྟེ་།
 lakṣaṇaṃ hy āvṛtis tatvaṃ pratipakṣasya bhāvanā |	མཚན་ཉིད་སྒྲིབ་པ་དེ་ཁོ་ན་༎ གཉེན་པོ་དག་ནི་བསྒོམ་པ་དང་༎ དེ་ཡི་གནས་དང་འབྲས་བུ་ཐོབ་༎
 tatra ca sthā phalaprāptir yānānuttaryam eva ca ||	ཐེག་པ་བླ་ན་མེད་པའོ་༎
 ity ete saptārthā hy asmiṃ cchāstre upadiśyante |	ཞེས་བྱ་བ་དོན་བདུན་པོ་འདི་དག་བསྟན་བཅོས་འདི་ལས་འཆད་དོ་༎ འདི་ལྟ་སྟེ་།
 yad uta lakṣaṇaṃ āvaraṇaṃ tatvaṃ pratipakṣasya bhāvanā | tasyām eva ca pratipakṣabhāvanāyām avasthā phalaprāptiś ca yānānuttatyañ ca saptamo 'rthaḥ | [chapter i| lakṣaṇapariccheda] [1| abhūtaparikalpa; a| sadasallaksaṇa]	མཚན་ཉིད་དང་༏་སྒྲིབ་པ་དང་། དེ་ཁོ་ན་དང་། གཉེན་པོ་བསྒོམ་པ་དང་། གཉེན་པོ་བསྒོམ་པ་དེ་ཉིད་ཀྱི་གནས་དང་། འབྲས་བུ་ཐོབ་པ་དང་། ཐེག་པ་བླ་ན་མེད་པ་སྟེ་དོན་བདུན་པའོ་༎
 tatra lakṣaṇam ārabhyāha |	དེ་ལ་མཚན་ཉིད་ལས་བརྩམས་ནས་༎
 abhūtaparikalpo 'sti dvayan tatra na vidyate |	ཡང་དག་མ་ཡིན་ཀུན་རྟོག་ཡོད་༎ དེ་ལ་གཉིས་པོ་ཡོད་མ་ཡིན་༎
 śūnyatā vidyate tv atra tasyām api sa vidyate || 1|1 (mvbh 18)	སྟོང་པ་ཉིད་ནི་འདི་ལ་ཡོད་༎ དེ་ལ་ཡང་ནི་དེ་ཡོད་དོ་༎
 tatrābhūtaparikalpo grāhyagrāhakavikalpaḥ |	ཞེས་བྱ་བ་གསུངས་སོ་༎ དེ་ལ་ཡང་དག་པ་མ་ཡིན་པའི་ཀུན་ཏུ་རྟོག་པའི་ནི་གཟུང་བ་དང་༄༢ཨ་༌་༎ འཛིན་པར་རྣམ་པར་རྟོག་པའོ་༎
 dvayaṃ grāhyaṃ grāhakañ ca |	གཉིས་པོ་ནི་གཟུང་བ་དང་འཛིན་པའི་དངོས་པོ་དང་བྲལ་བའོ་༎
 śūnyatā tasyābhūtaparikalpasya grāhyagrāhakabhāvena virahitatā |	སྟོང་པ་ཉིད་ནི་ཡང་དག་པ་མ་ཡིན་པའི་ཀུན་ཏུ་རྟོག་པ་དེ་གཟུང་བ་དང་འཛིན་པའི་དངོས་པོ་དང་བྲལ་བ་ཉིད་དོ་༎
 tasyām api sa vidyata ity abhūtaparikalpaḥ |	དེ་ལ་ཡང་ནི་དེ་ཡོད་དོ་༎ ཞེས་བྱ་བ་ནི་ཡང་དག་པ་མ་ཡིན་པ་ཀུན་ཏུ་རྟོག་པའོ་༎
 evaṃ yad yatra nāsti tat tena śūnyam iti yathābhūtaṃ samanupaśyati yat punar atrāvaśiṣṭaṃ	དེ་ལྟར་གང་ན་གང་མེད་པ་དེ་ནི་དེས་སྟོང་པར་ཡང་དག་པ་ཇི་ལྟ་བ་བཞིན་དུ་ཡང་དག་པར་རྗེས་སུ་མཐོང་ངོ་༎ འདི་ལ་ལྷག་མ་ཡོད་པ་གང་ཡིན་པ་དེ་ནི་འདིར་ཡོད་པར་ཡང་དག་པ་ཇི་ལྟ་བ་བཞིན་དུ་རབ་ཏུ་ཤེས་ཏེ་།
 bhavati tat sad ihāstīti yathābhūtaṃ prajānātīty aviparītaṃ śūnyatālakṣaṇam udbhāvitaṃ bhavati |	དེ་ལྟར་སྟོང་པ་ཉིད་ཀྱི་མཚན་ཉིད་ཕྱིན་ཅི་མ་ལོག་པར་བསྟན་པ་ཡིན་ནོ་༎
 na śūnyaṃ nāpi cāśūnyaṃ tasmāt sarvaṃ vidhīyate |	སྟོང་པ་མ་ཡིན་མི་སྟོང་མིན་༎ དེ་ལྟ་བས་ན་ཐམས་ཅད་བཤད་༎ ཡོད་པས་མེད་པས་ཡོད་པས་ན་༎
 satvād asatvāt satvāc ca madhyamā pratipac ca sā || i|2	དེ་ནི་དབུ་མའི་ལམ་ཡིན་ནོ་༎
 na śūnyaṃ śūnyatayā cābhūtaparikalpena ca |	སྟོང་པ་མ་ཡིན་ཞེས་བྱ་བ་ནི་སྟོང་པ་ཉིད་དང་ཡང་དག་པ་མ་ཡིན་པ་ཀུན་ཏུ་རྟོགས་པས་སོ་༎ 
 na cāśūnyaṃ dvayena grāhyena grāhakeṇa ca |	མི་སྟོང་མིན་ཞེས་བྱ་བ་ནི་༎ གཉིས་པ་སྟེ་། གཟུང་བ་དང་འཛིན་པས་སོ་༎
 sarvaṃ saṃskṛtaṃ cābhūtaparikalpākhyaṃ | asaṃskṛtaṃ ca śūnyatākhyaṃ |	ཐམས་ཅད་ཅེས་བྱ་བ་ནི་ཡང་དག་པ་མ་ཡིན་པ་ཀུན་ཏུ་རྟོག་པ་ཞེས་བྱ་བ་འདུས་བྱས་དང་སྟོང་པ་ཞེས་བྱ་བ་འདུས་མ་བྱས་སོ་༎ བཤད་ཅེས་བྱ་བ་ནི་བསྟན་པའོ་༎ ཡོད་པས་ཞེས་བྱ་བ་ནི་ཡང་དག་པ་མ་ཡིན་པ་ཀུན་ཏུ་རྟོག་པའོ་༎ མེད་པས་ཞེས་བྱ་བ་ནི་གཉིས་པའོ་༎
 vidhīyate nirdiśyate satvād abhūtaparikalpasya asatvād dvayasya satvāc ca śūnyatāyā abhūtaparikalpe tasyāṃ cābhūtaparikalpasya sā ca madhyamā pratipat |	ཡོད་པས་ན་ཞེས་བྱ་བ་ནི་ཡང་དག་པ་མ་ཡིན་ཀུན་ཏུ་རྟོག་པ་ལ་སྟོང་པ་ཉིད་ཡོད་པ་དང་། ༄༢བ་དེ་ལ་ཡང་ཡང་དག་པ་མ་ཡིན་པ་ཀུན་ཏུ་རྟོག་པ་ཡོད་པའོ་ཡོད་པ་དང་། ༎ དེ་ནི་དབུ་མའི་ལམ་ཡིན་ནོ་ཞེས་བྱ་བ་ནི་ཐམས་ཅད་གཅིག་ཏུ་སྟོང་པ་ཡང་མ་ཡིན་ནོ་༎
 yat sarvaṃ | naikāntena śūnyaṃ naikāntenāśūnyaṃ |	གཅིག་ཏུ་མི་སྟོང་པ་ཡང་མ་ཡིན་པ་གང་ཡིན་པའོ་༎
 evam ayaṃ pāṭhaḥ prajñāpāramitādiṣv anulomito bhavati sarvam idaṃ na śūnyaṃ nāpi cāśūnyam iti |	དེ་ལྟར་འདི་ནི་ཤེས་རབ་ཀྱི་ཕ་རོལ་ཏུ་ཕྱིན་པ་ལ་སོགས་པའི་ནང་ནས་འདི་ཐམས་ཅད་ནི་སྟོང་པ་ཡང་མ་ཡིན་། མི་སྟོང་པ་ཡང་མ་ཡིན་ཞེས་འབྱུང་བ་དང་མཐུན་པར་བྱས་པ་ཡིན་ནོ་༎
 [b| svalakṣaṇa] evam abhūtaparikalpasya sallakṣaṇam asallakṣaṇaṃ ca khyāpayitvā |	དེ་ལྟར་ཡང་དག་པ་མ་ཡིན་པ་ཀུན་ཏུ་རྟོག་པ་ཡོད་པའི་མཚན་ཉིད་དང་མེད་པའི་མཚན་ཉིད་བརྗོད་ནས་། 
 svalakṣaṇaṃ khyāpayati |	ད་ནི་རང་གི་མཚན་ཉིད་བརྗོད་དོ་༎
 arthasatvātmavijñaptipratibhāsaṃ prajāyate |	དོན་དང་སེམས་ཅན་བདག་རྣམ་རིག་། སྣང་བའི་རྣམ་པར་ཤེས་པ་ནི་༎ རབ་ཏུ་སྐྱེའོ་དེའི་དོན་མེད་༎
 vijñānaṃ nāsti cāsyārthas tadabhāvāt tad apy asat || i|3	དེ་མེད་པས་ན་དེ་ཡང་མེད་༎
 tatrārthapratibhāsaṃ yad rūpādibhāvena pratibhāsate |	དེ་ལ་དོན་དུ་སྣང་བ་ནི་གཟུགས་ལ་སོགས་པའི་དངོས་པོར་སྣང་བ་གང་ཡིན་པའོ་༎
 satvapratibhāsaṃ yat pañcendriyatvena svaparasantānayor [| ] ātmapratibhāsaṃ kliṣṭaṃ manaḥ | ātmamohādisaṃprayogāt |	སེམས་ཅན་དུ་སྣང་བ་ནི་དབང་པོ་ལྔར་བདག་དང་གཞན་གྱི་རྒྱུད་ལ་སྣང་བ་གང་ཡིན་པའོ་༎ བདག་ཏུ་སྣང་བ་ནི་བདག་ཏུ་རྨོངས་པ་ལ་སོགས་པ་དང་མཚུངས་པར་ལྡན་པའི་ཕྱིར་ཉོན་མོངས་པ་ཅན་གྱི་ཡིད་དོ་༎
 vijñaptipratibhāsaṃ ṣaḍ vijñānāni [| ] nāsti cāsyārtha iti |	རྣམ་པར་རིག་པར་སྣང་བ་ནི་རྣམ་པར་ཤེས་པ་དྲུག་རྣམས་སོ་༎
 arthasatvapratibhāsasyānākāratvāt | ātmavijñaptipratibhāsasya ca vitathapratibhāsatvāt | (mvbh 19) tadabhāvāt tad apy asad iti |	དེའི་དོན་མེད་ཅེས་བྱ་བ་ནི་དོན་དང་སེམས་ཅན་དུ་སྣང་བ་རྣམས་མེད་པ་དང་། བདག་དང་རྣམ་པར་རིག་པར་སྣང་བ་ནི་ལོག་པར་སྣང་བའི་ཕྱིར་རོ་༎
 yat tadgrāhyaṃ rūpādipañcendriyaṃ manaḥ ṣaḍvijñānasaṃjñakaṃ caturvidhaṃ tasya grāhyasyārthasyābhāvāt tad api grāhakaṃ vijñānam asat |	དོན་མེད་པས་འཛིན་པའི་རྣམ་པར་ཤེས་པ་དེ་ཡང་མེད་དོ་༎
 abhūtaparikalpatvaṃ siddham asya bhavaty ataḥ |	ཡང་དག་མ་ཡིན་ཀུན་རྟོག་པ་༎ དེ་ནི་དེ་ཕྱིར་གྲུབ་པ་ཡིན་༎
 na tathā sarvathābhāvāt |	དེ་བཞིན་མ་ཡིན་ཡེ་མེད་མིན་༎
 yasmān na tathāsya bhāvo yathā pratibhāsa utpadyate |	འདི་ལྟར་ཇི་ལྟར་སྣང་བ་འབྱུང་བ་དེ་ནི་དེ་བཞིན་དུ་ཡོད་པ་མ་ཡིན་ནོ་༎
 na ca sarvathābhāvo bhrāntimātrasyotpādāt|	འཁྲུལ་པ་ཙམ་དུ་འབྱུང་བའི་ཕྱིར་ཡེ་མེད་པ་ཡང་མ་ཡིན་ནོ་༎
 kimarthaṃ punas tasyābhāva eva neṣyate | yasmāt |	ཅིའི་ཕྱིར་དེ་ཡེ་མེད་པ་ཉིད་དུ་མི་འདོད་ཅེ་ན་། འདི་ལྟར་།
 tatkṣayān muktir iṣyate || i|4	དེ་ཟད་ནས་ནི་གྲོལ་བར་འདོད་༎
 anyathā na bandho na mokṣaḥ prasidhyed iti saṃkleśavyavadānāpavādadoṣaḥ syāt |	གཞན་དུ་ན་བཅིངས་པ་དང་ཐར་པར་མི་འགྲུབ་སྟེ་། ཀུན་ནས་ཉོན་མོངས་པ་དང་། རྣམ་པར་བྱང་བ་ལ་སྐུར་པ་འདེབས་པའི་ཉེས་པར་འགྱུར་རོ་༎
 [c| saṃgrahalakṣaṇa] evam abhūtaparikalpasya svalakṣaṇaṃ khyāpayitvā saṃgrahalakṣaṇaṃ khyāpayati | abhūtaparikalpamātre sati yathā trayāṇāṃ svabhāvānāṃ saṃgraho bhavati |	དེ་ལྟར་ཡང་དག་པ་མ་ཡིན་པ་ཀུན་ཏུ་རྟོག་པའི་རང་གི་མཚན་ཉིད་བསྟན་ནས་ཡང་དག་པ་མ་ཡིན་པ་ཀུན་ཏུ་རྟོག་པ་ཙམ་དུ་ཟད་ན་ངོ་བོ་ཉིད་གསུམ་དུ་ཇི་ལྟར་བསྡུ་བར་འགྱུར་བའི་བསྡུ་བའི་མཚན་ཉིད་སྟོན་ཏེ་།
 kalpitaḥ paratantraś ca pariniṣpanna eva ca |	བརྟགས་པ་དང་ནི་གཞན་དབང་དང་༎ ཡོངས་སུ་གྲུབ་པ་ཉིད་ཀྱང་ངོ་༎
 arthād abhūtakalpāc ca dvayābhāvāc ca deśitaḥ || i|5	དོན་ཕྱིར་ཡང་དག་མིན་རྟོག་ཕྱིར་༎ གཉིས་པོ་མེད་པའི་ཕྱིར་བཤད་དོ་༎
 arthaḥ parikalpitaḥ svabhāvaḥ |	ཞེས་བྱ་བའོ་༎ དེ་ལ་དོན་ནི་ཀུན་ཏུ་བརྟགས་པའི་ངོ་བོ་ཉིད་༄༣ཨ་༌་༎
 abhūtaparikalpaḥ paratantraḥ svabhāvaḥ | grāhyagrāhakābhāvaḥ pariniṣpannaḥ svabhāvaḥ | [d| asallakṣaṇānupraveśopāyalakṣaṇa]	དོ་༏་། ཡང་དག་པ་མ་ཡིན་པ་ཀུན་ཏུ་རྟོག་པ་ནི་གཞན་གྱི་དབང་གི་ངོ་བོ་ཉིད་དོ་༎ གཟུང་བ་དང་འཛིན་པ་མེད་པ་ཉིད་ནི་ཡོངས་སུ་གྲུབ་པའི་ངོ་བོ་ཉིད་དོ་༎
 idānīṃ tasminn evābhūtaparikalpe 'sallakṣaṇānupraveśopāyalakṣaṇaṃ paridīpayati | (mvbh 20)	ད་ནི་ཡང་དག་པ་མ་ཡིན་པ་ཀུན་ཏུ་རྟོག་པ་དེ་ཉིད་ཀྱི་མེད་པའི་མཚན་ཉིད་ལ་འཇུག་པའི་ཐབས་ཀྱི་མཚན་ཉིད་ཡོངས་སུ་སྟོན་ཏེ་། དམིགས་པ་ལ་ནི་བརྟེན་ནས་སུ་༎
 upalabdhiṃ samāśritya nopalabdhiḥ prajāyate |	མི་དམིགས་པ་ནི་རབ་ཏུ་སྐྱེ་༎ མི་དམིགས་པ་ལ་བརྟེན་ནས་སུ་༎
 nopalabdhiṃ samāśritya nopalabdhiḥ prajāyate || i|6	མི་དམིགས་པ་ནི་རབ་ཏུ་སྐྱེ་༎
 vijñaptimātropalabdhiṃ niśrityārthānupalabdhir jāyate |	ཞེས་བྱ་བའོ་༎ རྣམ་པར་རིག་པ་ཙམ་དུ་དམིགས་པ་ལ་བརྟེན་ནས་དོན་མི་དམིགས་པ་སྐྱེའོ་༎
 arthānupalabdhiṃ niśritya vijñaptimātrasyāpy anupalabdhir jāyate |	དོན་མི་དམིགས་པ་ལ་བརྟེན་ནས་རྣམ་པར་རིག་པ་ཙམ་ཡང་མི་དམིགས་པ་སྐྱེ་སྟེ་།
 evam asallakṣaṇaṃ grāhyagrāhakayoḥ praviśati |	དེ་ལྟར་གཟུང་བ་དང་འཛིན་པ་དག་མེད་པའི་མཚན་ཉིད་ལ་འཇུག་གོ་༎
 upalabdhes tataḥ siddhā nopalabdhisvabhāvatā |	དེ་ཡི་ཕྱིར་ན་དམིགས་པ་ནི་༎ མི་དམིགས་ངོ་བོ་ཉིད་དུ་གྲུབ་༎
 upalabhyārthābhāve upalabdhyayogāt |	དམིགས་པར་བྱ་བའི་དོན་མེད་ན་དམིགས་པ་མི་རུང་བའི་ཕྱིར་རོ་༎
 tasmāc ca samatā jñeyā nopalambhopalambhayoḥ || i|7	དེ་ལྟ་བས་ན་དམིགས་པ་དང་༎ མི་དམིགས་མཉམ་པར་ཤེས་པར་བྱ་༎
 upalabdher upalabdhitvenāsiddhatvād abhūtārthapratibhāsatayā tūpalabdhir ity ucyate 'nupalabdhisvabhāvāpi satī	དམིགས་པ་ནི་དམིགས་པ་ཉིད་དུ་མ་གྲུབ་པའི་ཕྱིར་རོ་༎ མི་དམིགས་པའི་ངོ་བོ་ཉིད་ཡིན་ཡང་ཡང་དག་པ་མ་ཡིན་པའི་དོན་དུ་སྣང་བས་དམིགས་པ་ཞེས་བྱའོ་༎ 
 [e| prabhedalakṣaṇa] tasyaivedānīm abhūtaparikalpasya prabhedalakṣaṇaṃ khyāpayati |	ད་ནི་ཡང་དག་པ་མ་ཡིན་པ་ཀུན་ཏུ་རྟོག་པ་ཉིད་ཀྱི་རབ་ཏུ་དབྱེ་བའི་མཚན་ཉིད་སྟོན་ཏེ་།
 abhūtaparikalpaś ca cittacaittās tridhātukāḥ |	ཡང་དག་མ་ཡིན་ཀུན་རྟོག་ནི་༎ སེམས་དང་སེམས་བྱུང་ཁམས་གསུམ་པ་༎ ཞེས་བྱ་བའོ་༎
 kāmarūpārūpyāvacarabhedena |	འདོད་པ་དང་། གཟུགས་དང་། གཟུགས་མེད་པ་ན་སྤྱོད་པ་ཐ་དད་པས་སོ་༎
 [f| paryāyalakṣaṇa] paryāyalakṣaṇaṃ ca khyāpayati |	རྣམ་གྲངས་ཀྱི་མཚན་ཉིད་ཀྱང་སྟོན་ཏེ་།
 tatrārthadṛṣṭir vijñānaṃ tadviśeṣe tu caitasāḥ || i|8	དེ་ལ་དོན་མཐོང་རྣམ་པར་ཤེས་༎ དེ་ཡི་ཁྱད་པར་སེམས་ལས་བྱུང་༎ ཞེས་བྱ་བའོ་༎
 tatrārthamātre dṛṣṭir vijñānaṃ |	དོན་ཙམ་མཐོང་བ་ནི་རྣམ་པར་ཤེས་པའོ་༎
 arthaviśeṣe dṛṣṭiś caitasā vedanādayaḥ |	དོན་གྱི་ཁྱད་པར་མཐོང་བ་ནི་སེམས་ལས་བྱུང་བ་རྣམས་ཏེ་ཚོར་བ་ལ་སོགས་པའོ་༎
 [g| pravṛttilakṣaṇa] pravṛttilakṣaṇaṃ ca khyāpayati | (mvbh 21)	འཇུག་པའི་མཚན་ཉིད་ཀྱང་སྟོན་ཏེ་།
 ekaṃ pratyayavijñānaṃ dvitīyam aupabhogikaṃ |	གཅིག་ནི་རྐྱེན་གྱི་རྣམ་པར་ཤེས་༎ གཉིས་པ་ཉེ་བར་སྤྱོད་པ་ཅན་༎
 upabhogaparicchedaprerakās tatra caitasāḥ || i|9	ཉེ་བར་སྤྱོད་པ་དང་ཡོངས་གཅོད་དང་༎ དེ་ཡི་འཇུག་བྱེད་སེམས་ལས་བྱུང་༎
 ālayavijñānam anyeṣāṃ vijñānānāṃ pratyayatvāt pratyayavijñānaṃ |	ཞེས་བྱ་བའོ་༎ ཀུན་གཞི་རྣམ་པར་ཤེས་པ་ནི་རྣམ་པར་ཤེས་པ་གཞན་དག་གི་རྐྱེན་ཡིན་པས་རྐྱེན་གྱི་རྣམ་པར་ཤེས་པའོ་༎ 
 tatpratyayaṃ pravṛttivijñānam aupabhogikaṃ |	དེ་ལས་བྱུང་བ་འཇུག་པའི་རྣམ་པར་ཤེས་པ་ནི་ཉེ་བར་སྤྱོད་པ་ཅན་པར་ཤེས་པའོ་༎ 
 upabhogo vedanā |	།
 paricchedaḥ saṃjñā |	ཡོངས་སུ་སྤྱོད་པ་ནི་འདུ་ཤེས་༎
 prerakāḥ saṃskārā vijñānasya cetanāmanaskārādayaḥ | [h| saṃkleśalaksaṇa]	རྣམ་པར་ཤེས་པ་འཇུག་པར་༄༣བ་བྱེད་པ་དག་ནི་འདུ་བྱེད་རྣམས་ཏེ་། སེམས་པ་དང་ཡིད་ལ་བྱེད་པ་ལ་སོགས་པའོ་༎
 saṃkleśalakṣaṇaṃ ca khyāpayati|	ཀུན་ནས་ཉོན་མོངས་པའི་མཚན་ཉིད་ཀྱང་སྟོན་ཏེ་།
 chādanād ropaṇāc caiva nayanāt saṃparigrahāt |	སྒྲིབ་པའི་ཕྱིར་དང་འདེབས་པའི་ཕྱིར་༎ ཁྲིད་པའི་ཕྱིར་དང་ཀུན་འཛིན་ཕྱིར་༎
 pūraṇāt triparicchedād upabhogāc ca karṣaṇāt || i|10	རྫོགས་བྱེད་ཕྱིར་དང་གསུམ་གཅོད་ཕྱིར་༎ ཉེ་བར་གཅོད་ཕྱིར་སྡུད་པའི་ཕྱིར་༎ སྦྱོར་བའི་ཕྱིར་དང་མངོན་དུའི་ཕྱིར་༎
 nibandhanād ābhimukhyād duḥkhanāt kliśyate jagat |	སྡུག་བསྔལ་ཕྱིར་ནི་འགྲོ་ཉོན་མོངས་༎ རྣམ་གསུམ་རྣམ་གཉིས་ཀྱང་ཉོན་མོངས་༎ རྣམ་བདུན་ཡང་དག་མིན་རྟོག་ལས་༎ ཞེས་བྱ་བའོ་༎
 tatra cchādanād avidyayā yathābhūtadarśanavibandhanāt |	དེ་ལ་སྒྲིབ་པའི་ཕྱིར་ནི་མ་རིག་པས་ཡང་དག་པ་ཇི་ལྟ་བ་བཞིན་དུ་མཐོང་བ་ལ་བགེགས་བྱེད་པའི་ཕྱིར་རོ་༎
 ropaṇāt saṃskārair vijñāne karmavāsanāyāḥ pratiṣṭhāpanāt |	འདེབས་པའི་ཕྱིར་ནི་འདུ་བྱེད་རྣམས་ཀྱིས་རྣམ་པར་ཤེས་པ་ལ་ལས་ཀྱི་བག་ཆགས་འཇོག་པའི་ཕྱིར་རོ་༎ 
 nayanād vijñānenopapattisthānasaṃprāpaṇāt |	ཁྲིད་པའི་ཕྱིར་ནི་རྣམ་པར་ཤེས་པས་སྐྱེ་བའི་གནས་སུ་ཕྱིན་པར་བྱེད་པའི་ཕྱིར་རོ་རོ་༎ 
 saṃparigrahān nāmarūpeṇātmabhāvasya |	༎ ཀུན་འཛིན་ཕྱིར་ནི་མིང་དང་གཟུགས་ཀྱི་ལུས་སོ་༎
 pūraṇāt ṣaḍāyatanena |	རྫོགས་བྱེད་ཕྱིར་ནི་སྐྱེ་མཆེད་དྲུག་གིས་སོ་༎
 triparicchedāt sparśena |	གསུམ་གཅོད་ཕྱིར་ནི་རེག་པས་སོ་༎
 upabhogād vedanayā |	ཉེ་བར་སྤྱོད་པའི་ཕྱིར་ནི་ཚོར་བས་སོ་༎
 karṣaṇāt tṛṣṇayā karmākṣiptasya punarbhavasya [|	སྡུད་པའི་ཕྱིར་ནི་ལས་ཀྱིས་བཏབ་པའི་ཡང་སྲིད་པ་སྲེད་པས་སོ་༎
 ] nibandhanād upādānair vijñānasyotpattyanukūleṣu kāmādiṣu |	སྦྱོར་བའི་ཕྱིར་ནི་ལེན་པ་རྣམས་ཀྱིས་རྣམ་པར་ཤེས་པ་སྐྱེ་བ་དང་མཐུན་པར་འདོད་པ་ལ་སོགས་པ་རྣམས་སུའོ་༎
 ābhimukhyād bhavena kṛtasya karmaṇaḥ punarbhave vipākadānāyābhimukhīkaraṇāt |	མངོན་དུའི་ཕྱིར་ནི་ལས་བྱས་པའི་རྣམ་པར་སྨིན་པ་སྲིད་པས་ཡང་སྲིད་པར་འབྱིན་པར་མངོན་པར་བྱེད་པའི་ཕྱིར་རོ་༎
 duḥkhanāj jātyā jarāmaraṇena ca parikliśyate jagat | so 'yaṃ |	སྡུག་བསྔལ་ཕྱིར་ནི་སྐྱེ་བ་དང་། རྒ་ཤིས་འགྲོ་བ་རྣམས་ཉོན་མོངས་པར་བྱེད་པའོ་༎ དེ་ཡང་།
 tredhā dvedhā ca saṃkleśaḥ saptadhābhūtakalpanāt || i|11	རྣམ་གསུམ་རྣམ་གཉིས་ཀྱང་ཉོན་མོངས་༎ རྣམ་བདུན་ཡང་དག་མིན་རྟོག་ལས་༎
 tredhā saṃkleśaḥ | kleśasaṃkleśaḥ karmasaṃkleśaḥ janmasaṃkleśaś ca |	རྣམ་གསུམ་ནི་ཉོན་མོངས་པའི་ཀུན་ནས་ཉོན་མོངས་པ་དང་། ལས་ཀྱི་ཀུན་ནས་ཉོན་མོངས་པ་དང་། སྐྱེ་བའི་ཀུན་ནས་ཉོན་མོངས་པའོ་༎
 tatra kleśasaṃkleśo 'vidyātṛṣṇopādānāni |	དེ་ལ་ཉོན་མོངས་པའི་ཀུན་ནས་ཉོན་མོངས་པ་ནི་མ་རིག་པ་དང་སྲེད་པ་དང་ལེན་པ་རྣམས་སོ་༎ 
 karmasaṃkleśaḥ saṃskārā bhavaś ca |	ལས་ཀྱི་ཀུན་ནས་ཉོན་མོངས་པ་ནི་འདུ་བྱེད་རྣམས་དང་སྲེད་པའོ་༎
 janmasaṃkleśaḥ śeṣāṇy aṅgāni |	སྐྱེ་བའི་ཀུན་ནས་ཉོན་མོངས་པ་ནི་ཡན་ལག་ལྷག་མ་རྣམས་སོ་༎
 dvedhā saṃkleśaḥ | hetusaṃkleśaḥ phalasaṃkleśaś ca |	ཀུན་ནས་ཉོན་མོངས་པ་རྣམ་པ་གཉིས་ནི་རྒྱུའི་ཀུན་ནས་ཉོན་མོངས་པ་དང་། འབྲས་བུའི་ཀུན་ནས་ཉོན་མོངས་པའོ་༎
 (mvbh 22) tatra hetusaṃkleśaḥ kleśakarmasvabhāvair aṅgaiḥ phalasaṃkleśaś ca śeṣaiḥ |	དེ་ལ་རྒྱུའི་ཀུན་ནས་ཉོན་མོངས་པ་ནི་ཉོན་མོངས་པ་དང་། ལས་ཀྱི་ངོ་བོ་ཉིད་ཀྱི་ཡན་ལག་རྣམས་ཀྱིས་སོ་༎ འབྲས་བུའི་ཀུན་ནས་ཉོན་མོངས་༄༤ཨ་༌་༎ པ་ནི་ཡན་ལག་ལྷག་མ་རྣམས་ཀྱིས་སོ་༎
 saptadhā saṃkleśaḥ saptavidho hetuḥ | viparyāsahetuḥ | ākṣepahetuḥ i upanayahetuḥ | parigrahahetuḥ | upabhogahetuḥ | ākarṣaṇahetuḥ | udvegahetuś ca |	ཀུན་ནས་ཉོན་མོངས་པ་རྣམ་པ་བདུན་ནི་རྒྱུ་རྣམ་པ་བདུན་ཏེ་།
 tatra viparyāsahetur avidyā |	མ་རིག་པ་ནི་ཕྱིན་ཅི་ལོག་གི་རྒྱུའོ་༎
 ākṣepahetuḥ saṃskārāḥ |	འདུ་བྱེད་རྣམས་ནི་འབེབས་པའི་རྒྱུའོ་༎
 upanayahetur vijñānaṃ |	རྣམ་པར་ཤེས་པ་ནི་ཉེ་བར་ཁྲིད་པའི་རྒྱུའོ་༎
 parigrahahetur nāmarūpaṣaḍāyatane |	མིང་དང་གཟུགས་དང་སྐྱེ་མཆེད་དྲུག་ནི་ཀུན་འཛིན་པའི་རྒྱུའོ་༎
 upabhogahetuḥ sparśavedane |	རེག་པ་དང་ཚོར་བ་ནི་ཉེ་བར་སྤྱོད་པའི་རྒྱུའོ་༎
 ākarṣaṇahetus tṛṣṇopādānabhavāḥ |	སྲེད་པ་དང་། ལེན་པ་དང་། སྲིད་པ་ནི་སྡུད་པའི་རྒྱུའོ་༎
 udvegahetur jātijarāmaraṇe |	སྐྱེ་བ་དང་། རྒ་ཤི་ནི་སྐྱོ་བའི་རྒྱུའོ་༎
 sarvaś caiṣa saṃkleśo 'bhūtaparikalpāt pravartata iti |	ཀུན་ནས་ཉོན་མོངས་པ་འདི་དག་ཐམས་ཅད་ནི་ཡང་དག་པ་མ་ཡིན་པ་ཀུན་ཏུ་རྟོག་པ་ལས་འབྱུང་བའོ་༎ 
 [abhūtaparikalpapiṇḍārtha] piṇḍārthaḥ punar abhūtaparikalpasya navavidhaṃ lakṣaṇaṃ paridīpitaṃ bhavati | sallakṣaṇaṃ |	ཡང་དག་པ་མ་ཡིན་པ་ཀུན་ཏུ་རྟོག་པའི་དོན་བསྡུས་པ་ནི་ཡོད་པའི་ལས་འབྱུང་བའོ་༎ 
 asallakṣaṇaṃ svalakṣaṇaṃ |	མཚན་ཉིད་དང་། 
 saṃgrahalakṣaṇaṃ [| ] asallakṣaṇānupraveśopāyalakṣaṇaṃ | prabhedalakṣaṇaṃ | paryāyalakṣaṇaṃ |	མེད་པའི་མཚན་ཉིད་དང་། རང་གི་མཚན་ཉིད་དང་། བསྡུ་བའི་མཚན་ཉིད་དང་། མེད་པའི་མཚན་ཉིད་ལ་འཇུག་པའི་ཐབས་ཀྱི་མཚན་ཉིད་དང་། རབ་ཏུ་དབྱེ་བའི་མཚན་ཉིད་དང་། རྣམ་གྲངས་ཀྱི་མཚན་ཉིད་དང་། འཇུག་པའི་མཚན་ཉིད་དང་། ཀུན་ནས་ཉོན་མོངས་པའི་མཚན་ཉིད་དེ་།
 pravṛttilakṣaṇaṃ | saṃkleśalakṣaṇañ ca | [2| śūnyatā]	མཚན་ཉིད་རྣམ་པ་དགུ་བསྟན་པའོ་༎
 evam abhūtaparikalpaṃ khyāpayitvā yathā śūnyatā vijñeyā tan nirdiśati |	དེ་ལྟར་ཡང་དག་པ་མ་ཡིན་པ་ཀུན་ཏུ་རྟོག་པ་བརྗོད་ནས་། སྟོང་པ་ཉིད་ཇི་ལྟར་ཤེས་པར་བྱ་བ་དེ་སྟོན་ཏེ་། སྟོང་པ་ཉིད་ནི་མདོར་བསྡུ་ན་༎
 lakṣaṇaṃ cātha paryāyas tadartho bheda eva ca | sādhanaṃ ceti vijñeyaṃ śūnyatāyāḥ samāsataḥ || i|12 [a| sūnyatālakṣaṇa]	མཚན་ཉིད་དང་ནི་རྣམ་གྲངས་དང་༎ དེ་ཡི་དོན་དང་དབྱེ་བ་དང་༎ སྒྲུབ་པ་དག་སྟེ་ཤེས་པར་བྱ་༎
 kathaṃ lakṣaṇaṃ vijñeyaṃ |	ཞེས་བྱ་བའོ་༎ མཚན་ཉིད་ཇི་ལྟར་ཤེས་པར་བྱ་ཞེ་ན་།
 dvayābhāvo hy abhāvasya bhāvaḥ śūnyasya lakṣaṇaṃ |	གཉིས་དངོས་མེད་དང་དངོས་མེད་པའི་༎ དངོས་པོ་སྟོང་པའི་མཚན་ཉིད་དོ་༎
 dvayagrāhyagrāhakasyābhāvaḥ | tasya cābhāvasya bhāvaḥ śūnyatayā (mvbh 23)	གཉིས་པོ་གཟུང་བ་དང་འཛིན་པའི་དངོས་པོ་མེད་པ་དང་། དངོས་པོ་མེད་པ་དེའི་དངོས་པོ་ནི་སྟོང་པ་ཉིད་ཀྱི་མཚན་ཉིད་དོ་༎
 lakṣaṇam ity abhāvasvabhāvalakṣaṇatvaṃ śūnyatāyāḥ paridīpitaṃ bhavati |	དེ་ལྟར་དངོས་པོ་མེད་པའི་ངོ་བོ་ཉིད་ནི་སྟོང་པ་ཉིད་ཀྱི་མཚན་ཉིད་དུ་ཡོངས་སུ་བསྟན་པ་ཡིན་ནོ་༎ 
 yaś cāsau tadabhāvasvabhāvaḥ sa |	དངོས་པོ་མེད་པའི་ངོ་བོ་ཉིད་གང་ཡིན་པ་དེ་ནི་།
 na bhāvo nāpi cābhāvaḥ |	ཡོད་པ་མ་ཡིན་མེད་པའང་མིན་༎
 kathaṃ na bhāvo yasmāt dvayasyābhāvaḥ |	ཇི་ལྟར་ཡོད་པ་མ་ཡིན་ཞེ་ན་། འདི་ལྟར་གཉིས་པོ་དེའི་དངོས་པོ་མེད་པའོ་༎ ཇི་ལྟར་མེད་པ་ཡང་མ་ཡིན་ཞེ་ན་།
 kathaṃ nābhāvo yasmāt dvayābhāvasya bhāvaḥ | etac ca śūnyatāyā lakṣaṇaṃ |	འདི་ལྟར་གཉིས་པོའི་དངོས་པོ་མེད་པའི་དངོས་པོ་དེ་ནི་སྟོང་པ་ཉིད་ཀྱི་མཚན་ཉིད་དེ་།
 tasmād abhūtaparikalpān na pṛthaktvaikalakṣaṇaṃ || i|13	དེ་བས་ན་ཡང་དག་པ་མ་ཡིན་པ་ཀུན་ཏུ་རྟོག་པ་དང་། ཐ་དད་གཅིག་པའི་མཚན་ཉིད་མིན་༎
 pṛthaktve sati dharmād anyā dharmateti na yujyate |	ཐ་དད་པ་ཡིན་ན་ནི་ཆོས་ལ་ཆོས་ཉིད་གཞན་མ་ཡིན་པ་མི་རུང་སྟེ་།
 anityatāduḥkhatāvat |	མི་རྟག་པ་ཉིད་དང་། སྡུག་བསྔལ་བ་ཉིད་བཞིན་ནོ་༎
 ekatve sati viśuddhyālambanaṃ jñānaṃ na syāt sāmānyalakṣaṇañ ca |	གཅིག་པ་ཡིན་དུ་ཟིན་ན་ནི་རྣམ་པར་དག་པའི་དམིགས་པ་དང་། སྤྱིའི་༄༤བ་མཚན་ཉིད་དུ་མི་འགྱུར་ཏེ་།
 etena tattvānyatvavinirmuktaṃ lakṣaṇaṃ paridīpitaṃ bhavati | [b| sūnyatāparyāya]	དེས་དེ་ཉིད་དང་གཞན་ལས་རྣམ་པར་གྲོལ་བ་སྟོང་པ་ཉིད་ཀྱི་མཚན་ཉིད་ཡོངས་སུ་བསྟན་པ་ཡིན་ནོ་༎ 
 kathaṃ paryāyo vijñeyaḥ |	རྣམ་གྲངས་ཇི་ལྟར་རིག་པར་བྱ་ཞེ་ན་། སྟོང་པ་ཉིད་ནི་མདོར་བསྡུ་ན་༎
 tathatā bhūtakoṭiś cānimittaṃ paramārthatā | dharmadhātuś ca paryāyāḥ śūnyatāyāḥ samāsataḥ || i|14 [c| śūnyatāparyāyārtha]	དེ་བཞིན་ཉིད་དང་ཡང་དག་མཐའ་༎ མཚན་མ་མེད་དང་དོན་དམ་དང་༎ ཆོས་ཀྱི་དབྱིངས་ནི་རྣམ་གྲངས་སོ་༎
 kathaṃ paryāyārtho vijñeyaḥ |	རྣམ་གྲངས་ཀྱི་དོན་ཇི་ལྟར་ཤེས་པར་བྱ་ཞེ་ན་།
 ananyathāviparyāsatannirodhāryagocaraiḥ |	གཞན་མིན་ཕྱིན་ཅི་ལོག་མ་ཡིན་༎ དེ་འགོག་འཕགས་པའི་སྤྱོད་ཡུལ་དང་༎ འཕགས་པའི་ཆོས་ཀྱི་རྒྱུ་ཡི་ཕྱིར་༎
 hetutvāc cāryadharmāṇāṃ paryāyārtho yathākramaṃ || i|15	རྣམ་གྲངས་དོན་དེ་གོ་རིམས་བཞིན་༎
 ananyathārthena tathātā nityan tathaiveti kṛtvā [|	གཞན་མ་ཡིན་པའི་ཕྱིར་དེ་བཞིན་ཉིད་དེ་། རྟག་ཏུ་དེ་བཞིན་པའི་ཕྱིར་རོ་༎
 ] aviparyāsārthena bhūtakoṭiḥ viparyāsāvastutvāt |	ཕྱིན་ཅི་ལོག་མ་ཡིན་པའི་ཕྱིར་ཡང་དག་པའི་མཐའ་སྟེ་། ཕྱིན་ཅི་ལོག་གི་གཞི་མ་ཡིན་པའི་ཕྱིར་རོ་༎
 nimittanirodhārthenānimittaṃ sarvanimittābhāvāt |	མཚན་མ་འགོག་པའི་ཕྱིར་མཚན་མ་མེད་པ་སྟེ་། མཚན་མ་ཐམས་ཅད་མེད་པའི་ཕྱིར་རོ་༎
 āryajñānagocaratvāt paramārthaḥ |	འཕགས་པའི་ཡེ་ཤེས་ཀྱི་སྤྱོད་ཡུལ་ཡིན་པས་དོན་དམ་པ་སྟེ་།
 paramajñānaviṣayatvād [|	ཡེ་ཤེས་དམ་པའི་ཡུལ་ཡིན་པའི་ཕྱིར་རོ་༎
 ] āryadharmahetutvād dharmadhātuḥ | (mvbh 24) āryadharmāṇān tadālambanaprabhavatvāt |	འཕགས་པའི་ཆོས་ཀྱི་རྒྱུ་ཡིན་པས་ཆོས་ཀྱི་དབྱིངས་ཏེ་༏་འཕགས་པའི་ཆོས་རྣམས་ནི་དེ་ལ་དམིགས་པས་འབྱུང་བའི་ཕྱིར་རོ་༎
 hetvartho hy atra dhātvarthaḥ |	འདིར་དབྱིངས་ཀྱི་དོན་ནི་རྒྱུའི་དོན་ཏོ་༎
 [d| śūnyatāprabheda] kathaṃ śūnyatāyāḥ prabhedo jñeyaḥ |	སྟོང་པ་ཉིད་ཀྱི་རབ་ཏུ་དབྱེ་བ་ཇི་ལྟར་ཤེས་པར་བྱ་ཞེ་ན་།
 saṃkliṣṭā ca viśuddhā ca |	ཀུན་ནས་ཉོན་མོངས་རྣམ་པར་དག་། 
 ity asyāḥ prabhedaḥ |	ཅེས་བྱ་བ་སྟེ་། དེའི་རབ་ཏུ་དབྱེ་བ་སྟེ་༎ གང་གི་ཚེ་ཀུན་ནས་ཉོན་མོངས་པ་ལ་།
 kasyām avasthāyāṃ saṃkliṣṭā kasyāṃ viśuddhā |	གང་གི་ཚེ་རྣམ་པར་དག་ཅེ་ན་།
 samalā nirmalā ca sā |	དེ་ནི་དྲི་བཅས་དྲི་མ་མེད་༎
 yadā saha malena vartate tadā saṃkliṣṭā |	གང་གི་ཚེ་དྲི་མ་དང་བཅས་པར་དེའི་ཚེ་ཀུན་ནས་ཉོན་མོངས་པ་གནས་པའོ་༎
 yadā prahīṇamalā tadā viśuddhā |	གང་གི་ཚེ་དྲི་མ་སྤངས་པ་དེའི་ཚེ་རྣམ་པར་དག་པའོ་༎
 yadi samalā bhūtvā nirmalā bhavati kathaṃ vikāradharmiṇītvād anityā na bhavati | yasmād asyāḥ	གལ་ཏེ་དྲི་མ་དང་བཅས་པར་གྱུར་ལ་དྲི་མ་མེད་པར་ཡང་འགྱུར་ན་འགྱུར་བའི་ཆོས་ཅན་ཡིན་པས་ཇི་ལྟར་མི་རྟག་པར་མི་འགྱུར་ཞེ་ན་། དེ་ནི་འདི་ལྟར་༏་ཆུ་ཁམས་གསེར་དང་ནམ་མཁའ་རྣམས་༎
 abdhātukanakākāśaśuddhivac chuddhir iṣyate || i|1	དག་པ་བཞིན་དུ་དག་པར་འདོད་༎
 āgantukamalāpagamān na tu tasyāḥ svabhāvānyatvaṃ bhavati | [ṣoḍaśavidhā śūnyatā]	གློ་བུར་གྱི་དྲི་མ་དང་བྲལ་བ་ལ་བྱའི་དེའི་ངོ་བོ་ཉིད་གཞན་དུ་འགྱུར་བ་ནི་མ་ཡིན་ནོ་༎ 
 ayam aparaḥ prabhedaḥ ṣoḍaśavidhā śūnyatā | adhyātmaśūnyatā | bahirdhāśūnyatā | adhyātmabahirdhāśūnyatā |	གཞན་ཡང་རབ་ཏུ་དབྱེ་བ་ནི་སྟོང་པ་ཉིད་རྣམ་པ་བཅུ་དྲུག་པོ་འདི་ལྟ་ཡིན་ནོ་༎ 
 mahāśūnyatā |	སྟེ་། 
 śūnyatāśūnyatā | paramārthaśūnyatā | saṃskṛtaśūnyatā | asaṃskṛtaśūnyatā | atyantaśūnyatā | anavarāgrasūnyatā | anavakāraśūnyatā | prakṛtiśūnyatā | lakṣaṇaśūnyatā |	ནང་སྟོང་པ་ཉིད་དང་། ཕྱི་སྟོང་པ་ཉིད་དང་། ཕྱི་ནང་སྟོང་པ་ཉིད་དང་། ཆེན་པོ་སྟོང་པ་ཉིད་དང་། སྟོང་པ་ཉིད་སྟོང་པ་ཉིད་དང་། དོན་དམ་པ་སྟོང་པ་ཉིད་དང་། འདུས་བྱས་སྟོང་པ་ཉིད་དང་། འདུས་མ་བྱས་སྟོང་པ་ཉིད་དང་། མཐའ་ལས་འདས་པ་སྟོང་པ་ཉིད་དང་། ཐོག་མ་དང་ཐ་མ་མེད་པ་སྟོང་པ་ཉིད་དང་། དོར་བ་མེད་པ་སྟོང་པ་ཉིད་དང་། རང་བཞིན་སྟོང་པ་ཉིད་དང་། ཆོས་ཐམས་ཅད་སྟོང་པ་ཉིད་༄༥ཨ་༌་༎
 sarvadharmaśūnyatā | abhāvaśūnyatā | abhāvasvabhāvaśūnyatā ca |	དང་༏་རང་གི་མཚན་ཉིད་སྟོང་པ་ཉིད་དང་། དངོས་པོ་མེད་པ་སྟོང་པ་ཉིད་དང་། དངོས་པོ་མེད་པའི་ངོ་བོ་ཉིད་སྟོང་པ་ཉིད་དོ་༎
 saiṣā samāsato veditavyā |	དེ་ཡང་མདོར་བསྡུ་ན་ཞེས་བྱ་བར་རིག་པར་བྱའོ་༎
 bhoktṛbhojanataddehapratiṣṭhāvastuśūnyatā | (mvbh 25)	ཟ་བ་བཟའ་དང་དེ་ཡི་ལུས་༎ གནས་ཀྱི་གཞི་ཡི་སྟོང་པ་ཉིད་༎ དེ་ཡང་གང་གིས་ཇི་ལྟར་མཐོང་༎
 tac ca yena yathā dṛṣṭaṃ yadarthaṃtasya śūnyatā || i|171 tatra bhoktṛśūnyatā (|	གང་ཕྱིར་དེ་ཡང་སྟོང་པ་ཉིད་༎ དགེ་གཉིས་ཐོབ་པར་བྱ་བའི་ཕྱིར་༎ རྟག་ཏུ་སེམས་ཅན་ཕན་བྱའི་ཕྱིར་༎ འཁོར་བ་གཏང་བར་མི་བྱའི་ཕྱིར་༎ དགེ་བ་མི་ཟད་བྱ་བའི་ཕྱིར་༎ རིགས་ཀྱང་རྣམ་པར་དག་བྱའི་ཕྱིར་༎ མཚན་དང་དཔེ་བྱད་ཐོབ་བྱའི་ཕྱིར་༎ སངས་རྒྱས་ཆོས་རྣམས་དག་བྱའི་ཕྱིར་༎
 ) ādhyātmikāny āyatanāny ārabdhā bhojanaśūnyatā bāhyāni |	བྱང་ཆུབ་སེམས་དཔའ་སྒྲུབ་པར་བྱེད་༎ དེ་ལ་ཟ་བ་སྟོང་པ་ཉིད་ནི་ནང་གི་སྐྱེ་མཆེད་རྣམས་ལས་བརྩམས་སོ་༎ བཟའ་བ་སྟོང་པ་ཉིད་ནི་ཕྱི་རོལ་གྱི་རྣམས་སོ་༎
 taddehas tayor bhoktṛbhojanayor yad adhiṣṭhānaṃ śarīraṃ [|	དེའི་ལུས་ནི་ཟ་པ་དང་བཟའ་བ་དེ་གཉིས་ཀྱི་གནས་གང་ཡིན་པ་སྟེ་ཁོག་པའོ་༎
 ] tasya śūnyatādhyātmabahirdhāśūnyatety ucyate |	དེའི་སྟོང་པ་ཉིད་ནི་ཕྱི་ནང་སྟོང་པ་ཉིད་ཅེས་བྱའོ་༎
 pratiṣṭhāvastu bhājanalokaḥ [|	གནས་ཀྱི་གཞི་ནི་སྣོད་ཀྱི་འཇིག་རྟེན་ཏེ་།
 ] tasya vistīrṇatvāc chūnyatā mahāśūnyatety ucyate |	དེ་རྒྱ་ཆེ་བའི་ཕྱིར་དེའི་སྟོང་པ་ཉིད་ནི་ཆེན་པོ་སྟོང་པ་ཉིད་ཅེས་བྱའོ་༎
 tac cādhyātmikāyatanādi yena śūnyaṃ dṛṣṭaṃ śūnyatājñānena [|	ནང་གི་སྐྱེ་མཆེད་ལ་སོགས་པ་དེ་ཡང་གང་གིས་སྟོང་པར་མཐོང་ཞེ་ན་།
 ] tasya śūnyatā śūnyatāśūnyatā |	སྟོང་པ་ཉིད་ཤེས་པས་ཏེ་། དེའི་སྟོང་པ་ཉིད་ནི་སྟོང་པ་ཉིད་སྟོང་པ་ཉིད་དོ་༎
 yathā ca dṛṣṭaṃ paramārthākāreṇa tasya śūnyatā paramārtha śūnyatā |	ཇི་ལྟར་དོན་དམ་པའི་རྣམ་པར་མཐོང་བ་དེའི་སྟོང་པ་ཉིད་ནི་དོན་དམ་པ་སྟོང་པ་ཉིད་དོ་༎ 
 yadarthaṃ ca bodhisatvaḥ prapadyate tasya ca śūnyatā |	གང་གི་ཕྱིར་བྱང་ཆུབ་སེམས་དཔའ་སྒྲུབ་པར་བྱེད་པ་དེ་ཡང་སྟོང་པ་ཉིད་དོ་༎
 kimarthañ ca prapadyate |	ཅིའི་ཕྱིར་སྒྲུབ་པར་བྱེད་ཅེ་ན་།
 śubhadvayasya prāptyarthaṃ |	དགེ་གཉིས་ཐོབ་པར་བྱ་བའི་ཕྱིར་༎ ཞེས་བྱ་བ་སྟེ་།
 kuśalasya saṃskṛtasyāsaṃskṛtasya ca |	དགེ་བ་གཉིས་ནི་འདུས་བྱས་དང་འདུས་མ་བྱས་སོ་༎
 sadā satvahitāya ca |	རྟག་ཏུ་སེམས་ཅན་ཕན་བྱའི་ཕྱིར་༎
 atyantasatvahitārthaṃ |	ཞེས་བྱ་བ་ནི་སེམས་ཅན་ལ་གཏན་དུ་ཕན་པར་བྱ་བའི་ཕྱིར་རོ་༎
 saṃsārātyajanārthañ ca |	འཁོར་བ་གཏང་བར་མི་བྱའི་ཕྱིར་༎
 anavarāgrasya hi saṃsārasya śūnyatām apaśyan khinnaḥ saṃsāraṃ parityajeta |	ཞེས་བྱ་བ་ནི་འཁོར་བ་ཐོག་མ་དང་ཐ་མ་མེད་པ་སྟོང་པ་ཉིད་དུ་མ་མཐོང་ན་སྐྱོ་སྟེ་འཁོར་བ་ཡོངས་སུ་གཏོང་ངོ་༎
 kuśalasyākṣayāya ca || i|18	དགེ་བ་མི་ཟད་བྱ་བའི་ཕྱིར་༎
 nirupadhiśeṣe nirvāṇe 'pi yan nāvakirati notsṛjati tasya śūnyatā (| ) (mvbh 26) anavakāraśūnyatety ucyate |	ཞེས་བྱ་བ་ནི་ཕུང་པོ་ལྷག་མ་མེད་པའི་མྱ་ངན་ལས་འདས་པ་ན་ཡང་མི་གཏོང་ཞིང་མི་འདོར་བ་གང་ཡིན་པའོ་༎
 gotrasya ca viśuddhyarthaṃ |	རིགས་ཀྱང་རྣམ་པར་དག་བྱའི་ཕྱིར་༎ ཞེས་བྱ་བ་ལ་།
 gotraṃ hi prakṛtiḥ svābhāvikatvāt |	རིགས་ནི་རང་བཞིན་ཏེ་ངོ་བོ་ཉིད་ཀྱི་ཕྱིར་རོ་༎
 lakṣaṇavyañjanāptaye |	མཚན་དང་དབྱེ་བྱད་ཐོབ་བའི་ཕྱིར་༎
 mahāpuruṣalakṣaṇānāṃ sānuvyañjanānāṃ prāptaye |	ཞེས་བྱ་བ་ནི་། སྐྱེས་བུ་ཆེན་པོའི་མཚན་རྣམས་དང་། དཔེ་བྱད་བཟང་པོ་རྣམས་དང་བཅས་པ་ཐོབ་པར་བྱ་བའི་ཕྱིར་རོ་༎
 śuddhaye buddhadharmāṇāṃ bodhisatvaḥ prapadyate || i|19	སངས་རྒྱས་ཆོས་རྣམས་དག་བྱའི་ཕྱིར་༎ བྱང་ཆུབ་སེམས་དཔའ་སྒྲུབ་པར་བྱེད་༎
 balavaiśāradyāveṇikādīnāṃ |	ཅེས་བྱ་བ་ནི་སྟོབས་དང་མི་འཇིགས་པ་དང་མ་འདྲེས་པ་ལ་སོགས་པའོ་༎
 evan tāvac caturdaśānāṃ śūnyatānāṃ vyavasthānaṃ veditavyaṃ |	དེ་༄༥བ་ལྟར་རེ་ཞིག་སྟོང་པ་ཉིད་བཅུ་བཞི་རྣམ་པར་གཞག་པར་ཤེས་པར་བྱའོ་༎
 kā punar atra śūnyatā |	འདི་ལ་སྟོང་པ་ཉིད་གང་ཡིན་ཞེ་ན་།
 pudgalasyātha dharmāṇām abhāvaḥ śūnyatātra hi |	གང་ཟག་དང་ནི་ཆོས་རྣམས་ཀྱི་༎ དངོས་པོ་མེད་འདིར་སྟོང་པ་ཉིད་༎
 tadabhāvasya sadbhāvas tasmin sā śūnyatāparā || i|20	དེ་དངོས་མེད་པའི་དངོས་ཡོད་པ་༎ དེ་ནི་དེ་ལས་སྟོང་ཉིད་གཞན་༎ ཞེས་བྱ་བའོ་༎
 pudgaladharmābhāvaś ca śūnyatā |	གང་ཟག་དང་ཆོས་ཀྱི་དངོས་པོ་མེད་པ་ནི་སྟོང་པ་ཉིད་དོ་༎
 tadabhāvasya ca sadbhāvaḥ [|	དངོས་པོ་མེད་པ་དེའི་དངོས་པོ་ཡོད་པ་ཡང་ཡིན་ནོ་༎
 ] tasmin yathokte bhoktrādau sānyā śūnyateti [| ] śūnyatālakṣaṇakhyāpanārthaṃ dvividhām ante śūnyatāṃ vyavasthāpayati |	ཟ་བ་ལ་སོགས་པ་སྟོང་པ་ཉིད་ཅེས་གོང་དུ་ཇི་སྐད་སྨོས་པ་དེར་སྟོང་པ་ཉིད་ཀྱི་མཚན་ཉིད་བསྟན་པའི་ཕྱིར་།
 abhāvaśūnyatām abhāvasvabhāvaśūnyatāṃ ca |	དངོས་པོ་མེད་པ་སྟོང་པ་ཉིད་དང་། དངོས་པོ་མེད་པའི་ངོ་བོ་ཉིད་སྟོང་པ་ཉིད་དང་། སྟོང་པ་ཉིད་རྣམ་པ་གཉིས་ཐ་མར་རྣམ་པར་འཇོག་སྟེ་།
 pudgaladharmasamāropasya tacchūnyatāpavādasya ca parihārārthaṃ yathākramaṃ |	གང་ཟག་དང་ཆོས་སུ་སྒྲོ་འདོགས་པ་དང་། དེའི་སྟོང་པ་ཉིད་ལ་སྐུར་པ་འདེབས་པ་བསལ་བའི་ཕྱིར་གོ་རིམས་བཞིན་ནོ་༎
 evaṃ śūnyatāyāḥ prabhedo vijñeyaḥ | [e| śūnyatāsādhana]	དེ་ལྟར་སྟོང་པ་ཉིད་ཀྱི་རབ་ཏུ་དབྱེ་བ་ཤེས་པར་བྱའོ་༎
 kathaṃ sādhanaṃ vijñeyaṃ |	སྒྲུབ་པ་ཇི་ལྟར་ཤེས་པར་བྱ་ཞེ་ན་།
 saṃkliṣṭā ced bhaven nāsau muktāḥ syuḥ sarvadehinaḥ |	གལ་ཏེ་ཉོན་མོངས་དེ་མ་གྱུར་༎ ལུས་ཅན་ཐམས་ཅད་གྲོལ་བར་འགྱུར་༎
 viśuddhā ced bhaven nāsau vyāyāmo niṣphalo bhavet || i|21	གལ་ཏེ་རྣམ་དག་དེ་མ་གྱུར་༎ འབད་པ་འབྲས་བུ་མེད་པར་འགྱུར་༎
 yadi dharmāṇāṃ śūnyatā āgantukair upakleśair anutpanne (mvbh 27) 'pi pratipakṣe na saṃkliṣṭā bhavet saṃkleśābhāvād ayatnata eva muktāḥ sarvasatvā bhaveyuḥ |	གལ་ཏེ་གཉེན་པོ་མ་སྐྱེས་པར་ཡང་ཆོས་རྣམས་ཀྱི་སྟོང་པ་ཉིད་ཀྱིས་གློ་བུར་གྱི་ཉེ་བའི་ཉོན་མོངས་པ་རྣམས་ཀྱིས་ཀུན་ནས་ཉོན་མོངས་པར་མི་འགྱུར་ན་ནི་ཀུན་ནས་ཉོན་མོངས་པ་མེད་པས་འབད་པ་མེད་པར་སེམས་ཅན་ཐམས་ཅད་གྲོལ་བར་འགྱུར་རོ་༎ 
 athotpanne 'pi pratipakṣe na viśuddhā bhavet mokṣārtham ārambho niṣphalo bhavet |	ཅི་སྟེ་གཉེན་པོ་སྐྱེས་ཀྱང་རྣམ་པར་དག་པར་མི་འགྱུར་ན་ནི་ཐར་པར་བྱ་བའི་ཕྱིར་རྩོམ་པ་འབྲས་བུ་མེད་པར་འགྱུར་བར་འགྱུར་རོ་༎ རོ་༎ 
 evaṃ ca kṛtvā |	དེ་ལྟར་ན་།
 na kliṣṭā nāpi vākliṣṭā śuddhāśuddhā na caiva sā |	ཉོན་མོངས་མ་ཡིན་མི་མོངས་མིན་༎ དེ་ནི་དག་དང་མ་དག་མིན་༎
 kathaṃ na kliṣṭā nāpi cāśuddhā | prakṛtyaiva | prahhāsvaratvāc cittasya |	ཇི་ལྟར་ཉོན་མོངས་པར་གྱུར་པ་མ་ཡིན་ལ་མ་དག་པ་ཡང་མ་ཡིན་ཞེ་ན་སེམས་རང་བཞིན་གྱིས་འོད་གསལ་བའི་ཕྱིར་རོ་༎
 kathaṃ nākliṣṭā na śuddhā |	ཇི་ལྟར་ཉོན་མོངས་པར་གྱུར་པ་མ་ཡིན་པ་ཡང་མ་ཡིན་ལ་དག་པ་ཡང་མ་ཡིན་ཞེ་ན་། 
 kleśasyāgantukatvataḥ || i|22	གློ་བུར་གྱི་ཉོན་མོངས་པའི་ཕྱིར་རོ་༎
 evaṃ śūnyatāyā uddiṣṭaḥ prabhedaḥ sādhito bhavati |	དེ་ལྟར་སྟོང་པ་ཉིད་ཀྱི་རབ་ཏུ་དབྱེ་བ་བསྟན་པ་བསྒྲུབས་པ་ཡིན་ནོ་༎
 [śūnyatāpiṇḍārtha] tatra śūnyatāyāḥ piṇḍārthaḥ | lakṣaṇato vyavasthānataś ca veditavyaḥ |	དེ་ཡང་སྟོང་པ་ཉིད་ཀྱི་དོན་བསྡུས་པ་ནི་མཚན་ཉིད་རྣམ་པར་གཞག་པར་རིག་པར་བྱའོ་༎
 tatra lakṣaṇato 'bhāvalakṣaṇato bhāvalakṣaṇataś ca |	དེ་ལ་མཚན་ཉིད་ནི་དངོས་པོ་མེད་པའི་མཚན་ཉིད་དང་། དངོས་པོའི་མཚན་ཉིད་དོ་༎
 bhāvalakṣaṇaṃ punar bhāvābhāvavinirmuktalakṣaṇataś ca | tatvānyatvavinirmuktalakṣaṇataś ca |	དངོས་པོའི་མཚན་ཉིད་ཀྱང་དངོས་པོ་༄༦ཨ་༌་༎ ཡོད་པ་དང་དངོས་པོ་མེད་པ་ལས་རྣམ་པར་གྲོལ་བའི་མཚན་ཉིད་དང་། དེ་ཉིད་དང་གཞན་ལས་རྣམ་པར་གྲོལ་བའི་མཚན་ཉིད་དོ་༎
 vyavasthānaṃ punaḥ paryāyādivyavasthānato veditavyaṃ | tatraitayā catuḥprakāradeśanayā śūnyatāyāḥ svalakṣaṇaṃ | karmalakṣaṇaṃ |	རྣམ་པར་གཞག་པ་ནི་རྣམ་གྲངས་ལ་སོགས་པས་རྣམ་པར་གཞག་པར་རིག་པར་བྱའོ་༎
 saṃkleśavyavadānalakṣaṇaṃ | yuktilakṣaṇaṃ codbhāvitaṃ bhavati | vikalpatrāsakauśīdyavicikitsopaśāntaye |	དེ་ལ་རྣམ་པ་བཞི་པོ་འདི་དག་བསྟན་པས་ནི་རྣམ་པར་རྟོག་པ་དང་། སྐྲག་པ་དང་། ལེ་ལོ་དང་། ཐེ་ཚོམ་ཉེ་བར་ཞི་བར་བྱ་བའི་ཕྱིར་སྟོང་པ་ཉིད་རང་གི་མཚན་ཉིད་དང་། ལས་ཀྱི་མཚན་ཉིད་དང་། ཀུན་ནས་ཉོན་མོངས་པ་དང་། རྣམ་པར་བྱང་བའི་མཚན་ཉིད་དང་། རིགས་པའི་མཚན་ཉིད་བརྗོད་པ་ཡིན་ནོ་༎
 madhyāntavibhāge | akṣaṇaparicchedaḥ prathamaḥ || || (mvbh 28) [chapter ii| āvaraṇapariccheda] [1| vyāpyādipañcāvaraṇa]	བསྟན་བཅོས་དབུས་དང་མཐའ་རྣམ་པར་འབྱེད་པ་ལས་མཚན་ཉིད་ཀྱི་ལེའུར་བཅད་པ་ཞེས་བྱ་བ་སྟེ་དང་པོའི་འགྲེལ་པའོ་།
 āvaraṇam adhikṛtyāha |	༎ ། སྒྲིབ་པའི་དབང་དུ་མཛད་དེ་།
 vyāpiprādeśikodriktasamādānavivarjanaṃi |	ཁྱབ་དང་ཉི་ཚེ་ལྷག་པ་དང་༎ མཉམ་དང་ལེན་པ་དང་སྤོང་བ་ནི་༎
 dvayāvaraṇam ākhyātaṃ |	གཉིས་ཀྱི་སྒྲིབ་པར་བསྟན་པ་ཡིན་༎
 tatra vyāpi kleśajñeyāvaraṇaṃ bodhisatvagotrakāṇāṃ kaṃ sākalyāt |	ཞེས་བྱ་པ་གསུངས་སོ་༎ དེ་ལ་ཁྱབ་པ་ནི་བྱང་ཆུབ་སེམས་དཔའི་རིགས་ཅན་རྣམས་ཀྱི་ཉོན་མོངས་པ་དང་ཤེས་བྱའི་སྒྲིབ་པ་སྟེ་། མཐའ་དག་པ་སྒྲིབ་པའི་ཕྱིར་རོ་༎
 prādeśikaṃ kleśāvaranaṃ śrāvakādigotrakāṇāṃ |	ཉི་ཚེ་བ་ནི་ཉན་ཐོས་ལ་སོགས་པའི་རིགས་ཅན་རྣམས་ཀྱི་ཉོན་མོངས་པའི་སྒྲིབ་པའོ་༎ ལྷག་མ་ནི་དེ་དག་ཉིད་ཀྱི་སྒྲིབ་པ་སྟེ་།
 udriktaṃ teṣām eva rāgādicaritānāṃ |	འདོད་ཆགས་ལ་སོགས་པའི་སྤྱོད་པ་རྣམས་ཀྱི་སྒྲིབ་པའོ་༎
 samaṃ samabhāgacaritānāṃ |	མཉམ་པ་ནི་ཆ་མཚུངས་པར་སྤྱོད་པ་རྣམས་ཀྱི་སྒྲིབ་པའོ་༎
 saṃsārādānatyāgāvaraṇaṃ bodhisatvagotrakāṇām apratiṣṭhitanirvāṇāvaraṇād ity etad yathāyogam ubhayeṣām āvaraṇam ākhyātaṃ |	འཁོར་བ་ལེན་པ་དང་སྤོང་བའི་སྒྲིབ་པ་ནི་བྱང་ཆུབ་སེམས་དཔའི་རིགས་ཅན་རྣམས་ཀྱི་སྒྲིབ་པ་སྟེ་། མི་གནས་པའི་མྱ་ངན་ལས་འདས་པ་ལ་སྒྲིབ་པའི་ཕྱིར་རོ་༎
 bodhisatvagotrakānāṃ śrāvakādigotrakāṇāṃ ca | [2| prayoganavasaṃyojanāvaraṇa]	དེ་ལྟར་འདི་དག་ནི་ཅི་རིགས་པར་བྱང་ཆུབ་སེམས་དཔའི་རིགས་ཅན་རྣམས་དང་། ཉན་ཐོས་ལ་སོགས་པའི་རིགས་ཅན་རྣམས་དང་གཉི་གའི་སྒྲིབ་པར་བསྟན་ཏོ་༎
 punar	ཡང་།
 navadhā kleśalakṣaṇaṃ || ii|1	ཉོན་མོངས་མཚན་ཉིད་རྣམ་དགུའོ་༎
 saṃyojanāny āvaraṇaṃ |	ཀུན་ཏུ་སྦྱོར་རྣམས་སྒྲིབ་པ་ཡིན་༎
 nava saṃyojanāni (| ) kleśāvaraṇaṃ |	ཀུན་ཏུ་སྦྱོར་བ་དགུ་ནི་ཉོན་མོངས་པའི་སྒྲིབ་པའོ་༎
 kasyaitasyāvaraṇaṃ |	དེ་དག་གང་ལ་གང་སྒྲིབ་ཅེ་ན་།
 udvegasamupekṣayoḥ | tattva'dṛṣṭeś ca | anunayasaṃyojanaṃ saṃvegasyāvaraṇaṃ [|	སྐྱོ་བ་དང་བཏང་སྙོམས་དང་༎ དེ་ཁོ་ན་ནི་མཐོང་བ་དང་༎ རྗེས་སུ་ཆགས་པའི་ཀུན་ཏུ་སྦྱོར་བ་ནི་ཀུན་ཏུ་སྐྱོ་བ་ལ་སྒྲིབ་པའོ་༎
 ] pratighasaṃyojanam (mvbh 29) upekṣīyāḥ |	ཁོང་ཁྲོ་བའི་ཀུན་ཏུ་སྦྱོར་བ་ནི་བཏང་སྙོམས་ལ་སྒྲིབ་སྟེ་།
 tena hi pratikūlam api pratighavastu upekṣituṃ na śaknoti |	དེས་ནི་མི་མཐུན་༄༦བ་པ་ལ་ཁོང་ཁྲོ་བའི་གཞི་ལ་བཏང་སྙོམས་སུ་བྱེད་མི་ནུས་སོ་༎
 śeṣāni tattvadarśanasyāvaraṇaṃ |	ལྷག་མ་རྣམས་ནི་དེ་ཁོ་ན་མཐོང་བ་ལ་།
 kathaṃ kṛtvā |	ཇི་ལྟ་ཞེ་ན་།
 tāni hi yathākramaṃ |	དེ་དག་ནི་གོ་རིམས་བཞིན་དུ་།
 satkāyadṛṣṭes tadvastuno 'pi ca || ii|2 nirodhamārgaratneṣu lābhasatkāra eva ca | saṃlekhasya parijñāne |	འཇིག་ཚོགས་ལྟ་དང་དེའི་གཞི་དང་༎ འགོག་དང་ལམ་དང་དཀོན་མཆོག་དང་༎ རྙེད་པ་དང་ནི་བཀུར་སྟི་དང་༎ ཡོ་བྱད་བསྙུངས་པ་ཡོངས་ཤེས་ལ་༎
 saṃyojanāny āvaraṇaṃ bhavaṃti |	སྒྲིབ་པ་ཡིན་ནོ་༎
 mānasaṃyojanaṃ hi satkāyadṛṣṭiparijñāne bhavaty āvaraṇaṃ |	ང་རྒྱལ་གྱི་ཀུན་ཏུ་སྦྱོར་བ་ནི་འཇིག་ཚོགས་ལ་ལྟ་བ་ཡོངས་སུ་ཤེས་པ་ལ་སྒྲིབ་པ་སྟེ་། 
 abhisamayakāle sāntaravyantarāsmimānasamudācāravaśena tadaprahāṇāt |	མངོན་པར་རྟོགས་པའི་དུས་ན་ངའོ་སྙམ་པའི་ང་རྒྱལ་བར་ཆད་དང་བཅས་པ་དང་བར་ཆད་མེད་པར་ཀུན་ཏུ་འབྱུང་བའི་དབང་གིས་དེ་མ་སྤངས་པའི་ཕྱིར་རོ་༎
 avidyāsaṃyojanaṃ satkāyadṛṣṭivastuparijñāne |	མ་རིག་པའི་ཀུན་ཏུ་སྦྱོར་བ་ནི་འཇིག་ཚོགས་ལ་ལྟ་བའི་གཞི་ཡོངས་སུ་ཤེས་པ་ལ་སྒྲིབ་སྟེ་། 
 tenopādānaskandhāparijñānāt |	དེས་ཉེ་བར་ལེན་པའི་ཕུང་པོ་རྣམས་ཡོངས་སུ་མི་ཤེས་པའི་ཕྱིར་རོ་༎
 dṛṣṭisaṃyojanaṃ nirodhasatyaparijñāne |	ལྟ་བའི་ཀུན་ཏུ་སྦྱོར་བ་ནི་འགོག་པའི་བདེན་པ་ཡོངས་སུ་ཤེས་པ་ལ་སྒྲིབ་སྟེ་།
 satkāyāntagrāhadṛṣṭibhyāṃ taduttrāsāt [| ] mithyādṛṣṭyā cāpavādāt |	འཇིག་ཚོགས་དང་མཐར་འཛིན་པར་ལྟ་བ་གཉིས་ཀྱིས་དེ་ལ་སྐྲག་པ་དང་། ལོག་པར་ལྟ་བས་དེ་ལ་སྐུར་པ་འདེབས་པའི་ཕྱིར་རོ་༎
 parāmarśasaṃyojanaṃ mārgasatyaparijñāne | anyathāgraśuddhiparāmarṣaṇāt |	མཆོག་ཏུ་འཛིན་པའི་ཀུན་ཏུ་སྦྱོར་བ་ནི་ལམ་གྱི་བདེན་པ་ཡོངས་སུ་ཤེས་པ་ལ་སྒྲིབ་སྟེ་། རྣམ་པ་གཞན་གྱིས་མཆོག་གི་དག་པར་མཆོག་ཏུ་འཛིན་པའི་ཕྱིར་རོ་༎
 vicikitsāsaṃyojanaṃ ratnatrayaparijñāne tadguṇānabhiśraddhānāt |	ཐེ་ཚོམ་གྱི་ཀུན་ཏུ་སྦྱོར་བ་ནི་དཀོན་མཆོག་གསུམ་ཡོངས་སུ་ཤེས་པ་ལ་སྒྲིབ་སྟེ་། དེའི་ཡོན་ཏན་ལ་མངོན་པར་ཡིད་མི་ཆེས་པའི་ཕྱིར་རོ་༎
 īrṣyāsaṃyojanaṃ lābhasatkāraparijñāne taddoṣādarśanāt |	ཕྲག་དོག་གི་ཀུན་ཏུ་སྦྱོར་བ་ནི་རྙེད་པ་དང་། བཀུར་སྟི་ཡོངས་སུ་ཤེས་པ་ལ་སྒྲིབ་སྟེ་། དེའི་ཉེས་པ་མི་མཐོང་བའི་ཕྱིར་རོ་༎
 mātsaryasaṃyojanaṃ saṃlekhaparijñāne pariṣkārādhyavasānāt | [3| bodhisattvāvaraṇa]	སེར་སྣའི་ཀུན་ཏུ་སྦྱོར་བ་ནི་ཡོ་བྱད་བསྙུངས་པ་ཡོངས་སུ་ཤེས་པ་ལ་སྒྲིབ་སྟེ་། ཡོ་བྱད་ལ་ལྷག་པར་ཞེན་པའི་ཕྱིར་རོ་༎
 [a| daśaśubhādiṣv āvaraṇam] śubhādau daśadhāparaṃ || ii|3	དགེ་ལ་སོགས་པ་བཅུ་ལ་གཞན་༎
 aparaṃ punar āvaraṇaṃ | daśavidhe śubhādau veditavyaṃ |	དགེ་བ་ལ་སོགས་པ་རྣམ་པ་བཅུ་ལ་སྒྲིབ་པ་གཞན་དུ་རིག་པར་བྱའོ་༎
 kin tad āvaraṇaṃ ke ca śubhādayaḥ |	སྒྲིབ་པ་དེ་ནི་གང་། དགེ་བ་ལ་སོགས་པ་ནི་གང་ཞེ་ན་།
 aprayogo 'nāyatane 'yogavihitaś ca yaḥ |	སྦྱོར་བ་མེད་དང་སྐྱེ་མཆེད་མིན་༎ རྣལ་འབྱོར་མིན་པས་གང་བསྐྱེད་དང་༎ སྐྱེ་བ་མེད་དང་ཡིད་མི་བྱེད་༎
 notpattir amanaskāraḥ saṃbhārasyāprapūrṇatā || ii|4 gotramitrasya vaidhuryaṃ cittasya parikheditā | (mvbh 30) pratipatteś ca vaidhuryaṃ kuduṣṭajanavāsatā || ii|5	ཚོགས་ནི་རབ་ཏུ་མ་རྫོགས་དང་༎ རིགས་དང་བཤེས་གཉེན་མི་ལྡན་དང་༎ སེམས་ནི་ཡོངས་སུ་སྐྱོ་བ་དང་༎ སྒྲུབ་པ་དང་ཡང་མི་ལྡན་དང་༎ སྐྱེ་བོ་ངན་དང་འགྲོགས་པ་དང་༎ ༄༧ཨ་༌་༎ རང་གི་གནས་ངན་ལེན་གསུམ་ལས་༎
 dauṣṭhulyam avaśiṣṭatvaṃ trayāt prajñāvipakvatā |	ལྷག་མ་ཤེས་རབ་མ་སྨིན་དང་༎ རང་བཞིན་གྱིས་ནི་གནས་ངན་ལེན་༎
 prakṛtyā caiva dauṣṭhulyaṃ kauśīdyaṃ ca pramāditā || ii|6 saktir bhave ca bhoge ca līnacittatvam eva ca | aśraddhānadhimuktiś ca yathārutavicāraṇā || ii|7 saddharme 'gauravaṃ lābhe gurutā kṛpatā tathā |	ལེ་ལོ་དང་ཡང་བདག་མེད་དང་༎ སྲིད་དང་ལོངས་སྤྱོད་ཆགས་པ་དང་༎ སེམས་ནི་ཞུམ་པར་གྱུར་པ་དང་༎ མ་དད་པ་དང་མ་མོས་དང་༏་། སྒྲ་བཞིན་དུ་ནི་དཔྱོད་པ་དང་༎ དམ་ཆོས་ཆེད་ཆེར་མི་འཛིན་དང་༎ རྙེད་ལ་གདུ་དང་སྙིང་རྗེ་མེད་༎
 śrutavyasanam alpatvaṃ samādhyaparikarmitā || ii|8	ཐོས་པས་ཕོངས་དང་ཉུང་བ་དང་༎ ཏིང་འཛིན་སྐྱངས་པ་མ་བྱས་པའོ་༎
 etad āvaraṇaṃ |	དེ་དག་ནི་སྒྲིབ་པའོ་༎
 ke śubhādayaḥ |	དགེ་བ་ལ་སོགས་པ་གང་ཞེ་ན་༎
 śubhaṃ bodhiḥ samādānan dhīmattvābhrāntyanāvṛtī |	དགེ་དང་བྱང་ཆུབ་ཡང་དག་འཛིན་༎ བློ་ལྡན་འཁྲུལ་མེད་སྒྲིབ་པ་མེད་༎
 natyatrāso 'matsaritvaṃ vaśitvaṃ ca śubhādayaḥ || ii|9	བསྔོ་དང་མི་སྐྲག་སེར་སྣ་མེད་༎ དབང་ནི་དགེ་ལ་སོགས་པའོ་༎
 eṣāṃ śubhādīnāṃ kasya katy āvaraṇāni jñeyānīty āha |	ཞེས་བྱ་བའོ་༎ དགེ་བ་ལ་སོགས་པ་འདི་དག་ལ་གང་གང་ལ་སྒྲིབ་པ་དུ་ཡོད་པར་ཤེས་པར་བྱ་ཞེ་ན་། 
 trīṇi trīṇi ca eteṣāṃ jñeyāny āvaraṇāni hi |	དེ་དག་གི་ནི་སྒྲིབ་པ་རྣམས་༎ གསུམ་གསུམ་དག་ཏུ་ཤེས་པར་བྱ་༎ ཞེས་གསུངས་སོ་༎
 kuśalasya trīṇy āvaraṇāni | aprayogo 'nāyatanaprayogo 'yoniśaḥprayogaś ca |	དགེ་བ་ལ་སྒྲིབ་པ་གསུམ་ནི་སྦྱོར་བ་མེད་པ་དང་། སྐྱེ་མཆེད་མ་ཡིན་པ་ལ་སྦྱོར་བ་དང་། ཚུལ་བཞིན་མ་ཡིན་པ་ལ་སྦྱོར་བའོ་༎
 bodhes trīṇi kuśalasyānutpattir amanasikaraṇaṃ | aparipūrṇasaṃbhāratā ca |	བྱང་ཆུབ་ཀྱི་སྒྲིབ་པ་གསུམ་ནི་དགེ་བ་མི་བསྐྱེད་པ་དང་། ཡིད་ལ་མི་བྱེད་པ་དང་། ཚོགས་ཡོངས་སུ་མ་རྫོགས་པའོ་༎
 samādānaṃ bodhicittotpādaḥ |	ཡང་དག་པར་འཛིན་པ་ནི་བྱང་ཆུབ་ཏུ་སེམས་བསྐྱེད་པ་སྟེ་།
 tasya trīṇi gotravaidhuryaṃ kalyāṇamitravaidhuryaṃ | parikhedacittatā ca |	དེའི་སྒྲིབ་པ་གསུམ་ནི་རིགས་དང་མི་ལྡན་པ་དང་། དགེ་བའི་བཤེས་གཉེན་དང་མི་ལྡན་པ་དང་། སེམས་ཡོངས་སུ་སྐྱོ་བའོ་༎
 dhīmatvaṃ bodhisatvatā |	བློ་དང་ལྡན་པ་ནི་བྱང་ཆུབ་སེམས་དཔའ་ཉིད་དེ་།
 tasyāḥ prajñāne trīṇy āvaraṇāni pratipattivaidhuryaṃ kujanavāsaḥ | duṣṭajanavāsaś ca |	དེའི་རབ་ཏུ་ཤེས་པ་ལ་སྒྲིབ་པ་གསུམ་ནི་སྒྲུབ་པ་དང་མི་ལྡན་པ་དང་། སྐྱེ་བོ་ངན་པ་དང་འགྲོགས་པ་དང་། སྐྱེ་བོ་སྡང་བ་དང་འགྲོགས་པའོ་༎
 tatra kujano mūrkhajanaḥ [|	དེ་ལ་སྐྱེ་བོ་ངན་པ་ནི་སྐྱེ་བོ་བླུན་པའོ་༎
 ] duṣṭajanaḥ pratihataḥ |	སྐྱེ་བོ་སྡང་བ་ནི་ཞེ་འགྲས་པ་རྣམས་སོ་༎
 abhrāntes trīṇi viparyāsadauṣṭhulyaṃ | kleśādyāvaraṇatrayād anyatamāvaśiṣṭatā | vimuktiparipācinyāḥ (| ) prajñāyā aparipakvatā ca |	འཁྲུལ་པ་མེད་པ་ལ་སྒྲིབ་པ་གསུམ་ནི་ཕྱིན་ཅི་ལོག་གི་གནས་ངན་ལེན་དང་། ཉོན་མོངས་པ་ལ་སོགས་པའི་སྒྲིབ་པ་གསུམ་ལས་ལྷག་མ་གང་ཡང་རུང་བ་དང་། རྣམ་པར་གྲོལ་བ་ཡོངས་སུ་སྨིན་པར་བྱེད་པའི་ཤེས་རབ་ཡོངས་སུ་མ་སྨིན་པའོ་༎
 āvaraṇaprahāṇam anāvaraṇaṃ |	སྒྲིབ་པ་སྤངས་པ་ནི་སྒྲིབ་པ་མེད་པ་སྟེ་།
 tasya trīṇi sahajaṃ dauṣṭhulyaṃ | kauśīdyaṃ pramādaś ca |	དེ་ལ་སྒྲིབ་༄༧བ་པ་གསུམ་ནི་ལྷན་ཅིག་སྐྱེས་པའི་གནས་ངན་ལེན་དང་། ལེ་ལོ་དང་བག་མེད་པའོ་༎
 pariṇates trīṇi yair anyatra cittaṃ pariṇāmayati | nānuttarasyāṃ samyaksaṃbodhau [|] (mvbh 31) bhavasaktir bhogasaktir līnacittatā ca | atrāsasya trīṇi [|	ཡོངས་སུ་བསྔོ་བའི་སྒྲིབ་པ་གསུམ་ནི་གང་དག་གིས་སེམས་གཞན་དུ་ཡོངས་སུ་སྔོ་བར་བྱེད་ཀྱི་། བླ་ན་མེད་པ་ཡང་དག་པར་རྫོགས་པའི་བྱང་ཆུབ་ཏུ་ནི་ཡོངས་སུ་མི་བསྔོ་བ་སྟེ་། ། སྲིད་པ་ལ་ཆགས་པ་དང་། ལོངས་སྤྱོད་ལ་ཆགས་པ་དང་། སེམས་ཞུམ་པའོ་༎
 ] asaṃbhāvanā pudgale | anadhimuktir dharme | yathārutavicāraṇārthe |	མི་སྐྲག་པའི་སྒྲིབ་པ་གསུམ་ནི་གང་ཟག་ལ་མི་སྲིད་སྙམ་པ་དང་། ཆོས་ལ་མི་མོས་པ་དང་། དོན་ལ་སྒྲ་ཇི་བཞིན་དུ་དཔྱོད་པའོ་༎
 amātsaryasya trīṇi saddharme 'gauravaṃ |	སེར་སྣ་མེད་པའི་སྒྲིབ་པ་གསུམ་ནི་དམ་པའི་ཆོས་ལ་ཆེད་ཆེར་མི་འཛིན་པ་དང་རྙེད་པ་དང་། 
 lābhasatkārapūjāyāṃ gauravaṃ satveṣv akāruṇyaṃ ca |	བཀུར་སྟི་དང་། མཆོད་པ་ལ་ཆེད་ཆེར་འཛིན་པ་དང་། སེམས་ཅན་རྣམས་ལ་སྙིང་རྗེ་མེད་པའོ་༎
 vaśitvasya trīṇi yair vibhutvaṃ na labhate [|	དབང་གི་སྒྲིབ་པ་གསུམ་ནི་། གང་དག་གིས་དབང་བྱེད་པ་མི་འཐོབ་པ་སྟེ་།
 ] śrutavyasanaṃ dharmavyasanasaṃvartanīyakarmaprabhavanāt | alpaśrutatvaṃ | samādher aparikarmitatvaṃ ca |	ཆོས་ཀྱིས་ཕོངས་པར་འགྱུར་བའི་ལས་བསྐྱེད་པས་ཐོས་པས་ཕོངས་པ་དང་། ཐོས་པས་ཉུང་བ་དང་། ཏིང་ངེ་འཛིན་ཡོངས་སུ་སྦྱང་བ་མ་བྱས་པའོ་༎
 [b| daśa kāraṇāni] tat punar etad āvaraṇaṃ śubhādau yatrārthe daśa kāraṇāni tadarthādhikāreṇa veditavyaṃ |	སྒྲིབ་པ་འདི་ནི་དགེ་བ་ལ་སོགས་པ་དོན་གང་ལ་བྱེད་རྒྱུ་བཅུར་འགྱུར་བ་དོན་དེའི་སྐབས་ཀྱིས་རིག་པར་བྱ་སྟེ་།
 daśakāraṇāni [| ] utpattikāraṇaṃ tadyathā cakṣurādayaś cakṣurvijñānasya |	བྱེད་རྒྱུ་བཅུ་ལ་འབྱུང་བའི་བྱེད་རྒྱུ་ནི་དཔེར་ན་མིག་གི་རྣམ་པར་ཤེས་པ་ལ་སོགས་པའི་མིག་ལ་སོགས་པ་ལྟ་བུའོ་༎
 sthitikāraṇaṃ tad yathā catvāra āhārāḥ satvānāṃ |	གནས་པའི་བྱེད་རྒྱུ་ནི་དཔེར་ན་སེམས་ཅན་རྣམས་ཀྱི་ཟས་བཞི་ལྟ་བུའོ་༎
 dhṛtikāraṇaṃ yad yasyādhārabhūtaṃ |	རྟེན་པའི་བྱེད་རྒྱུ་ནི་གང་གི་གནས་སུ་གང་གྱུར་པ་སྟེ་།
 tad yathā bhājanalokaḥ satvalokasya |	དཔེར་ན་སེམས་ཅན་གྱི་འཇིག་རྟེན་གྱི་ཁམས་ཀྱི་སྣོད་ཀྱི་འཇིག་རྟེན་ལྟ་བུའོ་༎
 abhivyaktikāraṇaṃ | tad yathā [| ] āloko rūpasya |	གསལ་བའི་བྱེད་རྒྱུ་ནི་དཔེར་ན་གཟུགས་ཀྱི་སྣང་བ་ལྟ་བུའོ་༎
 vikārakāraṇaṃ | tad yathāgnyādayaḥ pākyādīnāṃ |	འགྱུར་བའི་བྱེད་རྒྱུ་ནི་དཔེར་ན་བཙོ་བ་ལ་སོགས་པའི་མེ་ལ་སོགས་པ་ལྟ་བུའོ་༎
 viśleṣakāraṇaṃ tad yathā dātrādayaḥ cchedyādīnāṃ | pariṇatikāraṇaṃ |	འབྲལ་བའི་བྱེད་རྒྱུ་ནི་དཔེར་ན་བརྡ་བར་བྱ་བ་ལ་སོགས་པའི་ཟོར་བ་ལ་སོགས་པ་ལྟ་བུའོ་༎ 
 tad yathā suvarṇakārādayaḥ suvarṇādīnāṃ kaṭakādibhāvena pariṇatau |	སྒྱུར་བའི་བྱེད་རྒྱུ་ནི་དཔེར་ན་གསེར་ལ་སོགས་པའི་གསེར་མགར་ལ་སོགས་པ་ལྟ་བུ་བུའོ་༎ སྟེ་། གང་བུ་ལ་སོགས་པའི་དངོས་པོར་བསྒྱུར་བའོ་༎
 saṃpratyayakāraṇaṃ | tad yathā dhūmādayo 'gnyādīnāṃ |	ཡིད་ཆེས་པའི་བྱེད་རྒྱུ་ནི་དཔེར་ན་མེ་ལ་སོགས་པའི་དུ་བ་ལ་སོགས་པ་ལྟ་བུའོ་༎
 saṃpratyāyanankāraṇaṃ | tad yathā hetuḥ pratijñāyāḥ [|	ཡིད་ཆེས་པར་བྱེད་པའི་བྱེད་རྒྱུ་ནི་དཔེར་ན་དམ་བཅས་པ་དང་གཏན་ཚིགས་ལྟ་བུའོ་༎
 ] prāptikāraṇaṃ |	འཐོབ་པའི་བྱེད་རྒྱུ་ནི་དཔེར་ན་མྱ་ངན་ལས་༄༨ཨ་༌་༎
 tad yathā mārgādayo nirvāṇādīnāṃ |	འདས་པ་ལ་སོགས་པའི་ལམ་ལ་སོགས་པ་ལྟ་བུའོ་༎
 evam utpattyāvaraṇaṃ śubhe draṣṭavyaṃ tasyotpādanīyatvāt |	དེ་བཞིན་དུ་སྐྱེ་བ་ལ་སྒྲིབ་པ་ནི་དགེ་བ་ལ་སྒྲིབ་པ་སྟེ་དེ་བསྐྱེད་པར་བྱ་བའི་ཕྱིར་རོ་༎ 
 sthityāvaraṇaṃ bodhau tasyā akopyatvād [|	གནས་པ་ལ་སྒྲིབ་པ་ནི་བྱང་ཆུབ་ལ་སྒྲིབ་སྟེ་དེ་མི་འཁྲུགས་པའི་ཕྱིར་རོ་ཕྱིར་རོ་༎ 
 ] dhṛtyāvaraṇaṃ samādāne bodhicittasyādhārabhūtatvād [|	༎ རྟེན་གྱི་སྒྲིབ་པ་ནི་ཡང་དག་པར་འཛིན་པ་ལ་སྒྲིབ་སྟེ་། བྱང་ཆུབ་ཀྱི་སེམས་གཞིར་གྱུར་པའི་ཕྱིར་རོ་༎
 ] abhivyaktyāvaraṇaṃ dhīmatve tasya prakāśanīyatvāt |	གསལ་བ་ལ་སྒྲིབ་པ་ནི་བློ་དང་ལྡན་པ་ལ་སྒྲིབ་སྟེ་། དེ་བསྟན་པར་བྱ་བའི་ཕྱིར་རོ་༎
 vikārāvaraṇam abhrāntau tasyā (mvbh 32)	འགྱུར་བ་ལ་སྒྲིབ་པ་ནི་འཁྲུལ་པ་མེད་པ་ལ་སྒྲིབ་སྟེ་།
 bhrāntiparivṛttitvena vikāratvāt |	དེ་ནི་འཁྲུལ་པ་ལྡོག་པས་འགྱུར་བའི་ཕྱིར་རོ་༎
 viśleṣāvaraṇam anāvaraṇe tasyāvaraṇavisaṃyogatvāt [|	འབྲལ་བ་ལ་སྒྲིབ་པ་ནི་སྒྲིབ་པ་མེད་པ་ལ་སྒྲིབ་སྟེ་། དེའི་སྒྲིབ་པ་དང་བྲལ་བའི་ཕྱིར་རོ་༎
 ] pariṇatyāvaraṇaṃ natau bodhau cittapariṇatilakṣaṇatvāt |	སྒྱུར་བ་ལ་སྒྲིབ་པ་ནི་བསྔོ་བ་ལ་སྒྲིབ་སྟེ་། བྱང་ཆུབ་ཏུ་སེམས་ཡོངས་སུ་བསྔོ་བའི་མཚན་ཉིད་ཀྱི་ཕྱིར་རོ་༎
 saṃpratyayāvaraṇam atrāse |	ཡིད་ཆེས་པ་ལ་སྒྲིབ་པ་ནི་མི་སྐྲག་པ་ལ་སྒྲིབ་སྟེ་།
 asaṃpratyayena trasanāt |	ཡིད་མི་ཆེས་པས་སྐྲག་པའི་ཕྱིར་རོ་༎
 saṃpratyāyanāvaraṇam amatsaritve dharmāmatsaritvena parasaṃpratyāyanāt |	ཡིད་ཆེས་པར་བྱེད་པ་ལ་སྒྲིབ་པ་ནི་སེར་སྣ་མེད་པ་ལ་སྒྲིབ་སྟེ་། ཆོས་ལ་སེར་སྣ་མེད་པས་གཞན་ཡིད་ཆེས་པར་བྱེད་པའི་ཕྱིར་རོ་༎
 prāptyāvaraṇaṃ vaśitve tasya vibhutvaprāptilakṣaṇatvāt |	ཐོབ་པ་ལ་སྒྲིབ་པ་ནི་དབང་ལ་སྒྲིབ་སྟེ་། དབང་བྱེད་པ་ཐོབ་པའི་མཚན་ཉིད་ཀྱི་ཕྱིར་རོ་༎
 kāraṇaṃ daśadhotpattau sthitau dhṛtyāṃ prakāśane | vikāraviśleṣanatipratyayaprāyaṇāptiṣu ||	བྱེད་རྒྱུ་བཅུ་ནི་སྐྱེ་བ་དང་༎ གནས་པ་རྟེན་དང་བསྟན་བྱ་དང་༎ འགྱུར་དང་འབྲལ་དང་གཞན་དུ་དང་༎ ཡིད་ཆེས་གོ་འབྱེད་འཐོབ་རྣམས་ལ་༎
 cakṣurāhārabhūdīpavahnyādis tadudāhṛtiḥ |	མིག་དང་ཟས་ས་མར་མེ་དང་༎ མེ་ལ་སོགས་པ་དེ་ཡི་དཔེ་༎
 dātraśilpajñatādhūmahetumārgādayo 'pare ||	ཟོར་བ་བཟོ་ཤེས་དུ་བ་དང་༎ རྒྱུ་དང་ལམ་ལ་སོགས་པ་གཞན་༎ དགེ་བ་ལ་སོགས་པའི་གོ་རིམས་ནི་འདི་ཡིན་ཏེ་།
 bodhiprāptukāmenādita eva tāvat kuśalamūlam utpādayitavyaṃ |	བྱང་ཆུབ་ཐོབ་པར་འདོད་པས་ཐོག་མ་ཉིད་དུ་དགེ་བའི་རྩ་བ་བསྐྱེད་པར་བྱའོ་༎
 tataḥ kuśalamūlabalādhānena bodhiḥ prāptavyā |	དེའི་འོག་ཏུ་དགེ་བའི་རྩ་བའི་སྟོབས་བསྐྱེད་ན་བྱང་ཆུབ་ཐོབ་པར་བྱའོ་༎
 tasyāḥ punaḥ kuśalamūlotpatter bodhicittaṃ pratiṣṭhā [|	དགེ་བའི་རྩ་བ་བསྐྱེད་པ་དེའི་གནས་ནི་བྱང་ཆུབ་ཀྱི་སེམས་སོ་༎
 ] tasya bodhicittasya bodhisatva āśrayaḥ [|	བྱང་ཆུབ་ཀྱི་སེམས་དེའི་གནས་ནི་བྱང་ཆུབ་སེམས་དཔའོ་༎
 ] tena punar utpāditabodhicittena kuśalamūlabalādhānaprāptena bodhisatvena viparyāsaṃ prahāya aviparyāsa utpāditavyaḥ |	བྱང་ཆུབ་ཀྱི་སེམས་བསྐྱེད་དེ་། དགེ་བའི་རྩ་བའི་སྟོབས་བསྐྱེད་པ་ཐོབ་པའི་བྱང་ཆུབ་སེམས་དཔའ་དེས་ཕྱིན་ཅི་ལོག་སྤང་བའི་ཕྱིར་ཕྱིན་ཅི་མ་ལོག་པ་བསྐྱེད་པར་བྱའོ་༎
 tato darśanamārge 'viparyaste bhāvanāmārge sarvāvaraṇāni prahātavyāni |	དེའི་འོག་ཏུ་མཐོང་བའི་ལམ་ལ་ཕྱིན་ཅི་མ་ལོག་པས་བསྒོམ་༄༨བ་པའི་ལམ་གྱི་སྒྲིབ་པ་ཐམས་ཅད་སྤང་བར་བྱའོ་༎
 prahīṇāvaraṇena sarvāṇi kuśalamūlāni anuttarāyāṃ samyaksaṃbodhau pariṇāmayitavyāni |	སྒྲིབ་པ་སྤངས་ནས་དགེ་བའི་རྩ་བ་ཐམས་ཅད་བླ་ན་མེད་པ་ཡང་དག་པར་རྫོགས་པའི་བྱང་ཆུབ་ཏུ་ཡོངས་སུ་བསྔོ་བར་བྱའོ་༎
 tataḥ pariṇāmanābalādhānena gambhīrodāradharmadeśanāsu nottrasitavyaṃ |	དེའི་འོག་ཏུ་བསྔོ་བའི་སྟོབས་བསྐྱེད་ནས་ཆོས་ཟབ་ཅིང་རྒྱ་ཆེ་བ་བསྟན་པ་དག་ལ་མི་སྐྲག་པར་བྱའོ་༎ 
 tathānuttrastamānasena dharmeṣu guṇadarśinā pareṣāṃ te dharmā vistareṇa saṃprakāśayitavyās [|	དེ་ལྟར་མི་སྐྲག་པའི་ཡིད་ཀྱིས་ཆོས་རྣམས་ཀྱི་ཡོན་ཏན་མཐོང་ནས་གཞན་དག་ལ་ཆོས་དེ་དག་རྒྱ་ཆེར་ཡང་དག་པར་བསྟན་པར་པར་བྱའོ་༎ བྱའོ་༎ 
 ] tataḥ sa bodhisatva evaṃ vicitraguṇabalādhānaprāptaḥ kṣipram (mvbh 33) anuttarāṃ samyaksaṃbodhim anuprāptavān sarvadharmavaśitām anuprāpnotīty eṣo 'nukramaḥ (| ) śubhādīnāṃ [|] [4| bodhipakṣyapāramitābhūmiṣv āvaraṇam]	དེའི་འོག་ཏུ་བྱང་ཆུབ་སེམས་དཔའ་དེ་ལྟར་ཡོན་ཏན་སྣ་ཚོགས་ཀྱི་སྟོབས་བསྐྱེད་པ་ཐོབ་པ་དེ་མྱུར་དུ་བླ་ན་མེད་པ་ཡང་དག་པར་རྫོགས་པའི་བྱང་ཆུབ་ཐོབ་ནས་ཆོས་ཐམས་ཅད་ལ་དབང་འཐོབ་པོ་༎
 pakṣyapāramitābhūmiṣv anyad āvaraṇaṃ punaḥ || ii|10	ཕྱོགས་དང་ཕ་རོལ་ཕྱིན་ས་ལ་༎ སྒྲིབ་པ་དག་ནི་གཞན་ཡིན་ནོ་༎
 [a| bodhipakṣyeṣv āvaraṇam]	བྱང་ཆུབ་ཀྱི་ཕྱོགས་ཀྱི་ཆོས་རྣམས་ལ་སྒྲིབ་པ་ནི་།
 bodhipakṣyeṣu tāvat | vastvakauśalakausīdyaṃ samādher dvayahinatā | aropaṇātha daurbalyaṃ dṛṣṭidauṣṭhulyaduṣṭatā || ii|11	གཞི་ལ་མི་མཁས་ལེ་ལོ་དང་༎ གཉིས་ཀྱིས་ཏིང་འཛིན་ཉམས་པ་དང་༎ མི་སྐྱེད་པ་དང་ཉམ་ཆུང་དང་༎ ལྟ་དང་གནས་ངན་ལེན་སྐྱོན་ཆགས་༎
 smṛtyupasthāneṣu vastvakauśalam āvaraṇaṃ |	གཞི་ལ་མི་མཁས་པ་ནི་དྲན་པ་ཉེ་བར་གཞག་པ་རྣམས་ལ་སྒྲིབ་པོ་༎
 samyakprahāṇeṣu kausīdyaṃ [|	ལེ་ལོ་ནི་ཡང་དག་པར་སྤོང་བ་རྣམས་ལ་སྒྲིབ་པོ་༎
 ] ṛddhipādeṣu samādher dvayahīnatā [| ] paripūryā ca cchandavīryacittamīmānsānām anyatamavaikalyāt | bhāvanayā ca prahāṇasaṃskāravaikalyāt |	གཉིས་ཀྱི་ཏིང་ངེ་འཛིན་ཉམས་པ་ནི་འདུན་པ་དང་། བརྩོན་འགྲུས་དང་སེམས་པ་དང་། དཔྱོད་པ་རྣམས་ལས་གང་ཡང་རུང་བ་ཞིག་མ་ཚང་བས་ཡོངས་སུ་མ་རྫོགས་པ་དང་། སྤོང་བའི་འདུ་བྱེད་བསྒོམ་པ་མ་ཚང་བས་རྫུ་འཕྲུལ་གྱི་རྐང་པ་རྣམས་ལ་སྒྲིབ་པོ་༎
 indriyeṣu mokṣabhāgīyānām aropaṇaṃ |	ཐར་བའི་ཆ་དང་མཐུན་པ་རྣམས་མི་སྐྱེད་བ་ནི་དབང་པོ་རྣམས་ལ་སྒྲིབ་པོ་༎
 baleṣu teṣām evendriyāṇāṃ daurbalyaṃ vipakṣavyavakiraṇāt |	དབང་པོ་དེ་དག་ཉམ་ཆུང་བ་ནི་སྟོབས་རྣམས་ལ་སྒྲིབ་སྟེ་། མི་མཐུན་པའི་ཕྱོགས་དང་འདྲེས་པའི་ཕྱིར་རོ་༎
 bodhyaṅgeṣu dṛṣṭidoṣaḥ teṣāṃ darśanamārgaprabhāvitatvāt |	ལྟ་བའི་ཉེས་པ་ནི་བྱང་ཆུབ་ཀྱི་ཡན་ལག་རྣམས་ལ་སྒྲིབ་སྟེ་། དེ་དག་མཐོང་བའི་ལམ་གྱིས་རབ་ཏུ་ཕྱེ་བའི་ཕྱིར་རོ་༎
 mārgāṅgeṣu dauṣṭhulyadoṣaḥ |	གནས་ངན་ལེན་གྱི་ཉེས་པ་ནི་ལམ་གྱི་ཡན་ལག་རྣམས་ལ་སྒྲིབ་སྟེ་།
 teṣāṃ bhāvanāmārgaprabhāvitatvāt |	དེ་དག་བསྒོམ་པའི་ལམ་གྱིས་རབ་ཏུ་ཕྱེ་བའི་ཕྱིར་རོ་༎
 [b| pāramitāsv āvaraṇam]	ཕ་རོལ་ཏུ་ཕྱིན་པ་རྣམས་ལ་སྒྲིབ་པ་ནི་།
 pāramitāsv āvaraṇaṃ | (mvbh 34) aiśvaryasyātha sugateḥ satvātyāgasya cāvṛtiḥ |	ཕྱུག་པོ་དང་ནི་བདེ་འགྲོ་དང་༎ སེམས་ཅན་མི་གཏོང་སྒྲིབ་པ་དང་༎ ཉེས་པ་དག་དང་ཡོན་ཏན་རྣམས་༎
 hānivṛddhyoś ca doṣāṇāṃ guṇānām avatāraṇe || ii|12	འབྲི་དང་འཕེལ་དང་འཛུད་པ་དང་༎ གྲོལ་བར་བྱེད་དང་༄༩ཨ་༌་༎
 vimocane 'kṣayatve ca nairantarye śubhasya ca |	མི་ཟད་དང་༎ དགེ་བ་རྒྱུན་མི་འཆད་པ་དང་༎ ངེས་པར་བྱེད་དང་ཆོས་རྣམས་ལ་༎
 niyatīkaraṇe dharmasaṃbhogaparipācane || ii|13	ལོངས་པར་སྤྱོད་དང་ཡོངས་སྨིན་བྱེད་༎
 atra daśānāṃ pāramitānāṃ yasyāḥ pāramitāyāḥ yat phalaṃ tadāvaraṇena tasyā āvaraṇam udbhāvitaṃ bhavati |	འདི་ལ་ཕ་རོལ་ཏུ་ཕྱིན་པ་བཅུ་པོ་དག་ནི་ཕ་རོལ་ཏུ་ཕྱིན་པ་གང་གི་འབྲས་བུ་གང་ཡིན་པ་དེ་ལ་སྒྲིབ་པས་དེའི་སྒྲིབ་པ་ཞེས་བརྗོད་པ་ཡིན་ནོ་༎
 tatra dānapāramitāyāḥ aiśvaryādhipatyāvaraṇam āvaraṇaṃ |	དེ་ལ་སྦྱིན་པའི་ཕ་རོལ་ཏུ་ཕྱིན་པའི་འབྲས་བུ་ཕྱུག་པོ་དང་། བདག་པོ་ལ་སྒྲིབ་པས་སྒྲིབ་པའོ་༎
 śīlapāramitāyāḥ sugatyāvaraṇaṃ kṣāntipāramitāyāḥ satvāparityāgāvaraṇaṃ |	ཚུལ་ཁྲིམས་ཀྱི་ཕ་རོལ་ཏུ་ཕྱིན་པའི་འབྲས་བུ་བདེ་འགྲོ་ལ་སྒྲིབ་པོ་༎ བཟོད་པའི་ཕ་རོལ་ཏུ་ཕྱིན་པའི་འབྲས་བུ་སེམས་ཅན་ཡོངས་སུ་མི་གཏོང་བ་ལ་སྒྲིབ་པོ་༎
 vīryapāramitāyā doṣaguṇahānivṛddhyāvaraṇaṃ |	བརྩོན་འགྲུས་ཀྱི་ཕ་རོལ་ཏུ་ཕྱིན་པའི་འབྲས་བུ་ཉེས་པ་དང་ཡོན་ཏན་འབྲི་ཞིང་འཕེལ་བ་ལ་སྒྲིབ་པོ་༎ 
 dhyānapāramitāyā vineyāvatāraṇāvaraṇaṃ |	བསམ་གཏན་གྱི་ཕ་རོལ་ཏུ་ཕྱིན་པའི་འབྲས་བུ་གདུལ་བྱ་འཇུད་པ་ལ་སྒྲིབ་པོ་སྒྲིབ་པོ་༎ 
 prajñāpāramitāyāḥ vimocanāvaraṇaṃ |	༎ ཤེས་རབ་ཀྱི་ཕ་རོལ་ཏུ་ཕྱིན་པའི་འབྲས་བུ་རྣམ་པར་གྲོལ་བར་བྱེད་པ་སྒྲིབ་པོ་༎ 
 upāyakauśalyapāramitāyā dānādyakṣayatvāvaraṇaṃ |	༎ ལ་སྒྲིབ་པོ་༎ ཐབས་ཀྱི་ཕ་རོལ་ཏུ་ཕྱིན་པའི་འབྲས་བུ་སྦྱིན་པ་ལ་སོགས་པ་མི་ཟད་པ་ལ་སྒྲིབ་སྟེ་།
 bodhipariṇāmanayā tadakṣayatvāt |	བྱང་ཆུབ་ཏུ་ཡོངས་སུ་བསྔོས་པས་དེ་མི་ཟད་པའི་ཕྱིར་རོ་༎
 praṇidhānanpāramitāyāḥ sarvajanmasu kuśalanairantaryapravṛttyāvaraṇaṃ [|	སྨོན་ལམ་གྱི་ཕ་རོལ་ཏུ་ཕྱིན་པའི་འབྲས་བུ་ཚེ་རབས་ཐམས་ཅད་དུ་དགེ་བ་རྒྱུན་མི་འཆད་པར་འབྱུང་བ་ལ་སྒྲིབ་སྟེ་།
 ] praṇidhānavaśena tadanukūlopapattiparigrahād [[] balapāramitāyās tasyaiva kuśalasya niyatīkaraṇāvaraṇaṃ | pratisaṃkhyānabhāvanābalābhyāṃ vipakṣānabhibhavāt |	སྨོན་ལམ་གྱི་དབང་གིས་དེ་དང་མཐུན་པའི་སྐྱེ་བ་ཡོངས་སུ་འཛིན་པའི་ཕྱིར་རོ་༎ སྟོབས་ཀྱི་ཕ་རོལ་ཏུ་ཕྱིན་པའི་འབྲས་བུ་དགེ་བ་དེ་ཉིད་ངེས་པར་བྱེད་པ་ལ་སྒྲིབ་སྟེ་། སོ་སོར་བརྟགས་པ་དང་བསྒོམས་པའི་སྟོབས་ཀྱིས་མི་མཐུན་པའི་ཕྱོགས་ཀྱིས་ཟིལ་གྱིས་མི་གནོན་པའི་། ཕྱིར་རོ་༎ 
 jñānapāramitāyāḥ ātmaparayor dharmasaṃbhogaparipācanāvaraṇam āvaraṇaṃ |	ཡེ་ཤེས་ཀྱི་ཕ་རོལ་ཏུ་ཕྱིན་པའི་འབྲས་བུ་བདག་དང་གཞན་ཆོས་ལ་ལོངས་། ཕྱིར་རོ་༎ སྤྱོད་པ་དང་། ཡོངས་སུ་སྨིན་པར་བྱེད་པ་ལ་སྒྲིབ་སྟེ་།
 ayathārutaśrutārthāvabodhāt | [c| bhūmiṣv āvaraṇam]	ཐོས་པའི་དོན་སྒྲ་ཇི་བཞིན་མ་ཡིན་པར་ཁོང་དུ་ཆུད་པའི་ཕྱིར་རོ་༎
 bhūmiṣu punar yathākramaṃ |	ས་རྣམས་ལ་ཡང་གོ་རིམས་བཞིན་ཏེ་།
 sarvatragārthe agrārthe niṣyandāgrārtha eva ca | (mvbh 35)	ཀུན་ཏུ་འགྲོ་དོན་མཆོག་གི་དོན་༎
 niṣparigrahatārthe ca santānābheda eva ca || ii|14 niḥsaṃkleśaviśuddhyarthe 'nānātvārtha eva ca | ahīnānadhikārthe ca caturdhāvaśitāśraye || ii|15	རྒྱུ་མཐུན་དོན་གྱི་མཆོག་ཉིད་དང་༎ ཡོངས་སུ་འཛིན་པ་མེད་དོན་དང་༎ རྒྱུད་རྣམས་ཐ་དད་མེད་དོན་དང་༎ ཉོན་མོངས་རྣམ་དག་མིན་དོན་དང་༎ ཐ་དད་མེད་པའི་དོན་ཉིད་དང་༎ བྲི་མེད་འཕེལ་བ་མེད་དོན་དང་༎ དབང་ནི་རྣམ་པ་བཞི་ཡི་གནས་༎
 dharmadhātāv avidyeyaṃ akliṣṭā daśadhāvṛtiḥ |	ཆོས་ཀྱི་དབྱིངས་ལ་མ་རིག་པ་༎ ཉོན་མོངས་ཅན་མིན་སྒྲིབ་པ་བཅུ་༎
 daśabhūmivipakṣeṇa pratipakṣās tu bhūmayaḥ || ii|16	ས་བཅུའི་༄༩བ་མི་མཐུན་ཕྱོགས་རྣམས་ཀྱི་༎ གཉེན་པོ་དག་ནི་ས་ཡིན་ནོ་༎
 dharmadhātau daśavidhe sarvatragādyarthe yad akliṣṭam ajñānaṃ tad daśasu bodhisatvabhūmiṣv āvaraṇaṃ yathākramaṃ tadvipakṣatvāt | yad uta	ཀུན་ཏུ་འགྲོ་བའི་དོན་ལ་སོགས་པའི་ཆོས་ཀྱི་དབྱིངས་རྣམ་པ་བཅུ་ལ་ཉོན་མོངས་པ་ཅན་མ་ཡིན་པའི་མི་ཤེས་པ་གང་ཡིན་པ་དེ་ནི་བྱང་ཆུབ་སེམས་དཔའི་ས་བཅུ་ལ་གོ་རིམས་བཞིན་དུ་སྒྲིབ་སྟེ་། དེའི་མི་མཐུན་པའི་ཕྱོགས་སུ་གྱུར་པའི་ཕྱིར་རོ་༎ འདི་ལྟ་སྟེ་།
 sarvatragārthe prathamayā hi bhūmyā dharmadhātoḥ sarvatragārthaṃ pratividhyati [|	ས་དང་པོ་ལ་ནི་ཆོས་ཀྱི་དབྱིངས་ཀུན་ཏུ་འགྲོ་བའི་དོན་ལ་ཀུན་ཏུ་འགྲོ་བའི་དོན་དུ་རྟོགས་ཏེ་། 
 ] yenātmaparasamatāṃ pratilabhate |	དེས་བདག་དང་གཞན་མཉམ་པ་ཉིད་རབ་ཏུ་འཐོབ་པོ་༎
 dvitīyayāgrārthaṃ [|	གཉིས་པ་ལ་ནི་མཆོག་གི་དོན་དུ་རྟོགས་ཏེ་།
 ] yenāsyaivaṃ bhavati tasmāt tarhy asmābhiḥ samāne 'bhinirhāre sarvākārapariśodhanābhinirhāra eva yogaḥ karaṇīya iti |	དེས་འདི་སྙམ་དུ་སེམས་ཏེ་། དེ་ལྟ་བས་ན་བསྒྲུབ་ཏུ་མཚུངས་པ་ལ་བདག་གིས་རྣམ་པ་ཐམས་ཅད་དུ་ཡོངས་སུ་སྦྱོང་བ་མངོན་པར་བསྒྲུབ་པ་ཉིད་ལ་མངོན་པར་བརྩོན་པར་བྱའོ་སྙམ་མོ་༎ 
 tṛtīyayā tanniṣyandāgrārthaṃ |	གསུམ་པ་ལ་ནི་དེའི་རྒྱུ་མཐུན་པ་དོན་གྱི་མཆོག་ཏུ་རྟོགས་ཏེ་།
 yena dharmadhātuniṣyandasya śrutasyāgratāṃ viditvā tadarthaṃ trisāhasramahāsāhasrapramāṇāyām apy agnikhadāyām ātmānaṃ prakṣipet |	དེས་ཆོས་ཀྱི་དབྱིངས་ཀྱི་རྒྱུ་མཐུན་པ་ཐོས་པ་མཆོག་ཏུ་རིག་ནས་། དེའི་ཕྱིར་མེའི་འོབས་སྟོང་གསུམ་གྱི་སྟོང་ཆེན་པོའི་ཚད་ཙམ་དུ་ཡང་བདག་ཉིད་མཆོད་དོ་༎ བཞི་པ་ལ་ནི་ཡོངས་སུ་འཛིན་པ་མེད་པའི་དོན་དུ་རྟོགས་ཏེ་།
 caturthyā niṣparigrahatārthan tathā hi dharmatṛṣṇāpi vyāvartate |	འདི་ལྟར་ཆོས་ལ་སྲེད་པ་ལ་ཡང་ལྡོག་གོ་༎
 pañcamyā santānābhedārthaṃ daśabhiś cittāśayaviśuddhisamatābhiḥ |	ལྔ་པ་ལ་ནི་རྒྱུད་ཐ་དད་པ་མེད་པའི་དོན་དུ་རྟོགས་ཏེ་། སེམས་དང་བསམ་པ་རྣམ་པར་དག་པ་མཉམ་པ་ཉིད་རྣམ་པ་བཅུས་རྟོགས་སོ་༎
 ṣaṣṭhyā niḥsaṃkleṣaviśuddhyarthaṃ pratītyasamutpāde (|	དྲུག་པ་ལ་ནི་ཀུན་ནས་ཉོན་མོངས་པ་དང་། རྣམ་པར་དག་པ་མ་ཡིན་པའི་དོན་དུ་རྟོགས་ཏེ་།
 ) nāsti sa kaścid dharmo yaḥ saṃkliśyate vā viśudhyate veti prativedhāt |	རྟེན་ཅིང་འབྲེལ་བར་འབྱུང་བའི་དོན་ལ་གང་ཀུན་ཉོན་མོངས་པར་འགྱུར་བའམ་རྣམ་པར་དག་པར་འགྱུར་བའི་ཆོས་དེ་གང་ཡིན་ཡང་མེད་པར་རབ་ཏུ་རྟོགས་པའི་ཕྱིར་རོ་༎
 saptamyānānātvārthaṃ nirnimittatayā sūtrādidharmanimittanānātvāsamudācārād [|	བདུན་པ་ལ་ནི་ཐ་དད་པ་མེད་པའི་དོན་དུ་རྟོགས་ཏེ་། མཚན་མ་མེད་པས་མདོ་ལ་སོགས་པའི་ཆོས་ཀྱི་མཚན་མ་ཐ་དད་པར་མི་འབྱུང་བའི་ཕྱིར་རོ་༎ བརྒྱད་པ་ལ་ནི་བྲི་བ་མེད་ཅིང་འཕེལ་བ་མེད་པའི་དོན་དུ་རྟོགས་ཏེ་།
 ] aṣṭamyāhīnānadhikārtham anutpattikadharmakṣāntilābhāt saṃkleśe vyavadāne vā (mvbh 36)	མི་སྐྱེ་བའི་ཆོས་ལ་བཟོད་པ་ཐོབ་པས་ཀུན་ནས་ཉོན་མོངས་པའམ་།
 kasyacid dharmasya hānivṛddhyadarśanāc [|	རྣམ་པར་བྱང་བ་ན་ཡང་བྲི་བའམ་འཕེལ་བ་མི་མཐོང་བའི་ཕྱིར་རོ་༎
 ] caturdhā vaśitā nirvikalpavaśitā kṣetrapariśuddhivaśitā jñānavaśitā karmavaśitā ca [|	དབང་རྣམ་པ་བཞི་ནི་རྣམ་པར་མི་རྟོག་པ་ལ་དབང་བ་དང་། ཞིང་ཡོངས་སུ་དག་པ་ལ་དབང་བ་དང་། ཡེ་ཤེས་ལ་དབང་བ་དང་། ལས་ལ་དབང་བའོ་༎
 ] tatra prathamadvitīyavaśitāśrayatvaṃ dharmadhātāv aṣṭamyaiva bhūmyā pratividdhati |	དེ་ལས་བརྒྱད་པ་ཉིད་ལ་ཆོས་ཀྱི་༄༡༠ཨ་༌་༎ དབྱིངས་ལ་དབང་བ་དང་པོ་དང་། འོག་གི་གནས་ཉིད་དུ་རབ་ཏུ་རྟོགས་སོ་༎
 jñānavaśitāśrayatvaṃ navamyāṃ pratisaṃvillābhāt |	དགུ་པ་ལ་ནི་ཡེ་ཤེས་ལ་དབང་བའི་གནས་ཉིད་དུ་རྟོགས་ཏེ་། སོ་སོ་ཡང་དག་པར་རིག་པ་ཐོབ་པའི་ཕྱིར་རོ་༎
 karmavaśitāśrayatvaṃ daśamyāṃ yathecchaṃ nirmāṇaiḥ satvārthakaraṇāt | [5| avaraṇasamāsa]	བཅུ་པ་ལ་ནི་ལས་ལ་དབང་བའི་གནས་ཉིད་དུ་རྟོགས་ཏེ་། ཇི་ལྟར་བཞེད་པ་བཞིན་དུ་སྤྲུལ་པ་རྣམས་ཀྱིས་སེམས་ཅན་གྱི་དོན་མཛད་པའི་ཕྱིར་རོ་༎
 samāsena punaḥ |	མདོར་བསྡུ་ན་།
 kleśāvaraṇam ākhyātaṃ jñeyāvaraṇam eva ca |	ཉོན་མོངས་པ་ཡི་སྒྲིབ་པ་དང་། ཤེས་བྱའི་སྒྲིབ་པ་ཉིད་དུ་བསྟན་༎ དེར་ནི་སྒྲིབ་པ་ཐམས་ཅད་དེ་༎
 sarvāṇy āvaraṇānīha yatkṣayān muktir iṣyate || ii|17	དེ་ཟད་ནས་ནི་གྲོལ་བར་འདོད་༎
 asya hi dvividhasyāvaraṇasya (| ) kṣayāt sarvāvaraṇebhyo muktir iṣyate | [āvaraṇapiṇḍārtha]	སྒྲིབ་པ་རྣམ་པ་གཉིས་པོ་འདི་ཟད་ན་སྒྲིབ་པ་ཐམས་ཅད་ལས་གྲོལ་བར་འདོད་དོ་༎
 āvaraṇānāṃ piṇḍārthaḥ |	སྒྲིབ་པ་རྣམས་ཀྱི་དོན་བསྡུས་པ་སྟེ་།
 mahad āvaraṇaṃ yad vyāpi |	སྒྲིབ་པ་ཆེན་པོ་ནི་ཁྱབ་པ་གང་ཡིན་པའོ་༎
 pratanv āvaraṇaṃ yat prādeśikaṃ |	སྒྲིབ་པ་ཆུང་ངུ་ནི་ཉེ་ཚེ་པ་གང་ཡིན་པའོ་༎
 prayogāvaraṇaṃ yad udriktaṃ |	སྦྱོར་བའི་སྒྲིབ་པ་ནི་ལྷག་པ་གང་ཡིན་པའོ་༎
 prāptyāvaraṇaṃ yat samaṃ |	ཐོབ་པ་ལ་སྒྲིབ་པ་ནི་མཉམ་པ་གང་ཡིན་པའོ་༎
 prāptiviśeṣāvaraṇaṃ yad ādānavivarjane |	འཐོབ་པ་ཁྱད་པར་ཅན་ལ་སྒྲིབ་པ་ནི་ལེན་པ་དང་སྤོང་བ་གང་ཡིན་པའོ་༎
 samyakprayogāvaraṇaṃ yan navadhākleśāvaraṇaṃ |	ཡང་དག་པར་སྦྱོར་བ་ལ་སྒྲིབ་པ་ནི་ཉོན་མོངས་པའི་སྒྲིབ་པ་རྣམ་པ་དགུ་གང་ཡིན་པའོ་༎ རྒྱུ་ལ་སྒྲིབ་པ་ནི་དགེ་བ་ལ་སོགས་པ་རྣམ་པ་བཅུ་ལ་སྒྲིབ་པ་གང་ཡིན་པ་༎ སྟེ་། 
 hetvāvaraṇaṃ yac chubhādau daśavidhahetvarthādhikārāt i tatvapraveśāvaraṇaṃ yad bodhipakṣyeṣu |	རྒྱུའི་དོན་གྱི་སྐབས་ཀྱི་ཕྱིར་རོ་༎ དེ་ཁོ་ན་ལ་འཇུག་པ་ལ་སྒྲིབ་པ་ནི་བྱང་ཆུབ་ཀྱི་ཕྱོགས་རྣམས་ལ་སྒྲིབ་པ་གང་ཡིན་པའོ་༎ 
 śubhānuttaryāvaraṇaṃ yat pāramitāsu |	དགེ་བ་བླ་ན་མེད་པ་ལ་སྒྲིབ་པ་ནི་ཕ་རོལ་ཏུ་ཕྱིན་པ་རྣམས་ལ་སྒྲིབ་པ་གང་ཡིན་པའོ་༎
 tadviśeṣagatyāvaraṇaṃ yad bhūmiṣu |	དེ་ཁྱད་པར་དུ་འགྲོ་བ་ལ་སྒྲིབ་པ་ནི་ས་རྣམས་ལ་སྒྲིབ་པ་གང་ཡིན་པའོ་༎
 saṃgrahāvaraṇaṃ yat samāsato dvividhaṃ ||	བསྡུས་པའི་སྒྲིབ་པ་ནི་མདོར་བསྡུས་པ་རྣམ་པ་གཉིས་པོ་གང་ཡིན་པའོ་༎
 madhyāntavibhāge āvaraṇaparicchedo dvitīyaḥ || ḥ || (mvbh 37) [chapter iii| tattvapariccheda]	བསྟན་བཅོས་དབུས་དང་མཐའ་རྣམ་པར་འབྱེད་པ་ལས་སྒྲིབ་པའི་ལེའུར་བཅད་པ་ཞེས་བྱ་བ་གཉིས་པའི་འགྲེལ་པའོ་། 
 tatvam adhikṛtyāha |	༎ ། དེ་ཁོ་ནའི་དབང་དུ་མཛད་དེ་གསུངས་པ་།
 mūlalakṣaṇatatvaṃ aviparyāsalakṣaṇaṃ |	རྩ་བ་མཚན་ཉིད་དེ་ཁོ་ན་༎ ཕྱིན་ཅི་མ་ལོག་མཚན་ཉིད་དང་༎ འབྲས་བུ་རྒྱུ་ཡི་དེ་ཁོ་ན་༎
 phalahetumayan tatvaṃ sūkṣmaudārikam eva ca || iii| 1 prasiddhaṃ śuddhiviṣayaṃ saṃgrāhyaṃ bhedalakṣaṇaṃ |	རགས་པ་དང་ནི་ཕྲ་བ་དང་༎ གྲགས་དང་རྣམ་པར་དག་ཡུལ་དང་༎ བསྡུ་དང་དབྱེ་བའི་མཚན་ཉིད་དང་༎ མཁས་དེ་ཁོ་ན་རྣམ་བཅུ་ནི་༎
 kauśalyatatvaṃ daśadhā ātmadṛṣṭivipakṣataḥ || iii|2	བདག་ཏུ་ལྟ་བའི་གཉེན་པོའོ་༎
 ity etad daśavidhaṃ tatvaṃ yad uta mūlatatvaṃ lakṣaṇatatvaṃ | aviparyāsatatvaṃ |	ཞེས་བྱ་བ་འདི་དག་ནི་དེ་ཁོ་ན་རྣམ་པ་བཅུ་སྟེ་།
 phalahetutatvaṃ | audārikasūkṣmatatvaṃ | prasiddhatatvaṃ |	འདི་ལྟ་སྟེ་།
 viśuddhigocaratatvaṃ | saṃgrahatatvaṃ] prabhedatatvaṃ | kauśalyatatvañ ca |	རྩ་བའི་༄༡༠བ་དེ་ཁོ་ན་དང་། མཚན་ཉིད་ཀྱི་དེ་ཁོ་ན་དང་། ཕྱིན་ཅི་མ་ལོག་པའི་དེ་ཁོ་ན་དང་། འབྲས་བུ་དང་རྒྱུའི་དེ་ཁོ་ན་དང་། རགས་པ་དང་ཕྲ་བའི་དེ་ཁོ་ན་དང་། གྲགས་པའི་དེ་ཁོ་ན་དང་། རྣམ་པར་དག་པའི་སྤྱོད་ཡུལ་གྱི་དེ་ཁོ་ན་དང་། བསྡུ་བའི་དེ་ཁོ་ན་དང་། རབ་ཏུ་དབྱེ་བའི་དེ་ཁོ་ན་དང་། མཁས་པའི་དེ་ཁོ་ན་སྟེ་།
 tat punar daśavidhaṃ daśavidhātmagrāhapratipakṣeṇa veditavyaṃ |	རྣམ་པ་བཅུ་པོ་དེ་ཡང་བདག་ཏུ་འཛིན་པ་རྣམ་པ་བཅུའི་གཉེན་པོར་རིག་པར་བྱའོ་༎
 tad yathā skandhakauśalyaṃ | dhātukauśalyam āyatanakauśalyaṃ | pratītyasamutpādakauśalyaṃ |	འདི་ལྟ་སྟེ་།
 sthānāsthānakauśalyam indriyakauśalyaṃ adhvakauśalyaṃ satyakauśalyaṃ yānakauśalyaṃ | saṃskṛtāsaṃskṛtakauśalyaṃ ca | [1| mūlatattva]	ཕུང་པོ་ལ་མཁས་པ་དང་། ཁམས་ལ་མཁས་པ་དང་། སྐྱེ་མཆེད་ལ་མཁས་པ་དང་། རྟེན་ཅིང་འབྲེལ་བར་འབྱུང་བ་ལ་མཁས་པ་དང་། གནས་དང་གནས་མ་ཡིན་པ་ལ་མཁས་པ་དང་། དབང་པོ་ལ་མཁས་པ་དང་། དུས་ལ་མཁས་པ་དང་། བདེན་པ་ལ་མཁས་པ་དང་། ཐེག་པ་ལ་མཁས་པ་དང་། འདུས་བྱས་དང་འདུས་མ་བྱས་ཀྱི་ཆོས་ལ་མཁས་པའོ་༎
 tatra mūlatatvaṃ | svabhāvas trividhaḥ	དེ་ལ་རྩ་བའི་དེ་ཁོ་ན་ནི་ངོ་བོ་ཉིད་རྣམ་པ་གསུམ་སྟེ་།
 parikalpitaḥ paratantraḥ pariniṣpannaś ca |	ཀུན་བརྟགས་པ་དང་༏་གཞན་གྱི་དབང་དང་། ཡོངས་སུ་གྲུབ་པ་སྟེ་།
 tatrānyatatvavyavasthāpanāt |	དེ་ལ་དེ་ཁོ་ན་གཞན་རྣམ་པར་གཞག་པའི་ཕྱིར་རོ་༎
 kim atra svabhāvatraye tatvam iṣyate | (mvbh 38)	དེ་ཅིའི་ཕྱིར་འདིར་ངོ་བོ་ཉིད་གསུམ་ལ་དེ་ཁོ་ན་ཞེས་བྱ་བར་འདོད་ཅེ་ན་།
 asac ca nityaṃ sac cāpy atatvataḥ	ངོ་བོ་ཉིད་གསུམ་རྟག་མེད་དང་༎ ཡོད་ཀྱང་ཁོ་ན་མ་ཡིན་དང་༎ ཡོད་དང་མེད་དེ་ཁོ་ན་སྟེ་༎
 sadasattatvataś ceti svabhāvatraya iṣyate || iii|3	ངོ་བོ་ཉིད་ནི་གསུམ་དུ་འདོད་༎
 parikalpitalakṣaṇaṃ nityam asad ity etat parikalpitasvabhāve tatvam aviparītatvāt [|	ཀུན་ཏུ་བརྟགས་པའི་མཚན་ཉིད་ནི་རྟག་ཏུ་མེད་པའོ་༎ དེ་ནི་ཀུན་ཏུ་བརྟགས་པའི་ངོ་བོ་ཉིད་ལ་དེ་ཁོ་ན་ཞེས་བྱ་སྟེ་། ཕྱིན་ཅི་མ་ལོག་པའི་ཕྱིར་རོ་༎
 ] paratantralakṣaṇaṃ sac ca na ca tatvato bhrāntatvād ity etat paratantrasvabhāve tatvaṃ |	གཞན་གྱི་དབང་གི་མཚན་ཉིད་ནི་ཡོད་ཀྱང་ཡང་དག་པ་མ་ཡིན་ཏེ་འཁྲུལ་པའི་ཕྱིར་རོ་༎ དེ་ལྟ་བས་ན་གཞན་གྱི་དབང་གི་ངོ་བོ་ཉིད་ལ་དེ་ཁོ་ན་ཞེས་བྱའོ་༎
 pariniṣpannalakṣaṇaṃ sadasattatvataś cety etat (|	ཡོངས་སུ་གྲུབ་པའི་མཚན་ཉིད་ནི་ཡོད་པ་དང་མེད་པའི་དེ་ཁོ་ན་སྟེ་།
 ) pariniṣpannasvabhāve tatvaṃ | [2| laksaṇatattva]	དེ་བས་ན་འདི་ནི་ཡོངས་སུ་གྲུབ་པའི་ངོ་བོ་ཉིད་ལ་དེ་ཁོ་ནའོ་༎
 lakṣaṇatatvaṃ katamat |	མཚན་ཉིད་ཀྱི་དེ་ཁོ་ན་གང་ཞེ་ན་།
 samāropāpavādasya dharmapudgalayor iha | grāhyagrāhakayoś cāpi bhāvābhāve ca darśanaṃ || iii|4	འདི་ལ་ཆོས་དང་གང་ཟག་དང་༎ གཟུང་བ་དག་དང་འཛིན་པ་དང་༎ ཡོད་དང་མེད་པར་སྒྲོ་འདོགས་པ་དང་༎ སྐུར་བ་འདེབས་པར་ལྟ་བ་དང་༎ གང་ཤེས་ནས་ནི་མི་འབྱུང་བ་༎
 yajjñānān na pravarteta tad dhi tatvasya lakṣaṇaṃ |	དེ་དེ་ཁོ་ནའི་མཚན་ཉིད་དོ་༎
 pudgaladharmayoḥ samāropāpavādadarśanaṃ yasya jñānān na pravartate |	གང་ཤེས་ནས་གང་ཟག་དང་ཆོས་གཉིས་ལ་སྒྲོ་འདོགས་པ་དང་། སྐུར་པ་འདེབས་པར་ལྟ་བ་མི་འབྱུང་བ་དེ་ནི་ཀུན་༄༡༡ཨ་༌་༎
 tat parikalpitasvabhāve tatvalakṣaṇaṃ |	བརྟགས་པའི་ངོ་བོ་ཉིད་ཀྱི་དེ་ཁོ་ནའི་མཚན་ཉིད་དོ་༎
 grāhyagrāhakayoḥ samāropāpavādadarśanaṃ yasya jñānān na pravartate | tat paratantrasvabhāve tatvalakṣaṇaṃ |	གང་ཤེས་ནས་གཟུང་བ་དང་། འཛིན་པ་གཉིས་ལ་སྒྲོ་འདོགས་པ་དང་། སྐུར་པ་འདེབས་པར་ལྟ་བ་མི་འབྱུང་བ་དེ་ནི་གཞན་གྱི་དབང་གི་ངོ་བོ་ཉིད་ཀྱི་དེ་ཁོ་ནའི་མཚན་ཉིད་དོ་༎
 bhāvābhāvasamāropāpavādadarśanaṃ yasya jñānān na pravartate | tat pariniṣpannasvabhāve tatvalakṣaṇaṃ |	གང་ཤེས་ནས་དངོས་པོ་དང་དངོས་པོ་མེད་པར་སྒྲོ་འདོགས་པ་དང་། སྐུར་པ་འདེབས་པར་ལྟ་བ་མི་འབྱུང་བ་དེ་ནི་ཡོངས་སུ་གྲུབ་པའི་ངོ་བོ་ཉིད་ཀྱི་དེ་ཁོ་ནའི་མཚན་ཉིད་དོ་༎
 etan mūlatatve lakṣaṇam aviparītaṃ lakṣaṇatatvam ity ucyate | [3| aviparyāsatattva]	རྩ་བའི་དེ་ཁོ་ན་ལ་མཚན་ཉིད་ཀྱི་དེ་ཁོ་ན་ཕྱིན་ཅི་མ་ལོག་པ་འདི་ནི་མཚན་ཉིད་ཀྱི་དེ་ཁོ་ན་ཞེས་བྱའོ་༎
 aviparyāsatatvaṃ nityādiviparyāsapratipakṣeṇānityaduḥkhaśūnyānātmatā mūlatatve yathākramaṃ [|	ཕྱིན་ཅི་མ་ལོག་པའི་དེ་ཁོ་ན་ནི་རྟག་པ་ལ་སོགས་པར་ཕྱིན་ཅི་ལོག་པའི་གཉེན་པོར་མི་རྟག་པ་དང་། སྡུག་བསྔལ་བ་དང་། སྟོང་པ་དང་། བདག་མེད་པ་ཉིད་དོ་༎
 ] kathaṃ ca tatrānityatāditā veditavyā |	རྩ་བའི་དེ་ཁོ་ན་དེར་ཇི་ལྟར་ན་མི་རྟག་པ་ལ་སོགས་པ་ཉིད་རིག་པར་བྱ་ཞེ་ན་། 
 asadartho hy anityārtha utpādavyayalakṣaṇaḥ || iii|5 samalāmalabhāvena mūlatatve yathākramaṃ | (mvbh 39) trayo hi svabhāvā mūlatatvaṃ [|	མི་རྟག་དོན་ནི་མེད་དོན་དང་༎ སྐྱེ་ཞིང་འཇིག་པའི་མཚན་ཉིད་དང་༎ དྲི་བཅས་དྲི་མ་མེད་དོན་ཏེ་༎
 ] teṣu yathākramam	རྩ་བའི་ཁོ་ནར་གོ་རིམས་བཞིན་༎
 asadartho hy anityārtha	མི་རྟག་པའི་དོན་ནི་རྣམ་པ་གསུམ་སྟེ་།
 utpādavyayārthaḥ samalāmalatārthaś ca |	མེད་པའི་དོན་དང་། སྐྱེ་ཞིང་འཇིག་པའི་དོན་དང་། དྲི་མ་དང་བཅས་ཤིང་དྲི་མ་མེད་པ་ཉིད་ཀྱི་དོན་ནི་རྩ་བའི་དེ་ཁོ་ནར་ངོ་བོ་ཉིད་གསུམ་པོ་དག་དང་གོ་རིམས་བཞིན་ནོ་༎
 duḥkham ādānalakṣmākhyaṃ saṃbandhenāparaṃ mataṃ || iii|6	སྡུག་བསྔལ་ལེན་དང་མཚན་ཉིད་དང་༎ འབྲེལ་བ་གཞན་དུ་འདོད་པ་ཡིན་༎
 mūlatatve yathākramaṃ duḥkham upādānataḥ pudgaladharmābhiniveśopādānāt |	གང་ཟག་དང་ཆོས་ལ་མངོན་པར་ཞེན་པ་ཉེ་བར་ལེན་པའི་ཕྱིར་།
 lakṣaṇatas triduḥkhatālakṣaṇatvāt | saṃbandhataś ca duḥkhasaṃbandhāt [|	ཉེ་བར་ལེན་པའི་སྡུག་བསྔལ་བ་དང་། སྡུག་བསྔལ་བ་ཉིད་གསུམ་གྱི་མཚན་ཉིད་ཡིན་པས་མཚན་ཉིད་དང་། སྡུག་བསྔལ་དང་འབྲེལ་པའི་ཕྱིར་འབྲེལ་བ་ཡང་སྟེ་།
 ] tatraiva mūlatatve yathākramaṃ veditavyam |	རྩ་བའི་དེ་ཁོ་ན་ཉིད་ཀྱི་ནང་དུ་གོ་རིམས་བཞིན་ནོ་༎
 abhāvaś cāpy atadbhāvaḥ prakṛtiḥ śūnyatā matā |	དངོས་མེད་དེ་དངོས་མ་ཡིན་དང་༎ རང་བཞིན་གྱིས་ནི་སྟོང་པར་འདོད་༎
 parikalpitalakṣaṇaṃ na kenacit prakāreṇāstīty abhāva evāsya śūnyatā paratantralakṣaṇaṃ tathā nāsti yathā parikalpyate na tu sarvathā nāstīti tasyātadbhāvaḥ (|	ཀུན་བརྟགས་པའི་མཚན་ཉིད་ནི་རྣམ་པ་གང་གིས་ཀྱང་ཡོད་པ་མ་ཡིན་ཏེ་། དངོས་པོ་མེད་པ་ཉིད་པས་དེའི་སྟོང་པ་ཉིད་དོ་༏་། གཞན་གྱི་དབང་གི་མཚན་ཉིད་ནི་ཇི་ལྟར་ཀུན་བརྟགས་པ་དེ་ལྟར་མེད་ཀྱི་། ཡེ་ཤེས་མེད་པ་ས་ནི་མ་ཡིན་ཏེ་།
 ) śūnyatā [|	དེ་མ་ཡིན་པས་དེའི་སྟོང་པ་ཉིད་དོ་༎
 ] pariniṣpannalakṣaṇaṃ śūnyatāsvabhāvam eveti prakṛtir evāsya śūnyatā |	ཡོངས་སུ་གྲུབ་པའི་མཚན་ཉིད་ནི་། སྟོང་པ་ཉིད་ཀྱི་ངོ་བོ་ཉིད་ཁོ་ན་ཡིན་པས་རང་བཞིན་ཁོ་ནས་དེའི་སྟོང་པ་ཉིད་དོ་༎ མཚན་༄༡༡བ་ཉིད་མེད་པས་བདག་མེད་དང་༎ དེ་དང་མི་མཐུན་མཚན་ཉིད་དང་༎ རང་གི་མཚན་ཉིད་བསྟན་པ་ཡིན་༎ ཀུན་བརྟགས་པའི་ངོ་བོ་ཉིད་ནི་མཚན་ཉིད་ཀྱིས་མེད་པའི་ཕྱིར་རོ་༎
 alakṣaṇaṃ ca nairātmyaṃ tadvilakṣaṇam eva ca || iii|7	མཚན་ཉིད་དེའི་བདག་མེད་པ་ཉིད་དོ་༎
 svalakṣaṇañ ca nirdiṣṭaṃ | parikalpitasya svabhāvasya lakṣaṇam eva nāstīty alakṣaṇam evāsya nairātmyaṃ [| ] paratantrasyāsti lakṣaṇaṃ na tu yathā parikalpyata iti tadvilakṣaṇam asya lakṣaṇan nairātmyaṃ |	གཞན་གྱི་དབང་གི་མཚན་ཉིད་ནི་ཡོད་ཀྱང་ཇི་ལྟར་ཀུན་ཏུ་བརྟགས་པ་བཞིན་དུ་མེད་པས་དེ་དང་མི་མཐུན་པའི་མཚན་ཉིད་ཀྱིས་དེའི་བདག་མེད་པའོ་༎ 
 pariniṣpannas tu svabhāvo nairātmyam eveti prakṛtir evāsya nairātmyam iti trividhe mūlatatve trividhānityatā paridīpitā asadarthānityatā utpādabhaṅgānityatā samalanirmalānityatā ca |	ཡོངས་སུ་གྲུབ་པ་ནི་ངོ་བོ་ཉིད་ཀྱིས་བདག་མེད་པ་ཉིད་པས་རང་གི་མཚན་ཉིད་ཀྱིས་དེའི་བདག་མེད་པའོ་༎ རྩ་བ་དེ་ཁོ་ན་རྣམ་པ་གསུམ་ལ་མི་རྟག་པ་ཉིད་རྣམ་པ་གསུམ་ཡོངས་སུ་བསྟན་ཏོ་། མེད་པའི་དོན་མི་རྟག་པ་ཉིད་དང་། སྐྱེ་ཞིང་འཇིག་པ་མི་རྟག་པ་ཉིད་དང་། དྲི་མ་དང་བཅས་ཤིང་དྲི་མ་མེད་པ་མི་རྟག་པ་ཉིད་དོ་༎
 trividhā duḥkhatā upādānaduḥkhatā lakṣaṇaduḥkhatā saṃbandhaduḥkhatā (mvbh 40) ca |	སྡུག་བསྔལ་ཉིད་རྣམ་པ་གསུམ་སྟེ་། ཉེ་བར་ལེན་པས་སྡུག་བསྔལ་ཉིད་དང་། མཚན་ཉིད་ཀྱིས་སྡུག་བསྔལ་ཉིད་དང་༏་འབྲེལ་བས་སྡུག་བསྔལ་ཉིད་དོ་༎ སྟོང་པ་ཉིད་རྣམ་པ་གསུམ་སྟེ་།
 trividhā śūnyatā abhāvaśūnyatā atadbhāvaśūnyatā svabhāvaśūnyatā ca trividhaṃ nairātmyaṃ alakṣaṇanairātmyaṃ |	དངོས་པོ་མེད་པས་སྟོང་པ་ཉིད་དང་། དེ་མ་ཡིན་པས་སྟོང་པ་ཉིད་དང་། ངོ་བོ་ཉིད་ཀྱིས་སྟོང་པ་ཉིད་དོ་༎ བདག་མེད་པ་རྣམ་པ་གསུམ་སྟེ་།
 vilakṣaṇanairātmyaṃ svalakṣaṇanairātmyaṃ ca |	མཚན་ཉིད་མེད་པས་བདག་མེད་པ་དང་། མི་མཐུན་པའི་མཚན་ཉིད་ཀྱིས་བདག་མེད་པ་དང་། རང་གི་མཚན་ཉིད་ཀྱིས་བདག་མེད་པའོ་༎
 [4| phalahetutattva] phalahetumayan tatvaṃ tatraiva mūlatatve duḥkhasamudayanirodhamārgasatyatvaṃ [|	འབྲས་བུ་དང་རྒྱུའི་དེ་ཁོ་ན་ནི་རྩ་བའི་དེ་ཁོ་ན་ཉིད་ལ་སྡུག་བསྔལ་དང་། ཀུན་འབྱུང་བ་དང་། འགོག་པ་དང་། ལམ་གྱི་བདེན་པ་ཉིད་དོ་༎
 ] kathaṃ trividhaṃ mūlatatvaṃ duḥkhādisatyatvaṃ [|	ཇི་ལྟར་རྩ་བའི་དེ་ཁོ་ན་རྣམ་པ་གསུམ་ལས་སྡུག་བསྔལ་ལ་སོགས་པའི་བདེན་པ་ཞེས་བྱ་ཞེ་ན་། 
 ] yatas tad anityādilakṣaṇaṃ |	འདི་ལྟར་དེ་མི་རྟག་པ་ལ་སོགས་པའི་མཚན་ཉིད་ཀྱིས་ཏེ་།
 duḥkhasatyam ato mataṃ	དེའི་ཕྱིར་སྡུག་བསྔལ་བདེན་པར་འདོད་༎
 trividhena samudayārthena samudayasatyaṃ [|	ཀུན་འབྱུང་བའི་དོན་རྣམ་པ་གསུམ་གྱིས་ཀུན་འབྱུང་བའི་བདེན་པ་སྟེ་།
 ] trividhaḥ samudayārthaḥ |	ཀུན་འབྱུང་བའི་དོན་རྣམ་པ་གསུམ་ནི་།
 vāsanātha samutthānam avisaṃyoga eva ca || iii|8	བག་ཆགས་དང་ནི་ཀུན་ནས་འབྱུང་༎ མ་བྲལ་བ་ཡང་དེ་བཞིན་ནོ་༎
 vāsanāsamudayaḥ parikalpitasvabhāvābhiniveśavāsanā samutthānasamudayaḥ karmakleśāḥ |	བག་ཆགས་ཀྱི་ཀུན་འབྱུང་བ་ནི་། ཀུན་བརྟགས་པའི་ངོ་བོ་ཉིད་ལ་མངོན་པར་ཞེན་པའི་བག་ཆགས་སོ་༎ ཀུན་ནས་འབྱུང་བའི་ཀུན་འབྱུང་བ་ནི་ལས་དང་ཉོན་མོངས་པ་རྣམས་སོ་༎
 avisaṃyogasamudayaḥ |	མ་བྲལ་༄༡༢ཨ་༌་༎
 tathatāyā āvaraṇāvisaṃyogaḥ |	བའི་ཀུན་འབྱུང་ནི་དེ་བཞིན་ཉིད་སྒྲིབ་པ་དང་མ་བྲལ་བའོ་༎
 trividhena nirodhena nirodhasatyaṃ [|	འགོག་པ་རྣམ་པ་གསུམ་གྱིས་འགོག་པའི་བདེན་པ་སྟེ་འགོག་པ་རྣམ་པ་གསུམ་མོ་༎
 ] trividho nirodhaḥ |	འགོག་པ་རྣམ་པ་གསུམ་ནི་༎
 svabhāvadvayanotpattir malaśāntidvayaṃ mataṃ |	ངོ་བོ་ཉིད་དང་གཉིས་མི་སྐྱེ་༎ དྲི་མ་ཞི་བ་གཉིས་སུ་འདོད་༎
 svabhāvānutpattir grāhyagrāhakayor anutpattir malaśāntidvayaṃ ca pratisaṃkhyānirodhatathatākhyam ity eṣa trividho nirodho yad uta svabhāvanirodho dvayanirodhaḥ |	ངོ་བོ་ཉིད་ཀྱིས་མི་སྐྱེ་བ་དང་། གཟུང་བ་དང་འཛིན་པ་གཉིས་མི་སྐྱེ་བ་དང་། དྲི་མ་ཞི་བ་གཉིས་ཀྱང་སྟེ་། སོ་སོར་བརྟགས་པའི་འགོག་པ་དང་། དེ་བཞིན་ཉིད་ཅེས་བྱའོ་༎ འདི་ནི་འགོག་པ་རྣམ་གསུམ་སྟེ་༎ འདི་ལྟ་སྟེ་།
 prakṛtinirodhaś ca |	ངོ་བོ་ཉིད་ཀྱིས་འགོག་པ་དང་། གཉིས་པོ་འགོག་པ་དང་། རང་བཞིན་གྱིས་འགོག་པའོ་༎
 mārgasatyaṃ trividhe mūlatatve kathaṃ vyavasthāpyate |	ལམ་གྱི་བདེན་པ་རྩ་བའི་དེ་ཁོ་ན་རྣམ་པ་གསུམ་དུ་ཇི་ལྟར་གཞག་ཅེ་ན་།
 parijñāyāṃ prahāṇe ca prāptisākṣātkṛtāv ayaṃ [||] iii|9 (mvbh 41)	ཡོངས་སུ་ཤེས་དང་སྤང་བ་དང་༎ ཐོབ་པར་མངོན་སུམ་བྱ་བས་ནི་༎
 mārgasatyaṃ samākhyātaṃ |	ལམ་གྱི་བདེན་པ་ཡང་དག་བཤད་༎
 parikalpitasya parijñāne paratantrasya parijñāne prahāṇe ca |	ཀུན་བརྟགས་པ་ནི་ཡོངས་སུ་ཤེས་པར་བྱའོ་༎ གཞན་གྱི་དབང་ནི་ཡོངས་སུ་ཤེས་པར་བྱ་བ་དང་སྤང་བའོ་༎
 pariniṣpannasya parijñāne prāptisākṣātkaraṇe ca evam atra parijñāprahāṇasākṣātkriyāyāṃ mārgasatyavyavasthānam iti veditavyaṃ [|] [5| audārikasūkṣmatattva]	ཡོངས་སུ་གྲུབ་པ་ནི་ཡོངས་སུ་ཤེས་པར་བྱ་བ་དང་། ཐོབ་པར་མངོན་སུམ་དུ་བྱའོ་༎ དེ་ལྟར་འདིར་ཡོངས་སུ་ཤེས་པར་བྱ་བ་དང་། སྤང་བར་བྱ་བ་དང་། མངོན་སུམ་དུ་བྱས་པས་ལམ་གྱི་བདེན་པ་རྣམ་པར་གཞག་པར་རིག་པར་བྱའོ་༎
 audārikasūkṣmatatvaṃ punaḥ saṃvṛtiparamārthasatyaṃ tan mūlatatve kathaṃ veditavyaṃ |	རགས་པ་དང་ཕྲ་བའི་དེ་ཁོ་ན་ནི་ཀུན་རྫོབ་དང་དོན་དམ་པའི་བདེན་པའོ་༎ དེ་རྩ་བའི་དེ་ཁོ་ནར་ཇི་ལྟར་རིག་པར་བྱ་ཞེ་ན་། བརྟགས་པ་དང་ནི་ཤེས་པ་དང་༎ དེ་བཞིན་བརྗོད་པ་རགས་པ་ཡིན་༎
 prajñaptipratipattitas tathodbhāvanayodāraṃ |	ཀུན་རྫོབ་པ་ནི་རྣམ་པ་གསུམ་སྟེ་།
 trividhā hi saṃvṛtiḥ prajñaptisaṃvṛtiḥ | pratipattisaṃvṛtiḥ |	བརྟགས་པའི་ཀུན་རྫོབ་དང་། ཤེས་པའི་ཀུན་རྫོབ་དང་། བརྗོད་པ་ཡང་དག་པའི་ཀུན་རྫོབ་པོ་༎
 udbhāvanāsaṃvṛtiś ca | tayā saṃvṛtisatyatvaṃ mūlatatve yathākramaṃ veditavyaṃ | paramārthan tu ekataḥ || iii|10	དེས་ཀུན་རྫོབ་ཀྱི་བདེན་པ་ཉིད་དེ་རྩ་བའི་དེ་ཁོ་ནར་གོ་རིམས་བཞིན་དུ་རིག་པར་བྱའོ་༎ དམ་པའི་དོན་ནི་གཅིག་པུའོ་༎
 paramārthasatyaṃ | ekasmāt pariniṣpannād eva svabhāvād veditavyaṃ |	དོན་དམ་པའི་བདེན་པ་ནི་ཡོངས་སུ་གྲུབ་པའི་ངོ་བོ་ཉིད་གཅིག་པུར་རིག་པར་བྱའོ་༎
 sa punaḥ kathaṃ paramārthaḥ |	དེ་ཡང་ཇི་ལྟར་དོན་དམ་པ་ཡིན་ཞེ་ན་།
 arthaprāptiprapattyā hi paramārthas tridhā mataḥ |	དོན་དང་ཐོབ་དང་སྒྲུབ་པ་ནི་༎ དོན་དམ་རྣམ་པ་གསུམ་དུ་འདོད་༎
 arthaparamārthas tathatā paramasya jñānasyārtha iti kṛtvā |	དོན་དམ་པ་ནི་དེ་བཞིན་ཉིད་དེ་ཡེ་ཤེས་དམ་པའི་དོན་ཡིན་པའི་ཕྱིར་རོ་༎
 prāptiparamārtho nirvāṇaṃ paramo 'rtha iti kṛtvā pratipattiparamārtho mārgaḥ paramo 'syārtha iti kṛtvā [| ] katham asaṃskṛtaṃ ca (|	ཐོབ་པར་བྱ་བའི་དོན་དམ་པ་ནི་མྱ་ངན་ལས་འདས་པ་སྟེ་དོན་གྱི་དམ་པ་༄༡༢བ་ཡིན་པའི་ཕྱིར་རོ་༎ སྒྲུབ་པ་དོན་དམ་པ་ནི་ལམ་སྟེ་དེའི་དོན་ནི་དམ་པ་ཡིན་པའི་ཕྱིར་པའི་ཕྱིར་རོ་༎ རོ་༎ 
 ) saṃskṛtaṃ ca (| ) pariniṣpannaḥ (| ) svabhāva ucyate |	འདུས་མ་བྱས་དང་འདུས་བྱས་ཡོངས་སུ་གྲུབ་པའི་ངོ་བོ་ཉིད་དུ་ཇི་སྐད་དུ་བརྗོད་ཅེ་ན་།
 nirvikarāviparyāsapariniṣpattito dvayaṃ || iii|11	འགྱུར་མེད་ཕྱིན་ཅི་མ་ལོག་པ་༎ ཡོངས་སུ་གྲུབ་པ་རྣམ་པ་གཉིས་༎
 asaṃskṛtam avikārapariniṣpattyā pariniṣpannaṃ |	འདུས་མ་བྱས་ནི་འགྱུར་བ་མེད་པར་ཡོངས་སུ་གྲུབ་པས་ཡོངས་སུ་གྲུབ་པའོ་༎
 saṃskṛtaṃ mārgasatyasaṃgṛhītam aviparyāsapariniṣpattyā punar jñeyavastuny (mvbh 42)	འདུས་བྱས་འདི་ལམ་གྱིས་བསྡུས་པ་སྟེ་།
 aviparyāsāt | [6| prasiddhatattva]	ཕྱིན་ཅི་མ་ལོག་པས་ཡོངས་སུ་གྲུབ་པ་སྟེ་། ཤེས་བྱའི་དངོས་པོ་ལ་ཕྱིན་ཅི་ལོག་མེད་པའི་ཕྱིར་རོ་༎
 prasiddhatatvaṃ mūlatatve kathaṃ vyavasthāpyate |	གྲགས་པ་དེ་ཁོ་ན་རྩ་བའི་དེ་ཁོ་ན་ལ་བློ་ཇི་ལྟར་རྣམ་པར་གཞག་ཅེ་ན་།
 dvividhaṃ hi prasiddhatatvaṃ |	གྲགས་པའི་དེ་ཁོ་ན་ནི་རྣམ་པ་གཉིས་ཏེ་།
 lokaprasiddhaṃ yuktiprasiddhaṃ ca | tatra |	འཇིག་རྟེན་གྱི་གྲགས་པ་དང་། རིགས་པའི་གྲགས་པའོ་༎
 lokaprasiddham ekasmāt	དེ་ལ་། གཅིག་གིས་འཇིག་རྟེན་གྲགས་པ་སྟེ་༎
 parikalpitasvabhāvāt |	ཀུན་བརྟགས་པའི་ངོ་བོ་ཉིད་ཀྱིས་ཏེ་།
 yasmin vastuni saṃketasaṃstavānupraviṣṭayā buddhyā sarveṣāṃ laukikānāṃ darśanatulyatā bhavati |	འཇིག་རྟེན་པ་ཐམས་ཅད་ཀྱི་བརྡ་ལ་འདྲིས་པའི་རྗེས་སུ་ཞུགས་པའི་བློས་དངོས་པོ་གང་ལ་འདི་ནི་ས་ཡིན་གྱི་མེ་མ་ཡིན་ནོ་ཞེས་བྱ་བ་དང་། 
 pṛthivy eveyaṃ nāgnī rūpam evedaṃ na śabda ity evamādi |	འདི་ནི་གཟུགས་ཡིན་གྱི་སྒྲ་མ་ཡིན་ནོ་ཞེས་བྱ་བ་ལ་སོགས་པར་ལྟ་བ་མཐུན་པ་ཡིན་ནོ་༎
 trayād yuktiprasiddhakaṃ |	གསུམ་གྱིས་རིགས་པའི་གྲགས་པའོ་༎
 yat satāṃ yuktārthapaṇḍitānāṃ tārkikāṇāṃ pramāṇatrayaṃ niśrityopapattisādhanayuktyā prasiddhaṃ vastu |	གང་ཟག་དམ་པ་རིགས་པའི་དོན་ལ་མཁས་པ་རྟོག་གེ་པ་སྤྱོད་ཡུལ་ཅན་དག་ཚད་མ་གསུམ་ལ་བརྟེན་ནས་འཐད་པས་སྒྲུབ་པའི་རིགས་པས་གྲགས་པའི་དངོས་པོའོ་༎ 
 [7| viśuddhigocaratattva]	རྣམ་པར་དག་པའི་སྤྱོད་ཡུལ་གྱི་དེ་ཁོ་ན་ཉིད་རྣམ་པ་གཉིས་ཏེ་།
 viśuddhigocaratatvaṃ dvividhaṃ kleśāvaraṇaviśuddhijñānagocaraṃ | jñeyāvaraṇaviśuddhijñānagocaraṃ ca | tad etat |	ཉོན་མོངས་པའི་སྒྲིབ་པ་རྣམ་པར་དག་པའི་ཡེ་ཤེས་ཀྱི་སྤྱོད་ཡུལ་དང་། ཤེས་བྱའི་སྒྲིབ་པ་རྣམ་པར་དག་པའི་ཡེ་ཤེས་ཀྱི་སྤྱོད་ཡུལ་ལོ་༎
 viśuddhigocaraṃ dvedhā ekasmād eva kīrtitaṃ || iii|12	རྣམ་དག་སྤྱོད་ཡུལ་རྣམ་གཉིས་ཏེ་༎ གཅིག་པུ་ཁོ་ནར་བརྗོད་པ་ཡིན་༎
 pariniṣpannād eva svabhāvān na hy anyasvabhāvo viśuddhijñānadvayagocaro bhavati | [8| saṃgrahatattva] kathaṃ trividhe mūlatatve saṃgrahatatvaṃ veditavyaṃ |	ཡོངས་སུ་གྲུབ་པའི་ངོ་བོ་ཉིད་དུ་བརྗོད་དེ་ངོ་བོ་ཉིད་གཞན་ནི་རྣམ་པར་དག་པའི་ཡེ་ཤེས་རྣམ་པ་གཉིས་ཀྱི་སྤྱོད་ཡུལ་མ་ཡིན་ནོ་༎ བསྡུ་བའི་དེ་ཁོ་ན་རྩ་བའི་དེ་ཁོ་ནར་ཇི་ལྟར་རིག་པར་བྱ་ཞེ་ན་།
 nimittasya vikalpasya nāmnaś ca dvayasaṃgrahaḥ |	རྒྱུ་དང་རྣམ་པར་རྟོག་པ་དང་༎ མིང་ནི་རྣམ་པ་གཉིས་སུ་བསྡུ་༎
 yathāyogaṃ pañca vastūny ārabhya nimittavikalpayoḥ paratantreṇa (mvbh 43)	ཅི་རིགས་སུ་སྦྱར་རོ་༎ དངོས་པོ་ལྔ་ལས་བརྩམས་ཏེ་། རྒྱུ་དང་རྣམ་པར་རྟོག་པ་གཉིས་ནི་གཞན་གྱི་དབང་དུ་བསྡུའོ་༎
 saṃgrahaḥ nāmnaḥ parikalpitena |	མིང་ནི་ཀུན་བརྟགས་པར་བསྡུའོ་༎
 samyagjñānasatatvasya ekenaiva ca saṃgrahaḥ || iii|13	ཡང་དག་ཡེ་ཤེས་རབ་ཁོ་ན་༎
 tathatāsamyagjñānayoḥ pariniṣpannena svabhāvena saṃgrahaḥ |	གཅིག་༄༡༣ཨ་༌་༎ པུ་ཁོ་ནས་བསྡུས་པ་ཡིན་༎ དེ་བཞིན་ཉིད་དང་ཡང་དག་པའི་མཐའི་ཡེ་ཤེས་ནི་ཡོངས་སུ་གྲུབ་པའི་ངོ་བོ་ཉིད་ཀྱིས་བསྡུས་སོ་༎ 
 [9| prabhedatattva] prabhedatatvaṃ mūlatatve kathaṃ veditavyaṃ |	རབ་ཏུ་དབྱེ་བའི་དེ་ཁོ་ན་རྩ་བའི་དེ་ཁོ་ནར་ཇི་ལྟར་རིག་པར་བྱ་ཞེ་སོ་༎ ན་། 
 saptavidhaṃ prabhedatatvaṃ pravṛttitatvaṃ | lakṣaṇatatvaṃ | vijñaptitatvaṃ sanniveśatatvaṃ | mithyāpratipattitatvaṃ |	རབ་ཏུ་དབྱེ་བའི་དེ་ཁོ་ན་རྣམ་པ་བདུན་ཏེ་།
 viśuddhitatvaṃ samyakpratipattitatvañ ca | (tatra pravṛttitatvāditrividhaṃ | anavarāgreṣv eti saṃsāraḥ tathatācittasaṃkleśāt satvāḥ saṃkliśyanta iti sarvaṃ duḥkhādisatyaṃ ca yathāsaṃkhyaṃ)	འཇུག་པའི་དེ་ཁོ་ན་དང་། མཚན་ཉིད་ཀྱི་དེ་ཁོ་ན་དང་། རྣམ་པར་རིག་པའི་དེ་ཁོ་ན་དང་། གནས་པའི་དེ་ཁོ་ན་དང་། ལོག་པར་སྒྲུབ་པའི་དེ་ཁོ་ན་དང་། རྣམ་པར་དག་པའི་དེ་ཁོ་ན་དང་། ཡང་དག་པར་སྒྲུབ་པའི་དེ་ཁོ་ན་སྟེ་།
 yaiva ca sandhinirmocanasūtre saptavidhā tathatā nirdiṣṭā | tatra |	དགོངས་པ་ངེས་པར་འགྲེལ་བའི་མདོ་ལས་། དེ་བཞིན་ཉིད་རྣམ་པ་བདུན་འབྱུང་བ་གང་ཡིན་པ་དེ་དག་ཉིད་དོ་༎ དེ་ལ་།
 pravṛttitatvaṃ dvividhaṃ |	འཇུག་དེ་ཁོ་ན་རྣམ་པ་གཉིས་༎
 mūlatatvaṃ veditavyaṃ | parikalpitaparatantralakṣaṇaṃ |	རྩ་བའི་དེ་ཁོ་ན་ཀུན་བརྟགས་པ་དང་། གཞན་གྱི་དབང་གི་མཚན་ཉིད་དུ་རིག་པར་བྱའོ་༎
 yathā pravṛttitatvaṃ tathā |	འཇུག་པའི་དེ་ཁོ་ན་ཇི་ལྟ་བ་བཞིན་དུ་།
 sanniveśakupannatā |	གནས་པ་དང་ནི་ངན་པར་ཞུགས་༎
 sanniveśamithyāpratipattitatve api tathaiva dvividhaṃ mūlatatvaṃ |	གནས་པ་དང་ལོག་པར་སྒྲུབ་པའི་དེ་ཁོ་ན་ཡང་དེ་བཞིན་དུ་རྩ་བའི་དེ་ཁོ་ན་རྣམ་པ་གཉིས་སུ་རིག་པར་བྱའོ་༎
 ekaṃ lakṣaṇavijñaptiśuddhisamyakprapannatā || iii|14	།
 lakṣaṇatatvādīni catvāry ekaṃ mūlatatvaṃ pariniṣpannalakṣaṇaṃ | (mvbh 44) [10| kauśalyatattva]	མཚན་ཉིད་ཀྱི་དེ་ཁོ་ན་ལ་སོགས་པ་བཞི་ནི་རྩ་བའི་དེ་ཁོ་ན་གཅིག་སྟེ་། ཡོངས་སུ་གྲུབ་པའི་མཚན་ཉིད་དོ་༎ མཁས་དེ་ཁོ་ན་རྣམ་བཅུ་ནི་༎
 kauśalyatatvaṃ darśanapratipakṣeṇety uktaṃ |	བདག་ཏུ་ལྟ་བའི་གཉེན་པོའོ་༎
 katham eṣu skandhādiṣu daśavidham ātmadarśanam | ekahetutvabhoktṛtvakartṛtvavaśavartane |	ཞེས་གསུངས་ན་ཕུང་པོ་ལ་སོགས་པ་ལ་བདག་ཏུ་ལྟ་བ་རྣམ་པ་བཅུ་པོ་དེ་དག་ཇི་ལྟ་ཞེ་ན་། 
 ādhipatyārthanityatve kleśaśuddhyāśraye 'pi ca || iii|15	གཅིག་དང་རྒྱུ་དང་ཟ་བ་དང་༎ བྱེད་པ་དང་ནི་དབང་སྒྱུར་དང་༎ བདག་པོའི་དོན་དང་རྟག་པ་དང་༎ ཉོན་མོངས་པ་དང་དག་པའི་གནས་༎ རྣལ་འབྱོར་ཅན་དང་མ་གྲོལ་གྲོལ་༎
 yogitvāmuktamuktatve ātmadarśanam eṣu hi |	འདི་དག་ལ་ནི་བདག་ཏུ་ལྟ་༎
 eṣa daśavidha ātmāsadgrāhaḥ skandhādiṣu pravartate | yasya pratipakṣeṇa daśavidhaṃ kauśalyaṃ yad utaikatvagrāho hetutvagrāho bhoktṛtvagrāhaḥ |	བདག་མེད་པ་ལ་འཛིན་པ་རྣམ་པ་འདི་བཅུ་ནི་། ཕུང་པོ་ལ་སོགས་པ་ལ་འཇུག་སྟེ་། དེའི་གཉེན་པོར་མཁས་པ་རྣམ་པ་བཅུའོ་༎ འདི་ལྟ་སྟེ་།
 kartṛtvagrāhaḥ | svatantragrāhaḥ i adhipatitvagrāho nityatvagrāhaḥ | saṃkliṣṭavyavadānatvagrāho yogitvagrāhaḥ | amuktamuktatvagrāhaś ca |	གཅིག་པུར་འཛིན་པ་དང་། རྒྱུར་འཛིན་པ་དང་། ཟ་བར་འཛིན་པ་དང་། བྱེད་པར་འཛིན་པ་དང་། རང་དབང་དུ་འཛིན་པ་དང་། བདག་པོར་འཛིན་པ་དང་། རྟག་པར་འཛིན་པ་དང་། ཀུན་ནས་ཉོན་མོངས་པ་དང་། རྣམ་པར་བྱང་བར་འཛིན་པ་དང་། རྣལ་འབྱོར་ཅན་དུ་འཛིན་པ་དང་། མ་གྲོལ་༄༡༣བ་བ་དང་གྲོལ་བར་འཛིན་པའོ་༎
 katham idaṃ daśavidhaṃ kauśalyatatvaṃ mūlatatve 'ntarbhavati |	མཁས་པའི་དེ་ཁོ་ན་རྣམ་པ་བཅུ་པོ་འདི་དག་རྩ་བའི་དེ་ཁོ་ནར་ཇི་ལྟར་འདུས་ཤེ་ན་། 
 yatas triṣu svabhāveṣu te skandhādayo 'ntarbhūtāḥ |	འདི་ལྟར་ངོ་བོ་ཉིད་གསུམ་དུ་ཕུང་པོ་ལ་སོགས་པ་དེ་དག་འདུས་སོ་༎
 katham antarbhūtāḥ |	ཇི་ལྟར་འདུས་ཤེ་ན་།
 parikalpavikalpārthadharmatārthena teṣu te || iii|16	ཀུན་དུ་རྟོག་དང་རྣམ་རྟོག་དོན་༎ ཆོས་ཉིད་དོན་གྱིས་དེ་དག་དེར་༎
 trividhaṃ rūpaṃ parikalpitaṃ rūpaṃ yo rūpasya parikalpitaḥ svabhāvaḥ |	ཞེས་བྱའོ་༎ གཟུགས་ལ་སོགས་པ་རྣམ་པ་གསུམ་སྟེ་། ཀུན་བརྟགས་པའི་གཟུགས་ནི་གང་གཟུགས་ཀྱི་ཀུན་བརྟགས་པའི་ངོ་བོ་ཉིད་དོ་༎
 vikalpitaṃ rūpaṃ yo rūpasya paratantraḥ (| ) svabhāvas tatra hi rūpavikalpaḥ kriyate |	རྣམ་པར་བརྟགས་པའི་གཟུགས་ནི་གང་གཟུགས་ཀྱི་གཞན་གྱི་དབང་གི་ངོ་བོ་ཉིད་དེ་།
 dharmatārūpaṃ yo rūpasya pariniṣpannaḥ svabhāvaḥ |	དེ་ལ་གཟུགས་སུ་རྣམ་པར་རྟོག་པར་བྱེད་དོ་༎ ཆོས་ཉིད་ཀྱི་གཟུགས་ནི་གང་གཟུགས་ཀྱི་ཡོངས་སུ་གྲུབ་པའི་ངོ་བོ་ཉིད་དོ་༎
 yathā rūpam evaṃ vedanādayaḥ skandhāḥ dhātvāyatanādayaś ca yojyāḥ |	གཟུགས་ལ་ཇི་ལྟ་བ་བཞིན་དུ་ཚོར་བ་ལ་སོགས་པའི་ཕུང་པོ་རྣམས་དང་། ཁམས་དང་། སྐྱེ་མཆེད་ལ་སོགས་པ་ལ་ཡང་སྦྱར་བར་བྱའོ་༎
 evan triṣu svabhāveṣu skandhādīnām antarbhāvād daśavidhaṃ kauśalyatatvaṃ mūlatatva eva draṣṭavyaṃ |	དེ་ལྟར་ན་ངོ་བོ་ཉིད་གསུམ་དུ་ཕུང་པོ་ལ་སོགས་པ་འདུས་པའི་ཕྱིར་མཁས་པའི་དེ་ཁོ་ན་རྣམ་པ་བཅུ་ནི་རྩ་བའི་དེ་ཁོ་ན་ཉིད་དུ་བལྟའོ་༎ 
 uktam idaṃ yathā daśavidhātmadarśanapratipakṣeṇa skandhādikauśalyaṃ [|	ཇི་ལྟར་བདག་ཏུ་ལྟ་བ་རྣམ་པ་བཅུའི་གཉེན་པོར་ཕུང་པོ་ལ་སོགས་པ་ལ་མཁས་པ་འདི་བཤད་ན་།
 ] skandhādyarthas tu noktaḥ | sa idānīm ucyate| (mvbh 45) [a| skandhārtha]	ཕུང་པོ་ལ་སོགས་པའི་དོན་མ་བཤད་པས་དེ་ད་བརྗོད་པར་བྱ་སྟེ་། ཐོག་མ་དུ་མ་ཉིད་དང་ནི་༎
 anekatvābhisaṃkṣepaparicchedārtha āditaḥ |	བསྡུས་དང་ཡོངས་སུ་ཕྱེ་བའི་དོན་༎
 āditas tāvat skandhās te trividhenārthena veditavyāḥ |	ཐོག་མ་ཁོ་ནར་ཕུང་པོ་དེ་དག་དོན་རྣམ་པ་གསུམ་དུ་རིག་པར་བྱ་སྟེ་།
 anekatvārthena yat kiñcid rūpam atītānāgatapratyutpannam iti vistaraḥ |	དུ་མའི་དོན་ནི་གཟུགས་གང་ཅི་ཡང་རུང་སྟེ་། འདས་པ་དང་མ་འོངས་པ་ཞེས་རྒྱ་ཆེར་འབྱུང་བའོ་༎
 abhisaṃkṣepārthena tat sarvam aikadhyam abhisaṃkṣipyeti |	བསྡུས་པའི་དོན་ནི་དེ་དག་ཐམས་ཅད་གཅིག་ཏུ་བསྡུས་ཏེ་ཞེས་འབྱུང་བའོ་༎
 paricchedārthena ca rūpādilakṣaṇasya pṛthaktvavyavasthānāt |	ཡོངས་སུ་ཕྱེ་བའི་དོན་ནི་གཟུགས་ལ་སོགས་པའི་མཚན་ཉིད་ཐ་དད་དུ་རྣམ་པར་གཞག་པའི་ཕྱིར་རོ་༎ 
 rāśyartho hi skandhārtha evaṃ ca loke rāśyartho dṛṣṭa iti | [b| dhātvartha]	ཕུང་པོའི་དོན་ནི་སྤུངས་པའི་དོན་ཏེ་། དེ་ལྟར་འཇིག་རྟེན་ན་སྤུངས་པའི་དོན་མཐོང་ངོ་༎
 grāhakagrāhyatadgrāhabījārthaś cāparo mataḥ || iii| 17	འཛིན་དང་གཟུང་དང་དེ་འཛིན་པ་༎ ས་བོན་དོན་ཏེ་གཞན་དུ་འདོད་༎
 katamo 'paro dhātus tatra grāhakabījārthaḥ cakṣurdhātvādayaḥ [|	གཞན་གང་ཞེ་ན་། ཁམས་སོ་༎ དེ་ལ་འཛིན་པའི་ས་བོན་གྱི་དོན་ནི་མིག་གི་ཁམས་ལ་སོགས་པའོ་༎
 ] grāhyabījārtho rūpadhātvādayas [|	གཟུང་བའི་ས་བོན་གྱི་དོན་ནི་གཟུགས་ཀྱི་ཁམས་ལ་སོགས་པའོ་༎
 ] tadgrāhabījārthaś cakṣurvijñānadhātvādayaḥ |	དེ་འཛིན་པའི་ས་བོན་གྱི་དོན་ནི་མིག་གི་རྣམ་པར་ཤེས་པའི་ཁམས་ལ་སོགས་༄༡༤ཨ་༌་༎
 [c| āyatanārtha]	པའོ་༎
 veditārthaparicchedabhogāyadvārato 'paraṃ |	ཚོར་དང་དོན་རྣམས་ཡོངས་གཅོད་ཀྱི་༎ ཉེར་སྤྱོད་འབྱུང་སྒོ་གཞན་ཡིན་ནོ་༎
 kim aparaṃ āyatanaṃ |	གཞན་གང་ཡིན་ཞེ་ན་། སྐྱེ་མཆེད་དོ་༎
 tatra veditopabhogāyadvārārthena ṣaḍ ādhyātmikāny āyatanāni |	དེ་ལ་ནང་གི་སྐྱེ་མཆེད་དྲུག་པོ་དག་ནི་ཚོར་བ་ཉེ་བར་སྤྱོད་པའི་སྐྱེ་བའི་སྒོའི་ཕྱིར་རོ་༎ 
 arthaparicchedopabhogāyadvārārthena ṣaḍ bāhyāni |	ཕྱིའི་དྲུག་པོ་དག་ནི་དོན་ཡོངས་སུ་སྤྱོད་པའི་ཉེ་བར་སྤྱོད་པའི་སྐྱེ་བའི་སྒོའི་ཕྱིར་རོ་༎ རོ་༎ 
 [d| pratītyasamutpādārtha] pratītyasamutpādārthaḥ |	རྟེན་ཅིང་འབྲེལ་བར་འབྱུང་བའི་དོན་ནི་།
 punar hetuphalāyāsānāropānapavādataḥii iii|18	རྒྱུ་དང་འབྲས་བུ་རྩོལ་བ་ལ་༎
 hetuphalakriyāṇām asamāropānapavādārthaḥ pratītyasamutpādārthaḥ |	སྒྲོ་འདོགས་མེད་ཅིང་སྐུར་འདེབས་མེད་༎ རྒྱུ་དང་འབྲས་བུ་དང་བྱེད་པ་རྣམས་ལ་སྒྲོ་འདོགས་པ་མེད་པ་དང་། སྐུར་པ་འདེབས་པ་མེད་པའི་དོན་ནི་རྟེན་ཅིང་འབྲེལ་བར་འབྱུང་བའི་དོན་ཏོ་༎
 tatra hetu sa nāropaḥ saṃskārādīnāṃ viṣamahetukalpanāt |	དེ་ལ་རྒྱུ་ལ་སྒྲོ་འདོགས་པ་ནི་འདུ་བྱེད་ལ་སོགས་པའི་མི་མཐུན་པའི་རྒྱུ་ལ་རྟོག་པའི་ཕྱིར་རོ་༎ 
 (mvbh 46) hetvapavādo nirhetukatvakalpanāt phalasamāropaḥ sātmakānāṃ saṃskārādīnām avidyādipratyayapravṛttikalpanāt |	རྒྱུ་ལ་སྐུར་པ་འདེབས་པ་ནི་རྒྱུ་མེད་པ་ཅན་དུ་རྟོག་པའི་ཕྱིར་རོ་༎ འབྲས་བུ་ལ་སྒྲོ་འདོགས་པ་ནི་བདག་དང་བཅས་པའི་འདུ་བྱེད་ལ་སོགས་པ་ནི་མ་རིག་པ་ལ་སོགས་པའི་རྐྱེན་ལས་འབྱུང་བར་རྟོག་པའི་ཕྱིར་རོ་༎ 
 phalāpavādo na santy avidyādipratyayāḥ saṃskārādaya iti kalpanāt |	འབྲས་བུ་ལ་སྐུར་པ་འདེབས་པ་ནི་འདུ་བྱེད་ལ་སོགས་པ་མ་རིག་པ་ལ་སོགས་པའི་རྐྱེན་གྱིས་འབྱུང་བ་མེད་པར་རྟོག་པའི་ཕྱིར་རོ་༎ རོ་༎ བྱེད་པ་ལ་སྒྲོ་འདོགས་པ་ནི་འདུ་བྱེད་ལ་སོགས་པ་སྐྱེ་བ་ལ་མ་རིག་པ་ལ་སོགས་པ་ལ་བྱེད་པར་རྟོག་པའི་རོ་༎ 
 kriyāsamāropo 'vidyādīnāṃ saṃskārādyutpattau vyāpārakalpanāt kriyāpavādo niḥsāmarthyakalpanāt tadabhāvād asamāropānapavādo veditavyaḥ |	རོ་༎ ཕྱིར་རོ་༎ བྱེད་པ་ལ་སྐུར་པ་འདེབས་པ་ནི་ནུས་པ་མེད་པར་རྟོག་རོ་༎ རོ་༎ ཕྱིར་རོ་༎ པའི་ཕྱིར་རོ་༎ དེ་མེད་པའི་ཕྱིར་སྒྲོ་འདོགས་པ་མེད་པ་རོ་༎ རོ་༎ ཕྱིར་རོ་༎ པའི་ཕྱིར་རོ་༎ དང་། སྐུར་པ་འདེབས་པ་མེད་པར་རིག་རོ་༎ རོ་༎ 
 [e| sthānāsthānārtha]	ཕྱིར་རོ་༎ པའི་ཕྱིར་རོ་༎ དང་། པར་བྱའོ་༎ 
 aniṣṭeṣṭaviśuddhīnāṃ samotpattyādhipatyayoḥ |	མི་འདོད་འདོད་དང་རོ་༎ རོ་༎ ཕྱིར་རོ་༎ པའི་ཕྱིར་རོ་༎ དང་། པར་བྱའོ་༎ 
 saṃprāptisamudācārapāratantryārthato 'paraṃ || iii| 19	རྣམ་དག་དང་༎ མཉམ་དུ་འབྱུང་དང་དབང་བྱེད་དང་༎ འཐོབ་དང་ཀུན་ཏུ་སྤྱོད་པ་དག་། གཞན་དབང་ཉིད་ཀྱི་དོན་ཏེ་གཞན་༎
 sthānāsthānaṃ saptavidhapāratantryārthena veditavyaṃ |	གནས་དང་གནས་མ་ཡིན་པ་ནི་གཞན་གྱི་དབང་ཉིད་རྣམ་པ་བདུན་གྱི་དོན་གྱིས་རིག་པར་བྱ་སྟེ་། 
 tatrāniṣṭe pāratantryaṃ duścaritenānicchato 'pi durgatigamanād iṣṭe pāratantryaṃ sucaritena sugatigamanāt |	དེ་ལ་མི་འདོད་པ་གཞན་གྱི་དབང་ཉིད་ནི་ཉེས་པར་སྤྱོད་ལས་མི་འདོད་བཞིན་དུ་ཡང་ངན་འགྲོར་འགྲོ་བའི་ཕྱིར་རོ་༎ འདོད་པ་གཞན་གྱི་དབང་ཉིད་ནི་ལེགས་པར་སྤྱོད་པས་བདེ་འགྲོར་འགྲོ་བའི་ཕྱིར་རོ་༎
 viśuddhau pāratantryaṃ pañca nivaraṇāny aprahāya yāvat saptabodhyaṅgāny abhāvayitvā	རྣམ་པར་དག་པ་གཞན་གྱི་དབང་ཉིད་ནི་སྒྲིབ་པ་ལྔ་མ་སྤངས་ལ་བྱང་ཆུབ་ཀྱི་ཡན་ལག་བདུན་གྱི་བར་དུ་མ་བསྒོམས་ན་སྡུག་བསྔལ་གྱི་མཐར་མི་བྱེད་པའི་ཕྱིར་རོ་༎
 duḥkhasyāntākaraṇāt samotpattau pāratantryaṃ dvayor apūrvācaramayos tathāgatayoś	མཉམ་དུ་འབྱུང་བ་གཞན་གྱི་དབང་ཉིད་ནི་།
 cakravartinoś caikasmin lokadhātāv anutpādād ādhipatye pāratantryaṃ striyāś cakravartitvādyakaraṇāt	དེ་བཞིན་༄༡༤བ་གཤེགས་པ་དང་། འཁོར་ལོས་སྒྱུར་བ་གཉིས་གཉིས་སྔ་ཕྱི་མེད་པར་འཇིག་རྟེན་གྱི་ཁམས་གཅིག་ཏུ་མི་འབྱུང་བའི་ཕྱིར་རོ་༎ དབང་དུ་བྱེད་པ་གཞན་གྱི་དབང་ཉིད་ནི་། བུད་མེད་འཁོར་ལོས་སྒྱུར་བ་ལ་སོགས་པ་མི་བྱེད་པའི་ཕྱིར་རོ་༎
 saṃprāptau pāratantryaṃ striyāḥ pratyekānuttarabodhyanabhisaṃbodhāt samudācāre pāratantryaṃ	འཐོབ་པ་གཞན་གྱི་དབང་ཉིད་ནི་བུད་མེད་ཀྱིས་རང་བྱང་ཆུབ་དང་། བླ་ན་མེད་པའི་བྱང་ཆུབ་མངོན་པར་རྫོགས་པར་བྱང་ཆུབ་པར་མི་འགྱུར་བའི་ཕྱིར་རོ་༎ ཀུན་ཏུ་སྤྱོད་པ་གཞན་གྱི་དབང་ཉིད་ནི་།
 dṛṣṭisaṃpannasya vadhādyupakramāsamudācārāt pṛthagjanasya ca samudācārād vistareṇa	ལྟ་བ་ཕུན་སུམ་ཚོགས་པ་བསོད་པ་ལ་སོགས་པ་ཀུན་ཏུ་མི་སྤྱོད་པས་སོ་༎ སོ་སོའི་སྐྱེ་བོ་ནི་ཀུན་ཏུ་སྤྱོད་པའི་ཕྱིར་ཏེ་།
 bahudhātukasūtrānusārād anugantavyaṃ |	རྒྱ་ཆེར་ནི་ཁམས་མང་པོ་ཅན་གྱི་མདོ་ལས་འབྱུང་བ་བཞིན་དུ་ཁོང་དུ་ཆུད་པར་བྱའོ་༎
 [f| indriyārtha] indriyaṃ punar dvāviṃśatividhaṃ |	དབང་པོ་ནི་རྣམ་པ་ཉི་ཤུ་རྩ་གཉིས་ཏེ་།
 grahaṇasthānasaṃdhānabhogaśuddhidvayārthataḥ | (mvbh 47)	འཛིན་དང་གནས་དང་རྒྱུན་མི་འཆད་༎ སྤྱོད་དང་དག་པ་གཉིས་ཀྱི་ཕྱིར་༎ འཛིན་པའི་ཕྱིར་ནས་རྣམ་པར་དག་པ་གཉིས་ཀྱི་བར་དུ་སྟེ་།
 grahaṇārthena yāvad viśuddhidvayārthena teṣu tadādhipatyād rūpādiviṣayagrahaṇe hi cakṣurādīnāṃ ṣaṇṇām ādhipatyaṃ sthāne jīvitendriyasya tadādhipatyenāmaraṇāt	དེ་དག་ལ་དེ་དབང་བྱེད་པའི་ཕྱིར་རོ་༎ གཟུགས་ལ་སོགས་པ་ཡུལ་འཛིན་པ་ལ་ནི་མིག་ལ་སོགས་པ་དྲུག་པོ་དག་དབང་བྱེད་དོ་༎ གནས་པར་བྱ་བ་ལ་ནི་སྲོག་གི་དབང་པོ་དབང་བྱེད་དེ་། དེའི་དབང་གིས་མི་འཆི་བའི་ཕྱིར་རོ་༎ རིགས་འཚོ་བ་ལ་ནི་ཕོ་དང་མོའི་དབང་པོ་གཉིས་དབང་བྱེད་དེ་།
 kulasandhāne strīpuruṣendriyayor apatyaprasavādhipatyād upabhoge vedanendriyāṇāṃ kuśalākuśalakarmaphalopabhogāt |	བུ་འབྱུང་བར་དབང་བྱེད་པའི་ཕྱིར་རོ་༎ ཉེ་བར་སྤྱོད་པ་ལ་ནི་ཚོར་བའི་དབང་པོ་རྣམས་ཏེ་། དགེ་བ་དང་མི་དགེ་བའི་ལས་ཀྱི་འབྲས་བུ་ལ་ཉེ་བར་སྤྱོད་པའི་ཕྱིར་རོ་༎
 laukikaviśuddhau śraddhādīnāṃ |	འཇིག་རྟེན་པའི་རྣམ་པར་དག་པ་ནི་དད་པ་ལ་སོགས་པའོ་༎
 lokottaraviśuddhau anājñātamājñāsyāmīndriyādīnāṃ | [g| adhvārtha]	འཇིག་རྟེན་ལས་འདས་པའི་རྣམ་པར་དག་པ་ནི་ཀུན་ཤེས་པར་བྱེད་པའི་དབང་པོ་ལ་སོགས་པའོ་༎ འབྲས་བུ་རྒྱུ་རྣམས་སྤྱད་ཟིན་དང་༎ དེ་བཞིན་མ་སྤྱད་གཞན་ཡིན་ནོ་༎ གཞན་གང་ཞེ་ན་། དུས་གསུམ་མོ་༎ ཅི་རིགས་སུ་སྦྱར་ཏེ་།
 phalahetūpayogārthanopayogāt tathāparaṃ || iii|20	འབྲས་བུ་དང་རྒྱུ་སྤྱད་ཟིན་པའི་ཕྱིར་འདས་པའི་དུས་སོ་༎
 kim aparam adhvatrayaṃ yathāyogaṃ phalahetūpayogārthenātīto 'dhvā phalahetvanupayogārthenānāgato 'dhvā hetūpayogaphalānupayogārthena pratyutpanno 'dhvā veditavyaḥ | [h| catuḥsatyārtha]	འབྲས་བུ་དང་རྒྱུ་མ་སྤྱད་པའི་ཕྱིར་མ་འོངས་པའི་དུས་སོ་༎ རྒྱུ་སྤྱད་པ་ལ་འབྲས་བུ་མ་སྤྱད་པའི་ཕྱིར་ད་ལྟར་འབྱུང་བའི་དུས་སུ་རིག་པར་བྱའོ་༎
 vedanāsanimittārthatannimittaprapattitaḥ |	ཚོར་བ་རྒྱུ་དང་བཅས་པའི་དོན་༎ དེ་ཡི་རྒྱུ་ནི་སྒྲུབ་པ་ཡིན་༎
 tacchamapratipakṣārthayogād aparam iṣyate || iii|21	དེ་བཞི་བ་དང་གཉེན་པོའི་དོན་༎ ལྡན་པའི་ཕྱིར་ན་གཞན་དུ་འདོད་༎
 kim aparaṃ satyacatuṣṭayaṃ |	བདེན་པ་བཞི་པོ་དེ་༄༡༥ཨ་༌་༎
 tatra duḥkhasatyaṃ vedanāsanimittārthena yat kiñcid veditam idam atra duḥkhasyeti kṛtvā vedanānimittaṃ punar vedanāsthānīyā dharmā veditavyāḥ	ལ་སྡུག་བསྔལ་གྱི་བདེན་པ་ནི་ཚོར་བ་རྒྱུ་དང་བཅས་པའི་དོན་ཏེ་། གང་ཅི་ཚོར་ཡང་རུང་དེ་ནི་འདིར་སྡུག་བསྔལ་ལོ་ཞེས་བྱ་བའི་ཕྱིར་རོ་༎ ཚོར་བའི་རྒྱུ་ནི་ཚོར་བའི་གནས་ཀྱི་ཆོས་རྣམས་སུ་རིག་པར་བྱའོ་༎ དེ་ཡི་རྒྱུ་ནི་སྒྲུབ་པ་ཡིན་༎
 tannimittapratipattitaḥ samudayasatyaṃ duḥkhasatyanimittaṃ yā pratipattiḥ |	ཀུན་འབྱུང་བ་ཡི་བདེན་པ་སྟེ་༎ སྡུག་བསྔལ་གྱི་རྒྱུ་ནི་སྒྲུབ་པ་གང་ཡིན་པའོ་༎
 tayoḥ śamārthena nirodhasatyaṃ |	དེ་གཉིས་ཞི་བའི་ཕྱིར་འགོག་པའི་བདེན་པའོ་༎
 pratipakṣārthena mārgasatyaṃ | [i| yānatrayārtha]	གཉེན་པོའི་ཕྱིར་ལམ་གྱི་བདེན་པའོ་༎ ཡོན་ཏན་སྐྱོན་དང་རྣམ་མི་རྟོག་། 
 guṇadoṣāvikalpena jñānena parataḥ svayaṃ [|]	ཤེས་པས་གཞན་ལས་བདག་གིས་ནི་༎
 niryāṇād aparaṃ jñeyaṃ | (mvbh 48)	ངེས་པར་འབྱུང་ཕྱིར་གཞན་ཞེས་བྱ་༎
 yānatrayaṃ yathāyogaṃ |	ཐེག་པ་གསུམ་སྟེ་ཅི་རིགས་སུ་སྦྱར་བར་བྱའོ་༎
 tatra nirvāṇasaṃsārayor guṇadoṣajñānena parataḥ (| ) śrutvā niryāṇārthena śrāvakayānaṃ |	དེ་ལ་མྱ་ངན་ལས་འདས་པ་དང་། འཁོར་བ་ལ་ཡོན་ཏན་སྐྱོན་དུ་ཤེས་ཤིང་གཞན་ལས་ཐོས་ནས་ངེས་པར་འབྱུང་བའི་ཕྱིར་ཉན་ཐོས་ཀྱི་ཐེག་པའོ་༎ 
 tenaiva svayam aśrutvā parato niryāṇārthena pratyekabuddhayānaṃ |	གཞན་ལས་མ་ཐོས་པར་དེ་ཉིད་ཀྱིས་བདག་གིས་ངེས་པར་འབྱུང་བའི་ཕྱིར་། རང་སངས་རྒྱས་ཀྱི་ཐེག་པའོ་༎
 avikalpena jñānena svayaṃ niryāṇārthena mahāyānaṃ veditavyaṃ || [j| saṃskṛtāsaṃskṛtārtha]	བདག་གིས་རྣམ་པར་མི་རྟོག་པའི་ཡེ་ཤེས་ཀྱིས་ངེས་པར་འབྱུང་བའི་ཕྱིར་ཐེག་པ་ཆེན་པོར་རིག་པར་བྱའོ་༎ 
 saprajñaptisahetukāt |	བཏགས་བཅས་རྒྱུར་བཅས་རྒྱུ་མཚན་དང་༎ རབ་ཏུ་ཞི་བའི་དོན་བཅས་ནི་༎
 nimittāt praśamāt sārthāt paścimaṃ samudāhṛtaṃ || iii|22	ཐ་མ་ཉིད་དུ་བཤད་པ་ཡིན་༎
 saṃskṛtāsaṃskṛtaṃ tatra saprajñaptir nāmakāyādayaḥ hetur bījasaṃgṛhītam ālayavijñānaṃ |	འདུས་བྱས་དང་འདུས་མ་བྱས་སོ་༎ དེ་ལ་བཏགས་པ་ནི་མིང་གི་ཚོགས་ལ་སོགས་པའོ་༎ རྒྱུ་ནི་ས་བོན་དུ་བསྡུས་པའི་ཀུན་གཞི་རྣམ་པར་ཤེས་པའོ་༎
 nimittaṃ pratiṣṭhādehabhogasaṃgṛhītaṃ | pravṛttivijñānasaṃgṛhītāś ca manaudgrahavikalpaḥ |	རྒྱུ་མཚན་ནི་གནས་དང་ལུས་དང་ལོངས་སྤྱོད་དུ་བསྡུས་པ་དང་། འཇུག་པའི་རྣམ་པར་ཤེས་པར་བསྡུས་པ་ཡིད་དང་། འཛིན་པ་དང་༏་རྣམ་པར་རྟོག་པ་སྟེ་།
 etat saprajñaptisahetukaṃ nimittaṃ sasaṃprayogaṃ saṃskṛtaṃ veditavyaṃ |	བཏགས་པ་དང་བཅས་ཤིང་རྒྱུ་དང་བཅས་པའི་རྒྱུ་མཚན་མཚུངས་པར་ལྡན་པ་དང་བཅས་པ་འདི་ནི་འདུས་བྱས་སུ་རིག་པར་བྱའོ་༎
 tatra mano yan nityaṃ manyanākāraṃ |	དེ་ལ་ཡིད་ནི་གང་རྟག་ཏུ་རློམ་སེམས་པ་ནི་རྣམ་པའོ་༎
 udgrahaḥ pañcavijñānakāyāḥ vikalpo manovijñānaṃ (|	འཛིན་པ་ནི་རྣམ་པར་ཤེས་པའི་ཚོགས་ལྔའོ་༎ རྣམ་པར་རྟོག་པ་ནི་ཡིད་ཀྱི་རྣམ་པར་ཤེས་པ་སྟེ་། དེ་ནི་རྣམ་པར་རྟོག་པར་བྱེད་པའི་ཕྱིར་རོ་༎
 ) tasya vikalpakatvād asaṃskṛtaṃ punaḥ praśamaś ca nirodhaḥ | praśamārthaś ca tathatā tatra praśamo nirodho mārgaś ca yaś ca praśamo yena ceti kṛtvā praśamārthaḥ tathatā praśamasyārtha iti kṛtvā tathatāyā mārgālambanatvāt |	འདུས་མ་བྱས་ནི་རབ་ཏུ་ཞི་བ་འགོག་པ་དང་། རབ་ཏུ་ཞི་བའི་དོན་དེ་བཞིན་ཉིད་དེ་ལམ་གྱི་དམིགས་པ་ཡིན་པའི་ཕྱིར་རོ་༎
 mārgasya praśamatvan tena praśamanāt |	ལམ་ཡང་རབ་ཏུ་ཞི་བ་ཉིད་དོ་༎ དེས་རབ་ཏུ་ཞི་བར་༄༡༥བ་བྱེད་པའི་ཕྱིར་རོ་༎
 ity etenārthena skandhādiṣu jñānaṃ skandhādikauśalyaṃ veditavyaṃ | [tattvapiṇḍārtha]	དེ་ལྟར་དོན་འདིས་ཕུང་པོ་ལ་སོགས་པ་ཤེས་པ་ནི་ཕུང་པོ་ལ་སོགས་པ་ལ་མཁས་པར་རིག་པར་བྱའོ་༎ 
 tatvasya piṇḍārthaḥ | samāsato dvividhaṃ tatvaṃ |	དེ་ཁོ་ནའི་དོན་བསྡུས་པ་ནི་མདོར་བསྡུ་ན་དེ་ཁོ་ན་རྣམ་པ་གཉིས་རིག་པར་བྱའོ་༎ ཏེ་། 
 ādarśatatvaṃ |	མེ་ལོང་ལྟ་བའི་དེ་ཁོ་ན་དང་། སྣང་བའི་དེ་ཁོ་ནའོ་༎ དེ་ལ་མེ་ལོང་ལྟ་བུའི་དེ་ཁོ་ན་ནི་རྩ་བའི་རེ་ཁོ་ན་སྟེ་།
 dṛśyatatvaṃ ca tatrādarśatatvaṃ mūlatatvaṃ tatra śeṣāṇāṃ darśanāt |	ལྷག་མ་རྣམས་དེར་སྣང་བའི་ཕྱིར་རོ་༎
 (mvbh 49) dṛśyatatvaṃ navavidhaṃ nirabhimānadṛśyatatvaṃ | aviparyāsadṛśyatatvaṃ | śrāvakayānaniryāṇadṛśyatatvaṃ |	སྣང་བའི་དེ་ཁོ་ན་ནི་རྣམ་པ་དགུ་སྟེ་།
 mahāyānaniryāṇadṛśyatatvaṃ | audārikeṇa paripācanāt | sūkṣmeṇa ca vimocanāt paravādinigrahadṛśyatatvaṃ |	ང་རྒྱལ་མེད་པའི་སྣང་བའི་དེ་ཁོ་ན་དང་། ཕྱིན་ཅི་ལོག་གི་གཉེན་པོའི་སྣང་བའི་དེ་ཁོ་ན་དང་། ཉན་ཐོས་ཀྱི་ཐེག་པས་ངེས་པར་འབྱུང་བ་སྣང་བའི་དེ་ཁོ་ན་དང་། རགས་པས་ཡོངས་སུ་སྨིན་པར་བྱེད་ཅིང་ཕྲ་བས་རྣམ་པར་གྲོལ་བར་བྱེད་པའི་ཕྱིར་ཐེག་པ་ཆེན་པོས་ངེས་པར་འབྱུང་བ་སྣང་བའི་དེ་ཁོ་ན་དང་། 
 dṛṣṭāntasanniśrayeṇa yuktyā nigrahāt | mahāyānābhidyotanadṛśyatatvaṃ | sarvākārajñeyapraveśadṛśyatatvaṃ | avitathatathatābhidyotanadṛśyatatvaṃ | ātmagrāhavastusarvābhisandhipraveśadṛśyatatvaṃ ca || ḥ ||	དཔེ་ལ་བརྟེན་ཏེ་རིགས་པས་ཚར་གཅོད་པའི་ཕྱིར་ཕས་ཀྱི་རྒོལ་བ་ཚར་གཅོད་པ་སྣང་བའི་དེ་ཁོ་ན་དང་། ཐེག་པ་ཆེན་པོ་མངོན་པར་བརྗོད་པ་སྣང་བའི་དེ་ཁོ་ན་དང་། ཤེས་བྱའི་རྣམ་པ་ཐམས་ཅད་ལ་འཇུག་པ་སྣང་བའི་དེ་ཁོ་ན་དང་། མ་ནོར་བའི་དེ་བཞིན་ཉིད་མངོན་པར་བརྗོད་པ་སྣང་བའི་དེ་ཁོ་ན་དང་། བདག་ཏུ་འཛིན་པའི་གཞི་ལ་དགོངས་པ་ཐམས་ཅད་རྟོགས་པ་སྣང་བའི་དེ་ཁོ་ནའོ་༎
 madhyāntavibhāgaśāstre tatvaparicchedas tṛtīyaḥ || ḥ || (mvbh 50) [chapter iv| pratipakṣabhāvanāvasthāphalapariccheda]	བསྟན་བཅོས་དབུས་དང་མཐའ་རྣམ་པར་འབྱེད་པ་ལས་དེ་ཁོ་ན་ཞེས་བྱ་བའི་ལེའུར་བཅད་པ་གསུམ་པའི་འགྲེལ་པའོ་། ༎ ། བསྟན་བཅོས་དབུས་དང་མཐའ་རྣམ་པར་འབྱེད་པའི་འགྲེལ་པ་། བམ་པོ་གཉིས་པ་སྟེ་ཐ་མ་༎
 pratipakṣabhāvanā bodhipakṣyabhāvanā sedānīṃ vaktavyā | [a| catvāri smṛtyupasthānāni]	གཉེན་པོ་བསྒོམ་པ་ནི་བྱང་ཆུབ་ཀྱི་ཕྱོགས་བསྒོམ་པ་སྟེ་། དེ་ད་བརྗོད་པར་བྱའོ་༎
 tatra tāvad ādau |	དེ་ལ་རེ་ཞིག་དང་པོར་།
 dauṣṭhulyāt tarṣahetutvād vastutvād avimohataḥ |	གནས་ངན་ལེན་ཕྱིར་སྲེད་རྒྱུའི་ཕྱིར་༎ གཞི་ཡི་ཕྱིར་དང་མ་རྨོངས་ཕྱིར་༎
 catuḥsatyāvatārāya smṛtyupasthānabhāvanā || iv|1	བདེན་པ་བཞི་ལ་འཇུག་བྱ་བས་༎ དྲན་པ་ཉེ་བར་གཞག་པ་བསྒོམ་༎
 kāyena hi dauṣṭhulyaṃ prabhāvyate |	ལུས་ཀྱིས་ནི་གནས་ངན་ལེན་རབ་ཏུ་སྟོན་ཏེ་།
 tatparīkṣayā duḥkhasatyam avatarati |	དེ་ཡང་ཡོངས་སུ་བརྟགས་པས་སྡུག་བསྔལ་གྱི་བདེན་པ་ལ་འཇུག་གོ་༎
 tasya sadauṣṭhulyasaṃskāralakṣaṇatvāt |	དེའི་མཚན་ཉིད་ནི་གནས་ངན་ལེན་དང་བཅས་པའི་འདུ་བྱེད་ཡིན་པའི་ཕྱིར་རོ་༎
 dauṣṭhulyaṃ hi saṃskāraduḥkhatā | tayā sarvaṃ sāsravaṃ vastv āryā duḥkhataḥ paśyantīti |	གནས་ངན་ལེན་ནི་འདུད་བྱེད་ཀྱི་སྡུག་བསྔལ་ཉིད་དེ་དེས་ཟག་པ་དང་བཅས་པའི་དངོས་པོ་ཐམས་ཅད་འཕགས་པས་སྡུག་བསྔལ་དུ་གཟིགས་སོ་༎
 tṛṣṇāhetur vedanā tatparīkṣayā samudayasatyam avatarati |	སྲེད་པའི་རྒྱུ་ནི་ཚོར་བ་སྟེ་། དེ་ལ་ཡོངས་སུ་༄༡༦ཨ་༌་༎ བརྟགས་པས་ཀུན་འབྱུང་གི་བདེན་པ་ལ་འཇུག་གོ་༎
 ātmābhiniveśavastu cittaṃ tatparīkṣayā nirodhasatyam avataraty ātmocchedabhayāpagamāt |	བདག་ཏུ་མངོན་པར་ཞེན་པའི་གཞི་ནི་སེམས་ཏེ་། དེ་ལ་ཡོངས་སུ་བརྟགས་པས་འགོག་པའི་བདེན་པ་ལ་འཇུག་སྟེ་། བདག་ཆད་པར་དོགས་པའི་འཇིགས་པ་མེད་པའི་ཕྱིར་རོ་༎
 dharmaparīkṣayā sāṃkleśikavaiyavadānikadharmāsaṃmohāt | mārgasatyam avataraty ataḥ (| ) ādau catuḥsatyāvatārāya smṛtyupasthānabhāvanā vyavasthāpyate | [b| catvāri samyakprahāṇāni]	ཆོས་ལ་ཡོངས་སུ་བརྟགས་པས་ཀུན་ནས་ཉོན་མོངས་པ་དང་རྣམ་པར་བྱང་བའི་ཆོས་ལ་རྨོངས་པ་མེད་པའི་ཕྱིར་ལམ་གྱི་བདེན་པ་ལ་འཇུག་གོ་༎ དེ་བས་ན་བདེན་པ་བཞི་ལ་འཇུག་པར་བྱ་བའི་ཕྱིར་ཐོག་མར་དྲན་པ་ཉེ་བར་གཞག་པ་བསྒོམ་པ་རྣམ་པར་གཞག་གོ་༎
 tataḥ samyakprahāṇabhāvanā yasmāt |	དེའི་འོག་ཏུ་ཡང་དག་པར་སྤོང་བ་བསྒོམ་པ་སྟེ་།
 parijñāte vipakṣe ca pratipakṣe ca sarvathā |	འདི་ལྟར་མི་མཐུན་ཕྱོགས་དང་གཉེན་པོ་རྣམས་༎ རྣམ་པ་ཐམས་ཅད་ཡོངས་ཤེས་ན་།
 tadapāyāyavīryaṃ hi caturdhā saṃpravartate || iv|2	དེ་དག་སྤང་ཕྱིར་བརྩོན་འགྲུས་ནི་༎ རྣམ་པ་བཞི་དག་རབ་ཏུ་འབྱུང་༎
 smṛtyupasthānabhāvanayā vipakṣe pratipakṣe ca sarvaprakāraṃ parijñāte vipakṣāpagamāya pratipakṣopagamāya ca vīryañ caturdhā saṃpravartate |	དྲན་པ་ཉེ་བར་གཞག་པ་བསྒོམས་པས་མི་མཐུན་པའི་ཕྱོགས་དང་གཉེན་པོ་རྣམ་པ་ཐམས་ཅད་དུ་ཡོངས་སུ་ཤེས་ན་།
 utpannānāṃ pāpakānām akuśalānāṃ dharmāṇāṃ prahāṇāyeti vistaraḥ | (mvbh 51) [c| catvāra ṛddhipādāḥ]	མི་མཐུན་པའི་ཕྱོགས་གསལ་ཞིང་གཉེན་པོ་བསྐྱེད་པའི་ཕྱིར་བརྩོན་འགྲུས་རྣམ་པ་བཞི་རབ་ཏུ་འབྱུང་སྟེ་། སྡིག་པ་མི་དགེ་བའི་ཆོས་སྐྱེས་པ་རྣམས་སྤང་བའི་ཕྱིར་ཞེས་རྒྱ་ཆེར་འབྱུང་བའོ་༎
 karmaṇyatā sthites tatra sarvārthānāṃ samṛddhaye |	དེར་གནས་ལས་སུ་རུང་བ་ཉིད་༎ དོན་རྣམས་ཐམས་ཅད་འབྱོར་པར་འགྱུར་༎
 pañcadoṣaprahāṇāṣṭasaṃskārāsevanānvayā || iv|3	ཉེས་པ་ལྔ་སྤོང་འདུ་བྱེད་བརྒྱད་༎ བརྟེན་པའི་རྒྱུ་ལས་བྱུང་བའོ་༎
 tasyāṃ tadapāyāyavīryabhāvanāyāṃ cittasthiteḥ (|	དེ་སྤང་བའི་ཕྱིར་བརྩོན་འགྲུས་རྩོམ་པ་དེ་ལ་སེམས་གནས་པའི་ལས་སུ་རུང་བ་ཉིད་ནི་རྫུ་འཕྲུལ་གྱི་རྐང་པ་བཞི་པོ་དག་སྟེ་།
 ) karmaṇyatā catvāra ṛddhipādāḥ sarvārthasamṛddhihetutvāt sthitir atra cittasthitiḥ samādhir veditavyaḥ |	དོན་ཐམས་ཅད་འབྱོར་བའི་རྒྱུ་ཡིན་པའི་ཕྱིར་རོ་༎ གནས་པ་ནི་འདིར་སེམས་གནས་པ་སྟེ་ཏིང་ངེ་འཛིན་དུ་རིག་པར་བྱའོ་༎
 ataḥ samyakprahāṇānantaram ṛddhipādāḥ |	དེའི་ཕྱིར་ཡང་དག་པར་སྤང་བའི་འོག་ཏུ་རྫུ་འཕྲུལ་གྱི་རྐང་པ་རྣམས་སོ་༎
 sā punaḥ karmaṇyatā pañcadoṣaprahāṇāyāṣṭaprahāṇasaṃskārabhāvanānvayā veditavyā | [paṃca dosāḥ]	ལས་སུ་རུང་བ་དེ་ཡང་ཉེས་པ་ལྔ་སྤང་བའི་ཕྱིར་སྤོང་བའི་འདུ་བྱེད་བརྒྱད་བསྒོམ་པའི་རྒྱུ་ལས་བྱུང་བར་རིག་པར་བྱའོ་༎
 katame pañca doṣā ity āha |	ཉེས་པ་ལྔ་པོ་དེ་དག་གང་ཞེ་ན་། གསུངས་པ་།
 kausīdyam avavādasya saṃmoṣo laya uddhataḥ |	ལེ་ལོ་དང་ནི་གདམས་ངག་རྣམས་༎ བརྗེད་དང་བྱིང་དང་རྒོད་པ་དང་༎ འདུ་མི་བྱེད་དང་འདུ་བྱེད་དེ་༎
 asaṃskāro 'tha saṃskāraḥ pañca doṣā ime matāḥ || iv|4	འདི་དག་ཉེས་པ་ལྔར་འདོད་དོ་༎
 tatra layauddhatyam eko doṣaḥ kriyate |	དེ་ལ་བྱིང་བ་དང་རྒོད་པ་ནི་ཉེས་པ་གཅིག་ཏུ་བསྡུའོ་༎
 anabhisaṃskāro layauddhatyapraśamanakāle doṣaḥ |	བྱིང་བ་དང་རྒོད་པ་རབ་ཏུ་ཞི་བར་བྱ་བའི་དུས་ན་མངོན་པར་༄༡༦བ་འདུ་མི་བྱེད་ན་ཉེས་པའོ་༎ 
 abhisaṃskāraḥ praśāntau [|]	རབ་ཏུ་ཞི་བའི་ཚེ་ནི་མངོན་པར་འདུ་བྱེད་པའོ་༎
 [aṣṭa prahāṇasaṃskārāḥ] eṣāṃ prahāṇāya katham aṣṭau prahāṇasaṃskārā vyavasthāpyante |	དེ་དག་སྤང་བའི་ཕྱིར་སྤོང་བའི་འདུ་བྱེད་བརྒྱད་ཇི་ལྟར་རྣམ་པར་གཞག་ཅེ་ན་།
 catvāraḥ kausīdyaprahāṇāya cchandavyāyāmaśraddhāprasrabdhayas te punar yathākramaṃ veditavyāḥ |	ལེ་ལོ་སྤང་བའི་ཕྱིར་བཞི་སྟེ་། འདུན་པ་དང་། རྩོལ་བ་དང་། དད་པ་དང་། ཤིན་ཏུ་སྦྱངས་པའོ་༎ དེ་དག་ཀྱང་གོ་རིམས་བཞིན་དུ་རིག་པར་བྱ་སྟེ་།
 āśrayo 'thāśritas tasya nimittaṃ phalam eva ca |	གནས་དང་དེ་ལ་གནས་པ་དང་། རྒྱུ་དང་འབྲས་བུ་ཉིད་དུའོ་༎
 āśrayaś chando vyāyāmasya |	རྩོལ་བའི་གནས་ནི་འདུན་པའོ་༎ གནས་པ་ནི་རྩོལ་བའོ་༎
 āśrito vyāyāmas tasyāśrayasya cchandasya nimittaṃ śraddhā saṃpratyaye (|	གནས་འདུན་པ་དེའི་རྒྱུ་ནི་དད་པ་སྟེ་།
 ) saty abhilāṣāt tasyāśritasya vyāyāmasya phalaṃ prasrabdhir ārabdhavīryasya samādhiviśeṣādhigamāc (mvbh 52)	ཡིད་ཆེས་པར་གྱུར་ན་མངོན་པར་འདོད་པའི་ཕྱིར་རོ་༎ གནས་རྩོལ་བ་དེའི་འབྲས་བུ་ནི་ཤིན་ཏུ་སྦྱངས་པ་སྟེ་། བརྩོན་འགྲུས་བརྩམས་པས་ཏིང་ངེ་འཛིན་གྱི་ཁྱད་པར་ཐོབ་པའི་ཕྱིར་རོ་༎
 cheṣāś catvāraḥ prahāṇasaṃskārāḥ smṛtisaṃprajanyacetanopekṣāś caturṇāṃ doṣāṇāṃ yathāsaṃkhyaṃ pratipakṣās te punaḥ smṛtyādayo veditavyā yathākramaṃ	སྤོང་བའི་འདུ་བྱེད་ལྷག་མ་བཞི་ནི་དྲན་པ་དང་། ཤེས་བཞིན་དང་། སེམས་པ་དང་། བཏང་སྙོམས་ཏེ་ཉེས་པ་བཞིའི་གཉེན་པོར་གྲངས་བཞིན་ནོ་༎ དེ་དག་ཀྱང་དྲན་པ་ལ་སོགས་པར་རིག་པར་བྱ་སྟེ་གོ་རིམས་བཞིན་ནོ་༎
 ālambane 'saṃmoṣo layauddhatyānubuddhyanā | tadapāyābhisaṃskāraḥ śāntau praśaṭhavāhitā || iv|5	དམིགས་པ་བརྗེད་པར་མ་གྱུར་དང་༎ བྱིང་དང་རྒོད་པ་རྟོགས་པ་དང་༎ དེ་སྤོང་མངོན་པར་འདུ་བྱེད་དང་༎ ཞི་ཚེ་རྣལ་དུ་འཇུག་པའོ་༎
 smṛtir ālambane 'saṃpramoṣaḥ saṃprajanyaṃ smṛtyasaṃpramoṣe sati layauddhatyānubodhaḥ |	དྲན་པ་ནི་དམིགས་པ་མ་བརྗེད་པའོ་༎ ཤེས་བཞིན་ནི་དྲན་པ་མ་བརྗེད་པར་གྱུར་ན་བྱིང་བ་དང་རྒོད་པ་རྟོགས་པའོ་༎
 anubudhya tadapagamāyābhisaṃskāraś cetanā |	རྟོགས་ནས་དེ་དང་འབྲལ་བའི་ཕྱིར་མངོན་པར་འདུ་བྱེད་པ་ནི་སེམས་པའོ་༎
 tasya layauddhatyasyopaśāntau satyāṃ praśaṭhavāhitā cittasyopekṣā [|] [d| pañcendriyāṇi]	བྱིང་བ་དང་རྒོད་པ་དེ་ཉེ་བར་ཞི་བར་གྱུར་པ་ན་རྣལ་དུ་འཇུག་པ་ནི་སེམས་བཏང་སྙོམས་སུ་བྱེད་པའོ་༎
 ṛddhipādānām anantaraṃ pañcendriyāṇi śraddhādīni teṣāṃ kathaṃ vyavasthānaṃ |	རྫུ་འཕྲུལ་གྱི་རྐང་པའི་འོག་ཏུ་དབང་པོ་རྣམས་ཏེ་དད་པ་ལ་སོགས་པའོ་༎ དེ་དག་ལས་ཇི་ལྟར་རྣམ་པར་གཞག་ཅེ་ན་།
 ropite mokṣabhāgīye cchandayogādhipatyataḥ |	ཐར་པའི་ཆ་དང་མཐུན་བསྐྱེད་ནས་༎
 ālambane 'saṃmoṣāvisāravicayasya ca || iv|6	འདུན་དང་སྦྱོར་བ་དབང་བྱེད་དང་༎ དམིགས་པ་བརྗེད་པར་མ་གྱུར་དང་༎ མི་འཕྲོ་རྣམ་པར་འབྱེད་ཀྱང་ངོ་༎
 ādhipatyata iti vartate |	དབང་བྱེད་པ་ཞེས་བྱ་བར་སྙེགས་སོ་༎
 ṛddhipādaiḥ karmaṇyacittasyāropite mokṣabhāgīye kuśalamūle cchandādhipatyataḥ prayogādhipatyataḥ |	རྫུ་འཕྲུལ་གྱི་རྐང་པ་རྣམས་ཀྱི་སེམས་ལས་སུ་རུང་བ་དང་། ཐར་བའི་ཆ་དང་མཐུན་པའི་དགེ་བའི་རྩ་བ་བསྐྱེད་ནས་། འདུན་པ་ནི་དབང་བྱེད་པ་། སྦྱོར་བ་ནི་དབང་བྱེད་པ་།
 ālambanāsaṃpramoṣādhipatyataḥ |	དམིགས་པ་ན་བརྗེད་པ་ནི་དབང་བྱེད་པ་།
 avisārādhipatyataḥ |	མི་འཕྲོ་བ་ནི་དབང་བྱེད་པ་༎
 pravicayādhipatyataś ca |	རབ་ཏུ་རྣམ་པར་འབྱེད་པ་ནི་དབང་བྱེད་པ་སྟེ་།
 yathākramaṃ pañca śraddhādīnīndriyāṇi veditavyāni | [e| pañca balāni]	༄༡༧ཨ་༌་༎ དད་པ་ལ་སོགས་པ་དབང་པོ་ལྔ་དག་དང་གོ་རིམས་བཞིན་དུ་རིག་པར་བྱའོ་༎
 tāny eva śraddhādīni balavanti balānīty ucyante | teṣāṃ punar balavatvaṃ vipakṣasya hi saṃlekhad | (mvbh 53)	དད་པ་ལ་སོགས་པ་དེ་དག་ཉིད་སྟོབས་དང་ལྡན་པར་འགྱུར་བ་ལ་སྟོབས་རྣམས་ཞེས་བྱ་སྟེ་། དེ་དག་མི་མཐུན་ཕྱོགས་ནི་སྲབ་པའི་ཕྱིར་།
 yadā tāny aśraddhādibhir vipakṣair na vyavakīryante |	སྟོབས་ལྡན་གང་གི་ཚེ་དེ་དག་ཉིད་མ་དད་པ་ལ་སོགས་པ་མི་མཐུན་པའི་ཕྱོགས་དང་མི་འདྲེ་བ་ནའོ་༎ 
 kasmāc chraddhādīnāṃ pūrvottaranirdeśaḥ | yasmāt	ཅིའི་ཕྱིར་དད་པ་ལ་སོགས་པ་སྔ་ཕྱིར་བསྟན་ཞེ་ན་།
 pūrvasya phalam uttaraṃ |	འདི་ལྟར་སྔ་མའི་འབྲས་བུ་ཕྱི་མ་ཡིན་།
 śraddadhāno hi hetuphalaṃ vīryam ārabhate |	རྒྱུ་དང་འབྲས་བུ་ལ་དད་པར་གྱུར་བའི་རྒྱུས་འབྲས་བུ་ལ་བརྩོན་འགྲུས་རྩོམ་མོ་༎
 ārabdhavīryasya smṛtir upatiṣṭhate |	བརྩོན་འགྲུས་བརྩམས་པས་ནི་དྲན་པ་ཉེ་བར་གནས་སོ་༎
 upasthitasmṛteś cittaṃ samādhīyate |	དྲན་པ་ཉེ་བར་གནས་པས་ནི་སེམས་མཉམ་པར་འཇོག་གོ་༎
 samāhitacitto yathābhūtaṃ prajānāti |	སེམས་མཉམ་པར་གཞག་པས་ནི་ཡང་དག་པ་ཇི་ལྟ་བ་བཞིན་དུ་རབ་ཏུ་ཤེས་སོ་༎
 avaropitamokṣabhāgīyasyendriyāṇy uktāny atha nirvedhabhāgīyāni kim indriyāvasthāyāṃ veditavyāny āhosvid balāvasthāyāṃ |	ཐར་པའི་ཆ་དང་མཐུན་པ་བསྐྱེད་ཟིན་ནས་དབང་པོ་རྣམས་བསྟན་ན་། ངེས་པར་འབྱེད་པའི་ཆ་དང་མཐུན་པ་རྣམས་ཅི་དབང་པོའི་དུས་ལ་རིག་པར་བྱའམ་། འོན་ཏེ་སྟོབས་ཀྱི་དུས་ལ་རིག་པར་བྱ་ཞེ་ན་།
 dvau dvau nirvedhabhāgīyāv indriyāṇi balāni ca || iv|7	དབང་པོ་རྣམས་དང་སྟོབས་རྣམས་ལ་༎ དེས་འབྱེད་ཆ་མཐུན་གཉིས་གཉིས་སོ་༎
 uṣmagataṃ mūrdhānaś cendriyāṇi |	དྲོ་བར་གྱུར་པ་རྣམས་དང་རྩེ་མོ་དག་གི་ཚེ་ནི་དབང་པོ་རྣམས་སོ་༎
 kṣāntayo laukikāś cāgradharmā balāni | [f| sapta bodhyaṅgāni]	བཟོད་པ་དག་དང་འཇིག་རྟེན་པའི་ཆོས་ཀྱི་མཆོག་རྣམས་ཀྱི་ཚེ་ནི་སྟོབས་རྣམས་སོ་༎
 balānantaraṃ bodhyaṅgāni teṣāṃ kathaṃ vyavasthānaṃ |	སྟོབས་ཀྱི་འོག་ཏུ་བྱང་ཆུབ་ཀྱི་ཡན་ལག་རྣམས་ཏེ་། དེ་དག་ཇི་ལྟར་རྣམ་པར་གཞག་ཅེ་ན་།
 āśrayāṅgaṃ svabhāvāṅgaṃ niryāṇāṅgaṃ tṛtīyakaṃ |	།
 caturtham anuśaṃsāṅgan niḥkleśāṅgaṃ tridhā mataṃ || iv|8	བཞི་པ་ཕན་ཡོན་ཡན་ལག་ཡིན་༎ རྣམ་གསུམ་ཉོན་མོངས་མེད་ཡན་ལག་། 
 darśanamārge bodhāv aṅgāni bodhyaṅgāni |	མཐོང་བའི་ལམ་ལ་བྱང་ཆུབ་ཀྱི་ཡན་ལག་ཏུ་གྱུར་པ་དག་ནི་བྱང་ཆུབ་ཀྱི་ཡན་ལག་རྣམས་སོ་༎
 tatra bodher āśrayāṅgaṃ smṛtiḥ |	དེ་ལ་དྲན་པ་ནི་བྱང་ཆུབ་ཀྱི་གནས་ཀྱི་ཡན་ལག་གོ་༎
 svabhāvāṅgaṃ dharmavicayaḥ |	ཆོས་རྣམ་པར་འབྱེད་པ་ནི་རང་བཞིན་གྱི་ཡན་ལག་གོ་༎
 niryāṇāṅgaṃ vīryaṃ |	བརྩོན་འགྲུས་ནི་ངེས་པར་འབྱུང་བའི་ཡན་ལག་གོ་༎
 anuśansāṅgaṃ prītiḥ |	དགའ་བ་ནི་ཕན་ཡོན་གྱི་ཡན་ལག་གོ་༎
 asaṃkleśāṅgaṃ tridhā prasrabdhisamādhyupekṣāḥ |	རྣམ་པ་གསུམ་ནི་ཀུན་ནས་ཉོན་མོངས་པ་མེད་པའི་ཡན་ལག་སྟེ་། ཤིན་ཏུ་སྦྱངས་པ་དང་། ཏིང་ངེ་འཛིན་དང་། བཏང་སྙོམས་སོ་༎
 kimarthaṃ punar asaṃkleśāṅgaṃ tridhā deśitaṃ (mvbh 54)	ཅིའི་ཕྱིར་ཀུན་ནས་ཉོན་མོངས་པ་མེད་པའི་ཡན་ལག་རྣམ་པ་གསུམ་དུ་བསྟན་ཞེ་ན་།
 nidānenāśrayeṇeha svabhāvena ca deśitaṃ |	འདི་ལ་གཞི་དང་གནས་དང་ནི་༎
 asaṃkleśasya nidānaṃ prasrabdhir dauṣṭhulyahetutvāt saṃkleśasya |	༄༡༧བ་ངོ་བོ་ཉིད་དུ་བསྟན་པ་ཡིན་༎ ཀུན་ནས་ཉོན་མོངས་པ་ནི་གནས་ངན་ལེན་གྱི་རྒྱུ་ལས་བྱུང་བའི་ཕྱིར་རོ་༎ ཤིན་ཏུ་སྦྱངས་པ་ནི་ཀུན་ནས་ཉོན་མོངས་པ་མེད་པའི་གཞི་སྟེ་།
 tasyāś ca tatpratipakṣatvād āśrayaḥ samādhiḥ |	དེ་ནི་དེའི་གཉེན་པོ་ཡིན་པའི་ཕྱིར་རོ་༎ ཏིང་ངེ་འཛིན་ནི་གནས་སོ་༎
 svabhāvaupekṣā [|] [g| aṣṭa mārgāṅgāni]	བཏང་སྙོམས་ནི་ངོ་བོ་ཉིད་དོ་༎
 bodhyaṅgānantaraṃ mārgāṅgāni teṣāṃ kathaṃ vyavasthānaṃ |	བྱང་ཆུབ་ཀྱི་ཡན་ལག་གི་འོག་ཏུ་ལམ་གྱི་ཡན་ལག་རྣམས་ཏེ་། དེ་དག་ཇི་ལྟར་རྣམ་པར་གཞག་ཅེ་ན་།
 paricchedo 'tha saṃprāptiḥ parasaṃbhāvanā tridhā [||] iv|9	ཡོངས་སུ་གཅོད་དང་གོ་བྱེད་དང་༎ རྣམ་གསུམ་གཞན་ཡིད་ཆེས་པར་བྱེད་༎
 vipakṣapratipakṣaś ca mārgasyāṅgaṃ tad aṣṭadhā |	མི་མཐུན་ཕྱོགས་ཀྱི་གཉེན་པོར་ནི་༎ ལམ་གྱི་ཡན་ལག་དེ་བརྒྱད་དོ་༎
 bhāvanāmārge 'sya paricchedāṅgaṃ samyagdṛṣṭir laukikī lokottarapṛṣṭhalabdhā yayā svādhigamaṃ paricchinatti |	ཡང་དག་པའི་ལྟ་བ་ནི་བསྒོམ་པའི་ལམ་གྱི་ཚེ་མཐོང་བའི་ལམ་ལ་ཡོངས་སུ་གཅོད་པའི་ཡན་ལག་སྟེ་། འཇིག་རྟེན་ལས་འདས་པའི་རྗེས་ལས་ཐོབ་པ་འཇིག་རྟེན་པ་དེས་རང་གི་རྟོགས་པ་ཡོངས་སུ་གཅོད་དོ་༎
 parasaṃprāpaṇāṅgaṃ samyaksaṃkalpaḥ samyagvāk ca |	ཡང་དག་པའི་རྟོག་པ་དང་། ཡང་དག་པའི་ངག་ནི་གཞན་གོ་བར་བྱེད་པའི་ཡན་ལག་སྟེ་།
 sasamutthānayā vācā tatprāpaṇāt |	ཀུན་སློང་བ་དང་བཅས་པས་ངག་གི་དེ་གོ་བར་བྱེད་པའི་ཕྱིར་རོ་༎
 parasaṃbhāvanāṅgaṃ tridhā samyagvākkarmāntājīvās tair hi yathākramaṃ |	གཞན་ཡིད་ཆེས་པར་བྱེད་པའི་ཡན་ལག་ནི་རྣམ་པ་གསུམ་སྟེ་། ཡང་དག་པའི་ངག་དང་། ལས་ཀྱི་མཐའ་དང་། འཚོ་བའོ་༎ དེ་དག་ཀྱང་གོ་རིམས་བཞིན་དུ་།
 dṛṣṭau śīle 'tha saṃlekhe paravijñaptir iṣyate || iv|10	ལྟ་དང་ཚུལ་ཁྲིམས་ཡོ་བྱད་བསྙུངས་༎ གཞན་ལ་རྣམ་པར་རིག་བྱེད་འདོད་༎
 tasya samyagvācā kathāsāṃkathyaviniścayena prajñāyāṃ saṃbhāvanā bhavati |	ཡང་དག་པའི་ངག་གིས་བསྙད་པ་དང་། འབྲེལ་པའི་གཏམ་རྣམ་པར་ངེས་པས་ཤེས་རབ་ལ་ཡིད་ཆེས་པར་འགྱུར་རོ་༎ ཡང་དག་པའི་ལས་ཀྱི་མཐའ་ནི་ཚུལ་ཁྲིམས་ལ་སྟེ་། བྱ་བ་མ་ཡིན་པ་མི་བྱེད་པའི་ཕྱིར་རོ་༎
 samyakkarmāntena śīle 'kṛtyākaraṇāt samyagājīvena saṃlekhe dharmeṇa mātrayā ca cīvarādyanveṣaṇāt |	ཡང་དག་པའི་འཚོ་བས་ནི་ཡོ་བྱད་བསྙུངས་པ་ལ་སྟེ་། ཆོས་ཀྱིས་གས་ལ་སོགས་པ་ཚོད་ཟིན་པར་ཚོལ་བའི་ཕྱིར་རོ་༎
 vipakṣapratipakṣāṅgaṃ tridhaiva samyagvyāyamasmṛtisamādhayaḥ |	མི་མཐུན་པའི་ཕྱོགས་ཀྱི་གཉེན་པོའི་ཡན་ལག་ནི་རྣམ་པར་གསུམ་སྟེ་། ཡང་དག་པའི་རྩོལ་བ་དང་། དྲན་པ་དང་། ཏིང་ངེ་འཛིན་ཏོ་༎
 eṣāṃ hi yathākramaṃ |	དེ་དག་ནི་གོ་རིམས་བཞིན་དུ་།
 kleśopakleśavaibhutvavipakṣapratipakṣatā |	ཉོན་མོངས་ཉེ་བའི་ཉོན་མོངས་དབང་༎ མི་མཐུན་ཕྱོགས་ཀྱི་གཉེན་པོའོ་༎ མི་མཐུན་ཕྱོགས་ནི་རྣམ་པ་གསུམ་སྟེ་།
 trividho hi vipakṣaḥ kleśo bhāvanāheyaḥ | upakleśo layauddhatyaṃ (mvbh 55)	བསྒོམ་པས་སྤང་བར་བྱ་བའི་ཉོན་མོངས་པ་དང་། ཉེ་བའི་ཉོན་མོངས་པ་བྱིང་བ་དང་། རྒོད་པའི་དབང་གིས་མི་མཐུན་པའི་ཕྱོགས་ཏེ་། ཡོན་ཏན་༄༡༨ཨ་༌་༎
 vibhutvavipakṣaś ca vaiśeṣikaguṇābhinirhāravibandhaḥ tatra prathamasya samyagvyāyāmaḥ pratipakṣas tena mārgabhāvanāt |	ཁྱད་པར་ཅན་མངོན་པར་སྒྲུབ་པའི་གེགས་སུ་གྱུར་པའོ་༎ དེ་ལ་དང་པོའི་གཉེན་པོ་ནི་ཡང་དག་པའི་རྩོལ་བ་སྟེ་། དེས་ལམ་བསྒོམ་པའི་ཕྱིར་རོ་༎
 dvitīyasya samyaksmṛtiḥ śamathādinimitteṣu sūpasthitasmṛteḥ layauddhatyābhāvāt |	གཉིས་པ་ནི་ཡང་དག་པའི་དྲན་པ་སྟེ་། ཞི་གནས་ལ་སོགས་པའི་རྒྱུ་རྣམས་ལ་དྲན་པ་ཤིན་ཏུ་ཉེ་བར་གནས་པས་བྱིང་བ་དང་རྒོད་པ་མེད་པའི་ཕྱིར་རོ་༎ གསུམ་པ་ནི་ཡང་དག་པའི་ཏིང་ངེ་འཛིན་ཏེ་།
 tṛtīyasya samyaksamādhiḥ dhyānasanniśrayeṇābhijñādiguṇābhinirhārāt | [h| pratipakṣabhāvanāprabheda] saiṣā pratipakṣabhāvanā samāsena trividhā veditavyā |	བསམ་གཏན་ལ་གནས་ནས་མངོན་པར་ཤེས་པ་ལ་སོགས་པ་ཡོན་ཏན་མངོན་པར་བསྒྲུབ་པའི་ཕྱིར་རོ་༎ གཉེན་པོ་བསྒོམ་པ་དེ་མདོར་བསུ་ན་རྣམ་པ་གསུམ་དུ་རིག་པར་བྱ་སྟེ་།
 anukūlā viparyastā sānubandhā viparyayā || iv|11	རྗེས་སུ་མཐུན་ལ་ཕྱིན་ཅི་ལོག་༎
 aviparyastaviparyāsānānubandhā ca bhāvanā |	རྗེས་སུ་འབྲེལ་བཅས་བཟློག་པ་དང་༎ ཕྱིན་ཅི་མ་ལོག་ཕྱིན་ཅི་ལོག་། 
 viparyastāpi aviparyāsānukūlāviparyastā viparyāsānubandhā aviparyastā viparyāsaniranubandhā ca yathākramaṃ pṛthagjanaśaikṣāśaikṣāvasthāsu |	རྗེས་སུ་འབྲེལ་མེད་བསྒོམ་པའོ་༎ ཕྱིན་ཅི་མ་ལོག་པའི་རྗེས་སུ་མཐུན་ལ་ཕྱིན་ཅི་ལོག་པ་དང་། ཕྱིན་ཅི་ལོག་མེད་ལ་ཕྱིན་ཅི་ལོག་རྗེས་སུ་འབྲེལ་པ་དང་། ཕྱིན་ཅི་ལོག་ཀྱང་མེད་ལ་ཕྱིན་ཅི་ལོག་རྗེས་སུ་འབྲེལ་བ་ཡང་མེད་པ་སྟེ་། སོ་སོའི་སྐྱེ་བོ་དང་། སློབ་པ་དང་། མི་སློབ་པ་དང་། གོ་རིམས་བཞིན་ནོ་༎
 bodhisatvānān tv	བྱང་ཆུབ་སེམས་དཔའ་རྣམས་ཀྱི་ནི་༎
 ālambanamanaskāraprāptitas tadviśiṣṭatā || iv|12	དམིགས་དང་ཡིད་ལ་བྱེད་པ་དང་༎ ཐོབ་པས་དེ་ནི་ཁྱད་པར་འཕགས་ཏེ་།
 śrāvakapratyekabuddhānāṃ hi svāsantānikāḥ kāyādayaḥ ālambanam |	ཉན་ཐོས་དང་རང་སངས་རྒྱས་རྣམས་ནི་རང་གི་རྒྱུད་དུ་གཏོགས་པའི་ལུས་ལ་སོགས་པ་ལ་དམིགས་སོ་༎ 
 bodhisatvānāṃ svaparasāntānikāḥ śrāvakapratyekabuddhā anityādibhir ākāraiḥ kāyādīn manasikurvanti |	བྱང་ཆུབ་སེམས་དཔའ་རྣམས་ནི་བདག་དང་གཞན་གྱི་རྒྱུད་དུ་གཏོགས་པ་རྣམས་སོ་༎ ཉན་ཐོས་དང་རང་སངས་རྒྱས་རྣམས་ནི་ལུས་ལ་སོགས་པ་མི་རྟག་པ་ལ་སོགས་པའི་རྣམ་པར་ཡིད་ལ་བྱེད་དོ་༎
 bodhisatvās tv anupalambhayogena |	བྱང་ཆུབ་སེམས་དཔའ་རྣམས་ནི་མི་དམིགས་པའི་ཚུལ་རྣམ་པར་ཡིད་ལ་བྱེད་དོ་༎
 śrāvakapratyekabuddhāḥ smṛtyupasthānādīni bhāvayanti yāvad eva kāyādīnāṃ visaṃyogāya |	ཉན་ཐོས་དང་རང་སངས་རྒྱས་རྣམས་ནི་ཅི་ནས་ཀྱང་ལུས་ལ་སོགས་པ་དང་བྲལ་བར་བྱ་བའི་ཕྱིར་དྲན་པ་ཉེ་བར་གཞག་པ་ལ་སོགས་པ་བསྒོམ་མོ་༎ 
 bodhisatvā na visaṃyogāya |	བྱང་ཆུབ་སེམས་དཔའ་རྣམས་ནི་འབྲལ་བར་བྱ་བའི་ཕྱིར་ཡང་མ་ཡིན་།
 nāvisaṃyogāya |	མི་འབྲལ་བར་བྱ་བའི་ཕྱིར་ཡང་མ་ཡིན་གྱི་།
 yāvad evāpratiṣṭhitanirvāṇāya |	ཅི་ནས་ཀྱང་མི་གནས་པའི་མྱ་ངན་ལས་འདས་པའི་ཕྱིར་བསྒོམ་མོ་༎
 uktā pratipakṣabhāvanā | (mvbh 56) [2| tatrāvasthā]	གཉེན་པོ་བསྒོམ་པ་བཤད་ཟིན་ཏོ་༎
 tatrāvasthā katamā |	དེའི་གནས་གང་ཞེ་ན་།
 hetvavasthāvatārākhyā prayogaphalasaṃjñitā | kāryākāryaviśiṣṭā ca | uttarānuttarā ca sā || iv|13	༄༡༨བ་རྒྱུ་ཡི་གནས་དང་ཞུགས་པ་དང་༎ སྦྱོར་དང་འབྲས་བུ་བརྗོད་པ་དང་༎ བྱ་དང་བྱ་མེད་ཁྱད་པར་དང་༎ དེ་ནི་བླ་མ་བླ་ན་མེད་༎
 adhimuktau praveśe ca niryāṇe vyākṛtāv api | kathikatve 'bhiṣeke ca saṃprāptāv anuśansane || iv|1 kṛtyānuṣṭhā uddiṣṭā |	མོས་པ་དང་ནི་འཇུག་པ་དང་༎ ངེས་པར་འབྱུང་དང་ལུང་བསྟན་དང་༎ བརྗོད་པ་དང་ནི་དབང་བསྐུར་དང་༎ ཕྱིན་པ་དང་ནི་ཕན་ཡོན་དང་༎ བྱ་བ་བསྒྲུབ་པ་བསྟན་པའོ་༎
 tatra hetvavasthā yā gotrasthasya pudgalasyāvatārāvasthā utpāditabodhicittasya prayogāvasthā cittotpādād ūrdham aprāpte phale |	དེ་ལ་རྒྱུའི་གནས་ནི་གང་རིགས་ལ་གནས་པའི་གང་ཟག་གོ་༎ ཞུགས་པའི་གནས་ནི་སེམས་བསྐྱེད་པའོ་༎ སྦྱོར་བའི་གནས་ནི་སེམས་བསྐྱེད་ནས་འབྲས་བུ་མ་ཐོབ་ཚུན་ཆད་དོ་༎
 phalāvasthā prāpte |	འབྲས་བུའི་གནས་ནི་ཐོབ་པའོ་༎
 sakaraṇīyāvasthā śaikṣasya |	བྱ་བ་བཅས་པའི་གནས་ནི་སློབ་པའོ་༎
 akaraṇīyāvasthā aśaikṣasya |	བྱ་བ་མེད་པའི་གནས་ནི་མི་སློབ་པའོ་༎
 viśeṣāvasthābhijñādiguṇaviśeṣasamanvāgatasya |	ཁྱད་པར་གྱི་གནས་ནི་མངོན་པར་ཤེས་པ་ལ་སོགས་པའི་ཡོན་ཏན་གྱི་ཁྱད་པར་དང་ལྡན་པའོ་༎ བླ་མའི་གནས་ནི་ཉན་ཐོས་ལ་སོགས་པ་བས་སར་ཞུགས་པའི་བྱང་ཆུབ་སེམས་དཔའོ་༎
 uttarāvasthā śrāvakādibhyo bhūmipraviṣṭasya bodhisatvasya |	བླ་ན་མེད་པའི་གནས་ནི་སངས་རྒྱས་ཏེ་།
 anuttarāvasthā buddhasya tata ūrdham avasthābhāvād adhimuktyavasthā bodhisatvānāṃ sarvasyām adhimukticaryābhūmau |	དེའི་གོང་ན་གནས་མེད་པའི་ཕྱིར་རོ་༎ མོས་པའི་གནས་ནི་བྱང་ཆུབ་སེམས་དཔའ་རྣམས་ཀྱི་མོས་པས་སྤྱོད་པའི་ས་ཐམས་ཅད་དོ་༎
 praveśāvasthā prathamāyāṃ bhūmau niryāṇāvasthā taduttarāsu ṣaṭsu bhūmiṣu |	འཇུག་པའི་གནས་ནི་ས་དང་པོའོ་༎ ངེས་པར་འབྱུང་བའི་གནས་ནི་དེའི་གོང་མས་དྲུག་པོ་དག་གོ་༎
 vyākaraṇāvasthā aṣṭamyāṃ bhūmau kathikatvāvasthā navamyām abhiṣekāvasthā daśamyāṃ |	ལུང་བསྟན་པའི་གནས་ནི་ས་བརྒྱད་པའོ་༎ བརྗོད་པའི་གནས་ནི་ས་དགུ་པའོ་༎ དབང་བསྐུར་བའི་གནས་ནི་ས་བཅུ་པའོ་༎
 prāptyavasthā buddhānān dharmakāyaḥ |	ཕྱིན་པའི་གནས་ནི་སངས་རྒྱས་ཀྱི་ཆོས་ཀྱི་སྐུའོ་༎
 anuśansāvasthā sāṃbhogikaḥ kāyaḥ |	ཕན་ཡོན་གྱི་གནས་ནི་ལོངས་སྤྱོད་རྫོགས་པའི་སྐུའོ་༎
 kṛtyānuṣṭhānāvasthā nirmāṇakāyaḥ |	བྱ་བ་སྒྲུབ་པའི་གནས་ནི་སྤྲུལ་པའི་སྐུའོ་༎
 sarvāpy eṣā bahuvidhāvasthābhisamasya veditavyā |	གནས་རྣམ་པ་མང་པོ་འདི་དག་ཐམས་ཅད་ཀྱང་མདོར་བསྡུ་ན་།
 dharmadhātau tridhā puuaḥ |	ཆོས་ཀྱི་དབྱངས་ལ་རྣམ་གསུམ་སྟེ་༎
 aśuddhāśuddhaśuddhā ca viśuddhā ca yathārhataḥ || iv|15	ཞེས་བྱ་བར་རིག་པར་བྱ་སྟེ་། མ་དག་མ་དག་དག་པ་དང་༎ རྣམ་པར་དག་པར་ཅི་རིགས་སྦྱར་༎
 tatrāśuddhāvasthā hetvavasthām upādāya yāvat prayogād aśuddhaśuddhāvasthā (mvbh 57) śaikṣāṇāṃ |	དེ་ལ་མ་དག་པའི་གནས་ནི་རྒྱུའི་གནས་ནས་ཉེ་བར་བཟུང་སྟེ་།
 viśuddhāvasthā aśaikṣāṇāṃ |	སྦྱོར་བ་པའི་བར་དུའོ་༎ མ་དག་པ་དང་དག་གནས་ནི་སློབ་པ་རྣམས་སོ་༎ རྣམ་པར་དག་པའི་གནས་ནི་མི་སློབ་པ་རྣམས་སོ་༎ འདི་ལས་ཇི་ལྟར་འོས་འོས་སུ་༎
 pudgalānāṃ vyavasthānaṃ yathāyogam ato matam |	གང་ཟག་རྣམ་པར་གཞག་པར་འདོད་༎
 ato 'vasthāprabhedād yathāyogaṃ pudgalānāṃ vyavasthānaṃ (|	གནས་རབ་ཏུ་དབྱེ་བ་འདི་ལས་༄༡༩ཨ་༌་༎ ཅི་རིགས་པར་གང་ཟག་རྣམས་རྣམ་པར་གཞག་པར་རིག་པར་བྱ་སྟེ་།
 ) veditavyam ayaṃ gotrastho 'yam avatīrṇa ity evamādi |	འདི་ནི་རིགས་ལ་གནས་པའོ་༎ འདི་ནི་ཞུགས་པའོ་ཞེས་བྱ་བ་ལ་སོགས་པའོ་༎
 uktāvasthā [|]	གནས་བཤད་ཟིན་ཏོ་༎
 [3| phalaprāpti] phalaprāptiḥ katamā |	འབྲས་བུ་ཐོབ་པ་གང་ཞེ་ན་།
 bhājanatvaṃ vipākākhyaṃ balan tasyādhipatyataḥ || iv|16	སྣོད་གྱུར་རྣམ་པར་སྨིན་བརྗོད་དང་༎ དེ་ཡི་དབང་གིས་སྟོབས་དང་ནི་༎
 rucir vṛddhir viśuddhiś ca phalam etad yathākramaṃ |	འདོད་དང་འཕེལ་དང་རྣམ་དག་སྟེ་༎ དེ་དག་འབྲས་བུ་གོ་རིམས་བཞིན་༎
 bhājanatvaṃ yaḥ kuśalānukūlo vipākaḥ |	སྣོད་དུ་གྱུར་པ་དེ་ནི་གང་དགེ་བ་དང་རྗེས་སུ་མཐུན་པའི་རྣམ་པར་སྨིན་པའོ་༎
 balaṃ yā bhājanatvādhipatyāt kuśalasyādhimātratā |	སྟོབས་ནི་གང་སྣོད་དུ་གྱུར་པའི་དབང་གིས་དགེ་བ་ཤས་ཆེར་གྱུར་པའོ་༎
 rucir yā pūrvābhyāsāt kuśalaruciḥ |	འདོད་པ་ནི་སྔོན་གོམས་པར་བྱས་པས་དགེ་བ་འདོད་པའོ་༎
 vṛddhir yā pratyutpanne kuśaladharmābhyāsāt kuśalamūlaparipuṣṭiḥ |	འཕེལ་བ་ནི་གང་ད་ལྟར་བྱུང་བ་ན་དགེ་བའི་ཆོས་ལ་གོམས་པར་བྱས་པས་དགེ་བའི་རྩ་བ་རྒྱས་པའོ་༎ 
 viśuddhir yad āvaraṇaprahāṇaṃ |	རྣམ་པར་དག་པ་ནི་གང་སྒྲིབ་པ་སྤངས་པའོ་༎
 etad yathākramaṃ phalaṃ pañcavidhaṃ veditavyam |	འདི་དག་ནི་འབྲས་བུ་རྣམ་པ་ལྔ་དང་གོ་རིམས་བཞིན་ཏེ་།
 vipākaphalam adhipatiphalan niṣyandaphalaṃ puruṣakāraphalaṃ visaṃyogaphalañ ca |	རྣམ་པར་སྨིན་པའི་འབྲས་བུ་དང་། བདག་པོའི་འབྲས་བུ་དང་། རྒྱུ་མཐུན་པའི་འབྲས་བུ་དང་། སྐྱེས་བུ་བྱེད་པའི་འབྲས་བུ་དང་། བྲལ་བའི་འབྲས་བུའོ་༎
 uttarottaram ādyañ ca tadabhyāsāt samāptitaḥ || iv|17	ཕྱི་མ་ཕྱི་མ་ཐོག་མ་དང་༎ དེ་གོམས་བྱས་དང་རྫོགས་པའོ་༎
 ānukūlyād vipakṣāc ca visaṃyogād viśeṣataḥ |	རྗེས་སུ་མཐུན་དང་མི་མཐུན་ཕྱོགས་༎
 uttarānuttaratvāc ca phalam anyat samāsataḥ || iv|18	བྲལ་བ་དང་ནི་ཁྱད་པར་དང་༎ བླ་མ་དང་ནི་བླ་ན་མེད་༎
 uttarottaraphalaṃ gotrāc cittotpāda ity evamādi paraṃparayā veditavyaṃ |	འབྲས་བུ་གཞན་ཏེ་མདོར་བསྡུས་པའོ་༎ ཕྱི་མ་ཕྱི་མའི་འབྲས་བུ་ནི་རིགས་ལས་སེམས་བསྐྱེད་པ་ཞེས་བྱ་བ་དེ་ལྟ་བུ་ལ་སོགས་པའོ་༎ གཅིག་ནས་གཅིག་ཏུ་བརྒྱུད་པར་རིག་པར་བྱའོ་༎
 ādiphalaṃ prathamato lokottaradharmapratilambhaḥ |	ཐོག་མའི་འབྲས་བུ་ནི་དང་པོར་འཇིག་རྟེན་ལས་འདས་པའི་ཆོས་ཐོབ་པའོ་༎
 abhyāsaphalaṃ tasmāt pareṇa śaikṣāvasthāyāṃ |	གོམས་པར་བྱས་པའི་འབྲས་བུ་ནི་དེའི་ཕ་རོལ་སློབ་པའི་གནས་སོ་༎
 samāptiphalam aśaikṣādharmāḥ |	རྫོགས་པའི་འབྲས་བུ་ནི་མི་སློབ་པའི་ཆོས་རྣམས་སོ་༎
 ānukūlyaphalam upaniṣadbhāvenottarottaraphalam eva veditavyaṃ |	རྗེས་སུ་མཐུན་པའི་འབྲས་བུ་ནི་རྒྱུའི་དངོས་པོས་ཕྱི་མ་འབྲས་བུ་ཉིད་དུ་རིག་པར་བྱའོ་༎
 vipakṣaphalaṃ prahāṇamārgo yad evādiphalaṃ |	མི་མཐུན་པའི་ཕྱོགས་ཀྱི་འབྲས་བུ་ནི་སྤོང་བའི་ལམ་སྟེ་། ཐོག་མའི་འབྲས་བུ་གང་ཡིན་པ་དེ་ཉིད་དེ་།
 pratipakṣo 'bhipretaḥ |	དེ་ནི་མི་མཐུན་པའི་ཕྱོགས་གཉེན་པོ་ལ་བྱ་བར་འདོད་དོ་༎
 visaṃyogaphalaṃ nirodhasākṣātkriyā abhyāsaphalaṃ samāptiphalaṃ ca kleśavisaṃyogaḥ (mvbh 58)	བྲལ་བའི་འབྲས་བུ་ནི་གོམས་པར་བྱས་པའི་འབྲས་བུ་དང་རྫོགས་པའི་འབྲས་བུ་སྟེ་།
 śaikṣāśaikṣāṇāṃ yathākramaṃ |	ཉོན་མོངས་པ་དང་བྲལ་བར་ནི་སློབ་པ་དང་མི་སློབ་པ་དང་གོ་༄༡༩བ་རིམས་བཞིན་ནོ་༎
 viśeṣaphalam abhijñādiko guṇaviśeṣaḥ |	ཁྱད་པར་གྱི་འབྲས་བུ་ནི་མངོན་པར་ཤེས་པ་ལ་སོགས་པ་ཡོན་ཏན་གྱི་ཁྱད་པར་རོ་༎
 uttaraphalaṃ bodhisatvabhūmayas tadanyayānottaratvād anuttaraphalaṃ buddhabhūmiḥ |	བླ་མའི་འབྲས་བུ་ནི་བྱང་ཆུབ་སེམས་དཔའི་ས་རྣམས་ཏེ་། དེ་མ་ཡིན་པའི་ཐེག་པ་ལས་བླ་མར་གྱུར་པའི་ཕྱིར་རོ་༎ བླ་ན་མེད་པའི་འབྲས་བུ་ནི་སངས་རྒྱས་ཀྱི་སའོ་༎
 etāni catvāri abhyāsasamāptiphalaprabheda eva etad anyat phalaṃ samāsanirdeśato vyāsatas tv aparimāṇaṃ | [pratipakṣabhāvanāpiṇḍārtha]	བཞི་པོ་འདི་དག་ནི་གོམས་པར་བྱས་པ་དང་། རྫོགས་པའི་འབྲས་བུའི་རབ་ཏུ་དབྱེ་བ་ཉིད་དོ་༎ འབྲས་བུ་གཞན་འདི་དག་ནི་མདོར་བསྟན་པ་སྟེ་། རྒྱས་པར་བྱ་བ་དཔག་ཏུ་མེད་དོ་༎
 tatra pratipakṣabhāvanāyāḥ piṇḍārthaḥ | vyutpattibhāvanā nirlekhabhāvanā parikarmabhāvanā | uttarasamārambhabhāvanā | śliṣṭabhāvanā darśanamārgaśleṣāt | praviṣṭabhāvanā utkṛṣṭabhāvanā ādibhāvanā madhyabhāvanā paryavasānabhāvanā |	དེ་ལ་གཉེན་པོ་སྒོམ་པའི་དོན་བསྡུས་པ་ནི་བྱང་བར་བྱ་བའི་སྒོམ་པ་དང་། བསྲབས་པའི་སྒོམ་པ་དང་༏་ཡོངས་སུ་སྦྱང་བར་བྱ་བའི་སྒོམ་པ་དང་། གོང་མ་ཡང་དག་པར་རྩོམ་པའི་སྒོམ་པ་དང་། མཐོང་བའི་ལམ་དང་འདྲེ་བའི་ཕྱིར་འདྲེ་བའི་སྒོམ་པ་དང་། ཞུགས་པའི་སྒོམ་པ་དང་། མཆོག་གི་སྒོམ་པ་དང་། ཐོག་མའི་སྒོམ་པ་དང་། བར་མའི་སྒོམ་པ་དང་། མཐའི་སྒོམ་པ་དང་། བླ་མ་དང་བཅས་པའི་སྒོམ་པ་དང་། བླ་ན་མེད་པའི་སྒོམ་པ་སྟེ་།
 sottarā bhāvanā niruttarā ca bhāvanā yālambanamanaskāraprāptiviśiṣṭā ||	གང་དམིགས་པ་དང་། ཡིད་ལ་བྱེད་པ་དང་། ཐོབ་པ་ཁྱད་པར་དུ་འཕགས་པའོ་༎
 avasthānāṃ piṇḍārthaḥ | bhavyatāvasthā gotrasthasya | ārambhāvasthā yāvat prayogāt |	གནས་རྣམས་ཀྱི་དོན་བསྡུས་པ་ནི་རིགས་ལ་གནས་པའི་སྐལ་པ་ཡོད་པའི་གནས་དང་། སེམས་བསྐྱེད་ནས་བཟུང་སྟེ་།
 asuddhāvasthā aśuddhaśuddhāvasthā viśuddhāvasthā | sālaṃkārāvasthā | vyāptyavasthā daśabhūmivyāpanāt |	སྦྱོར་བའི་བར་དུ་རྩོམ་པའི་གནས་དང་། མ་དག་པ་དག་པའི་གནས་དང་། ཤིན་ཏུ་དག་པའི་གནས་དང་། རྒྱན་དང་བཅས་པའི་གནས་དང་། ས་བཅུ་ཁྱབ་པའི་ཕྱིར་ཁྱད་པར་བྱ་བའི་གནས་དང་། བླ་ན་མེད་པའི་གནས་སོ་༎
 anuttarāvasthā ca || phalānāṃ piṇḍārthaḥ saṃgrahataḥ tadviśeṣataḥ pūrvābhyāsataḥn uttarottaranirhārataḥ | uddeśato nirdeśataś ca |	འབྲས་བུ་རྣམས་ཀྱི་དོན་བསྡུས་པ་ནི་བསྡུས་པ་དང་། དེའི་བྱེ་བྲག་དང་། སྔོན་གོམས་པར་བྱས་པ་དང་། གོང་ནས་གོང་དུ་བསྒྲུབ་པ་དང་། བསྟན་པ་དང་། བཤད་པའོ་༎
 tatra saṃgrahataḥ | pañca phalāni |	དེ་ལ་བསྡུས་པ་ནི་འབྲས་བུ་ལྔའོ་༎
 tadviśeṣataḥ śeṣāṇi |	དེའི་བྱེ་བྲག་ནི་ལྷག་མ་རྣམས་སོ་༎
 pūrvābhyāsataḥ vipākaphalaṃ |	སྔོན་གོམས་པར་བྱས་པ་ནི་རྣམ་པར་སྨིན་པའི་འབྲས་བུའོ་༎
 uttarottaranirhāratas tadanyāni catvāri |	དེ་གོང་ནས་གོང་དུ་བསྒྲུབ་པ་ནི་དེ་མ་ཡིན་པ་གཞན་བཞིའོ་༎
 uddeśataḥ uttarottaraphalādīni catvāri nirdeśataḥ ānukūlyaphalādini ṣaṭ |	བསྟན་པ་ནི་ཕྱི་མ་ཕྱི་མའི་འབྲས་བུ་ལ་སོགས་པ་བཞིའོ་༎ བཤད་པ་ནི་རྗེས་སུ་མཐུན་པའི་འབྲས་བུ་ལ་སོགས་པ་དྲུག་སྟེ་།
 teṣām eva (mvbh 59)	དེ་དག་ཉིད་བཤད་པའི་ཕྱིར་རོ་༎
 caturṇāṃ nirdeśāt ||	བསྟན་༄༢༠ཨ་༌་༎
 madhyāntavibhāge pratipakṣabhāvanāvasthāphalaparicchedaś caturthaḥ || ḥ (mvbh 60) [chapter v| yānānuttaryapariccheda] [1| trividhānuttarya]	བཅོས་དབུས་དང་མཐའ་རྣམ་པར་འབྱེད་པ་ལས་གཉེན་པོ་བསྒོམ་པ་ཞེས་བྱ་བའི་ལེའུར་བཅད་པ་བཞི་བའི་འགྲེལ་པའོ་། 
 yānānuttaryam idānīṃ vaktavyaṃ | tad ucyate |	༎ ། ད་ནི་ཐེག་པ་བླ་ན་མེད་པ་བཤད་དགོས་པས་དེ་བརྗོད་དོ་༎
 ānuttaryaṃ prapattau hi punar ālambane mataṃ |	བླ་མེད་ཉིད་ནི་སྒྲུབ་པ་དང་༎ དམིགས་པ་དང་ནི་ཡང་དག་འགྲུབ་༎
 samudāgama uddiṣṭaṃ |	བསྟན་པ་ཡིན་པར་འདོད་པའོ་༎
 trividham ānuttaryaṃ mahāyāne yenaitad anuttaraṃ yānaṃ pratipattyānuttaryaṃ |	ཐེག་པ་ཆེན་པོ་བླ་ན་མེད་པ་ཉིད་རྣམ་པ་གསུམ་སྟེ་། དེས་བླ་ན་མེད་པ་ཉིད་དུ་འགྱུར་རོ་༎
 ālambanānuttaryaṃ | samudāgamānuttaryañ ca | [2| pratipattyānuttarya]	སྒྲུབ་པ་བླ་ན་མེད་པ་ཉིད་དང་། དམིགས་པ་བླ་ན་མེད་པ་ཉིད་དང་། ཡང་དག་པར་འགྲུབ་པ་བླ་ན་མེད་པ་ཉིད་དོ་༎
 tatra pratipattyānuttaryaṃ daśapāramitāpratipattito veditavyaṃ |	དེ་ལ་སྒྲུབ་པ་བླ་ན་མེད་པ་ཉིད་ནི་ཕ་རོལ་ཏུ་ཕྱིན་པ་བཅུ་བསྒྲུབ་པར་རིག་པར་བྱའོ་༎ 
 pratipattis tu ṣaḍvidhā || v|1	སྒྲུབ་པ་དག་ནི་རྣམ་དྲུག་སྟེ་༎
 tāsu pāramitāsu |	ཕ་རོལ་ཏུ་ཕྱིན་པ་དེ་དག་ལའོ་༎
 paramātha manaskāre anudharme 'ntavarjane | viśiṣṭā cāviśiṣṭā ca |	དམ་པ་དང་ནི་ཡིད་བྱེད་དང་༎ རྗེས་མཐུན་ཆོས་མཐའ་སྤངས་པ་དང་༎ ཁྱད་པར་ཅན་དང་ཁྱད་པར་མེད་༎
 ity eṣā ṣaḍvidhā pratipattir yad uta paramā pratipattiḥ |	རྣམ་པ་དྲུག་པོ་འདི་དག་ནི་སྒྲུབ་པ་སྟེ་།
 manaskārapratipattir anudharmapratipattiḥ | antadvayavarjitā pratipattiḥ viśistā pratipattiḥ | aviśiṣṭā ca pratipattiḥ | [a| paramā pratipattiḥ]	འདི་ལྟར་དམ་པར་སྒྲུབ་པ་དང་། ཡིད་ལ་བྱེད་པ་ལ་སྒྲུབ་པ་དང་། རྗེས་སུ་མཐུན་པའི་ཆོས་སྒྲུབ་པ་དང་༎ མཐའ་གཉིས་རྣམ་པར་སྤངས་པ་སྒྲུབ་པ་དང་། ཁྱད་པར་ཅན་སྒྲུབ་པ་དང་། ཁྱད་པར་མེད་པ་སྒྲུབ་པའོ་༎
 tatra | (mvbh 61)	དེ་ལ་།
 paramā dvādaśātmikā || v|2	དམ་པ་བཅུ་གཉིས་བདག་ཉིད་དེ་༎
 audāryam āyatatvaṃ ca adhikāro 'kṣayātmatā | nairantaryam akṛcchratvaṃ vittatvaṃ ca parigrahaḥ || v|3 ārambhaprāptiniṣyandaniṣpattiḥ paramā matā |	རྒྱ་ཆེ་བ་དང་ཡུན་རིང་དང་༎ ཆེད་དུ་བྱ་བ་དང་མི་ཟད་དང་༎ རྒྱུན་མི་འཆད་དང་ཚེགས་མེད་དང་༏་། དབང་འབྱོར་བ་དང་ཡོངས་གཟུང་དང་༎ རྩོམ་དང་ཐོབ་དང་རྒྱུ་མཐུན་དང་༎ འགྲུབ་པ་དམ་པར་འདོད་པ་ཡིན་༎
 ity eṣā dvādaśavidhā paramā matā | yad utaudāryaparamatā āyatatvaparamatā adhikāraparamatā akṣayatvaparamatā nairantaryaparamatā akṛcchratvaparamatā | vittatvaparamatā parigrahaparamatā |	རྣམ་པ་བཅུ་གཉིས་ལོ་འདི་དག་ནི་དམ་པ་སྟེ་།
 ārambhaparamatā pratilambhaparamatā niṣyandaparamatā niṣpattiparamatā ca |	འདི་ལྟར་རྒྱ་ཆེ་བ་དམ་པ་དང་། ཡུན་རིང་བ་དམ་པ་དང་། ཆེད་དུ་བྱ་བ་དམ་པ་དང་། ཟད་མི་ཤེས་པ་དམ་པ་དང་། རྒྱུན་མི་འཆད་པ་དམ་པ་དང་། ཚེགས་མེད་པ་དམ་པ་དང་། དབང་འབྱོར་བ་དམ་པ་དང་། ཡོངས་སུ་གཟུང་བ་དམ་པ་དང་། རྩོམ་པ་དམ་པ་དང་། རབ་ཏུ་ཐོབ་པ་དམ་པ་དང་། རྒྱུ་མཐུན་པ་དམ་པ་དང་། འགྲུབ་པ་དམ་པའོ་༎
 tatraudāryaparamatā sarvalaukikasaṃpattyanarthitvenotkṛṣṭatayā ca veditavyā |	དེ་ལ་རྒྱ་ཆེ་བ་དམ་པ་ནི་། འཇིག་རྟེན་གྱི་ཕུན་སུམ་ཚོགས་པ་ཐམས་ཅད་མི་འདོད་པ་དང་མཆོག་ཏུ་རིག་པར་བྱའོ་༎
 āyatatvaparamatā trikalpāsaṃkhyeyaparibhāvanāt |	ཡུན་རིང་པ་དམ་པ་ནི་བསྐལ་པ་གྲངས་མེད་པ་གསུམ་དུ་ཡོངས་སུ་བསྒོམས་པའི་ཕྱིར་རོ་༎
 adhikāraparamatā sarvasatvārthakriyādhikārāt |	ཆེད་དུ་བྱ་བ་དམ་པ་ནི་སེམས་ཅན་ཐམས་ཅད་ཀྱི་དོན་བྱ་བའི་ཆེད་ཀྱི་ཕྱིར་རོ་༎
 akṣayatvaparamatā mahābodhipariṇāmanayātyantam aparyādānān nairantaryaparamatātmaparasamatādhimokṣāt	ཟད་མི་ཤེས་པ་དམ་པ་ནི་བྱང་ཆུབ་ཆེན་པོར་ཡོངས་སུ་བསྔོས་༄༢༠བ་པས་གཏན་དུ་ཡོངས་སུ་གཏུགས་པར་མི་འགྱུར་བའི་ཕྱིར་རོ་༎ རྒྱུན་མི་འཆད་པའི་དམ་པ་ནི་བདག་གཞན་མཉམ་པ་ཉིད་དུ་མོས་པའི་ཕྱིར་ཏེ་།
 sarvasatvadānādibhiḥ pāramitāparipūraṇād akṛcchratvaparamatānumodanāmātreṇa paradānādīnāṃparamitāparipūraṇāt | vittatvaparamatā |	སེམས་ཅན་ཐམས་ཅད་ལ་སྦྱིན་པ་ལ་སོགས་པས་ཕ་རོལ་ཏུ་ཕྱིན་པ་རྣམས་ཡོངས་སུ་རྫོགས་པར་བྱེད་པའི་ཕྱིར་རོ་༎ ཚེགས་མེད་པ་དམ་པ་ནི་གཞན་གྱི་སྦྱིན་པ་ལ་སོགས་པ་ལ་རྗེས་སུ་ཡི་རང་བ་ཙམ་གྱིས་ཕ་རོལ་ཏུ་ཕྱིན་པ་ཡོངས་སུ་རྫོགས་པར་བྱེད་པའི་ཕྱིར་རོ་༎
 gaganagañjasamādhyādibhir dānādiparipūraṇāt parigrahaparamatā nirvikalpajñānaparigṛhītatvāt |	དབང་འབྱོར་པ་དམ་པ་ནི་ནམ་མཁའ་མཛོད་ཀྱི་ཏིང་ངེ་འཛིན་ལ་སོགས་པ་སྦྱིན་པ་ལ་སོགས་པ་ཡོངས་སུ་རྫོགས་པར་བྱེད་པའི་ཕྱིར་རོ་༎ ཡོངས་སུ་གཟུང་བ་དམ་པ་ནི་རྣམ་པར་མི་རྟོག་པའི་ཡེ་ཤེས་ཀྱིས་ཡོངས་སུ་བཟུང་བའི་ཕྱིར་རོ་༎ 
 ārambhaparamatādhimukticaryābhūmāv adhimātrāyāṃ kṣāntau pratilambhaparamatā prathamāyāṃ bhūmau |	རྩོམ་པ་དམ་པ་ནི་མོས་པ་ས་སྤྱོད་པའི་ས་ལ་བཟོད་པ་ཆེར་གྱུར་པའོ་༎ འཐོབ་པ་དམ་པ་ནི་ས་དང་པོ་ལའོ་༎
 niṣyandaparamatā | tadanyāsv aṣṭāsu bhūmiṣu |	རྒྱུ་མཐུན་པ་དམ་པ་ནི་དེ་མ་ཡིན་པ་གཞན་བརྒྱད་པོ་དག་ལའོ་༎
 niṣpattiparamatā daśamyāṃ bhūmau tathāgatyāṃ ca | bodhisatvaniṣpattyā buddhaniṣpattyā ca |	འགྲུབ་པ་དམ་པ་ནི་ས་བཅུ་པ་དང་། དེ་བཞིན་གཤེགས་པའི་ས་ལ་བྱང་ཆུབ་སེམས་དཔའ་འགྲུབ་པ་དང་། སངས་རྒྱས་འགྲུབ་པའི་ཕྱིར་རོ་༎
 tataś ca paramārthena daśa pāramitā matāḥ || v|4	དེའི་ཕྱིར་དམ་པའི་དོན་གྱིས་ནི་༎ ཕ་རོལ་གྱིན་པ་བཅུར་འདོད་དོ་༎
 yata eṣā dvādaśavidhā paramatā etāsu saṃvidyate | tataḥ paramā (mvbh 62)	འདི་ལྟར་དམ་པ་རྣམ་པ་བཅུ་གཉིས་པོ་འདི་དག་ནི་དེ་དག་ལ་ཡོད་པའི་ཕྱིར་དམ་པ་ཞེས་བྱ་སྟེ་། 
 ity anenārthena daśa pāramitāḥ |	དོན་འདིས་ཕ་རོལ་ཏུ་ཕྱིན་པ་བཅུ་པོ་དག་ཏུ་འདོད་དོ་༎
 katamā daśety ekeṣāṃ tannāmavyutpādanārtham ucyate |	ཁ་ཅིག་བཅུ་གང་ཡིན་སྙམ་དུ་སེམས་པ་ལ་དེ་དག་གི་མིང་བསྟན་པར་བྱ་བའི་ཕྱིར་།
 dānaṃ śīlaṃ kṣamā vīryaṃ dhyānaṃ prajñā upāyatā |	སྦྱིན་དང་ཚུལ་ཁྲིམས་བཟོད་བརྩོན་འགྲུས་༎ བསམ་གཏན་དང་ནི་ཤེས་རབ་ཐབས་༎
 praṇidhānaṃ balaṃ jñānam etāḥ pāramitā daśeti || v|5	སློན་ལམ་སྟོབས་དང་ཡེ་ཤེས་དང་༎ འདི་དག་ཕ་རོལ་ཕྱིན་པ་བཅུ་༎ ཞེས་བྱ་བ་བརྗོད་དོ་༎
 kim āsāṃ pratyekaṃ karma |	འདི་དག་གིས་སོ་སོའི་ལས་ཅི་ཞེ་ན་།
 anugraho 'vighātaś ca karma tasya ca marṣaṇaṃ |	ལས་ནི་རྗེས་སུ་འཛིན་བྱེད་དང་༎ གནོད་མི་བྱེད་དང་དེ་ལ་བཟོད་༎
 guṇavṛddhiś ca sāmarthyam avatāravimocane | akṣayatvaṃ sadā vṛttir niyataṃ bhogapācane || v|6	ཡོན་ཏན་འཕེལ་དང་འཛུད་ནུས་དང་༎ རྣམ་པར་གྲོལ་བར་བྱ་བ་དང་༎ མི་ཟད་པ་དང་རྟག་འཇུག་དང་༎ ངེས་པར་ལོངས་སྤྱོད་སྨིན་པར་བྱེད་༎
 ity etad āsāṃ karma yathākramaṃ |	འདི་དག་ནི་གོ་རིམས་བཞིན་དུ་དེ་དག་གི་ལས་ཏེ་།
 dānena hi bodhisatvaḥ satvān anugṛhṇāti |	བྱང་ཆུབ་སེམས་དཔའི་སྦྱིན་པས་ནི་སེམས་ཅན་རྣམས་རྗེས་སུ་འཛིན་ཏོ་༎
 śīlenopaghātaṃ pareṣāṃ na karoti |	ཚུལ་ཁྲིམས་ཀྱིས་ནི་དེ་དག་ལ་གནོད་པར་མི་བྱེད་དོ་༎
 kṣāntyā paraiḥ kṛtam upaghātaṃ marṣayati |	བཟོད་པས་ནི་གཞན་དག་གིས་གནོད་པར་བྱས་པ་ལ་ཅི་མི་སྙམ་པར་བྱེད་དོ་༎
 vīryeṇa guṇān vardhayati |	བརྩོན་འགྲུས་ཀྱིས་ནི་ཡོན་ཏན་རྣམས་འཕེལ་བར་བྱེད་དོ་༎ བསམ་གཏན་༄༢༡ཨ་༌་༎
 dhyānena rddhyādibhir āvarjyāvatārayati |	གྱིས་ནི་རྫུ་འཕྲུལ་ལ་སོགས་པས་མགུ་བར་བྱས་ཏེ་འཛུད་དོ་༎
 prajñayā samyagavavādadānād vimocayati |	ཤེས་རབ་ཀྱིས་ནི་ཡང་དག་པའི་གདམས་ངག་བྱིན་པས་རྣམ་པར་གྲོལ་བར་བྱེད་དོ་༎
 upāyakauśalyapāramitayā mahābodhipariṇāmanād dānādīn akṣayān karoti | praṇidhānapāramitayānukūlopapattiparigrahāt |	ཐབས་ལ་མཁས་པའི་ཕ་རོལ་ཏུ་ཕྱིན་པས་ནི་བྱང་ཆུབ་ཆེན་པོར་ཡོངས་སུ་བསྔོས་པས་སྦྱིན་པ་ལ་སོགས་པ་མི་ཟད་པར་བྱེད་དོ་༎
 sarvajanmasu buddhotpādārāgaṇato dānādiṣu sadā pravartate balapāramitayā pratisaṃkhyānabhāvanābalābhyāṃ niyataṃ dānādiṣu pravartate |	སྨོན་ལམ་གྱི་ཕ་རོལ་ཏུ་ཕྱིན་པས་ནི་མཐུན་པའི་སྐྱེ་བ་ཡོངས་སུ་འཛིན་པས་ཚེ་རབས་ཐམས་ཅད་དུ་སངས་རྒྱས་འབྱུང་བ་ལ་མཉེས་པར་བྱེད་ཅིང་སྦྱིན་པ་ལ་སོགས་པ་ལ་རྟག་ཏུ་འཇུག་གོ་༎ སྟོབས་ཀྱི་ཕ་རོལ་ཏུ་ཕིན་པས་ནི་སོ་སོར་རྟོག་པ་དང་། བསྒོམ་པའི་སྟོབས་གཉིས་ཀྱིས་མི་མཐུན་པའི་ཕྱོགས་ཀྱིས་ཟིལ་གྱིས་མི་ནོན་པའི་ཕྱིར་སྦྱིན་པ་ལ་སོགས་པ་ལ་ངེས་པར་འཇུག་གོ་༎
 vipakṣānabhibhavāt | jñānapāramitayā yathārutadharmasaṃmohāpagamād dānādyādhipateyadharmasaṃbhogañ ca pratyanubhavati | satvāṃś ca paripācayati |	ཡེ་ཤེས་ཀྱི་ཕ་རོལ་ཏུ་ཕྱིན་པས་ནི་ཆོས་ལ་སྒྲ་ཇི་བཞིན་དུ་རྨོངས་པ་དང་བྲལ་བས་སྦྱིན་པ་ལ་སོགས་པའི་དབང་དུ་མཛད་པའི་ཆོས་ལ་ལོངས་སྤྱོད་པ་མྱོང་བ་དང་། སེམས་ཅན་རྣམས་ཀྱང་ཡོངས་སུ་སྨིན་པར་བྱེད་དོ་༎
 uktā paramā pratipattiḥ |	དམ་པ་བསྒྲུབ་པ་བཤད་ཟིན་ཏོ་༎
 [b| manasikārapratipatti] (mvbh 63)	ཡིད་ལ་བྱེད་པ་བསྒྲུབ་པ་གང་ཞེ་ན་། ཐེག་པ་ཆེན་པོར་ཅི་ལྟ་བུར་༎ ཆོས་རྣམས་བཏགས་པར་མཛད་པ་དང་༎ བྱང་ཆུབ་སེམས་དཔའ་རྟག་པར་ཡང་༎
 manasikārapratipattiḥ katamā |	ཤེས་རབ་གསུམ་གྱིས་ཡིད་བྱེད་པའོ་༎
 yathāprajñaptito dharmamahāyānamanaskriyā | bodhisatvasya satataṃ prajñayā triprakārayā || v|7 dānādīny adhikṛtya yathāprajñaptānāṃ sūtrādidharmāṇāṃ mahāyāne manasikaraṇam abhīkṣṇaṃ śrutacintābhāvanāmayyā prajñayā manasikārapratipattiḥ	སྦྱིན་པ་ལ་སོགས་པའི་དབང་དུ་མཛད་ནས་ཐེག་པ་ཆེན་པོར་མདོ་ལ་སོགས་པ་ཇི་ལྟར་བཏགས་པའི་ཆོས་རྣམས་ཐོས་པ་དང་། བསམས་པ་དང་། བསྒོམས་པ་ལས་བྱུང་བའི་ཤེས་རབ་ཀྱིས་རྒྱུན་དུ་ཡིད་ལ་བྱེད་པ་ནི་ཡིད་ལ་བྱེད་པ་བསྒྲུབ་པའོ་༎ 
 sā triprakārayā prajñayā manasikriyā kaṃ guṇaṃkaroti |	ཤེས་རབ་རྣམ་པ་གསུམ་གྱིས་ཡིད་ལ་བྱེད་པ་དེས་ཡོན་ཏན་ཅི་ཞིག་ཐོབ་ཅེ་ན་པའོ་༎ 
 dhātupuṣṭyai praveśāya cārthasiddhyai bhavaty asau |	། ཁམས་བརྟས་བྱེད་དང་འཇུག་བྱེད་དང་༎ དེ་ནི་དོན་རྣམས་འགྲུབ་པར་འགྱུར་༎
 śrutamayyā prajñayā manasikurvato dhātupuṣṭir bhavati |	ཐོས་པ་ལས་བྱུང་བའི་ཤེས་རབ་ཀྱིས་ཡིད་ལ་བྱེད་པས་ཁམས་བརྟས་པར་འགྱུར་རོ་༎
 cintāmayyā tasya śrutasyārthaṃ bhāvena praviśati |	བསམས་པ་ལས་བྱུང་བས་ནི་ཐོས་པ་དེའི་དོན་ལ་སྙིང་ནས་འཇུག་པར་བྱེད་དོ་༎
 bhāvanāmayyārthasiddhiṃ prāpnoti bhūmipraveśapariśodhanāt |	བསྒོམས་པ་ལས་བྱུང་བས་ནི་དོན་འགྲུབ་པར་འགྱུར་ཏེ་། ས་ལ་འཇུག་པ་ཡོངས་སུ་སྦྱོང་བའི་ཕྱིར་རོ་༎
 saṃyuktā dharmacaritaiḥ sā jñeyā daśabhiḥ punaḥ || v|8	དེ་ནི་ཆོས་སྤྱོད་རྣམ་བཅུ་དང་༎ ཡང་དག་ལྡན་པར་ཤེས་པར་བྱ་༎
 sā punar manasikārapratipattiḥ |	ཡིད་ལ་བྱེད་པ་སྒྲུབ་པ་སྟེ་༎
 daśabhir dharmacaritaiḥ parigṛhītā veditavyā katamad daśadhā dharmacaritaṃ |	དེ་ཡང་ཆོས་སྤྱོད་པ་རྣམ་པ་བཅུས་ཡོངས་སུ་གཟུང་བར་རིག་པར་བྱའོ་༎ ཆོས་སྤྱོད་རྣམ་པ་བཅུ་གང་ཞེ་ན་།
 lekhanā pūjanā dānaṃ śravaṇaṃ vācanodgrahaḥ | prakāśanātha svādhyāyaś cintanā bhāvanā ca tat || v|9 mahāyānasya lekhanaṃ pūjanaṃ parebhyo dānaṃ pareṇa vācyamānasya śravaṇaṃ | svayaṃ ca vācanaṃ |	ཡི་གེ་འདྲི་མཆོད་སྦྱིན་པ་དང་༎ ཉན་དང་ཀློག་དང་ལེན་པ་༄༢༡བ་དང་༎ འཆད་དང་ཁ་ཏོན་བྱེད་པ་དང་༎ དེ་སེམས་པ་དང་སྒོམ་པའོ་༎
 udgrahaṇaṃ | parebhyo deśanaṃ granthasyārthasya vā svādhyāyanaṃ | cintanaṃ bhāvanañ ca |	ཐེག་པ་ཆེན་པོའི་ཡེ་གེ་འདྲི་བ་དང་། མཆོད་པ་དང་། གཞན་དགལ་སྦྱིན་པ་དང་། གཞན་ཀློག་པ་ལ་ཉན་པ་དང་། བདག་ཉིད་ཀློག་པ་དང་། ལེན་པ་དང་། ཚིག་དང་དོན་འཆད་པ་དང་། ཁ་ཏོན་བྱེད་པ་དང་། སེམས་པ་དང་སྒོམ་པའོ་༎
 ameyapuṇyaskandhaṃ hi caritan tad daśātmakaṃ | (mvbh 64)	སྤྱོད་པ་དེ་བཅུའི་བདག་ཉིད་ནི་༎ བསོད་ནམས་ཕུང་པོ་དཔག་ཏུ་མེད་༎
 kasmān mahāyāna eva dharmacaritam atyarthaṃ mahāphalan deśyate sūtreṣu na punaḥ śrāvakayāne | dvābhyāṃ kāraṇābhyāṃ |	ཅིའི་ཕྱིར་མདོ་དག་ལས་ཐེག་པ་ཆེན་པོ་ཉིད་ཀྱི་ཆོས་སྤྱོད་པ་ནི་ཤིན་ཏུ་འབྲས་བུ་ཆེ་བར་བསྟན་གྱི་། ཉན་ཐོས་ཀྱི་ཐེག་པ་ལ་ནི་མ་ཡིན་ཞེ་ན་། རྣམ་པ་གཉིས་ཀྱི་ཕྱིར་ཏེ་།
 viśeṣād akṣayatvāc ca |	ཁྱད་པར་ཕྱིར་དང་མི་ཟད་ཕྱིར་༎
 kathaṃ viśeṣāt |	ཁྱད་པར་ཕྱིར་ནི་ཅི་ལྟ་བུ་༎
 katham akṣayatvāt |	མི་ཟད་པའི་ཕྱིར་ཅི་ལྟ་བུ་ཞེ་ན་།
 parānugrahato 'śamāt || v|10	གཞན་ལ་ཕན་འདོགས་མ་ཞིའི་ཕྱིར་༎
 parānugrahavṛttitvād viśiṣṭatvaṃ |	གཞན་ལ་ཕན་འདོགས་པར་ཞུགས་པའི་ཕྱིར་ཁྱད་པར་དུ་འཕགས་སོ་༎
 parinirvāṇe 'py aśamāt | anuparamād akṣayatvaṃ veditavyaṃ |	ཡོངས་སུ་མྱ་ངན་ལས་འདས་པ་ན་ཡང་ཞི་བ་མེད་ཅིང་རྒྱུན་མི་འཆད་པའི་ཕྱིར་མི་ཟད་པར་རིག་པར་བྱའོ་༎
 uktā manasikārapratipattiḥ | [c| anudharmapratipatti]	ཡིད་ལ་བྱེད་པ་བསྒྲུབ་པ་བཤད་ཟིན་ཏོ་༎
 anudharmapratipattiḥ katamā |	རྗེས་སུ་མཐུན་པའི་ཆོས་བསྒྲུབ་པ་གང་ཞེ་ན་།
 avikṣiptāviparyāsapraṇatā cānudhārmikī |	མི་ག-ཡེང་ཕྱིན་ཅི་མ་ལོག་པར་༎ གྱུར་པ་རྗེས་སུ་མཐུན་པའི་ཆོས་༎
 ity eṣā dvividhānudharmapratipattiḥ |	རྣམ་པ་འདི་གཉིས་ནི་རྗེས་སུ་མཐུན་པའི་ཆོས་སྒྲུབ་པ་སྟེ་།
 yad utāvikṣiptā cāviparyāsapariṇatā ca |	འདི་ལྟར་རྣམ་པར་མི་ག-ཡེང་བ་དང་ཕྱིན་ཅི་མ་ལོག་པར་གྱུར་པའོ་༎
 [avikṣepapariṇatā] tatra ṣaḍvidhavikṣepābhāvād avikṣiptā |	དེ་ལ་རྣམ་པར་མི་ག-ཡེང་བ་རྣམ་པ་དྲུག་མེད་པའི་ཕྱིར་མི་ག-ཡེང་བའོ་༎
 tatra ṣaḍvidho vikṣepaḥ |	ག-ཡེང་བ་རྣམ་པ་དྲུག་ནི་།
 prakṛtivikṣepaḥ | bahirdhāvikṣepaḥ | adhyātmavikṣepaḥ nimittavikṣepaḥ dauṣṭhulyavikṣepaḥ manasikāravikṣepaś ca |	རང་བཞིན་གྱིས་རྣམ་པར་ག-ཡེང་བ་དང་། ཕྱི་རོལ་ཏུ་རྣམ་པར་ག-ཡེང་བ་དང་། ནང་གི་རྣམ་པར་ག-ཡེང་བ་དང་། མཚན་མའི་རྣམ་པར་ག-ཡེང་བ་དང་། གནས་ངན་ལེན་གྱི་རྣམ་པར་ག-ཡེང་བ་དང་། ཡིད་ལ་བྱེད་པའི་རྣམ་པར་ག-ཡེང་བའོ་༎
 sa eṣa kiṃlakṣaṇo veditavya ity ata āha |	འདི་དག་གི་མཚན་ཉིད་ཅི་ལྟ་བུར་རིག་པར་བྱ་ཞེ་ན་།
 vyutthānaṃ viṣaye sāras tathāsvādalayoddhataḥ | v|11	ལྡང་དང་ཡུལ་ལ་འཇུག་པ་དང་༎ དེ་བཞིན་རོ་མྱང་བྱིང་དང་རྒོད་༎
 saṃbhāvanābhisandhiś ca manaskāre 'py ahaṃkṛtiḥ | (mvbh 65)	ཡིད་ཆེས་པ་ཡི་བསམ་པ་དང་༎ ཡིད་ལ་བྱེད་པ་ངར་འཛིན་དང་༎ ཆུང་ངུའི་སེམས་ནི་ག-ཡེང་བ་སྟེ་༎
 hīnacittaṃca vikṣepaḥ parijñeyo hi dhīmatā || v|12	བློ་ལྡན་རྣམས་ཀྱིས་ཤེས་པར་བྱ་༎
 ity evaṃlakṣaṇaḥ ṣaḍvidho vikṣepo yo bodhisatvena parijñeyaḥ |	རྣམ་པར་ག-ཡེང་བ་རྣམ་པ་དྲུག་གི་མཚན་ཉིད་ནི་དེ་ལྟ་བུ་ཡིན་ཏེ་། དེ་བྱང་ཆུབ་སེམས་དཔས་ཡོངས་སུ་ཤེས་པར་བྱའོ་༎
 tatra vyutthānaṃ samādhitaḥ pañcabhir vijñānakāyaiḥ prakṛtivikṣepaḥ viṣaye visāro bahirdhāvikṣepaḥ |	དེ་ལ་ལྡང་བ་ནི་རྣམ་པར་ཤེས་པའི་ཚོགས་ལྔ་རྣམས་ཀྱིས་ཏིང་ངེ་འཛིན་ལས་ལྡང་བ་སྟེ་། རང་བཞིན་གྱིས་རྣམ་པར་ག-ཡེང་བའོ་༎ ཡུལ་ལ་འཇུག་པ་ནི་ཕྱི་རོལ་ཏུ་རྣམ་པར་ག-ཡེང་བའོ་༎
 samādher āsvādanā layauddhatyaṃ cādhyātmavikṣepaḥ |	ཏིང་ངེ་འཛིན་གྱི་རོ་མྱང་བ་དང་། བྱིང་བ་དང་། རྒོད་པ་ནི་ནང་གི་༄༢༢ཨ་༌་༎ རྣམ་པར་ག-ཡེང་བའོ་༎
 saṃbhāvanābhisandhiḥ nimittavikṣepaḥ |	ཡིད་ཆེས་པའི་བསམ་པ་ནི་མཚན་མའི་རྣམ་པར་ག-ཡེང་བ་སྟེ་།
 tan nimittaṃ kṛtvā prayogāt |	དེ་མཚན་མར་བྱས་ནས་སྦྱོར་བའི་ཕྱིར་རོ་༎
 sāhaṃkāramanaskāratā dauṣṭhulyavikṣepaḥ | dauṣṭhulyavaśenāsmimānasamudācārāt | hīnacittatvaṃ |	ངར་འཛིན་པ་དང་བཅས་པའི་ཡིད་ལ་བྱེད་པ་ན་གནས་ངན་ལེན་གྱི་རྣམ་པར་ག-ཡེང་བ་སྟེ་། གནས་ངན་ལེན་གྱི་དབང་གིས་ངའོ་སྙམ་པའི་ང་རྒྱལ་ཀུན་ཏུ་འབྱུང་བའི་ཕྱིར་རོ་༎ དམན་པའི་སེམས་ནི་ཡིད་ལ་བྱེད་པའི་རྣམ་པར་ག-ཡེང་བ་སྟེ་།
 manasikāravikṣepaḥ hīnayānamanasikārasamudācārāt | [aviparyāsapariṇatā]	ཐེག་པ་དམན་པ་ཡིད་ལ་བྱེད་པ་ཀུན་ཏུ་འབྱུང་བའི་ཕྱིར་རོ་༎
 tatrāviparyāso daśavidhe vastuni veditavyaḥ | yad uta |	དེ་ལ་ཕྱིན་ཅི་མ་ལོག་པའི་དངོས་པོ་ནི་རྣམ་པ་བཅུས་རིག་པར་བྱ་སྟེ་། འདི་ལྟ་སྟེ་།
 vyañjanārthamanaskāre 'visāre lakṣaṇadvaye |	ཡི་གེ་དོན་དང་ཡིད་བྱེད་དང་༎ མི་འཕྲོ་བ་དང་མཚན་ཉིད་གཉིས་༎
 aśuddhaśuddhāv āgantukatve 'trāsitānunnatau || v|13	མ་དག་དག་དང་གློ་བུར་དང་༎ མི་སྡང་བ་དང་ཁེངས་པ་མེད་༎
 tatra |	དེ་ལ་།
 saṃyogāt saṃstavāc caiva viyogād apy asaṃstavāt |	འབྲེལ་བའི་ཕྱིར་དང་འདྲིས་ཕྱིར་དང་༎ མ་འབྲེལ་ཕྱིར་དང་མ་འདྲིས་ཕྱིར་༎
 arthasatvam asatvañ ca vyañjane so 'viparyayaḥ |] v|14	དོན་ཡོད་པ་དང་མེད་པ་སྟེ་༎
 saṃyoge sati vyañjanānām avicchinnoccāraṇatayā asya cedaṃ nāmeti saṃstavāt sārthakatvaṃ viparyayān nirarthakatvam iti |	དེ་ནི་ཡི་གེ་མ་ལོག་པའོ་༎ ཡི་གེ་རྣམས་དང་འབྲེལ་ཏེ་རྒྱུན་མི་འཆད་པར་བརྗོད་པ་དང་། འདིའི་མིང་ནི་འདི་ཞེས་བྱའོ་ཞེས་འདྲིས་པས་དོན་ཡོད་པ་ཉིད་དོ་༎
 yad evandarśanaṃ so 'viparyāso vyañjane veditavyaḥ |	བཟློག་པ་ནི་དོན་མེད་པ་ཉིད་དོ་ཞེས་དེ་ལྟར་མཐོང་བ་གང་ཡིན་པ་དེ་ནི་ཡི་གེ་ལ་ཕྱིན་ཅི་མ་ལོག་པར་རིག་པར་བྱའོ་༎
 katham arthe 'viparyāsaḥ |	དོན་ལ་ཕྱིན་ཅི་མ་ལོག་པ་ཇི་ལྟ་བུ་ཞེ་ན་།
 dvayena pratibhāsatvaṃ tathā cāvidyamānatā j	གཉིས་སུ་སྣང་བར་གྱུར་པ་ནི་༎ དེ་ལྟར་ཡོད་པ་མ་ཡིན་ཏེ་༎
 arthe sa cāviparyāsaḥ sadasatvena varjitaḥ || v|15	དེ་ནི་དོན་ལ་མ་ལོག་པར་༎ ཡོད་དང་མེད་པ་རྣམ་པར་སྤངས་༎
 dvayena grāhyagrāhakatvena pratibhāsate tadākarotpattitaḥ |	གཉིས་ནི་གཟུང་བ་དང་འཛིན་པར་སྣང་བ་སྟེ་དེའི་རྣམ་ཕར་འབྱུང་བའི་ཕྱིར་རོ་༎
 tathā (mvbh 66) ca na vidyate | yathā pratibhāsata iti |	ཇི་ལྟར་སྣང་བ་དེ་ལྟར་ནི་ཡོད་པ་མ་ཡིན་ཏེ་།
 arthe yad darśanaṃ sa tatrāviparyāsaḥ arthasya satvena varjito grāhyagrāhakābhāvād asatvena varjitaḥ |	དེ་ལྟར་དོན་ལ་མཐོང་བ་གང་ཡིན་པ་དེ་ནི་དེ་ལ་ཕྱིན་ཅི་མ་ལོག་པའོ་༎ དོན་གྱི་ཡོད་པ་སྤངས་པ་ནི་གཟུང་བ་དང་འཛིན་པ་དངོས་པོ་མེད་པའི་ཕྱིར་རོ་༎
 tatpratibhāsabhrāntisadbhāvāt |	མེད་པ་སྤངས་པ་ནི་དེར་སྣང་བའི་འཁྲུལ་པ་ཡོད་པའི་ཕྱིར་རོ་༎ རྟོག་པ་དེ་ཡིས་བསྒོས་པ་ཡི་༎
 tajjalpabhāvito jalpamanaskāras tadāśrayaḥ	རྟོག་པ་ཡིད་བྱེད་དེའི་གནས་ནི་༎
 manaskāre 'viparyāso dvayaprakhyānakāraṇe || v|16	ཡིད་ལ་བྱེད་པ་མ་ལོག་པ་༎ གཉིས་སུ་སྣང་བའི་རྒྱུ་ལའོ་༎
 grāhyagrāhakajalpaparibhāvito jalpamanaskāras tasya grāhyagrāhakavikalpasyāśrayo bhavatīty ayaṃ manaskāre 'viparyāsaḥ |	གཟུང་བ་དང་འཛིན་པར་རྟོག་པས་ཡོངས་སུ་བསྒོས་པ་ནི་རྟོག་པའི་ཡིད་ལ་བྱེད་པ་སྟེ་། གཟུང་བ་དང་འཛིན་པ་རྣམ་པར་རྟོག་པ་དེའི་རྟེན་ཡིན་པས་། འདི་ནི་ཡིད་ལ་བྱེད་པ་ལ་ཕྱིན་ཅི་མ་ལོག་པའོ་༎
 katamasmin manaskāre grāhyagrāhakasaṃprakhyānakāraṇe sa hy asau jalpamanaskāro 'bhilāpasaṃjñāparibhāvitatvāt grāhyagrāhakavikalpāśrayo veditavyaḥ	ཡིད་ལ་བྱེད་པ་གང་ལ་ཕྱིན་ཅི་མ་ལོག་ཅེ་ན་། གཟུང་བ་དང་འཛིན་པ་གཉིས་སུ་སྣང་བའི་རྒྱུ་ལ་སྟེ་། རྟོག་པ་ཡིད་ལ་བྱེད་པ་དེ་ནི་བརྗོད་པའི་འདུ་ཤེས་ཀྱིས་ཡོངས་སུ་བསྒོས་པའི་ཕྱིར་རོ་༎
 māyādivad asatvañ ca satvaṃ cārthasya tan mataṃ [|]	དོན་གྱི་མེད་དང་ཡོད་པ་སྟེ་༎ སྒྱུ་མ་ལ་སོགས་བཞིན་དུ་འདོད་༎ ༄༢༢བ་དེ་ནི་མི་འཕྲོ་མ་ལོག་སྟེ་༎
 so 'visāre 'viparyāso bhāvābhāvāvisārataḥ || v|17	ཡོད་དང་མེད་པ་མི་འཕྲོའི་ཕྱིར་༎
 yat tad arthasyāsatvaṃ satvaṃ cānantaram uktaṃ |	དོན་གྱི་མེད་པ་དང་ཡོད་པ་གོང་དུ་བཤད་མ་ཐག་པ་གང་ཡིན་པ་དེ་ནི་སྒྱུ་མ་ལ་སོགས་པ་བཞིན་དུ་འདོད་དེ་།
 tan māyādivan mataṃ yathā māyā na hastyādibhāvenāsti na ca naivāsti | tadbhrāntimātrāstitvāt |	དཔེར་ན་སྒྱུ་མའི་གླང་པོ་ཆེ་ལ་སོགས་པའི་དངོས་པོར་ཡོད་པ་ཡང་མ་ཡིན་ལ་།
 evam artho 'pi na cāsti yathā saṃprakhyāti grāhyagrāhakatvena na ca naivāsti tadbhrāntimātrāstitvāt |	དེའི་འཁྲུལ་པ་ཙམ་དུ་ཡོད་པའི་ཕྱིར་མེད་པ་ཡང་མ་ཡིན་ནོ་༏་༏་དེ་བཞིན་དུ་དོན་ཀྱང་ཇི་ལྟར་གཟུང་བ་དང་འཛིན་པར་སྣང་བ་ལྟར་ཡོད་པ་མ་ཡིན་ལ་། དེ་ལ་འཁྲུལ་པ་ཙམ་དུ་ཡོད་པའི་ཕྱིར་མེད་པ་ཡང་མ་ཡིན་ནོ་༎
 ādiśabdena marīcisvapnodakacandrādayo dṛṣṭāntā yathāyogaṃ veditavyā iti yan māyādyupamārthe	སོགས་པ་ཞེས་བྱ་བའི་སྒྲས་ནི་སྨིག་རྒྱུ་དང་། རྨི་ལམ་དང་ཆུ་ཟླ་ལ་སོགས་པའི་དཔེ་རྣམས་ཏེ་ཅི་རིགས་སུ་རིག་པར་བྱའོ་༎ དེ་ལྟར་དོན་ལ་སྒྱུ་མ་ལ་སོགས་པ་ལྟ་བུར་མཐོང་ནས་སེམས་མི་འཕྲོ་བར་མཐོང་བ་གང་ཡིན་པ་དེ་ནི་མི་འཕྲོ་བ་ལ་ཕྱིན་ཅི་མ་ལོག་པ་སྟེ་།
 darśanād avisāraṃ cetasaḥ paśyati so 'visāre 'viparyāsas tena bhāvābhāvayoś cittasyāvisaraṇāt | (mvbh 67)	དེས་ཡོད་པ་དང་མེད་པ་ལ་སེམས་འཕྲོ་བ་མེད་པའི་ཕྱིར་རོ་༎
 sarvasya nāmamātratvaṃ sarvakalpāpravṛttaye |	རྟོག་པ་ཐམས་ཅད་མི་འཇུག་ཕྱིར་༎ ཐམས་ཅད་མིང་ཙམ་ཁོ་ན་སྟེ་༎
 svalakṣaṇe 'viparyāsaḥ |	རང་གི་མཚན་ཉིད་མ་ལོག་པའོ་༎
 sarvam idaṃ nāmamātraṃ | yad idaṃ cakṣūrūpaṃ yāvan manodharmā iti yaj jñānaṃ sarvavikalpānāṃ pratipakṣeṇa ayaṃ svalakṣaṇe 'viparyāsaḥ |	གང་འདི་མིག་དང་གཟུགས་རྣམས་ནས་། ཡིད་དང་ཆོས་རྣམས་ཞེས་བྱ་བའི་བར་འདི་དག་ཐམས་ཅད་ནི་མིང་ཙམ་མོ་ཞེས་དེ་ལྟར་གང་ཤེས་པ་ནི་རྣམ་པར་རྟོག་པ་ཐམས་ཅད་ཀྱི་གཉེན་པོ་ཡིན་པས་འདི་ནི་རང་གི་མཚན་ཉིད་ལ་ཕྱིན་ཅི་མ་ལོག་པའོ་༎
 katamasmin svalakṣaṇe |	རང་གི་མཚན་ཉིད་གང་ལ་ཞེ་ན་།
 paramārthe svalakṣaṇe || v|18	དོན་དམ་རང་གི་མཚན་ཉིད་ལའོ་༎
 saṃvṛtyā tu nedaṃ nāmamātram iti gṛhyate |	ཀུན་རྫོབ་ཏུ་ནི་འདི་མིང་ཙམ་མོ་ཞེས་འཛིན་པ་མེད་དོ་༎
 dharmadhātuvinirmukto yasmād dharmo na vidyate |	ཆོས་ཀྱི་དབྱིངས་ནི་མ་གཏོགས་པར་༎ འདི་ལྟར་ཆོས་ཡོད་མ་ཡིན་ཏེ་༎
 sāmānyalakṣaṇaṃ tasmāt sa ca tatrāviparyayaḥ || v|19	དེའི་ཕྱིར་སྤྱི་ཡི་མཚན་ཉིད་དེར་༎ དེ་ནི་ཕྱིན་ཅི་མ་ལོག་པའོ་༎
 na hi dharmanairātmyena vinā kaścid dharmo vidyate |	ཆོས་ལ་བདག་མེད་པ་ལས་མ་གཏོགས་པར་ཆོས་གང་མེད་དེ་།
 tasmād dharmadhātuḥ sarvadharmāṇāṃ sāmānyaṃ lakṣaṇam iti | yad evaṃjñānam ayaṃ sāmānyalakṣaṇe 'viparyāsaḥ |	དེ་བས་ན་ཆོས་ཀྱི་དབྱིངས་ནི་ཆོས་ཐམས་ཅད་ཀྱི་སྤྱིའི་མཚན་ཉིད་དོ་ཞེས་དེ་ལྟར་ཤེས་པ་གང་ཡིན་པ་དེ་ནི་སྤྱིའི་མཚན་ཉིད་ལ་ཕྱིན་ཅི་མ་ལོག་པའོ་༎ ཕྱིན་ཅི་ལོག་གི་ཡིད་ལ་བྱེད་༎
 viparyastamanaskārāvihāniparihāṇitaḥ |	མ་སྤངས་པ་དང་སྤངས་པ་ལས་༎
 tadaśuddhir viśuddhiś ca sa ca tatrāviparyayaḥ || v|20	དེ་ནི་མ་དག་རྣམ་དག་སྟེ་༎ དེ་ཡང་དེ་ལ་མ་ལོག་པའོ་༎
 viparyastasmanaskārāprahāṇan tasya dharmadhātor aviśuddhis tatprahāṇaṃ viśuddhir iti yad evaṃjñānam ayam aviśuddhau viśuddhau cāviparyāso yathākramaṃ	ཕྱིན་ཅི་ལོག་གི་ཡིད་ལ་བྱེད་པ་མ་སྤངས་པ་ནི་ཆོས་ཀྱི་དབྱིངས་དེ་རྣམ་པར་མ་དག་པའོ་༎ སྤངས་པ་ནི་རྣམ་པར་དག་པའོ་ཞེས་དེ་ལྟར་ཤེས་པ་གང་ཡིན་པ་དེ་ནི་རྣམ་པར་མ་དག་པ་དང་། རྣམ་པར་དག་པ་ལ་ཕྱིན་ཅི་མ་ལོག་པ་སྟེ་གོ་རིམས་བཞིན་ནོ་༎
 dharmadhātor viśuddhatvāt prakṛtyā vyomavat punaḥ |	ཆོས་ཀྱི་དབྱིངས་ནི་རང་བཞིན་གྱིས་༎ རྣམ་པར་དག་ཕྱིར་ནམ་མཁའ་བཞིན་༎ གཉིས་ནི་གློ་བུར་བྱུང་བ་སྟེ་༎
 dvayasyāgantukatvaṃ hi sa ca tatrāviparyayaḥ || v|21	དེ་ཡང་དེ་ལ་མ་༄༢༣ཨ་༌་༎ ལོག་པའོ་༎
 dharmadhātoḥ punar ākāśavat | prakṛtiviśuddhatvāt |	ཆོས་ཀྱི་དབྱིངས་ནི་ནམ་མཁའ་བཞིན་དུ་རང་བཞིན་གྱིས་རྣམ་པར་དག་པའི་ཕྱིར་རྣམ་པར་མ་དག་པ་དང་། 
 dvayam apy etad āgantukam aviśuddhiru viśuddhiś ca paścād iti | yad evaṃjñānam ayam āgantukatve 'viparyāsaḥ | (mvbh 68)	ཕྱིས་རྣམ་པར་དག་ཅེས་བྱ་བ་འདི་གཉིས་ཀྱང་གློ་བུར་ཡིན་པར་དེ་ལྟར་ཤེས་པ་གང་ཡིན་པ་དེ་ནི་གློ་བུར་དུ་བྱུང་བ་ཉིད་ལ་ཕྱིན་ཅི་མ་ལོག་པའོ་༎
 saṃkleśaś ca viśuddhiś ca dharmapudgalayor na hi |	།
 asatvāt trāsatāmānau nātaḥ so 'trāviparyayaḥ || v|22	མེད་ཕྱིར་དེ་བས་སྐྲག་དང་ང་༎ མེད་དེ་དེ་འདིར་མ་ལོག་པའོ་༎
 na hi pudgalasya saṃkleśo na viśuddhir nāpi dharmasya |	གང་ཟག་གི་ཀུན་ནས་ཉོན་མོངས་པ་མེད་པས་རྣམ་པར་དག་པ་མེད་དོ་༎ ཆོས་ཀྱི་ཡང་མེད་དེ་།
 yasmān na pudgalo 'sti na dharmo yataś ca na kasyacit saṃkleśo na vyavadānaṃ ato na saṃkleśapakṣe kasyacid dhāniḥ na vyavadānapakse kasyacid viśeṣaḥ |	འདི་ལྟར་གང་ཟག་མེད་ཅིང་ཆོས་མེད་པའི་ཕྱིར་རོ་༎ གང་གི་ཀུན་ནས་ཉོན་མོངས་པ་གང་ཡང་མེད་ཅིང་རྣམ་པར་བྱང་བ་ཡང་མེད་པ་དེའི་ཕྱིར་ཀུན་ནས་ཉོན་མོངས་པའི་ཕྱོགས་ལ་སུ་ཡང་འགྲིབ་པ་ཡང་མེད་ལ་། རྣམ་པར་བྱང་བའི་ཕྱོགས་ལ་སུའི་ཁྱད་པར་དུ་འགྱུར་བའང་མེད་ན་།
 yatas trāso vā syād unnatir vety ayam atrāse 'nunnatau cāviparyāsaḥ |	དེའི་ཕྱིར་སྐྲག་པའམ་ང་རྒྱལ་དུ་གྱུར་ཏེ་། འདི་ནི་སྐྲག་པ་མེད་པ་དང་༎ ཁེངས་པ་མེད་པ་ལ་ཕྱིན་ཅི་མ་ལོག་པའོ་༎
 [daśa vajrapadāni] ete ca daśāviparyāsā daśasu vajrapadeṣu yathākramaṃ yojayitavyāḥ |	ཕྱིན་ཅི་མ་ལོག་པ་བཅུ་པོ་འདི་དག་ནི་རྡོ་རྗེའི་ཚིག་བཅུ་པོ་དག་དང་གོ་རིམས་བཞིན་དུ་སྦྱར་བར་བྱ་སྟེ་།
 daśa vajrapadāni |	རྡོ་རྗེའི་ཚིག་བཅུ་པོ་འདི་དག་ནི་།
 sadasattā aviparyasaḥ | āśrayo māyopamatā avikalpanatā prakṛtiprabhāsvaratā saṃkleśo vyavadānaṃ | ākāśopamatā ahīnatā aviśiṣṭatā ca |	ཡོད་པ་དང་མེད་པ་དང་། ཕྱིན་ཅི་མ་ལོག་པ་དང་། གནས་དང་། སྒྱུ་མ་ལྟ་བུ་ཉིད་དང་། རྣམ་པར་མི་རྟོག་པ་ཉིད་དང་། རང་བཞིན་གྱིས་འོད་གསལ་བ་ཉིད་དང་། ཀུན་ནས་ཉོན་མོངས་པ་དང་། རྣམ་པར་བྱང་བ་དང་། ནམ་མཁའ་ལྟ་བུ་དང་། འགྲིབ་པ་མེད་པ་དང་། ཁྱད་པར་དུ་འཕགས་པ་མེད་པའོ་༎ རྡོ་རྗེའི་ཚིག་རྣམས་ཀྱི་ལུས་རྣམ་པར་གཞག་པ་ནི་ངོ་བོ་ཉིད་དེ་ངོ་བོ་ཉིད་རྣམ་པ་གསུམ་དང་དམིགས་པ་དང་། རྣམ་པར་མི་རྟོག་པ་ཉིད་དང་། བརྒལ་བ་དང་། ལན་ཏེ་།
 vajrapadānāṃ śarīravyavasthānaṃ | svabhāvataḥ | ālambanataḥ | avikalpanataḥ | codyaparihārataś ca |	རྡོ་རྗེའི་ཚིག་ལྷག་མ་རྣམས་སོ་༎ ལུས་རྣམ་པར་གཞག་པ་གཉིས་པ་ནི་། གང་ལ་གང་ཞིག་གང་གིས་འཁྲུལ་༎ མ་འཁྲུལ་གང་ཞིག་གང་ལ་དང་༎ འཁྲུལ་དང་མ་འཁྲུལ་འབྲས་བུ་ཉིད་༎ དེ་གཉིས་ཀྱི་ནི་མཐའ་མའོ་༎
 tatra svabhāvataḥ trayaḥ svabhāvāḥ |	རྡོ་རྗེའི་ཚིག་རྣམས་ཀྱིས་བསྡུས་པའི་དོན་ནི་ངོ་བོ་ཉིད་གསུམ་ནི་དམིགས་པ་སྟེ་།
 pariniṣpannaparikalpitaparatantrākhyā ādyais tribhiḥ padair yathākramaṃ | ālambanataḥ |	ཡོངས་སུ་གྲུབ་པ་དང་། ཀུན་བརྟགས་པ་དང་། གཞན་གྱི་དབང་ཞེས་བྱ་བ་དག་སྟེ་། ཚིག་དང་པོ་གསུམ་དང་གོ་རིམས་བཞིན་ནོ་༎
 ta eva avikalpanato yena ca na vikalpayati nirvikalpena jñānena yac ca na vikalpayati prakṛtiprabhāsvaratāṃ |	རྣམ་པར་མི་རྟོག་པ་ཉིད་ནི་གང་གིས་རྣམ་པར་མི་རྟོག་ཅེ་ན་། རྣམ་པར་མི་རྟོག་པའི་ཡེ་ཤེས་ཀྱིས་སོ་༎ གང་ལ་རྣམ་པར་༄༢༣བ་མི་རྟོག་ཅེ་ན་། རང་བཞིན་གྱིས་འོད་གསལ་བ་ཉིད་ལའོ་༎
 tad anena jñeyajñānavyavasthānaṃ yathākramaṃ veditavyaṃ |	དེ་བས་ན་འདིས་ཤེས་པ་དང་། ཤེས་པ་རྣམ་པར་གཞག་པ་འདི་ལྟ་སྟེ་།
 yad uta tribhiḥ svabhāvair avikalpanatayā ca |	ངོ་བོ་ཉིད་གསུམ་དང་། རྣམ་པར་མི་རྟོག་པ་ཉིད་དང་གོ་རིམས་བཞིན་དུ་རིག་པར་བྱའོ་༎
 codyaparihārataḥ | śiṣṭāni padāni tatredaṃ codyaṃ |	བརྒལ་བ་དང་། ལན་ནི་ལྷག་མ་རྣམས་སོ་ཞེས་བྱ་བ་དེ་ལ་བརྒལ་བ་ནི་འདི་ཡིན་ཏེ་།
 yady ete parikalpitaparatantralakṣaṇā dharmā na saṃvidyante | katham upalabhyante |	གལ་ཏེ་ཀུན་བརྟགས་པ་དང་། གཞན་གྱི་དབང་གི་མཚན་ཉིད་ཀྱི་ཆོས་དེ་དག་མེད་ན་ཇི་ལྟར་དམིགས་པར་འགྱུར་།
 atha saṃvidyante dharmāṇāṃ prakṛtiprabhāsvaratā na (mvbh 69) yujyate |	ཅི་སྟེ་ཡོད་ན་དེ་ལྟ་ན་གོ་ཆོས་རྣམས་རང་བཞིན་གྱིས་འོད་གསལ་བ་ཉིད་དུ་མི་རུང་ངོ་ཞེ་ན་། 
 tan māyopamatayā pariharati |	དེའི་ལན་ནི་སྒྱུ་མ་ལྟ་བུ་ཉིད་ཡིན་ཏེ་།
 yathā māyākṛtaṃ na vidyata upalabhyate ca yadi prakṛtiprabhāsvaratā dharmāṇāṃ tat kathaṃ pūrvaṃ saṃkleśaḥ paścād vyavadānaṃ |	དཔེར་ན་སྒྱུ་མ་བྱས་པ་ནི་མེད་ཀྱང་དམིགས་པ་ལྟ་བུའོ་༎ གལ་ཏེ་ཆོས་རྣམས་རང་བཞིན་གྱིས་འོད་གསལ་བ་ཉིད་ཡིན་ན་ཇི་ལྟར་སྔར་ཀུན་ནས་ཉོན་མོངས་པ་ཕྱིས་རྣམ་པར་བྱང་ཞེ་ན་།
 asya parihāraḥ | saṃkleśavyavadānam ākāśopamatayā veditavyaṃ |	དེའི་ལན་ནི་ཀུན་ནས་ཉོན་མོངས་པ་དང་། རྣམ་པར་བྱང་བ་ནམ་མཁའ་ལྟ་བུར་རེག་པ་བྱ་བ་ཡིན་ཏེ་།
 yathākāśaṃ prakṛtipariśuddhaṃ saṃkliśyate |	དཔེར་ན་ནམ་མཁའ་རང་བཞིན་གྱིས་རྣམ་པར་དག་པ་ལ་ཀུན་ནས་ཉོན་མོངས་སོ་༎
 vyavadāyate ceti |	རྣམ་པར་བྱང་ངོ་ཞེས་བྱ་བ་ལྟ་བུའོ་༎
 yady aprameyabuddhotpāde saty aprameyāṇāṃ satvānāṃ kleśāpaśamaḥ |	གལ་ཏེ་སངས་རྒྱས་དཔག་ཏུ་མེད་པ་བྱུང་སྟེ་། སེམས་ཅན་དཔག་ཏུ་མེད་པ་དག་གི་ཀུན་ནས་ཉོན་མོངས་པ་བསལ་ན་།
 tat kathaṃ na saṃsārasamucchedo na nirvāṇavṛddhir bhavati |	དེའི་ཕྱིར་ཅི་ལྟར་འཁོར་བ་རྒྱུན་ཆད་པར་མི་འགྱུར་ཞིང་མྱ་ངན་ལས་འདས་པ་འཕེལ་བར་མི་འགྱུར་ཞེ་ན་། 
 tasyāhīnāviśiṣṭatayā parihāraḥ |	དེའི་ལན་ནི་འགྲིབ་པ་མེད་པ་དང་། ཁྱད་པར་དུ་འཕགས་པ་མེད་པ་ཉིད་ཡིན་ཏེ་།
 aprameyatvāt satvadhātor vyavadānapakṣasya ca | dvitīyaṃ śarīravyavasthānam | yatra yā ca yato bhrāntir abhrāntir yā ca yatra ca | bhrāntyabhrāntiphale caiva paryantaś ca tayor iti ||	སེམས་ཅན་གྱི་ཁམས་དང་། རྣམ་པར་བྱང་བའི་ཕྱོགས་དཔག་ཏུ་མེད་པའི་ཕྱིར་རོ་༎
 sadasattāviparyāsaḥ āśrayo māyayopamā |	ཡོད་མེད་ཕྱིན་ཅི་མ་ལོག་དང་༎ གནས་དང་སྒྱུ་མ་ལྟ་བུ་ཉིད་༎
 akalpanā prakṛtyā ca bhāsvaratvaṃ sadaiva hi ||	མི་རྟོག་པ་དང་རང་བཞིན་གྱིས་༎ རྟག་པར་འོད་གསལ་ཉིད་དང་ནི་༎
 saṃkleśo vyavadānaṃ cākāśopamatā tathā |	ཀུན་ནས་ཉོན་མོངས་རྣམ་བྱང་དང་༎ དེ་བཞིན་ནམ་མཁའ་ལྟ་བུ་ཉིད་༎
 ahīnānadhikatvañ ca daśa vajrapadāni hi ||	འགྲིབ་པ་མེད་དང་ལྷག་མེད་པ་༎ རྡོ་རྗེའི་ཚིག་ནི་བཅུ་ཞེས་བྱ་༎
 uktānudharmapratipattiḥ |	རྗེས་སུ་མཐུན་པའི་ཆོས་སྒྲུབ་པ་བཤད་ཟིན་ཏེ་༎
 [d| antadvayavarjane pratipattiḥ]	མཐའ་གཉིས་སྤང་བ་བསྒྲུབ་པ་གང་ཞེ་ན་།
 antadvayavarjane pratipattiḥ katamā yā ratnakūṭe madhyamā pratipattir upadiṣṭā |	གང་དཀོན་མཆོག་བརྩེགས་པ་ལས་དབུ་མའི་ལམ་བཤད་པའོ་༎
 kasyāntasya varjanād asau veditavyā |	མཐའ་གང་དང་གང་སྤངས་པས་དེ་རིག་པར་བྱ་ཞེ་ན་།
 pṛthaktvaikatvam antaś ca tirthyaśrāvakayor api | samāropāpavādānto dvidhā pudgaladharmayoḥ || v|23	ཐ་དད་པ་དང་གཅིག་མཐའ་དང་༎ མུ་སྟེགས་ཉན་ཐོས་གཉིས་ཀ་དང་༎ གང་ཟག་ཆོས་ལ་སྒྲོ་འདོགས་དང་༎ སྐུར་འདེབས་མཐའ་༄༢༤ཨ་༌་༎
 vipakṣapratipakṣāntaḥ śāśvatocchedasaṃjñitaḥ |	རྣམས་གཉིས་གཉིས་དང་༎ མི་མཐུན་ཕྱོགས་དང་གཉེན་པོའི་མཐའ་༎ རྟག་དང་ཆད་པར་འདུ་ཤེས་དང་༎ གཟུང་དང་འཛིན་དང་ཀུན་ཉོན་མོངས་༎
 grāhyagrāhakasaṃkleśavyavadāne dvidhā tridhā || v|24	རྣམ་པར་བྱང་ལ་གཉིས་དང་གསུམ་༎
 vikalpadvayatāntaś ca sa ca saptavidho mataḥ |	རྣམ་པར་རྟོག་པ་གཉིས་ཀྱི་མཐའ་༎ དེ་ནི་རྣམ་པ་བདུན་དུ་འདོད་༎
 bhāvābhāve praśāmye 'tha śamane trāsyantadbhaye || v|25 (mvbh 70)	དངོས་ཡོད་དངོས་མེད་ཞི་བྱེད་དང་༎ ཞི་བྱེད་སྐྲག་བྱ་དེ་ལ་འཇིགས་༎
 grāhyagrāhe 'tha samyaktvamithyātve vyāpṛtau na ca |	གཟུང་དང་འཛིན་དང་ཡང་དག་ཉིད་༎ ལོག་པ་ཉིད་དང་བྱེད་དང་མིན་༎
 ajanmasamakālatve sa vikalpadvayāntatā || v|26	སྐྱེ་བ་མེད་དང་མཉམ་པའི་དུས་༎ དེ་ནི་རྣམ་རྟོག་གཉིས་ཀྱི་མཐའ་༎
 tatra rūpādibhyaḥ | pṛthaktvam ātmana ity antaḥ |	དེ་ལ་གཟུགས་ལ་སོགས་པ་དང་བདག་ཐ་དད་ཅེས་བྱ་བ་ཡང་མཐའོ་༎
 ekatvam ity antaḥ tatparivarjanārthaṃ madhyamā pratipat |	གཅིག་ཅེས་བྱ་བ་ཡང་མཐའོ་༎ དེ་ཡོངས་སུ་སྤང་བའི་ཕྱིར་དབུ་མའི་ལམ་སྟེ་།
 yā nātmapratyavekṣā |	གང་བདག་མེད་པར་སོ་སོར་རྟོག་པ་ནས་ཤེད་བུ་མེད་པར་སོ་སོར་རྟོག་པའི་བར་དུའོ་༎
 yāvan na mānavapratyavekṣā ātmadarśane hi jīvas tac charīraṃ | anyo jīvo 'nyac charīram iti bhavati darśanaṃ |	བདག་ཏུ་ལྟ་བ་ནི་སྲོག་ཀྱང་གཞན་ལ་ལུས་ཀྱང་གཞན་པ་དང་། སྲོག་དེ་ཉིད་ལུས་དེ་ཡིན་ཞེས་བྱ་བར་ལྟ་བ་ཡིན་ནོ་༎
 nityaṃ rūpam iti tīrthikāntaḥ |	གཟུགས་ལ་སོགས་པ་རྟག་གོ་ཞེས་བྱ་བ་ནི་མུ་སྟེགས་ཅན་གྱི་མཐའོ་༎
 anityam iti śrāvakāntaḥ |	མི་རྟག་གོ་ཞེས་བྱ་བ་ནི་ཉན་ཐོས་ཀྱི་མཐའོ་༎
 tatparivarjanārthaṃ madhyamā pratipad yā rūpādīnāṃ na nityapratyavekṣā nānityapratyavekṣā |	དེ་ཡོངས་སུ་སྤང་བའི་ཕྱིར་དབུ་མའི་ལམ་སྟེ་། གང་གཟུགས་ལ་སོགས་པ་ལ་རྟག་པར་ཡང་མི་རྟོག་། མི་རྟག་པར་ཡང་མི་རྟོག་པའོ་༎
 ātmeti pudgalasamāropāntaḥ nairātmyam ity apavādāntaḥ prajñaptisato 'py apavādāt |	བདག་ཅེས་བྱ་བ་ནི་གང་ཟག་ཏུ་སྒྲོ་འདོགས་པའི་མཐའོ་༎ བདག་མེད་ཅེས་བྱ་བ་ནི་སྐུར་བ་འདེབས་པའི་མཐའ་སྟེ་། བརྟགས་པའི་ཡོད་པ་ལ་སྐུར་པ་འདེབས་པའི་ཕྱིར་རོ་༎
 tatparivarjanārthaṃ madhyamā pratipad yad ātmanairātmyayor madhyaṃ nirvikalpaṃ jñānaṃ |	དེ་ཡོངས་སུ་སྤང་བའི་ཕྱིར་དབུ་མའི་ལམ་སྟེ་། གང་བདག་དང་བདག་མེད་པ་གཉིས་ཀྱི་དབུས་ནི་རྣམ་པར་མི་རྟོག་པ་ཉིད་དོ་༎
 bhūtaṃ cittam iti dharmasamāropāntaḥ abhūtam ity apavādāntaḥ |	སེམས་ཡང་དག་པའོ་ཞེས་བྱ་བ་ནི་ཆོས་ལ་སྒྲོ་འདོགས་པའི་མཐའོ་༎ སེམས་ཡང་དག་པ་མ་ཡིན་ནོ་ཞེས་བྱ་བ་ནི་སྐུར་པ་འདེབས་པའི་མཐའོ་༎ དེ་ཡོངས་སུ་སྤང་བའི་ཕྱིར་དབུ་མའི་ལམ་སྟེ་།
 tatparivarjanārthaṃ madhyamā pratipad yatra na cittaṃ na cetanā na mano na vijñānaṃ |	གང་ལ་སེམས་མེད་པ་དང་། སེམས་པ་མེད་པ་དང་། ཡིད་མེད་པ་དང་། རྣམ་པར་ཤེས་པ་མེད་པའོ་༎
 akuśalādayo dharmāḥ saṃkleśa iti vipakṣāntaḥ |	མི་དགེ་བ་ལ་སོགས་པའི་ཆོས་རྣམས་ནི་ཀུན་ནས་ཉོན་མོངས་པའོ་ཞེས་བྱ་བ་ནི་མི་མཐུན་པའི་ཕྱོགས་ཀྱི་མཐའོ་༎
 kuśalādayo vyavadānam iti pratipakṣāntas tatparivarjanārthaṃ madhyamā pratipad yo 'syāntadvayasyānupagamo 'nudāhāro 'pravyāhāraḥ |	དགེ་བ་ལ་སོགས་པ་ནི་རྣམ་པར་བྱང་བའོ་ཞེས་བྱ་བ་ནི་གཉེན་པོའི་མཐའོ་༎ དེ་ཡོངས་སུ་སྤང་བའི་ཕྱིར་དབུ་མའི་ལམ་སྟེ་། གང་མཐའ་དེ་གཉིས་ཁས་མི་ལེན་ཞིང་མི་བརྗོད་ཅིང་མི་སྨྲ་བའོ་༎ ༄༢༤བ་གང་ཟག་དང་ཆོས་ཡོད་དོ་ཞེས་བྱ་བ་ནི་རྟག་པའི་མཐའོ་༎
 astīti śāśvatāntas tayor eva pudgaladharmayor nāstīty ucchedāntas tatparivarjanārthaṃ madhyamā pratipad yad anayor dvayor antayor madhyaṃ |	མེད་དོ་ཞེས་བྱ་བ་ནི་ཆད་པའི་མཐའོ་༎ དེ་ཡོངས་སུ་སྤང་བའི་ཕྱིར་དབུ་མའི་ལམ་སྟེ་། མཐའ་དེ་གཉིས་ཀྱི་དབུས་གང་ཡིན་པའོ་༎
 avidyā grāhyā grāhakā cety antaḥ |	མ་རིག་པ་ལ་གཟུང་བའོ་༎ འཛིན་པའོ་ཞེས་བྱ་བ་ནི་མཐའ་སྟེ་།
 evaṃ vidyā saṃskārā asaṃskṛtaṃ ca tatpratipakṣaḥ |	དེ་བཞིན་དུ་རིག་པ་དང་འདུ་བྱེད་རྣམས་དང་། དེའི་གཉེན་པོ་འདུས་མ་བྱས་དང་། རྒ་ཤིའི་བར་ལ་གཟུང་བའོ་༎ འཛིན་པའོ་ཞེས་བྱ་བ་ཡང་མཐའོ་༎
 yāvaj jarāmaraṇaṃ grāhyaṃ grāhakaṃ cety antas tannirodho grāhyo grāhako vety anto yena mārgeṇa tan nirudhyate | evaṃ grāhyagrāhakānto (mvbh 71)	དེ་འགོག་པ་ལ་གཟུང་བའོ་༎ འཛིན་པའི་ཞེས་བྱ་བ་ཡང་མཐའ་སྟེ་། ལམ་གང་གིས་དེ་འགག་པའོ་༎
 dvidhā kṛṣṇaśuklapakṣabhedena tatparivarjanārthaṃ madhyamā pratipad vidyā cāvidyā cādvayam etad iti vistareṇa vidyāvidyādīnāṃ grāhyagrāhakatvābhāvāt	དེ་བཞིན་དུ་ནག་པོ་དང་དཀར་པོའི་ཕྱོགས་ཀྱི་བྱེ་བྲག་གིས་གཟུང་བ་དང་འཛིན་པའི་མཐའ་རྣམ་པ་གཉིས་སོ་༎ དེ་ཡོངས་སུ་སྤང་བའི་ཕྱིར་དབུ་མའི་ལམ་སྟེ་། རིག་པ་དང་མ་རིག་པ་འདི་ནི་གཉིས་སུ་མེད་ཅེས་རྒྱ་ཆེར་འབྱུང་སྟེ་། རིག་པ་དང་མ་རིག་པ་ལ་སོགས་པ་ལ་གཟུང་བ་དང་། འཛིན་པའི་དངོས་པོ་མེད་པའི་ཕྱིར་རོ་།
 trividhaḥ saṃkleśaḥ |	ཀུན་ནས་ཉོན་མོངས་པ་རྣམ་པ་གསུམ་སྟེ་།
 kleśasaṃkleśaḥ | karmasaṃkleśaḥ | janmasaṃkleśaś ca |	ཉོན་མོངས་པའི་ཀུན་ནས་ཉོན་མོངས་པ་དང་། ལས་ཀྱི་ཀུན་ནས་ཉོན་མོངས་པ་དང་། སྐྱེ་བའི་ཀུན་ནས་ཉོན་མོངས་པའོ་༎
 tatra kleśasaṃkleśas trividhaḥ |	དེ་ལ་ཉོན་མོངས་པའི་ཀུན་ནས་ཉོན་མོངས་པ་ཡང་རྣམ་པ་གསུམ་སྟེ་།
 dṛṣṭiḥ rāgadveṣamohanimittaṃ punarbhavapraṇidhānaṃ ca |	ལྟ་བ་དང་། འདོད་ཆགས་དང་། ཞེ་སྡང་དང་། གཏི་མུག་གི་རྒྱུ་དང་། ཡང་སྲིད་པ་ལ་སྨོན་པའོ་༎
 yasya pratipakṣo jñānaśūnyatā jñānānimittaṃ jñānāpraṇihitaṃ ca |	དེའི་གཉེན་པོ་ནི་སྟོང་པ་ཉིད་ཤེས་པ་དང་། མཚན་མ་མེད་པའི་ཤེས་པ་དང་། སྨོན་པ་མེད་པའི་ཤེས་པའོ་༎
 karmasaṃkleśaḥ | śubhāśubhakarmābhisaṃskāraḥ yasya pratipakṣo jñānānabhisaṃskāraḥ |	ལས་ཀྱི་ཀུན་ནས་ཉོན་མོངས་པ་ནི་དགེ་བ་དང་མི་དགེ་བའི་ལས་མངོན་པར་འདུ་བྱེད་པའོ༎ དེའི་གཉེན་པོ་ནི་མངོན་པར་འདུ་མི་བྱེད་པ་ཤེས་པའོ་༎
 janmasaṃkleśaḥ | punarbhavajātiḥ jātasya cittacaittānāṃ pratikṣaṇotpādaḥ |	སྐྱེ་བའི་ཀུན་ནས་ཉོན་མོངས་པ་ནི་ཡང་སྲིད་པར་སྐྱེ་བ་དང་། སྐྱེས་པའི་སེམས་དང་སེམས་ལས་བྱུང་བ་རྣམས་སྐད་ཅིག་རེ་རེ་ལ་བྱུང་བ་དང་། ཡང་སྲིད་པའི་རྒྱུན་ཏོ་༎
 punarbhavaprabandhaś ca yasya pratipakṣo jñānājātiḥ jñānānutpādo jñānāsvabhāvatā ca |	དེའི་གཉེན་པོ་ནི་སྐྱ་བ་མེད་པ་ཤེས་པ་དང་། འབྱུང་བ་མེད་པ་ཤེས་པ་དང་། ངོ་བོ་ཉིད་མེད་པ་ཤེས་པའོ་༎
 etasya trividhasya saṃkleśasyāpagamo vyavadānaṃ |	ཀུན་ནས་ཉོན་མོངས་པ་རྣམ་པ་དེ་གསུམ་དང་བྲལ་བ་ནི་རྣམ་པར་བྱང་བའོ་༎
 tatra jñānaśūnyatādibhiḥ | jñeyaśūnyatādayo dharmā etena trividhena saṃkleśena yathāyogaṃ yāvan na śūnyatādayaḥ kriyante |	དེ་ལ་སྟོང་པ་ཉིད་ཤེས་པ་ལ་སོགས་པས་ཤེས་བྱ་སྟོང་པ་ཉིད་ལ་སོགས་པའི་ཆོས་རྣམས་ཀུན་ནས་ཉོན་མོངས་པ་རྣམ་པ་གསུམ་པོ་དེ་དག་དང་ཅི་༄༢༥ཨ་༌་༎ རིགས་པར་སྟོང་པ་ཉིད་ལ་སོགས་པའི་བར་དུ་མི་བྱེད་ཀྱི་། རང་བཞིན་གྱིས་སྟོང་པ་ཉིད་ལ་སོགས་ཏེ་།
 prakṛtyaiva śūnyatādayo dharmadhātoḥ prakṛtyasaṃkliṣṭatvāt tena yadi dharmadhātuḥ saṃkliśyate vā viśudhyate veti kalpayaty ayam antaḥ |	ཆོས་ཀྱི་དབྱིངས་རང་བཞིན་གྱིས་ཀུན་ནས་ཉོན་མོངས་པ་ཅན་དུ་མ་གྱུར་བའི་ཕྱིར་རོ་༎ གལ་ཏེ་ཆོས་ཀྱི་དབྱིངས་ཀུན་ནས་ཉོན་མོངས་པར་གྱུར་པའམ་། རྣམ་པར་དག་པར་འགྱུར་བའོ་སྙམ་དུ་རྣམ་པར་རྟོག་པ་འདི་ནི་མཐའ་སྟེ་།
 prakṛtyasaṃkliṣṭasya saṃkleśaviśuddhyabhāvād etasyāntasya parivarjanārthaṃ | madhyamā pratipat |	རང་བཞིན་གྱིས་ཀུན་ནས་ཉོན་མོངས་པ་ཅན་མ་ཡིན་པ་ལ་ནི་ཀུན་ནས་ཉོན་མོངས་པ་དང་། རྣམ་པར་བྱང་བ་མེད་པའི་ཕྱིར་རོ་༎ མཐའ་དེ་གཉིས་ཡོངས་སུ་སྤང་བའི་ཕྱིར་དབུ་མའི་ལམ་སྟེ་།
 yan na śūnyatayā dharmāñ chūnyāṃ karoti | api tu dharmā eva śūnyā ity evamādi |	གང་སྟོང་པ་ཉིད་ཀྱིས་ཆོས་རྣམས་སྟོང་པར་མི་བྱེད་ཀྱི་ཆོས་རྣམས་ཉིད་ཀྱིས་སྟོང་པའི་ཞེས་འབྱུང་བ་ལ་སོགས་པའོ་༎
 aparaḥ saptavidho vikalpadvayāntas tad yathā bhāve 'pi vikalpo 'ntaḥ|	གཞན་ཡང་རྣམ་པར་རྟོག་པའི་མཐའ་གཉིས་རྣམ་པར་བདུན་ཏེ་། འདི་ལྟ་སྟེ་། དངོས་པོ་ཡོད་པར་རྣམ་པར་རྟོག་པ་ཡང་མཐའོ་༎
 abhāve 'pi pudgalo 'sti yasya vināśāya śūnyatā (mvbh 72)	དངོས་པོ་མེད་པར་རྣམ་པར་རྟོག་པ་ཡང་མཐའོ་༎ གང་ཟག་ཡང་དེ་དེ་གཞིག་པའི་ཕྱིར་སྟོང་པ་ཉིད་དོ་༎
 nairātmyam api vā nāstīti kalpanāt |	ཡང་ན་བདག་མེད་པ་ཡང་མེད་དོ་སྙམ་དུ་རྟོག་པའི་ཕྱིར་ཏེ་།
 tad etasya vikalpadvayāntasya parivarjanārtham iyaṃ madhyamā pratipat |	རྣམ་པར་རྟོག་པའི་མཐའ་འདི་གཉིས་སྤང་བའི་ཕྱིར་དབུ་མའི་ལམ་སྟེ་། འདི་ལྟ་སྟེ་།
 na khalu pudgalavināśāya śūnyatā api tu śūnyataiva śūnyā pūrvāntaśūnyatā |	གང་ཟག་རྣམ་པར་གཞིག་པའི་ཕྱིར་སྟོང་པ་ཉིད་མ་ཡིན་གྱི་སྟོང་པ་ཉིད་ཀྱིས་སྟོང་སྟེ་།
 aparāntaśūnyatā ity evamādivistaraḥ |	སྔོན་གྱི་མཐའ་སྟོང་པ་དང་། ཕྱི་མའི་མཐའ་སྟོང་པ་ཞེས་བྱ་བ་ལ་སོགས་པ་རྒྱ་ཆེར་འབྱུང་བའོ་༎
 śāmye 'pi vikalpo 'ntaḥ |	ཞི་བར་བྱ་བ་རྣམ་པ་ཡང་མཐའོ་༎
 śamane 'pi vikalpo 'nataḥ praheyaprahāṇakalpanayā śūnyatāyās trasanād etasya vikalpadvayāntasya parivarjanārtham ākāśadṛṣṭāntaḥ |	ཞི་བར་བྱེད་པ་རྣམ་པར་རྟོག་པ་ཡང་མཐའ་སྟེ་། སྤང་བར་བྱ་བ་དང་། སྤོང་བར་བྱེད་པ་རྣམ་པར་རྟོག་པས་སྟོང་པ་ཉིད་ཀྱིས་སྐྲག་པའི་ཕྱིར་རོ་༎ རྣམ་པར་རྟོག་པའི་མཐའ་དེ་གཉིས་ཡོངས་སུ་སྤང་བའི་ཕྱིར་དཔེ་ནམ་མཁའོ་༎
 trāsye 'pi vikalpo 'ntas tataś ca trāsyād bhaye 'pi parikalpitarūpāditrasanāt (|	སྐྲག་པར་བྱ་བར་རྣམ་པར་རྟོག་པ་ཡང་མཐའོ་༎ སྐྲག་པར་བྱ་བ་དེ་ལས་འཇིགས་པར་རྣམ་པར་རྟོག་པ་ཡང་མཐའ་སྟེ་། སྡུག་བསྔལ་གྱིས་ཁོང་དང་ངས་པས་ཀུན་བརྟགས་པའི་གཟུགས་ལ་སོགས་པ་ལ་སྐྲག་པའི་ཕྱིར་རོ་༎
 ) duḥkhabhīrutayā etasya vikalpadvayāntasya parivarjanārthaṃ citrakaradṛṣṭāntaḥ |	རྣམ་པར་རྟོག་པའི་མཐའ་དེ་གཉིས་ཡོངས་སུ་སྤང་བའི་ཕྱིར་དཔེ་ནི་རི་མོ་མཁན་ནོ་༎
 pūrvako dṛṣṭāntaḥ śrāvakān ārabhyāyaṃ tu bodhisatvān |	དཔེ་སྔ་མ་ནི་ཉན་ཐོས་རྣམས་ལས་བརྩམས་པའོ་༎ འདི་ནི་བྱང་ཆུབ་སེམས་དཔའ་རྣམས་ལས་བརྩམས་པའོ་༎
 grāhye 'pi vikalpo 'ntaḥ grāhake 'pi etasya vikalpadvayāntasya parivarjanārthaṃ māyākāradṛṣṭāntaḥ |	གཟུང་བར་རྣམ་པར་༄༢༥བ་རྟོག་པ་ཡང་མཐའོ་༎ འཛིན་པར་རྣམ་པར་རྟོག་པ་ཡང་མཐའོ་༎ རྣམ་པར་རྟོག་པའི་མཐའ་དེ་གཉིས་ཡོངས་སུ་སྤང་བའི་ཕྱིར་དཔེ་སྒྱུ་མ་མཁན་ནོ་༎
 vijñaptimātrajñānakṛtaṃ hy arthābhāvajñānaṃ |	རྣམ་པར་རིག་པ་ཙམ་དུ་ཤེས་པས་དོན་དངོས་པོ་མེད་པར་བྱས་ནས་༎
 tac cārthābhāvajñānaṃ | tad eva vijñaptimātrajñānaṃ nivartayati |	དོན་དངོས་པོ་མེད་པར་ཤེས་པ་དེས་ཀྱང་རྣམ་པར་རིག་པ་ཙམ་དུ་ཤེས་པ་དེ་ཉིད་རྣམ་པར་བཟློག་གོ་༎ 
 arthābhāve vijñaptyasaṃbhavād ity etad atra sādharmyaṃ |	དོན་དངོས་པོ་མེད་ན་རྣམ་པར་རིག་པ་མི་སྲིད་པའི་ཕྱིར་ཏེ་། དེ་ལྟར་ན་འདི་ནི་འདིར་མཚུངས་སོ་༎ ཡང་དག་པ་ཉིད་དུ་རྣམ་པར་རྟོག་པ་ཡང་མཐའོ་༎
 samyaktve 'pi vikalpo 'ntaḥ mithyātve 'pi bhūtapratyavekṣāṃ samyaktvena kalpayato mithyātvena vā etasyāntadvayasya parivarjanārthaṃ |	ལོག་པ་ཉིད་དུ་རྣམ་པར་རྟོག་པ་ཡང་མཐའ་སྟེ་། ཡང་དག་པར་སོ་སོར་རྟོག་པ་ན་ཡང་དག་པ་ཉིད་དུའམ་། ལོག་པ་ཉིད་དུ་རྟོག་པའོ་༎
 kāṣṭhadvayāgnidṛṣṭāntaḥ |	མཐའ་དེ་གཉིས་ཡོངས་སུ་སྤང་བའི་ཕྱིར་དཔེ་ཤིང་གཉིས་ལས་མེ་འབྱུང་བ་སྟེ་།
 yathākāṣṭhadvayād (mvbh 73) anagnilakṣaṇād agnir jāyate |	དཔེར་ན་མེའི་མཚན་ཉིད་མ་ཡིན་པ་ཤིང་གཉིས་ལས་མེད་འབྱུང་སྟེ་།
 jātaś ca tad eva kāṣṭhadvayaṃ dahaty evam asamyaktvalakṣaṇāyā yathābhūtapratyavekṣāyāḥ	བྱུང་ནས་ཀྱང་ཤིང་གཉིས་ཚིག་པར་བྱེད་དོ་༎
 samyaktvalakṣaṇam āryaṃ prajñendriyaṃ jāyate jātaṃ ca tām eva bhūtapratyavekṣāṃ vibhāvayatīty	དེ་བཞིན་དུ་ཡང་དག་པ་ཉིད་ཀྱི་མཚན་ཉིད་མ་ཡིན་པ་ཡང་དག་པ་ཇི་ལྟ་བ་བཞིན་དུ་སོ་སོར་རྟོག་པ་ལས་ཡང་དག་པ་ཉིད་ཀྱི་མཚན་ཉིད་འཕགས་པའི་ཤེས་རབ་ཀྱི་དབང་པོ་སྐྱེ་སྟེ་། སྐྱེས་ནས་ཀྱང་ཡང་དག་པར་སོ་སོར་རྟོག་པ་དེ་ཉིད་རྣམ་པར་འཇིག་པར་བྱེད་སྐྱེ་སྟེ་། དེ་། 
 etad atra sādharmyaṃ na cāsamyaktvalakṣaṇāpi bhūtapratyavekṣā mithyātvalakṣaṇā samyaktvānukūlyāt |	དེ་ལྟ་བས་ན་འདི་ནི་འདིར་མཚུངས་སོ་༎ ཡང་དག་པར་སོ་སོར་རྟོག་པ་ཡང་དག་པ་ཉིད་ཀྱི་མཚན་ཉིད་མ་ཡིན་ཀྱང་ལོག་པ་ཉིད་ཀྱི་མཚན་ཉིད་ཀྱང་མ་ཡིན་ཏེ་། ཡང་དག་པ་ཉིད་ཀྱི་རྗེས་སུ་མཐུན་པའི་ཕྱིར་རོ་༎
 vyāpṛtāv api vikalpo 'ntaḥ |	བྱེད་པ་རྣམ་པར་རྟོག་པ་ཡང་མཐའོ་༎ མི་བྱེད་པར་རྣམ་པར་རྟོག་པ་ཡང་མཐའ་སྟེ་།
 avyāpṛtāv api jñānasya buddhipūrvāṃ kriyāṃ niḥsāmarthyaṃ vā kalpayataḥ |	ཡེ་ཤེས་ནི་བློ་སྔོན་དུ་འགྲོ་བས་བྱེད་པའམ་མཐུ་མེད་པར་རྟོག་པའོ་༎
 etasya vikalpadvayāntasya parivarjanārthaṃ | tailapradyotadṛṣṭāntaḥ |	རྣམ་པར་རྟོག་པའི་མཐའ་དེ་གཉིས་ཡོངས་སུ་སྤང་བའི་ཕྱིར་དཔེ་མར་མེའོ་༎ སྐྱེ་བ་མེད་པར་རྣམ་པར་རྟོག་པ་ཡང་མཐའོ་༎
 ajanmatve 'pi vikalpo 'ntaḥ samakālatve 'pi yadi pratipakṣasyānutpattiṃ vā kalpayati	དུས་མཉམ་པ་ཉིད་དུ་རྣམ་པར་རྟོག་པ་ཡང་མཐའ་སྟེ་། གལ་ཏེ་གཉེན་པོ་མ་སྐྱེས་པའམ་། ཀུན་ནས་ཉོན་མོངས་པ་ཡུན་རིང་བ་ཉིད་དུ་རྟོག་པའོ་༎
 saṃkleśasyaiva vā dīrghakālatvam etasya vikalpadvayāntasya parivarjanārthaṃ dvitīyas tailapradyotadṛṣṭāntaḥ |	རྣམ་པར་རྟོག་པའི་མཐའ་དེ་གཉིས་སྤང་བའི་ཕྱིར་མར་མེའི་དཔེ་གཉིས་པའོ་༎
 uktāntadvayaparivarjane pratipattiḥ | [e| viśisṭā cāviśiṣṭā ca pratipattiḥ]	མཐའ་གཉིས་སྤང་བའི་སྒྲུབ་པ་བཤད་ཟིན་ཏོ་༎
 viśiṣṭā cāviśiṣṭā ca pratipattiḥ | katamā |	ཁྱད་པར་ཅན་དང་ཁྱད་པར་མེད་པ་སྒྲུབ་པ་གང་ཞེ་ན་།
 viśiṣṭā cāviśiṣṭā ca jñeyā daśasu bhūmiṣu |	ཁྱད་པར་ཅན་དང་ཁྱད་མེད་ནི་༎ ས་བཅུ་དག་ཏུ་༄༢༦ཨ་༌་༎
 yasyāṃ bhūmau yā pāramitātiriktatarā sā tatra viśiṣṭā sarvāsu ca sarvatra samudāgacchatīty aviśiṣṭā |	ཤེས་པར་བྱ་༎ ས་གང་ལ་ཕ་རོལ་ཏུ་ཕྱིན་པ་གང་གི་ཤས་ཆེ་བ་དེ་ནི་ཁྱད་པར་ཅན་ནོ་༎ ཐམས་ཅད་དུ་ཐམས་ཅད་ལ་ཡང་དག་པར་བསྒྲུབ་པ་ནི་ཁྱད་པར་མེད་པའོ་༎
 uktaṃ pratipattyānuttaryaṃ | [3| ālambanānuttarya]	བསྒྲུབ་པ་བླ་ན་མེད་པ་ཉིད་བཤད་ཟིན་ཏོ་༎
 ālambanānuttaryaṃ | katamat |	དམིགས་པ་བླ་ན་མེད་པ་ཉིད་གང་ཞེ་ན་།
 vyavasthānaṃ tathā dhātuḥ sādhyasādhanadhāraṇā || v|27	རྣམ་པར་གཞག་དང་དེ་བཞིན་དབྱིངས་༎
 avadhārapradhārā ca prativedhaḥ pratānatā | (mvbh 74)	བསྒྲུབ་དང་སྒྲུབ་དང་འཛིན་པ་དང་༎ ངེས་པར་འཛིན་དང་རབ་ཏུ་འཛིན་༎
 pragamaḥ praśaṭhatvaṃ ca prakarṣālambanaṃ mataṃ || v|28	རབ་ཏུ་རྟོགས་དང་རབ་རྒྱས་དང་༎ རྣམ་པར་རྟོག་དང་རྣལ་འདུག་དང་༎ ཕུལ་དུ་བྱུང་བའི་དམིགས་པར་འདོད་༎
 ity etat | dvādaśavidham ālambanaṃ |	དམིགས་པ་ནི་རྣམ་པ་བཅུ་གཉིས་པོ་འདི་དང་སྟེ་།
 yad uta dharmaprajñaptivyavasthānālambanaṃ dharmadhātvālambanaṃ sādhyālambanaṃ sādhanālambanaṃ | dhāraṇālambanaṃ avadhāraṇālambanaṃ | pradhāraṇālambanaṃ | prativedhālambanaṃ | pratānatālambanaṃ | pragamālambanaṃ | praśaṭhatvālambanaṃ prakarṣālambanaṃ ca |	འདི་ལྟར་ཆོས་བརྟགས་པ་རྣམ་པར་གཞག་པའི་དམིགས་པ་དང་། ཆོས་ཀྱི་དབྱིངས་ཀྱི་དམིགས་པ་དང་། བསྒྲུབ་བྱའི་དམིགས་པ་དང་། སྒྲུབ་པའི་དམིགས་པ་དང་། འཛིན་པའི་དམིགས་པ་དང་། ངེས་པར་འཛིན་པའི་དམིགས་པ་དང་། རབ་ཏུ་འཛིན་པའི་དམིགས་པ་དང་། རབ་ཏུ་རྟོགས་པའི་དམིགས་པ་དང་། རབ་ཏུ་རྒྱས་པའི་དམིགས་པ་དང་། རྣམ་པར་ཁོང་དུ་ཆུད་པའི་དམིགས་པ་དང་། རྣལ་དུ་འདུག་པའི་དམིགས་པ་དང་། ཕུལ་དུ་བྱུང་བའི་དམིགས་པའོ་༎
 tatra prathamaṃ ye pāramitādayo dharmā vyavasthāpyante |	དེ་ལ་དང་པོ་ནི་ཕ་རོལ་ཏུ་ཕྱིན་པ་ལ་སོགས་པའི་ཆོས་གང་དག་རྣམ་པར་འཇོག་པའོ་༎ གཉིས་པ་ནི་དེ་བཞིན་ཉིད་དོ་༎
 dvitīyan tathatā tṛtīyacaturthe te eva yathākramaṃ dharmadhātuprativedhena pāramitādidharmādhigamāt |	གང་གསུམ་པ་དང་བཞི་པ་དེ་དག་ཉིད་ལ་གོ་རིམས་བཞིན་ཏེ་། ཆོས་ཀྱི་དབྱིངས་རབ་ཏུ་རྟོགས་པས་ཕ་རོལ་ཏུ་ཕྱིན་པ་ལ་སོགས་པའི་ཆོས་རྣམས་ཁོང་དུ་ཆུད་པའི་ཕྱིར་རོ་༎ 
 pañcamaṃ śrutamayajñānālambanaṃ |	ལྔ་པ་ནི་ཐོས་པ་ལས་བྱུང་བའི་ཤེས་པའི་དམིགས་པའོ་༎
 ṣaṣṭhaṃ | cintāmayasyāvagamya dhāraṇāt |	དྲུག་པ་ནི་བསམས་པ་ལས་བྱུང་བའི་སྟེ་རྟོགས་ནས་འཛིན་པའི་ཕྱིར་རོ་༎
 saptamaṃ bhāvanāmayasya pratyātmaṃ dhāraṇāt |	བདུན་པ་ནི་བསྒོམས་པ་ལས་བྱུང་བའི་སྟེ་། སོ་སོ་རང་གིས་འཛིན་པའི་ཕྱིར་རོ་༎
 aṣṭamaṃ prathamāyāṃ bhūmau darśanamārgasya |	བརྒྱད་པ་ནི་ས་དང་པོ་ལ་མཐོང་བའི་ལམ་གྱིའོ་༎
 navamaṃ bhāvanāmārgasya yāvat saptamyāṃ bhūmau |	དགུ་བ་ནི་བསྒོམ་པའི་ལམ་གྱི་སྟེ་། ས་བདུན་པའི་བར་དུའོ་༎
 daśamaṃ tatraiva laukikalokottarasya mārgasya |	བཅུ་པ་ནི་དེ་ཉིད་ལ་འཇིག་རྟེན་པ་དང་འཇིག་རྟེན་ལས་འདས་པའི་ལམ་གྱི་སྟེ་།
 prakāraśo dharmādhigamāt |	ཆོས་རྣམ་པར་ཁོང་དུ་ཆུད་པའི་ཕྱིར་རོ་༎
 ekādaśam aṣṭamyāṃ bhūmau dvādaśaṃ navamyādibhūmitraye tad eva hi prathamadvayaṃ |	བཅུ་གཅིག་པ་ནི་ས་བརྒྱད་པ་ལའོ་༎ བཅུ་གཉིས་པ་ནི་ས་དགུ་པ་ལ་སོགས་པ་གསུམ་ལའོ་༎
 tasyān tasyām avasthāyāṃ tattadālambanaṃ nāma labhate | uktam ālambanaṃ || [4| samudāgamānuttarya]	དང་པོའི་གཉིས་པོ་དེ་དག་ནི་དེ་དང་དེའི་དུས་ན་དེ་དང་དེའི་དམིགས་པའི་མིང་འཐོབ་པོ་༎ དམིགས་པ་བཤད་ཟིན་ཏོ་༎
 samudāgamaḥ katamaḥ |	ཡང་དག་པར་འགྲུབ་པ་གང་ཞེ་ན་།
 avaikalyāpratikṣepo 'vikṣepaś ca prapūraṇā | samutpādo nirūḍhiś ca karmaṇyatvāpratiṣṭhitā |	མ་ཚང་མེད་དང་མི་སྤོང་དང་༎ མི་༄༢༦བ་ག-ཡེང་བ་དང་རབ་རྫོགས་པ་དང་༎ ཡང་དག་སྐྱེད་དང་འཕེལ་བ་དང་༎ ལས་སུ་རུང་དང་མི་གནས་དང་༎ སྒྲིབ་པ་མེད་པ་ཉིད་དང་དེ་༎
 nirāvaraṇatā tasyāprasrabdhisamudāgamaḥ || v|29	རྒྱུན་མི་གཅོད་པ་ཡང་དག་འགྲུབ་༎
 ity eṣa daśavidhaḥ samudāgamaḥ |	ཡང་དག་པར་འགྲུབ་པ་ནི་རྣམ་པ་བཅུ་པོ་འདི་དག་སྟེ་།
 tatra pratyayāvaikalyaṃ | gotrasamudāgamaḥ |	དེ་ལ་རྐྱེན་མཚང་བ་མེད་པ་ནི་རིགས་ཡང་དག་པར་འགྲུབ་པའོ་༎
 (mvbh 75) mahāyānāpratikṣepo 'dhimuktisamudāgamaḥ |	ཐེག་པ་ཆེན་པོ་མི་སྤང་བ་ནི་མོས་པ་ཡང་དག་པར་འགྲུབ་པའོ་༎
 hīnayānāvikṣepaś cittotpādasamudāgamaḥ |	ཐེག་པ་དམན་པར་མི་ག-ཡེང་བ་ནི་སེམས་བསྐྱེད་པ་ཡང་དག་པར་འགྲུབ་པའོ་༎
 pāramitāparipūraṇā pratipattisamudāgamaḥ |	ཕ་རོལ་ཏུ་ཕྱིན་པ་ཡོངས་སུ་རྫོགས་པ་ནི་བསྒྲུབ་པ་ཡང་དག་པར་འགྲུབ་པའོ་༎
 āryamārgotpādo niyāmāvakrāntisamudāgamaḥ |	འཕགས་པའི་ལམ་བསྐྱེད་པ་ནི་སྐྱོན་མེད་པར་འཇུག་པ་ཡང་དག་པར་འགྲུབ་པའོ་༎
 kuśalamūlanirūḍhiḥ dīrghakālaparicayāt satvaparipākasamudāgamaḥ [|	དགེ་བའི་རྩ་བ་འཕེལ་བ་ནི་ཡུན་རིང་པོ་ནས་འདྲིས་པར་བྱ་བའི་ཕྱིར་སེམས་ཅན་ཡོངས་སུ་སྨིན་པར་བྱེད་པ་ཡང་དག་པར་འགྲུབ་པའོ་༎
 ] cittakarmaṇyatvaṃ kṣetrapariśuddhisamudāgamaḥ |	སེམས་ལས་སུ་རུང་བ་ནི་ཞིང་ཡོངས་སུ་དག་པ་ཡང་དག་པར་འགྲུབ་པའོ་༎
 saṃsāranirvāṇāpratiṣṭhatā avinivartanīyabhūmivyākaraṇalābhasamudāgamaḥ saṃsāranirvāṇābhyām avinivartanāt |	འཁོར་བ་དང་མྱ་ངན་ལས་འདས་པ་ལ་མི་གནས་པ་ནི་ཕྱིར་མི་ལྡོག་པའི་ས་ལ་ལུང་བསྟན་པ་འཐོབ་པ་ཡང་དག་པར་འགྲུབ་པ་སྟེ་། འཁོར་བ་དང་མྱ་ངན་ལས་འདས་པ་གཉིས་ལས་མི་ལྡོག་པའི་ཕྱིར་རོ་༎
 nirāvaraṇatā buddhabhūmisamudāgamaḥ |	སྒྲིབ་པ་མེད་པ་ནི་སངས་རྒྱས་ཀྱི་ས་ཡང་དག་པར་འགྲུབ་པའོ་༎
 tadaprasrabdhir bodhisaṃdarśanasamudāgamaḥ [||] [śāstranāmavyākhyāna]	དེ་རྒྱུན་མི་གཅོད་པ་ནི་བྱང་ཆུབ་ཀུན་དུ་སྟོན་པ་ཡང་དག་པར་འགྲུབ་པའོ་༎
 ity etac	དེ་ལྟར་ན་འདི་ནི་།
 chāstraṃ madhyavibhāgaṃ hi	དབུས་རྣམ་འབྱེད་པའི་བསྟན་བཅོས་ཏེ་༎
 madhyamāpratipatprakāśanāt madhyāntavibhāgam apy etan madhyasyāntayoś ca prakāśanāt |	དབུ་མའི་ལམ་རབ་ཏུ་སྟོན་པའི་ཕྱིར་རོ་༎ འདི་ནི་དབུས་དང་མཐའ་རྣམ་པར་འབྱེད་པ་ཡང་ཡིན་ཏེ་། དབུས་དང་མཐར་གཉིས་རབ་ཏུ་སྟོན་པའི་ཕྱིར་རོ་༎
 ādyaparavarjitasya madhyasya vā |	ཡང་ན་ཐོག་མ་དང་མཐའ་མ་སྤངས་པའི་དབུས་རབ་ཏུ་སྟོན་པའི་ཕྱིར་རོ་༎
 gūḍhasārārtham eva ca |	རྟོག་པར་དཀའ་དང་སྙིང་པོའི་དོན་༎
 tarkasyāgocaratvāt paravādibhir abhedyatvāc ca yathākramaṃ |	རྟོག་ཀེའི་སྤྱོད་ཡུལ་མ་ཡིན་པ་དང་། ཕས་ཀྱི་རྒོལ་བ་དག་གིས་མི་ཤིགས་པའི་ཕྱིར་ཏེ་གོ་རིམས་བཞིན་ནོ་༎
 mahārthaṃ caiva | svaparādhikārāt |	དོན་ཆེན་ནི་བདག་དང་གཞན་གྱི་དོན་གྱི་ཆེད་ཀྱི་ཕྱིར་རོ་༎
 sarvārthaṃ | yānatrayādhikārāt |	དེ་བཞིན་ཀུན་གྱི་དོན་ནི་ཐེག་པ་གསུམ་ཆར་གྱི་དབང་དུ་བྱས་པའི་ཕྱིར་རོ་༎
 sarvānarthapraṇodanaṃ || v|30 (mvbh 76) kleśajñeyāvaraṇaprahāṇāvāhanāt | [yānānuttaryapiṇḍārtha]	དོན་མེད་ཐམས་ཅད་སེལ་བའོ་ཞེས་བྱ་བ་ནི་ཉོན་མོངས་པ་དང་ཤེས་བྱའི་སྒྲིབ་པ་སྤོང་བར་བྱེད་པའོ་༎ 
 ānuttaryasya piṇḍārthaḥ | samāsatas trividham ānuttaryaṃ pratipattiḥ (|	བླ་ན་མེད་པ་ཉིད་ཀྱི་དོན་བསྡུས་པ་ནི་མདོར་བསྡུ་ན་བླ་ན་མེད་པ་ཉིད་རྣམ་གསུམ་སྟེ་།
 ) pratipattyādhāraḥ pratipattiphalaṃ caiva |	སྒྲུབ་པ་དང་། བསྒྲུབ་པའི་གཞི་དང་། བསྒྲུབ་པའི་འབྲས་བུའོ་༎
 sā ca pratipattir yādṛśī paramā | yena ca	བསྒྲུབ་པ་དེ་ཡང་ཇི་ལྟ་བུ་ཞེ་ན་། དམ་པའོ་༎ གང་གིས་ཤེ་ན་། ཐེག་པ་ཆེན་པོར་ཇི་ལྟ་བུར་༎
 yathāprajñaptito dharmamahāyānamanaskriyā (v| 7ab)	༄༢༧ཨ་༌་༎ ཆོས་རྣམས་རབ་ཏུ་བཞག་པ་དག་། 
 ity evamādinā |	ཅེས་བྱ་བ་ལ་སོགས་པས་སོ་༎ ཇི་ལྟ་བུར་ཞེ་ན་།
 yathā yena prakāreṇāvikṣepapariṇatā ca śamathabhāvanayā aviparyāsapariṇatā ca vipaśyanābhāvanayā|	རྣམ་པ་གང་གིས་ཞི་གནས་བསྒོམ་པ་ལ་ག-ཡེང་བ་མེད་པར་གྱུར་པ་དང་། ལྷག་མཐོང་བསྒོམ་པ་ལ་ཕྱིན་ཅི་མ་ལོག་པར་གྱུར་བའོ་༎
 yadarthaṃ ca madhyamayā pratipadā niryāṇārthaṃ | yatra ca	གང་གི་དོན་དུ་ཞེ་ན་། དབུ་མའི་ལམ་གྱིས་ངེས་པར་འབྱུང་བར་བྱ་བའི་དོན་དུའོ་༎ གང་དུ་ཞེ་ན་།
 daśasu bhūmiṣu (v| 27b) |	ས་བཅུ་དག་ཏུ་སྟེ་།
 viśiṣṭā cāviśiṣṭā ca (v| 27a) |	ཁྱད་པར་ཅན་དང་། ཁྱད་པར་མེད་པའོ་ཞེས་བྱ་བའོ་།
 aviparyāsānāṃ piṇḍārthaḥ | vyañjanāviparyāsena śamathanimittaṃ pratividhyati | arthāviparyāsena vipaśyanānimittaṃ pratividhyati | manaskārāviparyāsena viparyāsanidānaṃ parivarjayati |	ཕྱིན་ཅི་མ་ལོག་པ་རྣམས་ཀྱི་དོན་བསླུས་པ་ནི་།
 avisārāviparyāsena tannimittaṃ sugṛhītaṃ karoti | svalakṣaṇāviparyāsena tatpratipakṣeṇāvikalpaṃ mārgaṃ bhāvayati | sāmānyalakṣaṇāviparyāsena vyavadānaprakṛtiṃ pratividhyati |	ཡི་གེ་ལ་ཕྱིན་ཅི་མ་ལོག་པས་ཞི་གནས་ཀྱི་མཚན་མ་རབ་ཏུ་རྟོགས་པ་དང་། དོན་ལ་ཕྱིན་ཅི་མ་ལོག་པས་ལྷག་མཐོང་གི་མཚན་མ་རབ་ཏུ་རྟོགས་པ་དང་། ཡིད་ལ་བྱེད་པ་ཕྱིན་ཅི་མ་ལོག་པས་ཕྱིན་ཅི་ལོག་གི་གཞི་ཡོངས་སུ་སྤོང་བ་དང་། མི་འཕྲོ་བ་ལ་ཕྱིན་ཅི་མ་ལོག་པས་དེའི་མཚན་མ་ལེགས་པར་རྟོགས་པར་བྱེད་པ་དང་། རང་གི་མཚན་ཉིད་ཕྱིན་ཅི་མ་ལོག་པས་དེའི་གཉེན་པོ་རྣམ་པར་མི་རྟོག་པའི་ལམ་བསྒོམས་པ་དང་༏་སྤྱིའི་མཚན་ཉིད་ལ་ཕྱིན་ཅི་མ་ལོག་པས་རྣམ་པར་བྱང་བའི་རང་བཞིན་དུ་རབ་ཏུ་དང་༏་རྟོགས་པ་དང་། 
 aśuddhiśuddhimanaskārāviparyāsena tadāvaraṇaprahīṇāprahīṇatāṃ prajānāti | tadāgantukatvāviparyāsena saṃkleśavyavadānaṃ yathābhūtaṃ prajānāti | atrāsānunnatyaviparyāsena nirāvaraṇe niryāti |	མ་དག་པ་དང་དག་པ་ཡིད་ལ་བྱེད་པ་ལ་ཕྱིན་ཅི་མ་ལོག་པས་དེའི་སྒྲིབ་པ་མ་སྤངས་པ་དང་། སྤངས་པ་རབ་ཏུ་ཤེས་པ་དང་། དེའི་གློ་བུར་དུ་བྱུང་བ་ལ་ཕྱིན་ཅི་མ་ལོག་པས་ཀུན་ནས་ཉོན་མོངས་པ་དང་རྣམ་པར་བྱང་བ་ཡང་དག་པ་ཇི་ལྟ་བ་བཞིན་དུ་རབ་ཏུ་ཤེས་པ་དང་། མི་སྐྲག་པ་དང་། ཁེངས་པ་མེད་པ་ལ་བྱིན་ཅི་མ་ལོག་པས་སྒྲིབ་པ་མེད་པར་ངེས་པར་འབྱུང་བའོ་༎ བཤད་པའི་འདི་བྱས་པ་ཡི་བསོད་ནམས་གང་ཡོད་དེས་༎ འགྲོ་བ་བསོད་ནམས་འབྱུང་བ་ཆེ་དང་ཡེ་ཤེས་ཀྱང་༏་།འབྱུང་བར་གྱུར་ཅིག་དེ་ལས་མངོན་མཐོ་ཆེན་པོ་དང་༎ བྱང་ཆུབ་གསུམ་ཡང་འགྲོ་བས་མྱུར་དུ་ཐོབ་གྱུར་ཅིག་། 
 ānuttaryaparicchedaḥ pañcamaḥ || (mvbh 77) || samāpto madhyāntavibhāgaḥ || || vyākhyām imām upanibadhya yad asti puṇyaṃ puṇyodayāya mahato jagatas tad astu | jñānodayāya ca yato 'bhyudayaṃ mahāntaṃ bodhitrayaṃ ca na cirāj jagad aśnuvīta ||	བསྟན་བཅོས་དབུས་དང་མཐའ་རྣམ་པར་འབྱེད་པ་ལས་ཐེག་པ་བླ་ན་མེད་པ་ཞེས་བྱ་བའི་ཚིག་ལེའུར་བཅད་པ་ལྔ་བའི་འགྲེལ་བའོ་།
 iti || madhyāntavibhāgakārikābhāṣyaṃ samāptam ||	༎ ། བསྟན་བཅོས་དབུས་དང་མཐའ་རྣམ་པར་འབྱེད་པའི་འགྲེལ་པ་སློབ་དཔོན་དབྱིག་གཉེན་གྱིས་མཛད་པ་རྫོགས་སོ་། 
