skt	tib
 māhāyāne traidhātukaṃ vijñaptimātraṃ vyavasthāpyate |	ཐེག་པ་ཆེན་པོ་ལ་ཁམས་གསུམ་པ་རྣམ་པར་རིག་པ་ཙམ་དུ་རྣམ་པར་གཞག་སྟེ་།
 cittamātraṃ bho jinaputrā yad uta traidhātukam iti sūtrāt |	མདོ་ལས་ཀྱེ་རྒྱལ་བའི་སྲས་དག་འདི་ལྟ་སྟེ་། ཁམས་གསུམ་པ་འདི་ནི་སེམས་ཙམ་མོ་ཞེས་འབྱུང་བའི་ཕྱིར་རོ་༎
 cittaṃ mano vijñānaṃ vijñaptiś ceti paryāyāḥ |	སེམས་དང་ཡིད་དང་། རྣམ་པར་ཤེས་པ་དང་། རྣམ་པར་རིག་པ་ཞེས་བྱ་བ་ནི་རྣམ་གྲངས་སུ་གཏོགས་པའོ་༎
 cittam atra sasaṃprayogam abhipretaṃ |	སེམས་དེ་ཡང་འདིར་མཚུངས་པར་ལྡན་པ་དང་བཅས་པར་དགོངས་པའོ་༎
 matram ity arthapratiṣedhārthaṃ |	ཙམ་ཞེས་བྱ་བ་སྨོས་པ་ནི་དོན་དགག་པའི་ཕྱིར་རོ་༎
 vijñaptimātram evedam asadarthāvabhāsanāt |	རྣམ་པར་ཤེས་པ་འདི་ཉིད་དོན་དུ་སྣང་བ་འབྱུང་སྟེ་།
 yadvat taimirikasyāsat keśoṇḍukādidarśanaṃ || 1 || atra codyate |	དཔེར་ན་རབ་རིབ་ཅན་རྣམས་ཀྱིས་སྐྲ་ཟླ་ལ་སོགས་པ་མེད་པར་མཐོང་བ་བཞིན་ཏེ་།
 kaścid artho nāsti |	དོན་གང་ཡང་མེད་དོ་༎ འདིར་འདི་སྐད་ཅེས་བརྒལ་ཏེ་། གལ་ཏེ་རྣམ་རིག་དོན་མིན་ན་༎
 na deśakālaniyamaḥ saṃtānāniyamo na ca |	ཡུལ་དང་དུས་ལ་ངེས་མེད་ཅིང་༎ སེམས་ཀྱང་དེས་མེད་མ་ཡིན་ལ་༎
 na ca kṛtyakriyā yuktā vijñaptir yadi nārthataḥ || 2 ||	བྱ་བ་བྱེད་བའང་མི་རིགས་འགྱུར་༎
 kim uktaṃ bhavati |	ཇི་སྐད་དུ་བསྟན་པར་འགྱུར་ཞེ་ན་།
 yadi vinā rūpādyarthena rūpādivijñaptir utpadyate na rūpādyarthāt |	གལ་ཏེ་གཟུགས་ལ་སོགས་པའི་དོན་མེད་པར་གཟུགས་ལ་སོགས་པའི་རྣམ་པར་རིག་པ་འབྱུང་སྟེ་གཟུགས་ལ་སོགས་པའི་དོན་ལས་མ་ཡིན་ན་།
 kasmāt kvacid deśa utpadyate na sarvatra |	ཅིའི་ཕྱིར་ཡུལ་ལ་ལར་འབྱུང་ལ་ཐམས་ཅད་ན་མ་ཡིན་།
 tatraiva ca deśe kadācid utpadyate na sarvadā |	ཡུལ་དེ་ཉིད་ན་ཡང་རེས་འགའ་འབྱུང་ལ་ཐམས་ཅད་དུ་མ་ཡིན་།
 taddeśakālapratiṣṭhitānāṃ sarveṣāṃ saṃtānāniyama utpadyate na kevalam ekasya |	ཡུལ་དང་དུས་དེ་ན་འཁོད་པ་ཐམས་ཅད་ཀྱི་སེམས་ལ་ངེས་པ་མེད་པ་འབྱུང་ལ་འགའ་ཙམ་ལ་མ་ཡིན་། 
 yathā taimirikāṇāṃ saṃtāne keśādyābhāso nānyeṣāṃ |	དེ་ལྟར་རབ་རི་བ་ཅན་ཉིད་ཀྱི་སེམས་ལ་སྐྲ་ལ་སོགས་པ་སྣང་གི་ལ་མ་ཡིན་། 
 kasmād yat taimirikaiḥ keśabhramarādi dṛśyate tena keśādikriyā na kriyate na ca tad anyair na kriyate |	། ༄༤བ་གཞན་དག་ལ་ནི་མ་ཡིན་༎ ཅིའི་ཕྱིར་གང་རབ་རིབ་ཅན་གྱིས་མཐོང་བའི་སྐྲ་དང་། སྦྲང་བུ་ལ་སོགས་པས་སྐྲ་ལ་སོག་པའི་བྱ་བ་མི་བྱེད་ལ་།
 yad annapānavastraviṣāyudhādi svapne dṛśyate tenānnādikriyā na kriyate na ca tad anyair na kriyate |	དེ་མ་ཡིན་པ་གཞན་དག་གིས་ནི་བྱེད་། རྨི་ལམ་ན་མཐོང་བའི་བཟའ་བ་དང་བཏུང་བ་དང་བགོ་བ་དང་དུག་དང་མཚོན་ལ་སོགས་པས་ཟས་དང་སྐོམ་ལ་སོགས་པའི་བྱ་བ་མི་བྱེད་ལ་། དེ་མ་ཡིན་པ་གཞན་དག་གིས་ནི་བྱེད་།
 gandharvanagareṇāsattvān nagarakriyā na kriyate na ca tad anyair na kriyate |	དྲི་ཟའི་གྲོང་ཁྱེར་ཡོད་པ་མ་ཡིན་པས་གྲོང་ཁྱེར་གྱི་བྱ་བ་མི་བྱེད་ལ་། དེ་མ་ཡིན་པ་གཞན་དག་གིས་ནི་བྱེད་།
 tasmād asadabhāvāvabhāsane deśakālaniyamaḥ saṃtānāniyamaḥ kṛtyakriyā ca na yujyate |	འདི་དག་དོན་མེད་པར་མེད་དུ་འདྲ་ན་ཡུལ་དང་དུས་ངེས་པ་དང་། སེམས་ངེས་པ་མེད་པ་དང་། བྱ་བ་བྱེད་པ་འདི་དག་ཀྱང་མི་རུང་ངོ་ཞེ་ན་།
 na khalu na yujyate | yasmāt |	མི་རུང་བ་མ་ཡིན་ཏེ་། འདི་ལྟར་།
 deśādiniyamaḥ siddhaḥ svapnavat	ཡུལ་ལ་སོགས་པ་ངེས་འགྲུབ་སྟེ་༎ རྨི་འདྲའོ་༎
 svapna iva svapnavat |	རྨི་ལམ་དུ་རྨིས་པ་དང་མཚུངས་པས་ན་རྨི་འདྲའོ་༎
 kathaṃ tāvat |	ཇི་ལྟ་ཞེ་ན་།
 svapne vināpy arthena kvacid eva deśe kiṃcid bhramarārāmastrīpurūṣādikaṃ dṛśyate na sarvatra | tatraiva ca deśe kadācid dṛśyate na sarvakālam iti siddho vināpy arthena deśakālaniyamaḥ |	རྨི་ལམ་ན་ཡང་དོན་མེད་པར་ཡུལ་ལ་ན་གྲོང་དང་། ཀུན་དགའ་ར་བ་དང་། སྐྱེས་པ་དང་བུད་མེད་ལ་སོགས་པ་ཇི་དག་སྣང་ལ་ཐམས་ཅད་ན་མ་ཡིན་ཡུལ་དེ་ཉིད་ན་ཡང་རེས་འགའ་སྣང་ལ་དུས་ཐམས་ཅད་དུ་མ་ཡིན་པས་དོན་མེད་པར་ཡང་ཡུལ་ལ་སོགས་པ་ངེས་པར་འགྲུབ་པོ་༎ སེམས་ཀྱང་ངེས་པ་མེད་།
 pretavat punaḥ | saṃtānāniyamaḥ	ཡི་དགས་བཞིན་ཏེ་།
 siddha iti vartate |	གྲུབ་ཅེས་བྱ་བར་བསྙེགས་སོ་༎
 pretānām iva pretavat |	ཡི་དགས་རྣམས་ཀྱི་དང་མཚུངས་པས་ན་ཡི་དགས་བཞིན་ནོ་༎
 kathaṃ siddhaḥ samaṃ |	ཇི་ལྟར་འགྲུབ་། ཐམས་ཅད་ཀྱིས་།
 sarvaiḥ pūyanadyādidarśane || 3 ||	ཀླུང་ལ་རང་ལ་སོགས་མཐོང་བཞིན་༎
 pūyapūrṇā nadī pūyanadī |	རང་གིས་གང་བའི་ཀླུང་ནི་རང་གི་ལུང་སྟེ་༎
 ghṛtaghaṭavat |	མར་གྱི་བུམ་པ་བཞིན་ནོ་༎
 tulyakarmavipākāvasthā hi pretāḥ sarve 'pi pūyapūrṇāṃ nadīṃ paśyanti naika eva |	ལས་ཀྱི་རྣམ་པར་སྨིན་པ་མཚུངས་པ་ལ་གནས་པའི་ཡི་དགས་རྣམས་ནི་ཀུན་གྱིས་ཀྱང་མཚུངས་པར་ཀླུང་རང་གིས་གང་བར་མཐོང་སྟེ་། གཅིག་འགས་ནི་མ་ཡིན་ནོ་༎
 yathā pūyapūrṇām evaṃ mūtrapurīṣādipūrṇāṃ daṇḍāsidharaiś ca puruṣair adhiṣṭhitām ity ādigrahaṇena |	རྣག་གིས་གང་བ་ཇི་ལྟ་བ་བཞིན་དུ་གཅིན་དང་། ངན་སྐྱུགས་དང་། མེ་མ་མུར་དང་། མཆིལ་མ་དང་། སྣབས་ཀྱིས་གང་བ་དང་། དབྱིག་པ་དང་། རལ་གྲི་ཐོགས་པའི་མི་དག་གིས་སྲུང་བ་ཡང་དེ་བཞིན་ཏེ་། སོགས་པ་ཞེས་བྱ་བར་བསྡུའོ་༎
 evaṃ saṃtānāniyamo vijñaptinām asaty apy arthe siddhaḥ || svapnopaghātavat kṛtyakriyā	དེ་ལྟར་ན་དོན་མེད་པར་ཡང་རྣམ་པར་རིག་པ་རྣམས་ཀྱི་སེམས་ངེས་པ་མེད་པར་འགྲུབ་པོ་༎ བྱ་བྱེད་རྨི་ལམ་གནོད་པ་འདྲ་༎
 siddha iti veditavyaṃ |	གྲུབ་ཅེས་བྱ་བར་རིག་པར་བྱའོ་། དཔེར་ན་རྨི་ལམ་ན་གཉིས་ཀྱིས་གཉིས་ཕྲད་པ་༄༥ཨ་༌་༎
 yathā svapne dvayasamāpattim antareṇa śukravisargalakṣaṇaḥ svapnopaghātaḥ |	མེད་པར་ཡང་ཁུ་བ་འབྱུང་བའི་མཚན་ཉིད་ནི་རྨི་ལམ་གྱི་གནོད་པའོ་༎
 evaṃ tāvad anyānyair dṛṣṭāntair deśakālaniyamādicatuṣṭayaṃ siddhaṃ | narakavat punaḥ | sarvaṃ	དེ་ལྟར་རེ་ཞིག་དཔེ་གཞན་དང་གཞན་དག་གིས་ཡུལ་དང་དུས་ངེས་པ་ལ་སོགས་པ་བཞིན་འགྲུབ་བོ་༎ ཐམས་ཅད་སེམས་ཅན་དམྱལ་བ་བཞིན་༎
 siddham iti veditavyaṃ |	གྲུབ་ཅེས་བྱ་བར་རིག་པར་བྱའོ་༎
 narakeṣv iva narakavat |	སེམས་ཅན་དམྱལ་བ་དག་ན་ཡོད་པ་དང་མཚུངས་པས་སེམས་ཅན་དམྱལ་བ་བཞིན་ནོ་༎
 kathaṃ siddhaṃ |	ཇི་ལྟར་འགྲུབ་ཅེ་ན་།
 narakapālādidarśane taiś ca bādhane || 4 ||	དམྱལ་བའི་སྲུང་མ་སོགས་མཐོང་དང་༎ དེ་དག་གིས་ནི་གནོད་ཕྱིར་རོ་༎
 yathā hi narakeṣu nārakāṇāṃ narakapālādidarśanaṃ deśakālaniyamena siddhaṃ |	དཔེར་ན་སེམས་ཅན་དམྱལ་བ་དག་ན་སེམས་ཅན་དམྱལ་བའི་སེམས་ཅན་རྣམས་ཀྱིས་སེམས་ཅན་དམྱལ་བའི་སྲུང་མ་ལ་སོགས་པ་མཐོང་སྟེ་། ཡུལ་དང་དུས་ངེས་པར་འགྲུབ་པོ་༎
 śvavāyasāyasaparvatādyāgamanagamanadarśanaṃ cety ādigrahaṇena |	ཁྱི་དང་བྱ་རོག་དང་ལྕགས་ཀྱི་རི་ལ་སོགས་པ་འོང་བ་དང་འགྲོ་བར་ཡང་མཐོང་བ་ནི་སོགས་པ་ཞེས་བྱ་བར་བསྡུ་སྟེ་། ཐམས་ཅད་ཀྱིས་མཐོང་གི་།
 sarveṣāṃ ca naikasyaiva taiś ca tadbādhanaṃ siddham asatsv api narakapālādiṣu samānasvakarmavipākādhipatyāt |	གཅིག་འགས་ནི་མ་ཡིན་ནོ་༎ དེ་དག་གིས་དེ་དགལ་གནོད་པ་ཡང་འགྲུབ་སྟེ་། དངོས་པོ་ལ་སེམས་ཅན་དམྱལ་བའི་སྲུང་མ་ལ་སོགས་པ་མེད་པར་ཡང་རང་གི་ལས་ཀྱི་རྣམ་པར་སྨིན་པ་མཚུངས་པའི་དབང་ཕྱིར་རོ་༎
 tathānyatrāpi sarvam etad deśakālaniyamādicatuṣtayaṃ siddham iti veditavyaṃ ||	དེ་བཞིན་དུ་གཞན་ཡང་ཡུལ་དང་དུས་ངེས་པ་ལ་སོགས་པ་བཞི་པོ་འདི་དག་ཐམས་ཅད་གྲུབ་པར་རིག་པར་བྱའོ་༎
 kiṃ punaḥ kāraṇaṃ narakapālās te ca śvāno vāyasāś ca sattvā neṣyante |	ཅིའི་ཕྱིར་སེམས་ཅན་དམྱལ་བའི་སྲུང་མ་དང་བྱ་རོག་དང་ཁྱི་ལ་སོགས་པ་དེ་དག་སེམས་ཅན་དུ་མི་འདོད་ཅེ་ན་།
 ayogāt |	མི་རིགས་པའི་ཕྱིར་རོ་༎
 na hi te nārakā yujyante |	དེ་དག་ནི་སེམས་ཅན་དམྱལ་བར་མི་རིགས་ཏེ་།
 tathaiva tadduḥkhāpratisaṃvedanāt |	དེ་བཞིན་དུ་སྡུག་བསྔལ་དེས་མི་མྱོང་བའི་ཕྱིར་རོ་༎ གཅིག་ལ་གཅིག་གནོད་པ་བྱེད་ན་ནི་འདི་དག་ནི་སེམས་ཅན་དམྱལ་བ་བདག་གོ་༎
 parasparaṃ yātayatām ime nārakā ime narakapālā iti vyavasthā na syāt | tulyākṛtipramāṇabalānāṃ ca parasparaṃ yātayatāṃ na tathā bhayaṃ syāt |	འདི་དག་ནི་སེམས་ཅན་དམྱལ་བའི་སྲུང་མ་དག་གོ་ཞེས་རྣམ་པར་གཞག་པ་མེད་པར་འགྱུར་རོ་། བྱད་གཟུགས་དང་བོང་ཚོད་དང་སྟོབས་མཚུངས་པ་དག་ནི་གཅིག་ལ་གཅིག་གནོད་པ་བྱེད་ཀྱང་ཇི་ལྟ་བུར་འཇིགས་པར་མི་འགྱུར་རོ་༎
 dāhaduḥkhaṃ ca pradīptāyām ayomayyāṃ bhūmāv asahamānāḥ kathaṃ tatra parān yātayeyuḥ |	ལྕགས་རབ་ཏུ་འབར་བའི་ས་གཞི་ལ་ཚ་བའི་སྡུག་བསྔལ་ཡང་མི་བཟོད་ན་ནི་ཇི་ལྟར་དེ་ན་གཞན་ལ་གནོད་པ་བྱེད་པར་འགྱུར་།
 anārakāṇāṃ vā narake kutaḥ saṃbhavaḥ |	སེམས་ཅན་དམྱལ་བ་པ་མ་ཡིན་པ་དག་སེམས་ཅན་དམྱལ་བར་འབྱུང་བར་ག་ལ་འགྱུར་།
 kathaṃ tāvat tiraścāṃ svargasaṃbhavaḥ |	འོ་ན་དུད་འགྲོ་དག་ཀྱང་ཇི་ལྟར་མཐོ་རིས་སུ་འབྱུང་སྟེ་།
 evaṃ narakeṣu tiryakpretaviśeṣāṇāṃ narakapālādīnāṃ saṃbhavaḥ syāt |	དེ་བཞིན་དུ་སེམས་ཅན་དམྱལ་བར་ཡང་དུད་འགྲོ་དང་ཡི་༄༥བ་དགས་ཀྱི་བྱེ་བྲག་སེམས་ཅན་དམྱལ་བའི་སྲུང་མ་ལ་སོགས་པ་འབྱུང་བར་འགྱུར་རོ་ཞེ་ན་། ཇི་ལྟར་དུད་འགྲོ་མཐོ་རིས་སུ་༎
 tiraścāṃ saṃbhavaḥ svarge yathā na narake tathā |	འབྱུང་བ་དེ་ལྟར་དམྱལ་བ་མིན་༎ ཡི་དགས་མིན་ཏེ་དེ་ལྟ་བུར་༎
 na pretānāṃ yatas tajjaṃ duḥkhaṃ nānubhavanti te || 5 ||	དེ་ཡོད་སྡུག་བསྔལ་དེས་མི་མྱོང་༎
 ye hi tiryañcaḥ svarge saṃbhavanti te tadbhājanalokasukhasaṃvartanīyena karmaṇā tatra saṃbhūtās tajjaṃ sukhaṃ pratyanubhavanti |	དུད་འགྲོ་གང་དག་མཐོ་རིས་སུ་འབྱུང་བ་དེ་དག་ནི་སྣོད་ཀྱི་འཇིག་རྟེན་ན་དེའི་བདེ་བ་མྱོང་བར་འགྱུར་བའི་ལས་ཀྱིས་དེར་འབྱུང་བ་དག་སྟེ་། དེ་ན་ཡོད་བའི་བདེ་བ་སོ་སོར་མྱོང་ངོ་༎
 na caiva narakapālādayo nārakaṃ duḥkhaṃ pratyanubhavanti |	སེམས་ཅན་དམྱལ་བའི་སྲུང་མ་ལ་སོགས་པ་དག་ནི་དེ་བཞིན་དུ་སེམས་ཅན་དམྱལ་བའི་སྡུག་བསྔལ་མི་མྱོང་ངོ་༎ 
 tasmān na tiraścāṃ saṃbhavo yukto nāpi pretānāṃ || teṣāṃ tarhi (vvs_5)	དེའི་ཕྱིར་དུད་འགྲོ་དག་དེར་འབྱུང་བར་མི་རིགས་སོ་༎
 nārakāṇāṃ karmabhis tatra bhūtaviśeṣāḥ saṃbhavanti varṇākṛtipramāṇabalaviśiṣṭā ye narakapālādisaṃjñāṃ pratilabhante | tathā ca pariṇamanti |	ཡི་དགས་ཀྱི་བྱེ་བྲག་དག་ཀྱང་མ་ཡིན་ནོ་༎ སེམས་ཅན་དམྱལ་བ་དེ་དག་གི་ལས་རྣམས་ཀྱིས་དེར་འབྱུང་བའི་བྱེ་བྲག་དག་འདི་ལྟ་བུར་འབྱུང་སྟེ་། མདོག་དང་བྱད་གཟུགས་དང་བོང་ཚོད་དང་སྟོབས་ཀྱི་བྱེ་བྲག་གང་གིས་སེམས་ཅན་དམྱལ་བའི་སྲུང་མ་ལ་སོགས་པའི་མིང་ཐོབ་པའོ་༎
 yad dvidhāṃ hastavikṣepādikriyāṃ kurvanto dṛśyante bhayotpādanārthaṃ |	གང་ལག་པ་བརྐྱང་པ་ལ་སོགས་པ་བྱ་བ་སྣ་ཚོགས་བྱེད་པར་སྣང་བ་དེ་ལྟ་བུར་ཡང་འགྲུབ་སྟེ་། དེ་དག་འཇིགས་པ་བསྐྱེད་པའི་ཕྱིར་རོ་༎
 yathā meṣākṛtayaḥ parvatā āgacchanto gacchanto 'yaḥśālmalīvane ca kaṇṭakā adhomukhībhavanta ūrddhvamukhībhavantaś ceti |	དཔེར་ན་ལུག་ལྟ་བུའི་རི་དགས་འོང་བ་དང་། འགྲོ་བ་དང་། ལྕགས་ཀྱི་ཤལ་ལ་མ་ལིའི་ནགས་ཚལ་ཆོར་མ་ཁ་ཐུར་དུ་ལྟ་བ་དང་གྱེན་དུ་ལྟ་བར་འགྱུར་བ་ལྟ་བུ་སྟེ་།
 na te na saṃbhavanty eva |	དེ་དག་ནི་མེད་པ་ཡང་མ་ཡིན་ནོ་ཞེ་ན་།
 yadi tatkarmabhis tatra bhūtānāṃ saṃbhavas tathā |	གལ་ཏེ་དེའི་ལས་ཀྱིས་དེར་འབྱུང་བ་དག་ནི་བྱུང་བ་དང་། དེ་བཞིན་འགྱུར་བར་འདུག་ན་གོ་༎
 iṣyate pariṇāmaś ca kiṃ vijñānasya neṣyate || 6 ||	རྣམ་པར་ཤེས་པར་ཅིས་མི་འདོད་༎
 vijñānasyaiva tatkarmabhis tathā pariṇāmaḥ kasmān neṣyate kiṃ punar bhūtāni kalpyante || api ca |	དེའི་ལས་རྣམས་ཀྱིས་དེར་རྣམ་པར་ཤེས་པ་ཉིད་དེར་དེ་ལྟ་བུར་འགྱུར་བ་ཅིའི་ཕྱིར་མི་འདོད་ལ་། ཅིའི་ཕྱིར་འབྱུང་བ་རྣམས་སུ་རྟོག་། 
 karmaṇo vāsanānyatra phalam anyatra kalpyate |	གཞན་ན་ལས་ཀྱི་བག་ཆགས་ལ་༎ འབྲས་བུ་དག་ནི་གཞན་དུ་རྟོག་། 
 tatraiva neṣyate yatra vāsanā kiṃ nu kāraṇaṃ || 7 ||	གང་ན་བག་ཆགས་ཡོད་པ་དེར་༎ ཅིའི་ཕྱིར་ན་འདོད་མི་བྱ་༎
 yena hi karmaṇā nārakāṇāṃ tatra tādṛśo bhūtānāṃ saṃbhavaḥ kalpyate pariṇāmaś ca tasya karmaṇo vāsanā teṣāṃ vijñānasaṃtānasaṃniviṣṭā nānyatra	སེམས་ཅན་དམྱལ་བ་པ་རྣམས་ཀྱི་ལས་གང་གིས་དེར་འབྱུང་བ་དག་དེ་ལྟ་བུར་འབྱུང་བ་དང་། འགྱུར་བར་ཡང་རྟོག་པའི་ལས་དེའི་བག་ཆགས་དེ་དག་ཉིད་ཀྱི་རྣམ་པར་ཤེས་པའི་རྒྱུད་ལ་། གནས་ཏེ་། 
 yatraiva ca vāsanā tatraiva tasyāḥ phalaṃ tādṛśo vijñānapariṇāmaḥ kiṃ neṣyate |	གཞན་མ་ཡིན་ན་བག་ཆགས་དེ་གང་ན་ཡོད་པ་དེ་དག་ཉིད་ལ་དེའི་འབྲས་བུ་རྣམ་པར་ཤེས་པར་གྱུར་པ་དེ་འདྲ་བར་ཅིའི་ཕྱིར་མི་འདོད་ལ་།
 yatra vāsanā nāsti tatra tasyāḥ phalaṃ kalpyata iti kim atra kāraṇaṃ ||	གང་ན་བག་ཆགས་མེད་པ་དེར་དེའི་འབྲས་བུ་རྟོག་བ་འདི་ལ་གཏན་ཚིགས་ཅི་ཡོད་། ༄༦ཨ་༌་༎ སྨྲས་པ་།
 āgamaḥ kāraṇaṃ |	ལུང་གི་གཏན་ཚིགས་ཡོད་དེ་།
 yadi vijñānam eva rūpādipratibhāsaṃ syān na rūpādiko 'rthas tadā rūpādyāyatanāstitvaṃ bhagavatā noktaṃ syāt |	གལ་ཏེ་རྣམ་པར་ཤེས་པ་ཉིད་གཟུགས་ལ་སོགས་པར་སྣང་གི་༎ གཟུགས་ལ་སོགས་པའི་དོན་ནི་མེད་ན་གཟུགས་ལ་སོགས་པའི་སྐྱེ་མཆེད་ཡོད་པར་ནི་བཅོམ་ལྡན་འདས་ཀྱིས་གསུང་བར་མི་འགྱུར་རོ་ཞེ་ན་། འདི་ནི་གཏན་ཚིགས་མ་ཡིན་ཏེ་༎
 akāraṇam etad yasmāt |	འདི་ལྟར་།
 rūpādyāyatanāstitvaṃ tadvineyajanaṃ prati |	གཟུགས་སོགས་སྐྱེ་མཆེད་ཡོད་པར་ནི་༎ དེས་འདུལ་བ་ཡི་སྐྱེ་བོ་ལ་༎ དགོངས་པའི་དབང་གིས་གསུངས་པ་སྟེ་༎
 abhiprāyavaśād uktam upapādukasattvavat || 8 ||	བརྫུས་ཏེ་བྱུང་བའི་སེམས་ཅན་བཞིན་༎
 yathāsti sattva upapāduka ity uktaṃ bhagavatā abhiprāyavaśāc cittasaṃtatyanucchedam āyatyām abhipretya |	དཔེར་ན་བཅོམ་ལྡན་འདས་ཀྱིས་བརྫུས་ཏེ་བྱུང་བའི་སེམས་ཅན་བཞིན་ཡོད་དོ་༎ ཞེས་གསུངས་བ་ཡང་ཕྱི་མ་ལ་སེམས་ཀྱི་རྒྱུད་རྒྱུན་མི་འཆད་པ་ལ་དགོངས་ནས་དགོངས་པའི་དབང་གིས་གསུངས་པ་སྟེ་།
 nāstīha sattva ātmā vā dharmās tv ete sahetukāḥ	འདི་ན་བདག་གམ་སེམས་ཅན་མེད་༎ ཆོས་འདི་རྒྱུ་དང་བཅས་ལས་བྱུང་༎
 iti vacanāt |	ཞེས་གསུངས་པའི་ཕྱིར་རོ་༎
 evaṃ rūpādyāyatanāstitvam apy uktaṃ bhagavatā taddeśanāvineyajanam adhikṛtyety ābhiprāyikaṃ tad vacanaṃ ||	དེ་བཞིན་དུ་བཅོམ་ལྡན་འདས་ཀྱིས་གཟུགས་ལ་སོགས་པའི་སྐྱེ་མཆེད་ཡོད་པར་གསུངས་པ་ཡང་དེ་བསྟན་པས་འདུལ་བའི་སྐྱེ་བོའི་ཆེད་དུ་སྟེ་། བཀའ་དེ་ནི་དགོངས་པ་ཅན་ནོ་༎
 ko 'tra abhiprāyaḥ |	འདིར་ཅི་ལས་དགོངས་ཤེ་ན་།
 yataḥ svabījād vijñaptir yadābhāsā pravartate |	རང་གི་ས་བོན་གང་ལས་སུ་༎ རྣམ་རིག་སྣང་བ་གང་བྱུང་བ་༎
 dvividhāyatanatvena te tasyā munir abravīt || 9 ||	དེ་དག་དེ་ཡི་སྐྱེ་མཆེད་ནི་༎ རྣམ་པ་གཉིས་སུ་ཐུབ་པས་གསུངས་༎
 kim uktaṃ bhavati |	འདི་སྐད་དུ་བསྟན་པར་འགྱུར་ཞེ་ན་།
 rūpapratibhāsā vijñaptir yataḥ svabījāt pariṇāmaviśeṣaprāptād utpadyate tac ca bījaṃ yat pratibhāsā ca sā te tasyā vijñapteś cakṣūrūpāyatanatvena	གཟུགས་སུ་སྣང་བའི་རྣམ་པར་རིག་པ་རང་གི་ས་བོན་འགྱུར་བའི་བྱེ་བྲག་ཏུ་གྱུར་པ་གང་ལས་བྱུང་བའི་ས་བོན་དེ་དང་སྣང་བ་གང་ཡིན་པ་དེ་དང་དེ་དག་ནི་དེའི་མིག་དང་། གཟུགས་ཀྱི་སྐྱེ་མཆེད་དུ་བཅོམ་ལྡན་འདས་ཀྱིས་གོ་རིམས་བཞིན་དུ་གསུངས་སོ་༎
 yathākramaṃ bhagavān abravīt | evaṃ yāvat spraṣṭavyapratibhāsā vijñaptir yataḥ svabījāt pariṇāmaviśeṣaprāptād utpadyate tac ca bījaṃ yat pratibhāsā ca sā te tasyā kāyaspraṣṭavyāyatanatvena yathākranaṃ	དེ་བཞིན་དུ་རེག་བྱར་སྣང་བའི་རྣམ་པར་རིག་པའི་བར་དུ་རང་རང་གི་ས་བོན་འགྱུར་བའི་བྱེ་བྲག་ཏུ་གྱུར་པའི་ས་བོན་གང་ལས་བྱུང་བའི་ས་བོན་དེ་དང་། སྣང་བ་གང་ཡིན་པ་དེ་དང་དེ་དག་ནི་བཅོམ་ལྡན་འདས་ཀྱིས་དེའི་ལུས་དང་རེག་བྱའི་སྐྱེ་མཆེད་དུ་གོ་རིམས་བཞིན་དུ་གསུངས་ཏེ་།
 bhagavān abravīd ity ayam abhiprāyaḥ ||	འདི་ནི་འདིར་དགོངས་པའོ་༎
 evaṃ punar abhiprāyavaśena deśayitvā ko guṇāḥ |	དེ་ལྟར་དགོངས་པའི་དབང་གིས་བསྟན་པ་ལ་ཡོན་ཏན་ཅི་ཡོད་ཅེ་ན་།
 tathā pudgalanairātmyapraveśo hi	དེ་ལྟར་གང་ཟག་ལ་བདག་མེད་པར་འཇུག་པར་འགྱུར་རོ་༎
 tathā hi deśyamāne pudgalanairātmyaṃ praviśanti |	དེ་ལྟར་བཤད་ན་གང་ཟག་ལ་བདག་མེད་པར་འཇག་༄༦བ་པར་འགྱུར་ཏེ་།
 dvayād vijñānaṣaṭkaṃ pravartate |	དྲུག་པོ་གཉིས་ལས་རྣམ་པར་ཤེས་པ་དྲུག་འབྱུང་གི་།
 na tu kaścid eko draṣṭāsti na yāvan mantety evaṃ viditvā ye pudgalanairātmyadeśanāvineyās te pudgalanairātmyaṃ praviśanti |	ལྟ་བ་པོ་གཅིག་པུ་ནས་རེག་པ་པོའི་བར་དུ་གནང་ཡང་མེད་པར་རིག་ནས་གང་དག་གང་ཟག་ལ་བདག་མེད་པར་བསྟན་པས་འདུལ་བ་དེ་དག་གང་ཟག་ལ་བདག་མེད་པར་འཇུག་གོ་༎
 anyathā punaḥ |	གཞན་དུ་ཡང་།
 deśanā dharmanairātmyapraveśaḥ	བསྟན་པ་ཆོས་ལ་བདག་མེད་པར་འཇུག་འགྱུར་༎
 anyatheti vijñaptimātradeśanā |	གཞན་དུ་ཡང་ཞེས་བྱ་བ་ནི་རྣམ་པར་རིག་པ་ཙམ་དུ་བསྟན་པའོ་༎
 kathaṃ dharmanairātmyapraveśaḥ |	ཇི་ལྟར་ཆོས་ལ་བདག་མེད་པར་འཇུག་ཅེ་ན་།
 vijñaptimātram idaṃ rūpādidharmapratibhāsam utpadyate na tu rūpādilakṣaṇo dharmaḥ ko 'py astīti viditvā |	རྣམ་པར་རིག་པ་ཙམ་འདི་ཉིད་གཟུགས་ལ་སོགས་པའི་ཆོས་སུ་སྣང་བར་འབྱུང་སྟེ་། གཟུགས་ལ་སོགས་པའི་མཚན་ཉིད་ཀྱི་ཆོས་གང་ཡང་མེད་བར་རིག་ནས་འཇུག་གོ་༎
 yadi tarhi sarvathā dharmo nāsti tad api vijñaptimātraṃ nāstīti kathaṃ tarhi vyavasthāpyate | na khalu sarvathā dharmo nāstīty evaṃ dharmanairātmyapraveśo bhavati | api tu | kalpitātmanā || 10 ||	གལ་ཏེ་ཆོས་རྣམ་པ་ཐམས་ཅད་དུ་མེད་ན་རྣམ་པར་རིག་པ་ཙམ་ཞེས་བྱ་བ་དེ་ཡང་མེད་པས་དེ་ཇི་ལྟར་རྣམ་པར་གཞག་ཅེ་ན་། ཆོས་ནི་རྣམ་པ་ཐམས་ཅད་དུ་མེད་པ་མ་ཡིན་པས་དེ་ལྟར་ཆོས་ལ་བདག་མེད་པར་འཇུག་པར་འགྱུར་ཏེ་།
 yo bālair dharmāṇāṃ svabhāvo grāhyagrāhakādiḥ parikalpatas tena kalpitenātmanā teṣāṃ nairātmyaṃ na tv anabhilāpyenātmanā yo buddhānāṃ viṣaya iti |	བརྟགས་པའི་བདག་ཉིད་ཀྱིས་། གང་བྱིས་པ་རྣམས་ཀྱིས་ཆོས་རྣམས་ཀྱི་རང་བཞིན་ཀུན་བརྟགས་པའི་བདག་ཉིད་དེས་དེ་དག་བདག་མེད་ཀྱི་སངས་རྒྱས་ཀྱི་ཡུལ་གང་ཡིན་པ་བརྗོད་དུ་མད་པའི་བདག་ཉིད་ཀྱིས་ནི་མེད་པ་མ་ཡིན་ནོ་༎ 
 evaṃ vijñaptimātrasyāpi vijñaptyantaraparikalpitenātmanā nairātmyapraveśāt vijñaptimātravyavasthāpanayā sarvadharmāṇāṃ nairātmyapraveśo bhavati na tu tadastitvāpavādāt |	དེ་ལྟར་རྣམ་པར་རིག་པ་ཙམ་ཡང་རྣམ་པར་རིག་པ་གཞན་གྱིས་ཀུན་བརྟགས་པའི་བདག་ཉིད་ཀྱིས་བདག་མེད་པར་རྟོགས་པའི་ཕྱིར་རྣམ་པར་རིག་པ་ཙམ་དུ་རྣམ་པར་གཞག་པས་ཆོས་ཐམས་ཅད་ལ་ཆོས་ལ་བདག་མེད་པར་འཇུག་པ་ཡིན་ནོ་༎ གྱི་། ཡོད་པ་དེ་ལ་ཡང་རྣམ་པ་ཐམས་ཅད་དུ་སྐུར་པས་ནི་མ་ཡིན་ནོ་ནོ་༎ 
 itarathā hi vijñapter api vijñaptyantaram arthaḥ syād iti vijñaptimātratvaṃ na sidhyetārthavatītvād vijñaptīnāṃ ||	གྱི་། ༎ གཞན་དུ་ན་ནི་རྣམ་པར་རིག་པ་གཞན་ཡང་རྣམ་པར་རིག་པ་གཞན་གྱི་དོན་དུ་འགྱུར་བས་རྣམ་པར་རིག་པ་ཙམ་ཉིད་དུ་མི་འགྲུབ་སྟེ་། རྣམ་པར་རིག་པ་རྣམས་དོན་དང་ལྡན་པའི་ཕྱིར་རོ་༎
 kathaṃ punar idaṃ pratyetavyam anenābhiprāyeṇa bhagavatā rūpādyāyatanāstitvam uktaṃ na punaḥ santy eva tāni yāni rūpādivijñaptīnāṃ pratyekaṃ viṣayībhavanti iti | yasmāt |	བཅོམ་ལྡན་འདས་ཀྱིས་དགོངས་པ་འདིས་གཟུགས་ལ་སོགས་པའི་སྐྱེ་མཆེད་ཡང་པར་གསུངས་ཀྱི་། གཟུགས་ལ་སོགས་པ་གང་དག་ཡོད་བཞིན་དུ་དེ་དག་རྣམ་པར་རིག་པ་སོ་སོའི་ཡུལ་དུ་མི་འགྱུར་རོ་ཞེས་བྱ་བ་དེ་ཇི་ལྟར་རྟོགས་པར་བྱ་ཞེ་ན་། 
 na tad ekaṃ na cānekaṃ viṣayaḥ paramāṇuśaḥ |	འདི་ལྟར་དེ་ནི་གཅིག་ནའང་ཡུལ་མིན་ལ་༎ ཕྲ་རབ་རྡུལ་དུ་དུ་མའང་མིན་༎
 na ca te saṃhatā yasmāt paramāṇur na sidhyati || 11 ||	དེ་དག་འདུས་པའང་མ་ཡིན་ཏེ་༎ འདི་༄༧ཨ་༌་༎ ལྟར་རྡུལ་ཕྲན་མི་འགྲུབ་ཕྱིར་༎
 iti | kim uktaṃ bhavati |	ཇི་སྐད་དུ་བསྟན་པར་འགྱུར་ཞེ་ན་།
 yat tadrūpādikam āyatanaṃ rūpādivijñaptīnāṃ pratyekaṃ viṣayaḥ syāt tad ekaṃ vā syād yathāvayavirūpaṃ kalpyate vaiśeṣikaiḥ |	གང་གཟུགས་ལ་སོགས་པའི་སྐྱེ་མཆེད་གཟུགས་ལ་སོགས་བ་རྣམ་པར་རིག་པ་སོ་སོའི་ཡུལ་ཡིན་དུ་ཟིན་ན་དེ་ནི་གཅིག་པུ་ཞིག་ཡིན་ཏེ་། ཇི་ལྟར་བྱེ་བྲག་པ་རྣམས་ཀྱིས་ཆ་ཤས་ཅན་གྱི་ངོ་བོར་བརྟག་པའི་ལྟ་བུའམ་།
 anekaṃ vā paramāṇuśaḥ | saṃhatā vā ta eva paramāṇavaḥ |	རྡུལ་ཕྲ་རབ་དུ་མའམ་རྡུལ་ཕྲ་རབ་དེ་དག་ཉིད་འདུས་པ་ཞིག་ཏུ་འགྱུར་གྲང་ན་།
 na tāvad ekaṃ viṣayo bhavaty avayavebhyo 'nyasyāvayavirūpasya kvacid apy agrahaṇāt |	གཅིག་པུ་དེ་ནི་ཡུལ་མ་ཡིན་ཏེ་། ཆ་ཤས་རྣམས་ལས་གཞན་པ་ཆ་ཤས་ཅན་གྱི་ངོ་བོ་གང་ལའང་མི་འཛིན་པའི་ཕྱིར་རོ་༎
 nāpy anekaṃ paramāṇūnāṃ (vvs_7)	དུ་མའང་ཡུལ་མ་ཡིན་ཏེ་།
 pratyekam agrahaṇāt |	རྡུལ་ཕྲ་རབ་སོ་སོ་ལ་མི་འཛིན་པའི་ཕྱིར་རོ་༎
 nāpi te saṃhatā viṣayībhavanti |	དེ་དག་འདུས་པ་ཡང་ཡུལ་མ་ཡིན་ཏེ་།
 yasmāt paramāṇur ekaṃ dravyaṃ na sidhyati ||	འདི་ལྟར་རྡུལ་ཕྲ་རབ་རྫས་གཅིག་ཏུ་མི་འགྲུབ་པའི་ཕྱིར་རོ་༎
 kathaṃ na sidhyati | yasmāt |	ཇི་ལྟར་མི་འགྲུབ་ཅེ་ན་འདི་ལྟར་༎
 ṣaṭkena yugapad yogāt paramāṇoḥ ṣaḍaṃśatā |	དྲུག་གིས་ཅིག་ཅར་སྦྱར་བས་ན་༎ ཕྲ་རབ་རྡུལ་ཆ་དྲུག་ཏུ་འགྱུར་༎
 ṣaḍbhyo digbhyaḥ ṣaḍbhiḥ paramāṇubhir yugapad yoge sati paramāṇoḥ ṣaḍaṃśatā prāpnoti |	ཕྱོགས་དྲུག་ནས་རྡུལ་ཕྲ་རབ་དྲུག་གིས་ཅིག་ཅར་དུ་སྦྱར་ན་ནི་རྡུལ་ཕྲ་རབ་ཆ་དྲུག་ཏུ་འགྱུར་ཏེ་། 
 ekasya yo deśas tatrānyasyāsaṃbhavāt |	གཅིག་གི་གོ་གང་ཡིན་པ་དེར་གཞན་མི་འབྱུང་བའི་ཕྱིར་རོ་༎ དྲུག་པོ་དག་ཀྱང་གོ་གཅིག་ན་༎ གོང་བུ་རྡུལ་ཕྲན་ཙམ་དུ་འགྱུར་༎
 ṣaṇṇāṃ samānadeśatvāt piṇḍaḥ syād aṇumātrakaḥ || 12 || atha ya evaikasya paramāṇor deśaḥ sa eva ṣaṇṇāṃ |	ཇི་སྟེ་རྡུལ་ཕྲ་རབ་གཅིག་གི་གོ་གང་ཡིན་པ་དེ་ཉིད་དུ་དྲུག་པོ་རྣམས་ཀྱི་གོ་ཡང་ཡིན་ན་ནི་དེས་ན་ཐམས་ཅད་གོ་གཅིག་པའི་ཕྱིར་གོང་བུ་ཐམས་ཅད་རྡུལ་ཕྲ་རབ་ཙམ་དུ་འགྱུར་ཏེ་། 
 tena sarveṣāṃ samānadeśatvāt sarvaḥ piṇḍaḥ paramāṇumātraḥ syāt parasparāvyatirekād iti na kaścit piṇḍo dṛśyaḥ syāt ||	ཕན་ཚུན་ཐ་དད་པ་མེད་པའི་ཕྱིར་གོང་བུ་གང་ཡང་སྣང་བར་མི་འགྱུར་རོ་འགྱུར་ཏེ་། ༎ ཁ་ཆེའི་བྱེ་བྲག་ཏུ་སྨྲ་བ་རྣམས་ཉེས་པ་འདི་འབྱུང་དུ་འོང་ངོ་ཞེས་འགྱུར་ཏེ་། ༎ ཏེ་། 
 naiva hi paramāṇavaḥ saṃyujyante niravayavatvāt | mā bhūd eṣa doṣaprasaṅgaḥ |	རྡུལ་ཕྲ་རབ་རྣམས་ནི་ཆ་ཤས་མེད་པའི་ཕྱིར་སྤྱོར་བ་མ་ཡིན་འགྱུར་ཏེ་། ༎ ཏེ་། གྱི་། 
 saṃhatās tu parasparaṃ saṃyujyanta iti kāśmīravaibhāṣikās ta idaṃ praṣṭavyāḥ |	འདུས་པ་དག་ནི་ཕན་ཚུན་སྦྱོར་རོ་ཞེས་ཟེར་བ་དེ་དག་ལ་འདི་སྐད་དུ་།
 yaḥ paramāṇūnāṃ saṃghāto na sa tebhyo 'rthāntaram iti |	རྡུལ་ཕྲ་རབ་རྣམས་འདུས་པ་གང་ཡིན་པ་དེ་དེ་དག་ལས་དོན་གཞན་རྣམས་མ་ཡིན་ནོ་ཞེས་བརྗོད་པར་བྱའོ་༎ 
 paramāṇor asaṃyogāt tatsaṃghāte 'sti kasya saḥ |	རྡུལ་ཕྲན་སྦྱོར་བ་མེད་ན་ནི་༎ དེ་འདུས་ཡོད་པ་དེ་གང་གིས་༎
 saṃyoga iti vartate |	སྦྱོར་བ་ཞེས་བྱ་བར་བསྙེགས་སོ་༎
 na cānavayavatvena tatsaṃyogo na sidhyati || 13 ||	ཆ་ཤས་ཡོད་བ་མ་ཡིན་པས་༎ དེ་སྦྱོར་མི་འགྲུབ་མ་ཟེར་ཅིག་། 
 atha saṃghātā apy anyonyaṃ na saṃyujyante |	ཇི་སྟེ་འདུས་པ་དག་ཀྱང་ཕན་ཚུན་མི་སྦྱོར་རོ་ཞེ་ན་། 
 na tarhi paramāṇūnāṃ niravayavatvāt saṃyogo na sidhyatīti vaktavyaṃ | sāvayavasyāpi hi saṃghātasya saṃyogānabhyupagamāt |	རྡུལ་ཕྲ་རབ་རྣམས་ནི་ཆ་ཤས་མེད་པའི་ཕྱིར་སྦྱོར་བ་མི་འགྲུབ་བོ་ཞེས་མ་ཟེར་ཅིག་འདུས་པ་ཆ་ཤས་དང་བཅས་པ་ཡང་སྦྱོར་བར་ཁས་མི་ལེན་པའི་ཕྱིར་རོ་༎
 tasmāt paramāṇur ekaṃ dravyaṃ na sidhyati |	དེ་བས་རྡུལ་ཕྲ་༄༧བ་རབ་རྫས་གཅིག་པུ་མི་འགྲུབ་བོ་༎
 yadi ca paramāṇoḥ saṃyoga iṣyate yadi vā neṣyate |	རྡུལ་ཕྲ་རབ་སྦྱོར་བར་འདོད་ཀྱང་རུང་མི་འདོད་ཀྱང་རུང་སྟེ་།
 digbhāgabhedī yasyāsti tasyaikatvaṃ na yujyate |	གང་ལ་ཕྱོགས་ཆ་ཐ་དད་ཡོད་༎ དེ་ནི་གཅིག་ཏུ་མི་རུང་ངོ་༎
 anyo hi paramāṇoḥ pūrvadigbhāgo yāvad adhodigbhāga iti digbhāgabhede sati kathaṃ tadātmakasya paramāṇor ekatvaṃ yokṣyate | chāyāvṛtī katha vā	རྡུལ་ཕྲ་རབ་ཀྱི་ཤར་ཕྱོགས་ཀྱི་ཆ་ཡང་གཞན་པ་ནས་འོག་གི་ཆའི་བར་དུ་ཡང་གཞན་ཏེ་། ཕྱོགས་ཀྱི་ཆ་ཐ་དད་ན་དེའི་བདག་ཉིད་ཀྱི་རྡུལ་ཕྲ་རབ་གཅིག་པུར་ཇི་ལྟར་རུང་།
 yady ekaikasya paramāṇor digbhāgabhedo na syād ādityodaye katham anyatra chāyā bhavaty anyatrātapaḥ |	སྒྲིབ་དང་སྒྲིབ་པར་ཇི་ལྟར་འགྱུར་༎ གལ་ཏེ་རྡུལ་ཕྲ་རབ་རེ་རེ་ལ་ཕྱོགས་ཀྱི་ཆ་ཐ་དད་པ་མེད་ན་ནི་ཉི་མ་ཤར་བའི་ཚེ་ངོས་གཞན་ན་ནི་གྲིབ་མ་འབབ་པར་ཇི་ལྟར་འགྱུར་ཏེ་།
 na hi tasyānyaḥ pradeśo 'sti yatrātapo na syāt |	དེ་ལ་ནི་གང་དུ་ཉི་མ་མི་འབབ་པའི་ཕྱོགས་གཞན་མེད་དོ་༎
 āvaraṇaṃ ca kathaṃ bhavati paramāṇoḥ paramāṇvantareṇa yadi digbhāgabhedo neṣyate |	གལ་ཏེ་ཕྱོགས་ཀྱི་ཕྱོགས་ཐ་དད་པར་མི་འདོད་ན་རྡུལ་ཕྲ་རབ་ལ་རྡུལ་ཕྲ་རབ་གཞན་གྱིས་སྒྲིབ་པར་ཡང་ཇི་ལྟར་འགྱུར་།
 na hi kaścid api paramāṇoḥ parabhāgo 'sti yatrāgamanād anyenānyasya pratighātaḥ syāt |	རྡུལ་ཕྲ་རབ་གང་ལ་ཡང་ཆ་ཤས་གཞན་མེད་ན་གང་དུ་འོང་བའི་ཕྱོགས་ལ་གཅིག་ལ་གཅིག་ཐོགས་པར་འགྱུར་། 
 asati ca pratighāte sarveṣāṃ samānadeśatvāt sarvaḥ saṃghātaḥ (vvs_8) paramāṇumātraḥ syād ity uktaṃ |	ཐོགས་པ་མེད་ན་ནི་ཐམས་ཅད་གོ་གཅིག་ཏུ་གྱུར་པས་འདུས་པ་ཐམས་ཅད་རྡུལ་ཕྲ་རབ་ཙམ་དུ་འགྱུར་ཏེ་།
 kim evaṃ neṣyate piṇḍasya te chāyāvṛtī na paramāṇor iti |	དེ་ནི་བཤད་ཟིན་ཏོ་༎ གྲིབ་མ་དང་སྒྲིབ་པ་རྡུལ་ཕྲ་རབ་ཀྱི་མ་ཡིན་ཡང་། ཅི་གོང་བུའི་ཡིན་པ་དེ་ལྟར་ཡང་མི་འདོད་དམ་།
 kiṃ khalu paramāṇubhyo 'nyaḥ piṇḍa iṣyate yasya te syātāṃ | nety āha |	རྡུལ་ཕྲ་རབ་རྣམས་ལ་གོང་བུ་གཞན་ཞིག་ཡིན་པར་འདོད་དམ་ཅི་ན་དེ་དག་དེའི་ཡིན་། སྨྲས་པ་།
 anyo na piṇḍaś cen na tasya te || 14 ||	ཡིན་ནོ་༎ གོང་བུ་གཞན་མིན་དེ་དེའི་མིན་༎
 yadi nānyaḥ paramāṇubhyaḥ piṇḍa iṣyate na te tasyeti siddhaṃ bhavati |	གལ་ཏེ་རྡུལ་ཕྲ་རབ་རྣམས་ལས་གོང་བུ་གཞན་མ་ཡིན་ན་དེ་དག་དེའི་མ་ཡིན་པར་གྲུབ་པ་ཡིན་ནོ་༎ ཡོངས་སུ་རྟོགས་པ་འདི་ནི་གནས་པའི་ཁྱད་པར་ཏེ་།
 saṃniveśaparikalpa eṣaḥ paramāṇuḥ saṃghāta iti vā ||	གཟུགས་ལ་སོགས་པའི་མཚན་ཉིད་ནི་མ་བཀག་ན་རྡུལ་ཕྲ་རབ་ཅེའམ་།
 kim anayā cintayā lakṣaṇaṃ | tu rūpādi yadi na pratiṣidhyate |	འདུས་བ་ཞེས་བསམ་པ་འདིས་ཅི་ཞིག་བྱ་ཞེ་ན་།
 kiṃ punas teṣāṃ lakṣaṇaṃ |	དེ་དག་གི་མཚན་ཉིད་གང་ཡིན་།
 cakṣurādiviṣayatvaṃ nīlāditvaṃ ca | tad evedaṃ saṃpradhāryate |	མིག་ལ་སོགས་པའི་ཡུལ་ཉིད་དང་༎ སྔོན་པོ་ལ་སོགས་བ་ཉིད་དོ་༎
 yat tac cakṣurādīnāṃ viṣayo nīlapītādikam iṣyate kiṃ tad ekaṃ dravyam atha vā tad anekam iti |	གང་མིག་ལ་སོགས་པའི་ཡུལ་སྔོན་པོ་དང་། སེར་པོ་ལ་སོགས་བ་འདོད་པ་དེ་ཅི་རྫས་གཅིག་པུ་ཞིག་གམ་། འོན་ཏེ་དུ་མ་ཞིག་ཅེས་དེ་དཔྱད་པར་བྱའོ་༎
 kiṃ cātaḥ |	འདིས་ཅི་ཞིག་བྱ་ཞེ་ན་།
 anekatve doṣa uktaṃ |	དུ་མའི་ངེས་པ་ནི་བཤད་ཟིན་ཏོ་༎ གཅིག་ན་རིམ་གྱིས་འགྲོ་བ་མེད་༎
 ekatve na krameṇetir yugapan na grahāgrahau |	ཟིན་དང་མ་ཟིན་ཅིག་ཅར་མེད་༎
 vicchinnānekavṛttiś ca sūkṣmānīkṣā ca no bhavet || 15 ||	རིས་ཆད་དུ་མར་གནས་པ་དང་༎ མིག་གིས་མི་སོད་ཕྲ་བའང་མེད་༎
 yadi yāvad vicchinnaṃ nānekaṃ cakṣuṣo viṣayas tad ekaṃ dravyaṃ kalpyate pṛthivyāṃ krameṇetir na syād gamanam ity arthaḥ |	གལ་ཏེ་མིག་གི་ཡུལ་སྔོན་པོ་དང་སེར་༄༨ཨ་༌་༎ པོ་ལ་སོགས་པ་གང་ཡིན་པ་དེ་རིས་སུ་མ་ཆད་དེ་རྫས་གཅིག་པར་རྟོགས་ནས་ལ་རིམ་གྱིས་འགྲོ་བར་མི་འགྱུར་ཏེ་།
 sakṛtpādakṣepeṇa sarvasya gatatvāt |	གོམ་པ་གཅིག་བོར་བས་ཐམས་ཅད་དུ་སོན་པའི་ཕྱིར་རོ་༎
 arvāgbhāgasya ca grahaṇaṃ parabhāgasya cāgrahaṇaṃ yugapan na syāt |	ཚུ་རོལ་གྱི་ཆ་ཟིན་ལ་ཕ་རོལ་གྱི་ཆ་མ་ཟིན་པ་ཅིག་ཅར་དུ་མི་འགྱུར་ཏེ་།
 na hi tasyaiva tadānīṃ grahaṇaṃ cāgrahaṇaṃ ca yuktam |	དེའི་ཚེ་ཟིན་པ་དང་མ་ཟིན་པ་དེ་མི་རིགས་སོ་༎ གླང་པོ་ཆེ་དང་རྟ་ལ་སོགས་པའི་རིས་སུ་ཆད་པ་དུ་མ་གཅིག་ན་འདུག་པར་མི་འགྱུར་ཏེ་། 
 vicchinnasya cānekasya hastyaśvādikasyaikatra vṛttir na syād yatraiva hy ekaṃ tatraivāparam iti kathaṃ tayor viccheda iṣyate |	གཅིག་གནང་ན་འདུག་པ་དེ་ཉིད་ན་གཞན་ཡང་འདུག་ན་དེ་དག་རིས་སུ་ཆད་པར་ཏེ་། ཇི་ལྟར་རུང་། དེ་གཉིས་ཀྱིས་གནང་ནོན་པ་དང་མ་ནོན་པ་དེ་དག་གཅིག་ཏུ་ཇི་ལྟར་རུང་སྟེ་།
 kathaṃ vā tad ekaṃ yat prāptaṃ ca tābhyāṃ na ca prāptam antarāle tac chūnyagrahaṇāt | sūkṣmāṇāṃ caudakajantūnāṃ sthūlaiḥ samānarūpāṇām anīkṣaṇaṃ na syād |	བར་ན་དེ་དག་གིས་སྟོང་པ་གཟུང་དུ་ཡོད་པའི་ཕྱིར་རོ་༎
 yadi lakṣaṇabhedād eva dravyāntaratvaṃ kalpyate nānyathā |	གལ་ཏེ་མཚན་ཉིད་ཐ་དད་པ་ཉིད་ཀྱིས་རྫས་གཞན་ཁོ་ནར་རྟོག་གི་གཞན་དུ་མ་ཡིན་ན་གོ་༎ ཆུའི་སྐྱེ་བོ་ཕྲ་མོ་རྣམས་ཀྱང་ཆེན་པོ་དག་དང་གཟུགས་མཚུངས་པས་མིག་གིས་མི་སོད་པར་མི་འགྱུར་རོ་༎
 tasmād avaśyaṃ paramāṇuśo bhedaḥ kalpayitavyaḥ |	དེའི་ཕྱིར་ངེས་པར་རྡུལ་ཕྲ་རབ་ཐ་དད་པར་བརྟག་པར་བྱ་སྟེ་།
 sa caiko na sidhyati |	དེ་དག་གཅིག་ཏུ་མི་འགྲུབ་བོ་༎
 tasyāsiddhau rūpādīnāṃ cakṣurādiviṣayatvam asiddham iti siddhaṃ vijñaptimātraṃ bhavatīti ||	དེ་མ་གྲུབ་པས་གཟུགས་ལ་སོགས་པ་ཡང་མིག་ལ་སོགས་པའི་ཡུལ་ཉིད་དུ་མི་འགྲུབ་སྟེ་། རྣམ་པར་རིག་པ་ཙམ་དུ་གྲུབ་པ་ཡིན་ནོ་༎
 pramāṇavaśād astitvaṃ nāstitvaṃ vā nirdhāryate sarveṣāṃ ca pramāṇānāṃ pratyakṣaṃ pramāṇaṃ gariṣṭam ity asaty arthe katham iyaṃ buddhir bhavati pratyakṣam iti | pratyakṣabuddhiḥ svapnādau yathā	ཚད་མའི་དབང་གིས་ན་ཡོད་དམ་མེད་པ་དམིགས་ཀྱིས་དབྱེ་བར་འགྱུར་ལ་། ཚད་མ་ཐམས་ཅད་ཀྱི་ནང་ན་ཡང་མངོན་སུམ་གྱི་ཚད་མ་ནི་མཆོག་ཡིན་ནོ་༎ དོན་དེ་མེད་ན་འདི་ནི་བདག་གི་མངོན་སུམ་མོ་སྙམ་པ་བློ་འདི་ཇི་ལྟར་འབྱུང་ཞེ་ན་། མངོན་སུམ་བློ་ནི་རྨི་སོགས་བཞིན་༎
 vināpy artheneti pūrvam eva jñāpitaṃ	དོན་མེད་པར་ཡང་ཞེས་སྔར་བསྟན་པ་ཉིད་དོ་༎
 sā ca yadā tadā |	དེ་ཡང་གང་ཚེ་དེ་ཡི་ཚེ་༎
 na so 'rtho dṛśyate tasya pratyakṣatvaṃ kathaṃ mataṃ || 16 ||	ཁྱོད་ཀྱི་དོན་དེ་མིན་སྣང་ན་༎ དེ་ནི་མངོན་སུམ་ཇི་ལྟར་འདོད་༎
 yadā ca sā pratyakṣabuddhir bhavatīdaṃ me pratyakṣam iti tadā na so 'rtho dṛśyate manovijñānenaiva paricchedāc cakṣurvijñānasya ca tadā niruddhatvād iti kathaṃ tasya pratyakṣatvam iṣṭaṃ |	གང་གི་ཚེ་ཡུལ་འདི་ཉིད་ནི་བདག་གི་མངོན་སུམ་མོ་སྙམ་དུ་མངོན་སུམ་གྱི་བློ་དེ་བྱུང་བ་དེའི་ཚེ་ཁྱོད་ཀྱི་དོན་དེ་མི་སྣང་སྟེ་། ཡིད་ཀྱི་རྣམ་པར་ཤེས་པས་ཡོངས་སུ་བཅད་པ་དང་། མིག་གི་རྣམ་པར་ཤེས་པ་ཡང་དེའི་ཚེ་འགགས་པའི་ཕྱིར་རོ་༎
 viśeṣeṇa tu kṣaṇikasya viṣayasya tadānīṃ (vvs_9)	ལྷག་པར་ཡང་སྐད་ཅིག་མར་སྨྲ་བས་དེ་མངོན་སུམ་དུ་ཇི་ལྟར་འདོད་།
 niruddham evaṃ tad rūpaṃ rasādikaṃ vā ||	དེ་ལྟར་ན་དེའི་ཚེ་གཟུགས་དང་རོལ་སོགས་པ་དེ་དག་ནི་འགགས་ཟིན་ཏོ་།
 nānanubhūtaṃ manovijñānena smaryata ity avaśyam arthānubhavena bhavitavyaṃ tac ca darśanam ity evaṃ tadviṣayasya rūpādeḥ pratyakṣatvaṃ mataṃ	མྱོང་བ་མེད་པར་ཡིད་ཀྱི་རྣམ་པར་ཤེས་པ་དྲན་པར་མི་༄༨བ་འགྱུར་བས་དོན་གདོན་མི་ཟ་བར་མྱོང་བར་འགྱུར་ཏེ་། དེ་ནི་ད་མ་མཐོང་བ་ཡིན་ནོ་༎ དེ་ལྟར་དེའི་ཡུལ་གཟུགས་ལ་སོགས་པ་མངོན་སུམ་དུ་འདོད་དོ་ཞེ་ན་།
 asiddham idam anubhūtasyārthasya smaraṇaṃ bhavatīti | yasmāt |	མྱོང་བ་ནི་དོན་དྲན་པ་ཡིན་ནོ་༎ ཞེས་དེ་མ་གྲུབ་སྟེ་། འདི་ལྟར་།
 uktaṃ yathā tadābhāsā vijñaptiḥ	དཔེར་ན་དེར་སྣང་རྣམ་རིག་བཞིན་༎ བཤད་ཟིན་།
 vināpy arthena yathārthābhāsā cakṣurvijñānādikā vijñaptir utpadyate tathoktaṃ | smaraṇaṃ tataḥ |	དཔེར་ན་དོན་མེད་པར་དོན་དུ་སྣང་བ་མིག་གི་རྣམ་པར་ཤེས་པ་ལ་སོགས་པའི་རྣམ་པར་རིག་པ་འབྱུང་བ་དེ་བཞིན་ཏེ་བཤད་ཟིན་ཏོ་༎ དེ་ལས་དྲན་པར་ཟད་།
 tato hi vijñapteḥ smṛtisaṃprayuktā tatpratibhāsaiva rūpādivikalpikā manovijñaptir utpadyata iti na smṛtyutpādād arthānubhavaḥ sidhyati |	རྣམ་པར་རིག་པ་དེ་ལས་དྲན་པ་དང་མཚུངས་པར་ལྡན་པ་དེར་སྣང་བ་ཉིད་གཟུགས་ལ་སོགས་པ་ལ་རྣམ་པར་རྟོག་པ་ཡིད་ཀྱི་རྣམ་པར་རིག་པ་འབྱུང་སྟེ་། དྲན་པ་བྱུང་བ་ལས་དོན་མྱོང་བར་མི་འགྲུབ་བོ་། དཔེར་ན་རྨི་ལམ་གྱི་རྣམ་པར་རིག་པའི་ཡུལ་ཡོད་པ་མ་ཡིན་པ་དེ་བཞིན་དུ་།
 yadi yathā svapne vijñaptir abhūtārthaviṣayā tathā jāgrato 'pi syāt tathaiva tadabhāvaṃ lokaḥ svayam avagacchet |	གལ་ཏེ་གཉིད་ཀྱིས་མ་ལོག་པའི་ཚེ་ན་ཡང་དེ་ལྟར་ཡིན་ན་ནི་དེ་ཁོ་ན་བཞིན་དུ་དེ་མེད་པར་འཇིག་རྟེན་རང་རང་གིས་ཁོང་དུ་ཆུད་པའི་རིགས་ན་།
 na caivaṃ bhavati |	དེ་ལྟར་ཡང་མ་ཡིན་ཏེ་།
 tasmān na svapna ivārthopalabdhiḥ sarvā nirarthikā |	དེའི་ཕྱིར་རྨི་ལམ་བཞིན་དུ་དོན་དམིགས་པ་ཐམས་ཅད་དོན་མེད་པ་མ་ཡིན་ནོ་ཞེ་ན་། དེ་ནི་གཏན་ཚིགས་སུ་མི་རུང་སྟེ་།
 idam ajñāpakaṃ | yasmāt |	འདི་ལྟར་།
 svapnadṛgviṣayābhāvaṃ nāprabuddho 'vigacchati || 17 ||	རྨི་ལམ་མཐོང་བ་ཡུལ་མེད་པར་༎
 evaṃ vitathavikalpābhyāsavāsanānidrayā prasupto lokaḥ svapna ivābhūtam arthaṃ paśyan na prabuddhas tadabhāvaṃ yathāvan nāvagacchati |	མ་སད་བར་དུ་རྟོགས་མ་ཡིན་༎ དེ་ལྟར་ལོག་པར་རྣམ་པར་རྟོག་པ་ལ་གོམས་པའི་བག་ཆགས་ཀྱི་གཉིད་ཀྱིས་ལོག་པའི་འཇིག་རྟེན་ནི་རྨི་ལམ་བཞིན་དུ་ཡང་དག་པ་མ་ཡིན་པའི་དོན་མཐོང་ཏེ་། མ་སད་ཀྱི་བར་དུ་དེ་མེད་པར་ཇི་ལྟ་བ་བཞིན་དུ་རྟོགས་པ་མ་ཡིན་གྱི་།
 yadā tu tatpratipakṣalokottaranirvikalpajñānalābhāt prabuddho bhavati tadā tatpṛṣṭhalabdhaśuddhalaukikajñānasaṃmukhībhāvād viṣayābhāvaṃ yathāvad avagacchatīti samānam etat ||	གང་གི་ཚེ་དེའི་གཉེན་པོ་འཇིག་རྟེན་ལས་འདས་པ་རྣམ་པར་མི་རྟོག་པའི་ཡེ་ཤེས་ཐོབ་ནས་སང་པར་གྱུར་པ་དེའི་ཚེ་དེའི་རྗེས་ལས་ཐོབ་པ་དག་པ་འཇིག་རྟེན་པའི་ཡེ་ཤེས་དེ་མངོན་དུ་གྱུར་ནས་ཡུལ་མེད་པར་ཇི་ལྟ་བ་བཞིན་དུ་ཁོང་དུ་ཆུད་དེ་དེ་ནི་མཚུངས་སོ་༎
 yadi svasaṃtānapariṇāmaviśeṣād eva satvānām arthapratibhāsā vijñaptaya utpadyante nārthaviśeṣāt |	གལ་ཏེ་རང་གི་རྒྱུད་གྱུར་པའི་ཁྱད་པར་ཉིད་ལས་སེམས་ཅན་རྣམས་ཀྱི་དོན་དུ་སྣང་བའི་རྣམ་པར་རིག་པ་འབྱུང་གི་། དོན་གྱི་ཁྱད་པར་ལས་མ་ཡིན་ན་།
 tadā ya eṣa pāpakalyāṇamitrasaṃparkāt sadasaddharmaśravaṇāc ca vijñaptiniyamaḥ sattvānāṃ sa kathaṃ sidhyati asati sadasatsaṃparke taddeśanāyāṃ ca |	བརྟེན་པ་དེ་དང་བཤད་པ་དེ་མེད་པས་སྡིག་པའི་གྲོགས་པོ་དང་། དགེ་བའི་བཤེས་གཉེན་ལ་བརྟེན་པ་དང་། དམ་པ་དང་དམ་པ་མ་ཡིན་པའི་ཆོས་མཉན་པ་ལས་སེམས་ཅན་རྣམས་ཀྱིས་རྣམ་པར་རིག་པ་ངེས་པ་ཇི་ལྟར་འགྲུབ་པར་འགྱུར་། གཅིག་ལ་༄༩ཨ་༌་༎ གཅིག་གི་དབང་གིས་ན་༎
 anyonyādhipatitvena vijñaptiniyamo mithaḥ |	རྣམ་པར་རིག་པ་ཕན་ཚུན་ངེས་༎
 sarveṣāṃ hi sattvānām anyonyavijñaptyādhipatyena mitho vijñapter niyamo bhavati yathāyogaṃ |	སེམས་ཅན་ཐམས་ཅད་ཀྱི་རྣམ་པར་རིག་པ་ཕན་ཚུན་གྱི་དབང་གིས་ཕན་ཚུན་དུ་རྣམ་པར་རིག་པ་རྣམས་ངེས་པར་འགྱུར་ཏེ་། ཅི་རིགས་སུ་སྦྱར་རོ་༎
 mitha iti parasparataḥ |	གཅིག་ལ་གཅིག་ཅེས་བྱ་བ་ནི་ཕན་ཚུན་ནོ་༎
 ataḥ saṃtānāntaravijñaptiviśeṣāt saṃtānāntare vijñaptiviśeṣa utpadyate nārthaviśeṣāt |	དེའི་ཕྱིར་རྒྱུད་གཞན་གྱི་རྣམ་པར་རིག་པའི་ཁྱད་པར་ལས་རྒྱུད་གཞན་ལ་རྣམ་པར་རིག་པའི་ཁྱད་པར་འབྱུང་གི་དོན་གྱི་ཁྱད་པར་ལས་ནི་མ་ཡིན་ནོ་༎ 
 yadi yathā svapne nirarthikā vijñaptir evaṃ jāgrato 'pi syāt kasmāt kuśalākuśalasamudācāro suptāsuptayos tulyaṃ phalam iṣṭāniṣṭam āyatyāṃ na bhavati | yasmāt |	དཔེར་ན་རྨི་ལམ་གྱི་རྣམ་པར་རིག་པའི་དོན་མེད་བ་བཞིན་དུ་གལ་ཏེ་གཉིད་ཀྱིས་མ་ལོག་པའི་ཡང་དེ་ལྟ་ན་གཉིད་ཀྱིས་ལོག་པ་དང་མ་ལོག་པ་ན་དགེ་བ་དང་མི་དགེ་བའི་ལས་ཀུན་ཏུ་སྤྱོད་པའི་འབྲས་བུ་ཕྱི་མ་ལ་འདོད་པ་དང་མི་འདོད་པ་འདྲ་བར་ཅིའི་ཕྱིར་མི་འགྱུར་།
 middhenopahataṃ cittaṃ svapne tenāsamaṃ phalaṃ || 18 ||	སེམས་ནི་གཉིད་ཀྱིས་ནོན་པས་ན་༎ དེ་ཕྱིར་རྨི་དང་འབྲས་མི་མཚུངས་༎
 idam atra kāraṇāṃ na tv arthasadbhāvaḥ ||	དེ་ནི་འདིར་རྒྱུ་ཡིན་གྱི་དོན་ཡོད་པ་ནི་མ་ཡིན་ནོ་༎
 yadi vijñāptimātram evedaṃ na kasyacit kāyo 'sti na vāk || katham upakramyamāṇānām aurabhrikādibhir urabhrādīnāṃ (vvs_10)	གལ་ཏེ་འདི་དག་རྣམ་པར་རིག་བཙམ་དུ་ཟད་ན་གང་ལ་ཡང་ལུས་དང་ངག་ཀྱང་མེད་པས་ཤན་པ་ལ་སོགས་པས་གསོད་པ་ན་ལུག་ལ་སོགས་པ་འཆི་བར་ཇི་ལྟར་འགྱུར་།
 maraṇaṃ bhavti | atatkṛte vā tanmaraṇe katham aurabhrikādīnāṃ prāṇātipātāvadyena yogo bhavati |	འཆི་བ་དེ་དེས་མ་བྱས་ན་ནི་ཤན་པ་ལ་སོགས་པ་སྲོག་གཅོད་པའི་ཁ་ན་མ་ཐོ་བ་དང་ལྡན་པར་ཇི་ལྟར་འགྱུར་ཞེ་ན་།
 maraṇam paravijñaptiviśeṣād vikriyā yathā |	འཆི་བ་གཞན་གྱི་རྣམ་རིག་གི་༎ བྱེ་བྲག་ལས་དེ་དཔེར་བྱ་ན་༎
 smṛtilopādikānyeṣāṃ piśācādimanovaśāt || 19 ||	འདྲེ་ལ་སོགས་པའི་ཡིད་དབང་གིས་༎ གཞན་གྱི་དྲན་ཉམས་འགྱུར་སོགས་བཞིན་༎
 yathā hi piśācādimanovaśād anyeṣāṃ smṛtilopasvapnadarśanabhūtagrahāveśavikārā bhavanti | ṛddhivan manovaśāc ca |	དཔེར་ན་འདྲེ་ལ་སོགས་པའི་ཡིད་ཀྱི་དབང་གིས་གཞན་དག་གི་དྲན་པ་ཉམས་པ་དང་། རྨི་ལྟས་སུ་མཐོང་བ་དང་། འབྱུང་པོའི་གདོན་ཕབ་པར་འགྱུར་བ་དང་། རྫུ་འཕྲུལ་དང་ལྡན་པའི་ཡིད་ཀྱི་དབང་གིས་ཏེ་།
 yathā sāraṇasyāryamahākātyāyanādhiṣṭhānāt svapnadarśanaṃ |	དཔེར་ན་འཕགས་པ་ཀའ་ཏཡའའི་བུ་ཆེན་པོའི་བྱིན་གྱི་བརླབས་ཀྱིས་ས་ར་ནས་རྨི་ལྟས་སུ་མཐོང་བ་དང་། 
 āraṇyakarṣimanaḥpradoṣāc ca vemacitraparājayaḥ | tathā paravijñaptiviśeṣādhipatyāt pareṣāṃ jīvitendriyavirodhinī kācid vikriyotpadyate yayā sabhāgasaṃtativicchedākhyaṃ maraṇaṃ bhavatīti veditavyaṃ kathaṃ vā daṇḍakāraṇyaśūnyatvam ṛṣikopataḥ |	དྲང་སྲོང་དགོན་པ་པའི་ཡིད་འཁྲུགས་པས་ཐགས་ཟངས་རིས་བཞིན་དུ་གཞན་གྱི་རྣམ་པར་རིག་པའི་བྱེ་བྲག་གིས་སེམས་ཅན་གཞན་གྱི་སྲོག་གི་དབང་པོ་དང་མི་མཐུན་པའི་འགྱུར་བ་འགའ་འབྱུང་སྟེ་དེ་བསྐལ་པ་འདྲ་བའི་རྒྱུད་ཀྱི་རྒྱུན་ཆད་པ་ཞེས་བྱ་བ་འཆི་བར་རིག་པར་བྱའོ་བ་དང་། ༎ དྲང་སྲོང་ཁྲོས་པས་དན་ཏ་ཀའི་༎ དགོན་པ་ཇི་ལྟར་སྟོངས་པར་འགྱུར་༎
 yadi paravijñaptiviśeṣādhipatyāt sattvānāṃ maraṇaṃ neṣyate | manodaṇḍasya hi mahāsāvadyatvaṃ sādhayatā bhagavatopālir gṛhapatiḥ pṛṣṭaḥ |	གལ་ཏེ་གཞན་གྱི་རྣམ་པར་༄༩བ་རིག་པའི་བྱེ་བྲག་གིས་སེམས་ཅན་དག་འཆི་བར་མི་འདོད་ན་། ཡིད་ཀྱི་ཉེས་པ་ཁ་ན་མ་ཐོ་བ་ཆེན་པོ་དང་བཅས་པ་ཉིད་དུ་བསྒྲུབ་པ་ན་། ། བཅོམ་ལྡན་འདས་ཀྱིས་ཁྱིམ་བདག་ཉེ་བ་འཁོར་ལ་བཀའ་སྩལ་པ་།
 kaccit te gṛhapate śrutaṃ kena tāni daṇḍakāraṇyāni mātaṅgāraṇyāni kaliṅgāraṇyāni śūnyāni medhyībhūtāni | tenoktaṃ | śrutaṃ me bho gautama ṛṣīṇāṃ manaḥpradoṣeṇeti |	ཁྱིམ་བདག་ཁྱོད་ཀྱིས་དན་ཏ་ཀའི་དགོན་པ་དང་། ཀ་ལིང་ཀའི་དགོན་པ་དང་མ་ཏང་ཀའི་དགོན་པ་དེ་དག་ཅི་ཞིག་གིས་སྟོངས་པ་དང་། གཙང་མར་གྱུར་པ་ཅི་ཐོས་ཞེས་སྨྲས་པ་དང་། དེས་གོཨོ་ཏ་མ་དྲང་སྲོང་རྣམས་ཁྲོས་པས་དེ་ལྟར་གྱུར་ཅེས་ཐོས་སོ་ཞེས་གསོལ་ཏོ་༎
 manodaṇḍo mahāvadyaḥ kathaṃ vā tena sidhyati || 20 ||	ཡིད་ཉེས་ཁན་མཐོ་ཆེར་༎ ཇི་ལྟར་དེ་ཡིས་འགྲུབ་པར་འགྱུར་༎
 yady evaṃ kalpyate |	གལ་ཏེ་འདི་ལྟར་རྟོག་སྟེ་༎
 tadabhiprasannair amānuṣais tadvāsinaḥ sattvā utsāditā na tv ṛṣīṇāṃ manaḥpradoṣān	དེ་ལ་དགའ་བ་མི་མ་ཡིན་པ་དེ་དག་གིས་དེ་ན་གནས་པའི་སེམས་ཅན་རྣམས་ཁ་བཏག་གི་། དྲང་སྲོང་རྣམས་ཀྱིས་ཡིད་འཁྲུགས་པས་དོགས་པ་ནི་མ་ཡིན་ནོ་ཞེ་ན་།
 mṛtā ity evaṃ sati kathaṃ tena karmaṇā manodaṇḍaḥ kāyavāgdaṇḍābhyāṃ mahāvadyatamaḥ siddho bhavati |	དེ་ལྟར་ན་ལས་དེས་ལུས་དང་ངག་གི་ཉེས་པ་རྣམས་པས་ཡིད་ཀྱི་ཉེས་པ་ཆེས་ཁ་ན་མ་ཐོ་བ་ཆེན་པོ་དང་བཅས་པར་འགྲུབ་པར་ཇི་ལྟར་འགྱུར་ཏེ་།
 tanmanaḥpradoṣamātreṇa tāvatāṃ sattvānāṃ maraṇāt sidhyati ||	དེའི་ཡིད་འཁྲུགས་པ་ཙམ་གྱིས་སེམས་ཅན་དེ་སྙེད་འཆི་བར་འགྲུབ་བོ་༎
 yadi vijñaptimātram evedaṃ paracittavidaḥ kiṃ paracittaṃ jānanty atha na |	གལ་ཏེ་འདི་དག་རྣམ་པར་རིག་པ་ཙམ་དུ་ཟད་ན་གཞན་གྱི་སེམས་རིག་པས་ཅི་གཞན་གྱི་སེམས་ཤེས་སམ་འོན་ཏེ་མི་ཤེས་ཤེ་ན་།
 kiṃ cātaḥ |	འདིས་ཅི་ཞིག་བྱ་།
 yadi na jānanti kathaṃ paracittavido bhavanti |	གལ་ཏེ་མི་ཤེས་ན་ནི་གཞན་གྱི་སེམས་རིག་པ་ཞེས་ཀྱང་ཅི་སྐད་དུ་བྱ་།
 atha jānanti |	ཇི་སྟེ་ཤེས་ན་ཡང་།
 paracittavidāṃ jñānam ayathārthaṃ kathaṃ yathā |	གཞན་སེམས་རིག་པས་ཤེས་བ་ནི་༎ དོན་བཞིན་མ་ཡིན་ཇི་ལྟར་དཔེར་༎
 svacittajñānaṃ	རང་སེམས་ཤེས་པ་།
 tad api katham ayathārtha |	དེ་ཡང་ཇི་ལྟར་དོན་ཇི་ལྟ་བ་བཞིན་དུ་མ་ཡིན་ཞེ་ན་།
 ajñānād yathā buddhasya gocaraḥ || 21 || yathā tannirabhilāpyenātmanā buddhānāṃ gocaraḥ |	སངས་རྒྱས་ཀྱི་སྤྱོད་ཡུལ་ཇི་བཞིན་མ་ཤེས་ཕྱིར་།
 tathā tadajñānāt tadubhayaṃ na yathārthaṃ vitathapratibhāsatayā grāhyagrāhakavikalpasyāprahīṇatvāt ||	ཇི་ལྟར་དེ་བརྗོད་དུ་མེད་པའི་བདག་ཉིད་དུ་སངས་རྒྱས་ཀྱི་སྤྱོད་ཡུལ་དུ་གྱུར་པ་དེ་ལྟར་དེས་མ་ཤེས་པའི་ཕྱིར་དེ་གཉི་ག་ཡང་དོན་ཇི་ལྟ་བ་བཞིན་མ་ཡིན་ཏེ་། ལོག་པར་སྣང་བའི་ཕྱིར་རོ་༎ གཟུང་བ་དང་འཛིན་པའི་རྣམ་པར་རྟོག་པ་མ་སྤངས་པའི་ཕྱིར་རོ་༎
 anantaviniścayaprabhedāgāmbhīryāyāṃ vijñaptimātratāyāṃ |	རྣམ་པར་རིག་པ་ཙམ་གྱིས་རབ་ཏུ་དབྱེ་བ་རྣམ་པར་ངེས་པ་མཐའ་ཡས་ལ་གཏིང་མི་དཔོགས་ཤིང་ཟབ་བའི་། 
 vijñaptimātratāsiddhiḥ svaśaktisadṛśī mayā |	རྣམ་རིག་ཙམ་དུ་གྲུབ་པ་འདི་༎ བདག་གིས་བདག་གི་མཐུ་འདྲ་བར་༎ བྱས་ཀྱི་དེ་ཡི་རྣམ་པ་ཀུན་༎
 kṛteyaṃ sarvathā sā tu na cintyā	བསམ་ཡས་།
 sarvaprakārā tu sā mādṛśaiś cintayituṃ na śakyate |	བདག་འདྲ་བས་རྣམ་པ་ཐམས་ཅད་ནི་བསམ་པར་མི་ནུས་ཏེ་།
 tarkāviṣayatvāt |	རྟོག་གེའི་སྤྱོད་ཡུལ་མ་ཡིན་པའི་༄༡༠ཨ་༌་༎ ཕྱིར་རོ་༎
 kasya punaḥ sā sarvathā gocara ity āha |	འོ་ན་དེ་རྣམ་པ་ཐམས་ཅད་དུ་སུའི་སྤྱོད་ཡུལ་སྙམ་པ་ལ་།
 buddhagocaraḥ || 22 ||	སངས་རྒྱས་སྤྱོད་ཡུལ་ལོ་ཞེས་བྱ་བ་སྨོས་ཏེ་།
 buddhānāṃ hi sā bhagavatāṃ sarvaprakāraṃ gocaraḥ sarvākārasarvajñeyajñānāvighātād iti || viṃśatikā vijñaptimātratāsiddhiḥ |	དེ་ནི་སངས་རྒྱས་བཅོམ་ལྡན་འདས་རྣམས་ཀྱི་སྤྱོད་ཡུལ་ཏེ་། ཤེས་བྱ་ཐམས་ཅད་ཀྱི་རྣམ་པ་ཐམས་ཅད་ལ་མཁྱེན་པ་ཐོགས་པ་མི་མངའ་བའི་ཕྱིར་རོ་༎
