skt	tib
 abhidharmakośabhāṣyam prathamaṃ kośasthānam oṃ namo buddhāya	༄༡བ་༅་༎ རྒྱ་གར་སྐད་དུ་། ཨཨ་བྷི་དྷརྨ་ཀོ་ཤའ་ཀའ་རི་ཀའ་། བོད་སྐད་དུ་། ཆོས་མངོན་པའི་མཛོད་ཀྱི་ཚིག་ལེའུར་བྱས་པ་། འཇམ་དཔལ་གཞོན་ནུར་གྱུར་པ་ལ་ཕྱག་འཚལ་ལོ་༎
 yaḥ sarvathāsarvahatāndhakāraḥ saṃsārapaṅkājjagadujjahāra |	dd་གང་ཞིག་ཀུན་ལ་མུན་པ་གཏན་བཅོམ་ཞིང་༎ འཁོར་བའི་འདམ་ལས་འགྲོ་བ་དྲངས་མཛད་པ་༎
 tasmai namaskṛtya yathārthaśāstre śāstraṃ pravakṣyāmyabhidharmakośam || vakk_1|1 ||	དོན་བཞིན་སྟོན་པ་དེ་ལ་ཕྱག་འཚལ་ནས་༎ ཆོས་མངོན་མཛོད་ཀྱི་བསྟན་བཅོས་རབ་བཤད་བྱ་༎
 prajñāmalā sānucarābhidharmaḥ tatprāptaye yāpi ca yacca śāstram |	ཆོས་མངོན་ཤེས་རབ་དྲི་མེད་རྗེས་འབྲང་བཅས་༎ དེ་ཐོབ་བྱ་ཕྱིར་གང་དང་བསྟན་བཅོས་གང་༎ འདིར་དེ་དོན་དུ་ཡང་དག་ཆུད་ཕྱིར་རམ་༎
 tasyārthato 'smin samanupraveśāt sa cā śrayo 'syetyabhidharmakośam || vakk_1|2 ||	འདི་ཡི་གནས་དེ་ཡིན་པས་ཆོས་མངོན་མཛོད་༎
 dharmāṇāṃ pravicayamantareṇa nāsti kleśānāṃ yata upaśāntaye 'bhyupāyaḥ |	ཆོས་རྣམས་རབ་ཏུ་རྣམ་འབྱེད་མེད་པར་ཉོན་མོངས་རྣམས་༎ གང་ཕྱིར་ཉེ་བར་ཞི་བར་བྱ་བའི་ཐབས་མེད་ལ་༎
 kleśaiśca bhramati bhavārṇave 'tra lokastaddhetorata uditaḥ kilaiṣa śāstrā || vakk_1|3 ||	ཉོན་མོངས་པས་ཀྱང་འཇིག་རྟེན་སྲིད་མཚོ་འདིར་འཁྱམས་ཏེ་༎ དེ་བས་དེ་ཕྱིར་འདི་ནི་སྟོན་པས་གསུངས་སོ་ལོ་༎
 sāsravānāsravā dharmāḥ saṃskṛtā mārgavarjitāḥ |	ཟག་བཅས་ཟག་པ་མེད་ཆོས་རྣམས་༎ ལམ་མ་གཏོགས་པའི་འདུས་བྱས་རྣམས་༎
 sāsravāḥ āsravāsteṣu yasmātsamanuśerate || vakk_1|4 ||	ཟག་བཅས་གང་ཕྱིར་དེ་དག་ལ་༎ ༄༢ཨ་༌་༎ ཟག་རྣམས་ཀུན་ཏུ་རྒྱས་པར་འགྱུར་༎
 anāsravā mārgasatyaṃ trividhaṃ cāpyasaṃskṛtam |	ཟག་མེད་ལམ་གྱི་བདེན་པ་དང་༎ འདུས་མ་བྱས་རྣམ་གསུམ་ཡང་སྟེ་༎
 ākāśaṃ dvau nirodhau ca tatrākāśamanāvṛtiḥ || vakk_1|5 ||	ནམ་མཁའ་དང་ནི་འགོག་པ་གཉིས་༎ དེ་ལ་ནམ་མཁའ་མི་སྒྲིབ་པའོ་༎
 pratisaṃkhyānirodho yo visaṃyogaḥ pṛthak pṛthak |	སོ་སོར་བརྟགས་པས་འགོག་པ་གང་༎ བྲལ་བའོ་སོ་སོ་སོ་སོ་ཡིན་༎ སྐྱེ་ལ་གཏན་དུ་གེགས་བྱེད་པ་༎
 utpādātyantavighno 'nyo nirodho 'pratisaṃkhyayā || vakk_1|6 ||	འགོག་གཞན་སོ་སོར་བརྟགས་མིན་པས་༎
 te punaḥ saṃskṛtā dharmā rūpādiskandhapañcakam |	འདུས་བྱས་ཆོས་རྣམས་དེ་དག་ཀྱང་༎ གཟུགས་ལ་སོགས་པའི་ཕུང་པོ་ལྔ་༎
 sa evādhvā kathāvastu saniḥsārāḥ savastukāḥ || vakk_1|7 ||	དེ་དག་ཉིད་དུས་གཏམ་གཞི་དང་༎ ངེས་པར་འབྱུང་བཅས་གཞི་དང་བཅས་༎
 ye sāsravā upādānaskandhāste saraṇā api |	གང་དག་ཟག་བཅས་ཉེར་ལེན་པའི་༎ ཕུང་པོའང་དེ་དག་འཐབ་བཅས་ཀྱང་༎
 duḥkhaṃ samudayo loko dṛṣṭisthānaṃ bhavaśca te || vakk_1|8 ||	སྡུག་བསྔལ་ཀུན་འབྱུང་འཇིག་རྟེན་དང་༎ ལྟ་གནས་སྲིད་པའང་དེ་དག་ཡིན་༎
 rūpaṃ pañcendriyāṇyarthāḥ pañcāvijñaptireva ca |	གཟུགས་ནི་དབང་པོ་ལྔ་དང་དོན་༎ ལྔ་དང་རྣམ་རིག་བྱེད་མིན་ཉིད་༎
 tadvijñānāśrayā rūpaprasādāścakṣurādayaḥ || vakk_1|9 ||	དེ་དག་རྣམས་ཀྱི་རྣམ་ཤེས་རྟེན་༎ མིག་ལ་སོགས་གཟུགས་དང་བ་རྣམས་༎
 rūpaṃ dvidhā viṃśatidhā śabdastvaṣṭavidhaḥ rasaḥ |	གཟུགས་རྣམ་གཉིས་དང་རྣམ་ཉི་ཤུ་༎ སྒྲ་ནི་རྣམ་པ་བརྒྱད་ཡོད་དེ་༎
 ṣoḍhā caturvidho gandhaḥ spṛśyamekādaśātmakam || vakk_1|10 ||	རོ་ནི་རྣམ་དྲུག་དྲི་རྣམ་བཞི་༎ རེག་བྱ་བཅུ་གཅིག་བདག་ཉིད་དོ་༎
 vikṣiptācittakasyāpi yo 'nubandhaḥ śubhāśubhaḥ |	ག-ཡེངས་དང་སེམས་མེད་པ་ཡི་ཡང་༎ དགེ་དང་མི་དགེ་རྗེས་འབྲེལ་གང་༎
 mahābhūtānyupādāya sa hyavijñaptirucyate || vakk_1|11 ||	འབྱུང་བ་ཆེ་རྣམས་རྒྱུར་བྱས་པ་༎ དེ་ནི་རྣམ་རིག་བྱེད་མིན་བརྗོད་༎
 bhūtāni pṛthividhāturaptejovāyudhātavaḥ |	འབྱུང་བ་དག་ནི་ས་༄༢བ་ཁམས་དང་༎ ཆུ་དང་མེ་དང་རླུང་ཁམས་རྣམས་༎
 dhṛtyādikarmasaṃsiddhā kharasnehoṣṇateraṇāḥ || vakk_1|12 ||	འཛིན་པ་ལ་སོགས་ལས་སུ་གྲུབ་༎ སྲ་གཤེར་དྲོ་ཉིད་ག-ཡོ་བ་རྣམས་༎
 pṛthivī varṇasaṃsthānamucyate lokasaṃjñayā |	འཇིག་རྟེན་གྱི་ནི་ཐ་སྙད་དུ་༎ ཁ་དོག་དབྱིབས་ལ་ས་ཞེས་བརྗོད་༎
 āpastejaśca vāyustu dhātureva tathāpi ca || vakk_1|13 ||	ཆུ་མེ་ཡང་ངོ་རླུང་ཚོགས་ཁམས་༎ ཉིད་ཡིན་དེ་དང་འདྲ་བའང་ཡིན་༎
 indriyārthāsta eveṣṭā daśāyatanadhātavaḥ |	དབང་དོན་དེ་དག་ཁོ་ན་ལ་༎ སྐྱེ་མཆེད་དང་ནི་ཁམས་བཅུར་འདོད་༎
 vedanānubhavaḥ saṃjñā nimittodgrahaṇātmikā || vakk_1|14 ||	ཚོར་བ་མྱོང་བའོ་འདུ་ཤེས་ནི་༎ མཚན་མར་འཛིན་པའི་བདག་ཉིད་དོ་༎
 caturbhyo 'nye tu saṃskāraskandhaḥ ete punastrayaḥ |	འདུ་བྱེད་ཕུང་པོ་བཞི་ལས་གཞན་༎
 dharmāyatanadhātvākhyāḥ sahāvijñaptyasaṃskṛtai || vakk_1|15 ||	དེ་གསུམ་རྣམ་རིག་བྱེད་མིན་དང་༎ འདུས་མ་བྱས་རྣམས་བཅས་པ་ནི་༎ ཆོས་ཀྱི་སྐྱེ་མཆེད་ཁམས་ཞེས་བྱ་༎
 vijñānaṃ prativijñaptiḥ mana āyatanaṃ ca tat |	རྣམ་ཤེས་སོ་སོར་རྣམ་རིག་པ་༎ ཡིད་ཀྱི་སྐྱེ་མཆེད་ཀྱང་དེ་ཡིན་༎
 dhātavaḥ sapta ca matāḥ ṣaḍ vijñānānyatho mahaḥ || vakk_1|16 ||	ཁམས་བདུན་དག་ཏུའང་འདོད་པ་སྟེ་༎ རྣམ་པར་ཤེས་པ་དྲུག་དང་ཡིད་༎
 ṣaṇṇāmanantarātītaṃ vijñānaṃ yaddhi tanmanaḥ |	དྲུག་པོ་འདས་མ་ཐག་པ་ཡི་༎ རྣམ་ཤེས་གང་ཡིན་དེ་ཡིད་དོ་༎
 ṣaṣṭhāśrayaprasiddhayarthaṃ dhatavo 'ṣṭādaśa smṛtāḥ || vakk_1|17 ||	དྲུག་པའི་རྟེན་ནི་རབ་བསྒྲུབ་ཕྱིར་༏་། ཁམས་ནི་བཅོ་བརྒྱད་དག་ཏུ་འདོད་༎
 sarvasaṃgraha ekena skandhenāyatanena ca |	ཕུང་པོ་དང་ནི་སྐྱེ་མཆེད་དང་༎ ཁམས་གཅིག་གིས་ནི་ཐམས་ཅད་བསྡུས་༎
 dhātunā ca svabhāvena parabhāvaviyogataḥ || vakk_1|18 ||	རང་གི་ངོ་བོ་ཉིད་ཀྱིས་ཏེ་༎ གཞན་གྱི་དངོས་དང་མི་ལྡན་ཕྱིར་༎ མིག་ལ་སོགས་པ་གཉིས་མོད་ཀྱི་༎
 jātigocaravijñānasāmānyādekadhātutā |	རིགས་དང་སྤྱོད་ཡུལ་རྣམ་པར་ཤེས་༏་།འདྲ་བའི་ཕྱིར་ན་ཁམས་གཅིག་ཉིད་༎
 dvitve 'pi cakṣurādīnāṃ śobhārtha tu dvayodbhavaḥ || vakk_1|19 ||	མཛེས་བྱའི་ཕྱིར་ན་གཉིས་བྱུང་ངོ་༎
 rāśyāyadvāragotrārthāḥ skandhāyatanadhātavaḥ |	སྤུངས་དང་སྐྱེ་སྒོ་རིགས་ཀྱི་དོན་༎ ཕུང་པོ་སྐྱེ་མཆེད་ཁམས་རྣམས་ཡིན་༎
 mohendriyarūcitraidhāttistraḥ skandhādideśanāḥ || vakk_1|20 ||	རྨོངས་དབང་འདོད་རྣམ་གསུམ་གྱི་ཕྱིར་༎ ཕུང་པོ་ལ་སོགས་གསུམ་བསྟན་ཏོ་༎
 vivādamūlasaṃsārahetutvāt kramakāraṇāt |	རྩོད་པའི་རྩ་བར་འགྱུར་པ་དང་༎ འཁོར་བའི་རྒྱུ་ཕྱིར་རིམ་རྒྱུའི་ཕྱིར་༎
 caittebhyo vedanāsaṃjñe pṛthakskandhau niveśitau || vakk_1|21 ||	སེམས་བྱུང་རྣམས་ལས་ཚོར་བ་དང་༎ འདུ་ཤེས་ལོགས་ཤིག་ཕུང་པོར་གཞག་། 
 skandheṣva saṃskṛtaṃ noktamarthāyogāt kramaḥ punaḥ |	ཕུང་པོ་དག་ཏུ་འདུས་མ་བྱས་༎ དོན་དུ་མི་རུང་ཕྱིར་མ་བཤད་༎
 yathaudārikasaṃklesabhājanādyarthadhātutaḥ || vakk_1|22 ||	རིམ་ནི་རགས་དང་ཀུན་ཉོན་མོངས་༎ སྣོད་སོགས་དོན་ཁམས་ཇི་བཞིན་ནོ་༎ ད་ལྟའི་དོན་ཕྱིར་དང་པོ་ལྔ་༎
 prāk pañca vārttamānārthyāt bhautikārthyāccatuṣṭayam |	འབྱུང་བ་ལས་གྱུར་དོན་ཕྱིར་བཞི་༎
 dūrāśutaravṛttyānyat yathāsthānaṃ kramo 'thavā || vakk_1|23 ||	གཞན་ནི་ཆེས་རིང་མྱུར་འཇུག་ཕྱིར་༎ ཡང་ན་ཇི་ལྟར་གནས་བཞིན་རིམ་༎
 viśeṣaṇārthaṃ prādhānyabdahudharmāgrasaṃgrahāt |	བྱེ་བྲག་དོན་དང་གཙོ་བོའི་ཕྱིར་༎ ཆོས་མང་བ་དང་མཆོག་བསྡུས་ཕྱིར་༎
 ekamāyatanaṃ rūpamekaṃ dharmākhyamucyate || vakk_1|24 ||	གཅིག་ནི་གཟུགས་ཀྱི་སྐྱེ་མཆེད་༄༣ཨ་༌་༎ དང་༏་། གཅིག་ནི་ཆོས་ཞེས་བྱ་བར་བརྗོད་༎
 dharmaskandhasahasrāṇi yānyaśītiṃ jagau muniḥ |	ཆོས་ཀྱི་ཕུང་པོ་བརྒྱད་ཁྲི་དག་། གང་རྣམས་ཐུབ་པས་གསུངས་དེ་དག་། 
 tāni vāṅnāma vetyeṣāṃ rūpasaṃskārasaṃgrahaḥ || vakk_1|25 ||	ཚིག་གམ་མིང་ཡིན་དེ་དག་ནི་༎ གཟུགས་དང་འདུ་བྱེད་དག་ཏུ་འདུས་༎
 śāstrapramāṇā ityeke skandhādīnāṃ kathaikaśaḥ |	ཁ་ཅིག་བསྟན་བཅོས་ཚད་ཅེས་ཟེར་༎ ཕུང་པོ་ལ་སོགས་གཏམ་རེ་ཡིན་༎
 caritapratipakṣastu dharmaskandho 'nuvarṇitaḥ || vakk_1|26 ||	སྤྱོད་པ་རྣམས་ཀྱི་གཉེན་པོར་ནི་༎ ཆོས་ཀྱི་ཕུང་པོ་མཐུན་པར་གསུངས་༎
 tathānye 'pi yathāyogaṃ skandhāyatanadhātavaḥ |	དེ་བཞིན་གཞན་ཡང་ཅི་རིགས་པར་༎ ཕུང་པོ་སྐྱེ་མཆེད་ཁམས་རྣམས་ནི་༎
 pratipādyā yathokteṣu saṃpradhārya svalakṣaṇam || vakk_1|27 ||	རང་གི་མཚན་ཉིད་ལེགས་དཔྱད་དེ་༎ ཇི་སྐད་བཤད་པར་བསྡུ་བར་བྱ་༎
 chidramākāśadhātvākhyam ālokatamasī kila |	བུ་ག་ནམ་མཁའི་ཁམས་ཤེས་བྱ་༎ སྣང་དང་མུན་པ་དག་ཡིན་ལོ་༎
 vijñānadhāturvijñānaṃ sāsravaṃ janmaniśrayāḥ || vakk_1|28 ||	ཟག་དང་བཅས་པའི་རྣམ་ཤེས་ནི་༎ རྣམ་ཤེས་ཁམས་ཡིན་སྐྱེ་བའི་རྟེན་༎
 sanidarśana eko 'tra rūpaṃ sapratighā daśa |	བསྟན་ཡོད་འདིར་ནི་གཟུགས་གཅིག་པུ་༎ ཐོགས་དང་བཅས་པ་གཟུགས་ཅན་བཅུ་༎
 rūpiṇaḥ avyākṛtā aṣṭau ta evārūpaśabdakāḥ || vakk_1|29 ||	ལུང་མ་བསྟན་བརྒྱད་དེ་དག་ཉིད་༎
 tridhānye kāmadhātvāptāḥ sarve rūpe caturdaśa |	གཟུགས་སྒྲ་མ་གཏོགས་གཞན་རྣམ་གསུམ་༎ འདོད་ཁམས་གཏོགས་པ་ཐམས་ཅད་དོ་༎ གཟུགས་ཀྱི་ཁམས་ན་བཅུ་བཞིའོ་༎
 vinā gandharasaghrāṇajivhāvijñānadhātubhiḥ || vakk_1|30 ||	དྲི་དང་རོ་དང་སྣ་དང་ནི་༎ ལྕེ་ཡི་རྣམ་ཤེས་ཁམས་མ་གཏོགས་༎
 ārūpyāptā manodharmamanovijñānadhātavaḥ |	གཟུགས་མེད་གཏོགས་པ་ཡིད་དང་ནི་༎ ཆོས་དང་ཡིད་ཀྱི་རྣམ་ཤེས་ཁམས་༎
 sāsravānāsravā ete trayaḥ śeṣāstu sāsravāḥ || vakk_1|31 ||	དེ་གསུམ་ཟག་བཅས་ཟག་པ་མེད་༎ ལྷག་མ་རྣམས་ནི་ཟག་བཅས་སོ་༎
 savitarkavicārā hi pañca vijñānadhātavaḥ |	རྟོག་དང་དཔྱོད་དང་བཅས་པ་ནི་༎ རྣམ་པར་ཤེས་པའི་ཁམས་ལྔ་ཡིན་༎
 antyāstrayastriprakārāḥ śeṣā ubhayavarjitāḥ || vakk_1|32 ||	ཐ་མ་གསུམ་ནི་རྣམ་གསུམ་མོ་༎ ལྷག་མ་རྣམས་ནི་གཉིས་ཀ་སྤངས་༎
 nirūpaṇānusmaraṇavikalpenāvikalpakāḥ |	ངེས་པར་རྟོག་དང་རྗེས་དྲན་པའི་༎ རྣམ་པར་རྟོག་པས་རྣམ་མི་རྟོག་། 
 tau prajñāmānasī vyagrā smṛtiḥ sarvaiva mānasī || vakk_1|33 ||	དེ་དག་ཡིད་ཀྱི་ཤེས་རབ་ག-ཡེང་༎ ཡིད་ཀྱི་དྲན་པ་ཐམས་ཅད་ཉིད་༎
 sapta sālambanāścittadhātavaḥ ardhaṃ ca dharmataḥ |	དམིགས་བཅས་སེམས་ཀྱི་ཁམས་བདུན་ནོ་༎ ཆོས་ཀྱི་ཕྱེད་ཀྱང་མ་ཟིན་དགུ་༎
 navānupāttā te cāṣṭau śabdaśca anye nava dvidhā || vakk_1|34 ||	བརྒྱད་པོ་དེ་དག་རྣམས་དང་སྒྲ་༎ དགུ་པོ་གཞན་ནི་རྣམ་པ་གཉིས་༎
 spraṣṭavyaṃ dvividhaṃ śeṣā rūpiṇo nava bhautikāḥ |	རེག་བྱ་རྣམ་པ་གཉིས་ཡིན་ཏེ་༎ ལྷག་མ་གཟུགས་ཅན་དགུ་པོ་ནི་༎
 dharmadhātvekadeśaśca saṃcitā daśa rūpiṇaḥ || vakk_1|35 ||	འབྱུང་གྱུར་ཆོས་ཁམས་ཕྱོགས་གཅིག་ཀྱང་༎ གཟུགས་ཅན་བཅུ་ནི་བསགས་པའོ་༎
 chinatti chidyate caiva bāhyaṃ dhātu catuṣṭayam |	གཅོད་བྱེད་གཅད་པར་བྱ་བ་ཉིད་༎ ཕྱི་རོལ་གྱི་ནི་ཁམས་བཞི་ཡིན་༎
 dahyate tulayatyevaṃ vivādo dagdhṛtulyayoḥ || vakk_1|36 ||	དེ་བཞིན་བསྲེག་བྱ་འཇལ་༄༣བ་བྱེད་པའོ་༎ སྲེག་དང་གཞལ་ལ་མི་མཐུན་སྨྲ་༎
 vipākajaupacayikāḥ pañcādhyātmaṃ vipākajaḥ |	རྣམ་པར་སྨིན་ལས་བྱུང་བ་དང་༎ རྒྱས་ལས་བྱུང་བ་ནང་གི་ལྔ་༎
 na śabdaḥ apratighā aṣṭau naiḥṣyandika vipākajāḥ || vakk_1|37 ||	སྒྲ་ནི་རྣམ་སྨིན་ལས་སྐྱེས་མིན་༎ རྒྱུ་མཐུན་ལས་བྱུང་རྣམ་སྨིན་སྐྱེས་༎ ཐོགས་པ་མེད་བརྒྱད་གཞན་རྣམ་གསུམ་༎
 tridhānye dravyavānekaḥ kṣaṇikāḥ paścimāstrayaḥ |	རྫས་དང་ལྡན་གཅིག་ཐ་མ་གསུམ༎
 cakṣurvijñānadhātvoḥ syāt pṛthak lābhaḥ sahāpi ca || vakk_1|38 ||	སྐད་ཅིག་མ་སྟེ་མིག་དང་ནི་༎ རྣམ་ཤེས་ཁམས་དག་སོ་སོ་དང་༎ ལྷན་ཅིག་ཏུ་ཡང་འཐོབ་པ་ཡོད་༎
 dvādaśādhyātmikāḥ hitvā rūpādīn dharmasaṃjñakaḥ |	ནང་གི་བཅུ་གཉིས་གཟུགས་ལ་སོགས་༎ མ་གཏོགས་ཆོས་ཞེས་བྱ་བ་ནི་༎
 sabhāgaḥ tatsabhāgāśca śeṣāḥ yo na svakarmakṛt || vakk_1|39 ||	སྟེན་པ་དང་བཅས་ལྷག་མ་ནི་༎ དེ་དང་མཚུངས་པ་དག་ཀྱང་ཡིན་༎ གང་ཞིག་རང་གི་ལས་མི་བྱེད་༎
 daśa bhāvanayā heyāḥ pañca ca antyāstrayastridhā |	བཅུ་ནི་བསྒོམ་པས་སྤང་བྱ་ཡིན་༎ ལྔ་ཡང་ཐ་མ་གསུམ་རྣམ་གསུམ་༎
 na dṛṣṭiheyamakliṣṭaṃ na rūpaṃ nāpyaṣaṣṭhajam || vakk_1|40 ||	ཉོན་མོངས་ཅན་མིན་མཐོང་སྤང་མིན་༎ གཟུགས་མིན་དྲུག་པ་མིན་སྐྱེས་མིན་༎
 cakṣuśca dharmadhātośca pradeśau dṛṣṭiḥ aṣṭadhā |	མིག་དང་ཆོས་ཀྱི་ཁམས་ཕྱོགས་ནི་༎ ལྟ་བ་ཡིན་ཏེ་རྣམ་པ་བརྒྱད་༎
 pañcavijñānasahajā dhīrna dṛṣṭiratīraṇāt || vakk_1|41 ||	རྣམ་ཤེས་ལྔ་དང་མཚུངས་སྐྱེས་བློ་༎ ངེས་རྟོག་མེད་ཕྱིར་ལྟ་མ་ཡིན་༎
 cakṣuḥ paśyati rūpāṇi sabhāgaṃ na tadāśritam |	མིག་གིས་གཟུགས་རྣམས་མཐོང་སྟེན་བཅས་༎ དེ་ལ་བརྟེན་པའི་རྣམ་ཤེས་མིན་༎
 vijñānaṃ dṛśyate rūpaṃ na kilāntaritaṃ yataḥ || vakk_1|42 ||	གང་ཕྱིར་བར་དུ་ཆོད་པ་ཡི་༎ གཟུགས་ནི་མཐོང་བ་མིན་ཕྱིར་ལོ་༎
 ubhābhyāmapi cakṣurbhyāṃ paśyati vyaktadarśanāt |	མིག་ནི་གཉིས་ཀ་དག་གིས་ཀྱང་༎ མཐོང་སྟེ་གསལ་བར་མཐོང་ཕྱིར་རོ་༎
 cakṣuḥśrotramano 'prāptaviṣayaṃ trayamanyathā || vakk_1|43 ||	མིག་དང་ཡིད་དང་རྣ་བ་ནི་༎ ཡུལ་དང་མ་ཕྲད་གསུམ་གཞན་དུ་༎
 tribhirghrāṇādibhistulyaviṣayagrahaṇaṃ matam |	སྣ་ལ་སོགས་པ་གསུམ་གྱིས་ནི་༎ ཡུལ་ནི་མཉམ་པ་འཛིན་པར་འདོད་༎
 caramasyāśrayo 'tītaḥ pañcānāṃ sahajaśca taiḥ || vakk_1|44 ||	ཐ་མའི་རྟེན་འདས་ལྔ་རྣམས་ཀྱི་༎ དེ་དག་ལྷན་ཅིག་སྐྱེས་པའང་ཡིན་༎
 tadvikāravikāritvādāśrayāścakṣurādayaḥ |	དེ་དག་གྱུར་པས་འགྱུར་ཉིད་ཕྱིར་༎ རྟེན་ནི་མིག་ལ་སོགས་པ་ཡིན་༎
 ato 'sādhāraṇatvāddhi vijñānaṃ tairnirucyate || vakk_1|45 ||	དེ་ཕྱིར་ཐུན་མོང་མ་ཡིན་ཕྱིར་༎ དེ་དག་གིས་ནི་རྣམ་ཤེས་བསྟན་༎
 na kāyasyādharaṃ cakṣuḥ ūrdhvaṃ rūpaṃ na cakṣuṣaḥ |	ལུས་ལ་འོག་མའི་མིག་མ་ཡིན་༎ མིག་གི་གོང་མའི་གཟུགས་མ་ཡིན་༎
 vijñānaṃ ca asya rūpaṃ tu kāyasyobhe ca sarvataḥ || vakk_1|46 ||	རྣམ་པར་ཤེས་པའང་དེ་ཡི་གཟུགས་༎ ལུས་ཀྱིའང་གཉིས་ཀ་ཐམས་ཅད་དུ་༎
 tathā śrotraṃ trayāṇāṃ tu sarvameva svabhūmikam |	རྣ་བའང་དེ་བཞིན་གསུམ་དག་ནི་༎ ཐམས་ཅད་རང་གི་ས་པ་ཉིད་༎
 kāyavijñānamadharasvabhūmi aniyataṃ manaḥ || vakk_1|47 ||	ལུས་ཀྱི་རྣམ་ཤེས་འོག་དང་ནི་༎ རང་གི་ས་ཡིད་མ་ངེས་ཏེ་༎
 pañca bāhyā divijñeyāḥ nityā dharmā asaṃskṛtāḥ |	གཉིས་ཀྱིས་རྣམ་ཤེས་ཕྱི་ཡི་ལྔ་༎ འདུས་མ་བྱས་ཆོས་རྟག་པའོ་༎
 dharmārdhamindriyaṃ ye ca dvādaśādhyātmikāḥ smṛtāḥ || vakk_1|48 ||	ཆོས་ཀྱི་ཕྱེད་དང་གང་དག་ནི་༎ བཅུ་གཉིས་ནང་གིར་བཤད་དབང་པོ་༎
 abhidharmakośabhāṣye dhātunirdeśo nāma prathamaṃ kośasthānaṃ samāptamiti | ye dharmā hetuprabhavā hetusteṣāṃ tathāgato hyavadat | teṣāṃ ca yo nirodha evaṃvādī mahāśramaṇaḥ || likhāpitamidaṃ śrīlāmāvākeneti |	ཆོས་༄༤ཨ་༌་༎ མངོན་པའི་མཛོད་ཀྱི་ཚིག་ལེའུར་བྱས་པ་ལས་༎
 dvitīyaṃ kośasthānam	ཁམས་བསྟན་པ་ཞེས་བྱ་བ་སྟེ་གནས་དང་པོའོ་།
 caturṣvartheṣu pañcānāmādhipatyaṃ dvayoḥ kila |	༎ ། ལྔ་པོ་རྣམས་ནི་དོན་བཞི་ལ་༎ དབང་བྱེད་བཞི་རྣམས་གཉིས་ལ་ལོ་༎
 caturṇṇāṃ pañcakāṣṭānāṃ saṃkleśavyavadānayoḥ || vakk_2|1 ||	ལྔ་དང་བརྒྱད་པོ་དེ་རྣམས་ནི་༎ ཀུན་ནས་ཉོན་མོངས་རྣམ་བྱང་ལ་༏་། རང་གི་དོན་དང་ཐམས་ཅད་ལ་༎
 svārthopalabdhyādhipatyāt sarvasya ca ṣaḍindriyam |	དམིགས་པར་དབང་བྱེད་ཕྱིར་དབང་དྲུག་། 
 strītvapuṃstvādhipatyāttu kāyāt strīpuruṣendriye || vakk_2|2 ||	མོ་ཉིད་ཕོ་ཉིད་ལ་དབང་ཕྱིར་༎ ལུས་ལས་མོ་དང་ཕོ་དབང་དག་། 
 nikāyasthitisaṃkleśavyavadānādhipatyataḥ |	རིགས་གནས་ཀུན་ནས་ཉོན་མོངས་དང་༎ རྣམ་པར་བྱང་ལ་དབང་བྱེད་ཕྱིར་༎
 jīvitaṃ vedanāḥ pañca śraddhādyāścendriyaṃ matāḥ || vakk_2|3 ||	སྲོག་དང་ཚོར་བ་རྣམས་དང་ནི་༎ དད་སོགས་དབང་པོ་ལྔར་འདོད་དོ་༎ མྱ་ངན་འདས་སོགས་གོང་ནས་གོང་༎ འཐོབ་པ་ལ་ནི་དབང་བྱེད་ཕྱིར་༎
 ājñāsyāmyākhyamājñākhyamājñātāvīndriyaṃ tathā | uttarottarasaṃprāptinirvāṇādyādhipatyataḥ || vakk_2|4 ||	། ཀུན་ཤེས་བྱེད་དང་ཀུན་ཤེས་དང་༎ དེ་བཞིན་ཀུན་ཤེས་ལྡན་དབང་པོ་༎
 cittāśrayastadvikalpaḥ sthitiḥ saṃkleśa eva ca |	།
 saṃbhāro vyavadānaṃ ca yāvatā tāvadindriyam || vakk_2|5 ||	ཚོགས་དང་རྣམ་བྱང་ཇི་སྙེད་པ་༎ དབང་པོ་དག་ཀྱང་དེ་སྙེད་དུ་༎
 pravṛtterāśrayotpattisthitipratyupabhogataḥ |	ཡང་ན་འཇུག་པའི་རྟེན་དང་ནི་༎ སྐྱེ་དང་གནས་དང་ཉེར་སྤྱོད་ལས་༎
 caturdaśa tathānyāni nivṛtterindriyāṇi vā || vakk_2|6 ||	བཅུ་བཞི་དེ་བཞིན་ལྡོག་པ་ལ་༎ དབང་པོ་རྣམས་ནི་གཞན་ཡིན་ནོ་༎
 duḥkhendriyamaśātā yā kāyikī vedanā sukham |	ལུས་ཚོར་སིམ་པ་མ་ཡིན་གང་༎ སྡུག་བསྔལ་དབང་པོའོ་སིམ་པ་ནི༎
 śātā dhyāne tṛtīye tu caitasī sā sukhendriyam || vakk_2|7 ||	བདེ་བའོ་བསམ་གཏན་གསུམ་པ་ན་༎ སེམས་ཀྱི་དེ་ནི་བདེ་དབང་པོ་༎
 anyatra sā saumanasyaṃ aśātā caitasī punaḥ |	གཞན་ན་དེ་ཡིད་བདེ་བ་ཡིན་༎ སེམས་ཀྱི་སིམ་པ་མ་ཡིན་པ་༎
 daurmanasyamupekṣā tu madhyā ubhayī avikalpanāt || vakk_2|8 ||	ཡིད་མི་བདེ་བའོ་བཏང་སྙོམས་ནི་༎ བར་མའོ་གཉིས་ཀའི་མི་རྟོག་ཕྱིར་༎
 dṛgbhāvanāśaikṣapathe nava trīṇi amalaṃ trayam |	མཐོང་བསྒོམ་མི་སློབ་ལམ་ལ་དགུ་༎ གསུམ་ཡིན་གསུམ་ནི་དྲི་མ་མེད་༎
 rūpīṇi jīvitaṃ duḥkhe sāsravāṇi dvidhā nava || vakk_2|9 ||	།
 vipāko jīvitaṃ dvedhā dvādaśa antyāṣṭakādṛte |	སྲོག་ནི་རྣམ་སྨིན་བཅུ་གཉིས་གཉིས་༎
 daurmanasyācca tattvekaṃ savipākaṃ daśa dvidhā || vakk_2|10 ||	ཐ་མ་བརྒྱད་དང་ཡིད་མི་བདེ་༎ མ་གཏོགས་པ་སྟེ་དེ་གཅིག་ནི་༎ རྣམ་པར་སྨིན་བཅས་བཅུ་རྣམ་གཉིས་༎
 mano 'nyavittiśraddhādīni aṣṭakaṃ kuśalaṃ dvidhā |	ཡིད་དང་ཚོར་གཞན་དད་ལ་སོགས་༎
 daurmanasyaṃ mano 'nyā ca vittistredhā anyadekadhā || vakk_2|11 ||	དགེ་བ་བརྒྱད་ཡིད་མི་བདེ་བ་༎ རྣམ་གཉིས་ཡིད་དང་ཚོར་གཞན་ནི་༎ རྣམ་གསུམ་གཞན་ནི་རྣམ་པ་གཅིག་། 
 kāmāptamamalaṃ hitvā rūpāptaṃ strīpumindriye |	དྲི་མེད་མ་གཏོགས་འདོད་པར་གཏོགས་༎
 duḥkhe ca hitvā ārūpyāptaṃ sukhe cāpohya rūpi ca || vakk_2|12 ||	ཕོ་མོའི་དབང་དང་སྡུག་བསྔལ་དག་། མ་གཏོགས་གཟུགས་གཏོགས་གཟུགས་ཅན་༄༤བ་དང་༏་། བདེ་བའང་མ་གཏོགས་གཟུགས་མེད་གཏོགས་༎
 manovittitrayaṃ tredhā dviheyā durmanaskatā |	ཡིད་དང་ཚོར་བ་གསུམ་རྣམ་གསུམ་༎ གཉིས་ཀྱིས་སྤང་བྱ་ཡིད་མི་བདེ་༎
 nava bhavanayā pañca tvaheyānyapi na trayam || vakk_2|13 ||	དགུ་ནི་བསྒོམ་པས་ལྔ་པོ་ནི་༎ སྤང་བར་བྱ་མིན་ཡང་གསུམ་མིན་༎
 kāmeṣvādau vipāko dve labhyate nopapādukaiḥ |	འདོད་པར་དང་པོར་རྣམ་སྨིན་གཉིས་༎ རྙེད་དེ་རྫུས་ཏེ་སྐྱེ་བས་མིན་༎
 teḥ ṣaḍ vā sapta vā aṣṭau vā ṣaḍ rūpeṣu ekamuttare || vakk_2|14 ||	དེ་ཡིས་དྲུག་གམ་བདུན་ནམ་བརྒྱད་༎ གཟུགས་ན་དྲུག་གོ་གོང་མར་གཅིག་། གཟུགས་མེད་དག་ཏུ་འཆི་བ་ནི་༎
 nirodhayatyuparamānnārūpye jīvitaṃ manaḥ |	སྲོག་དང་ཡིད་དང་བཏང་སྙོམས་ཉིད་༎
 upekṣāṃ caiva rūpe 'ṣṭau kāme daśa navāṣṭau vā || vakk_2|15 ||	འགག་པར་འགྱུར་རོ་གཟུགས་ན་བརྒྱད་༎ འདོད་པར་བཅུའམ་དགུའམ་བརྒྱད་༎
 kramamṛtyau tu catvāri śubhe sarvatra pañca ca |	རིམ་གྱིས་འཆི་བ་དག་ལ་བཞི་༎ དགེ་ལ་ཐམས་ཅད་དག་ཏུ་ལྔ་༎
 navāptirantyaphalayoḥ saptāṣṭanavabhirdvayoḥ || vakk_2|16 ||	འབྲས་བུ་ཐ་མ་གཉིས་དགུས་འཐོབ་༎ གཉིས་ནི་བདུན་དང་བརྒྱད་དང་དགུས་༎
 ekādaśabhirarhattvamuktaṃ tvekasya saṃbhavāt |	བཅུ་གཅིག་དག་གིས་དགྲ་བཅོམ་ཉིད་༎ འགའ་ཞིག་སྲིད་ཕྱིར་བཤད་པ་ཡིན་༎
 upekṣajīvitamanoyukto 'vaśyaṃ trayānvitaḥ || vakk_2|17 ||	བཏང་སྙོམས་དང་ནི་སྲོག་དང་ནི་༎ ཡིད་དང་ལྡན་ལ་ངེས་གསུམ་ལྡན་༎
 caturbhiḥ sukhakāyābhyāṃ pañcabhiścakṣurādimān |	བདེ་ལུས་ལྡན་ལ་བཞི་དག་དང་༎ མིག་སོགས་ལྡན་ལ་ལྔ་དང་ལྡན་༎
 saumanasyī ca duḥkhī tu saptabhiḥ strīndriyādimān || vakk_2|18 ||	ཡིད་བདེ་ལྡན་ཡང་སྡུག་བསྔལ་ལྡན་༎ བདུན་དང་མོ་ཡི་དབང་སོགས་ལྡན་༎
 aṣṭābhiḥ ekādaśabhistvājñājñāte ndriyānvitaḥ |	བརྒྱད་དང་ཀུན་ཤེས་ལྡན་པ་ཡི་༎ དབང་པོ་ལྡན་ལ་བཅུ་གཅིག་ལྡན་༎
 ājñāsyāmīndriyopetastrayodaśabhiranvitaḥ || vakk_2|19 ||	ཀུན་ཤེས་བྱེད་པའི་དབང་ལྡན་ལ་༎ བཅུ་གསུམ་དག་དང་ལྡན་པ་ཡིན་༎ དགེ་མེད་ནང་ན་ཉུང་ལྡན་པ་༎
 sarvālpairniḥśubho 'ṣṭābhirvinmanaḥkāyajīvitaiḥ |	ལུས་ཚོར་སྲོག་ཡིད་བརྒྱད་དང་ལྡན་༎
 yuktaḥ bālastathārūpye upekṣāyurmanaḥśubhaiḥ || vakk_2|20 ||	གཟུགས་མེད་བྱིས་པའང་དེ་བཞིན་ཏེ་༎ བཏང་སྙོམས་སྲོག་ཡིད་དགེ་རྣམས་དང་༎ མང་པོར་ལྡན་ལ་བཅུ་དགུ་སྟེ་༎
 bahubhiryukta ekānnaviṃśatyāmalavarjitaiḥ |	དྲི་མ་མེད་རྣམས་མ་གཏོགས་སོ་༎
 dviliṅgaḥ āryo rāgī ekaliṅgadvayamalavarjitaiḥ || vakk_2|21 ||	མཚན་གཉིས་འཕགས་པ་ཆགས་བཅས་ཏེ་༎ མཚན་གཅིག་དྲི་མེད་གཉིས་མ་གཏོགས་༎
 kāme 'ṣṭadravyako 'śabdaḥ paramāṇuranindriyaḥ |	འདོད་ན་དབང་པོ་མེད་པ་དང་༎ སྒྲ་མེད་ཕྲ་རབ་རྡུལ་རྫས་བརྒྱད་༎
 kāyendriyī navadravyaḥ daśadravyo 'parendriyaḥ || vakk_2|22 ||	ལུས་དབང་ལྡན་ལ་རྫས་དགུའོ་༎ དབང་པོ་གཞན་ལྡན་རྫས་བཅུའོ་༎
 cittaṃ caittāḥ sahāvaśyaṃ sarva saṃskṛtalakṣaṇaiḥ |	སེམས་དང་སེམས་བྱུང་ངེས་ལྷན་ཅིག་། ཐམས་ཅད་འདུས་བྱས་མཚན་ཉིད་དང་༎ ཐོབ་པའམ་སེམས་བྱུང་རྣམ་ལྔ་སྟེ་༎
 prāptyā vā pañcadhā caittā mahābhūmyādibhedataḥ || vakk_2|23 ||	ས་མང་ལ་སོགས་ཐ་དད་ཕྱིར་༎
 vedanā cetanā saṃjñā cchandaḥ sparśo matiḥ smṛtiḥ |	ཚོར་དང་སེམས་པ་འདུ་ཤེས་དང་༎ འདུན་དང་རེག་དང་བློ་གྲོས་དྲན་༎
 manaskāro 'dhimokṣaśca samādhiḥ sarvacetasi || vakk_2|24 ||	ཡིད་ལ་བྱེད་དང་མོས་པ་དང་༎ ཏིང་ངེ་འཛིན་༄༥ཨ་༌་༎ སེམས་ཐམས་ཅད་ལ་༎
 śraddhāpramādaḥ praśrabdhirupekṣā hrīrapatrapā |	དད་དང་བག་ཡོད་ཤིན་ཏུ་སྦྱངས་༎ བཏང་སྙོམས་ངོ་ཚ་ཤེས་ཁྲེལ་ཡོད་༎
 mūladvayamahiṃsā ca vīryaṃ ca kuśale sadā || vakk_2|25 ||	རྩ་བ་གཉིས་རྣམ་མི་འཚེ་དང་༎ བརྩོན་འགྲུས་རྟག་ཏུ་དགེ་ལ་འབྱུང་༎
 mohaḥ pramādaḥ kauśīdyamāśraddhayaṃ styānamuddhavaḥ |	རྨོངས་དང་བག་མེད་ལེ་ལོ་དང་༎ མ་དད་པ་དང་རྨུགས་དང་རྒོད་༎ ཉོན་མོངས་ཅན་ལ་རྟག་ཏུ་འབྱུང་༎
 kliṣṭe sadaiva akuśale tvāhrīkyamanapatrapā || vakk_2|26 ||	མི་དགེ་ལ་ནི་ཁྲེལ་མེད་དང་༎ ངོ་ཚ་མེད་པའོ་ཁྲོ་བ་དང་༎ ཁོན་དུ་འཛིན་དང་ག-ཡོ་དང་ནི་༎
 krodhopanāhaśāṭhyerṣyāpradāsamrakṣamatsarāḥ |	ཕྲག་དོག་འཚིག་འཆབ་སེར་སྣ་དང་༎ སྒྱུ་དང་རྒྱགས་དང་རྣམ་འཚེ་ནི་༎
 māyāmadavihiṃsāśca parīttakleśabhūmikāḥ || vakk_2|27 ||	ཉོན་མོངས་ཆུང་ངུའི་ས་པ་རྣམས་༎
 savitarkavicāratvāt kuśale kāmacetasi |	འདོད་པའི་དགེ་བའི་སེམས་ལ་ནི་༎ རྟོག་དང་དཔྱོད་དང་བཅས་པའི་ཕྱིར་༎
 dvāṃviṃśatiścaitasikāḥ kaukṛtyamadhikaṃ kvacit || vakk_2|28 ||	སེམས་ལས་བྱུང་བ་ཉི་ཤུ་གཉིས་༎ ལ་ལ་དག་ཏུ་འགྱོད་པ་བསྣན་༎
 āveṇike tvakuśale dṛṣṭiyukte ca viṃśatiḥ |	མི་དགེ་བ་ནི་མ་འདྲེས་དང་༎ ལྟ་དང་ལྡན་ལའང་ཉི་ཤུ་འབྱུང་༎
 kleśaiścaturbhiḥ krodhādyaiḥ kaukṛtyenaikaviṃśatiḥ || vakk_2|29 ||	ཉོན་མོངས་བཞི་དང་ཁྲོ་སོགས་དང་༎ འགྱོད་པ་དང་ནི་ཉི་ཤུ་གཅིག་། 
 nivṛte 'ṣṭādaśa anyatra dvādaśāvyākṛte matāḥ |	བསྒྲིབས་ལ་བཅོ་བརྒྱད་ལུང་མ་བསྟན་༎ གཞན་ལ་བཅུ་གཉིས་དག་ཏུ་འདོད་༎
 middhaṃ sarvāvirodhitvādyatra syādadhikaṃ hi tat || vakk_2|30 ||	གཉིད་ནི་ཀུན་ལ་མི་འགལ་ཕྱིར་༎ གང་ལ་ཡོད་པ་དེ་བསྣན་ནོ་༎
 kaukṛtyamiddhākuśalānyādye dhyāne na santyataḥ |	དེ་ལས་འགྱོད་གཉིད་མི་དགེ་རྣམས་༎ བསམ་གཏན་དང་པོ་དག་ན་མེད་༎
 dhyānāntare vitarkaśca vicāraścāpyataḥ param || vakk_2|31 ||	རྟོག་པའང་བསམ་གཏན་ཁྱད་པར་ཅན་༎ དེ་ཡི་གོང་ན་དཔྱོད་པ་ཡང་༎
 ahrīragurutā avadye bhayādarśitva matrapā |	མ་གུས་ངོ་ཚ་མེད་ཁྲེལ་མེད་༎ ཁ་ན་མ་ཐོ་འཇིགས་མི་ལྟ་༎
 prema śraddhā gurutvaṃ hrīḥ te punaḥ kāmarūpayoḥ || vakk_2|33 ||	དགའ་དང་གུས་ཉིད་ངོ་ཚ་ཤེས་༎ དེ་གཉིས་འདོད་དང་གཟུགས་དག་ན་༎
 vitarkacārā vaudāryasūkṣmate māna unnatiḥ |	རྟོག་དང་དཔྱོད་པ་རྩིང་ཞིབ་ཉིད་༎ ང་རྒྱལ་ཁེངས་པ་རྒྱགས་པ་ནི་༎
 madaḥ svadharme raktasya paryādānaṃ tu cetasaḥ || vakk_2|33 ||	རང་གི་ཆོས་ལ་ཆགས་པ་ཡི་༎ སེམས་ནི་ཡོངས་སུ་གཏུགས་པའོ༎
 cittaṃ mano 'tha vijñānamekārthaṃ cittacaitasāḥ | sāśrayā lambanākārāḥ saṃprayuktāśca pañcadhā || vakk_2|34 ||	སེམས་དང་ཡིད་དང་རྣམ་ཤེས་ནི་༎ དོན་གཅིག་སེམས་དང་སེམས་བྱུང་དང་༎ རྟེན་དང་དམིགས་དང་རྣམ་བཅས་དང་༎ མཚུངས་པར་ལྡན་པའང་རྣམ་པ་ལྔ་༎
 viprayuktāstu saṃskārāḥ prāptyaprāptī sabhāgatā | āsaṃjñikaṃ samāpattī jīvitaṃ lakṣaṇāni ca || vakk_2|35 ||	མི་ལྡན་པ་ཡི་འདུ་བྱེད་རྣམས་༎ ཐོབ་དང་མ་ཐོབ་སྐལ་མཉམ་དང་༎ འདུ་ཤེས་མེད་སྙོམས་འཇུག་པ་དང་༏་། སྲོག་དང་མཚན་ཉིད་རྣམས་དང་ནི་༎
 nāmakāyādayaśceti prāptirlābhaḥ samanvayaḥ |	མིང་གི་ཚོགས་ལ་སོགས་པ་ཡང་༎ ཐོབ་པ་རྙེད་དང་ལྡན་པའོ་༎
 prāptyaprāptī svasaṃtāna patitānāṃ nirodhayoḥ || vakk_2|36 ||	ཐོབ་དང་མ་ཐོབ་རྙེད་རྒྱུད་དུ་༎ གཏོགས་པ་རྣམས་ཀྱིའོ་འགོག་གཉིས་ཀྱི་༎
 traiyadhvikānāṃ trividhā śubhādīnāṃ śubhādikā |	དུས་གསུམ་པ་ཡི་རྣམ་པ་གསུམ་༎ དགེ་ལ་སོགས་ཀྱི་དགེ་ལ་སོགས་༎
 svadhātukā tadāptānāṃ anāptānāṃ caturvidhā || vakk_2|37 ||	དེར་༄༥བ་གཏོགས་རྣམས་ཀྱི་རང་ཁམས་པ་༎
 tridhā naśaikṣāśaikṣāṇāṃ aheyānāṃ dvidhā matā |	མ་གཏོགས་རྣམས་ཀྱི་རྣམ་པ་བཞི་༎ སློབ་དང་མི་སློབ་མིན་གྱི་གསུམ་༎ སྤང་བྱ་མིན་པའི་རྣམ་གཉིས་འདོད་༎
 avyākṛtāptiḥ sahajā abhijñānairmāṇikādṛte || vakk_2|38 ||	ལུང་བསྟན་མིན་ཐོབ་ལྷན་ཅིག་སྐྱེ་༎ མངོན་ཤེས་སྤྲུལ་པ་མ་གཏོགས་པ་༎
 nivṛtasya ca rūpasya kāme rūpasya nāgrajā |	བསྒྲིབས་པའི་གཟུགས་ཀྱིའང་འདོད་པ་ན་༎ གཟུགས་ཀྱི་སྔར་ནི་སྐྱེ་བ་མེད་༎
 akliṣṭāvyākṛtāprāptiḥ sātītājātayostridhā || vakk_2|39 ||	མ་ཐོབ་མ་བསྒྲིབས་ལུང་མ་བསྟན་༎ འདས་མ་སྐྱེས་ཀྱི་དེ་རྣམ་གསུམ་༎
 kāmādyāptāmalānāṃ ca mārgasyāprāptiriṣyate |	འདོད་སོགས་གཏོགས་དང་དྲི་མེད་ཀྱིའང་༎ ལམ་མ་ཐོབ་པ་སོ་སོ་ཡི་༎
 pṛthagjanatvam tatprāptibhūsaṃcārād vihīyate || vakk_2|40 ||	སྐྱེ་བོར་འདོད་དོ་དེ་ཐོབ་དང་༎ ས་འཕོས་ནས་ནི་རྣམ་ཉམས་འགྱུར་༎
 sabhāgatā sattvasāmyaṃ āsaṃjñikamasaṃjñiṣu |	སྐལ་མཉམ་སེམས་ཅན་འདྲ་བའོ་༎ འདུ་ཤེས་མེད་པ་པ་འདུ་ཤེས་༎
 nirodhaścittacaittānāṃ vipākaḥ te bṛhatphalāḥ || vakk_2|41 ||	མེད་པར་སེམས་དང་སེམས་བྱུང་རྣམས་༎ འགོག་པའོ་རྣམ་སྨིན་དེ་འབྲས་ཆེ་༎
 tathāsaṃjñisamāpattiḥ dhyāne 'ntye niḥsṛtīcchayā |	།
 śubhā upapadyavedyaiva nāryasya ekādhvikāpyate || vakk_2|42 ||	དགེ་བའོ་སྐྱེས་ནས་མྱོང་འགྱུར་ཉིད་༎ འཕགས་པའི་མ་ཡིན་དུས་གཅིག་འཐོབ་༎
 nirodhākhyā tathaiveyaṃ vihārārthaṃ bhavāgrajā |	འགོག་པ་ཞེས་པའང་དེ་བཞིན་ཉིད་༎ འདི་གནས་དོན་དུ་སྲིད་རྩེ་སྐྱེས་༎
 śubhā dvivedyāniyatā ca āryasya āpyā prayogataḥ || vakk_2|43 ||	དགེ་བའོ་གཉིས་སུ་མྱོང་འགྱུར་དང་༎ མ་ངེས་འཕགས་པའི་སྦྱོར་བས་འཐོབ་༎ ཐུབ་པའི་བྱང་ཆུབ་ཀྱིས་ཐོབ་བྱ་༎ དང་པོར་མ་ཡིན་སྐད་ཅིག་མ་༎
 bodhilabhyā muneḥ na prāk catustriṃśatkṣaṇāptitaḥ |	སུམ་ཅུ་རྩ་བཞིས་ཐོབ་ཕྱིར་རོ་༎
 kāmarūpāśraye bhūte nirodhākhyādito nṛṣu || vakk_2|44 ||	གཉིས་ཀ་འདོད་དང་གཟུགས་རྟེན་ཅན་༎ འགོག་པ་དང་པོར་མིའི་ནང་དུ་༎
 āyurjīvitam ādhāra ūṣmavijñāyorhi yaḥ |	སྲོག་ནི་ཚེ་ཡིན་དྲོད་དང་ནི་༎ རྣམ་ཤེས་རྟེན་གང་ཡིན་པའོ་༎
 lakṣaṇāni punarjātirjarā sthitiranityatā || vakk_2|45 ||	མཚན་ཉིད་དག་ནི་སྐྱེ་བ་དང་༎ རྒ་དང་གནས་དང་མི་རྟག་ཉིད་༎
 jātijātyādayasteṣāṃ te 'ṣṭadharmaikavṛttayaḥ |	དེ་དག་སྐྱེ་བའི་སྐྱེས་ལ་སོགས་༎ དེ་ཆོས་བརྒྱད་དང་གཅིག་ལ་འཇུག་། 
 janyasya janikā jātirna hetupratyayairvinā || vakk_2|46 ||	རྒྱུ་དང་རྐྱེན་དག་མེད་པར་ནི་༎ སྐྱེ་བས་བསྐྱེད་བྱ་སྐྱེད་བྱེད་མིན་༎
 nāmakāyādayaḥ saṃjñāvākyākṣarasamuktayaḥ |	མིང་གི་ཚོགས་ལ་སོགས་པ་ནི་༎ མིང་དང་ངག་དང་ཡི་གེའི་ཚོགས་༎
 kāmarūpāptasattvākhyā niḥṣyandāvyākṛtāḥ tathā || vakk_2|47 ||	འདོད་དང་གཟུགས་གཏོགས་སེམས་ཅན་སྟོན་༎ རྒྱུ་མཐུན་ལུང་བསྟན་མིན་དེ་བཞིན་༎
 sabhāgatā sā tu punarvipāko 'pi āptayo dvidhā |	སྐལ་མཉམ་རྣམ་པར་སྨིན་པའང་ཡིན་༎ ཁམས་གསུམ་པ་སྟེ་ཐོབ་རྣམ་གཉིས་༎
 lakṣaṇāni ca niḥṣyandāḥ samāpattya samanvayāḥ || vakk_2|48 ||	མཚན་ཉིད་རྣམས་ཀྱང་སྙོམས་འཇུག་དང་༎ མི་ལྡན་པ་དག་རྒྱུ་མཐུན་པ་༎
 kāraṇaṃ sahabhūścaiva sabhāgaḥ saṃprayuktakaḥ | sarvatrago vipākākhyaḥ ṣaḍvidho heturiṣyate || vakk_2|49 ||	བྱེད་རྒྱུ་ལྷན་ཅིག་འབྱུང་བ་དང་༎ སྐལ་མཉམ་མཚུངས་པར་ལྡན་པ་དང་༎ ༄༦ཨ་༌་༎ ཀུན་ཏུ་འགྲོ་དང་རྣམ་སྨིན་དང་། རྒྱུ་ནི་རྣམ་པ་དྲུག་ཏུ་འདོད་༎ རང་ལས་གཞན་པ་བྱེད་རྒྱུའི་རྒྱུ་༎
 svato 'nye kāraṇaṃ hetuḥ sahabhūrye mithaḥphalāḥ |	ལྷན་ཅིག་འབྱུང་གང་ཕན་ཚུན་འབྲས་༎
 bhūtavaccittacittānuvartilakṣaṇalakṣyavat || vakk_2|50 ||	འབྱུང་བཞིན་སེམས་ཀྱི་རྗེས་འཇུག་དང་༎ སེམས་དང་མཚན་ཉིད་མཚན་གཞི་བཞིན་༎
 caittā dvau saṃvarau teṣāṃ cetaso lakṣaṇāni ca |	སེམས་ལས་བྱུང་དང་སྡོམ་གཉིས་དང་༎ སེམས་དང་དེ་དག་གི་མཚན་ཉིད་༎
 cittānuvarttinaḥ kālaphalādiśubhatādibhiḥ || vakk_2|51 ||	སེམས་ཀྱི་རྗེས་འཇུག་དུས་དང་ནི་༎ འབྲས་སོགས་དགེ་ལ་སོགས་པས་སོ་༎
 sabhāgahetuḥ sadṛśāḥ svanikāyabhuvaḥ agrajāḥ |	སྐལ་མཉམ་རྒྱུ་ནི་འདྲ་བའོ་༎ རང་རིགས་ས་པའོ་སྔར་སྐྱེས་རྣམས་༎
 anyo 'nyaṃ navabhūmistu mārgaḥ samaviśiṣṭayoḥ || vakk_2|52 ||	ས་དགུའི་ལམ་ནི་ཕན་ཚུན་དུ་༎ མཉམ་དང་ཁྱད་པར་ཅན་གྱི་ཡིན་༎
 prayogajāstayoreva śrutacintāmayādikāḥ |	སྦྱོར་བྱུང་དེ་གཉིས་ཁོ་ནའི་ཡིན་༎ ཐོས་དང་བསམས་བྱུང་ལ་སོགས་པ་༎
 saṃprayuktakahetustu cittacaittāḥ samāśrayāḥ || vakk_2|53 ||	མཚུངས་ལྡན་རྒྱུ་ནི་སེམས་དག་དང་༎ སེམས་བྱུང་རྟེན་མཚུངས་ཅན་རྣམས་སོ་༎
 sarvatragākhyaḥ kliṣṭānāṃ svabhūmau pūrvasarvagāḥ |	ཀུན་འགྲོ་ཞེས་བྱ་ཉོན་མོངས་ཅན་༎ རྣམས་ཀྱི་རང་ས་ཀུན་འགྲོ་སྔ་༎
 vipākaheturaśubhāḥ kuśalāścaiva sāsravāḥ || vakk_2|54 ||	རྣམ་སྨིན་རྒྱུ་ནི་མི་དགེ་དང་༎ དགེ་བ་ཟག་བཅས་རྣམས་ཁོ་ན་༎
 sarvatragaḥ sabhāgaśca dvayadhvagau tryadhvagāstrayaḥ |	ཀུན་འགྲོ་སྐལ་མཉམ་དུས་གཉིས་པ་༎ གསུམ་པོ་དག་ནི་དུས་གསུམ་པ་༎
 saṃskṛtaṃ savisaṃyoga phalaṃ nāsaṃskṛtasya te || vakk_2|55 ||	འདུས་བྱས་བྲལ་བཅས་འབྲས་བུ་ཡིན་༎ འདུས་མ་བྱས་ལ་དེ་དག་མེད་༎
 vipākaphalamantyasya pūrvasyādhipataṃ phalam |	རྣམ་སྨིན་འབྲས་བུ་ཐ་མའི་ཡིན་༎ བདག་པོའི་འབྲས་བུ་དང་པོའི་ཡིན་༎
 sabhāga sarvatragayorniṣyandaḥ pauruṣaṃ dvayoḥ || vakk_2|56 ||	རྒྱུ་མཐུན་སྐལ་མཉམ་ཀུན་འགྲོ་བའི་༎ སྐྱེས་བུ་པ་ནི་གཉིས་ཀྱི་ཡིན་༎
 vipāko 'vyākṛto dharmaḥ sattvākhyaḥ vyākṛtodbhavaḥ |	རྣམ་སྨིན་ལུང་དུ་མ་བསྟན་ཆོས་༎ སེམས་ཅན་བརྗོད་ལུང་བསྟན་ཕྱིས་འབྱུང་༎
 niḥṣyando hetusadṛśaḥ visaṃyogaḥ kṣayo dhiyā || vakk_2|57 ||	རྒྱུ་མཐུན་རྒྱུ་དང་འདྲ་བའོ་༎ བྲལ་བ་བློ་ཡིས་ཟད་པའོ་༎
 yadvalājjāyate yattatphalaṃ puruṣakārajam |	གང་གི་སྟོབས་ཀྱིས་གང་སྐྱེས་པའི་༎ འབྲས་དེ་སྐྱེས་བུ་བྱེད་ལས་སྐྱེས༎
 apūrvaḥ saṃskṛtasyaiva saṃskṛto 'dhipateḥ phalam || vakk_2|58 ||	སྔོན་བྱུང་མ་ཡིན་འདུས་བྱས་ནི་༎ འདུས་བྱས་ཁོ་ནའི་བདག་པོའི་འབྲས་༎
 varttamānāḥ phalaṃ pañca gṛṇhanti dvau prayacchataḥ |	ལྔ་པོ་ད་ལྟར་འབྲས་བུ་འཛིན་༎
 varttamānābhyatītau dvau eko 'tītaḥ prayacchati || vakk_2|59 ||	གཉིས་ནི་རབ་ཏུ་འབྱིན་པར་བྱེད་༎ ད་ལྟར་གྱི་དང་འདས་པ་དག་། གཅིག་ནི་འདས་པས་འབྱིན་པར་འགྱུར་༎
 kliṣṭā vipākajāḥ śeṣāḥ prathamāryā yathākramam |	ཉོན་མོངས་ཅན་དང་རྣམ་སྨིན་སྐྱེས་༎ ལྷག་དང་དང་པོ་འཕགས་རིམ་བཞིན་༎
 vipākaṃ sarvagaṃ hitvā tau sabhāgaṃ ca śeṣajāḥ || vakk_2|60 ||	རྣམ་སྨིན་ཀུན་འགྲོ་དེ་གཉིས་དང་༎ སྐལ་མཉམ་མ་གཏོགས་ལྷག་ལས་སྐྱེས་༎
 cittacaitāḥ tathānye 'pi saṃprayuktakavarjitāḥ |	སེམས་དང་སེམས་ལས་བྱུང་བ་ཡིན་༎ མཚུངས་ལྡན་མ་གཏོགས་གཞན་དེ་བཞིན་༎
 catvāraḥ pratyayā uktāḥ hetvākhyaḥ pañca hetavaḥ || vakk_2|61 ||	རྐྱེན་ནི་བཞི་པོ་དག་ཏུ་གསུངས་༎ རྒྱུ་ཞེས་བྱ་བ་རྒྱུ་ལྔ་ཡིན་༎
 cittacaittā acaramā utpannāḥ samanantaraḥ |	སེམས་༄༦བ་དང་སེམས་བྱུང་སྐྱེས་པ་རྣམས་༎ ཐ་མ་མིན་མཚུངས་དེ་མ་ཐག་། 
 ālambanaṃ sarvadharmāḥ kāraṇākhyo 'dhipaḥ smṛtaḥ || vakk_2|62 ||	དམིགས་པ་ཆོས་རྣམས་ཐམས་ཅད་དོ་༎ བྱེད་རྒྱུ་ཞེས་བྱ་བདག་པོར་བཤད་༎
 nirudhyamāne kāritraṃ dvau hetū kurutaḥ trayaḥ |	རྒྱུ་གཉིས་པོ་དག་འགག་པ་ལ་༎ བྱ་བ་བྱེད་དོ་གསུམ་པོ་ནི་༎
 jāyamāne tato 'nyau tu pratyayau tadviparyayāt || vakk_2|63 ||	སྐྱེ་ལའོ་དེ་ལས་གཞན་པ་ཡི་༎ རྐྱེན་དག་དེ་ལས་བཟློག་པ་ཡིན་༎
 caturbhiścattacaittā hi samāpattidvayaṃ tribhiḥ |	བཞི་ཡིས་སེམས་དང་སེམས་བྱུང་རྣམས་༎ གསུམ་གྱིས་སྙོམས་པར་འཇུག་པ་གཉིས་༎
 dvābhyāmanye tu jāyante neśvarādeḥ kramādibhiḥ || vakk_2|64 ||	གཞན་ནི་གཉིས་པོ་དག་ལས་སྐྱེ་༎ དབང་ཕྱུག་སོགས་མིན་རིམ་སོགས་ཕྱིར་༎
 dvidhā bhūtāni taddhetuḥ bhautikasya tu pañcadhā |	དེའི་རྒྱུ་འབྱུང་བ་རྣམ་པ་གཉིས་༎ འབྱུང་ལས་གྱུར་པའི་རྣམ་པ་ལྔ་༎ འབྱུང་གྱུར་རྣམ་གསུམ་ཕན་ཚུན་དུ་༎
 tridhā bhautikamanyonyaṃ bhūtānāmekadhaiva tat || vakk_2|65 || kuśalākuśalaṃ kāme nivṛtānivṛtaṃ manaḥ |	འབྱུང་བ་རྣམས་ཀྱི་དེ་རྣམ་གཅིག་།འདོད་ཡིད་དགེ་དང་མི་དགེ་དང་༎ བསྒྲིབས་པ་དང་ནི་མ་བསྒྲིབས་པ་༎
 rūpārūpyeṣvakuśalādanyatra anāsravaṃ dvidhā || vakk_2|66 ||	གཟུགས་དང་གཟུགས་མེད་པ་དག་ན་༎ མི་དགེ་ལས་གཞན་ཟག་མེད་གཉིས་༎
 kāme nava śubhāccittāccittāni aṣṭābhya eva tat |	འདོད་སེམས་དགེ་བ་ལས་སེམས་དགུ་༎ དེ་ནི་བརྒྱད་པོ་ཁོ་ན་ལས་༎
 daśabhyo 'kuśalaṃ tasmāccatvāri nivṛtaṃ tathā || vakk_2|67 ||	མི་དགེ་བ་ནི་བཅུ་དག་ལས་༎ དེ་ལས་བཞི་སྟེ་བསྒྲིབས་དེ་བཞིན་༎
 pañcabhyo 'nivṛtaṃ tasmātsapta cittānyanantaram |	མ་བསྒྲིབས་པ་ནི་ལྔ་དག་ལས་༎ དེ་ལས་མཇུག་ཐོགས་སེམས་བདུན་ནོ་༎
 rūpe daśaikaṃ ca śubhāt navabhyastadanantaram || vakk_2|68 ||	གཟུགས་ན་དགེ་ལས་བཅུ་གཅིག་གོ་༎ དེ་ནི་དགུ་ཡི་མཇུག་ཐོགས་སུ་༎
 aṣṭābhyo nivṛtaṃ tasmāt ṣaṭ tribhyo 'nivṛtaṃ punaḥ |	།
 tasmāt ṣaṭ evāmārūpye tasya nītiḥ śubhātpunaḥ || vakk_2|69 ||	དེ་ལས་དྲུག་སྟེ་གཟུགས་མེད་པའང་༎ དེ་ཡི་ཚུལ་ལོ་དགེ་བ་ལས་༎
 nava cittāni tat ṣaṇṇāṃ nivṛtātsapta tattathā |	སེམས་དགུ་དག་གོ་དེ་དྲུག་གི་*go?་༎ བསྒྲིབས་པ་ལས་བདུན་དེ་དེ་བཞིན་༎
 caturbhyaḥ śaikṣam asmāttu pañca aśaikṣaṃ tu pañcakāt || vakk_2|70 ||	སློབ་པ་བཞི་ལས་དེ་ལས་ལྔ་༎ མི་སློབ་པ་ནི་ལྔ་ལས་སོ་༎
 tasmāccatvāri cittāni dvādaśaitāni viṃśatiḥ |	དེ་ལས་སེམས་ནི་བཞི་དག་གོ་༎ བཅུ་གཉིས་དེ་དག་ཉི་ཤུར་ཡང་༎
 prāyogikopapattyāptaṃ śubhaṃ bhittvā triṣu dvidhā || vakk_2|71 ||	གསུམ་དུ་སྐྱེས་ནས་ཐོབ་པ་དང་༎ སྦྱོར་བྱུང་དགེ་རྣམ་གཉིས་ཕྱེ་ནས་༎
 vipākajairyāpathikaśailpasthānikanairmitam |	རྣམ་སྨིན་སྐྱེས་དང་སྤྱོད་ལམ་པ་༎
 caturdhāvyākṛtaṃ kāme rūpe śilpavivarjitam || vakk_2|72 ||	བཟོ་ཡི་གནས་དང་སྤྲུལ་པ་དང་༎ འདོད་ན་ལུང་བསྟན་མིན་རྣམ་བཞིར་༎ གཟུགས་ན་བཟོ་མ་གཏོགས་པའོ་༎
 kliṣṭe traidhātuke lābhaḥ ṣaṇṇāṃ ṣaṇṇāṃ dvayoḥ śubhe |	ཁམས་གསུམ་པ་ཡི་ཉོན་མོངས་ཅན་༎ དྲུག་དང་དྲུག་དང་གཉིས་རྙེད་དོ་༎ གཟུགས་སྐྱེས་དགེ་ལ་གསུམ་དག་གོ་༎
 trayāṇāṃ rūpaje śaikṣe caturṇāṃ tasya śeṣite || vakk_2|73 ||	སློབ་པ་ལ་བཞི་ལྷག་ལ་དེ་༎
 abhidharmakośe indriyanirddeśo nāma dvitīyaṃ kośasthānaṃ samāptamiti | śrīlāmāvākasya	ཆོས་མངོན་པའི་མཛོད་ཀྱི་ཚིག་ལེའུར་བྱས་པ་ལས་༎
 tṛtīyaṃ kośasthānam	དབང་པོ་བསྟན་པ་ཞེས་བྱ་བ་སྟེ་གནས་གཉིས་པའོ་།
 oṃ namo buddhāya | narakapretatiryañco manuṣyāḥ ṣaḍ divaukasaḥ | kāmadhātuḥ sa narakadvīpabhedena viṃśatiḥ || vakk_3|1 ||	༎ ། ༄༧ཨ་༌་༎ དམྱལ་བ་ཡི་དགས་དུད་འགྲོ་དང་༎ མི་རྣམས་དང་ནི་ལྷ་དྲུག་དག་།འདོད་པའི་ཁམས་ཡིན་དམྱལ་བ་དང་༎ གླིང་དབྱེ་བ་ལས་དེ་ཉི་ཤུ་༎
 ūrdhvaṃ saptadaśasthāno rūpadhātuḥ pṛthak pṛthak |	གོང་མའི་གནས་དག་བཅུ་བདུན་ནི་༎ གཟུགས་ཁམས་ཡིན་དེར་སོ་སོ་ཡི་༎
 dhyānaṃ tribhūmikaṃ tatra caturthaṃ tvaṣṭabhūmikam || vakk_3|2 ||	བསམ་གཏན་ས་ནི་གསུམ་པ་ཡིན་༎ བཞི་པ་ས་ནི་བརྒྱད་པ་ཡིན་༎
 ārūpyadhāturasthānaḥ upapattyā caturvidhaḥ |	གཟུགས་མེད་ཁམས་ན་གནས་མེད་དོ་༎ སྐྱེ་བ་ལས་ནི་རྣམ་པ་བཞི་༎
 nikāyaṃ jīvitaṃ cātra niśritā cittasantatiḥ || vakk_3|3 ||	དེར་ནི་རིས་དང་སྲོག་ལ་ཡང་༎ སེམས་ཀྱི་རྒྱུད་ནི་རྟེན་པ་ཡིན་༎
 narakādisvanāmoktā gatayaḥ pañca teṣu tāḥ |	དེར་ནི་དམྱལ་སོགས་འགྲོ་བ་ལྔ་༎ རང་གི་མིང་གིས་བསྟན་དེ་དག་༎
 akliṣṭāvyākṛtā eva sattvākhyā nāntarābhavaḥ || vakk_3|4 ||	ཉོན་མོངས་ཅན་མིན་ལུང་བསྟན་མིན་༎ སེམས་ཅན་ཞེས་བྱ་བར་སྲིད་མིན་༎
 nānātvakāyasaṃjñāśca nānākāyaikasaṃjñinaḥ |	ལུས་དང་འདུ་ཤེས་ཐ་དད་དང་༎ ལུས་ཐ་དད་ཅིང་འདུ་ཤེས་གཅིག་། 
 viparyayāccaikakāyasaṃjñāścārūpiṇasrayaḥ || vakk_3|5 ||	བཟློག་དང་ལུས་དང་འདུ་ཤེས་གཅིག་། གཟུགས་ཅན་མ་ཡིན་གསུམ་པོ་དག་། 
 vijñānasthitayaḥ sapta śeṣaṃ tatparibhedavat |	རྣམ་ཤེས་གནས་པ་བདུན་ལྷག་མ་༎ 
 bhavāgrāsaṃjñisattvāśca sattvāvāsā nava smṛtāḥ || vakk_3|6 ||	དེ་འཇོམས་བྱེད་ལྡན་སྲིད་རྩེ་དང་༏་།འདུ་ཤེས་མེད་པའི་སེམས་ཅན་རྣམས་༎ སེམས་ཅན་གྱི་ནི་གནས་དགུར་བཤད་༎
 anicchāvasanānnānye catasraḥ sthitayaḥ punaḥ |	མི་འདོད་བཞིན་གནས་ཕྱིར་གཞན་མིན་༎
 catvāraḥ sāsravāḥ skandhāḥ svabhūmāveva kevalam || vakk_3|7 ||	གནས་པ་དག་ནི་ཡང་བཞི་སྟེ་༎ ཟག་དང་བཅས་པའི་ཕུང་པོ་བཞི་༎ རང་གི་ས་པ་ཉིད་རྣམ་ཤེས་༎
 vijñānaṃ na sthitiḥ proktaṃ catuṣkoṭi tu saṃgrahe |	འབའ་ཞིག་གནས་པར་མ་བཤད་དོ་༎ བསྡུ་ན་མུ་ནི་བཞི་ཡིན་ནོ་༎
 catasro yonayastatra sattvānāmaṇḍajādayaḥ || vakk_3|8 ||	དེར་ནི་སྒོ་ང་ལས་སྐྱེས་སོགས་༎
 caturdhā nara tiryañcaḥ nārakā upapādukāḥ |	སེམས་ཅན་སྐྱེ་གནས་བཞི་དག་ཏུ་༎ མི་དང་དུད་འགྲོ་རྣམ་པ་བཞི་༎ དམྱལ་བ་རྣམས་དང་ལྷ་རྣམས་དང་༎ སྲིད་པ་བར་མ་རྫུས་ཏེ་སྐྱེ་༎
 antarābhavadevāśca pretā api jarāyujāḥ || vakk_3|9 ||	ཡི་དགས་མངལ་ནས་སྐྱེ་བའང་ཡིན་༎
 mṛtyupapattibhavayorantarā bhavatīha yaḥ |	འདིར་གང་འཆི་དང་སྐྱེ་བ་ཡི་༎ སྲིད་པའི་བར་དུ་འབྱུང་བའོ་༎
 gamyadeśānupetatvānnopapanno 'ntarābhavaḥ || vakk_3|10 ||	བགྲོད་པའི་ཡུལ་དུ་མ་ཕྱིན་ཕྱིར་༎ སྲིད་པ་བར་མ་བྱུང་བ་མིན་༎
 vrīhisantānasādharmyādavicchinnabhavodbhavaḥ |	འབྲུ་ཡི་རྒྱུན་དང་ཆོས་མཐུན་ཕྱིར་༎ སྲིད་པ་ཆད་ལས་བྱུང་བ་མིན་༎
 pratibimbamasiddhatvādasāmyāccānidarśanam || vakk_3|11 ||	གཟུགས་བརྙན་མ་གྲུབ་ཕྱིར་པ་དང་༎ མི་འདྲའི་ཕྱིར་ན་དཔེ་མ་ཡིན་༎
 sahaikatra dvayābhāvāt asantānād dvayodayāt |	གཅིག་ན་ལྷན་ཅིག་གཉིས་མེད་ཕྱིར་༎ རྒྱུན་མིན་ཕྱིར་གཉིས་ལས་བྱུང་ཕྱིར་༎
 kaṇṭhokteścāsti gandharvāt pañcokteḥ gatisūtrataḥ || vakk_3|12 ||	མགུར་ནས་གསུངས་ཕྱིར་ཡོད་དྲི་ཟ་༎ ལྔར་གསུངས་འགྲོ་མདོ་ལས་ཀྱང་གྲུབ་༎
 ekākṣepādasāvaiṣyatpūrvakālabhavākṛtiḥ |	དེ་ནི་འཕེན་པ་གཅིག་པའི་ཕྱིར་༎ སྔོན་དུས་སྲིད་འབྱུང་ཤ་ཚུགས་ཅན་༎
 sa punarmaraṇātpūrva upapattikṣaṇātparaḥ || vakk_3|13 ||	དེ་ནི་འཆི་བའི་སྔོན་རོལ་ཏེ་༎ སྐྱེ་བའི་སྐད་ཅིག་༄༧བ་ཕན་ཆད་དོ་༎ རིགས་མཐུན་ལྷ་མིག་དག་པས་མཐོང་༎
 sajātiśuddhadivyākṣidṛśyaḥ karmarddhivegavān |	ལས་ཀྱི་རྫུ་འཕྲུལ་ཤུགས་དང་ལྡན་༎
 sakalākṣaḥ apratighavān anivartyaḥ sa gandhabhuk || vakk_3|14 ||	དབང་པོ་ཀུན་ཚང་ཐོགས་མེད་ལྡན་༎ མི་ཟློག་དེ་ནི་དྲི་ཟའོ་༎ བློ་ནི་ཕྱིན་ཅི་ལོག་གྱུར་པས་༎
 viparyastamatiryāti gatideśaṃ riraṃsayā |	རྩེ་དགས་འགྲོ་བའི་ཡུལ་དུ་འགྲོ་༎
 gandhasthānābhikāmo 'nyaḥ ūrdhvapādastu nārakaḥ || vakk_3|15 ||	དྲི་དང་གནས་ལ་མངོན་འདོད་གཞན་༎ དམྱལ་བ་ཡི་ནི་སྤྱིའུ་ཚུགས་ཡིན་༎
 saṃprajānan viśatyekaḥ tiṣṭhatyapyaparaḥ aparaḥ |	གཅིག་ནི་ཤེས་བཞིན་དུ་འཇུག་གོ་༎
 niṣkrāmatyapi sarvāṇi mūḍho 'nyaḥ nityamaṇḍajaḥ || vakk_3|16 ||	གཞན་ནི་གནས་པ་ཡང་གཞན་ནི་༎ འབྱུང་བ་འང་གཞན་ནི་ཐམས་ཅད་རྨོངས་༎ སྒོ་ང་ལས་སྐྱེས་རྟག་ཏུའོ་༎
 garbhāvakrāntayastisraścakravarttisvayaṃbhuvām |	མངལ་དུ་འཇུག་པ་གསུམ་དག་སྟེ་༎ འཁོར་ལོས་སྒྱུར་དང་རང་བྱུང་གཉིས་༎
 karmajñānobhayeṣāṃ vā viśadatvād yathākramam || vakk_3|17 ||	།
 nātmāsti skandhamātraṃ tu kleśakarmābhisaṃskṛtam |	བདག་མེད་ཕུང་པོ་ཙམ་ཉིད་དོ་༎ ཉོན་མོངས་ལས་ཀྱིས་མངོན་འདུས་བྱས་༎
 antarābhavasaṃtatyā kukṣimeti pradīpavat || vakk_3|18 ||	སྲིད་པ་བར་མའི་རྒྱུན་གྱིས་ན་༎ མར་མེ་བཞིན་དུ་མངལ་དུ་འགྲོ་༎
 yathākṣepaṃ kramādvṛddhaḥ santānaḥ kleśakarmabhiḥ |	ཇི་ལྟར་འཕངས་བཞིན་རིམ་གྱིས་རྒྱུན་༎ སྐྱེས་ནས་ལས་དང་ཉོན་མོངས་ཀྱིས་༎
 paralokaṃ punaryāti ityanādibhavacakrakam || vakk_3|19 ||	འཇིག་རྟེན་ཕ་རོལ་དག་ཏུ་འགྲོ་༎ སྲིད་པའི་འཁོར་ལོ་ཐོག་མ་མེད་༎
 sa pratītyasamutpādo dvādaśāṅgastrikāṇḍakaḥ |	དེ་ནི་རྟེན་ཅིང་འབྲེལ་འབྱུང་བའི་༎ ཡན་ལག་བཅུ་གཉིས་ཆ་གསུམ་མོ་༎
 pūrvāparāntayordve dve madhye 'ṣṭau paripūriṇaḥ || vakk_3|20 ||	སྔོན་དང་ཕྱི་མཐར་གཉིས་གཉིས་དང་༎ བར་དུ་བརྒྱད་ཡོངས་རྫོགས་ལྡན་ལ་༎
 pūrvakleśā daśāvidyā saṃskārāḥ pūrvakarmaṇaḥ |	མ་རིག་ཉོན་མོངས་མངོན་གནས་སྐབས་༎ འདུ་བྱེད་དག་ནི་སྔོན་ལས་ཀྱི་༎
 saṃdhiskandhāstu vijñānaṃ nāmarūpamataḥ param || vakk_3|21 ||	རྣམ་ཤེས་མཚམས་སྦྱོར་ཕུང་པོ་ཡིན་༎ མིང་དང་གཟུགས་ནི་དེ་ཕན་ཆད་༎
 prāk ṣaḍāyatanotpādāt tatpūrvaṃ trikasaṃgamāt |	སྐྱེ་མཆེད་དྲུག་དོད་ཚུན་ཆད་དོ་༎ དེ་ནི་གསུམ་འདུས་ཚུན་ཆད་དོ་༎
 sparśaḥ prāksukhaduḥkhādikāraṇajñānaśaktitaḥ || vakk_3|22 ||	རེག་པ་བདེ་སྡུག་ལ་སོགས་ཀྱི་༎ རྒྱུ་ཤེས་ནུས་པ་ཚུན་ཆད་དོ་༎
 vittiḥ prāk maithunāt tṛṣṇā bhogamaithunarāgiṇaḥ |	ཚོར་འཁྲིག་ཚུན་ཆད་སྲེད་པ་ནི་༎ ལོངས་སྤྱོད་འཁྲིག་པ་ཆགས་ཅན་གྱི་༎
 upādānaṃ tu bhogānāṃ prāptaye paridhāvataḥ || vakk_3|23 ||	ཉེ་བར་ལེན་པ་ལོངས་སྤྱོད་རྣམས་༎ ཐོབ་པར་བྱ་ཕྱིར་ཡོངས་རྒྱུག་པའི་༎
 sa bhaviṣyat bhavaphalaṃ kurute karma tat bhavaḥ |	དེ་སྲིད་འབྲས་བུ་འབྱུང་འགྱུར་བའི་༎ ལས་བྱེད་དེ་ནི་སྲིད་པ་ཡིན་༎
 pratisaṃdhiḥ punarjātiḥ jarāmaraṇamā vidaḥ || vakk_3|24 ||	ཉིང་མཚམས་སྦྱོར་བ་སྐྱེ་བ་ཡིན་༎ ཚོར་བའི་བར་ནི་རྒ་ཤི་ཡིན་༎ འདི་ནི་གནས་སྐབས་པར་འདོད་ལོ་༎
 āvasthikaḥ kileṣṭo 'yaṃ prādhānyā ttvaṅgakīrtanam |	གཙོ་བོའི་ཕྱིར་ན་ཡན་ལག་བསྒྲགས་༎
 pūrvāparāntamadhyeṣu saṃmohavinivṛttaye || vakk_3|25 ||	སྔོན་དང་ཕྱི་མཐའ་བར་དག་ལ་༎ རྨོངས་པ་རྣམ་པར་བཟློག་ཕྱིར་རོ་༎
 kleśāstrīṇi dvayaṃ karma sapta vastu phalaṃ tathā |	ཉོན་མོངས་གསུམ་མོ་ལས་གཉིས་སོ་༎ གཞི་བདུན་དེ་བཞིན་འབྲས་བུ་ཡིན་༎
 phalahetvabhisaṃkṣepo dvayormadhyānumānataḥ || vakk_3|26 ||	གཉིས་ཀྱི་རྒྱུ་༄༨ཨ་༌་༎ འབྲས་མདོར་བསྡུས་པ་༎ བར་མའི་རྗེས་སུ་དཔག་པ་ལས་༎
 kleśāt kleśaḥ kriyā caiva tato vastu tataḥ punaḥ |	ཉོན་མོངས་པ་ལས་ཉོན་མོངས་དང་༎ བྱ་བ་ཉིད་དོ་དེ་ལས་གཞི་༎ དེ་ལས་གཞི་དང་ཉོན་མོངས་སྐྱེ་༎
 vastu kleśāśca jāyante bhavāṅgānāmayaṃ nayaḥ || vakk_3|27 ||	འདི་ནི་སྲིད་པའི་ཡན་ལག་ལུགས་༎
 heturatra samutpādaḥ samutpannaḥ phalaṃ matam |	འདིར་ནི་འབྱུང་བ་རྒྱུ་ཡིན་ཏེ་༎ བྱུང་བ་འབྲས་བུ་ཡིན་པར་འདོད་༎
 vidyāvipakṣo dharmo 'nyo 'vidyāmitrānṛtādivat || vakk_3|28 ||	རིག་པའི་མི་མཐུན་ཕྱོགས་ཆོས་གཞན་༎ མ་རིག་མི་མཛའ་རྫུན་སོགས་བཞིན་༎
 saṃyojanādivacanāt kuprajñā cenna darśanāt |	ཀུན་སྦྱོར་སོགས་ཚིག་ཕྱིར་གལ་ཏེ་༎ ཤེས་རབ་ངན་པའོ་མིན་ལྟ་ཕྱིར་༎
 dṛṣṭestatsaṃprayuktatvāt prajñopakleśadeśanāt || vakk_3|29 ||	ལྟ་བ་དེ་དང་མཚུངས་ལྡན་ཕྱིར་༎ ཤེས་རབ་ཉོན་མོངས་བསྟན་ཕྱིར་རོ་༎
 nāma tvarūpiṇaḥ skandhāḥ sparśāḥ ṣaṭ saṃnipātajāḥ |	མིང་ནི་གཟུགས་ཅན་མིན་ཕུང་པོ་༎ རེག་དྲུག་འདུས་ཏེ་བྱུང་བ་ཡིན་༎
 pañcapratighasaṃsparśaḥ ṣaṣṭho 'dhivacanāvhaya || vakk_3|30 ||	ལྔ་ནི་ཐོགས་པའི་རེག་པ་ཡིན་༎ དྲུག་པ་བླ་དགས་ཚིག་ཅེས་བྱ་༎
 vidyāvidyetarasparśāḥ amalakliṣṭaśeṣitāḥ |	།
 vyāpādānunayasparśau sukhavedyādayastrayaḥ || vakk_3|31 ||	།
 tajjāḥ ṣaḍvedanāḥ pañca kāyikī caitasī parā |	དེ་ལས་བྱུང་བའི་ཚོར་བ་དྲུག་། ལྔ་ནི་ལུས་ཀྱིའོ་སེམས་ཀྱི་གཞན་༎ དེ་ཡིད་ཉེ་བར་རྒྱུ་བ་ལས་༎
 punaścāṣṭādaśavidhā sā manopavicārataḥ || vakk_3|32 ||	རྣམ་པ་དག་ནི་ཡང་བཅོ་བརྒྱད་༎
 kāme svālambanāḥ sarve rūpī dvādaśagocaraḥ |	འདོད་ན་ཐམས་ཅད་རང་དམིགས་ཅན་༎ སྤྱོད་ཡུལ་གཟུགས་ཅན་བཅུ་གཉིས་སོ་༎
 trayāṇāmuttaraḥ dhyānadvaye dvādaśa kāmagāḥ || vakk_3|33 ||	གོང་མ་གསུམ་གྱི་བསམ་གཏན་ནི་༎ གཉིས་ན་བཅུ་གཉིས་འདོད་འགྲོ་རྣམས་༎
 svo 'ṣṭālambanam ārūpyo dvayoḥ dhyānadvaye tu ṣaṭ |	རང་ལ་དམིགས་བརྒྱད་གཟུགས་མེད་པ་༎ གཉིས་ཀྱིའོ་བསམ་གཏན་གཉིས་ན་དྲུག་། 
 kāmāḥ ṣaṇṇāṃ caturṇā svaḥ ekasyālambanaṃ paraḥ || vakk_3|34 ||	དྲུག་གི་འདོད་པའོ་རང་ནི་བཞིའི་༎ གོང་མ་གཅིག་གི་དམིགས་པ་ཡིན་༎
 catvāro 'rūpisāmante rūpagāḥ eka ūrdhvagaḥ |	གཟུགས་མེད་ཉེ་བར་བསྡོགས་ན་བཞི་༎ གཟུགས་འགྲོ་གོང་མར་འགྲོ་བ་གཅིག་། 
 eko maule svaviṣayaḥ sarve 'ṣṭādaśa sāsravāḥ || vakk_3|35 ||	དངོས་གཞི་ན་གཅིག་རང་ཡུལ་ཅན་༎ བཅོ་བརྒྱད་ཐམས་ཅད་ཟག་དང་བཅས་༎
 uktaṃ ca vakṣyate cānyat atra tu kleśā iṣyate |	བཤད་དང་འཆད་པར་འགྱུར་བ་གཞན་༎
 bījavannāgavanmūlavṛkṣavattuṣavattathā || vakk_3|36 ||	འདིར་ནི་ཉོན་མོངས་ས་བོན་བཞིན་༎ ཀླུ་བཞིན་རཙབ༹་བཞིན་ལྗོན་ཤིང་བཞིན་༎ དེ་བཞིན་ཤུན་པ་བཞིན་དུ་འདོད་༎
 tuṣitaṇḍulavat karma tathaivauṣadhi puṣpavat |	ལས་ནི་ཤུན་བཅས་འབྲས་དང་འདྲ་༎ དེ་བཞིན་སྨན་དང་མེ་ཏོག་བཞིན་༎
 siddhānnapānavadvastu tasmin bhavacatuṣṭaye || vakk_3|37 ||	གཞི་ནི་བཟའ་བཏུང་གྲུབ་པ་བཞིན་༎ སྲིད་པ་བཞི་པོ་དེ་དག་ལས་༎
 upapattibhavaḥ kliṣṭaḥ sarvakleśaiḥ svabhūmikaiḥ |	སྐྱེ་བའི་སྲིད་པ་ཉོན་མོངས་ཅན་༎ རང་གི་ས་པའི་ཉོན་མོངས་ཀུན་༎
 tridhānye traya ārūpye āhārasthitikaṃ jagat || vakk_3|38 ||	གཞན་རྣམ་གསུམ་པོ་གཟུགས་མེད་གསུམ་༎ འགྲོ་བ་ཟས་ཀྱིས་གནས་པ་ཡིན་༎
 kavaḍīkāra āhāraḥ kāme tryāyatanātmakaḥ |	ཁམ་གྱི་ཟས་ནི་འདོད་པ་ན་༎ སྐྱེ་མཆེད་གསུམ་༄༨བ་གྱི་བདག་ཉིད་དོ་༎
 na rūpāyatanaṃ tena svākṣamuktānanugrahāt || vakk_3|39 ||	གཟུགས་ཀྱི་སྐྱེ་མཆེད་མ་ཡིན་དེས་༎ རང་དབང་གྲོལ་ལ་མི་ཕན་ཕྱིར་༎
 sparśaṃcetanāvijñā āhārāḥ sāsravāstriṣu |	རེག་དང་སེམས་པ་རྣམ་ཤེས་ནི་༎ ཟག་བཅས་ཟས་ཡིན་གསུམ་དག་ན་༎
 manomayaḥ saṃbhavaiṣī gandharvaścāntarābhavaḥ || vakk_3|40 ||	ཡིད་ལས་བྱུང་དང་སྲིད་ཚོལ་དང་༎ དྲི་ཟ་སྲིད་པ་བར་མ་དང་༎ འགྲུབ་པའོ་འདི་ལ་གནས་དང་ནི༎
 nirvṛttiśca iha puṣṭyarthamāśrayāśritayordvayam |	རྟེན་པ་རྒྱས་པའི་དོན་དུ་གཉིས་༎
 dvayamanyabhavākṣepanivṛttyartha yathākramam || vakk_3|41 ||	སྲིད་གཞན་འཕེན་དང་འགྲུབ་པ་ཡི་༎ དོན་དུ་གཉིས་ཏེ་གོ་རིམས་བཞིན་༎
 chedasaṃdhāna vairāgyahānicyutyupapattayaḥ |	འཆད་དང་མཚམས་སྦྱོར་འདོད་ཆགས་འབྲལ་༎ ཉམས་དང་འཆི་འཕོ་སྐྱེ་བ་རྣམས་༎
 manovijñāna eveṣṭāḥ upekṣāyāṃ cyutodbhavau || vakk_3|42 ||	ཡིད་ཀྱི་རྣམ་ཤེས་ཁོ་ནར་འདོད་༎ འཆི་འཕོ་སྐྱེ་བ་བཏང་སྙོམས་ལ་༎
 naikāgrācittayoretau nirvātyavyākṛtadvaye |	རྩེ་གཅིག་སེམས་མེད་ལ་དེ་མེད་༎ མྱ་ངན་འདའ་ལུང་བསྟན་མིན་གཉིས་༎ འོག་མི་ལྷར་འགྲོ་མི་སྐྱེ་རྣམས་༎
 kramacyutau pādanābhihṛdayeṣu manaścyutiḥ || vakk_3|43 ||	རིམ་གྱིས་འཆི་ན་རྐང་པ་དང་༎ ལྟེ་བ་སྙིང་གར་ཡིད་འཆི་འཕོ་༎
 adhonṛsuragājānāṃ marmacchedastvabādibhiḥ |	གནད་གཅོད་པ་ནི་ཆུ་སོགས་ཀྱིས་༎
 samyaṅ mithyātvaniyatā āryānantaryakāriṇaḥ || vakk_3|44 ||	འཕགས་དང་མཚམས་མེད་བྱེད་པ་དག་༎ ཡང་དག་ལོག་པ་ཉིད་དུ་ངེས་༎
 tatra bhājanalokasya saṃniveśamuśantyadhaḥ |	དེ་ལ་སྣོད་ཀྱི་འཇིག་རྟེན་གྱི་༎ གནས་པར་འདོད་པའི་འོག་དག་གི་༎
 lakṣaṣoḍaśakodvedhamasaṃkhyaṃ vāyumaṇḍalam || vakk_3|45 ||	རླུང་གི་དཀྱིལ་འཁོར་རྔམས་སུ་ནི་༎ ས་ཡ་དྲུག་འབུམ་གྲངས་མེད་དོ་༎
 apāmekādaśodvedhaṃ sahasrāṇi ca viṃśatiḥ |	ཆུ་རྔམས་འབུམ་ཕྲག་བཅུ་གཅིག་དང་༎ སྟོང་ཕྲག་དག་ནི་ཉི་ཤུའོ་༎ ཕྱིས་ནི་རྔམས་སུ་འབུམ་ཕྲག་བརྒྱད་༎
 aṣṭalakṣaucchrayaṃ paścāccheṣaṃ bhavati kāñcanam || vakk_3|46 ||	ལྷག་མ་དག་ནི་གསེར་དུ་འགྱུར་༎ ཆུ་དང་གསེར་གྱི་དཀྱིལ་འཁོར་གྱི་༎
 tiryak trīṇi sahasrāṇi sārdhaṃ śatacatuṣṭayam |	ཐད་ཀར་འབུམ་ཕྲག་བཅུ་གཉིས་དང་༎ སྟོང་ཕྲག་གསུམ་དང་བརྒྱ་ཕྲག་ནི་༎ ཕྱེད་དང་ལྔ་རྣམས་ཁོ་ནའོ་༎ ཁོར་ཡུག་ཏུ་ནི་སུམ་འགྱུར་རོ་༎
 lakṣadvādaśakaṃ caiva jalakāñcanamaṇḍalam || vakk_3|47 || samantatastu triguṇaṃ tatra merūryugandharaḥ |	དེ་ལ་ལྷུན་པོ་གཉའ་ཤིང་འཛིན་༎
 īśādhāraḥ khadirakaḥ sudarśanagiristathā || vakk_3|48 ||	གཤོལ་མདའ་འཛིན་དང་སེང་ལྡེང་ཅན་༎
 aśvakarṇo vinitako nimindharagiriḥ tataḥ |	དེ་བཞིན་བལྟ་ན་སྡུག་རི་དང་༎ རྟ་རྣ་དང་ནི་རྣམ་འདུད་དང་༎ མུ་ཁྱུད་འཛིན་རིའོ་དེ་ནས་ནི་༎
 dvīpāḥ bahiścakravāḍaḥ sapta haimāḥ sa āyasaḥ || vakk_3|49 ||	གླིང་རྣམས་ཡིན་ནོ་དེ་དག་གི་༎ ཕྱི་རོལ་ན་ནི་ཁོར་ཡུག་སྟེ་༎ བདུན་ནི་གསེར་ཡིན་དེ་ལྕགས་སོ་༎
 catūratnamayo meruḥ jale 'śītisahasrake |	ལྷུན་པོ་རིན་ཆེན་བཞིའི་རང་བཞིན་༎ ཆུ་ཡི་ནང་དུ་བརྒྱད་ཁྲི་དག་། ནུབ་བོ་དེ་བཞིན་སྟེང་དུ་ཡང་༎
 magnāḥ ūrdhva jalāt merurbhūyo 'śītisahasrakaḥ || vakk_3|50 ||	དཔག་ཚད་དག་ནི་བརྒྱད་ཁྲིའོ་༎
 ardhārdhahāniraṣṭāsu samocchrāyaghanāśca te |	བརྒྱད་པོ་འཕང་དུ་ཕྱེད་ཕྱེད་དབྲི་༎ དེ་དག་རྔམས་སུའང་འཕང་དང་མཉམ་༎
 śītāḥ saptāntarāṇyeṣāṃ ādyāśītisahasrikā || vakk_3|51 ||	དེ་དག་བར་བདུན་རོལ་མཚོ་ཡིན་༎ དང་པོ་སྟོང་ཕྲག་བརྒྱད་ཅུའོ་༎
 ābhyantaraḥ samudro 'sau triguṇaḥ sa tu pārśvataḥ |	དེ་ནི་ནང་གི་རྒྱ་མཚོ་ཡིན་༎ དེ་ཡི་ངོས་ལ་༄༩ཨ་༌་༎
 ardhārdhenāparāḥ śītāḥ śeṣaṃ bāhyo mahodadheḥ || vakk_3|52 ||	སུམ་འགྱུར་རོ་༎ རོལ་མཚོ་གཞན་ནི་ཕྱེད་ཕྱེད་དོ་༎ ལྷག་མ་ཕྱི་ཡི་མཚོ་ཆེན་ཡིན་༎
 lakṣatrayaṃ sahasrāṇi viṃśatirdve ca tatra tu |	འབུམ་ཕྲག་གསུམ་དང་སྟོང་ཕྲག་ནི་༎ ཉི་ཤུ་གཉིས་སོ་དེ་ལ་ནི་༎
 jambūdvīpo dvisāhasrastripārśvaḥ śakaṭākṛtiḥ || vakk_3|53 ||	འཛམ་བུའི་གླིང་སྟེ་ངོས་གསུམ་ལ་༎ སྟོང་ཕྲག་གཉིས་སོ་ཤིང་རྟའི་དབྱིབས་༎
 sārdhatriyojanaṃ tvekaṃ prāgvideho 'rdhacandravat |	གཅིག་ལ་དཔག་ཚད་ཕྱེད་དང་བཞི་༎ ཤར་གྱི་ལུས་འཕགས་ཟླ་ཁམ་འདྲ་༎
 pārśvatrayaṃ tathāsya ekaṃ sārdhaṃ triśatayojanam || vakk_3|54 ||	ངོས་གསུམ་འདི་དང་འདྲ་གཅིག་ལ་༎ དཔག་ཚད་སུམ་བརྒྱ་ལྔ་བཅུའོ་༎ བ་ལང་སྤྱོད་གླིང་ཟླུམ་པོ་སྟེ་༎
 godānīyaḥ sahasrāṇi sapta sārdhāni maṇḍalaḥ |	སྟོང་ཕྲག་ཕྱེད་དང་བརྒྱད་ཡིན་ནོ་༎
 sārdhe dve madhyamasya aṣṭau caturasraḥ kuruḥ samaḥ || vakk_3|55 || dehā videhāḥ kuravaḥ kauravāścāmarāvarāḥ |	དེའི་དབུས་སྟོང་ཕྲག་ཕྱེད་དང་གསུམ་༎
 aṣṭau tadantaradvīpā gāṭhā uttaramantriṇaḥ || vakk_3|56 ||	སྒྲ་མི་སྙན་བརྒྱད་གྲུ་བཞིར་མཉམ༎ དེ་ཡི་བར་གྱི་གླིང་བརྒྱད་ནི་༎ ལུས་དང་ལུས་འཕགས་སྒྲ་མི་སྙན་༎ སྒྲ་མི་སྙན་གྱི་ཟླ་དང་ནི་༎ རྔ་ཡབ་དང་ནི་རྔ་ཡབ་གཞན་༎ ག-ཡོ་ལྡན་དང་ནི་ལམ་མཆོག་འགྲོ་༎
 ihottareṇa kīṭādri navakāddhimavān tataḥ |	འདི་ནས་བྱང་དུ་རི་ནག་པོ་༎ དགུ་འདས་གངས་རིའོ་དེ་ནས་ནི་༎ སྤོས་ངད་ལྡང་བའི་ཚུ་རོལ་ན་༎
 pañcāśadvistṛtāyāmaṃ saro 'rvāggandhamādanāt || vakk_3|57 ||	ཆུ་ཞེང་ལྔ་བཅུ་ཡོད་པའི་མཚོ་༎
 adhaḥ sahasrairviśatyā tanmātro 'vīcirasya hi |	འདི་འོག་སྟོང་ཕྲག་ཉི་ཤུ་ན་༎ མནར་མེད་པའོ་དེ་ཙམ་མོ་༎
 tadūrdhvaṃ sapta narakāḥ sarve 'ṣṭau ṣoḍaśotsadāḥ || vakk_3|58 ||	དེ་ཡི་སྟེང་ན་དམྱལ་བ་བདུན་༎ བརྒྱད་པོ་ཀུན་ལས་ལྷག་བཅུ་དྲུག་། དེ་དག་གི་ནི་ངོས་བཞི་ན་༎
 kukūlaṃ kuṇapaṃ cātha kṣuramārgādikaṃ nadī |	མེ་མ་མུར་དང་རོ་མྱགས་དང་༎ སྤུ་གྲིའི་ལམ་སོགས་ཆུ་བོ་ཡིན་༎
 teṣāṃ caturdiśaṃ śītā anye 'ṣṭāvarvudādayaḥ || vakk_3|59 ||	ཆུ་བུར་ཅན་སོགས་གྲང་བརྒྱད་གཞན་༎
 ardhena meroścandrārkau pañcāśatsaikayojanau |	ཉི་ཟླ་ལྷུན་པོའི་ཕྱེད་ནའོ་༎ དཔག་ཚད་ལྔ་བཅུ་གཅིག་དང་བཅས་༎
 ardharātro 'staṃgamanaṃ madhyānha udayaḥ sakṛta || vakk_3|60 ||	ནམ་ཕྱེད་ཉི་མ་ནུབ་པ་དང་༎ ཉི་མ་ཕྱེད་དང་འཆར་དུས་གཅིག་༎
 prāvṛṇmāse dvitīye 'ntyanavamyāṃ vardhate niśā |	དབྱར་གྱི་ཟླ་བ་གཉིས་པ་ཡི་༎ ཐ་མའི་ཚེས་དགུ་ནས་མཚན་རིང་༎
 hemantānāṃ caturthe tu hīyate aharviparyayāt || vakk_3|61 ||	དགུན་རྣམས་ཀྱི་ནི་བཞི་པ་ལ་༎ ཐུང་ངུར་འགྱུར་རོ་ཉིན་མོ་བཟློག་། 
 lavaśo rātryaharvṛddhī dakṣiṇottarage ravau |	ཉིན་མཚན་རིང་བ་ཐང་ཅིག་གོ་༎ ཉི་མ་ལྷོ་བྱང་འགྲོ་ཚེའོ་༎ ཉི་མ་དང་ནི་ཉེ་བ་ལས་༎
 svacchāyayārkasāmīpyādvikalendusamīkṣaṇam || vakk_3|62 ||	རང་གི་གྲིབ་མས་འགྲིབ་པར་སྣང་༎
 pariṣaṇḍāścatasro 'sya daśasāhasrikāntarāḥ |	འདི་ལ་བང་རིམ་བཞི་ཡོད་དེ་༎ བར་གྱི་ཐག་ནི་སྟོང་ཕྲག་བཅུ་༎
 ṣoḍaśāṣṭau sahasrāṇi catvāri dve ca nirgatāḥ || vakk_3|63 ||	སྟོང་ཕྲག་དག་ནི་བཅུ་དྲུག་དང་༎ བརྒྱད་དང་བཞི་དང་གཉིས་འཕགས་སོ་༎
 karoṭapāṇayastāsu mālādhārāssadāmadāḥ |	དེ་ལ་ལག་ན་གཞོང་ཐོགས་དང་༎ ཕྲེང་ཐོགས་དང་ནི་རྟག་མྱོས་དང་༎ རྒྱལ་ཆེན་བཞི་པའི་ལྷ་རྣམས་གནས་༎
 mahārājikadevāśca parvateṣvapi saptasu || vakk_3|64 ||	རི་ནི་བདུན་པོ་དག་ལ་ཡང་༎
 merumūrdhni trayastriṃśāḥ sa cāśītisahasradik |	ལྷུན་པོའི་རྩེ་ན་སུམ་ཅུ་གསུམ་༎ དེ་ཡི་ངོས་ལ་བརྒྱད་ཁྲིའོ་༎
 vidikṣu kūṭāścatvāra uṣitā vajrapāṇibhiḥ || vakk_3|65 ||	ཕྱོགས་མཚམས་བརྩེགས་པ་བཞི་ལ་ནི་༎ ལག་ན་༄༩བ་རྡོ་རྗེ་གནས་དབུས་ན་༎ གྲོང་ཁྱེར་བལྟ་ན་སྡུག་ཅེས་པ་༎ ངོས་ལ་ཉིས་སྟོང་ལྔ་བརྒྱ་པ་༎
 madhye sārdhadvisāhasrapārśvamadhyardhayojanam |	དཔག་ཚད་ཕྱེད་དང་གཉིས་གསེར་གྱི་༎
 puraṃ sudarśanaṃ nāma haimaṃ citratalaṃ mṛdu || vakk_3|66 ||	རང་བཞིན་གཞི་བཀྲ་མཉེན་པ་ཡོད་༎
 sārdhadviśatapārśvo 'tra vaijayantaḥ bahiḥ punaḥ |	དེ་ན་རྣམ་པར་རྒྱལ་བྱེད་དེ་༎ ངོས་ལ་ཉིས་བརྒྱ་ལྔ་བཅུའོ་༎
 taccaitrarathapāruṣyamiśranandanabhūṣitam || vakk_3|67 ||	ཕྱི་རོལ་ཤིང་རྟ་སྣ་ཚོགས་དང་༎ རྩུབ་འགྱུར་འདྲེས་ཚལ་དགའ་བས་བརྒྱན་༎
 viṃśatyantaritānyeṣāṃ subhūmīni caturdiśam |	དེ་དག་གི་ནི་ཕྱོགས་བཞི་ན་༎ ཉི་ཤུས་བཅད་ན་ས་གཞི་བཟང་༎
 pūrvottare pārijātaḥ sudharmā dakṣiṇāvare || vakk_3|68 ||	བྱང་ཤར་མཚམས་ན་ཡོངས་འདུ་སྟེ་༎ ལྷོ་ནུབ་མཚམས་ན་ཆོས་བཟང་ངོ་༎
 tata ūrdhva vimāneṣu devāḥ kāmabhujastu ṣaṭ |	དེ་སྟེང་ལྷ་རྣམས་གཞལ་མེད་ཁང་༎ འདོད་པ་སྤྱོད་པ་དྲུག་ཡིན་ནོ་༎
 dvaṃdvāliṃṅganapāṇyāptivasitekṣitamaithunāḥ || vakk_3|69 ||	གཉིས་གཉིས་འཁྱུད་དང་ལག་བཅངས་དང་༎ དགོད་དང་བལྟས་པས་འཁྲིག་པ་ཡིན་༎ བྱིས་པ་ལོ་ལྔ་ལོན་པ་ནས་༎
 pañcavarṣopamo yāvat daśavarṣopamaḥ śiśuḥ |	ལོ་བཅུ་ལོན་པ་ལྟ་བུའི་བར་༎
 saṃbhavatyeṣu saṃpūrṇāḥ savastrāścaiva rūpiṇaḥ || vakk_3|70 ||	དེ་དག་ཏུ་སྐྱེ་གཟུགས་ཅན་རྣམས་༎ ཀུན་རྫོགས་གོས་དང་བཅས་པ་ཉིད་༎
 kāmopapattayastistraḥ kāmadevāḥ samānuṣāḥ |	འདོད་པ་སྐྱེ་བ་གསུམ་པོ་ནི་༎ འདོད་པའི་ལྷ་དང་མིར་བཅས་རྣམས་༎
 sukhopapattayastistro navatridhyānabhūmayaḥ || vakk_3|71 ||	བདེ་བ་སྐྱེ་བ་གསུམ་པོ་ནི་༎ བསམ་གཏན་གསུམ་ལ་ས་དགུ་ཡིན་།
 sthānāt sthānadadho yāvattāvadūrdhvaṃ tatastataḥ |	གནས་ནས་གནས་འོག་ཇི་སྲིད་པ་༎ དེ་ནས་དེ་ཡི་གོང་དེ་སྲིད་༎ རྫུ་འཕྲུལ་གཞན་རྟེན་མ་གཏོགས་པ་༎
 nordhva darśanamastyeṣāmanyatrarddhiparāśrayāt || vakk_3|72 ||	དེ་དག་གོང་མ་མཐོང་བ་མེད་༎
 caturdvīpakacandrārkamerukāmadivaukasām | brahmalokasahasraṃ ca sāhasraścūḍiko mataḥ || vakk_3|73 ||	གླིང་བཞི་པ་དང་ཉི་ཟླ་དང་༎ རི་རབ་དང་ནི་འདོད་ལྷ་དང་༎ ཚངས་པའི་འཇིག་རྟེན་སྟོང་ལ་ནི་༎ སྟོང་ནི་སྤྱི་ཕུད་ཡིན་པར་འདོད་༎
 tatsahasraṃ dvisāhasro lokadhātustu madhyamaḥ |	དེ་སྟོང་ལ་ནི་སྟོང་གཉིས་པ་༎ བར་མའི་འཇིག་རྟེན་ཁམས་ཡིན་ནོ་༎
 tatsahasraṃ trisāhasraḥ samasaṃvartasaṃbhavaḥ || vakk_3|74 ||	དེ་སྟོང་ལ་ནི་སྟོང་གསུམ་མོ་༎ མཉམ་དུ་འཇིག་ཅིང་འབྱུང་བ་ཡིན་༎
 jāmbūdvīpāḥ pramāṇena catuḥsārdhatrihastakāḥ |	འཛམ་བུ་གླིང་པ་རྣམས་ཀྱི་ཚད་༎ ཁྲུ་བཞི་པ་དང་ཕྱེད་དང་བཞི་༎ ཤར་དང་བ་ལང་སྤྱོད་དང་ནི་༎
 dviguṇottaravṛddhayā tu purvagodottarāvhayāḥ || vakk_3|75 ||	བྱང་ཞེས་བྱ་བ་ཉིས་འགྱུར་བསྐྱེད་༎
 pādabṛddhayā tanuryāva tsārdhakrośo divaukasām |	འདོད་དང་ལྡན་པའི་ལྷ་ཡི་ལུས་༎ བཞི་ཆ་ནས་ནི་རྒྱང་གྲགས་དག་༎ ཕྱེད་དང་གཉིས་ཀྱི་བར་དུ་བསྐྱེད་༎
 kāmināṃ rūpiṇāṃ tvādau yojanārdhaṃ tataḥ param || vakk_3|76 ||	གཟུགས་ཅན་དང་པོ་དཔག་ཚད་ཕྱེད་༎ དེ་ཡི་གོང་མ་ཕྱེད་ཕྱེད་བསྐྱེད་༎
 ardhārdhavṛddhi ūrdhva tu parīttābhebhya āśrayaḥ |	འོད་ཆུང་རྣམས་ཀྱི་ལྟག་ཡན་ཆད་༎ ལུས་ནི་ཉིས་འགྱུར་ཉིས་འགྱུར་ཏེ་༎
 dviguṇadviguṇā hitvānabhrakebhya striyojanam || vakk_3|77 ||	སྤྲིན་མེད་དཔག་ཚད་གསུམ་དོར་རོ་༎
 sahasrāmāyuḥ kuruṣu dvayorardhārdhavarjitam |	སྒྲ་མི་སྙན་ན་ཚེ་སྟོང་སྟེ་༎ གཉིས་ན་ཕྱེད་ཕྱེད་སྤངས་པའོ་༎
 ihāniyatam ante tu daśābdāḥ ādito 'mitam || vakk_3|78 ||	འདི་ན་མ་ངེས་ཐ་མར་ནི་༎ ལོ་བཅུ་དང་པོ་དཔག་ཏུ་མེད་༎
 nṛṇāṃ varṣāṇi pañcāśadahorātro divaukasām |	མི་རྣམས་ཀྱི་ལོ་ལྔ་བཅུ་ལ་༎ འདོད་པ་དག་གི་ལྷ་རྣམས་༄༡༠ཨ་༌་༎ ལས་༎ འོག་མ་དག་གི་ཉིན་ཞག་གཅིག་། 
 kāme 'dharāṇāṃ tenāyuḥ pañcavarṣaśatāni tu || vakk_3|79 ||	དེས་ན་ཚེ་ལོ་ལྔ་བརྒྱའོ་༎
 dviguṇottaramurdhvānāmubhayaṃ rūpiṇāṃ punaḥ |	གོང་མ་གཉིས་ཀ་ཉིས་འགྱུར་རོ་༎
 nāstyahorātramāyustu kalpaiḥ svāśrayasaṃmitaiḥ || vakk_3|80 ||	གཟུགས་ཅན་ཉིན་མཚན་མེད་ཚེ་ནི་༎ རང་ལུས་གཞལ་བའི་བསྐལ་པ་ཡིས་༎
 ārūpye viṃśatiḥ kalpasahasrāṇya dhikādhikam |	གཟུགས་མེད་བསྐལ་པ་སྟོང་ཕྲག་ནི་༎ ཉི་ཤུ་ལྷག་པས་ལྷག་པ་ཡིན་༏་།འོད་ཆུང་ནས་བཟུང་བསྐལ་ཆེན་ཏེ་༎
 mahākalpaḥ parīttābhāt prabhṛtyadharmadhastataḥ || vakk_3|81 ||	དེ་ཡི་འོག་མ་ཕྱེད་ཡིན་ནོ་༎
 kāmedevāyuṣā tulyā ahorātrā yathākramam |	ཡང་སོས་ལ་སོགས་དྲུག་རིམ་བཞིན་༎ འདོད་ལྷའི་ཚེ་དང་ཉིན་ཞག་མཉམ་༎
 saṃjīvādiṣu ṣaṭsu āyustaisteṣāṃ kāmadevavat || vakk_3|82 ||	དེས་ན་དེ་དག་རྣམས་ཀྱི་ཚེ་༎ འདོད་པའི་ལྷ་དང་འདྲ་བ་ཡིན་༎ རབ་ཏུ་ཚ་ཕྱེད་མནར་མེད་ནི་༎
 ardhaṃ pratāpane avīcāvantaḥkalpaṃ paraṃ punaḥ |	བར་གྱི་བསྐལ་པའོ་དུད་འགྲོ་རྣམས་༎ མཆོག་རིང་བསྐལ་པའོ་ཡི་དགས་རྣམས་༎
 kalpaṃ tiraścāṃ pretānāṃ māsānhā śatapañcakam || vakk_3|83 ||	ཟླ་བ་ཉིན་ཞག་གི་ལྔ་བརྒྱ་༎
 vāhādvarṣaśatenaikatiloddhārakṣayāyuṣaḥ |	ཏིལ་སྦྱངས་ནང་ནས་ལོ་བརྒྱ་ཞིང་༎ ཏིལ་གཅིག་ཕྱུང་བས་ཟད་གྱུར་པ་༎ ཆུ་བུར་ཅན་གྱི་ཚེ་ཡིན་ཏེ་༎
 arvudā dviṃśatiguṇaprativṛddhayāyuṣaḥ pare || vakk_3|84 ||	གཞན་གྱི་ཚེ་ནི་ཉི་ཤུས་བསྒྱུར་༎
 kurubāhyo 'ntarāmṛtyuḥ paramāṇvakṣarakṣaṇāḥ |	སྒྲ་མི་སྙན་མ་གཏོགས་པར་འཆི་༏་། གཟུགས་མིང་དུས་མཐའ་རྡུལ་ཡིག་དང་༎ སྐད་ཅིག་ཕྲ་རབ་རྡུལ་དང་ནི་༎
 rūpanāmādhvaparyantāḥ paramāṇuraṇustathā || vakk_3|85 ||	རྡུལ་ཕྲན་དང་ནི་དེ་བཞིན་དུ་༎
 lohāpśaśā vigocchidrarajolikṣāstadudbhavāḥ |	ལྕགས་ཆུ་རི་བོང་ལུག་དང་གླང་༎ ཉི་ཟེར་རྡུལ་དང་སྲོ་མ་དང་༎ དེ་ལས་བྱུང་དང་དེ་བཞིན་དུ་༎
 yavastathāṅgulīparva jñeyaṃ saptaguṇottaram || vakk_3|86 ||	སོར་ཚིགས་ཞེས་བྱ་གོང་བདུན་བསྒྱུར་༎
 caturviśatiraṅgulyo hasto hastacatuṣṭayam |	སོར་མོ་ཉི་ཤུ་བཞི་ལ་ཁྲུ་༎ ཁྲུ་བཞི་ལ་ནི་གཞུ་གང་ངོ་། དེ་དག་ལྔ་བརྒྱ་རྣམས་ལ་ནི་༎
 dhanuḥ pañcaśatānyeṣāṃ krośo raṇyaṃ ca tanmatam || vakk_3|87 ||	རྒྱང་གྲགས་དེ་ལ་དགོན་པར་འདོད་༎
 te 'ṣṭau yojanamityāhuḥ viṃśaṃ kṣaṇaśataṃ punaḥ |	དེ་བརྒྱད་དཔག་ཚད་ཅེས་བྱའོ་༎ སྐད་ཅིག་མ་བརྒྱ་ཉི་ཤུ་ལ་༎
 tatkṣaṇaḥ te punaḥ ṣaṣṭirlavaḥ triṃśad guṇottarāḥ || vakk_3|88 ||	དེ་ཡི་སྐད་ཅིག་དེ་དག་ཀྱང་༎ དྲུག་ཅུ་ལ་ནི་ཐང་ཅིག་གོ་༎
 trayo muhūrttāhorātramāsāḥ dvādaśamāsakaḥ |	ཡུད་ཙམ་ཉིན་ཞག་ཟླ་གསུམ་ནི་༎ གོང་ནས་གོང་དུ་སུམ་ཅུ་འགྱུར་༎ ཞག་མི་ཐུབ་དང་བཅས་པ་ཡི་༎
 saṃvatsaraḥ sonarātraḥ kalpo bahuvidhaḥ smṛtaḥ || vakk_3|89 ||	ཟླ་བ་བཅུ་གཉིས་ལ་ལོ་གཅིག་༎ བསྐལ་པ་རྣམ་པ་མང་བཤད་པ་༎
 saṃvarttakalpo narakasaṃbhavāt bhājanakṣayaḥ |	འཇིག་པའི་བསྐལ་པ་དམྱལ་བ་ཡི་༎ སྲིད་པ་མེད་ནས་སྣོད་ཟད་པ་༎
 vivartakalpaḥ prāgvāyoryāvannaraka saṃbhavaḥ || vakk_3|90 ||	འཆགས་པ་དང་པོའི་རླུང་ནས་ནི་༎ དམྱལ་བའི་སྲིད་པའི་བར་དུའོ་༎
 antaḥ kalpo 'mitāt yavaddaśavarṣāyuṣaḥ tataḥ |	བར་གྱི་བསྐལ་པ་དཔག་མེད་ནས་༎ ཚེ་ལོ་བཅུ་པའི་བར་དུའོ་༎ དེ་ནས་ཡར་སྐྱེ་མར་འབྲི་བའི་༎
 utkarṣā apakarṣāśca kalpā aṣṭā daśāpare || vakk_3|91 ||	བསྐལ་པ་གཞན་ནི་བཅོ་བརྒྱད་དང་༎ ཡར་སྐྱེ་བ་ནི་གཅིག་ཡིན་ཏེ་༎
 utkarṣa ekaḥ te 'śītisahasrādyāvadāyuṣaḥ |	དེ་དག་ཚེ་ནི་བརྒྱད་ཁྲིའི་བར་༎
 iti loko vivṛtto 'yaṃ kalpāṃstiṣṭhati viṃśatim || vakk_3|92 ||	དེ་ལྟར་འཇིག་རྟེན་ཆགས་པ་འདི་༎ བར་གྱི་༄༡༠བ་བསྐལ་པ་ཉི་ཤུར་གནས་༎
 vivartate 'tha saṃvṛtta āste saṃvartate samam |	འཆགས་པ་དང་ནི་འཇིག་པ་དང་༎ ཞིག་ནས་འདུག་པ་དག་མཉམ་མོ་༎ དེ་དག་བརྒྱད་ཅུ་ལ་བསྐལ་ཆེན་༎
 te hyaśītirmahākalpaḥ tadasaṃkhyatrayodbhavam || vakk_3|93 ||	དེ་གྲངས་མེད་གསུམ་ལ་སངས་རྒྱས་༎
 buddhatvam apakarṣe hi śatādyāvattadudbhavaḥ |	འབྱུང་ངོ་མར་ནི་འགྲིབ་པ་ཡི་༎ བརྒྱ་ཡི་བར་ལ་དེ་དག་འབྱུང་༎
 dvayoḥ pratyekabuddhānāṃ khaḍgaḥ kalpaśatānvayaḥ || vakk_3|94 ||	རང་སངས་རྒྱས་རྣམས་གཉིས་ཀ་ལ་༎ བསེ་རུ་བསྐལ་པ་བརྒྱ་ཡི་རྒྱུས་༎
 cakravartisamutpattirnādho 'śītisahasrakāt |	འཁོར་ལོས་སྒྱུར་བ་འབྱུང་བ་ནི་༎ སྟོང་ཕྲག་བརྒྱད་ཅུ་ལས་མི་འཕྱི་༎
 suvarṇarūpyatāmrāyaścakriṇaḥ te 'dharakramāt || vakk_3|95 ||	གསེར་དངུལ་ཟངས་ལྕགས་འཁོར་ལོ་ཅན་༎
 ekadvitricaturdvīpāḥ na ca dvau saha buddhavat |	དེ་དག་གླིང་གཅིག་གླིང་གཉིས་དང་༎ གསུམ་དང་བཞི་ལས་མས་རིམ་བཞིན་༎ ལྷན་ཅིག་གཉིས་མིན་སངས་རྒྱས་བཞིན་༎
 pratyudyānasvayaṃyāna kalahāstrajitaḥ avadhāḥ || vakk_3|96 ||	ཕས་བསུ་རང་འགྲོ་ག-ཡུལ་བཤམས་དང་༎ མཚོན་བརྩམས་པས་རྒྱལ་གནོད་པ་མེད་༎
 deśasthottaptapūrṇatvairlakṣaṇātiśayo muneḥ |	ཐུབ་མཚན་ཡུལ་ན་གནས་པ་དང་༎ གསལ་ལ་རྫོགས་པས་འཕགས་པ་ཡིན་༎
 prāgāsan rūpivat sattvāḥ rasarāgāttataḥ śanaiḥ || vakk_3|97 ||	སྔར་བྱུང་སེམས་ཅན་གཟུགས་ཅན་བཞིན་༎ དེ་ནས་རིམ་གྱིས་རོ་ལ་ཆགས༎
 ālasyātsaṃnidhiṃ kṛtvā sāgrahaiḥ kṣetrapo bhṛtaḥ |	ལེ་ལོས་སོག་འཇོག་བྱས་ནས་ནི་༎ འཛིན་བཅས་རྣམས་ཀྱིས་ཞིང་དཔོན་བསྟབས་༎
 tataḥ karmapathādhikyādapahrāse daśāyuṣaḥ || vakk_3|98 ||	དེ་ནས་ལས་ཀྱི་ལམ་ལྷག་པས་༎ ཚེ་ཐུང་ལོ་ནི་བཅུ་ཡིན་ནོ་༎
 kalpasya śastrarogābhyāṃ durbhikṣeṇa ca nirgamaḥ |	བསྐལ་པ་མཚོན་དང་ནད་དང་ནི་༎ མུ་གེ་དག་གིས་ཚར་ཕྱིན་ཏོ་༎
 divasān sapta māsāṃśca varṣāṇi ca yathākramam || vakk_3|99 ||	ཞག་རྣམས་དང་ནི་ཟླ་བ་དང་༎ ལོ་བདུན་དག་ཏུ་གོ་རིམས་བཞིན་༎
 saṃvartanyaḥ punastistro bhavantyagnyambuvāyubhiḥ |	མེ་དང་ཆུ་དང་རླུང་དག་གིས་༎ འཇིག་པ་དག་ནི་ཡང་གསུམ་ཡིན་༎
 dhyānatrayaṃ dvitīyādi śīrṣa tāsāṃ yathākramam || vakk_3|100 ||	བསམ་གཏན་གཉིས་སོགས་གསུམ་པོ་ནི་༎ དེ་དག་གི་རྩེ་གོ་རིམས་བཞིན་༎
 tadapakṣālasādharmyāt na caturthe 'styaniñjanāt |	དེ་ཡི་སྐྱོན་དང་ཆོས་མཐུན་ཕྱིར་༎ བཞི་པ་ན་མེད་མི་ག-ཡོའི་ཕྱིར་༎ མི་རྟག་དེ་ཡི་གཞལ་མེད་ཁང་༎
 na nityaṃ saha sattvena tadvimānodayavyayāt || vakk_3|101 ||	སེམས་ཅན་བཅས་ཏེ་འབྱུང་འཇིག་ཕྱིར་༎
 saptāgninā adbhirekā evaṃ gate 'dbhiḥ saptake punaḥ |	།
 tejasā saptakaḥ paścādvāyusaṃvartanī tataḥ || vakk_3|102 ||	མེ་ཡིས་བདུན་ནོ་དེ་ནས་ནི་༎ མཇུག་ཏུ་རླུང་གིས་འཇིག་པ་ཡིན་༎
 abhidharmakośabhāṣye lokanirdeśo nāma tṛtīyaṃ kośasthānam samāptamiti | śrīlāmāvākasya yadatra puṇyam |	ཆོས་མངོན་པའི་མཛོད་ཀྱི་ཚིག་ལེའུར་བྱས་པ་ལས་༎
 caturthaṃ kośasthānam oṃ namo buddhāya |	འཇིག་རྟེན་བསྟན་པ་ཞེས་བྱ་བ་སྟེ་གནས་གསུམ་པའོ་།
 karmajaṃ lokavaicitryaṃ cetanā tatkṛtaṃ ca tat |	༎ ། ལས་ལས་འཇིག་རྟེན་སྣ་ཚོགས་སྐྱེས་༎ དེ་ནི་སེམས་པ་དང་དེས་བྱས་༎
 cetanā mānasaṃ karma tajjaṃ vākkāyakarmaṇī || vakk_4|1 ||	སེམས་པ་ཡིད་ཀྱི་ལས་ཡིན་ནོ་༎ དེས་བསྐྱེད་ལུས་དང་ངག་གི་ལས་༎
 te tu vijñaptyavijñaptī kāyavijñaptiriṣyate |	དེ་དག་རྣམ་རིག་རྣམ་རིག་མིན་༎ ལུས་རྣམ་རིག་བྱེད་དབྱིབས་སུ་འདོད་༎
 saṃsthānaṃ na gatiryasmātsaṃskṛtaṃ kṣaṇikaṃ vyayāt || vakk_4|2 ||	འགྲོ་མིན་གང་ཕྱིར་འདུས་༄༡༡ཨ་༌་༎ བྱས་ནི་༎ སྐད་ཅིག་མ་ཡིན་འཇིག་ཕྱིར་རོ་༎
 na kasyacidahetoḥ syāt hetuḥ syācca vināśakaḥ |	རྒྱུ་མེད་པ་ལས་འགའ་མི་འབྱུང་༎ རྒྱུ་ཡང་འཇིག་པ་པོར་འགྱུར་རོ་༎
 dvigrāhyaṃ syāt na cāṇau tat vāgvijñaptistu vāgdhvaniḥ || vakk_4|3 ||	གཉིས་གཟུང་འགྱུར་ཏེ་རྡུལ་ལ་མེད་༎ ངག་རྣམས་རིག་བྱེད་ནི་ངག་སྒྲ་༎
 trividhāmalarūpoktivṛddhayakurvatpathādibhiḥ |	རྣམ་གསུམ་དྲི་མེད་གཟུགས་གསུངས་དང་༎ འཕེལ་དང་མ་བྱས་ལམ་སོགས་ཕྱིར་༎
 kṣaṇādūrdhvamavijñaptiḥ kāmāptātītabhūtajā || vakk_4|4 ||	འདོད་གཏོགས་རྣམ་རིག་མིན་སྐད་ཅིག་༎ ཕྱིན་ཆད་འདས་པའི་འབྱུང་ལས་སྐྱེ་༎
 svāni bhūtānyupādāya kāyavākkarma sāsravam |	ཟག་བཅས་ལུས་དང་ངག་གི་ལས་༎ རང་གི་འབྱུང་བ་དག་རྒྱུར་བྱས་༎
 anāsravaṃ yatra jātaḥ avijñaptiranupāttikā || vakk_4|5 ||	ཟག་མེད་གང་དུ་སྐྱེས་པའི་ཡིན་༎ རྣམ་རིག་བྱེད་མིན་མ་ཟིན་དང་༎ རྒྱུ་མཐུན་ལས་བྱུང་སེམས་ཅན་སྟོན་༎
 naiḥṣyandikī ca sattvākhyā niṣyandopāttabhūtajā |	རྒྱུ་མཐུན་ཟིན་པའི་འབྱུང་ལས་སྐྱེ་༎
 samādhijau pacayikānupāttābhinnabhūtajā || vakk_4|6 ||	ཏིང་འཛིན་སྐྱེས་འབྱུང་མ་ཟིན་དང་༎ རྒྱས་བྱུང་ཐ་དད་མིན་ལས་སྐྱེས་༎
 nāvyākṛtāstyavijñaptiḥ tridhānvyat aśubhaṃ punaḥ |	རྣམ་རིག་མིན་ལུང་བསྟན་མིན་མེད་༎ གཞན་ནི་རྣམ་གསུམ་མི་དགེ་ནི་༎
 kāme rūpe 'pyavijñaptiḥ vijñaptiḥ savicārayoḥ || vakk_4|7 ||	འདོད་ནའོ་གཟུགས་ནའང་རྣམ་རིག་མིན་༎ རྣམ་རིག་དཔྱོད་དང་བཅས་དག་ན་༎
 kāme 'pi nivṛtā nāsti samutthānamasadyataḥ |	འདོད་པ་ན་ཡང་བསྒྲིབས་པ་མེད་༎ གང་ཕྱིར་ཀུན་སློང་མེད་ཐར་པ་༎
 paramārthaśubho mokṣaḥ svato mūlahyrapatrapāḥ || vakk_4|8 ||	དམ་པའི་དོན་དུ་དགེ་རྩ་བ་༎ ངོ་ཚ་ཁྲེལ་ཡོད་བདག་ཉིད་ཀྱིས་༎
 saṃprayogeṇa tadyuktāḥ samutthā nāt kriyādayaḥ |	དེ་དག་དང་ལྡན་མཚུངས་ལྡན་གྱིས་༎ བྱ་བ་ལ་སོགས་ཀུན་སློང་བས་༎
 viparyayeṇākuśalaṃ paramāvyākṛte dhruve || vakk_4|9 ||	བཟློག་པ་མི་དགེ་དོན་དམ་པར༎ ལུང་མ་བསྟན་པ་བསྟན་པ་དག་༎
 samutthānaṃ dvidhā hetutatkṣaṇotthānasaṃjñitam |	ཀུན་སློང་རྣམ་གཉིས་རྒྱུ་དང་ནི་༎ དེ་ཡི་དུས་ཀྱི་སློང་ཞེས་བྱ་༎
 pravartakaṃ tayorādyaṃ dvitīyamanuvartakam || vakk_4|10 ||	གཉིས་ལས་དང་པོ་རབ་འཇུག་བྱེད་༎
 pravartakaṃ dṛṣṭiheyaṃ vijñānam ubhayaṃ punaḥ |	གཉིས་པ་རྗེས་སུ་འཇུག་བྱེད་ཡིན་༎ མཐོང་བས་སྤང་བྱའི་རྣམ་ཤེས་ནི་༎
 mānasaṃ bhāvanāheyaṃ pañcakaṃ tvanuvartakam || vakk_4|11 ||	རབ་ཏུ་འཇུག་བྱེད་ཡིན་ཡིད་ནི་༎ བསྒོམ་པས་སྤང་བྱ་གཉིས་ཀ་ཡིན་༎ ལྔ་ནི་རྗེས་སུ་འཇུག་བྱེད་ཡིན་༎
 pravartake śubhādau hi syāttridhāpyanuvartakam |	རབ་ཏུ་འཇུག་བྱེད་དགེ་སོགས་ལས་༎ རྗེས་འཇུག་བྱེད་ཀྱང་རྣམ་གསུམ་འགྱུར་༎
 tulyaṃ muneḥ śubhaṃ yāvat nobhayaṃ tu vipākajam || vakk_4|12 ||	ཐུབ་པའི་འདྲ་བའམ་དེ་དགེ་བ་༎ རྣམ་སྨིན་ལས་སྐྱེས་གཉིས་ཀ་མིན་༎
 avijñaptistridhā jñeyā saṃvarāsaṃvaretarā |	རྣམ་རིག་མིན་རྣམ་གསུམ་ཤེས་བྱ་༎ སྡོམ་དང་སྡོམ་པ་མིན་དང་གཞན་༎
 saṃvaraḥ prātimokṣākhyo dhyānajo 'nāsravastathā || vakk_4|13 ||	སྡོམ་པ་སོ་སོར་ཐར་ཞེས་བྱ་༎ དེ་བཞིན་ཟག་མེད་བསམ་གཏན་སྐྱེས་༎
 aṣṭadhā prātimokṣākhyaḥ dravyatastu caturvidhaḥ |	སོ་སོར་ཐར་ཞེས་བྱ་རྣམ་བརྒྱད་༎ རྫས་སུ་རྣམ་པ་བཞི་ཡིན་ནོ་༎
 liṅgato nāmasaṃcārāt pṛthak te cāvirodhinaḥ || vakk_4|14 ||	མཚན་ལས་མིང་ནི་འཕོ་བའི་ཕྱིར་༎ ཐ་དད་དེ་དག་འགལ་བ་མེད་༎
 pañcāṣṭadaśasarvebhyo varjyebhyo viratigrahāt |	སྤང་བྱ་ལྔ་བརྒྱད་བཅུ་དང་ནི་༎ ཐམས་ཅད་སྤོང་༄༡༡བ་བ་མནོས་པ་ལས་༎
 upāsakopavāsasthaśramaṇoddeśabhikṣutā || vakk_4|15 ||	དགེ་བསྙེན་དང་ནི་བསྙེན་གནས་དང་༎ དགེ་ཚུལ་ཆེད་དང་དགེ་སློང་ཉིད་༎
 śīlaṃ sucaritaṃ karma saṃvaraścocyate punaḥ |	ཚུལ་ཁྲིམས་དང་ནི་ལེགས་སྤྱད་དང་༎ ལས་དང་སྡོམ་པ་ཞེས་བྱའོ་༎
 ādye vijñaptyavijñapto prātimokṣakriyāpathaḥ || vakk_4|16 ||	དང་པོའི་རྣམ་རིག་རྣམ་རིག་མིན་༎ སོ་སོར་ཐར་དང་བྱ་བའི་ལམ་༎
 prātimokṣānvitā aṣṭau dhyānajena tadanvitaḥ |	སོ་སོར་ཐར་དང་ལྡན་པ་བརྒྱད་། བསམ་གཏན་སྐྱེས་དང་དེ་ལྡན་པ་༎
 anāsraveṇāryasattvāḥ antyau cittānuvartinau || vakk_4|17 ||	ཟག་མེད་འཕགས་པའི་སེམས་ཅན་དང་༎ ཐ་མ་གཉིས་ནི་སེམས་རྗེས་འབྲང་༎
 anāgamye prahāṇākhyau tāvānantaryamārgajau |	བར་ཆད་མེད་ལམ་སྐྱེས་དེ་གཉིས་༎ མི་ལྕོགས་མེད་ལ་སྤོང་ཞེས་བྱ་༎
 saṃprajñānasmṛtī dve tu manaindriyasaṃvarau || vakk_4|18 ||	ཤེས་བཞིན་དང་ནི་དྲན་དག་གཉིས་༎ ཡིད་དང་དབང་པོའི་སྡོམ་པ་ཡིན་༎
 prātimokṣasthito nityamatyāgā dvartamānayā |	སོ་སོར་ཐར་གནས་ཇི་སྲིད་དུ་༎ མ་བཏང་བར་དག་ད་ལྟར་གྱི་༎
 avijñaptyānvitaḥ pūrvāt kṣaṇādūrdhvamatītayā || vakk_4|19 ||	རྣམ་རིག་མིན་ལྡན་སྐད་ཅིག་མ་༎ དང་པོ་ཕྱིན་ཆད་འདས་པ་དང་༎ སྡོམ་མིན་གནས་པའང་དེ་དང་འདྲ་༎
 tathaivāsaṃvarastho 'pi dhyānasaṃvaravān sadā |	བསམ་གཏན་སྡོམ་དང་ལྡན་པ་ནི་༎
 atītājātayā āryastu prathame nābhyatītayā || vakk_4|20 ||	རྟག་ཏུ་འདས་དང་མ་འོངས་དང་༎ འཕགས་ནི་དང་པོ་འདས་དང་མིན་༏་། མཉམ་གཞག་འཕགས་ལམ་གནས་དེ་གཉིས་༎
 samāhītāryamārgasthau tau yuktau vartamānayā |	ད་ལྟར་དང་ལྡན་བར་གནས་ལ་༎
 madhyasthasyāsti cedādau madhyayā ūrdhvaṃ dvikālayā || vakk_4|21 ||	ཡོད་ན་དང་པོ་བར་གྱི་དང་༎ ཕྱིན་ཆད་དུས་ནི་གཉིས་དང་ངོ་༎
 asaṃvarasthaḥ śubhayāśubhayā saṃvare sthitaḥ |	སྡོམ་མིན་གནས་པ་དགེ་བ་དང་༎ སྡོམ་ལ་གནས་པ་མི་དགེ་བའི་༎
 avijñaptyānvito yāvat prasādakleśavegavān || vakk_4|22 ||	རྣམ་རིག་མིན་ལྡན་ཇི་སྲིད་དུ་༎ རབ་དང་ཉོན་མོངས་ཤུགས་ལྡན་པར་༎
 vijñaptyā tu punaḥ sarve kurvanto madhyayānvitāḥ |	རྣམ་རིག་བྱེད་ནི་ཐམས་ཅད་ལ་༎ བྱེད་པ་དག་ལ་ད་ལྟར་ལྡན་༎ མ་བཏང་བར་དུ་སྐད་ཅིག་མ་༎
 atītayā kṣaṇādūrdhvamātyāgāt nāstyajātayā || vakk_4|23 ||	ཕྱིན་ཆད་འདས་ལྡན་མ་འོངས་མེད་༎
 nivṛtānivṛtābhyāṃ ca nātītābhyāṃ samanvitaḥ |	བསྒྲིབས་པ་དང་ནི་མ་བསྒྲིབས་པ་༎ འདས་པ་དག་དང་ལྡན་པའང་མེད་༎
 asaṃvaro duścaritaṃ dauḥśīlyaṃ karma tatpathaḥ || vakk_4|24 ||	སྡོམ་པ་མིན་དང་ཉེས་སྤྱད་དང་༎ འཆལ་པའི་ཚུལ་ཁྲིམས་ལས་དེའི་ལམ་༎
 vijñaptyaivānvitaḥ kurvanmadhyastho mṛducetanaḥ |	བར་མ་དོར་གནས་སེམས་ཞན་པས་༎ བྱེད་ན་རྣམ་རིག་ཉིད་དང་ལྡན་༎
 tyaktānutpannavijñaptiravijñaptyāryapudgalaḥ || vakk_4|25 ||	རྣམ་རིག་བཏང་དང་མ་སྐྱེས་པའི་༎ འཕགས་པའི་གང་ཟག་རྣམ་རིག་མིན་༎
 dhyānajo dhyānabhūmyaiva labhyate anāsravastayā |	བསམ་གཏན་ལས་སྐྱེས་བསམ་གཏན་གྱི་༎ ས་ཉིད་ཀྱིས་འཐོབ་ཟག་མེད་ནི་༎
 āryayā prātimokṣākhyaḥ paravijñapanādibhiḥ || vakk_4|26 ||	འཕགས་དེས་སོ་སོར་ཐར་ཞེས་པ་༎ གཞན་གྱི་རྣམ་རིག་བྱེད་སྩོགས་ཀྱིས་༎
 yāvajjīvaṃ samādānamahorātraṃ ca saṃvṛteḥ |	ཇི་སྲིད་འཚོ་དང་ཉིན་ཞག་ཏུ་༎ སྡོམ་པ་ཡང་དག་བླང་བར་བྱ་༎
 nāsaṃvaro 'styahorātraṃ na kilaivaṃ pragṛhyate || vakk_4|27 ||	ཉིན་ཞག་པ་ཡི་སྡོམ་མིན་མེད་༎ དེ་དེ་ལྟར་ནོད་མེད་ཅེས་གྲག་། དམའ་བར་འདུག་སྨྲས་བཟླས་པ་ཡིས་༎ མི་བརྒྱན་ནམ་ནི་༄༡༢ཨ་༌་༎
 kālyaṃ grāhyo 'nyato nīcaiḥ sthitenoktānuvāditā |	ནང་པར་དུ་༎
 upavāsaḥ samagrāṅgo nirbhūṣeṇāniśākṣayāt || vakk_4|28 ||	བསྙེན་གནས་ཡན་ལག་ཚང་བར་ནི་༎ ནང་པར་གཞན་ལས་ནོད་པར་བྱ་༎
 śīlāṅgānyapramādāṅgaṃ vratāṅgāni yathākramam |	ཚུལ་ཁྲིམས་ཡན་ལག་བག་ཡོད་པའི་༎ ཡན་ལག་བརྟུལ་ཞུགས་ཡན་ལག་སྟེ་༎
 catvāryekaṃ tathā trīṇi smṛtināśo madaśca taiḥ || vakk_4|29 ||	བཞི་གཅིག་དེ་བཞིན་གསུམ་རིམ་བཞིན་༎ དེ་ཡིས་དྲན་ཉམས་དྲེགས་པར་འགྱུར་༎
 anyasyāpyupavāso 'sti śaraṇaṃ tvagatasya na |	གཞན་ལའང་བསྙེན་གནས་ཡོད་མོད་ཀྱི་༎ སྐྱབས་སུ་མ་སོང་བ་ལ་མེད་༎ དགེ་བསྙེན་ཉིད་དུ་ཁས་བླངས་པས་༎
 upāsakatvopagamātsaṃvṛt uktistu bhikṣuvat || vakk_4|30 ||	སྡོམ་པ་བསྟན་པ་དགེ་སློང་བཞིན་༎
 sarve cet saṃvṛtā ekadeśakāryādayaḥ katham |	གལ་ཏེ་ཐམས་ཅད་བསྡམས་ཡིན་ན་༎ སྣ་གཅིག་སྤྱོད་སོགས་ཇི་ལྟ་བུ་༎
 tatpalanāt kila proktāḥ mṛdvāditvaṃ yathā manaḥ || vakk_4|31 || buddhasaṃghakarāndharmānaśaikṣānubhayāṃśca saḥ |	དེ་སྲུང་བ་ལ་གསུངས་ཞེས་གྲག་། ཆུང་ངུ་ལ་སོགས་ཡིད་ཇི་བཞིན་༎
 nirvāṇaṃ ceti śaraṇaṃ yo yāti śaraṇatrayam || vakk_4|32 ||	གང་ཞིག་གསུམ་ལ་སྐྱབས་འགྲོ་དེ་༎ སངས་རྒྱས་དགེ་འདུན་བྱེད་པའི་ཆོས་༎ མི་སློབ་པ་དང་གཉིས་ཀ་དང་༎ མྱ་ངན་འདས་ལ་སྐྱབས་སུ་འགྲོ་༎
 mithyācārātigarhyatvātsaukaryādākriyāptitaḥ |	ལོག་ག-ཡེམ་ཤིན་ཏུ་སྨད་ཕྱིར་དང་༎ སླ་ཕྱིར་མི་བྱེད་ཐོབ་ཕྱིར་རོ་༎
 yathābhyupagamaṃ lābhaḥ saṃvarasya na saṃtate || vakk_4|33 ||	སྡོམ་པ་ཇི་ལྟར་ཁས་བླངས་བཞིན་༎ འཐོབ་ཀྱི་རྒྱུད་ལས་མ་ཡིན་ནོ་༎
 mṛṣāvādaprasaṅgācca sarvaśikṣāvyatikrame |	བསླབ་པ་ཐམས་ཅད་འདས་གྱུར་ན་༎ རྫུན་དུ་ཐལ་བར་འགྱུར་བའི་ཕྱིར་༎
 pratikṣepaṇasāvadyānmadyādeva anyuguptaye || vakk_4|34 ||	བཅས་པའི་ཁ་ན་མ་ཐོ་བ་༎ མྱོས་འགྱུར་ལས་གཞན་བསྲུང་ཕྱིར་རོ་༎
 sarvobhayebhyaḥ kāmāpto vartamānebhya āpyate |	འདོད་གཏོགས་ཐམས་ཅད་གཉིས་ཀ་དང་༎ ད་ལྟར་དག་ལས་འཐོབ་པར་འགྱུར་༎
 maulebhyaḥ sarvakālebhyo dhyānānāsrava saṃvarau || vakk_4|35 ||	བསམ་གཏན་ཟག་མེད་སྡོམ་པ་ནི་༎ དངོས་དང་དུས་ནི་ཐམས་ཅད་ལས་༎
 saṃvaraḥ sarvasattvebhyo vibhāṣā tvaṅgakāraṇaiḥ |	སྡོམ་པ་སེམས་ཅན་ཐམས་ཅད་ལས་༎ ཡན་ལག་རྒྱུ་ལ་དབྱེ་བ་ཡོད་༎
 asaṃvarastu sarvebhyaḥ sarvāṅgebhyo na kāraṇaiḥ || vakk_4|36 ||	སྡོམ་པ་མིན་པ་ཐམས་ཅད་དང་༎ ཡན་ལག་ཀུན་ལས་རྒྱུས་མིན་ནོ་༎
 asaṃvarasya kriyayā lābho 'bhyupagamena vā |	སྡོམ་པ་མིན་པ་བྱ་བའམ་༎ ཁས་ལེན་པ་ལས་འཐོབ་པར་འགྱུར་༎
 śeṣāvijñaptilābhastu kṣetrādānādarehanāt || vakk_4|37 ||	ལྷག་མའི་རྣམ་རིག་མིན་ཞིང་དང་༎ ལེན་དང་གུས་པར་བྱེད་པས་འཐོབ་༎
 prātimokṣadamatyāgaḥ śikṣānikṣepaṇāccyuteḥ | ubhayavyañjanotpattermūlacchedānniśātyayāt || vakk_4|38 ||	བསླབ་པ་ཕུལ་དང་ཤི་འཕོས་དང་༎ མཚན་གཉིས་དག་ནི་བྱུང་བ་དང་༎ རྩ་བ་ཆད་དམ་མཚན་འདས་ལས་༎ སོ་སོར་ཐར་པའི་འདུལ་བ་གཏོང་༎
 patanīyena cetyeke saddharmāntadhito 'pare |	ཁ་ཅིག་ལྟུང་བར་འགྱུར་ལས་སྨྲ་༎ གཞན་དག་དམ་ཆོས་ནུབ་པ་ལས་༎ ཁ་ཆེ་རྣམས་ནི་བྱུང་བ་ལ་༎
 dhanarṇavattu kāśmīrairāpannasyeṣyate dvayam || vakk_4|39 ||	བུ་ལོན་ནོར་བཞིན་གཉིས་སུ་འདོད་༎
 bhūmisaṃcārahānibhyāṃ dhyānāptaṃ tyajyate śubham |	བསམ་གཏན་གཏོགས་པའི་དགེ་བ་ནི་༎ ས་འཕོས་ཉམས་པ་དག་གིས་གཏོང་༎
 tathārūpyāptamāryaṃ tu phalāptyuttaptihānibhiḥ || vakk_4|40 ||	དེ་བཞིན་གཟུགས་མེད་གཏོགས་འཕགས་པ་༎ འབྲས་བུ་ཐོབ་༄༡༢བ་སྦྱངས་ཉམས་པ་ལས་༎
 asaṃvaraḥ saṃvarāptimṛtyudvivyañjanodayaiḥ |	སྡོམ་མིན་སྡོམ་པ་ཐོབ་པ་དང་༎ ཤི་དང་མཚན་གཉིས་བྱུང་བ་ལས་༎
 vegādānakriyārthāyurmūlacchedaistu madhyamā || vakk_4|41 ||	བར་མ་ཤུགས་བླངས་བྱ་བ་དང་༎ དོན་ཚེ་རྩ་བ་ཆད་པ་ལས་༎
 kāmāptaṃ kuśalārūpaṃ mūlacchedordhvajanmataḥ |	འདོད་གཏོགས་དགེ་བ་གཟུགས་མིན་ནི་༎ རྩ་ཆད་གོང་དུ་སྐྱེས་པ་ལས་༎
 pratipakṣodayāt kliṣṭamarūpaṃ tu vihīyate || vakk_4|42 ||	ཉོན་མོངས་པ་ཅན་གཟུགས་མིན་ནི༎ གཉེན་པོ་སྐྱེས་པས་རྣམ་ཉམས་འགྱུར་༎
 nṛṇāmasaṃvaro hitvā śaṇḍha paṇḍadvidhākṛtīn |	ཟ་མ་མ་ནིང་སྒྲ་མི་སྙན་༎ མཚན་གཉིས་མ་གཏོགས་མི་རྣམས་ལ་༎
 kurūṃśca saṃvaro 'pyevaṃ devānāṃ ca nṛṇāṃ trayaḥ || vakk_4|43 ||	སྡོམ་མིན་སྡོམ་པའང་དེ་བཞིན་ནོ་༎ ལྷ་ལའང་མི་རྣམས་ལ་གསུམ་མོ་༎
 kāmarūpajadevānāṃ dhyānajaḥ anāsravaḥ punaḥ |	འདོད་དང་གཟུགས་སྐྱེས་ལྷ་རྣམས་ལ་༎ བསམ་གཏན་སྐྱེས་ཡོད་ཟག་མེད་ནི་༎ བསམ་གཏན་ཁྱད་པར་འདུ་ཤེས་མེད་༎
 dhyānāntarāsaṃjñisattvavarjyānāmapyarūpiṇām || vakk_4|44 ||	སེམས་ཅན་མ་གཏོགས་གཟུགས་མེད་ནའང་༎
 kṣemākṣemetaratkarma kuśalākuśaletarat |	ལས་བདེ་མི་བདེ་དང་གཞན་ནི་༎ དགེ་དང་མི་དགེ་དང་གཞན་ཡིན་༎
 puṇyāpuṇyamaniñjaṃ ca sukhevedyādi ca trayam || vakk_4|45 ||	བསོད་ནམས་བསོད་ནམས་མིན་མི་ག-ཡོ་༎ བདེ་བ་མྱོང་འགྱུར་ལ་སོགས་གསུམ་༎
 kāmadhātau śubhaṃ karma puṇyamāneñjamūrdhvajam |	བསོད་ནམས་འདོད་ཁམས་དགེ་བའི་ལས་༎ མི་ག-ཡོ་གོང་མ་ལས་སྐྱེས་པའི་༎
 tadbhūmiṣu yataḥ karmavipākaṃ prati neñjati || vakk_4|46 ||	གང་ཕྱིར་ས་ནི་དེ་དག་ཏུ་༎ ལས་རྣམས་སྨིན་ཕྱིར་མི་ག-ཡོའི་ཕྱིར་༎
 sukhavedyaṃ śubhaṃ dhyānādātṛtīyāt ataḥ param |	བསམ་གཏན་གསུམ་པའི་བར་དགེ་བ་༎ བདེ་བ་མྱོང་འགྱུར་དེ་ཡན་ཆད་༎
 aduḥkhāsukhavedyaṃ tu duḥkhavedyamihāśubham || vakk_4|47 ||	སྡུག་མིན་བདེ་མིན་མྱོང་འགྱུར་བ་༎ སྡུག་བསྔལ་མྱོང་འགྱུར་འདིའི་མི་དགེ་འོག་ནའང་བར་མ་ཡོད་དོ་ཞེས་༎ ཁ་ཅིག་ཟེར་ཏེ་གང་གི་ཕྱིར་༎
 adho 'pi madhyamastyeke dhyānāntaravipākataḥ |	བསམ་གཏན་ཁྱད་པར་རྣམ་སྨིན་ལས་༎
 apūrvācaramaḥ pākastrayāṇāṃ ceṣyate yataḥ || vakk_4|48 ||	སྔ་ཕྱི་མེད་གསུམ་སྨིན་འདོད་ཕྱིར་༎
 svabhāvasaṃprayogābhyāmālambanavipākataḥ |	ངོ་བོ་ཉིད་དང་མཚུངས་ལྡན་དང་༎ དམིགས་པ་དང་ནི་རྣམ་སྨིན་དང་༎ མངོན་སུམ་དུ་ནི་གྱུར་པ་ལས་༎
 saṃmukhībhāvataśceti pañcadhā vedanīyatā || vakk_4|49 ||	མྱོང་འགྱུར་རྣམ་པ་ལྔ་ཡིན་ནོ་༎
 niyatāniyataṃ tacca niyataṃ trividhaṃ punaḥ | dṛṣṭadharmādivedyatvāt pañcadhā karma kecana || vakk_4|50 ||	དེ་ཡང་ངེས་དང་མ་ངེས་དང་༎ མཐོང་བའི་ཆོས་ལ་སོགས་པ་ལ་༎ མྱོང་འགྱུར་ཕྱིར་ན་ངེས་རྣམ་གསུམ་༎ ཁ་ཅིག་ལས་རྣམ་ལྔ་ཞེས་ཟེར་༎
 catuṣkoṭikamityanye nikāyākṣepaṇaṃ tribhiḥ |	གཞན་དག་མུ་ནི་བཞི་ཞེས་ཟེར་༎ གསུམ་གྱིས་རིགས་ནི་འཕེན་པར་བྱེད་༎
 sarvatra caturākṣepaḥ śubhasya narake tridhā || vakk_4|51 ||	ཐམས་ཅད་ན་ནི་འཕེན་པ་བཞི་༎ དམྱལ་བ་ན་ནི་དགེ་བའི་གསུམ་༎
 yadviraktaḥ sthiro bālastatra notpadyavedyakṛt |	གང་ལས་འདོད་ཆགས་བྲལ་བརྟན་པའི་༎ བྱིས་པ་དེར་སྐྱེས་མྱོང་མི་བྱེད་༎
 nānyavedyakṛdapyāryaḥ kāme 'gre vāsthiro 'pi na || vakk_4|52 ||	འཕགས་པ་གཞན་དུའང་མྱོང་མི་བྱེད་༎ འདོད་རྩེའི་མི་བརྟན་པ་ཡང་མིན་༎
 dvāviṃśatividhaṃ kāmeṣvākṣipatyantarābhavaḥ |	སྲིད་པ་བར་མ་འདོད་ཁམས་སུ་༎ འཕེན་པ་རྣམ་པ་ཉི་ཤུ་གཉིས་༎
 dṛṣṭadharmaphalaṃ tacca nikāyo hyeka eva saḥ || vakk_4|53 ||	དེ་ནི་མཐོང་ཆོས་༄༡༣ཨ་༌་༎ འབྲས་བུ་ཡིན་༎ དེ་ནི་རིགས་གཅིག་ཁོ་ན་ཡིན་༎
 tīvrakleśaprasādena sātatyena ca yatkṛtam |	ཉོན་མོངས་རབ་དང་དྲག་པོ་དང་༎ ཡོན་ཏན་ཞིང་དང་རྒྱུན་ཆགས་སུ་༎
 guṇakṣetre ca niyataṃ tatpitrorghātakaṃ ca yat || vakk_4|54 ||	བྱས་པ་གང་ཞིག་ཡིན་པ་དང་༎ ཕ་མ་གསོད་གང་དེ་ངེས་སོ་༎
 dṛṣṭadharmaphalaṃ karma kṣetrāśayaviśeṣataḥ |	མཐོང་ཆོས་འབྲས་བུ་ཅན་གྱི་ལས་༎ ཞིང་དང་བསམ་པའི་ཁྱད་པར་ལས་༎
 tadbhūmyatyantavairāgyāt vipāke niyataṃ hi yat || vakk_4|55 ||	ས་དེའི་འདོད་ཆགས་གཏན་བྲལ་ཕྱིར་༎ རྣམ་སྨིན་ངེས་པ་གང་ཡིན་པའོ་༎
 ye nirodhāraṇāmaitrīdarśanārhatphalotthitāḥ |	གང་དག་འགོག་བྱམས་ཉོན་མོངས་མེད་༎ མཐོང་དང་དགྲ་བཅོམ་འབྲས་ལངས་པ་༎
 teṣu kārāpakārāsya phalaṃ sadyo 'nubhūyate || vakk_4|56 ||	དེ་ལ་ཕན་གནོད་བྱས་པ་ཡི་༎ འབྲས་བུ་འཕྲལ་དུ་མྱོང་བར་འགྱུར་༎ རྣམ་པར་རྟོག་པ་མེད་པ་ཡི་༎
 kuśalasyāvitarkasya karmaṇo vedanā matā |	དགེ་བའི་ལས་ཀྱི་རྣམ་སྨིན་ནི་༎
 vipākaścaitasikyeva kāyikyevāśubhasya tu || vakk_4|57 ||	སེམས་ཀྱི་ཚོར་བ་ཁོ་ནར་འདོད་༎ མི་དགེ་བའི་ནི་ལུས་ཀྱི་ཡིན་༎
 cittakṣepo manaścitte sa ca karmavipākajaḥ |	ག-ཡེངས་པའི་སེམས་ནི་ཡིད་སེམས་ལ་༎ དེ་ནི་ལས་ཀྱི་རྣམ་སྨིན་སྐྱེས་༎
 bhayopaghātavaiṣamyaśokaiśca akurukāminām || vakk_4|58 ||	སྐྲག་གནོད་མ་མཉམ་མྱ་ངན་གྱིས་༎ སྒྲ་མི་སྙན་མིན་འདོད་ལྡན་རྣམས་༎
 vaṅkadoṣakaṣāyoktiḥ śāṭhyadveṣajarāgaje |	ཡོན་སྐྱོན་སྙིགས་མར་གསུངས་པ་ནི་༎ ག-ཡོ་དང་ཞེ་སྡང་འདོད་ཆགས་སྐྱེས་༎
 kṛṣṇaśuklādibhedena punaḥ karma caturvidham || vakk_4|59 ||	དཀར་ནག་ལ་སོགས་བྱེ་བྲག་གིས་༎ ལས་ནི་རྣམ་པ་བཞི་ཡིན་ནོ་༎
 aśubhaṃ rūpakāmāptaṃ śubhaṃ caiva yathākramam |	མི་དགེ་གཟུགས་དང་འདོད་གཏོགས་པའི་༎ དགེ་བ་ཉིད་ནི་རིམ་བཞིན་དུ་༎
 kṛṣṇaśuklobhayaṃ karma tatkṣayāya nirāsravam || vakk_4|60 ||	གནག་དང་དཀར་དང་གཉིས་ཀའི་ལས་༎ དེ་ཟད་བྱེད་པ་ཟག་མེད་ཡིན་༎
 dharmakṣāntiṣu vairāgye cānantaryapathāṣṭake |	ཆོས་བཟོད་འདོད་ཆགས་བྲལ་བ་ཡི་༎ བར་ཆད་མེད་ལམ་བརྒྱད་ཀྱི་གང་༎
 yā cetanā dvādaśadhā karma kṛṣṇakṣayāya tat || vakk_4|61 ||	སེམས་པ་རྣམ་པ་བཅུ་གཉིས་དེ་༎ ནག་པོ་ཟད་པར་བྱེད་པའི་ལས་༎
 navame cetanā yā sā kṛṣṇaśuklakṣayāya ca |	དགུ་པའི་སེམས་པ་གང་ཡིན་པ་༎ དེ་ནི་དཀར་ནག་ཟད་བྱེད་ཡིན་༎
 śuklasya dhyānavairāgyeṣvantyānantaryamārgajā || vakk_4|62 ||	དཀར་པོ་བསམ་གཏན་ཆགས་བྲལ་བའི་༎ བར་ཆད་མེད་ལམ་སྐྱེས་ཐ་མས་༎
 anye narakavedyānyakāmavedyaṃ dvayaṃ viduḥ |	གཞན་ནི་དམྱལ་བ་མྱོང་འགྱུར་དང་༎ འདོད་གཞན་མྱོང་འགྱུར་གཉིས་སུ་རིག་། གཞན་ནི་མཐོང་བས་སྤང་བྱ་གནག་༎
 dṛgdheyaṃ kṛṣṇamanye anyatkṛṣṇaśuklaṃ tu kāmajam || vakk_4|63 ||	འདོད་པ་ལས་སྐྱེས་གཞན་དཀར་གནག་༎
 aśaikṣaṃ kāyavākkarma manaścaiva yathākramam |	མི་སློབ་ལུས་ངག་ལས་ཡིད་ཉིད་༎ ཐུབ་པའི་གསུམ་སྟེ་གོ་རིམས་བཞིན་༎
 maunatrayam tridhā śaucaṃ sarva sucaritatrayam || vakk_4|64 ||	ལེགས་སྤྱད་གསུམ་པོ་ཐམས་ཅད་ནི་༎ གཙང་བྱེད་རྣམ་པ་གསུམ་ཡིན་ནོ་༎
 aśubhaṃ kāyakarmādi mataṃ duścarita trayam |	ལུས་ཀྱི་ལ་སོགས་མི་དགེ་བ་༎
 akarmāpi tvabhidhyādimanoduścaritaṃ tridhā || vakk_4|65 ||	ཉེས་པར་སྤྱད་པ་གསུམ་དུ་འདོད་༎ བརྣབ་སེམས་ལ་སོགས་ལས་མིན་ཡང་༎ ཡིད་ཀྱི་ཉེས་སྤྱད་རྣམ་གསུམ་མོ་༎
 viparyayātsucaritam tadaudārikasaṃgrahāt |	བཟློག་པ་ལེགས་པར་སྤྱད་པ་ཡིན་༎ དེ་ལས་ཆེ་ལོང་༄༡༣བ་བསྡུས་ནས་ནི་༎
 daśa karmapathā uktā yathāyogaṃ śubhāśubhāḥ || vakk_4|66 ||	དགེ་དང་མི་དགེ་ཅི་རིགས་པར་༎ ལས་ཀྱི་ལམ་ནི་བཅུར་གསུངས་སོ་༎
 aśubhāḥ ṣaḍavijñaptiḥ dvidhaikaḥ te 'pi kurvataḥ |	མི་དགེ་དྲུག་ནི་རྣམ་རིག་མིན་༎ གཅིག་རྣམ་གཉིས་སོ་དེ་དག་ཀྱང་༎ བྱེད་ན་དགེ་བ་བདུན་རྣམ་གྱིས་༎
 dvividhāḥ sapta kuśalāḥ avijñaptiḥ samādhijāḥ || vakk_4|67 ||	ཏིང་འཛིན་ལས་སྐྱེས་རྣམ་རིག་མིན་༎
 sāmantakāstu vijñaptiḥ avijñaptirbhavenna vā |	ཉེར་བསྡོགས་རྣམས་ནི་རྣམ་རིག་བྱེད་༎ རྣམ་རིག་བྱེད་མིན་འགྱུར་བའམ་༎ མ་ཡིན་བཟློག་པ་མཇུག་ཡིན་ནོ་༎
 viparyayeṇa pṛṣṭhāni prayogastu trimūlajaḥ || vakk_4|68 ||	སྦྱོར་བ་རྩ་བ་གསུམ་ལས་སྐྱེས་༎
 tadanantarasaṃbhūterabhidhyādyāstrimūlajāḥ |	དེ་ཡི་མཇུག་ཐོགས་ལས་བྱུང་ཕྱིར་༎ བརྣབ་སེམས་སོགས་རྩ་གསུམ་ལས་སྐྱེས་༎
 kuśalāḥ saprayogāntā alobhadveṣamohajāḥ || vakk_4|69 ||	དགེ་བ་སྦྱོར་དང་མཇུག་བཅས་རྣམས་༎ ཆགས་སྡང་གཏི་མུག་མེད་ལས་སྐྱེས་༎
 vadhavyāpādapāruṣyaniṣṭhā dveṣeṇa lobhataḥ |	གསོད་དང་གནོད་སེམས་ཚིག་རྩུབ་པོ་༎ ཞེ་སྡང་གིས་ནི་མཐར་ཕྱིན་བྱེད་༎
 parastrīgamanābhidhyādattādānasamāpanam || vakk_4|70 ||	ལོག་ག-ཡེམ་བརྣབ་སེམས་མ་བྱིན་ལེན་༎ ཆགས་པ་ཡིས་ནི་རྫོགས་པར་བྱེད་༎
 mithyādṛṣṭestu mohena śeṣāṇāṃ tribhiriṣyate |	ལོག་པར་ལྟ་བ་གཏི་མུག་གིས་༎ ལྷག་མ་གསུམ་གྱིས་རྫོགས་པར་འདོད་༎
 sattvabhogāvadhiṣṭhānaṃ nāmarūpaṃ ca nāma ca || vakk_4|71 ||	གཞི་ནི་སེམས་ཅན་ལོངས་སྤྱོད་དང་༎ མིང་དང་གཟུགས་ནི་མིང་ཡིན་ནོ་༎ སྔ་དང་མཉམ་དུ་ཤི་བ་ལ་༎
 samaṃ prāk ca mṛtasyāsti na maulaḥ anyāśrayodayāt |	དངོས་མེད་ལུས་གཞན་སྐྱེས་ཕྱེར་རོ་༎
 senādiṣvekakāryatvāt sarve karttṛvadanvitāḥ || vakk_4|72 ||	དམག་ལ་སོགས་པར་དོན་གཅིག་ཕྱིར་༎ ཐམས་ཅད་བྱེད་པ་པོ་བཞིན་ལྡན་༎
 prāṇātipātaḥ saṃcintya parasyābhrāntimāraṇam |	སྲོག་གཅོད་པ་ནི་བསམས་བཞིན་དུ་༎ མ་ནོར་བར་ནི་གཞན་གསད་པའོ་༎
 adattādānamanyasvasvīkriyā balacauryataḥ || vakk_4|73 ||	མ་བྱིན་ལེན་པ་གཞན་གྱི་ནོར་༎ མཐུ་དང་འཇབ་བུས་བདག་གིར་བྱེད་༎
 agamyagamanaṃ kāmamithyācāraścaturvidhaḥ |	བགྲོད་མིན་འགྲོ་བ་འདོད་པ་ཡིས་༎ ལོག་པར་ག-ཡེམ་པ་རྣམ་པ་བཞི་༎
 anyathāsaṃjñino vākyamarthābhijñe mṛṣāvacaḥ || vakk_4|74 ||	རྫུན་ཚིག་འདུ་ཤེས་གཞན་སྒྱུར་བའི་༎ ཚིག་དོན་མངོན་པར་གོ་བའོ་༎
 cakṣuḥ śrotamanaścittairanubhūtaṃ tribhiśca yat |	མིག་རྣ་ཡིད་ཀྱི་རྣམ་ཤེས་དང་༎ གསུམ་གྱིས་ཉམས་སུ་མྱོང་གང་དེ་༎
 taddaṣṭaśrutavijñātaṃ mataṃ coktaṃ yathākramam || vakk_4|75 ||	མཐོང་ཐོས་རྣམ་པར་ཤེས་པ་དང་༎ རྟོགས་པ་ཡིན་ཏེ་རིམ་བཞིན་བཤད་༎
 paiśunyaṃ kliṣṭacittasya vacanaṃ parabhedane |	ཕྲ་མ་ཕ་རོལ་དབྱེ་བའི་ཕྱིར་༎ ཉོན་མོངས་ཅན་གྱི་སེམས་ཀྱི་ཚིག་༎ ཚིག་རྩུབ་པོ་ནི་མི་སྙན་པ་༎
 pārūṣyamapriyaṃ sarva kliṣṭaṃ bhinna pralāpitā || vakk_4|76 ||	ཉོན་མོངས་ཅན་ཀུན་ཀྱལ་པ་ཉིད་༎
 ato 'nyat kliṣṭamityanye lapanāgītanāṭyavat |	གཞན་ནི་དེ་ལས་གཞན་ཉོན་མོངས་༎ ཁ་གསག་གླུ་དང་ཟློས་གར་བཞིན་༎ བསྟན་བཅོས་ངན་བཞིན་བརྣབ་སེམས་ནི་༎
 kuśāstavacca abhidhyā tu parasvaviṣamaspṛhā || vakk_4|77 ||	ལོག་པས་གཞན་གྱི་ནོར་ལ་ཆགས་༎
 vyāpādaḥ sattvavidveṣaḥ nāstidṛṣṭiḥ śubhāśubhe |	གནོད་སེམས་སེམས་ཅན་ལ་སྡང་བ་༎ དགེ་དང་མི་དགེ་མེད་ལྟ་བ་༎
 mithyādṛṣṭiḥ trayo hyatra panthānaḥ sapta karma ca || vakk_4|78 ||	ལོག་པར་ལྟ་བ་ཡིན་འདི་ལ་༎ གསུམ་ལམ་བདུན་ནི་ལས་ཀྱང་ཡིན་༎
 mūlacchedastvasaddṛṣṭayā kāmāptotpattilābhinām |	༄༡༤ཨ་༌་༎ མེད་པར་ལྟ་བས་རྩ་བ་གཅོད་༎ འདོད་གཏོགས་སྐྱེས་ནས་ཐོབ་པ་རྣམས་༎
 phalahetvapavādinyā sarvathā kramaśaḥ nṛṣu || vakk_4|79 ||	རྒྱུ་དང་འབྲས་ལ་སྐུར་འདེབས་པས་༎ ཀུན་གྱིས་རིམ་གྱིས་མིའི་ནང་དུ་༎ སྐྱེས་པ་བུད་མེད་ཀྱིས་གཅོད་དོ་༎
 chinatti strī pumān dṛṣṭicaritaḥ so 'samanvayaḥ |	ལྟ་སྤྱད་དེ་ནི་མི་ལྡན་པའོ་༎
 saṃdhiḥ kāṅkṣāstidṛṣṭibhyāṃ nehānantaryakāriṇaḥ || vakk_4|80 ||	མཚམས་ནི་ཐེ་ཚོམ་ཡོད་ལྟ་བས་། མཚམས་མེད་བྱེད་པའི་འདི་ལ་མིན་༎
 yugapadyāvadaṣṭābhiraśubhaiḥ saha vartate |	མི་དགེ་བརྒྱད་ཀྱི་བར་དག་དང་༎ སེམས་པ་ཅིག་ཅར་ལྷན་ཅིག་འབྱུང་༎
 cetanā daśabhiryāvacchubhaiḥ naikāṣṭapañcabhiḥ || vakk_4|81 ||	དགེ་བ་བཅུ་ཡི་བར་དག་དང་༎ གཅིག་དང་བརྒྱད་དང་ལྔ་དང་མིན་༎
 bhinnapralāpapārūṣyavyāpādā narake dvidhā |	དམྱལ་བ་ན་ནི་ཀྱལ་པ་དང་༎ ཚིག་རྩུབ་གནོད་སེམས་རྣམ་གཉིས་སོ་༎
 samanvāgamato 'bhidhyāmithyādṛṣṭī kurau trayaḥ || vakk_4|82 ||	བརྣབ་སེམས་ལོག་ལྟ་ལྡན་པས་སོ་༎ སྒྲ་མི་སྙན་ན་གསུམ་ཡོད་དེ་༎
 saptamaḥ svayamapyatra kāme 'nyatra daśāśubhāḥ |	དེ་ན་བདུན་པ་དངོས་སུ་ཡང་༎ འདོད་པ་གཞན་ན་མི་དགེ་བཅུ་༎
 śubhāstrayastu sarvatra saṃmukhībhāvalābhataḥ || vakk_4|83 ||	དགེ་བ་གསུམ་ནི་ཐམས་ཅད་ན་༎ རྙེད་དང་མངོན་དུ་གྱུར་སྒོ་ནས་༎
 ārūpyāsaṃjñisattveṣu lābhataḥ sapta śeṣite |	གཟུགས་མེད་འདུ་ཤེས་མེད་སེམས་ཅན་༎ རྙེད་པས་བདུན་ཡོད་ལྷག་བྱས་ན་༎ མངོན་དུ་གྱུར་པའི་སྒོ་ནས་ཀྱང་༎
 saṃmukhībhāvataścāpi hitvā sanarakān kurūn || vakk_4|84 ||	དམྱལ་བཅས་སྒྲ་མི་སྙན་མ་གཏོགས་༎
 sarve 'dhipatiniṣyandavipākaphaladā matāḥ |	ཐམས་ཅད་བདག་པོ་རྒྱུ་མཐུན་དང་༎ རྣམ་སྨིན་འབྲས་བུ་འབྱིན་པར་འདོད་༎
 duḥkhanānmāraṇādojonāśanāttrividhaṃ phalam || vakk_4|85 ||	སྡུག་བསྔལ་ཕྱིར་དང་བསད་ཕྱིར་དང་༎ གཟི་བྱིན་མེད་ཕྱིར་འབྲས་རྣམ་གསུམ་༎
 lobhajaṃ kāyavākkarma mithyājīvaḥ pṛthak kṛtaḥ |	ལུས་དང་ངག་ལས་ཆགས་ལས་སྐྱེས་༎ ལོག་འཚོ་སྦྱང་དཀའི་ཕྱིར་ལོགས་ཤིག་༎
 duḥśodhatvāt pariṣkāralobhotthaṃ cet na sūtrataḥ || vakk_4|86 ||	བསྟན་ཏོ་གལ་ཏེ་ཡོ་བྱད་ལ་༎ ཆགས་བསླང་མདོ་དང་འགལ་ཕྱིར་མིན་༎ དྲིར་བཅས་སྤོང་བའི་ལམ་དག་གི་༎
 prahāṇamārge samale saphalaṃ karma pañcabhiḥ |	ལས་ནི་ལྔ་ཡི་འབྲས་བུར་བཅས་༎
 caturbhiramale anyacca sāsravaṃ yacchubhāśubham || vakk_4|87 ||	དྲི་མེད་བཞི་ཡི་ཟག་བཅས་གཞན་༎ དགེ་དང་མི་དགེ་གང་ཡིན་པའང་༎
 anāsravaṃ punaḥ śeṣaṃ tribhiravyākṛtaṃ ca yat |	ཟག་པ་མེད་པ་ལྷག་མ་དང་༎ ལུང་བསྟན་མིན་གང་གསུམ་གྱིས་སོ་༎
 catvāri dve tathā trīṇi kuśalasya śubhādayaḥ || vakk_4|88 ||	དགེ་བའི་དགེ་ལ་སོགས་པ་ནི་༎ བཞི་དང་གཉིས་དང་དེ་བཞིན་གསུམ་༎
 aśubhasya śubhādyā dve trīṇi catvāryanukramam |	མི་དགེའི་དགེ་སོགས་གཉིས་དང་ནི་༎ གསུམ་དང་བཞི་སྟེ་རིམ་པ་བཞིན་༎
 avyākṛtasya dve trīṇi trīṇī caite śubhādayaḥ || vakk_4|89 ||	ལུང་བསྟན་མིན་གྱི་དགེ་ལ་སོགས་༎ དེ་དག་གཉིས་དང་གསུམ་དང་གསུམ་༎
 sarve 'tītasya catvāri madhyamasyāpyanāgatāḥ |	འདས་པའི་ཐམས་ཅད་བཞི་ཡིན་ནོ་༎ བར་མ་ཡི་ནི་མ་འོངས་པའང་༎
 madhyamā dve ajātasya phalāni trīṇyanāgatāḥ || vakk_4|90 ||	བར་མ་གཉིས་སོ་མ་སྐྱེས་པའི་༎ འབྲས་བུ་མ་འོངས་གསུམ་ཡིན་ནོ་༎
 svabhūmidharmāścatvāri trīṇi dve vānyabhūmikāḥ |	རང་གི་ས་པ་བཞི་ཡིན་ནོ་༎ གཞན་གྱི་ས་པ་གསུམ་དང་གཉིས་༎
 śaikṣasya trīṇi śaikṣādyāḥ aśaikṣasya tu karmaṇaḥ || vakk_4|91 ||	༄༡༤བ་སློབ་པའི་སློབ་ལ་སོགས་པ་གསུམ་༎ མི་སློབ་ལས་ཀྱི་འབྲས་བུ་ནི་༎ སློབ་པ་ཡི་ནི་ཆོས་ལ་སོགས་༎
 dharmāḥ śaikṣādikā ekaṃ phalaṃ trīṇyapi ca dvayam |	གཅིག་དང་གསུམ་དང་གཉིས་ཡིན་ནོ་༎
 tābhyāmanyasya śaikṣādyā dve dve pañca phalāni ca || vakk_4|92 ||	དེ་ལས་གཞན་པའི་འབྲས་བུ་ནི་༎ སློབ་སོགས་གཉིས་དང་གཉིས་དང་ལྔ་༎
 trīṇi catvāri caikaṃ ca dṛggheyasya tadādayaḥ |	མཐོང་བས་སྤང་བྱའི་དེ་ལ་སོགས་༎ གསུམ་དང་བཞི་དང་གཅིག་ཡིན་ནོ་༎
 te dve catvāryatha trīṇi bhāvanāheyakarmaṇaḥ || vakk_4|93 ||	བསྒོམ་པས་སྤང་བར་བྱ་ལས་ཀྱི་༎ དེ་དག་གཉིས་དང་བཞི་དང་གསུམ་༎
 apraheyasya te tvekaṃ dve catvāri yathākramam |	སྤང་བྱ་མིན་པའི་དེ་དག་གཅིག་༎ གཉིས་དང་བཞི་སྟེ་གོ་རིམས་བཞེན་༎
 ayogavihitaṃ kliṣṭaṃ vidhibhraṣṭaṃ ca kecana || vakk_4|94 ||	རིགས་མིན་བསྐྱེད་པ་ཉོན་མོངས་ཅན་༎ ཁ་ཅིག་ཆོ་ག་ཉམས་པའང་ཞེའོ་༎
 ekaṃ janmākṣipatyekam anekaṃ paripūrakam |	གཅིག་གིས་སྐྱེ་བ་གཅིག་འཕེན་ཏོ་༎ ཡོངས་རྫོགས་བྱེད་པ་དུ་མ་ཡིན་།
 nākṣepike samāpattī acitte prāptayo na ca || vakk_4|95 ||	སེམས་མེད་སྙོམས་པར་འཇུག་པ་དག་༎ འཕེན་བྱེད་མ་ཡིན་ཐོབ་པའང་མིན་༎
 ānantaryāṇi karmāṇi tīvrakleśo 'tha durgatiḥ | kauravāsaṃjñittvāśca matamāvaraṇatrayam || vakk_4|96 ||	མཚམས་མེད་པ་ཡི་ལས་རྣམས་དང་༎ ཉོན་མོངས་ཤས་ཆེན་ངན་འགྲོ་དང་༎ འདུ་ཤེས་མེད་པའི་སེམས་ཅན་དང་༎ སྒྲ་མི་སྙན་སྒྲིབ་གསུམ་དུ་འདོད་༎
 triṣu dvipeṣvānantarya śaṇḍhā dīnāṃ tu neṣyate |	མཚམས་མེད་གླིང་གསུམ་དག་ན་ཡོད་༎ ཟ་མ་སོགས་ལ་མི་འདོད་དོ་༎ ཕན་དང་ངོ་ཚ་ཆུང་བའི་ཕྱིར་༎
 alpopakārālajjitvāt śeṣe gatiṣu pañcasu || vakk_4|97 ||	ལྷག་མ་འགྲོ་བ་ལྔ་དག་ན་༎
 saṃghabhedastvasāmagrīsvabhāvo viprayuktakaḥ |	དགེ་འདུན་དབྱེན་ནི་མི་འཕྲོད་པའི་༎
 akliṣṭāvyākṛto dharmaḥ saṃghastena samanvitaḥ || vakk_4|98 ||	རང་བཞིན་ལྡན་པ་མ་ཡིན་ཆོས་༎ ཉོན་མོངས་ཅན་མིན་ལུང་བསྟན་མིན་༎ དེ་དག་དགེ་འདུན་ཡང་དག་ལྡན་༎
 tadavadya mṛṣāvādastena bhettā samanvitaḥ |	དེ་ཡི་ཁ་ན་མ་ཐོ་རྫུན་༎ དེ་དང་འབྱེད་པོ་ཡང་དག་ལྡན་༎
 avīcau pacyate kalpam adhikairadhikā rujaḥ || vakk_4|99 ||	བསྐལ་པར་མནར་མེད་པར་སྨིན་འགྱུར་༎ ལྷག་པས་གནོད་པ་ལྷག་པར་འགྱུར་༎ དགེ་སློང་ལྟ་སྤྱད་ཚུལ་ལྡན་པས་༎
 bhikṣurdṛk carito vṛttī bhinatti anyatra bāliśān |	འབྱེད་དོ་གཞན་དུའོ་བྱིས་པ་རྣམས་། སྟོན་དང་ལམ་གཞན་ལ་བཟོད་པ་༎
 śāstṛmārgāntarakṣāntau bhinnaḥ na vivasatyasau || vakk_4|100 ||	བྱེ་བའོ་དེ་ནི་མི་གནས་སོ་༎
 cakrabhedaḥ sa ca mataḥ jambūdvīpe navādibhiḥ |	དེ་ནི་འཁོར་ལོའི་དབྱེན་དུ་འདོད་༎ འཛམ་བུའི་གླིང་ནའོ་དགུ་སོགས་ཀྱི་༎
 karmabhedastriṣu dvipeṣu aṣṭabhiradhikaiśca saḥ || vakk_4|101 ||	ལས་ཀྱི་དབྱེན་ནི་གླིང་གསུམ་ན་༎ དེ་ནི་བརྒྱད་དག་ཡན་ཆད་ཀྱིས་༎ དང་པོ་མཐའ་སྐྱོན་ཟུང་གཅིག་གི་༎
 ādāvante 'rbudāt pūrvaṃ yugāccoparate munau |	སྔ་རོལ་ཐུབ་པ་ནོངས་པ་དང་༎ མཚམས་མ་བཅད་པ་དག་ཏུ་ཡང་༎
 sīmāyāṃ cāpyabaddhāyāṃ cakrabhedo na jāyate || vakk_4|102 ||	འཁོར་ལོའོ་དབྱེན་ནི་མི་འབྱུང་ངོ་༎
 upakāriguṇakṣetranirākṛtivipādanāt |	ཕན་འདོགས་པ་དང་ཡོན་ཏན་ཞིང་༎ སྤངས་དང་མེད་པར་བྱས་ཕྱིར་རོ་༎
 vyañjanāntarito 'pi syāt mātā yacchoṇitodbhavaḥ || vakk_4|103 ||	མཚན་ནི་གཞན་དུ་གྱུར་ཀྱང་འགྱུར་༎ གང་གི་ཟླ་མཚན་ལས་བྱུང་མ་༎
 buddhe na tāḍanecchasya prahārānnordhvamarhati |	སངས་རྒྱས་བརྡེག་པར་སེམས་ལ་༄༡༥ཨ་༌་༎ མིན་༎ བསྣུན་འོག་སྒྲ་བཅོམ་པ་ལ་མིན་༎
 nānantaryaprayuktasya vairāgyaphalasaṃbhavaḥ || vakk_4|104 ||	མཚམས་མེད་སྦྱོར་བ་བྱས་པ་ལ་༎ འདོད་ཆགས་བྲལ་འབྲས་མི་སྲིད་དོ་༎
 saṃghabhede mṛṣāvādo mahāvadyatamo mataḥ |	དགེ་འདུན་དབྱེ་ཕྱིར་རྫུན་སྨྲ་བ་༎ ཁ་ན་མ་ཐོ་རབ་ཆེར་འདོད་༎
 bhavāgracetanā loke mahāphalatamā śubhe || vakk_4|105 ||	འཇིག་རྟེན་པ་ཡི་དགེ་བ་ལ་༎ སྲིད་རྩེའི་སེམས་པ་འབྲས་རབ་ཆེ༎
 dūṣaṇaṃ māturarhantyā niyatisthasya māraṇam |	མ་དགྲ་བཅོམ་མ་སུན་བྱས་དང་༎ བྱང་ཆུབ་སེམས་དཔའ་ངེས་གནས་དང་༎ སློབ་པ་གསོད་དང་དགེ་འདུན་གྱི་༎
 bodhisattvasya śaikṣasya saṃghāyadvārahārikā || vakk_4|106 ||	འདུ་བའི་སྒོ་ནི་འཕྲོག་པ་དག་༎
 ānantaryasabhāgāni pañcamaṃ stūpabhedanam |	མཚམས་མེད་པ་དང་ཆ་འདྲ་སྟེ་༎ ལྔ་པ་མཆོད་རྟེན་འཇིག་པ་ཡིན་༎
 kṣāntyanāgāmitārhattvaprāptau karmātivighnakṛt || vakk_4|107 ||	བཟོད་དང་ཕྱིར་མི་འོང་དགྲ་བཅོམ་༎ འཐོབ་ལ་ལས་གེགས་ཤིན་ཏུ་བྱེད་༎
 bodhisattvaḥ kuto yāvat yato lakṣaṇa karmakṛt |	གང་ནས་བྱང་ཆུབ་སེམས་དཔའ་ཡིན་༎ གང་ནས་མཚན་གྱི་ལས་བྱེད་པ་༎
 sugatiḥ kulajo 'vyakṣaḥ pumān jātismaro 'nivṛt || vakk_4|108 ||	བདེ་འགྲོ་རིགས་མཐོར་སྐྱེ་དབང་ཚང་༎ ཕོར་འགྱུར་ཚེ་རབས་དྲན་མི་ལྡོག་༎
 jambūdvīpe pumāneva saṃmukhaṃ buddhacetanaḥ |	དེ་ནི་འཛམ་གླིང་ཕོ་གྱུར་ཉིད་༎ མངོན་སུམ་སངས་རྒྱས་ལ་སེམས་པ་༎
 cintāmayaṃ kalpaśate śeṣa ākṣipate hi tat || vakk_4|109 ||	བསམས་པ་ལས་བྱུང་བསྐལ་པ་བརྒྱ་༎ ལུས་པ་དག་ཏུ་འཕེན་པར་བྱེད་༎
 ekaikaṃ puṇyaśatajam asaṃkhyeyatrayāntyajāḥ |	རེ་རེའང་བསོད་ནམས་བརྒྱ་ལས་སྐྱེ་༎ རྣམ་གཟིགས་མར་མེ་རིན་ཆེན་གཙུག་༎ གྲངས་མེད་གསུམ་གྱི་ཐ་མར་བྱུང་༎
 vipaśyī dīpakṛdatnaśikhī śākyamuniḥ purā || vakk_4|110 ||	དང་པོ་ཤའཀྱ་ཐུབ་པ་ཡིན་༎
 sarvatra sarva dadataḥ kārūṇyāddānapūraṇam |	ཀུན་ལ་ཐམས་ཅད་སྙིང་རྗེ་ཡིས་༎ སྦྱིན་པར་བྱེད་པས་སྦྱིན་པ་རྫོགས་༎ ཆགས་བཅས་ཡན་ལག་བཅད་ཀྱང་ནི་༎
 aṅgacchede 'pyakopāttu rāgiṇaḥ kṣāntiśīlayoḥ || vakk_4|111 ||	མི་འཁྲུགས་བཟོད་དང་ཚུལ་ཁྲིམས་ཀྱི་༎
 tiṣyastotreṇa vīryasya dhīsamādhyoranantaram |	སྐར་རྒྱལ་བསྟོད་པས་བརྩོན་འགྲུས་ཀྱི་༎ དེ་མ་ཐག་ལ་ཏིང་འཛིན་བློའི་༎
 puṇyaṃ kriyātha tadvastu trayaṃ karmapathā yathā || vakk_4|112 ||	གསུམ་པོ་བསོད་ནམས་བྱ་བ་དང་༎ དེའི་གཞི་དཔེར་ན་ལས་ལམ་བཞིན་༎
 dīyate yena taddānaṃ pūjānugrahakāmyayā |	གང་གིས་སྦྱིན་བྱེད་དེ་སྦྱིན་པ་༎ མཆོད་དང་ཕན་གདགས་འདོད་པ་ཡིས་༎
 kāyavākkarma sotthānaṃ mahābhogyaphalaṃ ca tat || vakk_4|113 ||	ལུས་དང་ངག་ལས་སློང་དང་བཅས་༎ དེ་འབྲས་ལོངས་སྤྱོད་ཆེན་པོ་ཅན་༎
 svaparārthobhayārthāya nobhayārthāya dīyate |	བདག་གཞན་དོན་ཕྱིར་གཉིས་དོན་ཕྱིར་༎ གཉིས་ཀའི་དོན་དུ་མིན་ཕྱིར་སྦྱིན་༎
 tadviśeṣaḥ punardātṛvastukṣetraviśeṣataḥ || vakk_4|114 ||	དེ་ཡི་ཁྱད་པར་སྦྱིན་བདག་དང་༎ དངོས་དང་ཞིང་གི་ཁྱད་པ་ལས་༎
 dātā viśiṣṭaḥ śraddhādyaiḥ satkṛtyādi dadāti ataḥ |	སྦྱིན་བདག་ཁྱད་འཕགས་དད་སོགས་ཀྱིས་༎ གུས་ལ་སོགས་པས་སྦྱིན་པར་བྱེད་༎
 satkārodārarucitā kālānācchedyalābhitā || vakk_4|115 ||	དེ་ཕྱིར་བཀུར་སྟི་རྒྱ་ཆེན་དང་༎ དུས་དང་བར་ཆད་མེད་པར་རྙེད་༎
 varṇādisampadā vastu surūpatvaṃ yaśasvi vā |	ཁ་དོག་ལ་སོགས་ཕུན་སུམ་དངོས་༎
 priyatā sukumārartusukhasparśāṅgatā tataḥ || vakk_4|116 ||	དེ་ལས་གཟུགས་བཟང་གྲགས་ལྡན་དང་༎ དགའ་༄༡༥བ་དང་ཤིན་ཏུ་གཞོན་ཤ་དང་༎ དུས་སུ་རེག་ན་བདེ་ལུས་འགྱུར་༎
 gatiduḥkhopakāritvaguṇaiḥ kṣetraṃ viśiṣyate |	འགྲོ་དང་སྡུག་བསྔལ་ཕན་འདོགས་དང་༎ ཡོན་ཏན་རྣམས་ཀྱིས་ཞིང་ཁྱད་འཕགས་༎
 agraṃ muktasya muktāya bodhisattvasya ca aṣṭamam || vakk_4|117 ||	མཆོག་ནི་གྲོལ་བས་གྲོལ་བའམ་༎ བྱང་ཆུབ་སེམས་དཔའ་ཡིས་བརྒྱད་པ་༎
 mātṛpitṛglānadhārmakathikebhyo 'ntyajanmane |	འཕགས་པ་མིན་ཡང་ཕ་མ་དང་༎ ནད་པ་དང་ནི་ཆོས་སྨྲ་དང་༎ སྐྱེ་མཐའི་བྱང་ཆུབ་སེམས་དཔའ་ལ་༎
 bodhisattvāya cāmeyā anāryebhyo 'pi dakṣiṇā || vakk_4|118 ||	ཡོན་ནི་གཞལ་དུ་མེད་པ་ཡིན་༎
 pṛṣṭhaṃ kṣetramadhiṣṭhānaṃ prayogaścetanāśayaḥ |	མཇུག་དང་ཞིང་དང་གཞི་དང་ནི་༎ སྦྱོར་དང་སེམས་པ་བསམ་པ་སྟེ་༎
 eṣāṃ mṛdvadhimātratvāt karmamṛdvadhimātratā || vakk_4|119 ||	དེ་དག་ཆུང་དང་ཆེ་བ་ལས་༎ ལས་ཀྱང་ཆུང་དང་ཆེ་བ་ཉིད་༎
 saṃcetanasamāptibhyāṃ niṣkraukṛtya vipakṣataḥ |	བསམས་བཞིན་པ་དང་རྫོགས་པ་དང་༎ མི་འགྱོད་གཉེན་པོ་མེད་པ་དང་༎ འཁོར་དང་རྣམ་པར་སྨིན་པ་ལས་༎
 parivārādvipākācca karmopacittamucyate || vakk_4|120 ||	བསགས་པའི་ལས་ཤེས་བྱ་བ་ཡིན་༎
 caitye tyāgānvayaṃ puṇyaṃ maitryādivadagṛṇhati |	མཆོད་རྟེན་ལ་བཏང་རྒྱུས་བྱུང་བའི་༎ བསོད་ནམས་ལེན་མེད་བྱམས་སོགས་བཞིན་༎
 kukṣetre 'pīṣṭaphalatā phalabījāviparyayāt || vakk_4|121 ||	རྒྱུ་ལས་འབྲས་བུ་མི་འཁྲུལ་ཕྱིར་༎ ངན་པའི་ཞིང་ལའང་འབྲས་ཡིད་འོང་༎
 dauḥśīlyamaśubhaṃ rūpaṃ śīlaṃ tadviratiḥ dvidhā |	འཆལ་པའི་ཚུལ་ཁྲིམས་མི་དགེའི་གཟུགས་༎ དེ་སྤོང་ཚུལ་ཁྲིམས་རྣམ་གཉིས་སོ་༎ སངས་རྒྱས་ཀྱིས་ནི་བཅད་པ་ཡང་༎
 pratikṣiptācca buddhena viśuddhaṃ tu caturguṇam || vakk_4|122 ||	རྣམ་དག་ཡོན་ཏན་བཞི་ལྡན་ནོ་༎
 dauḥśīlyataddhetvahataṃ tadvipakṣaśamāśritam |	འཆལ་ཁྲིམས་དེའི་རྒྱུས་འཕེན་མ་བྱུང་༎ དེ་གཉེན་པོ་དང་ཞི་ལ་རྟེན་༎
 samāhitaṃ tu kuśalaṃ bhāvanā cittavāsanāt || vakk_4|123 ||	མཉམ་པར་བཞག་པའི་དགེ་བ་ནི་༎ བསྒོམ་པའོ་སེམས་ལ་སྒོ་ཕྱིར་རོ་༎
 svargāya śīlaṃ prādhānyāt visaṃyogāya bhāvanā |	མཐོ་རིས་དོན་དུ་ཚུལ་ཁྲིམས་དང་༎ འབྲལ་བའི་དོན་དུ་བསྒོམ་གཙོའི་ཕྱིར་༎
 caturṇāṃ brāhmapuṇyatvaṃ kalpaṃ svargeṣu modanāt || vakk_4|124 ||	བསྐལ་པར་མཐོ་རིས་དགའ་གནས་ཕྱིར་༎ བཞི་ཡི་ཚངས་པའི་བསོད་ནམས་ཡིན་༎
 dharmadānaṃ yathābhūta sūtrādyakliṣṭadeśanā |	ཆོས་སྦྱིན་ཉོན་མོངས་ཅན་མིན་པས་༎ མདོ་སོགས་ཡང་དག་ཇི་བཞིན་སྟོན་༎
 puṇyanirvāṇanirvedhabhāgīyaṃ kuśalaṃ tridhā || vakk_4|125 ||	བསོད་ནམས་མྱ་ངན་འདས་པ་དང་༎ ངེས་འབྱེད་ཆ་མཐུན་དགེ་རྣམ་གསུམ་༎
 yogapravartitaṃ karma sasamutthāpakaṃ tridhā |	རིགས་པས་རབ་ཏུ་བཅུག་པའི་ལས་༎ རྣམ་གསུམ་ཀུན་སློང་བཅས་པ་ནི་༎
 lipimudre sagaṇanaṃ kāvyaṃ saṃkhyā yathākramam || vakk_4|126 ||	ཡིག་འབྲུ་བརྒྱ་དང་བགྲང་བཅས་པའི་༎ སྙན་ངག་གྲངས་ཏི་གོ་རིམས་བཞིན་༎
 sāvadyā nivṛtā hīnāḥ kliṣṭāḥ dharmāḥ śubhāmalāḥ |	བསྒྲིབས་ངན་ཁ་ན་མ་ཐོ་བཅས་༎ ཉན་མོངས་ཅན་ཆོས་དྲི་མེད་དགེ་༎
 praṇītāḥ saṃskṛtaśubhā sevyāḥ mokṣastvanuttaraḥ || vakk_4|127 ||	གྱ་ནོམ་འདུས་བྱས་དགེ་བསྟེན་བྱ་༎
 abhidharmakośe karmanirddeśo nāma caturtha kośasthānamiti ||	ཐར་པ་བླ་ན་མེད་པ་ཡིན་༎ ཆོས་མངོན་པའི་མཛོད་ཀྱི་ཚིག་ལེའུར་བྱས་པ་ལས་༎
 pañcamaṃ kośasthānam oṃ namo buddhāya	ལས་བསྟན་པ་ཞེས་བྱ་བ་སྟེ་གནས་བཞི་པའོ་། ༎ ། སྲིད་པའི་རྩ་བ་ཕྲ་རྒྱས་༄༡༦ཨ་༌་༎
 mūlaṃ bhavasyānuśayāḥ ṣaḍrāgaḥ pratighastathā | māno 'vidyā ca dṛṣṭiśca vicikitsā ca te punaḥ || vakk_5|1 ||	དྲུག་།འདོད་ཆགས་དེ་བཞིན་ཁོང་ཁྲོ་དང་། ང་རྒྱལ་མ་རིག་ལྟ་བ་དང་༎ ཐེ་ཚོམ་ཡིན་ཏེ་དེ་དྲུག་ཀྱང་༎
 ṣaḍrāgabhedātsaptoktāḥ bhavarāgo dvidhātujaḥ |	འདོད་ཆགས་དབྱེ་བས་བདུན་དུ་བཤད་༎ ཁམས་གཉིས་ལས་སྐྱེས་སྲིད་འདོད་ཆགས་༎
 antarmukhatvāttanmokṣasaṃjñāvyāvṛttaye kṛtaḥ || vakk_5|2 ||	ཁ་ནི་ནང་དུ་བལྟས་ཕྱིར་དེར་༎ ཐར་པའི་འདུ་ཤེས་བཟློག་ཕྱིར་བཤད་༎
 dṛṣṭayaḥ pañca satkāyamithyāntagrahadṛṣṭayaḥ | dṛṣṭiśīlavrataparāmarśāviti punardaśaḥ || vakk_5|3 ||	ལྟ་བ་ལྔ་སྟེ་འཇིག་ཚོགས་དང་༎ ལོག་དང་མཐར་འཛིན་ལྟ་བ་དང་༎ ལྟ་བ་དང་ནི་ཚུལ་ཁྲིམས་དང་༎ བརྟུལ་ཞུགས་མཆོག་ཏུ་འཛིན་དང་བཅུ་༎
 daśaite saptāsaptāṣṭau tridvidṛṣṭivivarjitāḥ |	དེ་དག་བཅུ་དང་བདུན་བདུན་བརྒྱད་༎ ལྟ་བ་གསུམ་གཉིས་མ་གཏོགས་པ་༎
 yathākramaṃ prahīyante kāme duḥkhādidarśanaiḥ || vakk_5|4 ||	འདོད་ན་སྡུག་བསྔལ་ལ་སོགས་པ་༏་། མཐོང་བས་རིམ་བཞིན་སྤོང་བར་བྱེད་༎
 catvāro bhāvanāheyāḥ ta evāpratighāḥ punaḥ |	བཞི་ནི་བསྒོམ་པས་སྤང་བྱ་ཡིན་༎ ཁོང་ཁྲོ་མ་གཏོགས་དེ་དག་ཉིད་༎
 rūpadhātau tathārūpye ityaṣṭānavatirmatāḥ || vakk_5|5 ||	གཟུགས་ཁམས་གཟུགས་མེད་དེ་དང་འདྲ་༎ དེ་ལྟར་དགུ་བཅུ་བརྒྱད་དུ་འདོད་༎
 bhavāgrajāḥ kṣāntivadhya dṛggheyā eva śeṣajāḥ |	སྲིད་རྩེ་ལས་སྐྱེས་བཟོད་པ་ཡིས་༎ གཞོམ་བྱ་མཐོང་བས་སྤང་བྱ་ཉིད༎ ལྷག་སྐྱེས་མཐོང་དང་བསྒོམ་གཉིས་ཀྱིས་༎
 dṛgbhāvanābhyām akṣāntivadhyā bhāvanayaiva tu || vakk_5|6 ||	བཟོད་པས་གཞོམ་མིན་བསྒོམ་ཁོ་ནས་༎
 ātmātmīyadhruvocchedanāstihīnā gradṝṣṭayaḥ |	བདག་དང་བདག་གི་རྟག་ཆད་དང་༎ མེད་དང་དམན་ལ་མཆོག་ལྟ་དང་༎ རྒྱུ་མིན་ལམ་མིན་དེར་ལྟ་བ་༎
 ahetvamārge taddṛṣṭiretāstāḥ pañca dṛṣṭayaḥ || vakk_5|7 ||	དེ་དག་ལྟ་བ་ལྔ་ཡིན་ནོ་༎
 īśvarādiṣu nityātmaviparyāsāt pravartate |	དབང་ཕྱུག་སོགས་རྒྱུར་མངོན་ཞེན་པ་༎ རྟག་བདག་ཕྱིན་ཅི་ལོག་པ་ཡིས་༎ རབ་ཏུ་འཇུག་པས་དེ་ཕྱིར་དེ་༎
 kāraṇābhiniveśo 'to dūḥkhadṛggheya eva saḥ || vakk_5|8 ||	སྡུག་བསྔལ་མཐོང་བས་སྤང་བྱ་ཉིད་༎
 dṛṣṭitrayādviparyāsacatuṣkaṃ viparītataḥ |	ལྟ་བ་གསུམ་ལས་ཕྱིན་ཅི་ལོག་། བཞི་ཚན་ཕྱིན་ཅི་ལོག་ཕྱིར་དང་༎ ངེས་རྟོག་ཕྱིར་དང་སྒྲོ་འདོགས་ཕྱིར་༎
 nitīraṇāt samāropāt saṃjñācitte tu tadvaśāt || vakk_5|9 ||	སེམས་དང་འདུ་ཤེས་དེའི་དབང་གིས་༎
 sapta mānāḥ navavidhāstribhyaḥ dṛgbhāvanākṣayāḥ |	ང་རྒྱལ་བདུན་རྣམ་དགུ་གསུམ་པོ་༏་། མཐོང་དང་བསྒོམ་པས་ཟད་བྱ་བ་༎
 vadhādiparyavasthānaṃ heyaṃ bhāvanayā tathā || vakk_5|10 ||	བསྒོམ་པས་སྤང་བར་བྱ་བ་ནི་༎ གསོད་སྩོགས་ཀུན་ནས་དཀྲིས་པའོ་༎
 vibhavecchā na cāryasya saṃbhavanti vidhādayaḥ |	དེ་བཞིན་འཇིག་སྲེད་འཕགས་པ་ལ་༎ རྣམ་སོགས་ངའོ་སྙམ་མི་འབྱུང་༎
 nāsmitā dṛṣṭipuṣṭatvāt kaukṛtyaṃ nāpi cāśubham || vakk_5|11 ||	ལྟ་བས་རྒྱས་པར་འགྱུར་ཕྱིར་རོ་༎ མི་དགེའི་འགྱོད་པའང་མ་ཡིན་ནོ་༎
 sarvatragā duḥkhahetudṛggheyā dṛṣṭayastathā |	སྡུག་བསྔལ་རྒྱུ་མཐོང་སྤང་བྱ་བ་༎
 vimatiḥ saha tābhiśca yāvidyāveṇikī ca yā || vakk_5|12 ||	ལྟ་དང་དེ་བཞིན་ཐེ་ཚོམ་དང་༎ གང་དེ་ལྷན་ཅིག་མ་འདྲེས་པའི་༎ མ་རིག་གང་ཡིན་ཀུན་ཏུ་འགྲོ་༎
 navordhvālambanā eṣāṃ dṛṣṭidvayavivarjitāḥ |	དེ་དག་ལས་དགུ་གོང་དུ་དམིགས་༎ ལྟ་བ་གཉིས་པོ་མ་གཏོགས་སོ་༎
 prāptivarjyāḥ sahabhuvo ye 'pyebhiste 'pi sarvagāḥ || vakk_5|13 || mithyādṛgvimatī tābhyāṃ yuktāvidyātha kevalā |	དེ་དག་དང་ནི་ལྷན་ཅིག་གང་༎ འབྱུང་དེའང་ཀུན་འགྲོ་ཐོབ་མ་གཏོགས་༎
 nirodhamārgadṛggheyāḥ ṣaḍanāsravagocarāḥ || vakk_5|14 ||	འགོག་དང་༄༡༦བ་ལམ་མཐོང་སྤང་བྱ་བ་༎ ལོག་ལྟ་ཐེ་ཚོམ་དེ་དག་དང་༎ ལྡན་དང་འབའ་ཞིག་མ་རིག་དང་༎ དྲུག་ནི་ཟག་མེད་སྤྱོད་ཡུལ་ཅན་༎
 svabhūmyuparamo mārgaḥ ṣaḍbhūminavabhūmikaḥ | tadgocarāṇāṃ viṣayo mārgo hyanyo 'nyahetukaḥ || vakk_5|15 ||	རང་གི་ས་པའི་འགོག་པ་དང་༎ ལམ་ནི་ཕན་ཚུན་རྒྱུ་ཡིན་པས་༎ ས་དྲུག་ས་དགུའི་ལམ་ནི་དེའི་༎ སྤྱོད་ཡུལ་ཅན་གྱི་ཡུལ་ཡིན་ནོ་༎
 na rāgastasya varjyatvāt na dveṣo 'napakārataḥ |	འདོད་ཆགས་མིན་ཏེ་སྤང་བྱའི་ཕྱིར་༎ གནོད་མི་བྱེད་ཕྱིར་ཞེ་སྡང་མིན་༎
 na māno na parāmarśau śāntaśuddhyagrabhāvataḥ || vakk_5|16 ||	ཞི་དང་དག་དང་མཆོག་གྱུར་ཕྱིར་༎ ང་རྒྱལ་མ་ཡིན་མཆོག་འཛིན་མིན་༎
 sarvatragā anuśayāḥ sakalāmanuśerate |	ཕྲ་རྒྱས་ཀུན་ཏུ་འགྲོ་རྣམས་ནི་༎
 svabhūmimālambanataḥ svanikāyamasarvagāḥ || vakk_5|17 ||	དམིགས་པའི་སྒོ་ནས་རང་གི་ས་༎ ཐམས་ཅད་དུ་ནི་རྒྱས་པར་འགྱུར་༎ ཀུན་འགྲོ་མ་ཡིན་རང་རིས་སུ༎
 nānāsravordhvaviṣayāḥ asvīkārādvipakṣataḥ |	ཟག་མེད་གོང་མའི་ཡུལ་ཅན་མིན་༎ བདག་གིར་མ་བྱས་གཉེན་པོའི་ཕྱིར་༎
 yena yaḥ saṃprayuktastu sa tasmin saṃprayogataḥ || vakk_5|18 ||	གང་ཞིག་གང་དང་མཚུངས་ལྡན་པ་༎ དེ་ནི་དེར་མཚུངས་ལྡན་སྒོ་ནས་༎
 ūrdhvamavyākṛtāḥ sarve kāme satkāyadarśanam |	གོང་མ་ཐམས་ཅད་ལུང་མ་བསྟན་༎ འདོད་ན་འཇིག་ཚོགས་ལྟ་བ་དང་༎ མཐར་འཛིན་ལྷན་ཅིག་མ་རིག་པ་༎ ལྷག་མ་རྣམས་འདིར་མི་དགེ་བའོ་༎
 antagrāhaḥ sahābhyāṃ ca mohaḥ śeṣāstvihāśubhāḥ || vakk_5|19 || kāme 'kuśalamūlāni rāgapratighamūḍhayaḥ |	འདོད་ན་འདོད་ཆགས་ཁོང་ཁྲོ་དང་༎ རྨོངས་རྣམས་མི་དགེའི་རྩ་བ་ཡིན་༎
 trīṇyakuśalamūlāni tṛṣṇāvidyā matiśca sā || vakk_5|20 ||	ལུང་མ་བསྟན་པའི་རྩ་བ་གསུམ་༎ དེ་ནེ་སྲིད་དང་མ་རིག་བློ་༎
 dvidhordhvavṛtternāto 'nyau catvāryeveti bāhyakāḥ |	རྣམ་གཉིས་མཐོར་འཇུག་ཕྱིར་དེ་ལས་༎ གཞན་མིན་བཞི་ཞེས་ཉི་འོག་པ་༎
 tṛṣṇādṛṅmānamohāste dhyāyitritvādavidyayā || vakk_5|21 ||	དེ་དག་སྲེད་ལྟ་ང་རྒྱལ་རྨོངས་༎ བསམ་གཏན་པ་གསུམ་མ་རིག་ལས་༎
 ekāṃśato vyākaraṇaṃ vibhajya paripṛcchya ca |	མགོ་གཅིག་དང་ནི་རྣམ་ཕྱེ་དང་༎ དྲི་དང་གཞག་པར་ལུང་བསྟན་པ་༎
 sthāpyaṃ ca maraṇotpatti viśiṣṭātmānyatādivat || vakk_5|22 ||	འཆི་དང་སྐྱེ་དང་ཁྱད་པར་འཕགས་༎ བདག་གཞན་ལ་སོགས་ལྟ་བུ་ཡིན་༎
 rāgapratighamānaiḥ syadatītapratyupasthitaiḥ |	འདས་དང་ཉེར་གནས་འདོད་ཆགས་དང་༎ ཁོང་ཁྲོ་ང་རྒྱལ་དག་གིས་ནི་༏་། གང་ལ་དེ་སྐྱེས་མ་སྤངས་པའི་༎
 yatrotpannāprahīṇāste tasmin vastuni saṃyutaḥ || vakk_5|23 ||	དངོས་པོ་དེ་དང་ལྡན་པ་ཡིན་།
 sarvatrānāgatairebhirmānasaiḥ svādhvike paraiḥ |	ཡིད་ཀྱི་དེ་དག་མ་འོངས་པས་༎ ཀུན་དང་གཞན་གྱིས་རང་དུས་པ་༎
 ajaiḥ sarvatra śeṣaistu sarvaiḥ sarvatra saṃyutaḥ || vakk_5|24 ||	མི་སྐྱེ་རྣམས་ཀྱིས་ཐམས་ཅད་དང་༎ ལྷག་མ་ཀུན་གྱིས་ཀུན་དང་ལྡན་༎
 sarvakālāstitā uktatvāt dvayāt sadviṣayāt phalāt |	དུས་རྣམས་ཀུན་ཏུ་ཡོད་གསུངས་ཕྱིར་༎ གཉིས་ཕྱིར་ཡུལ་ཡོད་ཕྱིར་འབྲས་ཕྱིར་༎ དེ་ཡོད་སྨྲ་བའི་ཕྱིར་ཐམས་ཅད་༎
 tadastivādāt sarvāstivādā iṣṭāḥ caturvidhāḥ || vakk_5|25 ||	ཡོད་པར་སྨྲ་བར་འདོད་དེ་དག་། 
 te bhāvalakṣaṇāvasthānyathānyathikasaṃjñitāḥ |	རྣམ་བཞི་དངོས་དང་མཚན་ཉིད་དང་༎ གནས་སྐབས་གཞན་གཞན་འགྱུར་ཞེས་བྱ་།
 tṛtīyaḥ śobhanaḥ adhvānaḥ kāritreṇa vyavasthitāḥ || vakk_5|26 ||	གསུམ་པ་བཟང་སྟེ་བྱ་བ་ཡིས་༎ དུས་རྣམས་རྣམ་གཞག་གེགས་སུ་བྱེད་༎
 kiṃ vighnaṃ tatkathaṃ nānyat adhvāyogaḥ tathā sataḥ |	དེ་ཡང་ཇི་ལྟར་༄༡༧ཨ་༌་༎ གཞན་མ་ཡིན་༎ དུས་སུ་མི་རུང་དེ་བཞིན་དུ་༎
 ajātanaṣṭatā kena gambhīrā khalu dharmatā || vakk_5|27 ||	།
 prahīṇe duḥkhadṛggheye saṃyuktaḥ śeṣasarvagaiḥ |	སྡུག་བསྔལ་མཐོང་སྤང་བྱ་སྤངས་ཀྱང་༎ ཀུན་འགྲོ་ལྷག་མ་རྣམས་ཀྱིས་ལྡན་༎ དང་པོའི་རྣམ་པ་སྤངས་ཀྱང་དེའི་༎
 prāk prahīṇe prakare ca śeṣaistadviṣayairmalaiḥ || vakk_5|28 ||	ཡུལ་ཅན་དྲི་མ་ལྷག་རྣམས་ཀྱིས་༏་། སྡུག་བསྔལ་རྒྱུ་མཐོང་གོམས་པ་ཡིས་༎
 duḥkhahetudṛgabhyāsapraheyāḥ kāmadhātujāḥ |	སྤང་བྱ་འདོད་ཁམས་ལས་སྐྱེས་པ་༎
 svakatrayaikarūpāptāmalavijñānagocarāḥ || vakk_5|29 ||	།
 svakādharatrayordhvaikāmalānāṃ rūpadhātujāḥ |	གཟུགས་ཁམས་ལས་སྐྱེས་རང་གི་དང་༎ འོག་གསུམ་གོང་གཅིག་དྲི་མེད་ཀྱིའང་༎
 ārūpyajāstridhātvātpatrayānāsravagocarāḥ || vakk_5|30 ||	གཟུགས་མེད་ལས་སྐྱེས་ཁམས་གསུམ་གཏོགས་༎ གསུམ་དང་ཟག་མེད་སྤྱོད་ཡུལ་ལོ་༎
 nirodhamārgadṛggheyāḥ sarve svādhikagocarāḥ |	འགོག་དང་ལམ་མཐོང་སྤང་བྱ་ཀུན་༎ རང་གིས་གླགས་པའི་སྤྱོད་ཡུལ་ལོ་༎
 anāsravāstridhātvantyatrayānāsravagocarāḥ || vakk_5|31 ||	ཟག་མེད་ཁམས་གསུམ་མཐའ་གསུམ་དང་༎ ཟག་པ་མེད་པའི་སྤྱོད་ཡུལ་ལོ་༎
 dvidhā sānuśayaṃ kliṣṭamakliṣṭamanuśāyakaiḥ |	ཉོན་མོངས་ཕྲ་རྒྱས་བཅས་རྣམ་གཉིས་༏་། ཉོན་མོངས་ཅན་མིན་རྒྱས་འགྱུར་གྱིས་༎
 mohākāṅkṣā tato mithyādṛṣṭiḥ satkāyadṛktataḥ || vakk_5|32 ||	རྨོངས་ལས་ཐེ་ཚོམ་དེ་ནས་ནི་༎ ལོག་ལྟ་དེ་ནས་འཇིག་ཚོགས་ལྟ་༎
 tato 'ntagrahaṇaṃ tasmācchīlāmarśaḥ tato dṛśaḥ |	དེ་ནས་མཐར་འཛིན་དེ་ནས་ནི་༎ ཚུལ་ཁྲིམས་མཆོག་འཛིན་དེ་ནས་ལྟ་༎
 rāgaḥ svadṛṣṭau mānaśca dveṣo 'nyatra ityanukramaḥ || vakk_5|33 ||	རང་གི་ལྟ་ལ་ང་རྒྱལ་ཆགས་༎ གཞན་ལ་ཞེ་སྡང་དེ་ལྟར་རིམ་༎
 aprahīṇādanuśayādviṣayāt pratyupasthitāt |	ཕྲ་རྒྱས་སྤངས་པ་མ་ཡིན་དང་༎ ཡུལ་ནི་ཉེ་བར་གནས་པ་དང་༎ ཚུལ་བཞིན་མ་ཡིན་ཡིད་བྱེད་ལས་༎
 ayoniśo manaskārāt kleśaḥ saṃpūrṇakāraṇaḥ || vakk_5|34 ||	ཉོན་མོངས་རྒྱུ་ནི་ཚང་བ་ཡིན་༎
 kāme saparyavasthānāḥ kleśāḥ kāmasravo vinā |	འདོད་ན་གཏི་མུག་མ་གཏོགས་པའི་༎ ཉོན་མོངས་ཀུན་ནས་དཀྲིས་བཅས་ཟག་། 
 mohena anuśayā eva rūpārūpye bhavāsravaḥ || vakk_5|35 ||	གཟུགས་དང་གཟུགས་ནི་མེད་པ་ན་༎ ཕྲ་རྒྱས་ཁོ་ན་སྲིད་པའི་ཟག་། དེ་ལུང་མ་བསྟན་ཁ་ནང་བལྟས་༎
 avyākṛtāntarmukhā hi te samāhitabhūmikāḥ |	མཉམ་གཞག་ས་པའི་ཕྱིར་གཅིག་བྱས་༎
 ata ekīkṛtāḥ mūlamavidyetyāsravaḥ pṛthak || vakk_5|36 ||	རྩ་བ་མ་རིག་ཡིན་པས་ན་༎ ལོགས་ཤིག་ཏུ་ནི་ཟག་པར་བསྟན་༎
 tathaughayogā dṛṣṭīnāṃ pṛthagbhāvastu pāṭavāt |	ཆུ་བོ་སྦྱོར་བའང་དེ་བཞིན་དུ་༎ ལྷ་རྣམས་གསལ་ཕྱིར་ལོགས་ཤིག་བསྟན་༎
 nāsraveṣvasahāyānāṃ na kilāsyānukūlatā || vakk_5|37 ||	ཟག་པར་མ་ཡིན་གྲོགས་མེད་རྣམས་༎ འཇོག་པའི་རྗེས་སུ་མི་མཐུན་ལོ་༎
 yathoktā eva sāvidyā dvidhā dṛṣṭivivecanāt |	ཇི་སྐད་བཤད་ཉིད་མ་རིག་བཅས་༎ ཉེར་ལེན་རྣམས་ཏེ་ལྟ་རྣམ་གཉིས་༎ ཕྱེ་བའི་ཕྱིར་རོ་མ་རིག་པ་༎
 upādānāni avidyā tu grāhikā ne ti miśritā || vakk_5|38 ||	འཛིན་པར་བྱེད་པ་མིན་ཕྱིར་བསྲེས་༎
 aṇavo 'nugatāścaite dvidhā cāpyanuśerate |	གང་ཕྱིར་དེ་དག་ཕྲ་བ་དང་༎ རྗེས་འབྲེལ་རྣམ་གཉིས་རྒྱས་འགྱུར་དང་༎ རྗེས་༄༡༧བ་སུ་འབྲང་བས་དེ་ཡི་ཕྱིར་༎
 anubadhnanti yasmācca tasmādanuśayāḥ smṛtāḥ || vakk_5|39 || āsayantyāsravantyete haranti śleṣayantyatha |	ཕྲ་རྒྱས་དག་ཏུ་བཤད་པ་ཡིན་༎
 upagṛhṇanti cetyeṣāmāsravādiniruktayaḥ || vakk_5|40 ||	དེ་དག་འཇོག་བྱེད་ཟག་བྱེད་དང་༎ འཁྱེར་བར་བྱེད་དང་འབྱར་བྱེད་དང་༎ ཉེ་བར་འཛིན་ཕྱིར་ཟག་ལ་སོགས་༎ དེ་དག་གི་ནི་ངེས་ཚིག་ཡིན་༎
 saṃyojanādibhedena punaste pañcadhoditāḥ |	དེ་དག་ཀུན་ཏུ་སྦྱོར་སོགས་ཀྱི་༎ དབྱེ་བས་ཡང་རྣམ་ལྔར་བཤད་དོ་༏་། རྫས་དང་མཆོག་འཛིན་འདྲ་བའི་ཕྱིར་༎
 dravyāmarśana sāmānyaddṛṣṭī saṃyojanāntaram || vakk_5|41 ||	ལྟ་གཉིས་ཀུན་ཏུ་སྦྱོར་གཞན་ནོ་༎
 ekāntākuśalaṃ yasmāt svatantraṃ cobhayaṃ yataḥ |	གང་ཕྱིར་གཉིས་ཀའང་གཅིག་ཏུ་ནི་༎ མི་དགེ་རང་དབང་དེ་ཡི་ཕྱིར་༎ ཕྲག་དོག་སེར་སྣ་དེ་དག་ལས་༎
 īrṣyāmātsaryameṣūktaṃ pṛthak saṃyojanadvayam || vakk_5|42 ||	ལོགས་ཤིག་ཀུན་སྦྱོར་གཉིས་སུ་བཤད་༎
 pañcadhāvarabhāgīyaṃ dvābhyāṃ kāmānatikramaḥ |	ཐ་མའི་ཆ་དང་མཐུན་རྣམ་ལྔ་༎ གཉིས་ཀྱིས་འདོད་ལས་མི་འདའ་ལ་༎
 tribhistu punarāvṛttiḥ mukhamūlagrahāttrayam || vakk_5|43 ||	གསུམ་པོ་ཡིས་ནི་ཕྱིར་ཟློག་བྱེད་༎ སྒོ་དང་རྩ་བས་བསྡུས་ཕྱིར་གསུམ་༎ འགྲོ་མི་འདོད་དང་ལམ་ནོར་དང་༎ ལམ་ལ་ཐེ་ཚོམ་དེ་སྙེད་ཅིག་། 
 agantukāmatāmārgavibhramo mārgasaṃśayaḥ |	ཐར་པ་བགྲོད་ལ་གེགས་བྱེད་པ་༎
 ityantarāyā mokṣasya gamane 'tastrideśanā || vakk_5|44 ||	དེ་ཡི་ཕྱིར་ན་གསུམ་བསྟན་ཏོ་༎
 pañcadhaivordhvabhāgīyaṃ dvau rāgau rūpyarūpijau |	གོང་མའི་ཆ་དང་མཐུན་ལྔ་ཉིད་༎ གཟུགས་དང་གཟུགས་མེད་ལས་སྐྱེས་པའི་༎ འདོད་ཆགས་གཉིས་རྒོད་ང་རྒྱལ་རྨོངས་༎
 auddhatyamānamohāśca vidvaśād bandhanatrayam || vakk_5|45 ||	ཚོར་བའི་དབང་གིས་འཆིང་བ་གསུམ་༎
 ye 'pyanye caitasāḥ kliṣṭāḥ saṃskāraskandhasaṃjñitāḥ |	ཉོན་མོངས་ལས་གཞན་ཉོན་མོངས་ཅན་༎ སེམས་བྱུང་འདུ་བྱེད་ཕུང་ཞེས་པ་༎
 kleśebhyaste 'pyupakleśāste tu na kleśasaṃjñitāḥ || vakk_5|46 ||	གང་དེའང་ཉེ་བའི་ཉོན་མོངས་ཏེ་༎ དེ་དག་ཉོན་མོངས་ཞེས་མི་བྱ་༎
 āhrīkyamanapatrapyamīrṣyāmātsaryamuddhavaḥ | kaukṛtyaṃ styānamiddhaṃ ca paryavasthānamaṣṭadhā || vakk_5|47 ||	ངོ་ཚ་མེད་དང་ཁྲེལ་མེད་དང་༎ ཕྲག་དོག་སེར་སྣ་རྒོད་པ་དང་༎ འགྱོད་དང་རྨུགས་དང་གཉིད་དང་ནི་༎ ཀུན་ནས་དཀྲིས་པ་རྣམ་པ་བརྒྱད་༎
 krodhamrakṣau ca rāgotthā āhrīkyauddhatyamatsarāḥ |	ཁྲོ་དང་འཆབ་པའོ་འདོད་ཆགས་ཀྱིས་༎ ངོ་ཚ་མེད་རྒོད་སེར་སྣ་བསླང་༎
 mrakṣe vivādaḥ avidyātaḥ styānamiddhānapatrapāḥ || vakk_5|48 ||	འཆབ་པ་རྩོད་དོ་མ་རིག་ལས་༏་། རྨུགས་དང་གཉིད་དང་ཁྲེལ་མེད་དོ་༎
 kaukṛtyaṃ vicikitsātaḥ kodherṣye pratighānvaye |	ཐེ་ཚོམ་ལས་འགྱོད་ཁྲོ་བ་དང་༎ ཕྲག་དོག་ཁོང་ཁྲོའི་རྒྱུ་ལས་བྱུང་༎ གཞན་ཡང་ཉོན་མོངས་དྲི་མ་དྲུག་། 
 anye ca ṣaṭkleśamalāḥ māyā śāṭhyaṃ madastathā || vakk_5|49 || pradāśa upanāhaśca vihiṃsā ceti rāgajau |	སྒྱུ་དང་ག-ཡོ་དང་རྒྱགས་པ་དང་༎ དེ་བཞིན་འཚིག་དང་ཁོན་འཛིན་དང་༎ རྣམ་འཚེ་རྒྱུ་དང་རྒྱགས་པ་ནི་༎
 māyāmadau pratighaje upanāhavihiṃsane || vakk_5|50 ||	འདོད་ཆགས་ལས་སྐྱེས་ཁོན་འཛིན་དང་༎ རྣམ་འཚེ་ཁོང་ཁྲོ་ལས་སྐྱེས་སོ་༎
 dṛṣṭyāmarśāt pradāśastu śāṭhyaṃ dṛṣṭisamutthitam |	འཚིག་པ་ལྟ་བ་མཆོག་འཛིན་ལས་༎ ག-ཡོ་ནི་ལྟ་བས་ཀུན་ནས་བསླང་༎
 tatrāhrīkyānapatrāpyastyānāmiddhoddhavā dvidhā || vakk_5|51 ||	དེ་ལས་ངོ་ཚ་མེད་པ་དང་༎ ཁྲེལ་མེད་རྨུགས་གཉིད་རྒོད་རྣམ་གཉིས་༎
 tadanye bhāvanāheyāḥ svatantrāśca tathā malāḥ |	དེ་ལས་གཞན་ནི་བསྒོམ་སྤང་བྱ་༎ རང་དབང་དེ་བཞིན་༄༡༨ཨ་༌་༎ དྲི་མ་རྣམས་༎
 kāme 'śubhāḥ trayo dvidhā pareṇāvyākṛtāstataḥ || vakk_5|52 ||	འདོད་ན་མི་དགེ་གསུམ་རྣམ་གཉིས་༎ དེ་ཡན་ཆད་ནི་ལུང་མ་བསྟན་༎ འདོད་དང་བསམ་གཏན་དང་པོ་ན་༎
 māyā śāṭhyaṃ ca kāmādyadhyānayoḥ brahmavañcanāt |	ག-ཡོ་སྒྱུ་ཚངས་པས་འདྲིད་ཕྱིར་རོ་༎
 styānauddhatyamadā dhātutraye anye kāmadhātujāḥ || vakk_5|53 ||	རྨུགས་རྒོད་རྒྱགས་པ་ཁམས་གསུམ་ན་༎ གཞན་དག་འདོད་ཁམས་ལས་སྐྱེས་པ་༎
 samānasiddhā dṛggheyā manovijñānabhūmikāḥ |	མཐོང་སྤང་བྱ་གཉིད་ང་རྒྱལ་བཅས་༎ ཡིད་ཀྱི་རྣམ་ཤེས་ས་པ་ཡིན་༎
 upakleśāḥ svatantrāśca ṣaḍ vijñānāśrayāḥ pare || vakk_5|54 ||	ཉེ་བའི་ཉོན་མོངས་རང་དབང་ཡང་༎ གཞན་ནི་རྣམ་ཤེས་དྲུག་རྟེན་ཅན་༎
 sukhābhyāṃ saṃprayukto hi rāgaḥ dveṣo viparyayāt |	བདེ་བ་དག་དང་འདོད་ཆགས་སུ་༎ མཚུངས་ལྡན་ཞེ་སྡང་བཟློག་པའོ་༎
 mohaḥ sarvaiḥ asaddṛṣṭirmanoduḥkhasukhena tu || vakk_5|55 ||	མ་རིག་པ་དག་ཐམས་ཅད་དང་༎ མེད་ལྟ་ཡིད་བདེ་སྡུག་བསྔལ་དང་༎ ཡིད་མི་བདེ་དང་ཐེ་ཚོམ་མོ་༎
 daurmanasyena kāṅkṣā anye saumanasyena kāmajāḥ |	གཞན་ཡིད་བདེ་དང་འདོད་ལས་སྐྱེས་༎
 sarve 'pyupekṣayā svaiḥ svairyathābhūmyūrdhvabhūmikāḥ || vakk_5|56 ||	བཏང་སྙོམས་དད་ཀུན་ས་གོང་མ་༎
 daurmanasyena kaukṛtyamīrṣyā krodho vihiṃsanam | upanāhaḥ pradāśaśca mātsaryaṃ tu viparyayāt || vakk_5|57 ||	ས་ཇི་བཞིན་དུ་རང་རང་དང་༎ འགྱོད་དང་ཕྲག་དོག་ཁྲོ་བ་དང་༎ རྣམ་འཚེ་ཁོན་དུ་འཛིན་པ་དང་༎ འཚིག་པ་ཡིད་མི་བདེ་བ་དང་༎ སེར་སྣ་དག་ནི་བཟློག་པ་ཡིན་༎
 māyā śāṭhyamatho mrakṣo middhaṃ cobhayathā madaḥ |	ག-ཡོ་དང་སྒྱུ་དང་འཆབ་དང་གཉིས་༎
 sukhābhyām sarvagopekṣā catvāryanyāni pañcabhiḥ || vakk_5|58 ||	གཉིས་ཀ་དང་ལྡན་བདེ་དག་དང་༎ རྒྱགས་པ་བཏང་སྙོམས་ཀུན་ཏུ་འགྲོ་༎
 kāme nivaraṇāni ekavipakṣāhārakṛtyataḥ |	བཞི་པོ་གཞན་ནི་ལྔ་དག་དང་༎ འདོད་ན་སྒྲིབ་རྣམས་མི་མཐུན་དང་༎ ཟས་དང་བྱ་བ་གཅིག་པའི་ཕྱིར་༎
 dvayaketā pañcatā skandhavighātavicikitsanāt || vakk_5|59 ||	གཉིས་གཅིག་ཕུང་པོ་གནོད་བྱེད་དང་༎ ཐེ་ཚོམ་ཕྱིར་ན་ལྔ་ཉིད་དོ་༎
 ālambanaparijñānāttadālambanasaṃkṣayāt |	དམིགས་པ་ཡོངས་སུ་ཤེས་པ་དང་༎ དེ་ལ་དམིགས་པ་ཡང་དག་པར་༎
 ālambanaprahāṇācca pratipakṣodayāt kṣayaḥ || vakk_5|60 ||	ཟད་དང་དམིགས་པ་སྤངས་པས་སོ་༎ གཉེན་པོ་སྐྱེས་པས་ཟད་པར་འགྱུར་༎
 prahāṇādhārabhūtattva dūṣaṇākhyaścaturvidhaḥ |	གཉེན་པོ་རྣམ་བཞི་སྤོང་བ་དང་༎ གཞི་དང་སྲིད་ཉིད་རྣམ་པར་ནི་༏་སུན་འབྱིན་ཞེས་བྱ་དམིགས་པ་ལས་༎
 pratipakṣaḥ prahātavyaḥ kleśa ālambanāt mataḥ || vakk_5|61 ||	ཉོན་མོངས་པ་ནི་སྤང་བྱར་འདོད་༎
 vailakṣaṇyādvipakṣatvāddeśavicchedakālataḥ |	མཚན་ཉིད་མི་མཐུན་མི་མཐུན་ཕྱོགས་༎ ཡུལ་རྣམ་ཆད་དང་དུས་ཀྱིས་ཏེ་༎
 bhūtaśīlapradeśādhvadvayānāmiva dūratā || vakk_5|62 ||	འབྱུང་དང་ཚུལ་ཁྲིམས་ཕྱོགས་དང་ནི་༎ དུས་གཉིས་རིང་བ་ཉིད་ལྟ་བུའོ་༎
 sakṛt kṣayaḥ visaṃyogalābhasteṣāṃ punaḥ pūnaḥ |	།
 pratipakṣodayaphalaprāptīndriyavivṛddhiṣu || vakk_5|63 ||	གཉེན་པོ་སྐྱེས་དང་འབྲས་ཐོབ་དང་༎ དབང་པོ་རྣམ་པར་འཕེལ་རྣམས་སུ་༎
 parijñā nava kāmādyaprakāradvayasaṃkṣayaḥ |	ཡོངས་སུ་ཤེས་དགུ་འདོད་པ་ན་༎ དང་པོ་རྣམས་གཉིས་ཟད་ལ་གཅིག་། 
 ekā dvayoḥ kṣaye dve te tathordhvaṃ tisra eva tāḥ || vakk_5|64 ||	གཉིས་ཟད་པ་ནི་དེ་གཉིས་སོ་༎ དེ་བཞིན་གོང་མའི་དེ་གསུམ་ཉིད་༎
 anyā avarabhāgīyarūpasarvāsravakṣayāḥ | tisraḥ parijñāḥ ṣaṭ kṣāntiphalaṃ jñānasya śeṣitāḥ || vakk_5|65 ||	ཡོངས་སུ་ཤེས་པ་༄༡༨བ་གཞན་གསུམ་སྟེ་༎ ཐ་མའི་ཆ་དང་མཐུན་གཟུགས་དང་༎ ཟག་པ་ཀུན་ཟད་དྲུག་བཟོད་འབྲས་༎ ལྷག་མ་རྣམས་ནི་ཤེས་པའི་ཡིན་༎
 anāgamyaphalaṃ sarvā dhyānānāṃ pañca vāthavā |	མི་ལྕོགས་མེད་འབྲས་ཐམས་ཅད་དོ་༎ བསམ་གཏན་རྣམས་ཀྱི་ལྔའམ་བརྒྱད་༎ ཉེ་བར་བསྡོགས་པའི་གཅིག་ཡིན་ཏེ་༎
 aṣṭau sāmantakasyaikā maulārūpyatrayasya ca || vakk_5|66 ||	གཟུགས་མེད་དངོས་གཞི་གསུམ་གྱི་ཡང་༎
 āryamārgasya sarvāḥ dve laukikasya anvayasya ca |	ཐམས་ཅད་འཕགས་པའི་ལམ་གྱི་ཡིན་༎ འཇིག་རྟེན་པའི་གཉིས་རྗེས་ཀྱི་ཡང་༎
 dharmajñānasya tisrastu ṣaṭ tatpakṣasya pañca ca || vakk_5|67 ||	ཆོས་ཤེས་པའི་ནི་གསུམ་ཡིན་ནོ་༎ དེའི་ཕྱོགས་མཐུན་གྱི་དྲུག་དང་ལྔ་༎
 anāsravaviyogāpterbhavāgravikalīkṛteḥ |	བྲལ་བའི་ཐོབ་པ་ཟག་མེད་དང་༎ སྲིད་རྩེ་ཉམས་པར་བྱས་པ་དང་༎ རྒྱུ་གཉིས་ཀུན་ཏུ་བཅོམ་པའི་ཕྱིར་༎
 hetudvayasamudghātāt parijñā dhātvatikramāt || vakk_5|68 ||	ཡོངས་ཤེས་ཁམས་ལས་འདས་པ་ལས་༎
 naikayā pañcabhiryāvaddarśanasthaḥ samanvitaḥ |	གཅིག་མིན་མཐོང་ལ་གནས་པ་ནི་༎ ལྔ་ཡི་བར་དང་ཡང་དག་ལྡན་༎ བསྒོམས་ལ་གནས་པ་དྲུག་གམ་ནི་༎
 bhāvanāsthaḥ punaḥ ṣaḍibharekayā vā dvayena vā || vakk_5|69 ||	གཅིག་གམ་ཡང་ན་གཉིས་དང་ངོ་༎
 tāsāṃ saṃkalanaṃ dhātuvairāgyaphalalābhataḥ |	ཁམས་ལས་འདོད་ཆགས་བྲལ་བ་དང་༏་།འབྲས་བུ་ཐོབ་ཕྱིར་དེ་དག་བསྡོམས་༎
 ekāṃ dve pañca ṣaṭ kaścijjahātyāpnoti pañca na || vakk_5|70 ||	།
 samāptaḥ parijñāprasaṅgaḥ || abhidharmakośe 'nuśayanirddeśo nāma pañcamaṃ kośasthānaṃ samāptamiti || śrīlāmāvākasya yadatra puṇyam |	ཆོས་མངོན་པའི་མཛོད་ཀྱི་ཚིག་ལེའུར་བྱས་པ་ལས་༎
 ṣaṣṭhaṃ kośasthānam oṃ namo buddhāya ||	ཕྲ་རྒྱས་བསྟན་པ་ཞེས་བྱ་བ་སྟེ་གནས་དྲུག་པའོ་།
 kleśaprahāṇāmākhyātaṃ satyadarśanabhāvanāt |	༎ ། བདེན་པ་མཐོང་དང་བསྒོམས་པ་ལས་༏་། ཉོན་མོངས་སྤངས་པ་ཞེས་བཤད་པ་༎
 dvividho bhāvanāmārgo darśanākhyastvanāsravaḥ || vakk_6|1 ||	བསྒོམ་པའི་ལམ་ནི་རྣམ་གཉིས་ཏེ་༎ མཐོང་བ་ཞེས་བྱ་ཟག་པ་མེད་༎
 satyānyuktāni catvāri duḥkhaṃ samudayastathā |	བདེན་པ་དག་ནི་བཞིར་བཤད་དོ་༎ སྡུག་བསྔལ་ཀུན་འབྱུང་དེ་བཞིན་དུ་༎
 nirodhamārga iti eṣāṃ yathābhisamayaṃ kramaḥ || vakk_6|2 ||	འགོག་དང་ལམ་སྟེ་དེ་ལྟར་ན་༎ དེ་དག་ཇི་ལྟར་མངོན་རྟོགས་རིམ་༎
 duḥkhā stridūḥkhatāyogādyathāyogamaśeṣataḥ | manāpā amanāpāśca tadanye caiva sāsravāḥ || vakk_6|3 ||	ཡིད་འོང་ཡིད་དུ་མི་འོང་དང་༎ དེ་ལས་གཞན་ཟག་བཅས་རྣམས་ཉིད་༎ སྡུག་བསྔལ་ཉིད་གསུམ་ལྡན་པའི་ཕྱིར་༎ ཅི་རིགས་མ་ལུས་སྡུག་བསྔལ་ལོ་༎
 yatra bhinnena tadbuddhiranyāpohe dhiyā ca tat |	གང་ལ་བཅོམ་དང་བློ་ཡིས་གཞན་༎ བསལ་ན་དེ་བློ་མི་འཇུག་པ་༎
 ghaṭārthavatsaṃvṛtisat paramārthasadanyathā || vakk_6|4 ||	བུམ་ཆུ་བཞིན་དུ་ཀུན་རྫོབ་ཏུ་༎ ཡོད་དེ་དོན་དམ་ཡོད་གཞན་ནོ་༎
 vṛttasthaḥ śrutacintāvānbhāvanāyāṃ prayujyate |	ཚུལ་གནས་ཐོས་དང་བསམ་ལྡན་པས་༎ བསྒོམ་པ་ལ་ནི་རབ་ཏུ་སྦྱོར་༎
 nāmobhayārthaviṣayā śrutamayyādikā dhiyaḥ || vakk_6|5 ||	ཐོས་སྩོགས་ལས་བྱུང་བློ་རྣམས་ནི་༎ མིང་དང་གཉིས་ཀ་དོན་ཡུལ་ཅན་༎
 vyapakarṣadvayavataḥ nāsaṃtuṣṭamahecchayoḥ |	བསྲིང་གཉིས་ལྡན་ཆོག་མི་ཤེས་དང་༎ འདོད་ཆེན་ཅན་ལ་མ་ཡིན་ནོ་༎
 labdhe bhūyaḥspṛhātuṣṭiralabdhecchā mahecchatā || vakk_6|6 ||	རྙེད་ལ་ཡང་༄༡༩ཨ་༌་༎ སྲེད་ཆོག་མི་ཤེས་༎ མ་རྙེད་ལ་འདོད་འདོད་ཆེན་ཅན་༎
 viparyāsāttadvipakṣau tridhātvāptāmalau ca tau |	།
 alobhaḥ āryavaṃśāśca teṣāṃ tuṣṭayātmakāstrayaḥ || vakk_6|7 ||	མ་ཆགས་འཕགས་རིགས་དེ་དག་ལས་༎ གསུམ་ནི་ཆོག་ཤེས་བདག་ཉིད་དོ་༎
 karmāntena tribhirvṛttiḥ tṛṣṇotpādavipakṣataḥ |	གསུམ་གྱིས་ཚུལ་བསྟན་ཐ་མས་ལས་༎ སྲེད་པ་སྐྱེ་བའི་གཉེན་པོའི་ཕྱིར་༎
 mamāha kāravastvicchātatkālātyantaśāntaye || vakk_6|8 ||	བདག་གིར་བདག་འཛིན་དངོས་འདོད་པ་༎ དེ་ཡི་དུས་དང་གཏན་ཞིའི་ཕྱིར་༎
 tatrāvatāro 'śubhayā cānāpānasmṛtena ca |	དེ་ལ་འཇུག་པ་མི་སྡུག་པ་༎ དབུགས་རྔུབ་འབྱུང་བ་དྲན་པ་ཡིས་༎
 adhirāgavitarkāṇām śaṃkalā sarvārāgiṇām || vakk_6|9 ||	འདོད་ཆགས་རྣམ་རྟོག་ལྷག་རྣམས་སོ་༎ ཀེང་རུས་ཆགས་བཅས་ཐམས་ཅད་ལ་༎
 āsamudrāsthivistārasaṃkṣepādādikarmikaḥ |	རུས་པ་རྒྱ་མཚོའི་བར་དུ་ནི་༎ སྤྲོ་ཞིང་སྡུད་པས་ལས་དང་པོ་༎
 pādāsthna ākapālārdhatyāgāt kṛtajayaḥ smṛtaḥ || vakk_6|10 ||	རྐང་རུས་ནས་ནི་ཐོད་ཕྱེད་བར་༎ བཏང་བས་སྦྱང་བ་བྱས་པར་བཤད་༎
 atikrāntamanaskāro bhrūmadhye cittadhāraṇāt |	སྨིན་མའི་བར་དུ་སེམས་འཛིན་པས་༎ ཡིད་ལ་བྱེད་པ་རྫོགས་པ་ཡིན་༎
 alobho daśabhūḥ kāmadṛśyālambā nṛjāśubhā || vakk_6|11 ||	མི་སྡུག་མ་ཆགས་ས་བཅུ་དང་༎ དམིགས་པ་འདོད་སྣང་མིས་སྐྱེད་དོ་༎
 ānāpānasmṛtiḥ prajñā pañcabhūrvāyurgīcarā |	དབུགས་རྔུབ་དབུགས་འབྱུང་དྲན་པ་ནི་༎ ཤེས་རབ་ས་ལྔ་སྤྱོད་ཡུལ་རླུང་༎
 kāmāśrayā na bāhyānām ṣaḍ vidhā gaṇanādibhiḥ || vakk_6|12 ||	འདོད་རྟེན་ཕྱི་བའི་མ་ཡིན་ནི་༎ བགྲང་ལ་སོགས་པ་རྣམ་པ་དྲུག་། དབུགས་རྔུབ་དབུགས་འབྱུང་གང་ལས་ལུས་༎
 ānāpānau yataḥ kāyaḥ sattvākhyau anupāttakau |	སེམས་ཅན་ཞེས་བྱ་མ་ཟིན་པའོ་༎
 naiḥṣyandikau nādhareṇa lakṣyete manasā ca tau || vakk_6|13 ||	རྒྱུ་མཐུན་ལས་བྱུང་འོག་མ་ཡི་༎ ཡིད་ཀྱིས་དེ་གཉིས་མ་རྟོགས་སོ་༎
 niṣprannaśamathaḥ kuryāt smṛtyupasthānabhāvanām |	ཞི་གནས་གྲུབ་པར་གྱུར་པ་ཡིས་༎ དྲན་པ་ཉེར་གཞག་བསྒོམ་པར་བྱ་༎ ལུས་ཚོར་སེམས་དང་ཆོས་རྣམས་ལ་༎
 kāyaviccittadharmāṇāṃ dvilakṣaṇaparīkṣaṇāt || vakk_6|14 ||	མཚན་ཉིད་གཉིས་སུ་ཡོངས་བརྟགས་པས་༎
 prajñā śrutādimayī anye saṃsargālambanāḥ kramaḥ |	ཤེས་རབ་ཐོས་སོགས་ལས་བྱུང་བའོ་༎ གཞན་ནི་འབྲེལ་དང་དམིགས་པ་ལས་༎ རིམ་ནི་ཇི་ལྟར་སྐྱེ་བ་བཞིན་༎
 yathotpatti catuṣkaṃ tu viparyāsavipakṣataḥ || vakk_6|15 ||	ཕྱིན་ཅི་ལོག་གི་གཉེན་པོར་བཞི་༎
 sa dharmasmṛtyupasthāne samastālambane sthitaḥ |	དེ་ནི་ཆོས་དྲན་ཉེར་གཞག་པ་༎ སྤྱི་ལ་དམིགས་པ་ལ་གནས་ཏེ་༎
 ānityaduḥkhataḥ śūnyānātmatastānvipaśyati || vakk_6|16 ||	དེ་དག་ལ་ནི་མི་རྟག་དང་༎ སྡུག་བསྔལ་སྟོང་བདག་མེད་པར་ལྟ་༎
 tata ūṣmagatotpattiḥ taccatuḥsatyagocaram |	དེ་ལས་དྲོ་བར་གྱུར་པ་འབྱུང་༏་། དེ་ནི་བདེན་བཞིའི་སྤྱོད་ཡུལ་ཅན་༎
 ṣoḍaśākāram ūṣmabhyo mūrdhānaḥ te 'pi tādṛśāḥ || vakk_6|17 ||	རྣམ་པ་བཅུ་དྲུག་དྲོ་བ་ལས་༎ རྩེ་མོ་དེ་ཡང་དེ་དང་འདྲ་༎
 ubhayākaraṇaṃ dharmeṇa anyairapi tu vardhanam |	གཉིས་ཀ་ཆོས་ཀྱིས་རྣམ་པ་གཏོད་༎ གཞན་དག་གིས་ཀྱང་འཕེལ་བར་བྱེད་༎
 tebhyaḥ kṣāntiḥ dvidhā tadvat kṣāntyā dharmeṇa vardhanam || vakk_6|18 ||	དེ་ལས་བཟོད་པ་གཉིས་དེ་བཞིན་༎ ཐམས་ཅད་ཆོས་ཀྱིས་འཕེལ་བར་བྱེད་༎
 kāmāptaduḥkhaviṣayā tvadhimātrā kṣaṇaṃ ca sā |	༄༡༩བ་ཆེན་པོ་འདོད་གཏོགས་སྡུག་བསྔལ་ཡུལ་༎ དེ་ནི་སྐད་ཅིག་གཅིག་དེ་བཞིན་༎
 tathāgradharmāḥ sarve tu pañcaskandhāḥ vināptibhiḥ || vakk_6|19 ||	ཆོས་མཆོག་ཐམས་ཅད་ཕུང་པོ་ལྔ་༎ ཐོབ་པ་མ་གཏོགས་དེ་ལྟར་ན་༎
 iti nirvedhabhāgīyaṃ caturdhā bhāvanāmayam |	ངེས་འབྱེད་ཆ་མཐུན་རྣམ་པ་བཞི་༎
 anāgamyā ntaradhyānabhūmikam dve tvadho 'pi vā || vakk_6|20 ||	བསྒོམས་བྱུང་མི་ལྕོགས་མེད་པ་དང་༎ ཁྱད་པར་བསམ་གཏན་ས་པའོ་༎ གཉིས་ནི་འོག་ནའང་ཡོད་པའམ་༎
 kāmāśrayāṇi agradharmān dvayāśrayān labhate 'ṅganā |	འདོད་རྟེན་ཆོས་མཆོག་བུད་མེད་ཀྱིས་༎ གཉིས་ཀའི་རྟེན་ཅན་འཐོབ་པར་འགྱུར་༎
 bhūmityāgāttyajatyāryastāni anāryastu mṛtyunā || vakk_6|21 ||	འཕགས་པས་དེ་དག་ས་བོར་ནས་༎ གཏོང་ངོ་འཕགས་མིན་འཆི་བས་སོ་༎
 ādye dve parihāṇyā ca maulestatraiva satyadṛk |	དང་པོ་གཉིས་ཡོངས་ཉམས་པས་ཀྱང་། དངོས་གཞིས་དེ་ཉིད་ལ་བདེན་མཐོང་༎ རྣམ་པར་ཉམས་ཚེ་སྔོན་མེད་འཐོབ་༎
 apūrvāptirvihīneṣu hānī dve asamanvitiḥ || vakk_6|22 ||	ཉམས་པ་གཉིས་ནི་མི་ལྡན་པ་༎
 mūrdhalābhī na mūlacchit kṣāntilābhyanapāyagaḥ |	རྩེ་མོ་ཐོབ་པ་རྩ་མི་འཆད་༎ བཟོད་ཐོབ་ངན་སོང་མི་འགྲོའོ་༎
 śiṣyagotrā nnivartya dve buddhaḥ syāt trīṇyapītaraḥ || vakk_6|23 ||	གཉིས་སློབ་རིགས་ལས་བཟློག་ནས་ནི་༎ སངས་རྒྱས་སུ་འགྱུར་གཞན་གསུམ་ཡང་༎ སྟོན་དང་བསེ་རུ་བྱང་ཆུབ་བར་༎
 ābodheḥ sarvamekatra dhyānāntye śāstṛkhaḍgayoḥ |	བསམ་གཏན་མཐའ་རྟེན་གཅིག་ལ་ཀུན་༎
 prāktebhyo mokṣabhāgīyaṃ kṣipraṃ mokṣastribhirbhavaiḥ || vakk_6|24 ||	དེ་ཡི་སྔོན་དུ་ཐར་ཆ་མཐུན་༎ མྱུར་བ་སྲིད་པ་གསུམ་གྱིས་ཐར་༎
 śrutacintāmayaṃ trīṇi karmāṇi ākṣipyate nṛṣu |	ཐོས་བསམས་ལས་བྱུང་ལས་གསུམ་མོ་༎ མི་ཡི་ནང་ནས་འཕེན་པར་བྱེད་༎
 laukikebhyo 'gradharmebhyo dharmakṣāntiranāsravā || vakk_6|25 ||	འཇིག་རྟེན་པ་ཡི་ཆོས་མཆོག་ལས་༎ ཆོས་ཀྱི་བཟོད་པ་ཟག་པ་མེད་༎
 kāmaduḥkhe tato 'traiva dharmajñānaṃ tathā punaḥ |	འདོད་སྡུག་བསྔལ་ལ་དེ་ནས་ནི་༏་། དེ་ཉིད་ལ་ཆོས་ཤེས་དེ་བཞིན་༎
 śeṣe duḥkhe 'nvayakṣāntijñāne satyatraye tathā || vakk_6|26 ||	སྡུག་བསྔལ་ལྷག་ལ་རྗེས་བཟོད་ཤེས་༎ བདེན་པ་གསུམ་ལའང་དེ་བཞིན་ནོ་༎
 iti ṣoḍaśacitto 'yaṃ satyābhisamayaḥ tridhā |	དེ་ལྟར་བདེན་པ་མངོན་རྟོགས་འདི་༎ སེམས་བཅུ་དྲུག་གོ་རྣམ་གསུམ་སྟེ་༎
 darśanālambakāryākhyaḥ so 'gradharmaikabhūmikaḥ || vakk_6|27 ||	མཐོང་དམིགས་བྱ་བ་ཞེས་བྱའོ་༎ དེ་ནི་ཆོས་མཆོག་དང་ས་གཅིག་།
 kṣāntijñānānyanantarya muktimārgā yathākramam |	བཟོད་དང་ཤེས་པ་གོ་རིམས་བཞིན་༎ བར་ཆད་མེད་དང་རྣམ་གྲོལ་ལམ་༎
 adṛṣṭadṛṣṭerdṛṅgmārgastatra pañcadaśa kṣaṇāḥ || vakk_6|28 ||	དེ་ལ་སྐད་ཅིག་བཅོ་ལྔ་ནི་༎ མ་མཐོང་མཐོང་ཕྱིར་མཐོང་བའི་ལམ་༎
 mṛdutīkṣṇendriyau teṣu śraddhādharmānusāriṇau |	དབང་པོ་རྣོ་རྟུལ་དེ་དག་ཏུ་༎ དད་དང་ཆོས་ཀྱི་རྗེས་འབྲང་བ་༎
 ahīnabhāvanāheyau phalādyuapratipannakau || vakk_6|29 ||	བསྒོམས་པས་སྤང་བྱ་མ་སྤངས་ན་༎ འབྲས་བུ་དང་པོ་ལ་ཞུགས་པ༎
 yāvat pañcaprakāraghnau dvītīye 'rvāṅnavakṣayāt |	རྣམ་ལྔའི་བར་བཅོམ་གཉིས་པ་ལ་༎ དགུ་པ་ཚུན་ཆད་ཟད་པ་ཡིན་༎
 kāmādviraktāvūrdhvaṃ vā tṛtīyapratipannakau || vakk_6|30 ||	འདོད་པའམ་ཡང་ན་གོང་མ་ལས་༎ ཆགས་བྲལ་གསུམ་པ་ལ་ཞུགས་པ་།
 ṣoḍaśe tu phalasthau tau yatra yaḥ pratipannakaḥ |	གང་ཞིག་གང་ལ་ཞུགས་པ་ནི་༎ བཅུ་དྲུག་པ་ལ་དེ་འབྲས་གནས་༎
 śraddhādhimuktadṛṣṭyāptau mṛdutīkṣṇendriyau tadā || vakk_6|31 ||	དེ་ཚེ་དབང་པོ་རྣོ་རྟུལ་དག་། དད་པས་མོས་དང་མཐོང་བས་༄༢༠ཨ་༌་༎ ཐོབ་༏་འབྲས་ཐོབ་འབྲས་བུ་ཁྱད་པར་གྱི་༎
 phale phalaviśiṣṭasya lābho mārgasya nāstyataḥ |	ལམ་ཐོབ་མེད་པས་དེ་ཡི་ཕྱིར་༎ འབྲས་གནས་ཁྱད་པར་བྱ་བའི་ཕྱིར་༎
 nāprayukto viśeṣāya phalasthaḥ pratipannakaḥ || vakk_6|32 ||	མི་བརྩོན་པ་ནི་ཞུགས་མ་ཡིན་༎
 navaprakārā doṣā hi bhūmau bhūmau tathā guṇāḥ |	ས་དང་ས་ན་ཉེས་རྣམ་དགུ་༎ དེ་བཞིན་དུ་ནི་ཡོན་ཏན་རྣམས་༎
 mṛdumadhyādhimātrāṇāṃ punarmṛdvādibhedataḥ || vakk_6|33 ||	ཆུང་དང་འབྲིང་དང་ཆེ་རྣམས་ཀྱི་༎ ཆུང་ངུ་ལ་སོགས་ཐ་དད་ཕྱིར་༎
 akṣīṇabhāvanāheyaḥ phalasthaḥ saptakṛtparaḥ |	འབྲས་གནས་བསྒོམ་སྤང་བྱ་མ་ཟད་༎ རེ་ལྟར་ཐོགས་ན་ལན་བདུན་པ་༎
 tricaturvidhamuktastu dvitrijanmā kulaṃkulaḥ || vakk_6|34 ||	རྣམ་གསུམ་རྣམ་བཞི་ལས་གྲོལ་བ་༎ ཚེ་གཉིས་གསུམ་དུ་རིགས་ནས་རིགས་༎
 āpañcamaprakāraghno dvitīyapratipannakaḥ |	རྣམས་པ་ལྔ་ཡི་བར་བཅོམ་པ་༎ གཉིས་པ་ལ་ནི་ཞུགས་པའང་ཡིན་༎
 kṣīṇaṣaṣṭhaprakārastu sakṛdāgāmyasau punaḥ || vakk_6|35 ||	རྣམ་པ་དྲུག་པ་ཟད་གྱུར་པ་༎ དེ་ནི་ལན་ཅིག་ཕྱིར་འོང་བ་༎
 kṣīṇasaptāṣṭadoṣāṃśa ekajanmaikavīcikaḥ |	ཉེས་ཆ་བདུན་དང་བརྒྱད་ཟད་པ་༎
 tṛtīyapratipannaśca so 'nāgāmi navakṣayāt || vakk_6|36 ||	ཚེ་གཅིག་བར་ཆད་གཅིག་པ་དང་༎ གསུམ་པ་ལ་ནི་ཞུགས་པའང་ཡིན་༎ དེ་དགུ་ཟད་པས་ཕྱིར་མི་འོང་༎
 so 'ntarotpannasaṃskārāsaṃskāraparinirvṛtiḥ |	དེ་ནི་བར་སྐྱེས་འདུ་བྱེད་དང་༎ འདུ་བྱེད་མེད་ཡོངས་མྱ་ངན་འདའ་༎
 ūrdhvastrotāśca sa dhyāne vyavakīrṇo 'kaniṣṭhagaḥ || vakk_6|37 ||	གོང་དུ་འཕོ་བ་རྣམས་དེ་ནི་༎ བསམ་གཏན་སྤེལ་ན་འོག་མིན་འགྲོ་༎ དེ་འཕར་ཕྱེད་འཕར་ཐམས་ཅད་དུ་༎
 sa pluto 'rdhaplutaḥ sarvacyutaśca anyo bhavāgragaḥ |	འཆི་འཕོ་གཞན་སྲིད་རྩེ་མོར་འགྲོ་༎
 ārūpyagaścaturdhānyaḥ iha nirvāpako 'paraḥ || vakk_6|38 ||	གཞན་ནི་གཟུགས་མེད་འགྲོ་རྣམ་བཞི་༎ གཞན་ནི་འདི་ལ་མྱ་ངན་འདའ་༎
 punastrīṃstrividhān kṛtvā nava rūpopagāḥ smṛtāḥ |	གསུམ་ལ་ཡང་རྣམ་གསུམ་ཕྱེ་ནས་༎ གཟུགས་སུ་ཉེ་འགྲོ་དགུར་བཤད་དོ་༎
 tadviśeṣaḥ punaḥ karmakleśendriyaviśeṣataḥ || vakk_6|39 ||	དེ་དག་གི་ནི་ཁྱད་པར་རྣམས་༎ ལས་དབང་ཉོན་མོངས་བྱེ་བྲག་ལས་༎
 ūrdhvastroturabhedena sapta sadgatayo matāḥ |	གོང་དུ་འཕོ་བ་མ་ཕྱེ་བར་༎ དམ་པའི་འགྲོ་བ་བདུན་དུ་འདོད་༎
 sadasadvṛttyavṛttibhyāṃ gatāpratyāgateśca tāḥ || vakk_6|40 ||	།
 na parāvṛttajanmāryaḥ kāme dhātvantaropagaḥ |	འདོད་པར་ཚེ་ཡོངས་གྱུར་པའི་འཕགས་༎ ཁམས་གཞན་དུ་ནི་འགྲོ་བ་མེད་༎
 sa cordhvajaśca naivākṣasaṃcāraparihāṇibhāk || vakk_6|41 ||	དེ་དང་གོང་མར་སྐྱེས་པ་ནི་༎ ཡོངས་ཉམས་དབང་པོ་འཕོ་མི་སྟེན་༎
 ākīryate caturtha prāk niṣpatti kṣaṇamiśraṇāt |	དང་པོ་བཞི་པ་སྤེལ་བར་བྱེད་༎ སྐད་ཅིག་མ་ནི་བསྲེས་པས་གྲུབ་༎
 upapattivihārārtha kleśabhīrutayāpi ca || vakk_6|42 ||	སྐྱེ་དང་གནས་པར་བྱ་ཕྱིར་དང་༎ ཉོན་མོངས་པས་ནི་འཇིགས་ཕྱིར་ཡང་༎ དེ་ནི་རྣམ་པ་ལྔ་ཡི་ཕྱིར་༎
 tatpāñcavidhyātpañcaiva śuddhāvāsopapattayaḥ |	གནས་གཙང་སྐྱེ་བ་ལྔ་ཁོ་ན་༎
 nirodhalābhyanāgāmī kāyasākṣī punarmataḥ || vakk_6|43 ||	འགོག་པ་ཐོབ་པའི་ཕྱིར་མི་འོང་༎ ལུས་ཀྱིས་མངོན་སུམ་བྱེད་པར་འདོད་༎
 ābhavāgrāṣṭabhāgakṣidarhattve pratipannakaḥ |	སྲིད་རྩེའི་བར་ཆ་བརྒྱད་ཟད་པ་༎ དགྲ་བཅོམ་ཉིད་ལ་ཞུགས་པ་ཡིན་༎
 navamasyāpyānantaryapathe vajropamaśca saḥ || vakk_6|44 ||	དགུ་པའི་བར་ཆད་མེད་ལམ་ཡང་༎ དེ་ནི་རྡོ་རྗེ་ལྟ་བུ་ཡིན་༎
 tatkṣayāptyā kṣayajñānaṃ āśaikṣo 'rhannasau tadā |	དེ་ཟད་ཐོབ་དང་ཟད་པ་ཤེས་༎ དེ་ཚེ་དེ་མི་སློབ་དགྲ་བཅོམ་༎
 lokottareṇa vairāgyaṃ bhavāgrāt anyato dvidhā || vakk_6|45 ||	འཇིག་རྟེན་༄༢༠བ་འདས་ཀྱིས་སྲིད་རྩེ་ལས་༎ ཆགས་འབྲལ་གཞན་ལས་རྣམ་པ་གཉིས་༎
 laukikenāryavairāgye visaṃyogāptayo dvidhā |	འཇིག་རྟེན་པ་ཡིས་ཆགས་བྲལ་བའི་༎ འཕགས་ལ་བྲལ་བའི་ཐོབ་རྣམ་གཉིས་༎ ཁ་ཅིག་འཇིག་རྟེན་འདས་ཀྱིས་ཀྱང་༎
 lokottareṇa cetyeke tyakte kleśāsamanvayāt || vakk_6|46 ||	བཏང་ལ་ཉོན་མོངས་མི་ལྡན་ཕྱིར་༎
 bhavāgrādhavimuktordhvajātavattvasamanvayaḥ |	སྲིད་རྩེའི་ཕྱེད་ལས་རྣམ་གྲོལ་དང༎ གོང་དུ་སྐྱེས་པ་བཞིན་མི་ལྡན་༎
 anāsraveṇa vairāgyamanāgāmyena sarvataḥ || vakk_6|47 ||	ཟག་མེད་མི་ལྕོགས་མེད་པ་ཡིས་༎ ཐམས་ཅད་ལས་ནི་འདོད་ཆགས་འབྲལ་༎
 dhyānātsāmantakādvāntyo mukti mārgastribhūjaye |	ས་གསུམ་རྒྱལ་ལ་བསམ་གཏན་ནམ་༎ ཉེར་བསྡོགས་ལས་མཐའི་རྣམ་གྲོལ་ལམ་༎
 nordhvaṃ sāmantakāt āryairaṣṭābhiḥ svordhvabhūjayaḥ || vakk_6|48 ||	གོང་མའི་ཉེར་བསྡོགས་ལས་མིན་འཕགས་༎ བརྒྱད་ཀྱིས་རང་གོང་ས་ལས་རྒྱལ་༎
 vimuktyānantaryapathā laukikāstu yathākramam |	འཇིག་རྟེན་པ་ཡི་རྣམ་གྲོལ་དང་༎ བར་ཆད་མེད་ལམ་གོ་རིམས་བཞིན་༎
 śāntādyudārādyākārāḥ uttarādharagocarāḥ || vakk_6|49 ||	ཞི་སོགས་རགས་སོགས་རྣམ་པ་ཅན་༎ གོང་དང་འོག་མའི་སྤྱོད་ཡུལ་ཅན་༎
 yadyakopyaḥ kṣayajñānādanutpādamatiḥ na cet |	གལ་ཏེ་མི་ག-ཡོའི་ཟད་ཤེས་ལས་༎ མི་སྐྱེའི་བློ་གྲོས་གལ་ཏེ་མིན་༎
 kṣayajñānamaśaikṣo vā dṛṣṭiḥ sarvasya sārhataḥ || vakk_6|50 ||	ཟད་པ་ཤེས་སམ་མི་སློབ་ལྟ་༎ དེ་ནི་དགྲ་བཅོམ་ཐམས་ཅད་ལ་༎
 śrāmaṇyamamalo mārgaḥ saṃskṛtāsaṃskṛtaṃ phalam |	དགེ་སྦྱོང་ཚུལ་ནི་དྲི་མེད་ལམ་༎ འབྲས་བུ་འདུས་བྱས་འདུས་མ་བྱས་༎
 ekānnavatistāni muktimārgāḥ saha kṣayaiḥ || vakk_6|51 ||	དེ་དག་བརྒྱད་ཅུ་རྩ་དགུའོ་༎ གྲོལ་ལམ་ཟད་པ་རྣམས་དང་བཅས་༎
 catuṣphalavyavasthā tu pañcakāraṇasaṃbhavāt |	འབྲས་བུ་བཞིར་རྣམས་གཞག་པ་ནི་༎ རྒྱུ་ལྔ་དག་ནི་སྲིད་ཕྱིར་རོ་༎
 pūrvatyāgo 'nyamārgāptiḥ kṣayasaṃkalanaṃ phale || vakk_6|52 || jñānāṣṭakasya lābho 'tha ṣoḍaśākārabhāvanā |	འབྲས་ལ་སྔོན་ལམ་བཏང་བ་དང་༎ གཞན་ཐོབ་པ་དང་ཟད་བསྡོམས་དང་༎ ཤེས་པ་བརྒྱད་ཚན་ཐོབ་པ་དང་༎ རྣམ་པ་བཅུ་དྲུག་ཐོབ་པའོ་༎
 laukikāptaṃ tu miśratvānāsravāptiḥ dhṛteḥ phalam || vakk_6|53 ||	འཇིག་རྟེན་པ་ཡིས་ཐོབ་འབྲས་ནི་༎ བསྲེས་དང་ཟད་མེད་ཐོབ་འཛིན་ཕྱིར་༎
 brāhmaṇyaṃ brahmacakraṃ ca tadeva brahmavartanāt |	དེ་ཉིད་ཚངས་ཚུལ་ཚངས་པ་ཡི་༎ འཁོར་ལོ་ཚངས་པས་བསྐོར་ཕྱིར་རོ་༎
 dharmacakraṃ tu dṛṅmārgaḥ āśugatvādyarādibhiḥ || vakk_6|54 ||	ཆོས་ཀྱི་འཁོར་ལོ་མཐོང་བའི་ལམ་༎ མྱུར་བར་འགྲོ་སོགས་རྩིབས་སོགས་ཀྱིས་༎
 kāme trayāptiḥ antyasya triṣu nordhva hi dṛkpathaḥ |	འདོད་པར་གསུམ་འཐོབ་ཐ་མ་ནི་༎ གསུམ་དུའོ་གོང་ན་མཐོང་ལམ་མེད་༎
 asaṃvegādiha vidhā tatra niṣṭheti cāgamāt || vakk_6|55 ||	མི་སྐྱོ་ལུང་ལས་འདིར་རྩོམ་ཞིང་༎ དེར་མཐར་ཕྱིན་ཅེས་འབྱུང་ཕྱིར་རོ་༎
 ṣaḍarhanto matāḥ teṣāṃ pañca śraddhādhimuktijāḥ |	དགྲ་བཅོམ་དྲུག་འདོད་དེ་དག་ལས་༎ ལྔ་ནི་དད་པས་མོས་ལས་སྐྱེས་༎ དེ་དག་རྣམ་གྲོལ་དུས་དང་སྦྱོར་༎
 vimuktiḥ sāmayikyeṣām akopyākopyadharmaṇaḥ || vakk_6|56 ||	མི་ག-ཡོའི་ཆོས་ཅན་མི་ག-ཡོ་བ་༎
 ato 'samayamukto 'sau dṛṣṭiprāptānvayaśca saḥ |	དེ་ཕྱིར་དེ་དུས་མི་སྦྱོར་གྲོལ་༎ དེ་ནི་མཐོང་ཐོབ་རྒྱུ་ལས་བྱུང་༎
 tadgotrā āditaḥ kecitkeciduttāpanāgatāḥ || vakk_6|57 ||	ཁ་ཅིག་དང་པོ་ནས་དེའི་རིགས་༎ ཁ་ཅིག་སྦྱངས་པ་ལས་གྱུར་ཏོ་༎ བཞི་ནི་རིགས་ལས་ལྔ་འབྲས་ལ་༎
 gotrāccaturṇāṃ pañcānāṃ phalāddhāniḥ na pūrvakāt |	ཉམས་འགྱུར་དང་པོ་ལས་མ་༄༢༡ཨ་༌་༎
 śaikṣānāryāśca ṣaḍgotrāḥ saṃcāro nāsti darśane || vakk_6|58 ||	ཡིན་༏་། སློབ་དང་འཕགས་མིན་རིགས་དྲུག་ལྡན་༎ མཐོང་བ་ལ་ནི་འཕོ་བ་མེད་༎
 parihāṇistridhā jñeyā prāptāprāptopabhogataḥ |	ཐོབ་དང་མ་ཐོབ་ཉེར་སྤྱད་ལས་༎ ཡོངས་ཉམས་རྣམ་པ་གསུམ་ཤེས་བྱ་༎ སྟོན་ལ་ཐ་མ་མི་ག-ཡོ་ལ་༎
 antyā śāsturakopyasya madhyā cānyasya tu tridhā || vakk_6|59 ||	བར་མའང་གཞན་ལ་རྣམ་གསུམ་མོ་༎ འབྲས་ལས་ཉམས་པ་འཆི་བ་མེད་༎
 mriyate na phalabhraṣṭaḥ tadakārya karoti na |	བྱ་བ་མ་ཡིན་དེ་མི་བྱེད་༎
 vimuktyānantaryapathā navākopye atisevanāt || vakk_6|60 ||	མི་ག-ཡོ་རྣམ་གྲོལ་བར་ཆད་མེད་༎ ལམ་དགུའོ་ཤིན་ཏུ་བསྟེན་ཕྱིར་རོ་༎
 dṛṣṭayāptatāyāmekaikaḥ anāsravāḥ nṛṣu vardhanam |	མཐོང་བས་ཐོབ་ལ་རེ་རེའོ་༎ ཟག་མེད་མི་ཡི་ནང་དུ་འཕེལ་༎
 aśaikṣo nava niśritya bhūmīḥ śaikṣastu ṣaṭ yataḥ || vakk_6|61 ||	མི་སློབ་ས་དགུ་ལ་བསྟེན་ཏེ་༎ སློབ་པ་དྲུག་ལ་གང་གི་ཕྱིར་༎
 saviśeṣaṃ phalaṃ tyaktvā phalamāpnoti vardhayan |	འཕེལ་བ་འབྲས་བུ་ཁྱད་པར་ཅན་༎ བཏང་སྟེ་འབྲས་བུ་ཐོབ་པར་འགྱུར་༎
 dvau buddhau śrāvakāḥ sapta navaite navadhendriyāḥ || vakk_6|62 ||	སངས་རྒྱས་གཉིས་དང་ཉན་ཐོས་བདུན་༎ དེ་དགུ་དབང་པོ་རྣམ་དགུ་ཅན་༎
 prayogākṣasamāpattivimuktyubhayataḥ kṛtāḥ | pudgalāḥ sapta ṣaṭ tvete dvau dvau mārgatraye yataḥ || vakk_6|63 ||	གང་ཟག་བདུན་པོ་སྦྱོར་བ་དང་༎ དབང་པོ་སྙོམས་འཇུག་རྣམ་གྲོལ་དང་༎ གཉིས་ཀས་བྱས་པའོ་དེ་དག་དྲུག་།འདི་ལྟར་ལམ་གསུམ་ལ་གཉིས་གཉིས་༎
 nirodhalābhyubhayatovimuktaḥ prajñayetaraḥ |	འགོག་ཐོབ་གཉིས་ཀ་ལས་རྣམ་གྲོལ་༎ ཤེས་རབ་ཀྱིས་ནི་ཅིག་ཤོས་སོ་༎
 samāpattīndriyaphalaiḥ pūrṇaḥ śaikṣo 'bhidhīyate || vakk_6|64 ||	སྙོམས་འཇུག་དབང་པོ་འབྲས་རྣམས་ཀྱིས་༎ སློབ་པ་ཡོངས་རྫོགས་ཞེས་བྱའོ་༎
 aśaikṣaparipūrṇatvaṃ dvābhyām mārgaḥ samāsataḥ |	གཉིས་ཀྱིས་མི་སློབ་ཡོངས་སུ་རྫོགས་༎ མདོར་ན་ལམ་ནི་རྣམ་བཞི་སྟེ་༎
 viśeṣamuktyānantaryaprayogākhya ścaturvidhaḥ || vakk_6|65 ||	ཁྱད་པར་ཅན་དང་རྣམ་གྲོལ་དང་༎ བར་ཆད་མེད་དང་སྦྱོར་ཞེས་བྱ་༎
 dhyāneṣu mārgaḥ pratipatsukhā duḥkhānyabhūmiṣu |	བསམ་གཏན་དག་གི་ལམ་རྣམས་སླ་༎ ས་གཞན་དག་གི་དཀའ་བ་ཡིན་༎
 dhanyābhijñā mṛdumateḥ kṣiprābhijñetarasya tu || vakk_6|66 ||	བློ་རྟུལ་མངོན་ཤེས་བུལ་བ་སྟེ་༎ ཅིག་ཤོས་ཀྱི་ནི་མངོན་ཤེས་མྱུར་༎
 anutpādakṣayajñāne bodhiḥ tādanulomyataḥ |	ཟད་དང་མི་སྐྱེ་ཤེས་པ་ནི་༎ བྱང་ཆུབ་དེ་དང་མཐུན་ཉིད་ཕྱིར་༎
 saptatriṃśattu tatpakṣyāḥ nāmato dravyato daśa || vakk_6|67 ||	སུམ་ཅུ་རྩ་བདུན་དེའི་ཕྱོགས་མཐུན་༎ མིང་གི་སྒོ་ནས་རྫས་སུ་བཅུ་༎
 śraddhā vīryaṃ smṛtiḥ prajñā samādhiḥ prītyupekṣaṇe |	དད་དང་བརྩོན་འགྲུས་དྲན་པ་དང་༎ ཤེས་རབ་ཏིང་འཛིན་བཏང་སྙོམས་དགའ་༎
 praśrabdhiśīlasaṃkalpāḥ prajñā hi smṛtyupasthitiḥ || vakk_6|68 ||	རྟོག་དང་ཚུལ་ཁྲིམས་ཤིན་ཏུ་སྦྱངས་༎ དྲན་པ་ཉེར་གཞག་ཤེས་རབ་སྟེ་༎
 vīryaṃ samyakprahāṇākhyamṛddhipādāḥ samādhayaḥ |	བརྩོན་འགྲུས་ཡང་དག་འཇོག་ཅེས་བྱ་༎ རྫུ་འཕྲུལ་རྐང་པ་ཏིང་འཛིན་ཏོ་༎
 pradhānagrahaṇaṃ sarve guṇāḥ prāyogikāstu te || vakk_6|69 ||	གཙོ་བོ་སྨོས་པ་དེ་དག་ནི་༎ སྦྱོར་བྱུང་ཡོན་ཏན་ཀུན་ཀྱང་ཡིན་༎ སྡེ་ཚན་བདུན་ནི་གོ་རིམས་བཞིན་༎
 ādikarmikanirvedhabhāgīyeṣu prabhāvitāḥ |	ལས་ནི་དང་པོ་པ་དག་དང་༎ ངེས་འབྱེད་ཆ་མཐུན་རྣམས་དང་ནི་༎
 bhāvane darśane caiva sapta vargā yathākramam || vakk_6|70 ||	བསྒོམ་དང་མཐོང་ལ་རབ་ཏུ་ཕྱེ་༎
 anāsravāṇi bodhyaṅgamārgāṅgāni dvidhetare |	།
 sakalāḥ prathame dhyāne anāgamye prītivarjitāḥ || vakk_6|71 ||	བསམ་གཏན་དང་པོ་ན་ཐམས་ཅད་༎ མི་ལྕོགས་མེད་ན་དགའ་མ་གཏོགས་༎
 dvitīye 'nyatra saṃkalpāt dvayostaddvayavarjitāḥ |	གཉིས་པ་ན་༄༢༡བ་ནི་རྟོག་མ་གཏོགས་༎ གཉིས་ན་དེ་གཉིས་མ་གཏོགས་པ་༎
 dhyānāntare ca śīlāṅgaistābhyāṃ ca triṣvarūpiṣu || vakk_6|72 ||	བསམ་གཏན་བར་ནའང་གཟུགས་མེད་པ་༎ གསུམ་ནའང་དེ་དང་ཚུལ་ཡན་ལག་། 
 kāmadhātau bhavāgre ca bodhimārgāṅgavarjitāḥ |	བྱང་ཆུབ་དང་ནི་ལམ་ཡན་ལག་། མ་གཏོགས་འདོད་ཁམས་སྲིད་རྩེ་ན་༎ 
 trisatyadarśane śīladharmāvetyaprasādayoḥ || vakk_6|73 || lābho mārgābhisamaye buddhatatsaṃghayorapi |	བདེན་གསུམ་མཐོང་ན་ཚུལ་ཁྲིམས་དང་༎ ཆོས་ལ་ཤེས་ནས་དད་པ་འཐོབ་༏་། ལམ་མངོན་རྟོགས་ན་སངས་རྒྱས་དང་༎ དེ་ཡི་དགེ་འདུན་དག་ལ་ཡང་༎
 dharmaḥ satyatrayaṃ bodhisattvapratyekabuddhayoḥ || vakk_6|74 ||	ཆོས་བདེན་གསུམ་དང་རང་སངས་རྒྱས་༎ བྱང་ཆུབ་སེམས་དཔའི་ལམ་ཡིན་ནོ་༎
 mārgaśca dravyatastu dve śraddhā śīlaṃ ca nirmalāḥ |	རྫས་སུ་གཉིས་ཏེ་དད་པ་དང་༎ ཚུལ་ཁྲིམས་དྲི་མ་མེད་པ་ཡིན་༎
 noktā vimuktiḥ śaikṣāṅgaṃ baddhatvāt sā punardvidhā || vakk_6|75 ||	བཅིངས་ཕྱིར་སློབ་པའི་ཡན་ལག་ཏུ་༎ རྣམ་གྲོལ་མ་བཤད་དེ་རྣམ་གཉིས་༎
 asaṃskṛtā kleśahānamadhimuktastu saṃskṛtā |	ཉོན་མོངས་བཅོམ་པ་འདུས་མ་བྱས་༎ མོས་པ་འདུས་བྱས་ཡན་ལག་ནི་༎
 sāṅgaḥ saiva vimuktī dve jñānaṃ bodhiryathoditā || vakk_6|76 ||	དེ་ཡིན་དེ་ཉིད་རྣམ་གྲོལ་གཉིས་༎ བྱང་ཆུབ་ཇི་སྐད་བཤད་ཅེས་པ་༎
 vimucyate jāyamānasaśaikṣaṃ cittamāvṛteḥ |	མི་སློབ་སེམས་ནི་སྐྱེ་འགྱུར་བ་༎ སྒྲིབ་པ་ལས་ནི་རྣམ་གྲོལ་འགྱུར་༎
 nirudhyamāno mārgastu prajahāti tadāvṛtim || vakk_6|77 ||	འགག་པར་འགྱུར་བའི་ལམ་གྱིས་ནི་༎ དེ་ཡི་སྒྲིབ་པ་རབ་ཏུ་སྤོང་༎
 asaṃskṛtaiva dhātvākhyā virāgo rāgasaṃkṣayaḥ |	འདུས་མ་བྱས་ཉིད་ཁམས་ཞེས་བྱ་༎ འདོད་ཆགས་ཀུན་ཟད་འདོད་ཆགས་བྲལ་༎
 prahāṇadhāturanyeṣāṃ nirodhākhyastu vastunaḥ || vakk_6|78 ||	སྤངས་པའི་ཁམས་ནི་གཞན་དག་གོ་༎ འགོག་པའི་ཁམས་ཞེས་བྱ་བ་གཞི་༎
 nirvidyate duḥkhahetukṣāntijñānaiḥ virajyate |	སྡུག་བསྔལ་རྒྱུ་བཟོད་ཤེས་རྣམས་ཀྱིས་༎ ཡིད་འབྱུང་གང་གིས་སྤོང་འགྱུར་བ་༎ ཀུན་གྱི་འདོད་ཆགས་འབྲལ་བར་འགྱུར་༎
 sarvairjahāti yaiḥ evaṃ catuṣkoṭikasaṃbhavaḥ || vakk_6|79 ||	དེ་ལྟར་ན་ནི་མུ་བཞི་སྲིད་༎
 abhidharmakośe mārgapudgalanirdeśo nāma ṣaṣṭhaṃ kośasthānaṃ samāptamiti || saptamaṃ kośasthānam namo buddhāya ||	ཆོས་མངོན་པའི་མཛོད་ཀྱི་ཚིག་ལེའུར་བྱས་པ་ལས་༎ ལམ་དང་གང་ཟག་བསྟན་པ་ཞེས་བྱ་བ་སྟེ་གནས་དྲུག་པའོ་།
 nāmalā kṣāntayo jñānaṃ kṣayānutpādadhīrna dak |	༎ ། དྲི་མེད་བཟོད་རྣམས་ཤེས་པ་མིན་༎ ཟད་དང་མི་སྐྱེའི་བློ་ལྟ་མིན་༎
 tadanyobhayathāryā dhīḥ anyā jñānaṃ dṛśaśca ṣaṭ || vakk_7|1 ||	དེ་ལས་གཞན་འཕགས་བློ་གཉིས་ཀ་༏་། གཞན་ཤེས་དྲུག་ནི་ལྟ་བའང་ཡིན་༎
 sāsravānāsravaṃ jñānaṃ ādyaṃ saṃvṛtijñāpakam |	ཤེས་པ་ཟག་བཅས་ཟག་པ་མེད་༎ དང་པོ་ཀུན་རྫོབ་ཅེས་བྱའོ་༎
 anāsravaṃ dvidhā dharmajñānamanvayameva ca || vakk_7|2 ||	ཟག་མེད་རྣམ་གཉིས་ཆོས་དང་ནི་༎ རྗེས་སུ་ཤེས་པ་ཁོ་ན་ཡིན་༎
 sāṃvṛtaṃ sarvaviṣayaṃ kāmaduḥkhādigocaram |	ཀུན་རྫོབ་ཡུལ་ནི་ཐམས་ཅད་དོ་༎
 dharmākhyam anvayajñānaṃ tūrdhvaduḥkhādigocaram || vakk_7|3 ||	ཆོས་ཞེས་བྱ་བའི་སྤྱོད་ཡུལ་ནི་༎ འདོད་སྡུག་བསྔལ་སོགས་རྗེས་ཤེས་པའི་༎ སྤྱོད་ཡུལ་གོང་མའི་སྡུག་བསྔལ་སོགས་༎
 te eva satyabhedena catvāri ete caturvidhe |	དེ་དག་ཉིད་བདེན་བྱེ་བྲག་གིས་༎ བཞི་སྟེ་རྣམ་བཞི་དེ་དག་ནི་༎
 anutpādakṣayajñāne te punaḥ prathamodite || vakk_7|4 ||	མི་སྐྱེ་བ་དང་ཟད་པ་ཤེས་༎ དེ་གཉིས་དང་པོ་སྐྱེས་པ་ནི་༎
 duḥkhahetvanvayajñāne caturbhyaḥ paracittavit |	སྡུག་བསྔལ་རྒྱུ་རྗེས་ཤེས་པ་ཡིན་༎ བཞི་ལས་ཕ་རོལ་སེམས་རིག་པ་༎
 bhūmyakṣapudgalotkrāntaṃ naṣṭājātaṃ na vetti tat || vakk_7|5 ||	དེས་ནི་ས་དབང་གང་ཟག་འདས་༎ ཞིག་དང་མ་སྐྱེས་༄༢༢ཨ་༌་༎ མི་རིག་གོ་༎
 ta dharmānvayadhīpakṣyamanyo 'nyaṃ darśanakṣaṇau |	ཆོས་རྗེས་བློ་ཕྱོགས་ཕན་ཚུན་མིན་༎ ཉན་ཐོས་མཐོང་བའི་སྐད་ཅིག་གཉིས་༎ རིག་སྟེ་བསེ་རུ་ལྟ་བུས་གསུམ་༎
 śrāvako vetti khaṅgastrīn sarvānbuddho 'prayogataḥ || vakk_7|6 ||	སངས་རྒྱས་སྦྱོར་བ་མེད་པར་ཀུན་༎
 kṣayajñānaṃ hi satyeṣu parijñātādiniścayaḥ |	ཟད་པར་ཤེས་པ་བདེན་རྣམས་ལ་༎ ཡོངས་ཤེས་ལ་སོགས་པ་ངེས་པའོ་༎
 na parijñeyamityādiranutpādamatirmatā || vakk_7|7 ||	ཡོངས་ཤེས་བྱར་མེད་ཅེས་ལ་སོགས་༎ མི་སྐྱེ་བ་ཡི་བློ་འདོད་དོ་༎
 svabhāvapratipakṣābhyāmākārākāragocarāt | prayogakṛtakṛtyatvahetūpacayato daśa || vakk_7|8 ||	རང་བཞིན་དང་ནི་གཉེན་པོ་དང་༎ རྣམ་པ་རྣམ་པ་སྤྱོད་ཡུལ་དང་༎ སྦྱོར་དང་བྱ་བ་བྱས་ཉིད་དང་༎ རྒྱུ་རྒྱས་པ་ལས་བཅུ་ཡིན་ནོ་༎
 dharmajñānanirodhe yanmārge vā bhāvanāpathe |	བསྒོམ་པའི་ལམ་ལ་འགོག་པའམ་༎ ལམ་ལ་ཆོས་ཤེས་གང་ཡིན་དེ་༎
 tridhātupratipakṣastat kāmadhāto 'stu nānvayam || vakk_7|9 ||	ཁམས་གསུམ་གྱི་ནི་གཉེན་པོ་ཡིན་༎ འདོད་པའི་ཁམས་ཀྱི་རྗེས་མ་ཡིན་༎
 dharmajñānānvayajñānaṃ ṣoḍaśākāram anyathā |	ཆོས་ཤེས་པ་དང་རྗེས་སུ་ཤེས་༎ རྣམ་པ་བཅུ་དྲུག་ཀུན་རྫོབ་ནི་༎
 tathā ca sāṃvṛtaṃ svaiḥ svaiḥ satyākāraiścatuṣṭayam || vakk_7|10 ||	།
 tathā paramanojñānaṃ nirmalaṃ samalaṃ punaḥ |	ཕ་རོལ་ཡིད་ཤེས་དྲི་མེད་ཀྱང་༎ དེ་བཞིན་དྲི་མ་དང་བཅས་ནི་༎
 jñeyasvalakṣaṇākāraṃ ekaikadravyagocaram || vakk_7|11 ||	ཤེས་བྱ་རང་གི་མཚན་ཉིད་རྣམ་༎ རྫས་རེ་རེ་ཞིག་སྤྱོད་ཡུལ་ལོ་༎
 śeṣe caturdaśākāre śūnyānātmavivarjite |	ལྷག་མ་རྣམ་པ་བཅུ་བཞི་ཅན་༎ སྟོང་དང་བདག་མེད་མ་གཏོགས་སོ་༎
 nāmalaḥ ṣoḍaśabhyo 'nya ākāraḥ anye 'sti śāstrataḥ || vakk_7|12 ||	དྲི་མེད་བཅུ་དྲུག་གཞན་རྣམ་མེད་༎ གཞན་ཡོད་ཅེས་པ་བསྟན་བཅོས་ལས་༎
 dravyataḥ ṣoḍaśākārāḥ prajñākāraḥ tayā saha |	རྫས་སུ་རྣམ་པ་བཅུ་དྲུག་གོ་༎ རྣམ་པ་ཤེས་རབ་དང་བཅས་པའི་༎
 ākārayanti sālambāḥ sarvamākāryate tu sat || vakk_7|13 ||	དམིགས་དང་བཅས་པས་འཛིན་པར་བྱེད་༎ ཡོད་པ་ཐམས་ཅད་གཟུང་བྱ་ཡིན་༎
 tridhādyaṃ kuśalānyanyāni ādyaṃ sarvāsu bhūmiṣu |	།
 dharmākhyaṃ ṣaṭsu navasu tvanvayākhyaṃ tathaiva ṣaṭ || vakk_7|14 ||	དྲུག་ན་ཆོས་ཤེས་བྱ་བར་དགུ་༎ རྗེས་ཤེས་བྱ་བ་དེ་བཞིན་དྲུག་། 
 dhyāneṣvanyamanojñānaṃ kāmarūpāśrayaṃ ca tat |	གཞན་ཡིད་ཤེས་པ་བསམ་གཏན་བཞི་༎ དེ་ནི་འདོད་དང་གཟུགས་རྟེན་ཅན་༎
 kāmāśrayaṃ tu dharmākhyam anyattraidhātukāśrayam || vakk_7|15 ||	ཆོས་ཤེས་བྱ་བ་འདོད་རྟེན་ཅན་༎ ཁམས་གསུམ་པ་ཡི་རྟེན་ཅན་གཞན་༎
 smṛtyupasthānamekaṃ dhīrnirodhe paracittadhīḥ |	འགོག་བློ་དྲན་པ་ཉེར་གཞག་པ་༎ གཅིག་སྟེ་ཕ་རོལ་སེམས་བློ་ནི་༎
 trīṇi catvāri śeṣāṇi dharmadhīgocaro nava || vakk_7|16 ||	གསུམ་མོ་ལྷག་མ་བཞི་ཡིན་ནོ་༎ ཆོས་བློའི་སྤྱོད་ཡུལ་དགུ་ཡིན་ནོ་༎
 nava mārgānvayadhiyoḥ duḥkhahetudhiyordvayam |	ལམ་རྗེས་བློ་ཡི་དགུ་ཡིན་ནོ་༎ སྡུག་བསྔལ་རྒྱུ་བློའི་གཉིས་ཡིན་ནོ་༎
 caturṇāṃ daśa naikasya yojyā dharmāḥ punardaśa || vakk_7|17 ||	བཞི་ཡི་བཅུ་ཡིན་གཅིག་གི་མིན་༎ ཆོས་བཅུ་དག་ནི་སྦྱར་བར་བྱ་༎
 traidhātukāmalā dharmā akṛtāśca dvidhā dvidhā |	ཁམས་གསུམ་པ་དང་དྲི་མེད་ཆོས་༎ འདུས་མ་བྱས་རྣམས་གཉིས་གཉིས་སོ་༎
 sāṃvṛtaṃ svakalāpānyadekaṃ vidyādanātmataḥ || vakk_7|18 ||	ཀུན་རྫོབ་གཅིག་པུས་རང་ཚོགས་ལས་༎ གཞན་ནི་བདག་མེད་ཉིད་རིག་འགྱུར་༎
 ekajñānānvito rāgī prathame 'nāsravakṣaṇe |	ཟག་མེད་སྐད་ཅིག་དང་པོ་ལ་༎ ཆགས་ཅན་ཤེས་པ་གཅིག་དང་ལྡན་༎
 dvitīye tribhiḥ ūrdhvastu caturṣvekaikavṛddhimān || vakk_7|19 ||	གཉིས་པ་ལ་གསུམ་༄༢༢བ་ཡན་ཆད་ནི་༎ བཞི་ལ་རེ་རེ་འཕེལ་དང་ལྡན་༎
 yathotpannāni bhāvyante kṣāntijñānāni darśane |	མཐོང་བའི་ལམ་ལ་བཟོད་པ་དང་༎ ཤེས་པ་ཇི་ལྟར་སྐྱེས་པ་རྣམས་༎
 anāgatāni tatraiva sāṃvṛtaṃ cānvayatraye || vakk_7|20 ||	མ་འོངས་པ་འཐོབ་དེ་ཉིད་ལ་༎ རྗེས་གསུམ་ལ་ནི་ཀུན་རྫོབ་ཀྱང་༎ དེ་ཕྱིར་མངོན་རྟོགས་མཐའ་ཞེས་བྱ་༎
 ato 'bhisamayāntyākhyaṃ tadānutpattidharmakam |	དེ་ནི་མི་སྐྱེའི་ཆོས་ཅན་ཡིན་༎
 svādhobhūmi nirodhe 'ntyaṃ svasatyākāraṃ yātnikam || vakk_7|21 ||	རང་དང་འོག་ས་འགོག་པའི་མཐའ་༎ རང་བདེན་རྣམ་ཅན་འབད་ལས་བྱུང་༎
 ṣoḍaśe ṣaṭ sarāgasya vītarāgasya sapta tu |	ཆགས་བཅས་བཅུ་དྲུག་པ་ལ་དྲུག་།འདོད་ལས་ཆགས་དང་བྲལ་བས་བདུན་༎
 sarāgabhāvanā mārge tadūrdhvaṃ saptabhāvanā || vakk_7|22 ||	དེ་ཡི་གོང་མ་ཆགས་བཅས་ཀྱི་༎ བསྒོམ་པའི་ལམ་ལ་བདུན་འཐོབ་བོ་༎
 saptabhūmijayābhijñākopyāptyākīrṇabhāvite	ས་བདུན་ལས་རྒྱལ་མངོན་ཤེས་དང་༎ མི་ག-ཡོ་འཐོབ་དང་སྤེལ་བསྒོམ་པའི་།
 ānantaryapatheṣūrdhvaṃ muktimārgāṣṭake 'pi ca || vakk_7|23 ||	བར་ཆད་མེད་པའི་ལམ་དག་དང་༎ གོང་མའི་གྲོལ་བའི་ལམ་བརྒྱད་ལའང་༎
 śaikṣottāpanamuktau vā ṣaṭ saptajñānabhāvanā |	སློབ་པ་སྦྱོང་བའི་གྲོལ་བ་ལ་༎ ཤེས་པ་དྲུག་དང་བདུན་འཐོབ་བམ་༎
 ānantaryapathe ṣaṇṇāṃ bhavāgravijaye tathā || vakk_7|24 ||	།
 navānāṃ tu kṣayajñāne akopyasya daśa bhāvanā |	ཟད་པ་ཤེས་པ་ལ་དགུའོ་༎ མི་ག-ཡོ་བས་ནི་བཅུ་འཐོབ་བོ་༎ དེར་འཕོ་གྲོལ་བའི་ཐ་མ་ལའང་༎
 tatsaṃcare 'ntyamuktau ca proktaśeṣe 'ṣṭabhāvanā || vakk_7|25 ||	བཤད་པའི་ལྷག་མ་ལ་བརྒྱད་འཐོབ་༎
 yadvairāgyāya yallābhastatra cādhaśca bhāvyate |	གང་ལས་ཆགས་བྲལ་བྱ་ཕྱིར་གང་༎ ཐོབ་པ་དེར་ཡང་འོག་མའང་འཐོབ་༎
 sāsravāśca kṣayajñāne labdhapūrvaṃ na bhāvyate || vakk_7|26 ||	ཟད་པ་ཤེས་ལ་ཟག་བཅས་ཀྱང་༎ ས་ཀུན་སྔོན་རྙེད་མི་འཐོབ་བོ་༎ རྙེད་དང་བསྟེན་ཅེས་བྱ་བ་ནི་༎
 pratilambhaniṣevākhye śubhasaṃskṛtabhāvane |	དགེ་བ་འདུས་བྱས་ཐོབ་པའོ་༎
 pratipakṣavinirdhāvabhāvane sāsravasya tu || vakk_7|27 ||	གཉེན་པོ་དང་ནི་ཐག་བསྲིང་པའི་༎ ཐོབ་པ་ཟག་དང་བཅས་པའི་ཡིན་༎
 aṣṭādaśāveṇikāstu buddhadharmā balādayaḥ |	སངས་རྒྱས་ཆོས་ནི་མ་འདྲེས་པ་༎ སྟོབས་ལ་སོགས་པ་བཅོ་བརྒྱད་དོ་༎
 sthānāsthāne daśa jñānāni aṣṭau karmaphale nava || vakk_7|28 ||	གནས་དང་གནས་མིན་ཤེས་པ་བཅུ་༎ ལས་འབྲས་ལ་བརྒྱད་བསམ་གཏན་སོགས་༎
 dhyānādyakṣādhimokṣeṣu dhātau ca pratipatsu tu |	དབང་པོ་མོས་དང་ཁམས་ལ་ནི་༎
 daśa vā saṃvṛtijñānaṃ dvayoḥ ṣaṭ daśa vā kṣaye || vakk_7|29 ||	དགུའོ་ལམ་དག་ལ་བཅུ་འམ་༏་། གཉིས་ནི་ཀུན་རྫོབ་ཤེས་པ་ཡིན་༎ ཟད་པ་དྲུག་གམ་བཅུ་ཡིན་ནོ་༎ སྔོན་གནས་འཆི་འཕོ་སྐྱེ་བའི་སྟོབས་༎
 prāṅinavisacyutotpādabaladhyāneṣu śeṣitam |	བསམ་གཏན་དག་ན་ལྷག་མ་ནི་༎
 sarvabhūmiṣu kenāsya balamavyāhataṃ yataḥ || vakk_7|30 ||	ས་རྣམས་ཀུན་ན་ཅི་ཡི་ཕྱིར་༎ འདིའི་སྟོབས་གང་ཕྱིར་ཐོགས་མི་མངའ་༎
 nārāyaṇabalaṃ kāye saṃdhiṣvanye daśādhikam |	སྐུ་ལ་སྲེད་མེད་བུ་ཡི་སྟོབས་༎ གཞན་དག་ཚིགས་ན་གླང་ཆེན་སོགས་༎
 hastyādisaptakabalam spraṣṭavyāyatanaṃ ca tat || vakk_7|31 ||	བདུན་ཅུས་བླགས་པའི་སྟོབས་ཡིན་ནོ་༎ དེ་ནི་རེག་བྱའི་སྐྱེ་མཆེད་དོ་༎
 vaiśāradyaṃ caturdhā tu yathādyadaśame bale |	མི་འཇིགས་པ་ནི་རྣམ་པ་བཞི་༎
 dvitīyasaptame caiva smṛtiprajñātmakaṃ trayam || vakk_7|32 ||	ཇི་ལྟར་སྟོབས་ནི་དང་པོ་དང་༎ བཅུ་པ་གཉིས་པ་བདུན་པ་བཞིན་༎ དྲན་དང་ཤེས་བཞིན་བདག་ཉིད་གསུམ་༎
 mahākṛpā saṃvṛtidhīḥ saṃbhārākāragocaraiḥ |	ཐུགས་རྗེ་ཆེན་པོ་ཀུན་རྫོབ་བློ་༎ ཚོགས་དང་རྣམ་པ་སྤྱོད་ཡུལ་༄༢༣ཨ་༌་༎
 samatvādādhimātryācca nānākaraṇamaṣṭadhā || vakk_7|33 ||	དང་༏་། མཉམ་པའི་ཕྱིར་དང་ཆེས་ཆེའི་ཕྱིར་༎ ཐ་དད་བྱ་བ་རྣམ་པ་བརྒྱད་༎ སངས་རྒྱས་ཐམས་ཅད་ཚོགས་དང་ནི་༎
 saṃbhāradharmakāyābhyāṃ jagataścārthacaryayā |	ཆོས་སྐུ་འགྲོ་བའི་དོན་སྤྱོད་པས་༎
 samatā sarvabuddhānāṃ nāyurjātipramāṇataḥ || vakk_7|34 ||	མཉམ་པ་ཉིད་དེ་སྐུ་ཚེ་དང་༎ རིགས་དང་སྐུ་བོང་ཚོད་ཀྱིས་མིན་༎
 śiṣyasādhāraṇā anye dharmāḥ kecit pṛthagjanaiḥ |	ཆོས་གཞན་སློབ་དང་ཐུན་མོང་ཡིན་༎ ཁ་ཅིག་སོ་སོའི་སྐྱེ་བོ་དང་༎ ཉོན་མོངས་མེད་དང་སྨོན་ནས་ཤེས་༎
 araṇāpraṇidhijñānapratisaṃvidguṇādayaḥ || vakk_7|35 ||	སོ་སོ་ཡང་དག་རིག་མངོན་སོགས་༎
 saṃvṛtijñānamaraṇā dhyāne 'ntye akopyadharmaṇaḥ |	ཉོན་མོངས་མེད་པ་ཀུན་རྫོབ་ཤེས་༎ བསམ་གཏན་མཐའ་ན་མི་ག-ཡོའི་ཆོས་༎
 nṛjā anutpannakāmāptasavastukleśagocarāḥ || vakk_7|36 ||	མིས་སྐྱེས་ཉོན་མོངས་འདོད་གཏོགས་པ་༎ མ་སྐྱེས་གཞིར་བཅས་སྤྱོད་ཡུལ་ཅན་༎
 tathaiva praṇidhijñānaṃ sarvālambaṃ tu tat tathā |	སྨོན་ནས་ཤེས་པའང་དེ་བཞིན་ནོ་། དེ་ཡི་དམིགས་པ་ཐམས་ཅད་དོ་༎
 dharmārthayorniruktau ca pratibhāne ca saṃvidaḥ || vakk_7|37 ||	དེ་བཞིན་ཆོས་དོན་ངེས་ཚིག་དང་༎ སྤོབས་པ་སོ་སོ་ཡང་དག་རིག་། 
 tisro nāmāthavāgjñānamavivartyaṃ yathākramam |	གསུམ་ནི་གོ་རིམས་བཞིན་མིང་དང་༎ དོན་དང་ངག་ལ་ཐོགས་མེད་ཤེས་།
 caturthīyuktamuktābhilāpamārgavaśitvayoḥ || vakk_7|38 ||	བཞི་པ་རིགས་པ་ཐགས་ཐོགས་མེད་༎ མངོན་བརྗོད་ལམ་ལ་དབང་ཉིད་ལ་༎
 vāṅmārgālambanā cāsau nava jñānāni sarvabhūḥ |	དེ་ཡི་དམིགས་པ་ངག་དང་ལམ་༏་། ཤེས་པ་དགུའོ་ས་ཐམས་ཅད་༎
 daśa ṣaḍvārthasaṃvit sā sarvatra anye tu sāṃvṛtam || vakk_7|39 ||	།
 kāmadhyāneṣu dharme vit vāci prathamakāmayoḥ |	ཆོས་རིག་འདོད་དང་བསམ་གཏན་ན་༎ ངག་ནི་འདོད་དང་དང་པོ་ན་༎
 vikalābhirna tallābhī ṣaḍete prāntakoṭikāḥ || vakk_7|40 ||	མ་ཚང་བར་ནི་དེ་ཐོབ་མེད་༎ དྲུག་པོ་དེ་དག་རབ་མཐའ་བས་༎ དེ་ནི་རྣམ་དྲུག་བསམ་གཏན་མཐའ་༎
 tatṣaḍ vidhaṃ sarvabhūmyanulomitam |	དེ་ནི་ས་ཀུན་གྱིས་མཐུན་བྱས་༎ འཕེལ་པའི་རབ་ཏུ་ཕྱིན་པ་ཡིན་༎
 vṛddhikāṣṭhāgataṃ tacca buddhānyasya prayogajāḥ || vakk_7|41 ||	སངས་རྒྱས་ལས་གཞན་སྦྱོར་ལས་སྐྱེས་༎
 ṛddhiśrotramanaḥpūrvajanmacyutyudayakṣaye |	རྫུ་འཕྲུལ་རྣ་བ་ཡིད་དང་ནི་༎ སྔོན་ཚེ་འཆི་འཕོ་སྐྱེ་བ་དང་༎ ཟད་ཤེས་མངོན་དུ་བྱ་བ་ཡི་༎
 jñāta sākṣīkriyābhijñā ṣaḍ vidhā muktimārgadhīḥ || vakk_7|42 ||	མངོན་ཤེས་རྣམ་དྲུག་རྣམ་གྲོལ་བློ་༎
 catasraḥ saṃvṛtijñānaṃ cetasi jñānapañcakam |	བཞི་ནི་ཀུན་རྫོབ་ཤེས་པ་སྟེ་༎ སེམས་ལ་ཤེས་པ་ལྔ་ཡིན་ནོ་༎
 kṣayābhijñā balaṃ yadvat pañca dhyānacatuṣṭaye || vakk_7|43 ||	ཟད་པའི་མངོན་ཤེས་སྟོབས་བཞིན་ནོ་༎ ལྔ་ནི་བསམ་གཏན་བཞི་དག་ན་༎
 svādhobhūviṣayāḥ labhyā ucitāstu virāgataḥ |	རང་དང་འོག་སའི་ཡུལ་ཅན་ཡིན་༎ ཐོབ་བྱ་འདྲིས་པ་ཆགས་བྲལ་བས་༎
 tṛtīyā trīpyupasthānāni ādyaṃ śrotraddhircakṣuṣi || vakk_7|44 ||	གསུམ་པ་དྲན་པ་ཉེར་གཞག་གསུམ་༎ དང་པོ་རྫུ་འཕྲུལ་རྣ་བ་མིག་། མིག་དང་རྣ་བའི་མངོན་ཤེས་ནི་༎
 avyākṛte śrotracakṣurabhijñe itarāḥ śubhāḥ |	ལུང་དུ་མ་བསྟན་ལྷག་རྣམས་དགེ་། 
 tisro vidyāḥ avidyāyāḥ pūrvāntādau nivarttanāt || vakk_7|45 ||	གསུམ་ནི་རིག་པ་སྔོན་མཐའ་སོགས་༎
 aśaikṣyantyā tadākhye dve tatsaṃtānamudbhavāt |	མ་རིག་པ་ནི་བཟློག་ཕྱིར་རོ་༎ མི་སློབ་ཐ་མ་གཉིས་ནི་དེའི་༎ རྒྱུད་ལ་སྐྱེས་ཕྱིར་དེ་ཞེས་བྱ་༎
 iṣṭe śaikṣasya nokte tu vidye sāvidyasaṃtateḥ || vakk_7|46 ||	སློབ་ལ་འདོད་དེ་མ་རིག་དང་༎ བཅས་རྒྱུད་ཕྱིར་ན་རིག་མ་བཤད་༎
 ādyā tṛtīyā ṣaṣṭhī ca prātihāryāṇi śāsanam |	དང་པོ་གསུམ་པ་དྲུག་པ་ནི་༎ ཆོ་འཕྲུལ་རྣམས་ཡིན་བསྟན་པ་མཆོག་། 
 agyram avyabhicāritvāddhiteṣṭaphalayojanāt || vakk_7|47 ||	མི་འཁྲུལ་༄༢༣བ་ཕྱིར་དང་ཕན་པ་དང་༎ ཡིད་འོང་འབྲས་ལ་སྦྱོར་བྱེད་ཕྱིར་༎ རྫུ་འཕྲུལ་ཏིང་འཛིན་དེ་ལས་ནི་༎
 ṛddhiḥ samādhiḥ gamanaṃ nirmāṇaṃ ca gatistridhā |	སྤྲུལ་དང་འགྲོ་བ་སྟོན་པ་ལ་༎
 śāsturmanojavā anyeṣāṃ vāhinyapyādhimokṣikī || vakk_7|48 ||	ཡིད་མགྱོགས་འགྲོ་བ་གཞན་དག་ལ་༎ ཕྱིན་བྱེད་མོས་པ་ལས་བྱུང་ཡང་༎
 kāmāptaṃ nirmitaṃ bāhyaṃ caturāyatanaṃ dvidhā |	འདོད་པར་གཏོགས་པའི་སྤྲུལ་པ་ནི་༎ ཕྱི་ཡི་སྐྱེ་མཆེད་བཞི་རྣམ་གཉིས་༎
 rūpāptaṃ dve tu nirmāṇacittaistāni caturdaśa || vakk_7|49 ||	གཟུགས་གཏོགས་གཉིས་སྤྲུལ་སེམས་དག་གིས་༎ དེ་དག་ཀྱང་ནི་བཅུ་བཞིའོ་༎
 yathākramaṃ dhyānaphalaṃ dve yāvat pañca nordhvajam |	བསམ་གཏན་འབྲས་གཉིས་ནས་ལྔའི་བར་༎ རིམ་བཞིན་གོང་མ་ལས་སྐྱེས་མིན་༎
 tallābho dhyānavat śuddhāttatsvataśca tato 'pi te || vakk_7|50 ||	དེ་རྙེད་བསམ་གཏན་བཞིན་དེ་ནི་༎ དག་དང་རང་ལས་དེ་ལས་གཉིས་༎
 svabhūmikena nirmāṇaṃ bhāṣaṇaṃ tvadhareṇa ca |	རང་གི་ས་པས་སྤྲུལ་པར་བྱེད་༎ སྨྲར་འཇུག་པ་ནི་འོག་མས་ཀྱང་༎ སྟོན་མིན་སྤྲུལ་པ་པོ་དང་བཅས་༎
 nirmātraiva sahāśāstuḥ adhiṣṭhāyānyavarttanāt || vakk_7|51 ||	བྱིན་གྱིས་བརླབས་ནས་གཞན་འཇུག་ཕྱིར་༎
 mṛtasyāpyastyadhiṣṭhānaṃ nāsthirasya apare tu na |	ཤི་བ་ལ་ཡང་བྱིན་བརླབས་ཡོད་༎ མི་བརྟན་ལ་མེད་གཞན་དག་མིན་༎
 ādāvekamanekena jitāyāṃ tu viparyayāt || vakk_7|52 ||	དང་པོ་དུ་མས་གཅིག་ཡིན་ཏེ་༎ བྱང་བར་གྱུར་ནས་བཟློག་པའོ་༎
 avyākṛtaṃ bhāvanājaṃ trividhaṃ tūpapattijam |	བསྒོམས་ལས་སྐྱེས་པ་ལུང་མ་བསྟན་༎ སྐྱེ་བ་ལས་སྐྱེས་རྣམ་གསུམ་མོ་༎
 ṛddhirmantrauṣadhābhyāṃ ca karmajā ceti pañcadhā || vakk_7|53 ||	རྫུ་འཕྲུལ་གསང་སྔགས་སྨན་དག་དང་༎ ལས་ལས་སྐྱེས་དང་རྣམ་པ་ལྔ་༎
 divyaśrotrākṣiṇī rūpaprasādau dhyānabhūmikau |	ལྷ་ཡི་མིག་དང་རྣ་བ་ཡིན་༎ བསམ་གཏན་ས་པའི་གཟུགས་དང་བ་༎
 sabhāgāvikale nityaṃ dūrasūkṣmādigocare || vakk_7|54 ||	རྟག་ཏུ་རྟེན་བཅས་མ་ཚང་མེད་༎
 durasthamāvṛtaṃ sūkṣmaṃ sarvataśca na paśyati | māṃsacakṣuryato rūpamato divyaṃ dṛgiṣyate ||	ཐག་རིང་ཕྲ་སོགས་སྤྱོད་ཡུལ་ཅན་༎ དགྲ་བཅོམ་བསེ་རུ་སྟོན་རྣམས་ཀྱིས་༎
 dvitrisāhasrakāsaṃkhyadṛśo 'rhatkhaḍgadaiśikāḥ |	སྟོང་གཉིས་གསུམ་དང་གྲངས་མེད་མཐོང་༏་། གཞན་ཡང་སྐྱེ་བས་ཐོབ་དེས་ནི་༎
 anyadapyupapattyāptaṃ taddṛśyo nāntarībhavaḥ || vakk_7|55 ||	སྲིད་པ་བར་མ་མི་མཐོང་ངོ་༎
 cetojñānaṃ tu tattredhā tarkavidyākṛtaṃ ca yat |	སེམས་ཤེས་དེ་ནི་རྣམ་གསུམ་གང་༎ རྟོག་དང་རིག་སྔགས་ཀྱིས་བྱས་པའང་༎
 jānate nārakā ādau nṛṇāṃ notpattilabhikam || vakk_7|56 ||	དམྱལ་བ་པས་ནི་དང་པོ་ཤེས་༎ མི་ལ་སྐྱེ་བས་ཐོབ་པ་མེད་༎
 abhidharmakośe jñānanirdeśo nāma saptamaṃ kośasthānam || aṣṭamaṃ kośasthānam oṃ namo buddhāya ||	ཆོས་མངོན་པའི་མཛོད་ཀྱི་ཚིག་ལེའུར་བྱས་པ་ལས་། ཡེ་ཤེས་བསྟན་པ་ཞེས་བྱ་བ་སྟེ་གནས་བདུན་པའོ་།
 dvidhā dhyānāni catvāri proktāstadupapattayaḥ |	༎ ། བསམ་གཏན་དག་ནི་རྣམ་གཉིས་བཞི་༎ དེར་སྐྱེ་བ་དག་རབ་ཏུ་བཤད་༎
 samāpattiḥ śubhaikāgyraṃ pañcaskandhāstu sānugam || vakk_8|1 ||	སྙོམས་འཇུག་དགེ་བ་རྩེ་གཅིག་པ་༎ རྗེས་འབྲང་བཅས་ན་ཕུང་པོ་ལྔ་༎
 vicāraprītisukhavat pūrvapūrvāṅgavarjitam |	དཔྱོད་དང་དགའ་དང་བདེ་དང་ལྡན་༎ ཡན་ལག་སྔ་སྔ་སྤངས་པ་ཡི་༎
 tathārūpyāḥ catuskandhāḥ adhobhūmivivekajāḥ || vakk_8|2 ||	དེ་བཞིན་གཟུགས་མེད་ཕུང་པོ་བཞི་༎ འོག་མའི་ས་ལས་དབེན་ལས་སྐྱེས་༎
 vibhūtarūpasaṃjñākhyāḥ saha sāmantakaistribhiḥ |	ཉེར་བསྡོགས་གསུམ་དང་བཅས་པར་ནི་༎ གཟུགས་ཀྱི་འདུ་ཤེས་བཤིག་ཅེས་བྱ་༎
 nārūpye rūpasadbhāvaḥ rūpotpattistu cittataḥ || vakk_8|3 ||	གཟུགས་མེད་པ་ན་གཟུགས་མེད་དོ་༎ གཟུགས་ནི་སེམས་ལས་སྐྱེ་བར་འགྱུར་༎
 ākāśānantyavijñānanatyākiṃcanyasaṃjñakāḥ |	རྣམ་ཤེས་མཐའ་ཡས་མཁའ་མཐའ་ཡས་༎ ཅི་ཡང་མེད་ཅེས་བྱ་དེ་ལྟར་༎
 tathāprayogāt māndyāttu nasaṃjñānāpyasaṃjñakaḥ || vakk_8|4 ||	སྦྱོར་ཕྱིར་དམན་༄༢༤ཨ་༌་༎ ཕྱིར་འདུ་ཤེས་མེད་༎ འདུ་ཤེས་མེད་པའང་མ་ཡིན་ནོ་༎
 iti maulaṃ samāpattidravyamaṣṭavidhaṃ tridhā |	དེ་ལྟར་སྙོམས་འཇུག་དངོས་གཞིའི་རྫས་༎ རྣམ་པ་བརྒྱད་བདུན་རྣམ་པ་གསུམ་༎
 sapta āsvādanavacchuddhānāsravāṇi aṣṭamaṃ dvidhā || vakk_8|5 ||	རོ་མྱང་ལྡན་དང་དག་པ་དང་༎ ཟག་མེད་བརྒྱད་པ་རྣམ་པ་གཉིས་༎
 āsvādanāsaṃprayuktaṃ satṛṣṇaṃ laukikaṃ śubham |	རོ་མྱང་མཚུངས་ལྡན་སྲེད་བཅས་སོ་༎ འཇིག་རྟེན་པ་ཡི་དགེ་བ་ནི་༎
 śuddhakaṃ tattadāsvādyaṃ lokattaramanāsravam || vakk_8|6 ||	དག་པ་དེ་ནི་དེས་མྱང་བྱ་༎ ཟག་མེད་འཇིག་རྟེན་འདས་པའོ་༎
 pañcādye tarkacārau ca prītisaukhyasamādhayaḥ |	དང་པོ་ལ་ལྔ་རྟོག་དཔྱོད་དང་༎ དགའ་དང་བདེ་དང་ཏིང་འཛིན་རྣམས་༎
 prītyādayaḥ prasādaśca dvitīye 'ṅgacatuṣṭayam || vakk_8|7 ||	གཉིས་པ་ལ་ནི་ཡན་ལག་བཞི་༎ རབ་དང་དང་ནི་དགའ་ལ་སོགས་༎
 tṛtīye pañca tūpekṣā smṛtiḥ prajñā sukhaṃ sthitiḥ |	གསུམ་པ་ལ་ལྔ་བཏང་སྙོམས་དང་༎ དྲན་དང་ཤེས་བཞིན་བདེ་དང་གནས་༎
 catvāryante 'sukhāduḥkhopekṣāsmṛtisamādhayaḥ || vakk_8|8 ||	མཐའ་ན་བཞི་དྲན་བཏང་སྙོམས་དང་༏་། བདེ་མིན་སྡུག་མིན་ཏིང་འཛིན་རྣམས་༎
 dravyato daśa caikaṃ ca prasrabdhi sukhamādyayoḥ |	རྫས་སུ་བཅུ་གཅིག་དང་པོ་ན་༎ ཤིན་ཏུ་སྦྱངས་པ་བདེ་བ་ཡིན་༎
 śraddhā prasādaḥ prītistu saumanasyaṃ dvidhāgamāt || vakk_8|9 ||	རབ་ཏུ་དང་བ་དད་པ་ཡིན་༎ ལུང་རྣམ་གཉིས་ཕྱིར་དགའ་ཡིད་བདེ་༎
 kliṣṭeṣva satprītisukhaṃ prasādaḥ saṃpradhīḥ smṛtiḥ | upekṣāsmṛtiśuddhiśca kecit prasrabdhyupekṣaṇe || vakk_8|10 ||	ཉོན་མོངས་ཅན་ལ་དགའ་བདེ་དང་༎ རབ་དང་ཤེས་བཞིན་དྲན་པ་དང་༎ བཏང་སྙོམས་དྲན་པ་དག་པ་མེད་༎ ཁ་ཅིག་ཤིན་ཏུ་སྦྱངས་བཏང་སྙོམས་༎
 aṣṭāpakṣālamuktatvādāniñjaṃ tu caturthakam |	སྐྱོན་བརྒྱད་ལས་ནི་གྲོལ་བའི་ཕྱིར་༎ བཞི་པ་ག-ཡོ་བ་མེད་པ་ཡིན་༎
 vitarkacārau śvāsau ca sukhādi ca catuṣṭayam || vakk_8|11 ||	རྟོག་དང་དཔྱོད་དང་དབུགས་དག་དང་༎ བདེ་བ་ལ་སོགས་བཞི་ཡིན་ནོ་༎
 saumanasyasukhopekṣā upekṣāsumanaskate | sukhopekṣe upekṣā pravido dhyānopapattiṣu || vakk_8|12 ||	སྐྱེ་བའི་བསམ་གཏན་དག་ན་ནི་༎ ཡིད་བདེ་བདེ་དང་བཏང་སྙོམས་དང་༎ བཏང་སྙོམས་ཡིད་བདེ་བདེ་བ་དང་༎ བཏང་སྙོམས་བཏང་སྙོམས་ཚོར་བ་ཡོད་༎
 kāyākṣiśrotravijñānaṃ vijñaptyutthāpakaṃ ca yat |	གཉིས་པ་སོགས་ན་ལུས་མིག་དང་༎ རྣ་བའི་རྣམ་ཤེས་རྣམ་རིག་སློང་༎
 dvitīyādau tadādyāptaṃ akliṣṭāvyākṛtaṃ ca tat || vakk_8|13 ||	གང་ཡིན་དེ་ནི་དང་པོར་གཏོགས་༎ དེ་ལུང་མ་བསྟན་ཉོན་མོངས་མིན་༎ དེ་དང་མི་ལྡན་འདོད་ཆགས་བྲལ་༎
 atadvān labhate śuddhaṃ vairāgyeṇopapattitaḥ |	སྐྱེ་བ་ལས་ནི་དག་པ་འཐོབ་༎
 anāsravaṃ tu vairāgyāt kliṣṭaṃ hānyupapattitaḥ || vakk_8|14 ||	ཟག་མེད་འདོད་ཆགས་བྲལ་བ་ཡིས་༎ ཉོན་མོངས་ཅན་ཉམས་སྐྱེ་བ་ཡིས་༏་། ཟག་པ་མེད་པའི་མཇུག་ཐོགས་སུ་༎
 tṛtīyādyāvadūrdhvādho 'nāsravānantaraṃ śubham |	ལྟག་འོག་གསུམ་པའི་བར་དགེ་བ་༎
 utpadyate tathā śuddhāt kliṭaṃ cāpi svabhūmikam || vakk_8|15 ||	སྐྱེའོ་དག་པ་ལས་དེ་བཞིན་༎ རང་གི་ས་པའི་ཉོན་མོངས་ཀྱང་༎
 kliṣṭāt svaṃ śuddakaṃ kliṣṭaṃ evaṃ cādharaśuddhakam |	ཉོན་མོངས་ཅན་ལས་རང་དག་དང་༎ ཉོན་མོངས་འོག་མའི་དག་གཅིག་ཀྱང་༎
 cyutau tu śuddhakāt kliṣṭaṃ sarvaṃ kliṣṭāttu nottaram || vakk_8|16 ||	འཆི་འཕོའི་དག་ལས་ཉོན་མོངས་ཀུན་༎ ཉོན་མོངས་ཅན་ལས་གོང་མ་མིན་༎
 caturdhā śuddhakaṃ hānabhāgīyādi yathākramam |	དག་པ་ཉམས་པའི་ཆ་མཐུན་སོགས་༎ རྣམ་བཞི་དེ་ནི་གོ་རིམས་བཞིན་༎
 kleśotpattisvabhūmyūrdhvānāsravānuguṇaṃ hi tat || vakk_8|17 ||	ཉོན་མོངས་སྐྱེ་དང་རང་ས་དང་༎ གོང་དང་ཟག་མེད་རྗེས་མཐུན་པ་༎ ཉམས་ཆ་མཐུན་སོགས་མཇུག་ཐོགས་སུ་༎
 dve trīṇi trīṇi caikaṃ ca hāna bhāgādyanantaram |	གཉིས་དང་གསུམ་དང་གསུམ་དང་གཅིག་། 
 gatvāgamya dvidhā bhūmīraṣṭau śliṣṭai kalaṅghitāḥ || vakk_8|18 ||	ས་བརྒྱད་རྣམ་གཉིས་འབྲེལ་པ་དང་༎ གཅིག་རྒལ་སོང་ཞིང་འོངས་ནས་ནི་༎ རིགས་མི་༄༢༤བ་མཐུན་པ་གསུམ་པར་འགྲོ་༎
 vyutkrāntakasamāpattirvisabhāgatṛtīyagā |	ཐོད་རྒལ་གྱི་ནི་སྙོམས་འཇུག་ཡིན་༎
 svādhobhūmyāśrayā eva dhyānārūpyāḥ vṛthādharam || vakk_8|19 ||	བསམ་གཏན་གཟུགས་མེད་རང་དང་ནི་༎ འོག་སའི་རྟེན་ཅན་འོག་དགོས་མེད་༎
 āryākiṃcanyasāṃmukhyāt bhavāgre tvāsravakṣayaḥ |	སྲིད་རྩེར་འཕགས་པའི་ཅི་ཡང་མེད་༎ མངོན་སུམ་བྱས་ནས་ཟག་པ་ཟད་༎
 satṛṣṇāḥ svabhavālambāḥ dhyānaṃ sadviṣayaṃ śubham || vakk_8|20 ||	སྲེད་བཅས་རང་གི་སྲིད་ལ་དམིགས་༎ བསམ་གཏན་དགེ་ཡུལ་ཡོད་དགུ་ཡིན་༏་། གཟུགས་མེད་དངོས་གཞི་དགེ་རྣམས་ཀྱི་༎
 na maulāḥ kuśalārūpyāḥ sāsravādharagocarāḥ |	སྤྱོད་ཡུལ་ཟག་བཅས་འོག་མ་མིན་༎
 anāsraveṇa hīyante kleśāḥ sāmantakena ca || vakk_8|21 ||	ཟག་པ་མེད་པས་ཉོན་མོངས་རྣམས་༎ སྤོང་ངོ་ཉེར་བཟློག་དག་པས་ཀྱང་༎
 aṣṭau sāmantakānyeṣāṃ śuddhāduḥkhāsukhāni hi |	དེ་དག་ལ་ནི་ཉེར་བཟློག་བརྒྱད་༎ དག་པ་བདེ་མིན་སྡུག་བསྔལ་མིན་༎
 ārya cādyaṃ tridhā kecit atarka dhyānamantaram || vakk_8|22 ||	དང་པོ་འཕགས་པའང་ཁ་ཅིག་གསུམ་༎ རྟོག་མེད་བསམ་གཏན་ཁྱད་པར་ཅན་༎
 tridhā aduḥkhāsukhaṃtacca mahābrahmaphalaṃ ca tat |	རྣམ་གསུམ་བདེ་མིན་སྡུག་བསྔལ་མིན་༎ དེ་ནི་ཚངས་ཆེན་འབྲས་བུ་ཅན་༎
 savitarkavicāro 'dhaḥsamādhiḥ parato 'dvayaḥ || vakk_8|23 ||	མན་ཆད་རྟོག་དཔྱོད་བཅས་པ་ཡི་༎ ཏིང་འཛིན་ཡན་ཆད་གཉིས་ཀ་མེད་༎
 ānimittaḥ samākāraiḥ śūnyatānātmaśūnyataḥ |	མཚན་མེད་ཞི་བའི་རྣམ་པ་དང་༎ སྟོང་ཉིད་བདག་མེད་སྟོང་ཉིད་དུ་༎ འཇུག་པའོ་སྨོན་པ་མེད་པ་ནི་༎
 pravartate apraṇihitaḥ satyākārairataḥ paraiḥ || vakk_8|24 ||	དེ་ལས་གཞན་བདེན་རྣམ་པ་དང་། དག་དང་དྲི་མ་མེད་དེ་དག་། 
 śuddhāmalāḥ nirmalāstu te vimokṣamukhatrayam |	དྲི་མེད་རྣམ་ཐར་སྒོ་གསུམ་མོ་༎
 śūnyatāśunyatādyākhyāstrayo 'parasamādhayaḥ || vakk_8|25 ||	སྟོང་ཉིད་སྟོང་ཉིད་ཅེས་ལ་སོགས་༎ གཞན་ཡང་ཏིང་ངེ་འཛིན་གསུམ་མོ་༎
 ālambete aśaikṣaṃ dvau śūnyataścāpyanityataḥ |	གཉིས་ནི་སྟོང་དང་མི་རྟག་པར་༎ མི་སློབ་པའི་ལ་དམིགས་པ་ཡིན་༎
 ānimittānimittastu śāntato 'saṃkhyayā kṣayam || vakk_8|26 ||	མཚན་མ་མེད་པ་མཚན་མེད་ནི་༎ ཞི་བར་མ་བརྟགས་ཟད་པ་ལ་༎
 sāsravāḥ nṛṣu akopyasya saptasāmantavarjitāḥ |	ཟག་བཅས་མི་ནང་མི་ག-ཡོ་ལ་༏་། ཉེར་བསྡོགས་བདུན་ནི་མ་གཏོགས་སོ་༎
 samādhibhāvanā dhyānaṃ subhamādyaṃ sukhāya hi || vakk_8|27 ||	དགེ་བའི་བསམ་གཏན་དང་པོ་ནི་༎ བདེ་འགྱུར་ཏིང་འཛིན་སྒོམ་པ་ཡིན་༎
 darśanāyākṣyabhijñeṣṭā dhībhedāya prayogajāḥ |	མིག་གི་མངོན་ཤེས་མཐོང་འགྱུར་འདོད་༎ སྦྱོར་བ་ལས་བྱུང་བློ་དབྱེར་འགྱུར་༎
 vajropamo 'ntye yo dhyāne sāsravakṣayabhāvanā || vakk_8|28 ||	རྡོ་རྗེ་ལྟ་བུའི་བསམ་གཏན་མཐའི་༎ གང་ཡིན་དེ་ཟག་ཟད་འགྱུར་བསྒོམ་༎
 apramāṇāni catvāri vyāpādādivipakṣataḥ |	ཚད་མེད་པ་ནི་བཞི་ཡིན་ནོ་༏་། གནོད་སེམས་ལ་སོགས་གཉེན་པོའི་ཕྱིར་༎
 maitryadveṣaḥ api karuṇā muditā sumanaskatā || vakk_8|29 ||	ཞེ་སྡང་མེད་བྱམས་སྙིང་རྗེ་ཡང་༎ ཡིད་བདེ་བ་ནི་དགའ་བ་ཡིན་༎
 upekṣālobhaḥ ākāraḥ sukhitā duḥkhitā vata |	བཏང་སྙོམས་མ་ཆགས་རྣམ་པ་ནི་༎ ཀྱེ་མ་བདེར་གྱུར་སྡུག་བསྔལ་དང་༎ དགར་གྱུར་སེམས་ཅན་རྣམས་སྙམ་པ་༎
 modantāmiti sattvācca kāmasattvāstu gocaraḥ || vakk_8|30 ||	སྤྱོད་ཡུལ་འདོད་པའི་སེམས་ཅན་རྣམས་༎
 dhyānayormuditā anyāni ṣaṭ su kecittu pañcasu |	དགའ་བ་བསམ་གཏན་གཉིས་ན་ཡོད་༎ གཞན་ནི་དྲུག་ན་ཁ་ཅིག་ལྔ་༎
 na taiḥ prahāṇaṃ nṛṣveva janyante tryanvito dhruvam || vakk_8|31 ||	།
 aṣṭau vimokṣāḥ prathamāvaśubhā dhyānayordvayoḥ |	རྣམ་པར་ཐར་བརྒྱད་དང་པོ་གཉིས་༎ མི་སྡུག་བསམ་གཏན་གཉིས་ན་ཡོད་༎
 tṛtīyo 'ntye sa cālobhaḥ śubhārūpyāḥ samāhitāḥ || vakk_8|32 ||	གསུམ་པ་མཐའ་ན་དེ་མ་ཆགས་༎ གཟུགས་མེད་མཉམ་གཞག་དགེ་རྣམས་སོ་༎
 nirodhastu samāpattiḥ sūkṣmasūkṣmādanantaram |	འགོག་པའི་སྙོམས་པར་འཇུག་པའོ་། ༄༢༥ཨ་༌་༎ ཕྲ་བ་ཕྲ་བའི་མཇུག་ཐོགས་སུ་༎ རང་གི་དག་དང་འོག་མ་ཡི་༎
 svaśuddhakādharāryeṇa vyutthānaṃ cetasā tataḥ || vakk_8|33 ||	འཕགས་པའི་སེམས་ཀྱིས་དེ་ལས་ལྡང་༎ དང་པོ་འདོད་གཏོགས་སྣང་ཡུལ་ཅན་༎
 kāmāptadṛśyaviṣayāḥ prathamāḥ ye tvarūpiṇaḥ |	གང་དག་གཟུགས་ཅན་མིན་དེ་དག་། 
 te 'nvayajñānapakṣordhvasvabhūduḥkhādigocarāḥ || vakk_8|34 ||	སྤྱོད་ཡུལ་གོང་དང་རང་གི་སའི་༎ སྡུག་བསྔལ་སོགས་དང་རྗེས་ཤེས་ཕྱོགས་༎
 abhibhvāyatanānyaṣṭau dvayamādyavimokṣavat |	ཟིལ་གྱིས་གནོན་པའི་སྐྱེ་མཆེད་བརྒྱད་༎ གཉིས་ནི་རྣམ་ཐར་དང་པོ་བཞིན་༎
 dve dvitīyavat anyāni punaḥ śubhavimokṣavat || vakk_8|35 ||	གཉིས་ནི་གཉིས་པ་བཞིན་དེ་གཞན་༎ སྡུག་པའི་རྣམ་པར་ཐར་པ་བཞིན་༎
 daśa kṛtsnāni alobhāṣṭau dhyāne 'ntye gocaraḥ punaḥ |	ཟད་པར་བཅུའོ་བརྒྱད་མ་ཆགས་༎ བསམ་གཏན་མཐའ་ན་སྤྱོད་ཡུལ་ནི་༎
 kāmāḥ dve śuddhākārūpye svacatuḥskandhagocare || vakk_8|36 ||	།
 nirodha uktaḥ vairāgyaprayogāptaṃ tu śeṣitam |	འགོག་པ་བཤད་ཟིན་ལྷག་མ་ནི་༎ འདོད་ཆགས་བྲལ་དང་སྦྱོར་བས་འཐོབ་༎
 tridhātvāśrayamārūpyasaṃjñaṃ śeṣaṃ manuṣyajam || vakk_8|37 ||	གཟུགས་མེད་ཅེས་བྱ་ཁམས་གསུམ་གྱི་༎ རྟེན་ཅན་ལྷག་མ་མི་ལས་སྐྱེ་༎
 hetukarmabālāddhātvorārupyotpādanaṃ dvayoḥ |	ཁམས་གཉིས་དག་ཏུ་གཟུགས་མེད་པ་༎ རྒྱུ་དང་ལས་ཀྱི་སྟོབས་ཀྱིས་སྐྱེ་༎
 dhyānānāṃ rūpadhātau tu tābhyāṃ dharmatayāpi ca || vakk_8|38 ||	གཟུགས་ཀྱི་ཁམས་སུ་བསམ་གཏན་རྣམས་༎ དེ་དག་དང་ཆོས་ཉིད་ཀྱིས་ཀྱང་༎
 saddharmo dvividhaḥ śāsturāgamādhigamātmakaḥ |	སྟོན་པའི་དམ་ཆོས་རྣམ་གཉིས་ཏེ་༎ ལུང་དང་རྟོགས་པའི་བདག་ཉིད་དོ་༎
 dhātārastasya vaktāraḥ pratipattāra eva ca || vakk_8|39 ||	དེ་འཛིན་བྱེད་པ་སྨྲ་བྱེད་དང་༎ སྒྲུབ་པར་བྱེད་པ་ཁོ་ན་ཡིན་༎
 kāśmīravaibhāṣikanītisiddhaḥ prāyo mayāyaṃ kathito 'bhidharmaḥ |	བདག་གིས་མངོན་པའི་ཆོས་འདི་ཕལ་ཆེར་ནི་༎ ཁ་ཆེ་བྱེ་བྲག་སྨྲ་བའི་ཚུལ་གྲུབ་བཤད་༎ ཉེས་པར་ཟིན་གང་དེ་འདིར་བདག་གིས་ཉེས་༎
 yaddurguhītaṃ tadihāsmadāgaḥ saddharmanītau munayaḥ pramāṇam || vakk_8|40 ||	དམ་ཆོས་ཚུལ་ལ་ཚད་མ་ཐུབ་རྣམས་ཡིན་༎ ཆོས་མངོན་པའི་མཛོད་ཀྱི་ཚིག་ལེའུར་བྱས་པ་ལས་། སྙོམས་པར་འཇུག་པ་བསྟན་པ་ཞེས་བྱ་བ་སྟེ་གནས་བརྒྱད་པའོ་། ༎ ། སྟོན་པ་འཇིག་རྟེན་མིག་ནི་ཟུམ་གྱུར་ཅིང་༎
 nimīlite śāstari lokacakṣuṣi kṣayaṃ gate sākṣijane ca bhūyasā |	དབང་གྱུར་སྐྱེ་བོ་ཕལ་ཆེར་ཟད་པ་ན་༎
 adṛṣṭatattvairniravagrahaiḥ kṛtaṃ kutārkikaiḥ śāsanametadākulam || vakk_8|41 ||	དེ་ཉིད་མ་མཐོང་རང་དགར་གྱུར་པ་ཡི་༎ ངན་རྟོག་རྣམས་ཀྱིས་བསྟན་པ་འདི་དཀྲུགས་སོ་༎
 gate 'tha śāntiṃ paramāṃ svayaṃbhuvi svayaṃbhuvaḥ śāsanadhūrdhareṣu ca |	རང་བྱུང་རང་བྱུང་བསྟན་པ་གཅེས་འཛིན་རྣམས་༎ མཆོག་ཏུ་ཞིར་གཤེགས་འགྲོ་མགོན་མེད་པ་ན་༎
 jagatyanāthe gaṇaghātibhirmataiḥ niraṅkuśaiḥ svairamihādya caryate || vakk_8|42 ||	འདོམས་མེད་ཡོན་ཏན་འཇོམས་པར་བྱེད་པ་ཡི་༎ དྲི་མས་དགའ་མགུར་དེང་སང་འདི་ན་སྤྱོད་༎
 iti kaṇṭhagataprāṇaṃ viditvā śāsanaṃ muneḥ |	དེ་ལྟར་ཐུབ་པ་དག་གི་བསྟན་པ་ནི་༎ ལྐོག་མར་སྲོག་ཕྱིན་འདྲ་དང་དྲི་མ་རྣམས་༎ སྟོབས་དང་ལྡན་པའི་དུས་སུ་རིག་ནས་ནི་༎
 balakālaṃ malānāṃ ca na pramādyaṃ mumukṣubhiḥ || vakk_8|43 ||	ཐར་པ་འདོད་པ་དག་གིས་བག་ཡོད་གྱིས་*kyis?་༎
