skt	tib
 oṃ namo ratnatrayāya ||	དཀོན་མཆོག་གསུམ་ལ་ཕྱག་འཚལ་ལོ་༎ གང་གིས་མཛད་པ་ཤིན་ཏུ་དཀའ་སྤྱད་སྔོན་བྱུང་བ་༎
 pūrvāvadānacariteṣu suduṣkareṣu gīteṣu yasya surakiṃnarasundarībhiḥ |	མིའམ་ཅི་དང་ལྷ་མོ་རྣམས་ཀྱིས་རབ་བསྙད་ན་༎
 adyāpi candrakiraṇairiva saṃkucanti mārāṅganāvadanapaṅkajakānanāni || śl_1 ||	བདུད་ཀྱི་བུ་མོ་བཞིན་རས་པདམའི་ནགས་ཚལ་དག་། ད་ལྟར་ཟླ་བའི་ཟེར་གྱིས་ཕོག་པ་བཞིན་དུ་ཟུམ་༎ བཀྲ་ཤིས་ཡིད་འོང་ཤིན་ཏུ་རྨད་བྱུང་སྐུ་མངའ་བ་༎
 saubhāgyahṛdyavapuṣaḥ paramādbhutasya yasyālpapuṇyajanadurlabhadarśanasya |	བསོད་ནམས་ཆུང་ངུའི་སྐྱེ་བོས་མཐོང་བ་རྙེད་དཀའ་བ་༎ འཇིག་རྟེན་མངོན་པར་འདོད་པའི་རེ་བ་བསྒྲུབ་པ་གང་༎
 saṃpāditābhimatalokamanorathasya cintāmaṇeriva parārtharasaikavṛttiḥ || śl_2 ||	ཡིད་བཞིན་ནོར་བུ་ལྟ་བུར་གཞན་དོན་རོ་གཅིག་སྤྱོད་༎
 yaḥ sarvadā parasukhaikaraso babhūva duḥkhena duḥkhamagamatparamaṃ pareṣām |	གང་ཞིག་རྟག་ཏུ་ཕ་རོལ་བདེ་བས་བདེ་འགྱུར་ཞིང་༎ གཞན་དག་སྡུག་བསྔལ་གྱུར་པས་མཆོག་ཏུ་འོ་བརྒྱལ་བ་༎ ཐུགས་རྗེ་ཆེན་པོས་ཡོན་ཏན་ཤིན་ཏུ་བསྐྲུན་པ་གང་༎
 atyarthamāhitamahākaruṇāguṇasya yasyātmaduḥkhasukhamantaritaṃ tadeva || śl_3 || vicchi x māvayasi yasya śiraḥ parārtha x x x sannayanapaṅkajatāmavāpa |	དེ་ཉིད་རང་གི་བདེ་སྡུག་སྤངས་ཏེ་བཞུགས་པ་ཡིན་༎ གང་ཞིག་གཞན་གྱི་དོན་དུ་དབུ་རྣམས་གཅོད་བྱེད་ཀྱང་༎ པདམ་ལྟ་བུར་དགྱེས་པའི་སྤྱན་འབྱེད་གཟིགས་མཛད་ཅིང་༎ ཉིད་ཀྱི་དོན་དུ་གདུགས་དཀར་གཅིག་གིས་ཁེབས་པ་ལྟའི་༎
 svārthaṃ puna x x x x x sitātapatrā pṛthvī babhūva niśiteva kṛpāṇadhārā || śl_4 || lokopakāranirataprakaṭodayena śulka x x x x x x guṇojjvalena |	ས་ཡང་རལ་གྲི་སོ་བདར་རྣོན་པོ་ལྟ་བུར་དགོངས་༎ ཟླ་བ་ཡར་གྱི་ངོ་ལྟར་ཡོན་ཏན་གསལ་བ་རྫོགས་༎
 doṣāndhakārabhidureṇa manorameṇa yenoditena śaśineva jagatprakāśam || śl_5 || cūḍāvibhūṣaṇamivottamaratnakalpamūḍhaṃ śirobhirurubhiḥ phaṇināṃ x x x |	ཉེས་པའི་མུན་པ་སེལ་མཛད་གཅིག་དུ་ཡིད་དུ་འོང་༏་།འཇིག་རྟེན་ཕན་ལ་བརྩོན་བ་རབ་ཏུ་གསལ་བ་བྱུང་༎ དེ་ཤར་ཟླ་བ་བཞིན་དུ་འགྲོ་བ་བསིལ་བར་མཛད་༎
 yacchāsanaṃ śubhamakhaṇḍaviśuddhavṛttaṃ pātālamūrdhani layatimiraṃ pramārṣṭi || śl_6 ||	བསྟན་པ་རིན་ཆེན་མཆོག་ལྟར་བཟང་ལ་འཕན་མེད་པ་༎ རྣམ་བར་དག་ཆུལ་གང་ཡིན་ཀླུ་མགོ་གདེངས་ཀ་ཅན་༎ ཆེན་པོ་རྣམས་ཀྱིས་གཙུག་གི་རྒྱན་བཞིན་གུས་མནོས་༄༤༧ཨ་༌་༎ ནས་༏་། ས་ཡི་སྟེང་ན་གནས་པའི་རབ་རིབ་སེལ་བར་མཇད་༎
 dharmāmbuvāha iva yo 'bhyudito hitāya dharmāmṛtaṃ jalamivaikarasaṃ vavarṣa | tāpāpa x x x x x x x x x x x x yadanekarasa x x x x x x x x x x x x x x || śl_7 ||	ཆོས་ཀྱི་སྤྲིན་དེ་ཕན་པ་མཛད་པའི་དོན་དུ་ག-ཡོས་༎ ཆོས་ཀྱི་བདུད་རྩི་མྱ་ངན་འདས་པ་མཆོག་གི་རྒྱུ་༎ རོ་གཅིག་གདུང་བ་སེལ་བ་ཆར་ཆུ་བཞིན་དུ་བབ་༎ དེ་ནི་སྣོད་ལ་བརྟེན་ནས་རོ་རྣམས་དུ་མར་གྱུར་༎
 vistīrṇanimnavimalaprakaṭāśrayeṣu pātreṣu sarvaparimardasaheṣu yeṣu | tatsaṃsthitaṃ bhavati sarvajanopakāraṃ x x x x x x x x x x x x x x || śl_8 ||	སྣོད་ཡངས་ཟབ་ལ་དྲི་མ་མེད་ཅིང་གསལ་བ་ཡི་༎ བསམ་པ་དང་ལྡན་ཁུར་ཀུན་བཟོད་པ་གང་དག་ལ་༎ སྐྱེ་བོ་ཀུན་གྱིས་ཉེ་བར་སྤྱད་བྱ་དེ་གནས་པ་༎ མཚོ་ཆེན་མི་ཡི་གཟུགས་ཅན་དེ་ལ་ཕྱག་འཚལ་ལོ་༎ གང་ཞིག་སྐྱེ་ནང་རྒ་ཤི་སེལ་བའི་བདུད་རྩི་དེ་༎
 tajjāgaraṃ maraṇajanmajarāpahāri ye nāpnuvanti na pibanti na dhārayanti |	ཐོབ་བར་མི་བྱེད་མི་སྦྱོད་འཛིན་པར་མི་བྱེད་པ་༎
 te māhitā bahulamohamahāmadena x x x x x x x x x dhamādriyante || śl_9 ||	དེ་དག་ཉེས་མང་གཏི་མུག་ཐིབས་པོས་བསླད་པ་སྟེ་༎ ཡུན་རིང་ནད་ཀྱིས་ཐེབས་པ་སྨན་ཆེན་མི་བསྟེན་བཞིན་༎ འགྲོ་བ་ཀུན་གྱི་མིག་གཅིག་དྲི་མ་མེད་པ་གང་༎
 cakṣuryadekamamalaṃ jagato 'khilasya sādhāraṇaṃ tribhuvanasya yadekadīpaḥ |	དེ་ནིས་རྣམས་གསུམ་པོའི་སྤྱི་མཐུན་སྒྲོན་མ་སྟེ་༎
 tacchāsanaṃ samadhigamya yadutsṛjanti mohasya tadvilasitaṃ paramādbhutasya || śl_10 ||	བསྟན་པ་ལེགས་པར་རྙེད་ནས་གང་ཞིག་འདོར་བ་དེ་༏་། གཏི་མུག་ཤིན་ཏུ་རྨད་བྱུང་དག་གིས་གཙེས་པར་ཟད་༎ བྱང་ཆུབ་ཁང་བཟངས་བགྲོད་ལམ་ཐེམ་སྐས་ལྟ་བུ་ཡི་༎
 śikṣā x x x viditeṣviva bodhisaudhasopānapaddhatipadeṣu padaṃ dadhānāḥ | tuṅgāṃ prayānti padavīmanivartamānā bhūmiṃ nijāmavataranti vivartamānāḥ || śl_11 ||	བསླབ་གཞི་བཅས་པ་རྣམས་ལ་རྐང་ཚུགས་རྟོན་པ་རྣམས་༎ རྗེས་སུ་སྒྲུབ་པས་གོ་འཕང་ཆེ་མཐོར་ཕྱིན་འགྱུར་ཏེ་༎ ལྡོག་པར་བྱེད་པ་རང་གི་ས་ནི་གཉུག་མར་ལྟུང་༏་། སྐྱེ་བའི་རྒྱ་མཚོ་ཤིན་ཏུ་རྒལ་དཀའ་རྒལ་འདོད་པ་༎
 janmārṇavaṃ paramadustaramuttitīrṣuḥ śīlaplavaṃ ka iha hastagataṃ jahāti |	སུ་ཞིག་ཚུལ་ཁྲིམས་གཟིངས་གྱུར་ལག་ཏུ་འོང་བ་སྤང་༎
 kāntāramadhyapatitaḥ kathamāryasārthādbhraṣṭo na śocati ciraṃ supathānabhijñaḥ || śl_12 ||	འཕགས་པའི་དེད་དཔོན་དང་བྲལ་ལམ་རྒྱུས་མི་ཤེས་པ་༎ འབྲོག་དགོན་འཁྱམས་ན་ཅི་སྟེ་ཡུན་རིངས་གདུངས་མི་བྱེད་༎
 saṃsārabhūdharadarījaṭharaprapātādutthātumudyataparāḥ paramāndhakārāt |	འཁོར་བའི་རི་སུལ་ཁྲོད་ཀྱི་ག-ཡང་སར་ལྷུང་གྱུར་པ་༎ མུན་ནག་ཐིབས་པོའི་ནང་ནས་ལྡང་བར་བརྩོན་པ་གང་༎ ཡོན་ཏན་སྨྱུག་མའི་ཕྲེང་བ་བར་མ་དོར་འདོར་བ་༎
 muñcanti ye jinaguṇāvalimantarāle vegena te viṣamapātamadhaḥ patanti || śl_13 ||	དེ་དག་ཤུགས་དྲག་ཉམ་ངའི་ལྟུང་བར་འོག་ཏུ་ལྟུང་༎
 ekākino 'pi manasā niyamaṃ prakalpya ye karmaṇā samuditena samunnayanti |	གང་དག་གཅིག་པུའང་ཡིད་ཀྱིས་ངེས་པར་རབ་བརྟགས་སྟེ་༎ ཡང་དག་ལམ་དང་ལྷན་ཅིག་འགྲོགས་པར་བྱེད་པ་དེ་༎ ས་སྟེང་དཀྱིལ་ན་གཙོ་བོར་གྱུར་པ་དམ་པ་སྟེ་༎
 te sādhavo bhuvanamaṇḍalamaulibhūtāstaireva yānti gurutāṃ guravaḥ suśiṣyaiḥ || śl_14 || labdhvā guṇaughajananīṃ jananīmivāryāmatyantaśuddahṛdayāmanuvartamānāḥ |	སློབ་མ་མཆོག་དེས་བླ་མར་བཀུར་བ་ཉིད་དུ་འགྱུར་༎ ངོ་ཚ་ཡོན་ཏན་ཚོགས་སྐྱེད་མ་གཅིག་ཡ་རབས་མོ་༎ མཆོག་ཏུ་ག-ཡོ་མེད་བྱམས་པ་ལྟ་བུའི་རྗེས་འབྲང་བ་༎ བདེན་དང་གཞུང་ལ་དགའ་བའི་གཟི་༄༤༧བ་བརྗིད་ལྡན་པ་རྣམས་༎
 tejasvinaḥ sukhamasūnapi saṃtyajanti satyasthitivyasanino na punaḥ pratijñām || śl_15 ||	སྲོག་ནི་བདེ་བླག་གཏོང་བར་བྱེད་ཀྱི་དམ་བཅས་མིན་༎ རེ་ཞིག་སྐྱེ་བོ་ཀུན་གྱིས་དཔྱས་དང་སྡིག་པ་ཡིས་༎
 tiṣṭhantu tāvadiha sarvajanāpavādāḥ sarvāśca pāpagatayo nirayāśca ghorāḥ |	འགྲོ་བ་ཀུན་ལ་དམྱལ་བ་མི་བཟོད་ཕར་ཞོག་གི་། རང་བཞིན་རྣལ་མ་བོར་ནས་སྨོད་པ་སྡུག་བསྔལ་བ་༎ 
 sadyo jahāti sahajāṃ prakṛtiṃ yadeṣa duḥkhaṃ tataḥ kimaparaṃ bhuvi sajjanasya || śl_16 ||	མཁས་ལ་ས་སྟེང་དེ་ལས་སྡུག་བསྔལ་གཞན་ཅི་ཡོད་༎
 yaḥ prapya nāvamiva dharmamayīṃ viśālāṃ bhūyo jahāti padavīṃ munibhiḥ praklṛptām |	གང་ཞིག་ཐུབ་པ་རྣམས་ཀྱིས་སྲོལ་བཏོད་ཆོས་ཀྱི་ལམ་༎ རྒྱ་ཆེན་གྲུ་དང་འདྲ་བ་རྙེད་ནས་སླར་འདོར་བ་༎
 saṃsārasāgaravivartananartaneṣu cetaḥspṛhā taralitā niyamena tasya || śl_17 ||	འཁོར་བའི་རྒྱ་མཚོའི་ཀློང་འཁྱིལ་གར་མཁན་འདྲ་རྣམས་ལ་༎ དགའ་བས་ངེས་པར་དེ་ཡི་སེམས་བསླུས་འགྱུར་བ་སྙམ་༎
 saṃsāracakramaniśaṃ parivartamānamāruhya yaḥ sukhamavaiti vivartamānaḥ |	གང་ཞིག་འཁོར་བའི་འཁོར་ལོ་རྟག་ཏུ་འཁོར་གྱུར་པའི་༎ ནང་དུ་ཞུགས་ནས་བསྟི་བ་ཙམ་ལ་བདེར་སེམས་པ་༎
 so 'vaśyameva tarivaśaṃ masaḥ krameṇa sarvāḥ samāśca visamāśca gatīḥ prayāti || śl_18 ||	དེ་ནི་ངེས་པར་དབང་མེད་རིམ་གྱིས་བརྒྱ་ཕྲག་ཏུ་༎ འགྲོ་བ་མཉམ་དང་མི་མཉམ་ཀུན་དུ་འཁྱམ་པར་འགྱུར་༎
 atyugragandhamaśuciprakaroparuddhamatyantasaṃkaṭamupoḍhaghanāndhakāram |	ཤིན་ཏུ་མི་བཟད་དྲི་ང་མི་གཙང་གཙེར་བས་བགགས་༎ རབ་ཏུ་དོག་པ་མུན་ནག་ཐིབས་པོར་འདུག་པའི་མི་༎
 āviśya garbhanilayaṃ nirayaṃ yathaiva duḥkhaṃ mahatsa sahate paripiṇḍatāṅgaḥ || śl_19 ||	མངལ་གནས་དམྱལ་བ་ལྟ་བུའི་ནང་དུ་དེ་ཞུགས་ནས་༎ ལུས་ཡོངས་བསྐུམ་ལ་སྡུག་བསྔལ་ཆེན་པོ་བརྣག་དགོས་སོ་༎
 kālakramena sa tato dṛḍhatailayantraniṣpīḍyamāna iva yāti bhuvaṃ kathaṃcit |	དེ་ནི་རིམ་གྱིས་ཏིལ་མར་བཙིར་སྤྱད་སྲ་བ་ཡིས་༎ བཙིར་བ་ལྟར་བྱས་དེ་ནས་ཅི་ཞིག་ལྟར་དེ་བཙའ་༎
 sadyastathāpi yadayaṃ na jahāti jīvaṃ duḥkhopabhogagatidurlabhi tattadeva || śl_20 ||	འོན་ཀྱང་མོད་ལ་དེ་སྲོག་མི་འདོར་གང་ཡིན་པ་༎ སྡུག་བསྔལ་ཉེ་བར་སྤྱད་པའི་རྣམ་པར་མཐོ་བཙམས་མོད་༎
 tatra sthitaṃ tamaśucau parivartamānamārdrolbaveṣṭitatanuṃ bahalogragandham | pūrvasmṛtivraṇamivolbaṇadoṣapākaṃ bhinnaṃ jahāti ghṛṇayeva nipīḍyamānaḥ || śl_21 ||	མི་གཙང་དེ་ནང་གནས་བཅས་འཕེལ་བའི་ལུས་དེ་ནི་༎
 sarvopacāravivaśaṃ śithilākulāṅgamutsṛjya bālyamupajātakaṇairabhāvaḥ |	མངལ་གནས་རླམ་པས་དཀྲིས་ཤིང་དྲི་ངི་མ་བཟང་ལྡང་༎ གཟིར་བས་གནོད་པ་བདོ་སྟེ་རྨ་རྨེན་ཞིག་པ་ལྟར་༎ གྱུར་པ་དེ་ཡི་སྐྱོན་གྱིས་སྔོན་གྱི་དྲན་པ་སྤོང་༎ བྱིས་ལུས་ཉེ་བར་སྤྱོད་པ་ཀུན་ལ་མི་འབོངས་པ་༎ མི་བརྟེན་འཁོར་བ་སྤངས་ཏེ་མཁྲང་པའི་དངོས་གྱུར་ནས་༎ དར་ལ་བབས་པའི་རི་དབང་བཙན་བོའི་རི་སུལ་དུ་༎
 tuṅgeṣu yauvanagirīndradarītaṭeṣu mohāyate viṣayadṛṣṭiviṣālayeṣu || śl_22 ||	སྦྲུལ་གདུག་གནས་གྱུར་མུ་ལ་བག་རྐྱང་སྤྱོད་པར་བྱེད་༎
 sa tato'pi patatyacetanaḥ patito naiva jahāti vikriyām |	བསམ་བརླག་དེ་ནི་དེ་ནས་ཀྱང་ལྷུང་ལ་༏་། ལྷུང་བཞིན་མི་གཙིགས་སྤྱོད་པ་མི་འདོར་བ་༎
 ajarāmaramātmavigrahaṃ lalitaṃ manyata evaṃ bāliśaḥ || śl_23 ||	བྱིས་པ་བདག་ལུས་སྡུག་པ་རྒ་བ་དང་༎ འཆི་བ་མེད་བ་ཉིད་དུ་སེམས་པ་ལྟ་༎ རྨོངས་པ་དེ་ནི་ཐུབ་དབང་གིས་བསྟན་པའི་༎
 sa vihāya munīndrasevitaṃ supathaṃ yātyapathena mohitaḥ |	ལམ་བཟང་རྣམ་པར་སྤངས་ནས་ལམ་མིན་པར་༎
 rabhasena parāṃ vicūrṇayan gajavajjātamado niraṅkuśaḥ || śl_24 ||	གླང་པོ་མྱོས་པ་ལྕགས་ཀྱུ་མེད་པས་གཞན༎ ༄༤༨ཨ་༌་༎ བབ་དགུ་ཕྱེ་མར་རློག་པ་བཞིན་དུ་འགྲོ་༎
 atha tasya balādanicchataḥ śirasi nyastapadā sunirdayam |	དེ་ནས་དེ་ནི་མི་འདོད་བཞིན་དུ་མགོར་༎ བརྩེ་མེད་རྒ་བས་རྡོག་པ་ནན་མནན་ནས་༎ སྐྲ་དཀར་ལྕགས་ཀྱུ་བདར་བ་རྣོན་པོ་ཡིས་༎
 niśitaṃ palitāṅkuśaṃ jarā kariṇo hastipakīva yacchati || śl_25 ||	གླང་ཆེན་རྫི་བོས་གླང་ཆེན་བཞིན་དུ་འདེབས་༎
 sa tathāpi vijihyaceṣṭitaḥ kuśalenāpi bhayādivojjhitaḥ |	འོན་ཀྱང་དེ་ནི་སྤྱོད་ལ་སྐྱོར་འབྱིན་པས་༎ དགེ་བའམ་འཇིགས་པ་བཞིན་དུ་སྤང་བར་འགྱུར་༎
 sukṛtāni karoti mohitaḥ śaravatsvātmavadhāya puṣpitaḥ || śl_26 || atha taṃ prahasannivāntakaḥ palitaughairdarśanairivolbaṇaiḥ |	རྨོངས་པ་བྱ་བ་མིན་བྱེད་བདག་སྐྱེས་པ་༎ སྨྱུག་མ་འབྲུ་ཆགས་ལྟ་བུར་བརླག་པར་ཟད་༎ དེ་ནས་དེ་ནི་འཆི་བདག་དགའ་བའི་སྤུན་༎ གཞིལ་བའི་བཅོས་ཐབས་མེད་པས་བཟུང་ནས་ནི་༎
 śirasi grasituṃ pravartate nirupāyapraśamo jarārujaḥ || śl_27 ||	རྒས་པའི་ངོ་བོ་འཆི་བདག་འོངས་ནས་ནི་༎ རྒོད་པ་བཞིན་དུ་སྦྱི་ནས་འཛིན་པར་བྱེད་། དེ་ནས་དེ་ནི་ལྟུ་ཚིགས་རྣམས་འབྱེ་ཞིང་༎
 vidalanti tato 'sya sanvayo matirutkrāmati hīyate gatiḥ |	བློ་ཡང་བསླད་འགྱུར་འགྲོ་བ་ཉམས་པར་འགྱུར་༎ ལུས་ཀྱང་དེངས་ནས་ཤིག་ཤིག་པར་འགྱུར་ལ་༎
 kṣayameti vapuḥ pariślaṣaṃ niyataṃ vardhata eva jīvitāśā || śl_28 ||	ངེས་པར་སྡིག་པ་འཕེལ་བ་ཁོ་ནར་འགྱུར་༎
 kramaśaśca nimīlitendriyo hataśaktirviṣayeṣu lālasaḥ |	དབང་པོ་རྣམས་ཀྱང་རིམ་གྱིས་ཞུམ་ནས་ནི་༏་། ཡུལ་ལ་ཆགས་ཀྱང་ནུས་པ་ཉམས་པར་འགྱུར་༎ གནས་སྐབས་གང་དུ་འདི་འགྲོ་གྱུར་བ་དེ་༎
 upagacchati yāmayaṃ daśāṃ narake sā yadi bhīma eva saḥ || śl_29 ||	གལ་ཏེ་དམྱལ་ན་ཡོད་ན་དེ་ཉིད་འཇིགས་༎
 kathamevamidaṃ mayā kṛtaṃ kathamevaṃ na kṛtaṃ hatā gatiḥ |	བདག་གིས་ཇི་ལྟར་དེ་བཞིན་འདི་མ་བྱས་༎ ཅི་སྟེ་དེ་ལྟར་དེ་བྱས་འགྲོ་བ་ཉམས་༎ བདག་གིས་ཅི་སྟེ་འདི་ལྟར་འཆི་བདག་ནི་༎
 kathamevamayaṃ mayāstakaḥ śirasi nyastapado na lakṣitaḥ || śl_30 ||	མགོ་བོར་རྡོག་པས་གནོན་པ་འཕྲིགས་མ་གྱུར་༎ མྱ་ངན་རྡོ་རྗེ་དེ་ལྟ་དེ་ལྟ་བུར་༎
 iti x x x cittamādhibhiḥ kukṛtaiḥ śokamayairupadrutaḥ |	སེམས་ལ་གནོད་པ་རྣམས་ཀྱིས་དེ་གཙེས་ནས་༎ ཉེ་དུའི་སྐྱེ་བོ་དུད་མོའི་མཆི་རྒྱུན་ཅན་༎ སྡུག་བསྔལ་སྙིང་ནི་རྡོ་རྗེ་ལྟ་བུས་བལྟས་༎
 vyadhitena savāṣpavāriṇā karuṇaṃ bandhujanena vīkṣitaḥ || śl_31 ||	གནད་ཀྱི་གཤིས་སུ་འཇེབས་པར་གཟིར་ནས་ནི་༎
 vinipīḍitamarmabandhanastimiraṃ ghorataraṃ viśanniva | vijahāti nijaṃ kaḍevaraṃ dayitaṃ yatnapareṇa rakṣitam || śl_32 ||	ཤིན་ཏུ་མི་བཟད་མུན་རུམ་འཇུག་པར་འགྱུར་༎ འབད་པ་ལྷུར་བླངས་སྲུང་བ་བྱས་པའི་ལུས་༎ ཡིད་འོང་འདྲིས་པ་རྣམ་པར་འདོར་བར་འགྱུར་༎
 sa virauti gṛhītamūrdhajo yamadūtairdṛḍhapāśasaṃyataḥ |	གཤིན་རྗེའི་ཞགས་པས་དམ་དུ་བཏགས་པ་སྟེ་༎ ཅོ་དོ་འབལ་ཞིང་ཆོ་དེས་འདེབས་བྱེད་ཀྱང་༎
 na śṛṇoti jano 'sya bhāṣitaṃ svakṛtākrandaravādivākulaḥ || śl_33 ||	དེ་ཡིས་གླེངས་པ་ཉེ་དུའི་སྐྱེ་བོ་ཡིས་༎ རང་གི་དུས་སྒྲ་ལྡིར་བ་བཞིན་མི་ཐོས་༎ བགྲོད་དཀའ་ཆུ་དང་ཕ་བང་ཐག་ཐུག་འདོམ་པའི་བར་༎
 prastāraśailasaridantaradurgameṣu mārgeṣu tīkṣṇatarakaṇṭakasaṃkaṭeṣu |	ཚེར་མ་རྣོན་པོས་འཛིངས་པ་ཉམ་ངའི་ལམ་དག་དུ་༎ དུས་ཀྱི་ཞག་ས་པས་སྐེ་ནས་བཏགས་ཏེ་གཤིན་རྗེའི་མི་༎
 ghoraiḥ kṛtāntapuruṣairyamadaṇḍaghātamākṛṣyate galaniṣevitakālapāśaḥ || śl_34 ||	གཏུམ་པོ་རྣམས་ཀྱིས་དབྱུག་པས་བདའ་ཞིང་ཁྲིད་པར་འགྱུར་༎ མི་བཟད་སྐམ་པས་རྒྱང་༄༤༨བ་ནས་ཆུ་ཀླུང་དྲི་མེད་པ་༎
 dūrānnirīkṣya vimalaṃ salilaṃ pipāsurabhyeti gāḍhatṛṣito yadayaṃ tadeva |	མཐོང་ནས་བཏུང་བར་འདོད་དེ་སོང་ན་དེ་ཉིད་ཀྱང་༎
 keśaughaśaivalavimiśritapūtipūyapaṅkāpaṅkitaṃ kṣatajavaṃ jalatā prayāti || śl_35 ||	སྐྲ་ཤད་ཉ་ལྕིབས་ཚོགས་དང་རྣག་སུངས་འདྲེས་པ་དང་༎ འདམ་རྫབ་ཁྲག་དང་བྱི་སས་གང་བའི་ཆུར་འགྱུར་རོ་༎
 velānilākulitaśīkaraśītasānumānīlacandanataruṃ malayaṃ prayāti |	དུས་རླབས་རླུང་ལངས་ཆུ་འཐོར་རི་རྩེ་བསིལ་འགྱུར་ཞིང་༎
 so 'pyasya caṇḍavanadāvaśikhāvalīḍhaśīrṇolmukaprakaradanturatāṃ prayāti || śl_36 ||	ཙན་དན་ལྗོན་པ་སྔོན་འཁྲུངས་མ་ལ་ཡར་སོང་ནས་༏་། དེ་ཡང་འདི་ལ་ནགས་སྲེག་མེ་ལྕེ་རྣོས་འཁྲིགས་ཤིང་༎ མགལ་དུམ་འགྱེལ་བ་མང་པོས་རད་རོད་ཅན་དུ་འགྱུར་༎
 yadyeti vārinidhimudvatabhīmalolakallolabhedajanitolvaṇaphenahāsam |	ཆུ་གཏེར་རླབས་འཇིགས་འཕང་མཐོ་གྱེས་པ་ལས་བྱུང་བའི་༎ དབུ་བ་ཚེར་མ་ལྷག་གེ་སྟུག་པར་སོང་ན་ཡང་༎ དེ་ཡང་འདི་ལ་བྱེ་ཚན་ཁུ་བ་དམར་རྩུབ་པའི་༎ རླུང་དམར་འཇེབས་པ་འཚུབ་པའི་མྱ་ངན་ཉིད་དུ་འགྱུར་༎ འདི་ནི་དེ་གནས་ཆར་སྦྲིན་ལྡང་བར་འདོད་ན་ཡང་༎
 so 'pyasya taptaviṣadāruṇasaikatābhravibhrāntakarkaśamarunmarutāṃ prayāti || śl_37 ||	སྦྲིན་ལས་ལྕགས་མདའི་ཆར་པ་དུད་འཐུལ་མདག་མར་བཅས་༎
 tatra sthitasya jaladāgamaśaṃsino 'sya sāṅgāradhūmakuliśopalavisphuliṅgam |	ཚ་ཚ་རྡོ་རྗེའི་ཕ་བང་དམར་འཕྲོག་སེར་མདོག་ལྟ་བུ་ཡི་༎
 vidyullatākanakarājipiśaṅgamaṅge nārācavarṣamabhivarṣati vārivahaḥ || śl_38 ||	གློག་ཕྲེང་དམར་སེར་འགྱུ་བ་ལུས་ལ་ཆར་དུ་འབབ་༎ ཆ་བས་ཉེན་ལ་བུ་ཡུག་ཀྱང་ནི་ཚར་འགྱུར་ལ་༎
 tāpārditasya dahanaṃ tu hitānilo 'pi śītārditasya dahano 'pi karoti śītam |	ལྷགས་པས་ཉམ་ཐག་པ་ལ་མེ་ཡང་གྲང་བྱེད་དོ་༎ ཤིན་ཏུ་མི་བཟད་ལས་ཡོངས་སྨིན་པས་རྣམ་རྨོངས་པ་༎
 atyugrakarmapariṇāmavimohitasya viśvaṃ tadāsya viparītamidaṃ vibhāti || śl_39 ||	འདི་ལ་སྣ་ཚོགས་འདི་ཀུན་ཕྱིན་ཅི་ལོག་ཏུ་སྣང་༎ ཁབ་མིག་ཙམ་གྱི་ཁ་ལ་དཔག་ཚད་མད་འཇིགས་པའི་༎
 śūcīmukhasya bahuyojanabhīmakukṣerārtasya vāripibato 'pi mahāsamudre |	ལྟོ་ཅན་ཉམ་ཐག་རྒྱ་མཚོ་ཆེན་པོའི་ཆུ་འཐུང་ཀྱང་༎ མགུལ་ཕུགས་ཡངས་པ་ཉིད་དུ་ཕྱིན་པར་མ་གྱུར་པར་༎
 aprāpta eva pṛthukaṇṭhadarīprapātaśleṣmoṣmaṇā jalalavaḥ pariśoṣameti || śl_40	ཁ་ཡི་དུགས་ཀྱིས་ཆུ་ཡི་ཐིགས་པ་སྐམ་པར་འགྱུར་༎ རལ་པའི་ཚོགས་མང་སྤུངས་པས་བསྒྱིངས་པའི་ཁྱི་དག་གིས་༎ མཆེ་བ་གཙོང་རིངས་རྡོ་རྗེའི་རྩེ་མོས་ལུས་དབད་ཅིང་༎ ཆུ་བོ་རབ་མེད་ཐལ་སྐྱོ་མེ་ལྕེས་གང་བའི་དོགས་༎ རྡོ་བཟུར་རྣོན་མི་བཟད་རྩེ་རྣོན་ཅན་དུ་བདས་༎
 cañcacchaṭānika x pīvarasārameyadaṃṣṭrāṅkurāgrakuliśakṣatacūrṇitāṅgaḥ |	སྦུ་གྲི་རྣོས་གཏམས་ལྕུག་ཆལ་ལོ་མ་རལ་གྲི་ཡི་༎ ནང་དུ་ཐང་ཆད་རྒྱུགས་ན་ལུས་སྨས་སྐྱབས་མེད་པ་༎
 kṣārāmbupūrṇataravaitaraṇītaṭeṣu niṣkṛṣyate viṣamakoṭiśitopaleṣu || śl_41 ||	རྩེ་གསུམ་མདུང་ཐུང་དང་ནི་རལ་གྲི་རྣོས་གར་བའི་༎
 dhāvañjavena niśitakṣurasaṃstareṣu vicchinnamūrtirasipattralatāvaneṣu |	ཁྲོན་པ་གཤིན་རྗེའི་ཁ་བས་ཐུ་བའི་ནང་དུ་ལྷུང་༎
 kūpe patatyaśaraṇaḥ śitaśūlaśaktiprāsāsihāsanijitāntakavaktrarandhe || śl_42 ||	ཉི་ཚན་གྱིས་གདུང་བཟོད་དཀའ་རླག་པར་དགའ་བའི་ལུས་༎
 tīvrātapakvaṣitaduḥsahākhinnadeho vṛkṣānnirīkṣya ghananīladalānupaiti | tatpattraśastraśatapātavibhinnamūrtistatraiva tiṣṭhati ciraṃ virutaikabandhuḥ || śl_43 ||	ལྗོན་ཤིང་ལོ་མ་སྔོ་སྟུག་མཐོང་ནས་སོང་བ་དང་༎ དེ་ཡི་ལོ་མ་མཚོན་བརྒྱ་ལྷུང་བས་ལུས་དབད་ཅིང་། དེ་ན་ཡུན་རིང་དུད་མོ་ལས་ཤེས་བརླག་པར་གནས་༎ བུད་མེད་ཀུན་ནས་མེ་ལྕེ་བརྒྱ་ཕྲག་འཐོན་པའི་མི་༎
 paryantanirgataśikhāśatavisphuliṅgamālākulajvalitamaṇḍanamaṇḍitābhiḥ |	མེ་སྟག་ཕྲེང་བ་འཁྲིགས་པའི་རྒྱན་གྱིས་༄༤༩ཨ་༌་༎ གཞག་གྱུར་ཅིང་༎
 premāntarapraṇayanirdayamaṅganābhirāliṅgyate krakacakarkaśavigrahābhiḥ || śl_44 || śailābhabhīṣaṇavisaṃkaṭameṣayūthasaṃghaṭṭacūrṇitaviśīrṇasamastagātraḥ |	སོག་ལེ་ལྟ་བུའི་རྩུབ་པའི་ལུས་ཀྱི་ཟོན་མེད་པ་། ཤིན་ཏུ་སྡུག་པའི་ཚུལ་དུ་བཅུམ་ནས་འཁྱུད་པར་བྱེད་༎ རི་དང་མཉམ་དུ་ལུག་རུ་འཇིགས་སུ་རུང་བ་གཉིས་༎ འདུས་པའི་ཕྲག་ཏུ་ལུས་ཀུན་ཕྱེ་མར་རློག་ཅིང་འཇོམས་༎
 āpātavātalavaśaityasamarpitāsuḥ saṃcūrṇyate punarasau śataśastathaiva || śl_45 ||	ཅུང་ཟད་བསིལ་བའི་རླུང་ཞེག་ལངས་པས་བརྟས་ནས་དེ་༎ དེ་བཞིན་ཕྱིར་ཡང་ལན་བརྒྱར་ཀུན་ནས་ཕྱེ་མར་རློག་། 
 uttrāsito mukharakhaḍgaśivāsahasrairārohati drutapadaṃ punareva raudrān |	བསེ་ཁྱི་བོང་བུ་ཅེ་སྦྱང་སྟོང་ཕྲག་གིས་བྲེད་ནས་༎ ཤལ་མ་རི་མཐོ་མི་བཟད་དེ་ལ་མྱུར་འཛེགས་ན་༎
 tāṃ kūṭaśālmalimadhomukhakaṇṭhakaughanirbhidyamānavapurarpitagāḍhaśalyaḥ || śl_46 ||	ཚེར་མའི་ཚོགས་ཁ་ཐུར་དུ་བལྟས་པས་ཐལ་འབྱིན་ཅིང་༎ ཟུག་རྡུ་ཚབས་བོ་ཆེ་དག་ཁོང་རླག་ནུབ་པར་འགྱུར་༎
 mṛtyoḥ karāntagalitairiva kālapāśairāśīviṣairdhṛtaphaṇairdṛḍhasaṃyatasya |	གཤིན་རྗེའི་ལག་ན་ཐོགས་པ་དུས་ཀྱི་ཞགས་པ་ལྟའི་༎ སྦྲུལ་སྡུག་མགོ་འཕང་བསྟོད་པས་དམ་གཞག་གཞུངས་ནས་ནི་།
 utpāṭayanti nayane sphurataḥ prasahya tatra sthitasya bakavāyasakaṅkagṛdhrāḥ || śl_47 ||	གསོན་པོར་ཁ་དང་བྱ་གར་ཀང་ཀ་བྱ་རྒོད་ཀྱིས་༎ དེ་ན་གནས་པའི་མིག་དག་ཚམ་ཚོམ་མེད་པར་འདྲུ་༎
 teṣāṃ mukhaiḥ kuliśakoṭinibhaiḥ prasahya nidrāyamānavapureṣa kṛtārtanādaḥ |	དེ་ལུས་དེ་དག་གི་མཆུ་རྡོ་རྗེ་རྩེ་མོ་ལྟས་༏་། བརྩམ་པ་མེད་དབང་ཉམ་ཐག་ང་རོ་འབྱིན་བྱེད་ཅིང་༎ ཐུར་དུ་བབས་ན་ལྕགས་ཚེར་གྱེན་དུ་ཁ་བལྟས་པ་༎
 lohonmukhapracurapīvaratīkṣṇaśaṅkunirbhinnamūrtiravarohati naṣṭacetāḥ || śl_48 ||	སྦོམ་བ་རྣོ་བ་མང་པོས་ལུས་ཕུག་དྲན་པ་ཉམས་༎
 ādīptaśūlaśitaśalyavibhinnadehāstatraiva kecidavaroḍhumaśaknuvantaḥ |	དེ་བས་ཁ་ཅིག་མདུང་རྩེ་གསུམ་པ་འབར་བ་དང་༎ ཟུག་རྡུ་རྣོན་པོས་ལུས་དབང་ཐུར་དུ་འབབ་མི་ནུས་༎
 ghorairyadā niśitaśastramukhairayobhirākṛṣyamāṇavisaradgalitāntrasūtrāḥ || śl_49 ||	དེ་ཚེ་མཚོན་ཆ་བདར་བའི་མཆུ་ཅན་ཁབ༹་རྣམས་ཀྱིས་༎ ཀུན་དུ་དྲངས་པས་རྒྱུ་ལྟོ་བྲང་བྲེང་ནར་ཞང་འཐོར་༎ ཁ་ཅིག་རི་བོའི་ག-ཡང་ས་ཡ་ངར་ག-ཡང་དུ་ལྷུང་༎
 kecitpatanti viṣameṣū girestaṭeṣu kecitparikvaṣitatailakaṭāhakukṣau |	ཁ་ཅིག་འབྲུ་མར་སྐོལ་བའི་ཟངས་ཆེན་ནང་དུ་ལྟུང་༎ གཞན་དག་ཕྱེ་མ་སྲེག་པ་མེ་སྟག་འཕྲོ་བ་ཡི་༎ ས་གཞི་རྐང་པ་གཞག་པའི་གནས་མི་ཐོད་པར་ལྷུང་༎ ཁ་ཅིག་འབུ་སྦྲང་ཕྲ་མོ་ལྕིག་ལྕིག་འདུག་པ་ཡི་༎ ཚོགས་ཀྱིས་ལུས་རྨུགས་བམ་ཞིང་རྣམ་པར་འདྲུལ་༎ ལས་ཀྱི་རང་བཞིན་སྙི་ལ་འཚོ་བ་ཐོགས་པ་རྣམས་༎ བསྐྱོད་པ་ཙམ་ཡང་བྱ་བར་མི་ནུས་བཞིན་དུ་གསོན་༎
 uttaptavālukabhuvaṃ visṛtasphuliṅgāmenya viśanti padasaṅgamanāpnuvantaḥ || śl_50 ||	ལྷགས་པ་དཔེ་མེད་རུས་བ་ལ་ཡང་ཐིམ་པ་ཡིས་༏་། ལུས་སྦྲེབས་འདར་ཞིང་བསྐུར་ནས་གུམ་གུམ་པོར་འདུག་པ་༎
 eke punaḥ simisimāyitamūkṣmajantusaṃghātajarjaritasūnavipūtikāyāḥ | saṃcālamātramapi hartumaśaknuvanto jīvanti karmamayapāśanibaddhajīvāḥ || śl_51 ||	ཆུ་བུར་བརྒྱ་བྱུང་རྡོལ་བ་ལས་སྐྱེས་སྲོག་ཆགས་ཀྱི་༎
 asthīnyapi praṇayatā rahitopamena śītena jarjaritavepitapiṇḍitāṅgāḥ | utpannabhinnapiṭakā śatajātajantujagdhakṣataśrutasamajjavaśālaśīkāḥ || śl_52 ||	རལ་གྲིས་དབད་ནས་ཞག་དང་ཆུ་སེར་རྐང་བཅས་འཛག་། 
 saṃdaṣṭalagnadaśanāstanulomakeśāḥ saṃghaṭṭitavyadhitalocanakarṇakaṇṭhāḥ |	དཀོས་ཐག་སོ་འཐམས་སྐྲ་དང་སྤུ་རྣམས་ག-ཡེངས་གྱུར་པ་༎ མིག་དང་རྣ་བ་ལྐོག་མ་གནོད་༄༤༩བ་པས་ཀུན་གཞིར་ཞིང་༎ ལུས་དང་སེམས་ཀྱི་བར་དག་རབ་ཏུ་ཀློང་གྱུར་ནས་༎
 ā cetaso jaḍataratvamupetakāyāstiṣṭhanti śītanarakeṣu bhṛśaṃ nadantaḥ || śl_53 ||	གྲང་བའི་དམྱལ་བར་གནས་ཤིང་ཤིན་ཏུ་འོ་དོད་འབོད་༎ དམྱལ་མེ་དུ་བ་མཆེད་དཀུ་མནམ་པ་འཐུལ་བས་གནམ་མདོག་འགྱུར་༎
 vikīrṇabahalogragandhakaṭudhūmadhūmrāntaraṃ vijṛmbhitaśikhākaraprakararudradigmaṇḍalam |	མེ་ལྕེའི་ལག་མང་རྣམ་པར་འཕྲོས་ནས་ཕྱོགས་ཀྱི་དཀྱིལ་འཁོར་ཁེབས་༏་། རུས་གོད་དཀར་དུམ་ཕྲེང་བའི་རྒྱན་གྱིས་སྤུད་པ་སྐྱི་ག-ཡའ་བ་༎
 sitāsthisakalāṭalīracitabhūṣaṇaṃ bhīṣaṇaṃ pravṛttamiva bhairavaṃ sasujacarma hāhāravam || śl_54 ||	གླང་ཆེན་པགས་གྱོན་བསྡིགས་ཐབས་ཀྱེ་མ་ཀྱི་ཧུད་ཟེར་བ་བཞིན་༎
 caṭacchaḍhaditi kvacitsphuradurusphuliṅgākulaṃ chamacchamaditi kṣaṇasthagitajṛmbhitaṃ medasi |	ལ་ལར་མེ་སྟག་ཆེ་འཕྲོ་འཁྲུག་པ་འུར་སྒྲ་ཏོག་ཡར་ལ་༎
 kaṭatkaṭaditi kvaṇantamuraso 'sthirandhrāntare patanti narakānalaṃ vijitakalpakālānalam || śl_55 ||	ཞག་གིས་བབ་ན་སྐད་ངན་བོད་པའི་རྩེ་ཞིལ་ཆིལ་ཆིལ་འབར་༎ བྲང་གི་རུས་པའི་ཁོང་དུ་ཐལ་ལ་ལྷག་ལྷག་སྒྲ་གྲགས་པ་༎ བསྐལ་པའི་དུས་ཀྱི་མེ་ཡིས་བསྐྱོད་དུ་མེད་པའི་ནང་དུ་ལྷུང་༎
 purāṇatṛṇajarjarajvalitaparśukā x x x x x x x x latālavo dhagiti vāntadīptārciṣaḥ |	གློ་ནས་རཙབ༹་སྐམ་རྙིང་ལས་སྦར་བ་ལྟ་བུར་མེ་ཚོགས་འབར་༎
 sphuṭajjaṭharaniḥsṛtaprasaradantrasaṃtrāsitāḥ vimuktagurughargharadhvanitamātraśeṣakriyāḥ || śl_56 ||	མགྲིན་དང་ཁ་ནས་མེ་ལྕེ་འབར་བ་དུད་བཅས་བསྟུད་མར་འབྱུང་༎ ཁོང་ལྟོ་གས་པ་ནས་ལུག་ནང་ཁྲོལ་ནར་བས་ཀུན་བྲེད་ཅིང་༎ བརྡ་མི་ཕྲད་པའི་སྐད་ཆེན་ཙམ་ཞིག་འདོན་པར་བྱེད་པར་ཟད་༎
 nirīkṣya vivarāntaraṃ muhurapāvṛtaṃ dūrataḥ prayānti kathamapyamī pramataduḥkhamokṣāśrayāḥ |	སྡུག་བསྔལ་ཆེ་ལས་ཐར་པར་འདོད་པས་དེ་དག་ཡང་དང་ཡང་༎ སྒོ་བྱེ་གསེབ་གཞན་མཐོང་ནས་ཐག་རིང་ཅི་ཞིག་ལྟར་ཏེ་འབྱེར་༎
 yadā tadapi ghaṭṭitaṃ bhavati karmapaṭṭairdṛḍhaistadā viphalavāñchitāḥ kimapi yānti duḥkhāntaram || śl_57 ||	གང་ཚེ་ལས་ཀྱི་སྒོ་འཕར་དམ་པོས་དེ་དེ་ཡང་བཅད་འགྱུར་པ་༎ དེ་ཚེ་ཡི་མུག་བཟོད་བླག་སྡུག་བསྔལ་གཞན་ཡང་འབྱུང་བར་འགྱུར་༎ མངའ་ཆེན་རྣོ་ཚོགས་འབར་བ་ཆར་བཞིན་འབབ་པའི་རྗེས་ལ་ཡང་༎ དམྱལ་བའི་སྲུང་མས་དབྱུག་པས་བཏབ་ཅིང་མཆི་མ་འཛག་བཞིན་དུ་༎
 jvalanniśitatomaraprakaravarṣaṇānantaraṃ dravīkṛtamayorasaṃ dahanaraśmimālākulam |	ལྕགས་ཞུན་ཁུ་བ་མ་སྟག་འབར་བའི་ཕྲེང་བས་འཁྲིགས་པ་ལྡུད་༎ ཁ་སྣ་རྣ་བའི་བུག་དག་ནས་དུད་འཐུལ་གྱེན་དུ་འབྱུང་༎
 pibanti galadasravo narakapāladaṇḍāhatā mukhaśravaṇanāsikāvivaralabdhadhūmodgamāḥ || śl_58 ||	མིག་དང་གླད་སྤྲིས་རྡོལ་གྱི་བར་དུ་ཀུན་སྲེག་ཅིང་༎
 ādagdhavisphuṭitanetraśiraḥ kapālamastiṣkadīpitapiśaṅgaśikhākalāpaḥ |	གླད་པའི་རྒྱས་ལ་འབར་བའི་མེ་ལྕེ་སྨུག་ནག་ཚོགས་༎ མེ་དེ་ཁྲོས་པ་ལྟ་བུར་དེ་ཡི་ལུས་ཕུང་ལ་༎
 śuṣkendhanaprakaranirdayatāmupaiti śokāgnikoṣa iva gātracayeṣu teṣām || śl_59 ||	བུད་ཤིང་སྐམ་པོ་བཅེར་ལ་སྦར་བ་བཞིན་དུ་མཆེད་༎ སྐྱེ་བོ་དེ་སྲོག་རིག་ཟར་ཀླུང་གི་ཆུ་ལྟར་ག-ཡོ་༎
 te jantavo girinadījalalolajīvā auṣṭhyaṃ tadeva narakeṣu ta eva cāgniḥ |	དམྱལ་བའི་མེ་ཡང་དེར་ཟད་ཚ་བའང་དེར་ཟད་དེ་༎
 karmāṇi tatkhalu tathā pariṇāmayanti sarvaṃ yathā paramadāruṇamāvibhāti || śl_60 ||	ལས་རྣམས་ཇི་ལྟར་ཐམས་ཅད་ཤིན་ཏུ་མི་བཟད་པ་༎ སྣང་བར་འགྱུར་བ་དེ་ལྟར་ཡོངས་སུ་སྒྱུར་པར་བྱེད་༎
 ātmīyakarmavivaśākulaveṣṭitasya muktasya pāpanilayānnirayāṃ kathaṃcit |	སྐྱེ་བོ་རང་གི་ལས་ཀྱིས་དབང་མེད་འཆལ་སྤྱོད་པ་༎ བརྒྱ་ལ་སྡིག་ནས་དམྱལ་བ་དག་ནས་ཐར་ན་ཡང་༎
 lokeṣvanantagatibhedabhayākuleṣu mānuṣyakaṃ paramadurlabhameva jantoḥ || śl_61 ||	འཇིག་རྟེན་འགྲོ་བ་མཐའ་དག་བྱེ་༄༥༠ཨ་༌་༎ བ་འཕྱེས་རྣམས་སུ་༎ མི་ཡི་དངོས་པོ་ཤིན་ཏུ་རྙེད་པར་དཀའ་བ་ཉིད་༎ གལ་ཏེ་ཀླ་ཀློ་དམྱལ་བའི་སྲུང་དང་སྤྱོད་མཚུངས་སམ་༎
 mleccheṣu vā narakapālasamavrateṣu tiryakṣu vā kṛtaparasparabhakṣaṇeṣu |	དུད་འགྲོ་ཕན་ཚུན་ཟ་བར་བྱེད་པའི་ནང་དག་ཏུ་༎
 jātiṃ labheta yadi tatra tadeva śīlamāsevate patati yena punaḥ prapātam || śl_62 ||	སྐྱེ་བ་ཐོབ་པར་འགྱུར་ན་གང་གི་ཕྱིར་ཡང་ནི་༎ ག-ཡང་དུ་ལྷུང་བར་འགྱུར་བའི་ངང་ཚུལ་དེ་ཉིད་བསྟེན་༎ གང་ཞིག་ཐོབ་ནས་སྐྱེ་བའི་རྒྱ་མཚོ་མཐར་འབྱིན་ཅིང་༎
 yatprāpya janmajaladherapi yānti pāramāropayanti śivamuttamabodhibījam |	བྱང་ཆུབ་མཆོག་གི་ས་བོན་དགེ་བའང་འདེབས་གྱུར་པ་༎ ཡིད་བཞིན་ནོར་བུ་བས་ཀྱང་ཡོན་ཏན་ལྷག་པ་ཡི་༎
 cintāmaṇerapi samabhyadhikaṃ guṇaughairmānuṣyakaṃ ka iha tadviphalīkaroti || śl_63 ||	མི་ཉིད་དེ་ནི་སུ་ཞིག་འབྲས་བུ་མེད་པར་བྱེད་༎ བདེ་གཤེགས་ལམ་བསྟེན་འགྲོ་བ་འདྲེན་པར་ཆས་གྱུར་ཅིང་༎ སེམས་ཀྱི་སྟོབས་ཆེན་མི་ཡིས་རྙེད་པ་གང་ཡིན་པའི་༎ ལམ་དེ་ལྷ་དང་ཀླུ་ཡིས་མི་རྙེད་ལྷ་མིན་དང་༎ མཁའ་ལྡིང་རིག་འཛིན་མིའམ་ཅི་སྟེ་ལྟོ་འཕྱེས་མིན་༎ མི་ཡི་དངོས་པོ་ཤིན་ཏུ་རྙེད་དཀའ་རྙེད་གྱུར་ནས་༎
 atyantadurlabhamupetya manuṣyabhāvaṃ yadvāñchitaṃ tadabhivāñchitameva kuryāt |	དོན་དུ་བརྣག་པ་གང་ཡིན་དེ་ནི་བརྟུན་ཏེ་བསྒྲུབ་༎ མར་མེའི་མེ་ལྕེ་ཤུགས་དྲག་རླུང་གིས་བསྐྱོད་པ་ལྟའི་༎
 caṇḍānilākulitadīpaśikhācalasya na hyāyuṣaḥ kṣaṇamapi sthitiniścayo'sti || śl_64 ||	ཚེ་ནི་སྐད་ཅིག་གནས་པའི་གདེངས་ཡང་ཡོད་མ་ཡིན་༎
 śvaḥ kāryametadidamadya paraṃ muhūrtādetatkṣaṇāditi janena vicintyamāne |	འདི་ནི་སང་བྱ་འདི་ནི་ཐང་ཅིག་འོག་ཏུ་བྱ་༎ འདི་ནི་དེའུ་རེ་བྱ་ཞེས་སྐྱེ་བོ་སེམས་པ་ན་༎
 tiryagnirīkṣaṇapiśaṅgitakāladaṇḍaḥ śaṅke hasatyasahanaḥ kupitaḥ kṛtāntaḥ || śl_65 ||	གཤིན་རྗེ་བེ་ཅོན་ནག་ཐོགས་ཟུར་གྱིས་ལྟ་བ་ཡི་༏་། མིག་རྩ་དམར་ཁྲོས་མ་རངས་གད་མོས་རེ་སྙམ་འདེབས་༎
 āyāti phullakusumaḥ kusumāgamo 'yameṣā śaśāṅkatilakā śaradāgateti |	སོས་ཀ་མེ་ཏོག་རྒྱས་པའི་དུས་འདེ་འབྱུང་བར་འགྱུར་༎ ཟླ་བ་གསལ་བས་མཚོན་པའི་སྟོན་དུས་འདི་འབྱུང་ཞེས་༎
 sarvaḥ prahṛṣyati jano na punarmamaitadāyuḥ prahīṇamiti yāti paraṃ viṣādam || śl_66 ||	སྐྱེ་བོ་ཐམས་ཅད་དགའ་འགྱུར་བདག་གི་ཚེ་འདི་ནི་༎ ཟད་པར་འགྱུར་ཞེས་ཤིན་ཏུ་མི་དགར་འགྱུར་བ་མེད་༎ ཟླ་བའི་དཀྱིལ་འཁོར་རྒྱས་པ་ཉེ་བར་བརྒྱན་བྱས་ཤིང་༎
 āsannapīnaśaśimaṇḍalamaṇḍanāsu viśrāntavāriguruvāridamekhalāsu |	རྐེད་འཆིངས་ཆར་ཆེན་སྤྲིན་གྱི་འཁྲིགས་པས་འཁྱུད་གྱུར་པ་༎ རི་རྩེའི་ནགས་ཀྱི་མཐོངས་དེར་ཆགས་པ་མེད་པ་ནི་༎ རླུང་ལྟར་ག-ཡོ་བའི་རང་བཞིན་ཚེ་གཏུགས་སྐལ་བ་ཆེ་༎ ནགས་མཐོངས་རི་དགས་རྒྱུ་བའི་ཚོགས་ཀྱིས་བསྟེན་བྱས་ལ་༎ ཀུན་ནས་ཉམས་དགའ་བཟང་པོ་དེ་ནི་སྐྱིད་པ་གང་༎ དེ་ཅི་དགའ་བའི་ནགས་ཚལ་ལྷ་མོའི་ཉམས་བག་ཏུ་༎ ཐེལ་གྱིས་འབེབས་པའི་རྡོ་ལེབ་ཅན་ལ་ཡོད་འགྱུར་སྙམ་༎
 niḥsaṅgamāsu giriśṛṅgavanasthalīṣu dhanyā nayantyanilacañcalaśīlamāyuḥ || śl_67 ||	ནགས་ཀླུང་ཆུ་གཙང་དོགས་ཀྱི་དབེན་པ་སྐྱིད་པ་གང་༎
 kiṃ sā ratirbhavati nandanabhūmikāsu divyāṅganājaghanapṛṣṭhaśilātalāsu | yā mugdhamugdhaharaṇīgaṇasevitāsu niḥsaṅgacārusubhagāsu vanasthalīṣu || śl_68 ||	༄༥༠བ་དེ་ཅི་ལྷ་ཡི་བུ་མོ་དྲི་ཞིམ་བྱུགས་པ་ཡི་༎ ལན་བུའི་རྒྱན་དུ་ཐོགས་པའི་རྒྱུ་ལྡན་མེ་ཏོག་ཚོགས་༎ མཛེས་པའི་ཟིལ་གནོན་ལྷ་ཡི་ཆུ་ལའང་ཡོད་འགྱུར་རམ་༎ རྩ་བ་འབྲས་བུ་ཤུན་པ་ལོ་མ་ཕུན་སུམ་ཚོགས་པའི་ལྗོན་ཤིང་ལྡན་༎ ནགས་ཚལ་ལྟོས་མེད་རི་བོའི་ཆུ་རྒྱུན་བསིལ་འབབ་ཆགས་པ་མེད་པའི་གནས་༎
 divyāṅganāparimalāvilaye nibhinnasaṃtānakastavakahāsavitaṇvanīṣu |	ཆུ་ཀླུང་ཡངས་པའི་མཐའ་རུ་འབྲས་བུ་མེ་ཏོག་ལྷུང་བས་བརྒྱན་པ་ཡི་༎ ཉམས་དགའ་བས་མཐར་ཅི་ཞིག་མེད་དེ་དམྱལ་སྡོང་ཁྱིམ་གྱིས་བསླུས་ཏེ་སྡོད་༎
 kiṃ sā ratiḥ surasaritsu viviktaramyatīrāsu yā śucijalāsu vane nadīṣu || śl_69 ||	རི་སུལ་ཡངས་པར་སྐྱེ་བོ་བུན་ལོང་མེད་པས་རབ་བདེ་བ་༎
 viśālāḥ śailānāṃ viratajanasaṃpātasubhagā guhā gāḍhābhogā haritavanalekhāparikarāḥ |	ཉེར་སྤྱོད་རྒྱ་ཆེན་ནགས་ཚལ་སྡོ་འཁྲུངས་ཕྲེང་བས་སྦྲེངས་༎
 sarittīrāsannā surajamadhurairnirjanaravairna gamyāḥ kleśāgnerayamiti vadantīva pathikān || śl_70 ||	ཆུ་དོགས་སྙན་པ་ཕུ་ཆུའི་རྒྱུན་འདྲ་རྔ་ལྟར་སྙན་པ་ཡིས་༎ བདག་ཅག་ཉོན་མོངས་ཡུལ་མ་ཡིན་ཞེས་འདོན་ལ་སྒྲོགས་པ་བཞིན་༎
 māyāmarīcidakacandrataraṃgakalpāḥ kāmā jinena gaditā vibhavāḥ striyaśca |	འདོད་པ་རྣམས་དང་འབྱོར་དང་སྲིད་གསུམ་རྒྱལ་བ་ཡིས་༎ སྒྱུ་མ་སྨིག་རྒྱུ་ཆུ་ཟླ་དཔའ་རླབས་འདྲ་བར་གསུངས་༎
 svapnāntadurlabhitavibhramavipralabdhā bālāḥ patanti nirayeṣvapi yeṣu saktāḥ || śl_71 ||	རྨི་ལམ་ལྟ་བུའི་ངན་སྤྱོད་འཁྲུལ་བས་བསླུས་པ་ཡི་༎ བྱིས་པ་གང་དག་དེ་ལ་ཆགས་པ་དམྱལ་བར་ལྟུང་༎ ཡུལ་དང་དུག་མཚུངས་དང་པོ་མྱོད་བ་ཙམ་ན་བདེ་༎
 āpātamātramadhurā viṣayā viṣaśca ghorā viṣākakaṭukā viṣayā viṣaśca |	ཡུལ་དང་དུག་མཚུངས་རྣམ་སྨིན་རྩུབ་པས་མི་བཟད་པ་༎ ཡུལ་དང་དུག་མཆུངས་གཏི་མུག་མུན་པས་ཐིབས་པོར་བྱེད་༎
 mohāndhakāragahanā viṣayā viṣaśca durvāravegacapalā viṣayā viṣaśca || śl_72 ||	ཡུལ་དང་དུག་མཚུངས་ཤུགས་བཟློག་དཀའ་ཞིང་ག-ཡོ་བ་ཡིན་༎ དུག་དང་ཡུལ་རྣམས་བློ་ཡིས་ངེས་པར་བརྟགས་བྱས་ན་༎
 kāmā viṣaśca viṣayāśca nirūpyamānāḥ śreyo viṣaṃ na viṣayā viṣamasvabhāvāḥ |	ཉིས་ན་དུག་བླ་མི་བཟད་རང་བཞིན་ཡུལ་རྣམས་མིན་༎ དུག་ནི་སྐྱེ་བ་གཅིག་ལ་དུག་ཏུ་འགྱུར་བར་ཟད་༎
 ekatra janmani viṣaṃ viṣatāṃ prayāti janmāntare 'pi viṣayā viṣatāṃ prayānti || śl_73 || viṣasya viṣayāṇāṃ ca dūramatyantagocaram | upayuktaṃ viṣaṃ hanti viṣayāḥ smaraṇādapi || śl_74 ||	ཡུལ་ནི་ཚེ་རབས་གཞན་ལའང་དུག་ཏུ་འགྱུར་བར་བྱེད་༎ དུག་ནི་དུག་དང་བསྲེས་ནས་རབ་ཏུ་ཞི་བར་འགྱུར་༎
 saṃsṛṣṭaṃ vrajati viṣaṃ viṣeṇa śāntiṃ sanmantrairagadadharaiśca sādhyamānam |	གསང་སྔགས་མཆོག་དང་དུག་སེལ་སྨན་གྱིས་གསོ་བར་རུང་༎ དུག་ནི་ཐབས་ལྡན་སྤྱད་ན་མི་ལ་ཕན་འགྱུར་གྱི་༎
 yuktaṃ vā bhavati viṣaṃ hitāya nṝṇāṃ na tvevaṃ viṣayamahāviṣaṃ kadācit || śl_75 ||	དུག་ཆེན་ཡུལ་ནི་ནམ་ཡང་དེ་ལྟ་མ་ཡིན་ནོ་༎ ཇི་ལྟར་གླང་བུ་ཁྲོན་ཟབ་ཁ་ནས་འཁྲུངས་པ་ཡི་༎
 yadvadvṛṣo viṣamakūpataṭāntatrūḍho dūrvāpravālalavalālasamānasaḥ san |	རཙབ༹་ལོ་ཁམ་འགའ་ཙམ་ལ་ཡིད་ནི་ཆགས་གྱུར་པ་༎ རྙེད་པ་གྲུབ་པ་མེད་པར་ག-ཡང་དུ་ལྟུང་བ་ལྟར་༎
 śvabhre patatyatha ca nāstu ta eva lābhastadvatsukhānvitamatiḥ khalu jīvalokaḥ || śl_76 ||	འཚོ་བའི་འཇིག་རྟེན་བདེ་ལྡན་འདོད་པའང་དེ་དང་འདྲ་༎
 mandākinījalarayākulitālakābhiḥ krīḍāvihāramanubhūya sahāpsarobhiḥ | bhūyo bhramanti kharavaitaraṇe taraṃgasaṃparkajarjaritadāruṇaduḥkhabhājaḥ || śl_77 ||	ལྷ་ཡི་བུ་མོ་དལ་གྱིས་འབབ་པའི་ཆུ་རྒྱུན་གྱིས་༎ འཕྲལ་ཐབས་ཀློང་པ་རྣམས་དང་ལྷན་ཅིག་རྩེ་མྱོང་༄༥༡ཨ་༌་༎ ནས་༏་། ཕྱེར་ཡང་ཆུ་བོ་རབ་མེད་རྦ་དྲག་འབོགས་པ་ཡིས་༎ སྨས་པའི་སྡུག་བསྔལ་མི་བཟད་བསྟན་པར་བྱ་དགོས་སོ་༎
 āstīrṇakalpatarupallvasaṃstareṣu kāntāsakhāḥ suravaneṣu makhaṃ vihṛtya |	ལྷ་ཚལ་དཔག་བསམ་ཤིང་ལོའི་གདིང་བ་ཀུན་བཀྲམ་པར་༎ ལྷ་ཡི་བུ་མོ་དང་བསྟེན་བདེ་བར་གནས་ནས་ཀྱང་༎ ཕྱིར་ཡང་མཚོན་རྣོན་མང་པོ་འབབ་པས་ལུས་དབང་པ་༎ ལོ་མ་རལ་གྲི་ལྟ་བུའི་ནགས་ཚལ་བགྲོད་དགོས་སོ་༎ རྐང་བཞག་ནེམས་དང་འཕར་བྱེད་རེག་ན་བདེ་བ་ཡི་༎ རི་རབ་སྤོ་ཡི་དཀྱིལ་དུ་ཡུན་རིང་གནས་ནས་ཀྱང་༎
 bhūyo bhramanti niśitākulaśastrapātavicchinnagātramasipattravanasthalīṣu || śl_78 || sparśe sukhāsu padapātanatonnatāsu merornitambapadavīṣu ciraṃ vihṛtya | uttaptasaikatakukūlakṛśānurāśiṃ saṃsīryamāṇacaraṇorubhujo bhramanti || śl_79 ||	ཕྱིར་ཡང་བྱེ་མ་བསྲེགས་པའི་མེ་མ་མུར་གྱི་ཚོགས་༎ བརླ་དང་རྐང་ལག་ཀུན་དུ་ཞིག་པར་འཁྱམ་པར་འགྱུར་༎
 gatvā divaṃ mukharabhāsurakiṅkanīkahārāvalīnikaradanturitairvimānaiḥ |	དྲིལ་བུ་མཛེས་ཁྲོལ་མུ་ཏིག་ཕྲེང་ཚོགས་ལྷག་གེ་བ་༎ གཞལ་མེད་ཁང་དུ་ཞུགས་ཏེ་ལྷ་ཡུལ་བགྲོད་ནས་ཀྱང་༎
 ghoraṃ sthirāśrayamameyamanantapāramandhaṃ tamaḥ punaradhaḥśirasā patanti || śl_80 ||	མི་བཟད་སྐྱབས་མེད་མུན་ནག་ཐིབས་པོ་དཔག་མེད་པ་༎ ཕ་མཐའ་མེད་པའི་ནང་དུ་སྤྱི་ཚུགས་ལྟུང་བར་འགྱུར་༎
 śakro 'pi yatra surakiṃnaranāgayakṣamauliprabhāprakarapiñjarapādapīṭhaḥ |	གང་དུ་ལྷ་ཀླུ་མིའམ་ཅི་ཡི་མགོ་རྒྱན་གྱི་༏་།འོད་ཀྱི་ཚོགས་ཀྱིས་རྐང་རྟེན་དམར་བའི་བརྒྱ་བྱིན་ཡང་༎
 karmānilākulagatiḥ kugatiḥ prayāti ko nāma tatra puruṣo na bhayaṃ bhajeta || śl_81 ||	ལས་ཀྱི་རླུང་འཁྲུགས་འགྲོ་བ་ངན་པར་འགྲོ་འགྱུར་བ་༎ དེ་ལ་སྐྱེས་བུ་སུ་ཞིག་འཇིགས་པ་བསྟན་མི་བྱེད་༎
 pramlāyamānakusumāḥ śru x x x digdhā mlānāmbarāḥ karuṇadīkṣitabandhuvargāḥ |	མེ་ཏོག་རབ་ཏུ་རྙིངས་ཤིང་ལུས་རྡུལ་ཐོན་པ་དང་༎ གོས་རྙིང་སྨྲེ་ཞིང་ཉེ་དུ་རྣམས་ལ་ལྟ་བ་ཡིས་༎
 duḥkhaṃ paraṃ yadamarā maraṇe vrajanti tanmānavā na jalabudbudalolajīvāḥ || śl_82 ||	ལྷ་རྣམས་འཆི་བའི་རབ་ཏུ་སྡུག་བསྔལ་གང་ཡིན་དེ་༎ འཚོ་བ་ཆུ་བུར་ལྟ་བུར་ག-ཡོ་བའི་མི་ལ་མེད་༎
 duḥkhāgniprakaranirodhabhairave 'sminyaloke vahati janaḥ sukhābhimānam | tanmatyorvadanamapāvṛtaṃ viśālaṃ tadbījaṃ punarapi janmapādapasya || śl_83 || taṃ tṛṣṇāmayadṛḍhadīrghatantubaddhaṃ paryastapraṇihitabhīmakāladaṇḍam |	སྡུག་བསྔལ་མེ་ཚོགས་འཕུང་བས་འཇིགས་པའི་འཇིག་རྟེན་འདིར་༎ སྐྱེ་བོ་བདེ་སྙམ་མངོན་པའི་ང་རྒྱལ་བྱེད་པ་དང་༎ དེ་ནི་གཤིན་རྗེའི་ཁ་ཡངས་འབྱེད་པར་བྱེད་པ་སྟེ་༎ དེ་ནི་སྐྱེ་བ་ཕྱི་མའི་ལྗོན་ཤིང་ས་བོན་ཡིན་༎ དེ་ནི་གཤིན་རྗེས་སྲིད་མཚོར་རྒྱུ་བའི་སེམས་ཅན་ལ་༎ ལོག་པར་སྨོན་པའི་འཇིགས་པ་དབྱིག་པ་ནག་པོའི་རྩེར་༎ སྲེད་པའི་ཐ་གུ་རིང་པོས་དམ་བཞག་བཏགས་པ་ཡི་༎
 sattvānāṃ bhavajaladhau pariplutānāṃ matsyanāṃ baḍiśamivāntakena dattam || śl_84 ||	མཆིལ་པས་ཉ་ལ་བྱ་བ་བཞིན་དུ་བཏབ་པ་ཡིན་༎
 kumbhīpākakvathitakalilāduṣṇasaṃrambhavegātkṛtvodgrīvaṃ kṣaṇamapi sukhaṃ labdhaniśvāsamokṣāḥ |	དམྱལ་རྣམས་ཟངས་ཆེན་ལྷག་ལྷག་སྐོལ་བ་ཚ་བའི་ཤུགས་དྲག་ནས་༎ སྐད་ཅིག་ཙམ་ཞིག་མགོ་སྟོད་དབུགས་འབྱིན་འགྱུར་བ་རྣམས་༎
 krodhāpūrṇaiḥ subahubhirayomudgaraistāḍyamānā manyate taṃ paramiva sukhaṃ nārakā yadvadeva || śl_85 ||	ལྕགས་ཀྱི་ཐོ་བ་རབ་ཏུ་མང་པོ་ཁྲོས་ཏེ་གཟས་པ་ཡིས་༎ བརྒྱབ་ན་དེ་ཉིད་མཆོག་ཏུ་བདེ་བ་ཡིན་པར་སེམས་པ་ལྟར་༎ དེ་བཞིན་སྡུག་བསྔལ་མི་བཟད་པ་ཡིས་དབང་མེད་རྟག་༄༥༡བ་གཟིར་ཅིང་༎ རེ་ཞིག་ཙམ་ཞིག་ཇི་ཞིག་ལྟར་ཏེ་སྐྱེ་ཤིའི་འཁྲུགས་མེད་ནས་༎
 tadvadduḥkhairaniśamavaśo dāruṇaiḥ pīḍyamānastāvatkālaṃ jaraṇamaṇarakṣobhamuktaḥ kathaṃcit |	སྐད་ཅིག་སྡུག་བསྔལ་གཉུག་མར་བཟོད་དཀའ་མེ་ལྕེ་ཞིལ་གྱུར་ན་༎
 mandībhūte kṣaṇamapi nije duḥsahe duḥkhavahnau sarvo lokastanusukhalavagrāmatṛṣṇāṃ karoti || śl_86 ||	འཇིག་རྟེན་ཐམས་ཅད་བདེ་བ་ཁམ་འགའ་ལ་ཡང་སྲེད་པར་བྱེད་༎
 yāvadyāvajjagati sakale jāyate saukhyasaṃjñā tāvattāvadbahutaraśikho jāyate rāgabahniḥ |	ཇི་ལྟ་ཇི་ལྟར་འགྲོ་བ་ཀུན་ལ་བདེ་བའི་འདུ་ཤེས་བསྐྱེད་༎ དེ་ལྟ་དེ་ལྟར་གཏི་མུག་མུན་པ་ཤིན་ཏུ་སྟུག་པོར་འགྱུར་༎ ཇི་ལྟ་ཇི་ལྟར་འགྲོ་བ་ཀུན་ལ་སྡུག་བསྔལ་འདུ་ཤེས་བསྐྱེད་༎ དེ་ལྟ་དེ་ལྟར་གཏི་མུག་མུན་པ་ཤིན་ཏུ་སྲབ་མོར་འགྱུར་༎
 yāvadyāvadvisarati śubhā bhāvanā bhāvyamānā tāvattāvadbahalataratāmeti mohāndhakāram || śl_87 ||	ཇི་ལྟ་ཇི་ལྟར་སྡུག་པ་བསྒོམ་པ་ཤིན་ཏུ་རྣམ་འཕེལ་བ་༎ དེ་ལྟ་དེ་ལྟར་འདོད་ཆགས་མེ་ལྕེ་ཤིན་ཏུ་འཕྲོ་བར་འགྱུར་༎
 yāvadyāvanniyatamaśubhā bhāvanā yāti vṛddhim | tāvattāvattaralataratamiti mohāndhakāram || śl_88 ||	ཇི་ལྟ་ཇི་ལྟར་མི་སྡུག་བསྒོམ་པ་ཤིན་ཏུ་འཕེལ་འགྱུར་བ་༎ དེ་ལྟ་དེ་ལྟར་འདོད་ཆགས་མེ་ལྕེ་ཤིན་ཏུ་རྩེ་ཞིལ་འགྱུར་༎
 durgandhipūtivikṛtairaravindamindumindīvaraṃ ca tulayanti yadāṅganāṅgaiḥ |	བུད་མེད་ཡན་ལག་དྲིང་རུལ་པ་མི་སྡུག་དང་༎ པད་མའི་འདབ་མ་ཨཽཏཔལ་དག་ཏུ་སྙམ་བྱེད་པ་༎ སྙན་དངགས་མཁན་གྱི་བརྫུན་དེའི་འབྲས་བུ་མི་བཟད་པ་༎
 tasyānṛtasya phalamugramidaṃ kavīnāṃ tāsveva garbhanilayaṃ padamī viśanti || śl_89 ||	དེ་དག་དེ་ཡི་མངལ་གནས་འཇུག་པ་དེ་ཡིན་ནོ་༎
 kā saugatirjagati yā śataśo na yātā kiṃ tatsukhaṃ yadaśakṛnna purānubhūtam |	འགྲོ་བར་ལན་བརྒྱར་མ་སོན་འགྲོ་དེ་གང་ཞིག་ཡོད་༎ སྔོན་ཆད་ལན་མང་མ་མྱོང་བདེ་བ་དེ་གང་ཞིག་། 
 kāstāḥ śriyaścapalacāmaracāruhāsāḥ prāptā na yāstadapi vardhata eva rāgaḥ || śl_90 ||	རྔ་ཡབ་དཀར་མཛེས་ལྟ་བུའི་དཔལ་གང་མ་ཐོབ་པ་༎ དེ་ཡང་གང་ཞིག་ཡོད་ན་འོན་ཀྱང་འདོད་ཆགས་འཕེལ་༎ གང་གི་གླིང་བར་མ་གནས་ཆུ་བོ་དེ་ཡོང་མིན་༎
 nadyo na tā na vihṛtaṃ pulineṣu yāsāṃ sthānaṃ na tajjagati yatra kṛto na vāsaḥ |	ཡུལ་ཕྱོགས་གང་དུ་གནས་མ་བཅས་པའི་གནས་དེ་མེད་༎
 vyomnāpi tanna padamasti na yatra yātaṃ duṣpūraṇastadapi vardhata eva rāgaḥ || śl_91 ||	གང་དུ་མ་སོང་ནམ་མཁའི་ཕྱོགས་དེའང་ཡོད་མིན་ན་༎ འོན་ཀྱང་འདོད་ཆགས་དགང་དཀའ་འཕེལ་བར་འགྱུར་བ་ཉིད་༎
 duḥkhaṃ na tadyadasakṛnna purānubhūtaṃ kāmā na te jagati yairiha tṛptirāsīt |	སྔོན་ཆད་ལན་མང་མ་མྱོང་སྡུག་བསྔལ་དེ་ཡོད་མིན་༎ འགྲོ་བར་གང་གིས་ཚིམ་གྱུར་འདོད་པ་དེ་དག་མེད་།
 sattvo na so 'sti jaṭhare śayitaṃ na yasya saṃsāriṇastadapi nāsti kathaṃ virāgaḥ || śl_92 ||	གང་གི་ལྟོར་མཉལ་བའི་སེམས་ཅན་དེ་མེད་ན་༎ འོན་ཀྱང་ཇི་ལྟར་འཁོར་བ་ཅན་ལ་ཆགས་བྲལ་མེད་༎
 atyāyate jagati janmaparigrahe 'sminduḥkhe sukhe ca bahuśaḥ parivartamānaḥ |	སྐྱེ་བ་ཡོངས་སུ་འཛིན་པ་འགྲོ་བ་རྒྱ་ཆེན་འདིར་༎ བདེ་དང་སྡུག་བསྔལ་དག་ཏུ་ལན་མང་འགྲེ་ལྡོག་པ་༎
 nāsau jano jagati yo na babhūva bandhurdveṣoragastadapi tiṣṭhati bhīmabhogaḥ || śl_93 ||	འགྲོ་བ་གཉེན་མ་གྱུར་པའི་སྐྱེ་བོ་དེ་གང་མེད་༎ འོན་ཀྱང་ཞེ་སྡང་སྤྲུལ་གྱི་རང་བཞིན་འཇིགས་པར་གནས་༎
 yaiḥ sārdhametya hasitaṃ lalitaṃ pragītamekatra pītamaśitaṃ ca kṛtāśca goṣṭhyaḥ | kālakrameṇa gamitāḥ kati ke 'pi ramyā nītāḥ samāśca viṣamāśca daśāḥ kathaṃcit || śl_94 || tānārjavaṃ javavivartanadṛṣṭanaṣṭānāvartamadhyapatitāniva vīkṣyamāṇaḥ |	གང་དང་ལྷན་ཅིག་འདུས་ནས་བགད་ཅིང་རྩེས་པ་དང་༎ གླུ་བླངས་དགའ་འདུན་བྱས་ཤིང་གཅིག་ཏུ་ཟོས་འཐུངས་དང་༎ དུས་ཀྱི་རིམ་པས་མེ་ཏོག་རྣ་རྒྱན་དེངས་བྱས་དང་༎ གནས་སྐབས་ཅི་ཞིག་༄༥༢ཨ་༌་༎ ལྟར་མཉམ་མི་མཉམ་བྱས་པ་ཡི་༎
 saṃsārasāgaragatānapahāya bandhūnekaḥ prayāti yadi nāsti tataḥ kṛtaghnaḥ || śl_95 ||	ཉེ་དུ་འཁོར་བའི་རྒྱ་མཚོའི་ཁོངས་སུ་ཆུད་གྱུར་པ་༎ ཀློང་གི་ནང་དུ་ལྷུང་བ་ལྟ་བུ་སྣང་བཞིན་དུ་༎ སྐྱེ་ཤིས་འཕོས་པས་ངོ་མ་ཤེས་པ་དེ་བོར་ནས་༎ གལ་ཏེ་གཅིག་ཐར་བྱེད་ན་དེ་ལས་ཁྲེལ་བོར་མེད་༎ བྱིས་པ་བང་ན་བཙའ་བ་ཅི་ཡང་མི་ནུས་པར་༎
 aṅkasthitena śiśunā vivaśena yāsāṃ pītaḥ payodhararasaṃ praṇayānuyātaḥ |	གང་གི་ནུ་ཞོ་བྱམས་པའི་ཤུགས་ཀྱིས་གཟགས་འཐུངས་པ་༎ ངལ་བ་མང་བསྟེན་བྱམས་པ་བསྟེན་པ་དེ་དག་འདིར་༎
 tanniṣphalapracuradurlalitaikabhājaḥ ko nāma dasyurapi hātumihotsaheta || śl_96 || yā saṃsthito 'yamudare 'pi kṛtāvakāśo yāḥ snehaviklavadhiyaḥ ślathamenamūhuḥ |	ཤིན་ཏུ་མ་རབས་ཞིག་ནའང་སྤོང་བར་སུ་ཞིག་སྤྲོ་༎ གང་གི་ཁོང་ན་འདི་སྐབས་རྙེད་ནས་གནས་བཅས་ཤིང་༎ གང་གི་རྩེ་བག་སེམས་ཀྱིས་ཟོན་བཅས་འདི་བླངས་པ་༎
 tā duḥkhitā aśaraṇāḥ kṛpaṇā vihāya ko nāma śatrurapi gantumihotsaheta || śl_97 ||	ཉོན་མོངས་དེ་དག་སྡུག་བསྔལ་སྐྱབས་མེད་དེར་བོར་ནས་༎ འགྲོ་བ་མ་རབས་ཐ་ཤལ་ཞིག་ནའང་སུ་ཞིག་སྤྲོ་༎
 vikīrṇe duḥkhaughairjagati vivaśe 'sminnaśaraṇe parārthe yadduḥkhaṃ tadiha sukhamāhuḥ supuruṣāḥ |	འགྲོ་བ་སྡུག་བསྔལ་མི་བཟད་མང་པོས་དབང་མེད་སྐྱབས་མེད་འདིར་༎ གཞན་གྱི་དོན་དུ་སྡུག་བསྔལ་གང་དེ་བདེ་ཞེས་སྐྱེས་མཆོག་གསུངས་༏་། སྐད་ཅིག་གཞན་བཀྲེས་སྐོམ་དང་ཚ་ངལ་བྲལ་བས་རངས་བྱས་པ་༎ དེས་དགའ་གང་ཡིན་དེ་དང་འདྲ་བ་འདི་ནའང་གང་ཞིག་ཡོད་༎ གཞན་ཕན་བདེ་བ་སྐྱེད་པར་བརྩོན་པས་དགའ་བ་རྙེད་པ་གང་༎
 kṣaṇaṃ kṣuttṛṣṇoṣṇaśramavigamaramyānarucaḥ paraṃ kṛtvā teṣāmapi yadiha ka ivāsya pratisamaḥ || śl_98 ||	དེ་ནི་ཡུལ་བདེའི་ལོངས་སྤྱོད་ལྷུར་ལེན་རྣམས་ཀྱིས་ཇི་ལྟར་ཡང་༎
 na sāramyairyā naiva ca nṛpatilakṣmīparikarairna dārairnāpatyairna surabhavane nāsuragatau | kathaṃcitsaṃprāpyaṃ x viṣayasukhaṃ bhogaparamairlabhante yā prītiṃ parahitasukhādhānaniratāḥ || śl_99 ||	གཞོན་བདེས་མི་ཐོབ་མི་དབང་འབྱོར་པའི་ཡོ་བྱད་རྣམས་ཀྱིས་མིན་༎ ཆུང་མས་མ་ཡིན་གཞན་མིན་ལྷ་གནས་ལྷ་མིན་འགྲོ་བས་མིན་༎ ཤིན་ཏུ་རྙེད་སླ་རཙབ༹་ཁམ་འགའ་ལྟ་ཕྱུགས་ཀྱང་རང་ཉིད་ཟ་༎
 svayaṃ ghāsagrāsaṃ paśurapi karotyeva sulabhaṃ yadṛcchā labdhaṃ vā pibati salilaṃ gāḍhatṛṣitaḥ |	ཤིན་ཏུ་སྐོམ་པས་གདུངས་པའང་ཆུ་ཞིག་རྙེད་ན་དགའ་མགུར་འཐུང་༎ འདི་ན་སྐྱེས་བུ་གཞན་དོན་བྱེད་པར་བརྩོན་པ་གང་ཡིན་བ་༎
 parasyārtha kartuṃ yadiha puruṣo 'yaṃ prayatate tadasya svaṃ tejaḥ sukhamidamaho pauruṣamidam || śl_100 ||	དེ་འདིའི་བརྗིད་བག་ཡིན་ཏེ་དེ་བདེ་སྐྱེས་བུའི་རྩལ་དེ་འཕགས་༎
 yadālokaṃ kuvan bhramati raviraśrāntaturagaḥ sadālokaṃ dhatte yadagaṇitabhārā vasumatī |	ཉི་མ་རླབས་ཆན་རྟ་ཞོན་རྒྱུ་པ་སྣང་བྱེད་གང་ཡིན་དང་༎ ཁུར་ལ་མི་རྩེགས་ས་ཡིས་འཇིག་རྟེན་འདེགས་པ་གང་ཡིན་དེ་༎
 na sa svārthaḥ kaścitprakṛtiriyameva mahatāṃ yadete lokānāṃ hitasukharasaikāntarasikāḥ || śl_101 ||	རང་དོན་འགའ་མེད་ཆེན་པོ་རྣམས་ཀྱི་རང་བཞིན་དེ་འདྲ་སྟེ་༎ དེ་དག་འཇིག་རྟེན་ཕན་དང་བདེ་བའི་རོལ་གཅིག་ཏུ་གཞོལ་༎ འཇིག་རྟེན་མ་རིག་དུད་སྤྲིན་འཁྲིགས་པས་འགྲོ་བ་འཁྲུགས་གྱུར་བ་༎
 avidyādhūmrāndhabhramaparigatavyākulagatipradīpte duḥkhāgnau patitamavaśaṃ vīkṣya bhuvanam |	སྡུག་བསྔལ་མེ་རབ་འབར་བའི་ནང་དུ་དབང་མེད་ལྟུང་མཐོང་ནས་༎
 sphuradvahnijvālā pramathitaśiroveṣṭananibhā yātante ye 'trādbhuta iha puruṣāste sukṛtinaḥ || śl_102 ||	ཐོང་ལ་མེ་ལྕེ་འབར་བ་ལྟ་བུར་ཡིད་བྲེལ་བརྩོན་པ་གང་༎ འདི་ན་དེ་དག་སྐྱེས་༄༥༢བ་བུ་ཡིན་ཏེ་མཁས་པའང་དེ་དག་ཡིན་༎ གཞན་གྱི་དོན་དུ་མེ་ལྕེས་གང་བའི་མནར་མེད་དམྱལ་བར་ཡང་༎
 avīciṃ gāhante hutavahaśikhāpūritamapi prasarpadromāñcā himanikaracandrāṃśuśiśiram |	གངས་དང་ཟླ་འོད་བསིལ་བ་ལྟ་བུར་རབ་ཏུ་དགའ་བཞིན་འཇུག་། ཉིད་ཀྱི་དོན་དུ་པད་མ་ཁ་བྱེ་ལྷག་གེར་འདུག་པ་ཡི་༎
 parārthe x x x sphuṭanalinahāsāpi nalinī karotyeṣāṃ tāpaṃ hutavahaśikhāsaṃhatiriva || śl_103 ||	མཚོ་ཡང་དེ་ལ་མེ་ལྕེའི་ཚོགས་བཞིན་རབ་ཏུ་གདུངས་བར་བྱེད་༏་། གཞན་ལ་ཕན་བར་བྱེད་པར་ཆས་པའི་མཁས་པ་རྣམས་༎
 parahitakaraṇāya baddhakakṣāḥ sukhamasipattravane vasanti santaḥ |	ལོ་མ་རལ་གྲི་ཚལ་ནའང་བདེ་བླག་གནས་བྱེད་ཀྱིས་༎ སྐད་ཅིག་ཙམ་ཡང་ལྷ་ཡི་བུ་མོ་དང་འགྲོགས་ནས་༎
 na punaramarasundarīsahāyāḥ kṣaṇamapi nandanakānane ramante || śl_104 ||	དགའ་བའི་ཚལ་གྱི་ནང་དུ་སྐྱིད་པར་བྱེད་མི་འགྱུར་༎
 aśaraṇajanatāraṇāya tīrṇāḥ punarapi vaitaraṇīṃ taranti dhīrāḥ | na tu gaganasarittaraṃgabhaṅgavyatikarasaṅgasukhaṃ svayaṃ bhajante || śl_105 ||	རྒལ་བར་གྱུར་པ་སྐྱབས་མེད་སྐྱེ་བོ་བསྒྲལ་བའི་ཕྱིར་༎ ཕྱིར་ཡང་ཆུ་བོ་རབ་མེད་ནང་དུ་འཇུག་བྱེད་ཀྱིས་༎ ལྷ་ཡི་ཆུ་བོ་དབའ་རླབས་ཆིལ་ཆིལ་འདུག་པ་ཡིས་༎ རེག་པའི་བདེ་བ་བདག་ཉིད་སྟེན་པར་བྱེད་མ་ཡིན་༎
 iti sucaritaratnaṃ bhūṣaṇaṃ bhūṣaṇānāṃ śivamamṛtamudāraṃ bhāsuraṃ bhāsurāṇām |	དེ་ལྟར་རྒྱན་གྱིས་བརྒྱན་གྱུར་ལེགས་སྤྱད་རིན་པོ་ཆེ་༎ གསལ་བའི་ནང་ན་གསལ་བ་ཞི་བའི་བདུད་རྩི་ཡངས་༏་། དགའ་བའི་དགའ་བ་བྱས་པ་མི་གཟོ་རྙེད་དཀའ་བ་༎
 asulabhamakṛtajñairnandanaṃ nandanānāṃ bhaja samasukhahetuṃ maṅgalaṃ maṅgalānām || śl_106 ||	བཀྲ་ཤིས་རྣམས་ཀྱི་བཀྲ་ཤིས་ཞི་བའི་བདེ་རྒྱུན་ཏེ་༎ བདེ་བར་གཤེགས་པའི་གསུང་གི་མེ་ཏོག་རྟག་བསྟེན་བྱ་༎
 sugatavacanapuṣpaṃ sarvadā sevanīyaṃ phalati phalamudāraṃ puṣpameva drumāṇām |	ལྗོན་ཤིང་མེ་ཏོག་དེ་ལས་འབྲས་བུ་རྒྱ་ཆེན་འབྱུང་༎ བདེ་གཤེགས་མེ་ཏོག་གསུང་ལས་དོན་ཚོགས་བསྟེན་བྱ་སྟེ་༎
 sugatavacanapuṣpādartharāśirniṣevyo madhuni mudhakarāṇāṃ yasya vāñchāprakarṣam || śl_107 ||	སྦྲང་མ་སྦྲང་རྩི་ལ་མཆོག་དགའ་བར་བྱེད་ལ་ལྟོས་༎
 visṛja viṣayānnītyākīrṇāṃ kṣaṇavyayasaṅgino bhaja samasukhaṃ sākāṅkṣaṃ kṛtāntabhayojjhitam |	སྐད་ཅིག་གཅིག་ལ་ཟད་ཅིང་རྟག་ཏུ་འཁྲུག་པའི་ཡུལ་རྣམས་སྤོང་༎ ཞི་བའི་བདེ་འབྲས་འཆི་བའི་འཚེར་མེད་གཅིག་བུ་དབེན་པ་སྟེན་༎
 vikara timiraṃ mohavyājaṃ vimokṣayathārgalaṃ na khalu suciraṃ nidrāyante sadaśvakiśorakāḥ || śl_108 ||	རྣམ་ཐར་སྒོ་ཡི་གཏན་པས་གཏི་མུག་འཁྲུགས་པའི་རབ་རིབ་སོལ་༎ རྟ་མཆོག་རྟེའུ་ནི་ཤིན་ཏུ་ཡུན་རིང་གཉིད་ལོག་འགྱུར་མ་ཡིན་༎ ཁྱོད་གཅིག་གདུང་བས་ཉམ་ཐག་རྣམས་ལ་སྲིད་པའི་མྱ་ངམ་དུ་༎
 vinayavisaro vīryaskandhaḥ kṣamādamapallavaḥ śamathakusumaḥ prajñāśākhaḥ pradānaghanacchadaḥ |	ཤིང་ཆེན་སྡང་བརྟན་རྒྱ་ཆེན་ཀུན་གེལ་བཟོད་དང་དུལ་བའི་ལོ་མ་ཅན་༎ ཞིག་ནས་མེ་ཏོག་ཤེས་རབ་ཡལ་ག་རབ་སྨིན་ལོ་བྲན་སྟུག་། 
 praṇidhiśikharaḥ śīlacchāyaḥ praśāntiphalaprado bhava bhava marau tāpārtānāṃ tvamekamahādrumaḥ || śl_109 ||	སྨོན་ལམ་རྩེ་མོ་ཚུལ་ཁྲིམས་དྲི་མ་རབ་ཞི་འབྲས་བཅས་ཀྱིས་༎ ཁྱོད་གཅིག་གདུང་བས་ཉམ་ཐག་རྣམས་ལ་སྲིད་པའི་མྱ་ངམ་དུ་༎
 bahujanahito mābhairvādapradānamahāsvanaḥ pṛthutaraśodhārāsāraḥ kṛpānilacoditaḥ | praśamitarajaḥ śīlacchāyāvibhūṣitabhūtalo bhava bhava marau tāpārtānāṃ tvamekamahāghanaḥ || śl_110 ||	མཚོ་ཆེན་ཡངས་གསལ་བྱིན་གཞོལ་གཏིང་ཟབ་བསམ་པ་རབ་ཏུ་དངས་༎
 prakaṭavipulaṃ paṅkāgādhaḥ prasannatarāśrayaḥ satataśiśiro jālavyālapramādavivarjitaḥ |	རྟག་བསིལ་སྤྲུལ་གདུག་རྙི་ཡིས་བག་མེད་འཇིགས་སྤངས་རང་བཞིན་གྱིས་༎ རབ་ཏུ་༄༥༣ཨ་༌་༎ གཙང་ཞིང་སྲེད་བ་གཅོད་བྱེད་རྟུལ་བའི་ཁུར་བཟོད་ཀྱིས་༎
 prakṛtisubhagastṛṣṇācchedāvimardabharakṣamo bhava bhava marau tāpārtānāṃ tvamekamahāhradaḥ || śl_111 ||	ཁྱོད་གཅིག་གདུང་བས་ཉམ་ཐག་རྣམས་ལ་སྲིད་པའི་མྱ་ངམ་དུ་༎ སྤྲིན་ཆེན་སྐྱེ་བོ་མང་ཕན་མི་འཇིགས་སྨྲ་བའི་སྒྲ་ཆེན་སྒྲོགས་༎ དྲག་པ་རྒྱ་ཆེན་ཆར་གྱི་ཤུགས་དྲག་སྙིང་རྗེའི་རླུང་གིས་བསྐྱོད་༎ རྡུལ་བྲལ་ཞི་བས་ཚུལ་ཁྲིམས་དྲི་མས་ས་སྟེང་བརྒྱན་པར་གྱིས་༎
 iti nigadatā yadupārjitaṃ puṇyaṃ mayā kiyatsugatacarite kṛtvā śraddhāmanena jano 'khilaḥ |	བདག་གིས་དེ་སྐད་བརྗོད་པས་བསོད་ནམས་ཅུང་ཟད་བསྒྲུབས་པ་གང་༎ དེ་ཡིས་སྐྱེ་བོ་མ་ལུས་བདེ་གཤེགས་སྤྱོད་ལ་དང་བྱེད་ཅིང་༎
 satatasukhito ramyābhogaḥ samṛddhamanorathaḥ parahitarataḥ sarvajñatvaṃ prayātu tataḥ śanaiḥ || śl_112 ||	རྟག་བདེ་ལོངས་སྤྱོད་བཟང་ལྡན་ཡིད་ལ་རེ་བ་འབྱོར་བ་དང་༎ གཞན་ལ་ཕན་དགའ་དེ་ནས་རིམ་གྱིས་ཀུན་མཁྱེན་བགྲོད་པར་ཤོག་། 
 karatalasamāḥ spaṣṭālokāḥ praśāntakṛśānavaḥ sthalakamalinīpattracchannā bisāṅkuradanturāḥ |	དམྱལ་བ་ལག་མཐིལ་ལྟར་མཉམ་རྣམ་བསལ་མེ་རབ་ཞི་བ་དང་༎ སྐམ་འཁྲུངས་པདམའི་ལོ་མས་ཁེབས་ཤིང་རྩ་བའི་ཁྱེའུ་སོ་འཐོན་༎
 śucisurabhayaḥ sphullāmbhojairvibhūṣitabhūmayo dadhatu narakāḥ sphītāṃ śobhāṃ saśīkaravāyavaḥ || śl_113 ||	གཙང་ཞིང་དྲི་ཞིམ་པདམ་ཁ་བྱེས་ས་རྣམས་བརྒྱན་པ་དང་༎ རྒྱས་ཤིང་བཟང་ལ་སེར་བུའི་ངད་བཅས་ཆར་ཟིམ་འབབ་པ་པར་ཤོག་། བདུད་དཔུང་ཕམ་པ་ཆོ་ངེས་འདེབས་པས་མི་བསྙེངས་སྒྲོགས་པ་པོ་༎
 vijitaṃvirutamārānīkāḥ kṛtābhayaghoṣaṇā gaganasalilakrīḍā ramyā sameta narāmarāḥ |	ལྷ་ཆུའི་རྩེ་མོ་བས་ཀྱང་དགའ་མཛད་ལྷ་དང་མི་འདུལ་བ་༎
 jananamaraṇakleśāyāsaprabandhavighātino diśi diśi sadā buddhotpādā bhavantu samīhitāḥ || śl_114 ||	སྐྱེ་ཤི་ཉོན་མོངས་སྡུག་བསྔལ་རྒྱུན་རྣམས་འཇོམས་པའི་སངས་རྒྱས་དག་། ཕྱོགས་དང་ཕྱོགས་སུ་བྲང་པ་བཞིན་དུ་ནམ་ཞར་འབྱུང་བར་ཤོག་།འགྲོ་བ་ཆོས
 bhavatu jagatāṃ dharmāmodaḥ prabandhamahotsavaḥ suciraguṇitā mṛtyorbandhyā bhavantu manorathāḥ |	ཀྱི་ཀུན་དགའ་འཕེལ་བའི་དགའ་སྟོན་ཆེ་བར་ཤོག་།འཆི་བདག་རེ་བ་ཤིན་ཏུ་ཡུན་རིང་གོམས་པ་དོན་མེད་ཤོག་། 
 munijanakathāgoṣṭhībandhaiḥ samāvṛtavarṣibhiḥ satataśiśiraḥ subhagacandrālokaḥ prayātu kṛtārthatām || śl_115 ||	ཐུབ་པའི་སྐྱེ་བོ་གཏམ་ཚོགས་འཕེལ་བས་ཞེ་བ་བདུད་རྩི་ཡི་༎ ཆར་གྱི་ཟླ་བའི་སྣང་བ་རབ་བཟང་བསིལ་བས་དོན་བྱས་ཤོག་། 
 || iti śiṣyalekhanāma dharmakāvyaṃ samāptam ||	སློབ་མ་ལ་སྤྲིངས་པའི་ཕྲིན་ཡིག་སློབ་དཔོན་ཆེན་པོ་ཙན་དྲ་གོ་མིས་མཛད་པ་རྫོགས་སོ་། 
