skt	tib
 dharmakīrti: hetubindu namo buddhāya |	༄༢༣༨ཨ་༅་༎ རྒྱ་གར་སྐད་དུ་། ཧེ་ཏུ་བིན་དུ་ནའ་མ་པྲ་ཀ་ར་ན་། བོད་སྐད་དུ་། གཏན་ཚིགས་ཀྱི་ཐིགས་པ་ཞེས་བྱ་བའི་རབ་ཏུ་བྱེད་པ་། འཇམ་དཔལ་གཞོན་ནུར་གྱུར་པ་ལ་ཕྱག་འཚལ་ལོ་༎
 (1|1) parokṣārthapratipatteranumānāśrayatvādeva tad vyutpādanārtha saṃkṣepata idamārabhyate- pakṣadharmastadaṃśena vyāpto hetustridhaiva saḥ	དོན་ལྐོག་ཏུ་གྱུར་པ་སྒྲུབ་པའི་རྟེན་ནི་། རྗེས་སུ་དཔག་པ་ཉིད་ཡིན་པས་། དེ་བྱེ་བྲག་ཏུ་རྟོགས་པར་༄༢༣༨བ་བྱ་བའི་ཕྱིར་། མདོར་བསྡུས་ནས་འདི་བརྩམ་མོ་༎ ཕྱོགས་ཆོས་དེའི་ཆས་ཁྱབ་པ་ནི་༎ གཏན་ཚིགས་དེ་ནི་རྣམ་གསུམ་ཉིད་༎
 avinābhāvaniyamād hetvābhāsāstato 'pare ||	མེད་ན་མི་འབྱུང་ངེས་ཕྱིར་རོ་༎ གཏན་ཚིགས་ལྟར་སྣང་དེ་ལས་གཞན་༎
 (1|2) pakṣo dharmī,	ཕྱོགས་ནི་ཆོས་ཅན་ཏེ་།
 avayave samudāyopacārāt |	ཡན་ལག་ལ་སྤྱི་ཉེ་བར་བརྟགས་པའི་ཕྱིར་རོ་༎
 prayojanābhāvādanupacāra iti cet | na |	གལ་ཏེ་དགོས་པ་མེད་པའི་ཕྱིར་ཉེ་བར་གདགས་པར་མི་བྱའོ་ཞེ་ན་།
 sarvadharmidharmapratiṣedhārthatvādupacārasya |	མ་ཡིན་ཏེ་ཉེ་བར་གདགས་པ་ནི་ཆོས་ཅན་གྱི་ཆོས་ཐམས་ཅད་དགག་པའི་ཕྱིར་ཏེ་།
 evaṃ hi cākṣuṣatvādi parihṛtaṃ bhavati |	དེ་ལྟར་ན་མིག་གིས་གཟུང་བར་བྱ་བ་ཡིན་པའི་ཕྱིར་རོ་ཞེས་བྱ་བ་ལ་སོགས་པ་ཡོངས་སུ་སྤངས་པ་ཡིན་ནོ་༎ གལ་ཏེ་ཆོས་ནི་གཞན་ལ་བརྟེན་པ་ཡིན་པས་ཀྱང་།
 dharmavacanenāpi parāśrayatvād dharmasya dharmyāśrayasiddhau pratyāsatteḥ sādhyadharmiṇa eva siddhiriti cet | na |	རྟེན་ཆོས་ཅན་འགྲུབ་ལ་། ཆོས་ཅན་སྨོས་པས་ཀྱང་ཉེ་བ་ཡིན་པའི་ཕྱིར་། བསྒྲུབ་པར་བྱ་བའི་ཆོས་ཅན་ཡིན་པར་འགྲུབ་པོ་ཞེ་ན་།
 pratyāsatteḥ dṛṣṭāntadharmiṇo 'pi |	དཔེའི་ཆོས་ཅན་ཡང་ཉེ་བ་ཡིན་པའི་ཕྱིར་རོ་༎
 siddhe tadaṃśavyāptyā dṛṣṭāntadharmiṇi sattve punardharmiṇo vacanaṃ dṛṣṭāntadharmiṇa eva yo dharmaḥ sa heturiti niyamārthamāśaṃkyeta |	དེའི་ཆོས་ཁྱབ་པས་དཔེའི་ཆོས་ཅན་ལ་ཡོད་པར་གྲུབ་པའི་ཕྱིར་༏་ཆོས་ཅན་གྱི་ཆོས་སྨོས་པས་ནི་། བསྒྲུབ་པར་བྱ་བའི་ཆོས་ཅན་ཡོངས་སུ་བསྡུས་སོ་༎ བསྒྲུབ་ཀྱང་ངེས་པར་བྱ་བའི་ཕྱིར་ཡང་སྨོས་སུ་དོགས་པར་འགྱུར་ཏེ་།
 dṛṣṭaṃ sajātīya eva sattvam ityavadhāraṇena sādhyābhāve siddhe 'pi vyatireke sādhyābhāve asattvavacanam,	མཐུན་པ་ལ་ཡོད་པ་ཁོ་ནས་ལྡོག་པ་ལ་དེ་མེད་པར་གྲུབ་མོད་ཀྱི་། བསྒྲུབ་པར་བྱ་བ་མེད་པ་ལ་མེད་པ་ཞེས་སྨོས་པ་བཞིན་དུ་། དེའི་ཆོས་ཁྱབ་པ་སྨོས་པས་།
 tathehāpi tadaṃśavyāptivacanāt siddhe 'pi dṛṣṭāntadharmiṇi sattve tatraiva bhāvaniyamārtha dharmivacanamāśaṃkyeta |	དཔེའི་ཆོས་ཅན་ལ་ཡང་ཡོད་པར་གྲུབ་མོད་ཀྱི་། དེ་ཉིད་ལ་ཡོད་པར་ངེས་པར་བྱ་བའི་ཕྱིར་། ཆོས་ཅན་སྨོས་སུ་དོགས་པར་འགྱུར་རོ་༎
 tasmāt sāmarthyād arthapratītāvapi upacāramātrāt samānanirdeśāt pratipattigauravaṃ ca parihṛtaṃ bhavati | (1|3) pakṣasya dharmatve tadviśeṣaṇāpekṣasyānyatrānanuvṛtterasādhāraṇateti cet | na |	དེ་བས་ན་ཤུགས་ཀྱིས་དོན་གོ་ཡང་ཉེ་བར་བརྟགས་པ་ཙམ་ཡི་གེ་མཉམ་པས་སྒྲུབ་དཀའ་བ་ཡང་ཡོངས་སུ་སྤངས་པ་ཡིན་ནོ་༎ གལ་ཏེ་ཕྱོགས་ཀྱི་ཆོས་ཉིད་ཡིན་ན་། དེའི་ཁྱད་པར་ལ་ལྟོས་པ་གཞན་དུ་མི་འཇུག་གོ་ཞེ་ན་།
 ayogavyavacchedena viśeṣaṇāt | yathā caitro dhanurdhara iti |	མ་ཡིན་ཏེ་མ་འབྲེལ་བ་རྣམ་པར་བཅད་པས་བྱེ་བྲག་ཏུ་བྱས་པའི་ཕྱིར་དཔེར་ན་ནག་པ་གཞུ་ཐོགས་སོ་ཞེས་བྱ་བ་ལྟ་བུ་ཡིན་གྱི་། དཔེར་ན་སྲིད་སྒྲུབ་གཞུ་ཐོགས་པ་ལྟ་བུའོ་།
 nānyayogavyavacchedena | yathā pārtho dhanurdhara iti |	ཞེས་གཞན་དང་འབྲེལ་བ་རྣམ་པར་བཅད་པས་ནི་མ་ཡིན་ནོ་༎
 tadaṃśastadharmaḥ |	དེའི་ཆ་ནི་དེའི་ཆོས་སོ་༎
 (1|4) tasya vyāptirhi vyāpakasya tatra bhāva eva |	ཁྱབ་པ་ནི་དེ་ལ་ཁྱབ་པར་བྱེད་པ་ཡོད་པ་ཁོ་ནའམ་།
 vyāpyasya vā tatraiva bhāvaḥ |	ཡང་ན་དེ་ཁོ་ན་ལ་ཁྱབ་པར་བྱ་བ་ཡོད་པའོ་༎
 etena anvayo vyatireko vā pakṣadharmaśca yathāsvaṃ pramāṇena niścita uktaḥ |	འདིས་རྗེས་སུ་འགྲོ་བའམ་། ལྡོག་པ་དང་ཕྱོགས་ཀྱི་ཆོས་རང་གི་ཚད་མ་ཇི་ལྟ་བདག་གིས་ངེས་པར་བཤད་༄༢༣༩ཨ་༌་༎ པ་ཡིན་ཏེ་།
 sarvatra hetau sādhyavaidharmye vyāptyasiddhervyāpakānivṛttau nivṛttyabhāvādvā |	གཏན་ཚིགས་ཐམས་ཅད་ལ་བསྒྲུབ་པར་བྱ་བའི་ཆོས་མེད་ན་། ཁྱབ་པ་མི་འགྲུབ་པའི་ཕྱིར་རམ་། ཡང་ན་ཁྱབ་པར་བྱེད་པ་ལོག་ན་ལྡོག་པ་མེད་པའི་ཕྱིར་རོ་༎
 anvayavyatirekāniścayābhyāṃ hi taddharmavyāptiniścayaḥ |	རྗེས་སུ་འགྲོ་བ་དང་། ལྡོག་པ་ངེས་པ་དག་གིས་ནི་། དེའི་ཆོས་ཁྱབ་པ་ངེས་པ་ཡིན་ནོ་༎
 (1|5) tatra pakṣadharmasya sādhyadharmiṇi pratyakṣato 'numānato vā prasiddhiḥ |	དེ་ལ་བསྒྲུབ་པར་བྱ་བའི་ཆོས་ཅན་ལ་། ཕྱོགས་ཀྱི་ཆོས་མངོན་སུམ་མམ་། རྗེས་སུ་དཔག་པའི་སྒོ་ནས་རབ་ཏུ་གྲུབ་པ་ནི་ངེས་པ་སྟེ་།
 tathā pradeśe dhūmasya,	དཔེར་ན་ཕྱོགས་ན་དུ་བའམ་།
 śabde vā kṛtakatvasya |	སྒྲ་ལ་བྱས་པ་ཉིད་ལྟ་བུའོ་༎
 sadhūmaṃ hi pradeśamarthāntaraviviktarūpamasādhāraṇātmanā dṛṣṭavataḥ smārtaṃ yathādṛṣṭabheda viṣayaṃ liṅgajñānamutpadyate |	དུ་བ་དང་བཅས་པའི་ཕྱོགས་དོན་གཞན་གྱིས་དཔེ་ན་པའི་ངོ་བོ་ཅན་ཐུན་མོང་མ་ཡིན་པའི་བདག་ཉིད་དུ་མངོན་སུམ་གྱིས་མཐོང་བ་ལ་། ཇི་ལྟར་མཐོང་བ་ཐ་དད་པའི་ཡུལ་ཅན་དྲན་པ་རྟགས་ཤེས་པ་སྐྱེའོ་༎
 tatra yadādyamasādhāraṇaviṣayaṃ darśanaṃ tadeva pramāṇam |	དེ་ལ་དང་པོ་ཡུལ་ཐུན་མོང་མ་ཡིན་པ་མཐོང་བ་གང་ཡིན་པ་དེ་ཁོ་ན་ཚད་མ་ཡིན་ནོ་༎ 
 (1|6) tasmiṃstathābhūte darśanena dṛṣṭesati sa yena yenāsādhāraṇastadasādhāraṇatāṃ tato bhedamabhilapantī atadvayāvṛtiviṣayā smṛtirutpatrā pratyakṣabalena na pramāṇam |	དེ་དེ་ལྟར་མཐོང་ནས་མངོན་སུམ་གྱི་སྟོབས་ཀྱིས་དེ་དང་དང་གང་གིས་ཐུན་མོང་མ་ཡིན་པ་དེའི་ཐུན་མོང་མ་ཡིན་པ་ཉིད་དེ་ལས་ཐ་དད་པ་མངོན་པར་བརྗོད་པ་དེ་མ་ཡིན་པ་ལས་ལོག་པའི་ཡུལ་ཅན་གྱི་དྲན་པ་སྐྱེས་པ་ནི་།
 yathādṛṣṭākāragrahaṇāt,	ཇི་ལྟར་ཡོངས་སུ་མཐོང་བའི་རྣམ་པ་འཛིན་པའི་ཕྱིར་ཚད་མ་མ་ཡིན་ཏེ་།
 prāgasādhāraṇaṃ dṛṣṭvā asādhāraṇa ityabhilapataḥ apūrvārthādhigamābhāvāt,	སྔར་ཐུན་མོང་མ་ཡིན་པ་མཐོང་ནས་། ཐུན་མོང་མ་ཡིན་པའོ་ཞེས་མངོན་པར་བརྗོད་པས་ནི་། སྔོན་མ་རྟོགས་པའི་དོན་རྟོགས་པ་མེད་པའི་ཕྱིར་རོ་༎
 arthakriyāsādhanasya ālocanājñānena darśanācca |	དོན་བྱེད་པ་སྒྲུབ་པ་མཐོང་ཟིན་པའི་ཕྱིར་།
 adṛṣṭasya punastatsādhanasya vikalpenāpratipatteranumānavat |	རྣམ་པར་རྟོག་པས་ནི་རྗེས་སུ་དཔག་པ་ནི་དེ་སྒྲུབ་པའི་རང་གི་ངོ་བོ་མ་མཐོང་བ་ཡང་རྟོགས་པ་མེད་པའི་ཕྱིར་རོ་༎ དོན་བྱེད་པ་དོན་དུ་གཉེར་བ་རྟོགས་པ་དང་ལྡན་པ་ཐམས་ཅད་ནི་ཚད་མའམ་།
 arthakriyārthī hi sarvaḥ prekṣāvān pramāṇamapramāṇaṃ vānveṣate |	ཚད་མ་མ་ཡིན་པ་ཚོལ་ན་།
 na ca sāmānyaṃ svalakṣaṇapratipatterūrdhvaṃ tatsāmarthyotpatravikalpavijñānagrāhyaṃ kāñcidarthakriyāmupakalpayati |	སྤྱི་ནི་དོན་བྱེད་ཅུང་ཟད་ཀྱང་མི་ནུས་ཏེ་། རང་གི་མཚན་ཉིད་རྟོགས་པའི་འོག་ཏུ་དེའི་མཐུ་ལས་སྐྱེས་པ་རྣམ་པར་རྟོག་པ་ཅན་གྱི་རྣམ་པར་ཤེས་པའི་གཟུང་བ་ཡིན་པས་།
 yathā nīlaṃ dṛṣṭvā nīlamiti jñāne |	དཔེར་ན་སྔོན་པོ་མཐོང་ནས་སྔོན་པོའོ་མཐོང་ནས་སྔོན་པོའོ་སྙམ་པའི་རྣམ་པར་ཤེས་པ་ལ་སྣང་བ་བཞིན་ཏེ་། 
 tadeva hi nīlasvalakṣaṇaṃ tathāvidhasādhyārthakriyākāri |	སྔོན་པོའི་རང་གི་མཚན་ཉིད་དེ་ཉིད་དེ་ལྟ་བུས་བསྒྲུབ་པར་བྱ་བ་། དོན་བྱ་བ་བྱེད་པ་ཡིན་ལ་།
 tacca tenātmanā dṛṣṭameva ālocanāpratyayena |	དེ་ཡང་དེའི་བདག་ཉིད་དུ་མངོན་སུམ་གྱིས་མཐོང་བ་ཁོ་ན་ཡིན་ནོ་༎
 na ca tatsvalakṣaṇagrahaṇottarakālabhāvino nīlavikalpasya viṣayeṇa nīlasādhyārthakriyā kriyate |	དེའི་རང་གི་མཚན་ཉིད་གཟུང་བའི་འོག་ཏུ་འབྱུང་བ་སྔོན་པོ་རྣམ་པར་རྟོག་པའི་ཡུལ་༄༢༣༩བ་གྱིས་ནི་། སྔོན་པོ་དོན་གྱིས་བསྒྲུབ་པར་བྱ་བའི་དོན་བྱ་བ་སྒྲུབ་པར་མི་བྱེད་དེ་།
 (1|7) tasmāt anadhigatārthaviṣayaṃ pramāṇam ityapi anadhigate svalakṣaṇe iti viśeṣaṇīyam |	དེ་ལྟ་བས་ན་དོན་མ་རྟོགས་པའི་ཡུལ་ཅན་ཚད་མ་ཡིན་ཞེས་བྱ་བ་ཡང་རང་གི་མཚན་ཉིད་མ་རྟོགས་པ་ཞེས་ཁྱད་པར་དུ་བྱའོ་༎
 adhigate tu svalakṣaṇe tatsāmarthyajanmā vikalpastadanukārī kāryatastadviṣayatvāt smṛtireva,	རང་གི་མཚན་ཉིད་རྟོགས་ནས་དེའི་མཐུ་ལས་སྐྱེས་པ་ཅན་རྣམ་པར་རྟོག་པ་དེ་དང་མཐུན་པར་བྱེད་པ་ནི་བྱ་བའི་སྒོ་ནས་དེའི་ཡུལ་ཅན་ཡིན་པའི་ཕྱིར་དྲན་པ་ཁོ་ན་ཡིན་གྱི་།
 na pramāṇam,	ཚད་མ་ནི་མ་ཡིན་ཏེ་།
 anadhigatavasturūpasyānadhigateḥ |	དངོས་པོའི་ངོ་བོ་མ་རྟོགས་པ་མེད་པའི་ཕྱིར་རོ་༎
 vastvadhiṣṭhānatvāt pramāṇavyavasthāyāḥ |	ཚད་མ་རྣམ་པར་གཞག་པ་ནི་དངོས་པོ་ལ་བརྟེན་པ་ཅན་ཉིད་ཡིན་པའི་ཕྱིར་རོ་༎
 arthakriyāyogyaviṣayatvāt tadarthināṃ pravṛtteḥ |	དེའི་དོན་དུ་འཇུག་པ་ནི་དོན་བྱེད་པར་རུང་བའི་ཡུལ་ཅན་ཡིན་པའི་ཕྱིར་རོ་༎
 arthakriyāyogyalakṣaṇaṃ hi vastu |	དངོས་པོ་ནི་དོན་བྱེད་པར་རུང་བའི་མཚན་ཉིད་ཅན་ཡིན་པའི་ཕྱིར་རོ་༎
 tato 'pi vikalpāt vastunyeva tadadhyavasāyena puruṣasya pravṛtteḥ |	རྣམ་པར་རྟོག་པ་དེ་ལས་ཀྱང་དེ་ལ་ལྷག་པར་ཆགས་པས་། དངོས་པོ་ཁོ་ན་ལ་འཇུག་པའི་ཕྱིར་རོ་༎
 pravṛttau pratyakṣeṇābhinnayogakṣematvāt |	ཞུགས་ནས་མངོན་དང་རྣམ་པར་རྟོག་པ་གྲུབ་པ་དང་བདེ་བ་མི་དད་པའི་ཕྱིར་རོ་༎
 pūrvapratyakṣakṣaṇena abhinnayogakṣematvāduttareṣāṃ kvacidaprāmāṇyaprasaṅga iti cet | na |	གལ་ཏེ་མངོན་སུམ་སྔ་མ་དང་ཕྱི་མ་རྣམས་སུ་འགའ་ཞིག་ལ་ཉེ་བར་སྦྱོར་བ་ཐ་མི་དད་པའི་ཕྱིར་རོ་༎ ཚད་མ་ཉིད་མ་ཡིན་པར་ཐལ་བར་འགྱུར་རོ་ཞེ་ན་། མ་ཡིན་ཏེ་སྐད་ཅིག་མའི་བྱེ་བྲག་གིས་བསྒྲུབ་པར་བྱ་བའི་དོན་དུ་འདོད་པ་ལ་གྲུབ་པ་དང་། 
 kṣaṇaviśeṣasādhyārthavāñcāyāṃ nānāyogakṣematvāt | sādhāraṇe hi kārye na teṣāṃ sāmarthyabhedaḥ |	བདེ་བ་ཐ་དད་པའི་ཕྱིར་རོ་༎
 aparāparadhūmapramitasatrikṛṣṭāgniṣu iva anumānajñānānāmagnimātrasādhye 'rthe |	འབྲས་བུ་ཐུན་མོང་བ་ཟམ་གྱི་བསྒྲུབ་པར་བྱ་བའི་དོན་ལ་དུ་བ་གཞན་དང་གཞན་གྱིས་གཞལ་བའི་མེ་ཉེ་བ་བཞིན་ནོ་༎
 etena dharmidharmaliṅgādivikalpasya pramāṇapṛṣṭhabhāvinaḥ prāmāṇyaṃ pratyuktam |	འདིས་ནི་ཆོས་དང་ཆོས་ཅན་དང་རྟགས་ལ་སོགས་པའི་རྣམ་པར་རྟོག་པ་ཚད་མའི་རྗེས་ལ་འབྱུང་བ་ཚད་མ་ཉིད་དུ་བསལ་བ་ཡིན་ནོ་༎
 (1|8) anvayaniścayo 'pi svabhāvahetau sādhyadharmasya vastutastadbhāvatayā sādhanadharmabhāvamātrānubandhasiddhiḥ |	རྗེས་སུ་འགྲོ་བ་ངེས་པ་ཡང་རང་བཞིན་གྱི་གཏན་ཚིགས་ཀྱི་ནི་བསྒྲུབ་པར་བྱ་བའི་ཆོས་དངོས་སུ་ན་དེའི་ངོ་བོ་ཅན་ཉིད་ཡིན་པས་། སྒྲུབ་པའི་ཆོས་ཀྱི་ངོ་བོ་ཙམ་དང་རྗེས་སུ་འབྲེལ་པར་གྲུབ་པ་ཡིན་ནོ་༎
 sā hi sādhyaviparyaye hetorbādhakapramāṇavṛttiḥ | yathā sat tat kṣaṇikameva,	དེ་ནི་བསྒྲུབ་པར་བྱ་བ་ལས་བཟློག་པ་ལ་གཏན་ཚིགས་ཀྱི་གནོད་པ་ཅན་གྱི་ཚད་མ་འཇུག་པ་ཡིན་ཏེ་དཔེར་ན་གང་ཡོད་པ་དེ་ནི་སྐད་ཅིག་མ་ཁོ་ན་ཡིན་ནོ་༎
 akṣaṇikatve 'rthakriyā virodhāt tallakṣaṇaṃ vastutvaṃ hīyate |	སྐད་ཅིག་མ་ཉིད་མ་ཡིན་ན་དོན་བྱེད་པ་དང་འགལ་བའི་ཕྱིར་དེའི་མཚན་ཉིད་དངོས་པོ་ཉིད་ཉམས་པར་འགྱུར་བལྟ་བུའོ་༎
 kāryahetau kāryakāraṇabhāvasiddhiḥ |	འབྲས་བུའི་ཚིགས་ཀྱི་རྒྱུ་དང་འབྲས་བུའི་ངོ་བོ་གྲུབ་པ་ཡིན་ཏེ་།
 yathedamasyopalambhe upalabdhilakṣaṇaprāptamanupalabdhamupalabhyate,	འདི་ལྟ་སྟེ་འདི་དམིགས་ན་དམིགས་པའི་༄༢༤༠ཨ་༌་༎ རིག་བྱར་གྱུར་པ་སྔོན་པོ་མི་དམིགས་པ་འདི་དམིགས་པ་ཡིན་ནོ་༎
 satsu apyanyeṣu hetuṣu asyābhāve na bhavatīti yastadbhāve bhāvastadabhāve 'bhāvaśca pratyakṣānupalambhasādhanaḥ kāryakāraṇabhāvaḥ tasya siddhiḥ	རྒྱུ་གཞན་དག་ཡོད་ཀྱང་འདི་མེད་ན་མེད་པའི་ཕྱིར་། དེ་ཡོད་ན་ནི་ཡོད་མེད་ན་ནི་མེད་བས་། རྒྱུ་དང་འབྲས་བུའི་ངོ་བོ་ནི་མངོན་སུམ་དང་མི་དམིགས་པའི་གྲུབ་པ་ཅན་ཡིན་ཏེ་།
 kāryakāraṇabhāva eva hyarthāntarasya evaṃ syāt- yatra dhūmastatrāvaśyamagniriti,	དེ་གྲུབ་པའོ་༎ དེ་ལྟར་ན་རྒྱུ་དང་འབྲས་བུའི་ངོ་བོ་ནི་དོན་ཐ་དད་པ་ཁོ་ནར་འགྱུར་ལ་། གང་ན་དུ་བ་ཡོད་པ་དེ་ན་གདོན་མི་ཟ་བར་མེ་ཡོད་དེ་།
 agnibhāva eva hi bhāvo dhūmasya tatkāryatvamiti |	མེ་ཡོད་ན་ཡོད་པ་ཁོ་ན་དེའི་འབྲས་བུ་ཉིད་དུ་བ་ཡིན་པའི་ཕྱིར་རོ་༎
 anupalabdhāvapi anvayaniścayaḥ asadvayavahārasyopalabdhilakṣaṇaprāptasyānupalabdhimātravṛtti sādhanaṃ,	མི་དམིགས་པའི་རྗེས་སུ་འགྲོ་བ་ངེས་པ་ཡང་མེད་པའི་ཐ་སྙད་དམིགས་པའི་རིག་བྱར་གྱུར་པ་མི་དམིགས་པ་ཙམ་འཇིག་པའི་སྒྲུབ་པ་ཅན་ཡིན་ཏེ་། 
 nimittāntarābhāvopadarśanāt | (1|9) vyatirekaniścayo 'pi kāryasvabhāvahetvoḥ kāraṇavyāpakānupalabdhibhyāṃ dṛśyaviṣayābhyāṃ	རྒྱུ་མཚན་གཞན་མེད་པར་མཐོང་བའི་ཕྱིར་རོ་༎
 kāryakāraṇavyāpyavyāpakabhāvasiddhau satyāṃ sādhyābhāve 'bhāvasiddhiruddiṣṭa viṣayasyābhāvopadarśane |	ལྡོག་པ་ངེས་པ་ཡང་འབྲས་བུ་དང་རང་བཞིན་གྱི་གཏན་ཚིགས་དག་གིས་ནི་རྒྱུ་དང་འབྲས་བུ་དང་ཁྱབ་པར་བྱ་བ་དང་། ཁྱབ་པར་བྱེད་པའི་ངོ་བོ་གྲུབ་ན་ཡུལ་བལྟར་རུང་བ་རྒྱུ་དང་ཁྱབ་པར་བྱེད་པ་དག་མི་དམིགས་པས་། བསྒྲུབ་པར་བྱ་བ་མེད་ན་གཏན་ཚིགས་འགྲུབ་པའོ་༎ ཡུལ་བསྟན་པ་ཅན་མེད་པར་ཉེ་བར་སྟོན་པ་ལ་།
 anupalabdhilakṣaṇaprāptasyānyathā kvacidabhāvāsiddheḥ |	དེ་ལྟ་མ་ཡིན་ན་དམིགས་པའི་རིག་བྱར་མ་གྱུར་པ་གང་དུ་ཡང་མེད་པར་མི་འགྲུབ་པའི་ཕྱིར་རོ་༎ ཡུལ་མ་བསྟན་པ་ཅན་ནི་བསྒྲུབ་པར་བྱ་བ་མེད་ན་མེད་པར་སྟོན་པ་ཡིན་ཕྱིར་རོ་༎ ཏེ་། 
 anuddiṣṭaviṣayaṃ sādhyābhāve hetvabhāvakhyāpanaṃ pratibandhamātrasiddhau sidhyatīti na tatra vyatirekasādhane anupalabdhyoḥ dṛśyaviṣayatāviśeṣaṇamapekṣyate	འབྲེལ་པ་ཙམ་གྲུབ་ན་འགྲུབ་པས་དེ་ལས་ནི་ལྡོག་པ་བསྒྲུབ་པར་བྱ་བ་མི་དམིགས་པ་ཡུལ་ལྟར་རུང་བ་ལྟོས་པ་ཕྱིར་རོ་༎ ཏེ་། མ་ཡིན་ནོ་༎ 
 vyatirekāniścayo 'nupalabdhāvupalabdhilakṣaṇaprāptāt sato 'nupalambhābhāvadarśanam |	མི་དམིགས་པའི་ལོག་པ་ངེས་པ་ནི་དམིགས་པའི་རིག་བྱར་གྱུར་པ་མི་དམིགས་པ་མེད་པ་ཉེ་བར་ཕྱིར་རོ་༎ ཏེ་། མ་ཡིན་ནོ་༎ སྟོན་པའོ་༎ མཚན་ཉིད་དེ་ལྟ་བུ་ཅན་དེ་ནི་ཕྱིར་རོ་༎ ཏེ་། མ་ཡིན་ནོ་༎ 
 (1|10) etallakṣaṇaḥ tridhaiva saḥ hetustriprakāra eva |	སྟོན་པའོ་༎ རྣམ་པ་གསུམ་། གཏན་ཚིགས་ནི་རྣམ་པ་གསུམ་ཁོ་ན་སྟེ་།
 svabhāvaḥ kāryamanupalabdhiśceti |	རང་བཞིན་དང་འབྲས་བུ་དང་། མི་དམིགས་པ་ཡིན་ཏེ་།
 yathā anitye kasmiṃścitsādhye sattvamiti | agnimati pradeśe dhūma iti | abhāve ca upalabdhilakṣaṇaprāptasyānupalabdhiriti |	དཔེར་ན་འགའ་ཞིག་མི་རྟག་པ་བསྒྲུབ་པར་བྱ་བ་ལ་ཡོད་པ་ལྟ་བུ་དང་། མེ་དང་ལྡན་པའི་ཕྱོགས་ལ་དུ་བ་ལྟ་བུ་དང་། མེད་པ་ལ་དམིགས་པའི་རིག་བྱར་གྱུར་པ་མི་དམིགས་པ་ཞེས་བྱ་བ་ལྟ་བུའོ་༎
 atraiva trividhahetāvavinābhāvasya niyamāt |	རྣམ་པ་གསུམ་པོ་འདི་ཁོ་ནར་། མེད་ན་མི་འབྱུང་ངེས་ཕྱིར་རོ་༎
 pakṣadharmasya yathoktā vyāptiravinābhāvaḥ |	ཕྱོགས་ཀྱི་ཆོས་ཀྱི་ཁྱབ་པ་ཇི་སྐད་དུ་། བཤད་པ་ནི་མེད་ན་མི་འབྱུང་བ་ཡིན་ཏེ་།
 na sa trividhāddhetoranyatrāstītyatraiva niyata ucyate |	དེ་ནི་གཏན་ཚིགས་རྣམ་པ་གསུམ་ལས་མེད་པས་འདི་ཉིད་དུ་ངེས་པ་ཞེས་བྱའོ་༎
 (2|1) tatra sādhanadharmabhāvamātrānvayini sādhyadharme svabhāvo hetuḥ |	དེ་ལ་སྒྲུབ་པའི་ཆོས་ཀྱི་ངོ་བོ་ཙམ་དང་ལྡན་༄༢༤༠བ་པ་ཅན་ནི་བསྒྲུབ་པར་བྱ་བའི་ཆོས་ཀྱི་རང་བཞིན་གྱི་གཏན་ཚིགས་ཡིན་ནོ་༎
 aparāparavyāvṛttibhedena dharmabhede satyapi vastutaḥ liṅgasvabhāva eva |	ཕན་ཚུན་ལྡོག་པའི་བྱེ་བྲག་གིས་ཆོས་ཐ་དད་པ་ཡིན་ཡང་། དངོས་སུ་ན་གཏན་ཚིགས་ནི་རྟགས་ཅན་གྱི་རང་བཞིན་ཁོ་ན་ཡིན་ནོ་༎
 hetusvabhāve sādhyadharme 'nvayavyabhicārābhāvāt lakṣaṇe tanmātrānvayeneti viśeṣaṇaṃ paramatāpekṣam |	རང་བཞིན་ལ་རྗེས་སུ་འགྲོ་བ་འཁྲུལ་པ་མེད་པ་ལས་མཚན་ཉིད་ལ་གཞན་གྱི་ལུགས་ལ་ལྟོས་ནས་། དེ་ཙམ་དང་ལྡན་པ་ཅན་གྱིས་ཁྱད་པར་དུ་བྱས་སོ་༎
 pare hi arthāntaranimittamatadbhāvamātrānvayinamapi svabhāvamiccanti |	གཞན་དག་ནི་དོན་གཞན་གྱི་རྒྱུ་མཚན་ཅན་དེའི་ངོ་བོ་ཙམ་དང་ལྡན་པ་མ་ཡིན་པའི་ཆོས་ཀྱང་རང་བཞིན་དུ་འདོད་པས་།
 tena ca viśeṣaṇena tathavidhasya atatsvabhāvatāṃ tasmin sādhye hetorvyabhicāraṃ cāha |	ཁྱད་པར་གྱིས་དེ་ལྟ་བུ་རང་བཞིན་མ་ཡིན་པ་ཉིད་དང་། བསྒྲུབ་པར་བྱ་བ་དེ་ལ་གཏན་ཚིགས་འཁྲུལ་པར་བསྟན་དེ་།
 yathā hetumati vināśe kṛtakatvasya |	དཔེར་ན་འཇིག་པ་རྒྱུ་དང་ལྡན་པ་ལ་བྱས་པ་ལྟ་བུའོ་༎
 (2|2) tasya dvidhā prayogaḥ |	དེའི་སྦྱོར་བ་ནི་རྣམ་པར་གཉིས་ཏེ་།
 sādharmyeṇaikaḥ vaidharmyeṇāparaḥ |	ཆོས་མཐུན་པ་ཉིད་ཅན་དང་༎ ཆོས་མི་མཐུན་པ་ཅན་གཉིས་ཀྱིས་སོ་༎
 yathā yat sat tat sarvaṃ kṣaṇikam |	དཔེར་ན་གང་ཡོད་པ་དེ་ཐམས་ཅད་ནི་སྐད་ཅིག་མ་སྟེ་།
 yathā ghaṭādayaḥ | saṃśca śabdaḥ iti |	དཔེར་ན་བུམ་པ་ལ་སོགས་པ་ལྟ་བུའོ་༎
 tathā, kṣaṇikatvābhāve sattvābhāvaḥ saṃśca śabda iti |	སྒྲ་ཡང་ཡོད་པ་ཡིན་པས་ཞེས་བྱ་བ་དང་། དེ་བཞིན་དུ་སྐད་ཅིག་མ་ཉིད་མེད་ན་ཡོད་པ་ཡང་མེད་པ་ཡིན་ན་། སྒྲ་ནི་ཡོད་པས་ཞེས་བྱ་བ་ལྟ་བུ་སྟེ་། རྗེས་སུ་འགྲོ་བའམ་།
 sarvopasaṃhāreṇa vyāptipradarśanalakṣaṇau sādharmyavaidharmyaprayogāvuktau |	ལྡོག་པས་ཐམས་ཅད་ཉེ་བར་བསྡུས་ནས་། ཁྱབ་པ་རབ་ཏུ་སྟོན་པའི་མཚན་ཉིད་ཅན་གྱིས་ཆོས་མཐུན་པ་ཅན་དང་། ཆོས་མི་མཐུན་པ་ཅན་གྱི་སྦྱོར་བ་དག་ཡིན་ནོ་༎
 (2|3) atra pakṣadharmasambandhavacanamātrasāmarthyādeva pratijñārthasya pratīteḥ na pratijñāyāḥ prayoga upadarśitaḥ |	འདིར་ནི་ཤུགས་ཁོ་ནས་དམ་བཅས་པའི་དོན་རྟོགས་པའི་ཕྱིར་དམ་བཅས་པའི་སྦྱོར་བ་མི་བྱའོ་༎
 apradarśite prameye kathaṃ tatpratītiriti cet | svayaṃ pratipattau prameyasya ka upadarśayitā?	གལ་ཏེ་གཞལ་བྱའི་དོན་རབ་ཏུ་མ་བསྟན་ན་། དེ་ཅི་ལྟར་རྟོགས་ཤེ་ན་།
 pradeśasthaṃ dhūmamupalabdhavataḥ tasyāgninā vyāpteḥ smaraṇe tatsāmarthyādeva agniratra iti pratijñārthapratītirbhavati |	བདག་ཉིད་ཀྱིས་རྟོགས་པ་ལ་གཞན་བྱ་ཉེ་བར་སྟོན་པར་བྱེད་པ་སུ་ཞིག་ཡོད་དེ་། ཕྱོགས་ན་ཡོད་པའི་དུ་བ་ཉེ་བར་དམིགས་པས་དེ་ལ་མེས་ཁྱབ་པ་དྲན་ན་། དེའི་མཐུ་ཁོ་ནས་འདི་ན་མེ་ཡོད་དོ་སྙམ་དུ་ཤེས་སོ་༎
 na ca tatra kaścit agniratreti asmai nivedayati |	དེ་ན་འདི་ལ་འགའ་ཡང་འདི་ན་མེ་ཡོད་དོ་ཞེས་སྟོན་པར་ཡང་མི་བྱེད་ལ་།
 nāpi svayamapi prāgeva pratipadyate kiñcit,	བདག་ཉིད་ཀྱིས་ཀྱང་ཅུང་ཟད་ཀྱང་མི་རྟོགས་ཏེ་།
 pramāṇamantareṇaivaṃ pratīteḥ nimittābhāvāt pratītau liṅgasya vaiyarthyam |	ཚད་མ་མ་རྟོགས་པར་དེ་ལྟར་རྟོགས་པའི་རྒྱུ་མཚན་མེད་པའི་ཕྱིར་རོ་༎ རྟོགས་ན་ནི་རྟོགས་དོན་མེད་པ་ཉིད་དུ་འགྱུར་རོ་༎ བདག་ཉིད་ཀྱིས་བབ་ཅོལ་དུ་འདི་ན་མེ་ཡོད་དོ་སྙམ་དུ་༄༢༤༡ཨ་༌་༎ གཞལ་བྱ་རྣམ་པར་བཞག་ནས་།
 svayamevākasmāt agniratreti vyavasthāpya tatpratipattaye paścālliṅgamanusaratīti ko 'yaṃ pratipatteḥ kramaḥ?	ཕྱིས་དེ་རབ་ཏུ་སྒྲུབ་པའི་ཡན་ལག་གི་རྗེས་སུ་འབྲང་ངོ་སྙམ་ན་། རྟོགས་པའི་རིམ་པ་འདི་ནི་ཅི་ཞིག་ཡིན་།
 pareṇāpi taducyamānaṃ plavata eva upayogābhāvāt |	དེ་གཞན་གྱིས་བརྗོད་ན་ཡང་དགོས་པ་མེད་པའི་ཕྱིར་ཆ་ཆུང་ངོ་༎
 viṣayopadarśanamupayoga iti cet,	གལ་ཏེ་དགོས་པ་ཡུལ་བསྟན་པ་ཡིན་ནོ་ཞེ་ན་།
 tenaiva tāvaddarśyamānena ko 'rthaḥ?	རེ་ཞིག་བསྟན་པ་དེ་ཉིད་ཀྱིས་ཅི་ཞིག་ཕན་།
 yadi pratītiranyathā na syāttadā sarvaṃ śobheta |	གལ་ཏེ་གཞན་དུ་ན་རྟོགས་པར་མི་འགྱུར་ན་ནི་། ཐམས་ཅད་ལེགས་པར་འགྱུར་རོ་༎ དེ་ལྟ་བས་ན་འདིས་བདག་ཉིད་ཀྱིས་རྟོགས་པ་ན་།
 tasmādeṣa svayaṃpratītau kenacid viṣayopasthāpakena vināpi pratiyan asmān kāryiṇo dṛṣṭvā parvabrāhmaṇa iva vyaktaṃ mūlyaṃ mṛgayate |	ཡུལ་ཉེ་བར་འགོད་པ་འགའ་ཡང་མེད་པར་རྟོགས་ལ་། ཁོ་བོ་དོན་དུ་གཉེར་བ་མཐོང་ནས་། དུས་སྟོན་གྱི་བྲམ་ཟེ་བཞིན་དུ་། གསལ་བར་རྔན་པ་སྒུགས་པར་བྱེད་པ་ཡིན་ནོ་༎
 asmadvacanādapi svayaṃ siddhameva liṅgamanusṛtya sādhyaṃ pratyetīti ko 'nayoravasthayorviśeṣaḥ? dṛṣṭā ca pakṣadharmasambandhavacanamātrāt sādharmyavatprayogādeḥ pratijñāvacanamantareṇāpi pratītiriti kastasyopayogaḥ?	ཁོ་བོས་བརྗོད་ཀྱང་བདག་ཉིད་གྲུབ་ཟིན་པའི་རྟགས་ཁོ་ནའི་རྗེས་སུ་འབྲངས་ན་རྟོགས་པར་འགྱུར་བས་གནས་སྐབས་འདི་གཉིས་ལ་ཁྱད་པར་ཅི་ཞིག་ཡོད་། དམ་བཅའ་བ་སྨོས་པ་མེད་པར་ཡང་ཕྱོགས་ཀྱི་ཆོས་དང་འབྲེལ་པ་སྨོས་པ་ཙམ་གྱིས་རྟོགས་པ་ཡང་མཐོང་བའི་ཕྱིར་དེ་དགོས་པ་ཅི་ཞིག་། ཡོད་། 
 svaniścayavadanyeṣāmapi niścayotpādanāya sādhanamucyate |	རང་ལ་ངེས་པ་བཞིན་དུ་གཞན་དག་ལ་ངེས་པ་བསྐྱེད་པར་འདོད་པའི་ཕྱིར་སྒྲུབ་། ཡོད་། 
 tatra svayaṃ prameyopadarśanena vināpi pratipadya paraṃ pratipādayatrapūrva kramamāśrayate iti kimatra kāraṇam?	པ་ཞེས་བྱའོ་༎ དེ་ལ་འདི་དག་ཉིད་ཀྱིས་གཞལ་བྱ་ཉེ་བར་བསྟན་པ་མེད་པར་ཡང་རྟོགས་ལ་། གཞན་ཁོང་དུ་ཆུད་པར་བྱེད་པ་ན་། དོན་གྱི་རིམ་པ་སྔོན་མ་བྱུང་བ་མ་བསྟན་ཏོ་ཞེས་བྱ་བ་འདི་ལ་རྒྱུ་ཅི་ཞིག་ཡོད་། དེ་ལྟ་བས་ན་གཞན་དུ་ན་ཡང་རྟོགས་པ་སྐྱེ་བའི་ཕྱིར་།
 tasmātra prameyasya vacanena kiñcitprayojanamanyathāpi pratipatterutpatteḥ |	གཞལ་བྱ་སྨོས་པ་ནི་ཅུང་ཟད་ཀྱང་ཀྱང་མི་དགོས་སོ་༎
 (2|4) etenopanayanigamanādikamapi pratyuktam |	འདིས་ནི་ཉེ་བར་གཏོད་པ་དང་། མཇུག་སྡུད་པ་ལ་སོགས་པ་ཡང་སྤངས་པ་ཡིན་ཏེ་།
 etāvataiva sādhyapratīterbhāvāt |	སྦྱོར་བ་འདི་ཙམ་ཁོ་ནས་རྟོགས་པར་བཏུབ་པའི་ཕྱིར་རོ་༎
 ḍiṇḍikarāgaṃ parityajyākṣiṇī nimīlya cintaya tāvat kimiyatā pratītiḥ syātra veti |	རེ་ཞིག་ཁ་བྱའི་ཆགས་པ་ཡོངས་སུ་བོར་ལ་མིག་ཚུམས་ཏེ་། ཅི་འདི་ཙམ་གྱིས་རྟོགས་པར་བཏུབ་བམ་། འོན་ཏེ་མི་བཏུབ་ཅེས་སོམས་ཤིག་། 
 bhāve kiṃ prapañcamālayā? iti iyāneva sādhanavākye prayogo jyāyān |	བཏུབ་པ་ལྟར་ན་ནི་སྤྲོས་པའི་ཕྲེང་པས་ཅི་ཞིག་བྱ་། སྒྲུབ་པའི་ཚིག་ལ་སྦྱོར་བ་འདི་ཙམ་ཁོ་ན་ཞིག་སྦྱར་བར་བྱའོ་༎
 (2|5) atra pūrvaṃ hetuḥ prayoktavyaḥ paścād dṛṣṭānta iti kramaniyamo 'pi na kaścit | sarvathā gamakatvāt |	འདི་ལ་ཡང་ཕྱོགས་ཀྱི་ཆོས་དང་འབྲེལ་པ་སྨོས་པ་དག་གི་རིམ་པ་ངེས་པ་ནི་འགའ་ཡང་མེད་དེ་ཇི་ལྟར་ཡང་རྟོགས་པར་བྱེད་པའི་ཕྱིར་རོ་༎ 
 (2|6) sambandhavacane 'pi nārthabhedo 'pi kaścit |	༄༢༤༡བ་འབྲེལ་པ་སྨོས་པ་ལ་ཡང་སྦྱོར་བ་འབའ་ཞིག་ཐ་དད་པར་ཟད་དེ་།
 ubhayathāpi tadbhāvasyaiva khyāpanāt |	གཉི་ག་ལྟར་ཡང་ཆོས་ཐ་དད་ཀྱང་དེའི་ངོ་བོ་ཁོ་ན་སྟོན་པའི་ཕྱིར་རོ་༎
 nahi atatsvabhāvasya bhāve ekāntenānyasya bhāvaḥ kṛtakatvasya bhāve prayatnānantarīyakatvavat |	དེའི་རང་བཞིན་མ་ཡིན་པ་ཡོད་ན་གཞན་ཡོད་པར་ངེས་པ་མེད་དེ་། བྱས་པ་ཉིད་ཡོད་ན་བརྩལ་ནས་འབྱུང་བའི་ཆོས་ཉིད་བཞིན་ནོ་༎
 kāryasyāpi atatsvabhāvasyābhāve na tannivṛttiḥ,	དེའི་རང་བཞིན་མ་ཡིན་པ་ལོག་ན་ཡང་འབྲས་བུ་མ་ཡིན་པ་དེ་ལྡོག་པ་མེད་དེ་།
 yathānayoreva naikanivṛttāvanyanivṛttiḥ | tasmādanvayavyatirekayoryathālakṣaṇameko 'pi prayokto dvitīyamākṣipatīti naikatraṃ sādhanavākye dvayoḥ prayogaḥ iṣyate vaiyarthyāt |	དཔེར་ན་ཆོས་འདི་གཉིས་ཁོ་ན་བཟློག་པ་བཞིན་ནོ་༎ དེ་ལྟ་བས་ན་རྗེས་སུ་འགྲོ་བ་དང་ལྡོག་པ་དག་ལས་མཚན་ཉིད་ཇི་ལྟ་བ་གཅིག་རབ་ཏུ་སྦྱར་བས་ཀྱང་གཉིས་པ་འཕེན་པས་སྒྲུབ་པའི་ཚིག་གཅིག་ལ་གཉི་ག་སྦྱོར་བར་མི་འདོད་དེ་། དོན་མེད་པའི་ཕྱིར་རོ་༎
 tatsvabhāvatayānvayasiddhau tadabhāve 'bhāvo 'pi sidhyatyeva |	དེའི་རང་བཞིན་ཡིན་པ་ཉིད་ཀྱིས་རྗེས་སུ་འགྲོ་བ་གྲུབ་ན་། དེ་མེད་ན་མེད་པ་འགྲུབ་པའི་ཕྱིར་ལ་།
 tathā siddhau cānvayasyāpi siddheriti |	དེ་མེད་ན་མེད་པ་གྲུབ་ན་དེའི་རྗེས་སུ་འགྲོ་བ་གྲུབ་པའི་ཕྱིར་རོ་༎
 tadabhāva eva hetorabhāvakhyātiryathā syāt nānyatra vipakṣe viruddhe vā iti niyamakhyāpanārtho 'pi vyatirekaprayogo na yuktaḥ,	ལྡོག་པ་སྦྱོར་བ་ནི་། ཇི་ལྟར་ན་དེ་མེད་པ་ཁོ་ན་ལ་མེད་པ་ཡིན་པར་སྟོན་པར་འགྱུར་བ་སྟེ་། གཞན་ལ་ཡང་མ་ཡིན་ལ་འགལ་བ་ལ་ཡང་མ་ཡིན་ནོ་ཞེས་ངེས་པར་བསྟན་པའི་དོན་དུ་ཡང་ངེས་པ་མ་ཡིན་ཏེ་།
 anyaviruddhayorapi vipakṣatvāt |	གཞན་དང་འགལ་བ་དག་ཀྱང་མི་མཐུན་པའི་ཕྱོགས་ཡིན་པའི་ཕྱིར་རོ་༎
 (2|7) kathamidam avagamyate sadavaśyaṃ naśvarasvabhāvamiti yena anvayavyatirekasambhava iti cet |	གང་གིས་ན་རྗེས་སུ་འགྲོ་བ་དང་ལྡོག་པ་དག་ཏུ་འགྱུར་བ་ཡོད་པ་གདོན་མི་ཟ་བར་འཇིག་པའི་རང་བཞིན་ཡིན་ན་ཞེས་བྱ་བ་འདི་ཇི་ལྟར་ཁོང་དུ་ཆུད་ཅེ་ན་།
 vināśahetvayogāt |	འཇིག་པའི་རྒྱུ་མི་རུང་བའི་ཕྱིར་རོ་༎
 svabhāvata eva bhāvā naśvarāḥ naiṣāṃ svahetubhyo niṣpatrānāmanyato vināśotpattiḥ |	དངོས་པོ་རྣམས་ནི་རང་གི་ངོ་བོ་ཁོ་ནས་འཇིག་པ་ཡིན་གྱི་གྲུབ་པ་རྣམས་གཞན་ལས་འཇིག་པ་འབྱུང་བ་འདི་ནི་མེད་དེ་།
 tasyāsāmarthyāt |	དེ་ལ་ནུས་པ་མེད་པའི་ཕྱིར་རོ་༎
 na hi vināśaheturbhāvasya svabhāvameva karoti tasya svahetubhyo nirvṛtteḥ | nāpi bhāvāntarameva,	འཇིག་པའི་རྒྱུས་དངོས་པོའི་རང་གི་ངོ་བོ་ཁོ་ན་བྱེད་པ་ནི་མ་ཡིན་ཏེ་། དེ་གྲུབ་ཟིན་པའི་ཕྱིར་རོ་༎ ངོ་བོ་ཉིད་གཞན་ཞིག་བྱེད་ན་ཡང་དངོས་པོ་དེའི་སོ་ན་འདུག་པ་ལ་ཅུང་ཟད་ཀྱང་མི་བྱེད་པས་། 
 bhāvāntarakaraṇe bhāvasya tadavasthatvāt tathopalabdhyādiprasaṅgaḥ |	དེ་བཞིན་དུ་དམིགས་པ་ལ་སོགས་པར་ཐལ་བར་འགྱུར་རོ་༎
 nāpi svabhāvāntaramasyāvaraṇam tadavasthe tasminnāvaraṇāyogāt |	ངོ་བོ་ཉིད་གཞན་ནི་འདིའི་སྒྲིབ་པ་ཡིན་ཏེ་། དེའི་སོ་ན་འདུག་ན་དེ་ལ་སྒྲིབ་པར་ཡང་མི་རུང་བའི་ཕྱིར་རོ་༎
 nāpi vināśahetunā bhāvābhāvaḥ kriyate |	འཇིག་པའི་རྒྱུས་དངོས་པོ་མེད་པར་བྱེད་པར་ཡང་མ་ཡིན་ཏེ་།
 abhāvasya vidhinānyatayopagame vyatirekāvyatireka vikalpānatikramāt |	མེད་པའི་ཚུལ་དུ་ཁས་ལེན་ན་ཐ་དད་པ་དང་། ཐ་དད་པ་མ་ཡིན་པར་རྣམ་པར་རྟོག་པ་ལས་མ་འདས་པའི་ཕྱིར་རོ་༎
 bhāvapratiṣedhakaraṇe na tasya kiñcidbhavati na bhavatyeva kevalamiti |	དངོས་པོ་དགག་པའི་ངོ་བོ་ཉིད་གཅིག་ཡིན་ན་ནི་།
 evaṃ ca kartā na bhavatītyakarturahetutvamiti na vināśahetuḥ kaścit |	དངོས་པོ་མི་བྱེད་ཅེས་བྱ་བར་༄༢༤༢ཨ་༌་༎ འགྱུར་རོ་༎ དེ་ལྟ་ན་བྱེད་པ་པོ་མ་ཡིན་པ་ནི་རྒྱུ་ཉིད་མ་ཡིན་པས་འཇིག་པའི་རྒྱུ་འགའ་ཡང་མེད་དོ་༎ 
 (2|8) vaiyarthyācca |	དོན་མེད་པའི་ཡང་ཕྱིར་ཏེ་།
 yadi svabhāvato naśvaraḥ svātmanyanavasthāyī bhāvaḥ tasya na kiñcinnāśakāraṇaiḥ |	གལ་ཏེ་དངོས་པོ་རང་གི་ངོ་བོས་འཇིག་པ་ཡིན་ན་། དེ་ལ་འཇིག་པའི་རྒྱུ་ཅུང་ཟད་ཀྱང་མི་དགོས་ཏེ་།
 tatsvabhāvatayaiva svayaṃ nāśāt |	དེའི་ངོ་བོ་ཉིད་ཡིན་པ་ཁོ་ནས་བདག་ཉིད་འཇིག་པའི་ཕྱིར་རོ་༎
 yo hi yatsvabhāvaḥ sa svahetoreva utpadyamānaḥ tādṛśo bhavati,	གང་ཞིག་གང་གི་ངོ་བོ་ཉིད་ཡིན་པ་དེ་ནི་རང་གི་རྒྱུ་ཁོ་ན་ལས་སྐྱེ་བ་ན་དེ་ལྟ་བུར་འགྱུར་གྱི་།
 na punastadbhāve hetvantaramapekṣate |	དེ་ངོ་བོར་བྱ་བ་ལ་རྒྱུ་གཞན་ལ་ནི་མི་ལྟོས་ཏེ་།
 prakāśadravoṣṇakaṭhinadravyādivat |	གསལ་བ་དང་། གཤེར་བ་དང་། དྲོ་བ་དང་། སྲ་བ་ལ་སོགས་པའི་རྫས་དང་འདྲའོ་༎
 na hi prakāśādayastadātmāna utpannāḥ punaḥ prakāśādibhāve hetvantaramapekṣante |	གསལ་བ་ལ་སོགས་པ་དེ་དག་གི་བདག་ཉིད་དུ་བྱུང་བ་རྣམས་ནི་ཡང་གསལ་བ་ལས་ངོ་བོར་བྱ་བའི་ཕྱིར་། རྒྱུ་གཞན་ལ་མི་ལྟོས་ཏེ་།
 tadātmanastādātmyābhāve nairātmyaprasaṅgāt |	དེའི་བདག་ཉིད་ལ་དེའི་བདག་ཉིད་མེད་ན་བདག་ཉིད་མེད་པར་ཐལ་བར་འགྱུར་རོ་༎
 tadvadasthitidharmā cet svabhāvato bhāvo niṣpanno na punastadātmatāyāṃ hetvantaramapekṣate |	དེ་དང་འདྲ་བར་གལ་ཏེ་མི་གནས་པའི་ཆོས་ཅན་ཞིག་ཡིན་ན་ནི་། ངོ་བོ་ཉིད་ཀྱིས་གྲུབ་པ་ཡང་དེའི་བདག་ཉིད་དུ་བྱ་བའི་ཕྱིར་རྒྱུ་གཞན་ལ་མི་ལྟོས་སོ་༎ གལ་ཏེ་ས་བོན་ལ་སོགས་པ་བཞིན་དུ་མ་ངེས་པ་ཡིན་ནོ་སྙམ་སྟེ་།
 (2|9) bījādivadanekānta iti cet | syādetad bījādayo 'ṅkurādijananasvabhāvā |	འདི་སྙམ་དུ་ས་བོན་ལ་སོགས་པ་མྱུ་གུ་ལ་སོགས་པ་བསྐྱེད་པའི་རང་བཞིན་ཡང་།
 api salilādihetvantarāpekṣaṇāt na kevalā janayanti |	ཆུ་ལ་སོགས་པ་རྒྱུ་གཞན་ལ་ལྟོས་པའི་ཕྱིར་འབའ་ཞིག་གིས་ནི་སྐྱེད་པར་མི་བྱེད་དོ་༎
 tadvad bhāvo 'pi vināśe syādīt | na |	དངོས་པོ་འཇིག་པ་ཡང་དེ་དང་འདྲ་བར་འགྱུར་རོ་སྙམ་དུ་སེམས་ན་མ་ཡིན་ཏེ་།
 tasvabhāvasya jananādajanakasya cātatsvabhāvatvāt |	དེའི་ངོ་བོ་ཉིད་སྐྱེ་བའི་ཕྱིར་ལ་། སྐྱེད་པར་བྱེད་པ་མ་ཡིན་པ་ཡང་དེའི་ངོ་བོ་ཉིད་མ་ཡིན་པའི་ཕྱིར་རོ་༎
 ata eva tayoravasthayorvastubhedo niśceyaḥ |	དེ་ཉིད་ཀྱི་ཕྱིར་གནས་སྐབས་དེ་གཉིས་པོ་ཐ་དད་པར་ངེས་ཏེ་།
 bhāvānāṃ svabhāvānyathātvābhāvāt tatsvabhāvasya paścādiva prāgāpi jananaprasaṅgāt |	དངོས་པོ་རྣམས་ཀྱི་ངོ་བོ་ཉིད་གཞན་དུ་འགྱུར་བ་ཉིད་མེད་པས་། དེའི་ངོ་བོ་ཉིད་ནི་ཕྱིས་བཞིན་དུ་སྔོན་པོ་ཡང་སྐྱེད་པར་ཐལ་བར་འགྱུར་བའི་ཕྱིར་རོ་༎
 tasmādyo 'ntyo 'vasthāviśeṣaḥ sa evāṅkurajananasvabhāvaḥ |	དེ་ལྟ་བས་ན་གནས་སྐབས་ཀྱི་བྱེ་བྲག་ཐ་མ་གང་ཡིན་པ་དེ་ཉིད་མྱུ་གུ་ལ་སོགས་པ་སྐྱེད་པའི་ངོ་བོ་ཉིད་ཡིན་ནོ་༎
 pūrvabhāvinastu avasthāviśeṣā aṅkurakāraṇasya kāraṇāni iti nānekāntaḥ |	སྔོན་གྱི་གནས་སྐབས་ན་ཡོད་པའི་བྱེ་བྲག་རྣམས་ནི་རྒྱུའི་རྒྱུད་ཉིད་ཡིན་པས་མ་ངེས་པ་ཉིད་ཡིན་ནོ་༎ 
 kṣaṇikeṣu bhāveṣu aparāparotpatteraikyābhāvāt |	དེ་ལྟ་བས་ན་དངོས་པོ་སྐད་ཅིག་མ་རྣམས་ལ་གཞན་དང་གཞན་སྐྱེ་བས་གཅིག་པ་ཉིད་མེད་པའི་ཕྱིར་རོ་༎
 (2|10) yadi te 'ntyāḥ samarthāḥ kiṃ na janayanti pratyekamiti |	གལ་ཏེ་ཐ་མ་དག་ནུས་པ་ཡིན་ན་ཅིའི་ཕྱིར་སྐྱེད་པར་མི་བྱེད་ཅེ་ན་། སྐྱེད་པར་བྱེད་པ་ཁོ་ནའོ་༎
 janayantyeva nātrānyathābhāvaḥ svabhāsyāvaiparītyāt |	༄༢༤༢བ་འདི་ལ་གཞན་དུ་འགྱུར་བ་མེད་དེ་ངོ་བོ་ཉིད་བཟློག་པ་མེད་པའི་ཕྱིར་རོ་༎
 nanu teṣu sahakāriṣu samarthasvabhāveṣu ko 'parasyopayogaḥ?	གལ་ཏེ་ལྷན་ཅིག་བྱེད་པ་དེ་དག་ཐམས་ཅད་ནུས་པའི་ངོ་བོ་ཉིད་ཡིན་པ་ལ་།
 na vai bhāvānāṃ kācit prekṣāpūrvakāritā yataḥ ayamasmāsvanyatamo 'pi samarthaḥ kimasmābhiḥ kartavyam ityālocyāpare nivarteran |	གཞན་གྱི་ཉེ་བར་སྦྱོར་བ་ཅི་ཞིག་དགོས་ཤེ་ན་། དངོས་པོ་རྣམས་ལ་ནི་གང་གིས་ན་འདི་གཅིག་པུས་ཀྱང་ནུས་ན་བདག་གིས་ཅི་ཞིག་བྱ་ཞེས་གཞན་དག་ལྡོག་པར་འགྱུར་བ་རྟོག་པ་སྔོན་དུ་གཏོང་ཞིང་བྱེད་པ་ཅན་དག་ནི་འགའ་ཡང་མེད་པ་ཁོ་ན་སྟེ་།
 te nirabhiprāyavyāpārā eva svahetupariṇāmopanidhidharmāṇonopālambhamarhanti, tatprakṛteḥ |	སེམས་པ་མེད་པར་བྱེད་པ་ཅན་རང་གི་རྒྱུ་ཡོངས་སུ་གྱུར་པས་འདུ་བའི་ཆོས་ཅན་དག་ཡིན་ལ་། དེའི་རང་བཞིན་ལས་དེ་ལྟ་བུར་འགྱུར་བ་ལ་ཀླན་ཀ་བཙལ་བར་འོས་པ་མ་ཡིན་ལ་། 
 te samarthāḥ kiṃ nāparāparaṃ janayantīti cet |	ནོ་༎ གལ་ཏེ་ནུས་པ་དག་ཅིའི་ཕྱིར་གཞན་དང་གཞན་སྐྱེད་པར་མི་བྱེད་ཅེ་ན་ལ་། ནོ་༎ 
 na, tatraiva sāmarthyāt tasyaivaikasya janane samarthā nānyasyeti nāparāparajananam |	། མ་ཡིན་ཏེ་དེ་ཁོ་ན་ལ་ནུས་པའི་ཕྱིར་རོ་༎ གཅིག་པུ་དེ་ཉིད་བསྐྱེད་པར་བྱ་བར་ནུས་ཀྱི་།
 (2|11) bhinnasvabhāvebhyaścakṣurādibhyaḥ sahakāribhya ekakāryotpattau na kāraṇabhedāt kāryabhedaḥ syāditi cet | na |	གཞན་ལ་ནི་མ་ཡིན་པས་། གཞན་དང་གཞན་སྐྱེད་པ་མ་ཡིན་ནོ་༎ གལ་ཏེ་མིག་ལ་སོགས་པ་ལྷན་ཅིག་བྱེད་པ་ངོ་བོ་ཉིད་ཐ་དད་པ་དག་ལས་འབྲས་བུ་གཅིག་སྐྱེ་ན་རྒྱུའི་བྱེ་བྲག་ལས་འབྲས་བུའི་བྱེ་བྲག་ཏུ་མི་འགྱུར་རོ་ཞེ་ན་།
 yathāsvaṃ svabhāvabhedena tadviśeṣopayogastadupayogaiḥ kāryasvabhāvaviśeṣāsaṅkarāt |	མ་ཡིན་ཏེ་བདག་ཉིད་ཇི་ལྟ་བའི་ངོ་བོ་ཉིད་ཀྱི་བྱེ་བྲག་གིས་དེའི་ཁྱད་པར་ལ་ཉེ་བར་སྦྱོར་བའི་ཕྱིར་། དེའི་ཉེ་བར་སྦྱོར་བས་བྱ་བའི་ཁྱད་པར་འཆོལ་བ་མེད་པའི་ཕྱིར་རོ་༎
 yathā mṛtpiṇḍakulālasūtrā dibhyo bhavato ghaṭasya mṛtpiṇḍādamṛtsvabhāvebhyo vṛkṣādibhyo	དཔེར་ན་འཇི་བའི་གོང་བུ་དང་། རྫ་མཁན་དང་སྐུད་པ་ལ་སོགས་པ་དག་ལས་བུམ་པར་འགྱུར་བ་ལ་། འཇི་བའི་གོང་བུ་ལས་ནི་འཇི་བའི་ངོ་བོ་ཉིད་མ་ཡིན་པ་ཤིང་ལ་སོགས་པ་ལས་གཞན་པའི་ངོ་བོ་ཉིད་།
 bhinnaḥ svabhāvaḥ kulālāttasyaiva mṛdātmanaḥ sataḥ saṃsthāviśeṣātmatayā tadanyebhyo	རྫ་མཁན་ལས་ནི་འཇི་བའི་བདག་ཉིད་ཡིན་པ་དེ་ཉིད་དབྱིབས་ཀྱི་བྱེ་བྲག་གི་བདག་ཉིད་ཀྱིས་དེ་ལས་གཞན་པ་དག་ལས་ཐ་དད་པ་།
 bhinnaḥ sūtrāttasyaiva mṛtsaṃsthāna viśeṣātmanaḥ cakrādervibhaktaḥ svabhāvo bhavati |	སྐུད་པ་ལས་ནི་འཇི་བ་དང་དབྱིབས་ཀྱི་བྱེ་བྲག་གི་བདག་ཉིད་ཅན་དེ་ཉིད་འཁོར་ལོ་ལ་སོགས་པ་ལས་རྣམ་པར་ཕྱེ་བའི་ངོ་བོ་ཉིད་དུ་འགྱུར་བ་ལྟ་བུ་སྟེ་།
 tadevaṃ na kulālānmṛtsvabhāvatāḥ,	དེ་ལྟར་ན་རྫ་མཁན་ལས་ནི་འཇི་བའི་ངོ་བོ་ཉིད་མ་ཡིན་ལ་།
 na mṛdaḥ saṃsthānaviśeṣaḥ |	འཇི་བ་ལས་ཀྱང་དབྱིབས་ཀྱི་བྱེ་བྲག་མ་ཡིན་ནོ་༎
 na ca tayoḥ śāktiviśeṣaviṣayabhede 'pi tajjanitaviśeṣabhedasya kāryasya svabhāvena bhedaḥ mṛtsaṃsthānayoraparasparātmatayā saṃsthānamṛdrūpābhyāṃ tayorapratibhāsanaprasaṅgāt |	དེ་གཉིས་ཀྱི་ནུས་པའི་བྱེ་བྲག་གི་ཡུལ་ཐ་དད་ཀྱང་དེས་བསྐྱེད་པའི་ཁྱད་པར་གྱི་བྱེ་བྲག་གི་འབྲས་བུའི་ངོ་བོ་ཉིད་དི་ཐ་དད་པ་མ་ཡིན་ཏེ་། འཇི་བ་དང་དབྱིབས་དག་ཕན་ཚུན་གྱི་བདག་ཉིད་ཅན་མ་ཡིན་པ་ཉིད་ཀྱིས་མ་ཡིན་ཏེ་། ། དེ་གཉིས་དབྱིབས་དང་འཇི་བའི་ངོ་བོ་དག་ཏུ་མི་སྣང་བར་༄༢༤༣ཨ་༌་མ་ཡིན་ཏེ་། ། ༎ ཐལ་བར་འགྱུར་བའི་ཕྱིར་རོ་༎
 (2|12) anyadeva saṃsthānaṃ guṇo mṛddravyāt tena bhinnasvabhāvaḥ kulālamṛtpiṇḍayorupayogaviśeṣa iti cet | uktamatra |	གལ་ཏེ་ཡོན་ཏན་དབྱིབས་ནི་རྫས་ལས་གཞན་པ་ཁོ་ན་ཡིན་ཏེ་། དེས་ན་རྫ་མཁན་དང་། འཇི་བའི་ཉེ་བར་སྦྱོར་བའི་ཡུལ་ངོ་བོ་ཉིད་ཐ་དད་པ་ཡིན་ནོ་ཞེ་ན་འདི་ལས་བཤད་ཟིན་ཏོ་༎ 
 api ca yadi saṃsthānaṃ bhinnaṃ mṛdaḥ kulālaḥ kiṃ na pṛthakkaroti?	གཞན་ཡང་འཇི་བ་ལ་དབྱིབས་ཐ་དད་པ་ཞིག་ཡིན་ན་། རྫ་མཁན་གྱིས་ཅིའི་ཕྱིར་ལོགས་ཤིག་ཏུ་མི་བྱེད་།
 guṇasya dravyaparatantratvāt sa kathaṃ pṛthak kriyeta?	གལ་ཏེ་ཡོན་ཏན་ནི་རྫས་ཀྱིས་གཞན་གྱི་དབང་ཡིན་པས་ལོགས་ཤིག་ཏུ་མི་བྱེད་དོ་༎
 tatsaṃsthānādhārātmakaṃ yadi svabhāvenaiva tad dravyam, tatsaṃsthānaṃ vā tadādheyātmakaṃ,	གལ་ཏེ་རང་བཞིན་གྱི་རྫས་དེ་དབྱིབས་དེའི་རྟེན་གྱི་བདག་ཉིད་ཅན་ཡིན་པའམ་། དབྱིབས་དེ་དེ་ལ་རག་ལས་པའི་བདག་ཉིད་ཅན་ཞིག་ཡིན་ན་།
 tadā kimiti kulālavyāpāramapekṣate iti cet | na |	རྫ་མཁན་ལ་ལྟོས་ཅི་དགོས་ཤེ་ན་མ་ཡིན་ཏེ་།
 tataḥ parasparasambandhayogyatāpratilambhāt |	དེ་ལས་ཕན་ཚུན་འབྲེལ་དུ་རུང་པ་ཉིད་ཐོབ་པའི་ཕྱིར་རོ་༎
 anyathā mṛtpiṇḍasya svabhāvata eva tathāvidhasaṃsthānasambandhayogyatve vastuna eva prāgapi yogyatālakṣaṇā dharmatāstīti saṃsthānaviśeṣeṇa sambandhaḥ syāditi |	དེ་ལྟ་མ་ཡིན་ཏེ་དངོས་པོའི་ཆོས་ཉིད་རུང་བ་ཁོ་ནས་། སྔོན་ཡང་འཇི་བའི་གོང་བུ་དབྱིབས་ཀྱི་ཁྱད་པར་དང་འབྲེལ་དུ་རུང་བ་ཉིད་གཅིག་ཡིན་ན་ནི་དབྱིབས་ཀྱི་ཁྱབ་པ་དང་འབྲེལ་པའི་ཁྱད་པར་དུ་ཐལ་བར་འགྱུར་རོ་༎
 evaṃ tarthi sā yogyatā mṛddravyasya kulālād bhavatīti nānayoḥ svabhāvabhedaḥ | bhedehi prāgvat prasajyeta |	དེ་ལྟ་ཡིན་ན་ནི་འོ་ན་རྫས་འཇི་བའི་རུང་བ་དེ་རྫ་མཁན་ལས་འགྱུར་བས་འདི་གཉིས་ངོ་བོ་ཉིད་ཐ་དད་པ་ཡང་མ་ཡིན་ནོ་༎ ཐ་དད་པ་ཡིན་ན་ནི་།
 asti tāvadekasvabhāvatve 'pi ekasyānekapratyayopādheyaviśeṣateti kiṃ mṛtsaṃsthānayoḥ ekasvabhāvatvasādhanāya atinirbandhena |	སྔ་མ་བཞིན་དུ་ཐལ་བར་འགྱུར་བའི་ཕྱིར་རོ་༎ རེ་ཞིག་ངོ་བོ་ཉིད་གཅིག་པ་ཉིད་ལ་ཡང་རྐྱེན་དུ་མས་པར་དུ་བྱ་བ་འགའ་ཡོད་པས་། འཇི་བ་དང་དབྱིབས་དག་ངོ་བོ་ཉིད་གཅིག་ཏུ་བསྒྲུབ་པར་མི་འདོད་དོ་༎ དེས་ན་དངོས་སུ་འབྲས་སུ་ངོ་བོ་ཉིད་གཅིག་པ་ཉིད་ཡིན་ཡང་།
 (2|13) tena sahakāriṇaḥ pratyayā naikopayogaviṣayāḥ kāryasyaikasvabhāvatve 'pi vastuta iti yatheha kāraṇabhedo bhinnaviśeṣopayogāt naikakāryaḥ,	ལྷན་ཅིག་བྱེད་པའི་རྐྱེན་དག་ཉེ་བར་སྦྱོར་བའི་ཡུལ་གཅིག་པ་ཅན་མ་ཡིན་ན་། ཇི་ལྟར་འདིར་རྒྱུ་ཐ་དད་པའི་ཉེ་བར་སྦྱོར་བའི་ཡུལ་གཅིག་པ་ཅན་མ་ཡིན་ནོ་༎ ཇི་ལྟར་འདིར་རྒྱུ་ཐ་དད་པའི་ཉེ་བར་སྦྱོར་བའི་ཡུལ་ཐ་དད་པའི་ཕྱིར་འབྲས་བུ་གཅིག་པ་མ་ཡིན་པ་དེ་བཞིན་དུ་།
 tathā cakṣurādibhyo vijñānotpattau utreyaḥ |	མིག་ལ་སོགས་པ་ལ་མིག་གི་རྣམ་པར་ཤེས་པ་སྐྱེ་བ་ལ་ཡང་རིག་པར་བྱ་སྟེ་།
 tathā hi - samanantarapratyayādvijñānāccakṣurvijñānasya upalambhātmatā tasyaivopalambhātmanaḥ	འདི་ལྟར་མཚུངས་པ་དེ་མ་ཐག་པའི་རྐྱེན་ལས་ནི་མིག་གི་རྣམ་པར་ཤེས་པ་དམིགས་པའི་བདག་ཉིད་ཡིན་ལ་དམིགས་པའི་བདག་ཉིད་མིག་གི་དབང་པོ་ལས་ནི་གཟུགས་འཛིན་དུ་རུང་བ་ཉིད་དུ་སོ་སོར་ངེས་པ་ཡིན་།
 sataścakṣurindriyādrūpagrahaṇayogyatāpratiniyamaḥ viṣayāttattulyarūpateti abhinnatve	ཡུལ་ལས་ནི་དེ་དང་འདྲ་བའི་ངོ་བོ་ཅན་ཉིད་ཅེས་བྱ་བ་ཡིན་ནོ་༎
 'pi vastutaḥ kāryasya kāraṇānāṃ bhinnebhyaḥ svabhāvebhyo bhinnā eva viśeṣā bhvantīti	དངོས་སུ་འབྲས་བུ་ཐ་དད་པའི་ངོ་བོ་ཉིད་མ་ཡིན་ཡང་། རྒྱུའི་ངོ་བོ་ཉིད་ཐ་༄༢༤༣བ་དད་པ་དག་ལས་ཁྱད་པར་ཐ་དད་པ་ཁོ་ན་དག་ཏུ་འགྱུར་བས་། 
 na kāraṇabhede 'pi abhedastatkāryaviśeṣasya |	རྒྱུ་ཐ་དད་པ་ཡིན་ཡང་དེས་བྱ་བའི་ཁྱད་པར་ཐ་མི་དད་པ་ཡིན་ནོ་༎
 ta evaite kāraṇaśaktibhedā yathāsvaṃ prativiśiṣṭakāryajanane 'vyavadheyaśaktitayā pratyupasthitāḥ kṣaṇikatvātsāmagrīkāryasya svabhāvasthityāśrayaityucyante	རྒྱུའི་ནུས་པ་ཐ་དད་པ་དེ་དག་ཁོ་ན་སྐད་ཅིག་པ་ཡིན་པའི་ཕྱིར་། བདག་ཉིད་ཇི་ལྟ་བ་བཞིན་སོ་སོའི་ཁྱད་པར་ཅན་གྱི་འབྲས་བུ་སྐྱེད་པར་ནུས་པ་ཆོད་པ་མེད་པ་ཉིད་དུ་ཉེ་བར་གནས་པ་ནི་ཚོགས་པའི་འབྲས་བུའི་ངོ་བོ་ཉིད་གནས་པའི་གཞི་དག་ཡིན་ཞེས་བྱ་སྟེ་།
 tathāhi tattebhyaḥ samastebhyaḥ upalambhātmakaṃ rūpagrahaṇaṃ pratiniyataṃ viṣayarūpaṃ ceti prativiśiṣṭasvabhāvamekameva jātam | (2|14) apratirodhaśaktikeṣu anantarakāryeṣu anādheyaviśeṣeṇu kṣaṇikeṣu pratyayeṣu parasparaṃ kaḥ sahakārārthaḥ?	འདི་ལྟར་དེ་ནི་དེ་མཐའ་དག་ལས་དམིགས་པའི་བདག་ཉིད་དང་། གཟུགས་འཛིན་པར་སོ་སོར་ངེས་པ་དང་། ཡུལ་དང་ངོ་བོ་ཅན་ཞེས་བྱ་བ་སོ་སོའི་ཁྱད་པར་ཅན་གྱི་ངོ་བོ་ཉིད་གཅིག་སྐྱེས་སོ་༎ གལ་ཏེ་ནུས་པ་འགོག་པ་མེད་པ་འབྲས་བུ་མཇུག་ཐོགས་པ་སྐད་ཅིག་པ་ཁྱད་པར་དུ་བོགས་དབྱུང་དུ་མེད་པ་དག་གི་རྐྱེན་རྣམས་ལ་༎ ། ཕན་ཚུན་ལྷན་ཅིག་བྱེད་པའི་དོན་ཅི་ཞིག་ཡིན་ཞེ་ན་།
 na vai sarvatrātiśayotpādanaṃ sahakriyā kā tarhi?	ལྷན་ཅིག་བྱེད་པ་ནི་ཐམས་ཅད་དུ་བོགས་འབྱིན་པ་སྐྱེད་པ་འབའ་ཞིག་ཀྱང་མ་ཡིན་ནོ་༎ འོ་ན་ཅི་ཞེ་ན་།
 ekārthakaraṇaṃ yad bahūnāmapi |	མང་པོ་དག་དོན་གཅིག་བྱེད་པ་གང་ཡིན་པ་ཡིན་ཏེ་།
 yathāntyasya kāraṇakalāpasya |	དཔེར་ན་ཚོགས་ཐ་མ་ལྟ་བུའོ་༎
 tadeva mukhyaṃ sahakāritvaṃ sahakāriṇāṃ,	འདི་ཉིད་དངོས་སུ་ལྷན་ཅིག་བྱེད་པ་རྣམས་ཀྱི་ལྷན་ཅིག་བྱེད་པ་ཡིན་ཏེ་།
 tasyaivāntyasya kāraṇatvāt |	ཐ་མ་དེ་ཉིད་རྒྱུ་ཡིན་པའི་ཕྱིར་རོ་༎
 tatra ca kṣaṇe ekasya svabhāvasyāvivekād viśeṣasya kartumaśakyatvāt,	སྐད་ཅིག་མ་དེ་ལ་ངོ་བོ་ཉིད་གཅིག་ལ་དབྱེ་བ་མེད་པས་ཁྱད་པར་དུ་བྱ་བར་མི་ནུས་པའི་ཕྱིར་ཏེ་།
 svabhāvāntarotpattilakṣaṇatvād viśeṣotpatteḥ | bhāvāntarajanane 'ntyatvameva hīyeta |	ཁྱད་པར་འབྱུང་བའི་མཚན་ཉིད་ནི་། ངོ་བོ་ཉིད་གཞན་འབྱུང་བའི་ཕྱིར་རོ་༎ ངོ་བོ་ཉིད་གཞན་འབྱུང་ན་ནི་ཐ་མར་མི་འགྱུར་ཏེ་།
 tataśca na sākṣātkāraṇaṃ syāt |	དེའི་ཕྱིར་མངོན་སུམ་གྱི་རྒྱུར་མི་འགྱུར་རོ་༎
 tasmānna kāraṇasya sahakāribhyo viśeṣasyotpattiḥ |	དེ་ལྟ་བས་ན་ལྷན་ཅིག་བྱེད་པ་རྣམས་ལས་རྒྱུའི་ཁྱད་པར་འབྱུང་བ་མ་ཡིན་ནོ་༎
 te samarthā eva svabhāvato 'ntyāḥ pratyayāḥ saha jāyante kṣaṇikā yeṣāṃ prākpaścātpṛthagbhāvo nāsti, yebhyaścānantarameva kāryamutpadyate |	གང་དག་ལ་སྔོན་དང་ཕྱིས་དང་ཐ་དད་པའི་ངོ་བོ་མེད་པ་། གང་གི་མཇུག་ཐོགས་སུ་འབྲས་བུ་འབྱུང་བའི་རྐྱེན་ཐ་མ་ངོ་བོ་ཉིད་ཀྱིས་ནུས་པར་སྐད་ཅིག་པ་དེ་དག་ལྷན་ཅིག་སྐྱེ་སྟེ་།
 tatra ekārthakriyaiva sahakāritvam |	དེ་ལ་བྱ་བ་གཅིག་པ་ཁོ་ན་ལྷན་ཅིག་བྱེད་པ་ཉིད་ཡིན་ནོ་༎
 (2|15) samarthaḥ kuto jāyata iti cet |	གལ་ཏེ་ནུས་པ་དེ་དག་ག་ལས་བྱུང་ཞེ་ན་།
 svakāraṇebhyaḥ |	རང་གི་ངག་ལས་སོ་༎
 tāni enamaparasannidhāna evaṃ kiṃ janayanti? kadācidanyathāpi syuḥ tataścaiko 'pi kvacit janayed iti cet |	གལ་ཏེ་དེ་དག་གིས་འདི་རྐྱེན་གཞན་དང་ཉེ་བ་མེད་པ་ཁོ་ནར་ཅི་སྟེ་མི་སྐྱེད་དེ་རེས་འགའ་གཞན་དུ་ཡང་འགྱུར་རོ་༎ དེའི་ཕྱིར་ལ་ལར་གཅིག་པུས་ཀྱང་སྐྱེ་བར་འགྱུར་རོ་ཞེ་ན་།
 aparāpara pratyayayogena pratikṣaṇaṃ bhinnaśaktayaḥ saṃskārāḥ santanvanto yadyapi kutaścitsāmyātsarūpāḥ pratīyante tathāpi bhitra evaiṣāṃ svabhāvaḥ	འདུ་བྱེད་རྒྱུ་མ་གཞན་དང་གཞན་གྱི་རྐྱེན་དང་ལྡན་པས་། སྐད་ཅིག་མ་རེ་རེ་ལ་ནུས་པ་ཐ་དད་པ་ཅན་དག་འགའ་ཞིག་གིས་མཚུངས་པས་ངོ་བོ་འདྲ་བར་ཤེས་མོད་ཀྱི་། དེ་༄༢༤༤ཨ་༌་༎ ལ་འདི་དག་གི་ངོ་བོ་ཉིད་ཐ་དད་པ་ཁོ་ན་ཡིན་ཏེ་།
 tena kiñcideva kasyacit kāraṇam |	དེས་ན་འགའ་ཞིག་ཁོ་ན་འགའ་ཞིག་གི་རྒྱུ་ཡིན་ནོ་༎
 tatra yo 'vyavadhanādideśo rūpendriyādikalāpaḥ sa vijñānajanane samartho hetuḥ |	དེ་ལ་གཟུགས་དང་དབང་པོ་ལ་སོགས་པའི་ཚོགས་ཡུལ་ཆོད་པ་མེད་པ་ལ་སོགས་པ་དང་ལྡན་པ་ཅན་གང་ཡིན་པ་དེ་ནི་། རྣམ་པར་ཤེས་པ་སྐྱེད་པར་ནུས་པའི་རྒྱུ་ཡིན་ནོ་༎
 yasteṣāṃ parasparopasarpaṇādyāśrayaḥ pratyayaviśeṣaḥ sa taddhetujanane samarthaḥ	དེ་དག་ཕན་ཚུན་ཉེ་བར་འགྲོ་བ་ལ་སོགས་པའི་རྟེན་རྐྱེན་གྱི་ཁྱད་པར་གང་ཡིན་པ་དེ་ནི་དེའི་རྒྱུ་སྐྱེད་པར་ནུས་པ་ཡིན་ནོ་༎
 teṣāṃ ca na pūrvaṃ na paścātra pṛthagbhāva iti samarthānapi pūrvāparapṛthagbhāvbhāvino doṣā nopalīyante |	དེ་དག་ཀྱང་སྔོན་ཡང་མེད་། ཕྱིས་ཀྱང་མེད་། སོ་སོ་ན་ཡང་མེད་པས་ནུས་ཀྱང་སྔོན་དང་ཕྱིས་ཀྱང་སོ་སོ་ན་ཡོད་པ་ལས་འབྱུང་བའི་ཉེས་པ་དག་གིས་མི་གོས་སོ་༎
 tena yasteṣāṃ parasparopasarpaṇādihetuḥ sa samarthasya heturiti tatra na kadācidanyathābhāvaḥ |	དེ་དག་ན་འདི་དག་ཕན་ཚུན་ཉེ་བར་འགྲོ་བ་ལ་སོགས་པའི་རྒྱུ་གང་ཡིན་པ་དེ་ནུས་པའི་རྒྱུ་ཡིན་པས་། དེ་ལ་ནམ་ཡང་གཞན་དུ་འགྱུར་བ་མེད་དོ་༎
 (2|16) anena nyāyena sarvatra hetuphalabhāvapratiniyamo draṣṭavyaḥ pratikṣaṇamanyānyasvabhāvabhedānvayinīṣu śaktiṣu,	ཚུལ་འདིས་ཐམས་ཅད་ལ་རྒྱུ་དང་འབྲས་བུའི་ངོ་བོ་སོ་སོར་ངེས་པ་ཁོང་དུ་ཆུད་པར་བྱའོ་༎ དངོས་པོའི་ནུས་པ་སྐད་ཅིག་མ་རེ་རེ་ལ་ངོ་བོ་ཉིད་ཀྱི་བྱེ་བྲག་གཞན་དང་གཞན་གྱི་རྗེས་སུ་འགྲོ་བ་ཅན་དག་ལ་ཡིན་གྱི་དངོས་པོ་བསྟན་པ་གཅིག་པུའི་ངོ་བོ་ཉིད་ཅན་དག་ལ་ནི་མ་ཡིན་ཏེ་།
 na tu sthiraikasvabhāveṣu bhāveṣu svabhāvasyānyathātvāsaṃbhavāt | samarthāsamarthasvabhāvayoḥ kriyākriyānupapatteḥ |	ངོ་བོ་ཉིད་གཞན་དུ་འགྱུར་བ་མེད་པས་ནུས་པ་དང་མི་ནུས་པའི་ངོ་བོ་ཉིད་དག་ལ་བྱེད་པ་དང་མི་བྱེད་པ་མི་རུང་བའི་ཕྱིར་རོ་༎ 
 anyasahitaḥ karoti na kevala iti cet |	གལ་ཏེ་ལྷན་ཅིག་བྱེད་ཀྱི་འགའ་ཞིག་ནི་མ་ཡིན་ནོ་ཞེ་ན་།
 kiṃ kevalasya kāryajanane 'samarthaḥ svabhāvaḥ? samartha iti cet |	ཅི་འབའ་ཞིག་གིས་འབྲས་བུ་བསྐྱེད་པར་ནུས་སམ་། མི་ནུས་སོ་༎
 kiṃ na karoti?	ཅིའི་ཕྱིར་མི་བསྐྱེད་།
 akurvan kathaṃ samarthaḥ?	མི་བསྐྱེད་ན་ཇི་ལྟར་ནུས་།
 kuvindādayaḥ paṭādikriyāyāṃ samarthā api na sarvatra kurvantīti cet |	གལ་ཏེ་ཐ་ག་ལ་སོགས་པ་རས་ཡུག་ལ་སོགས་པ་བྱ་བར་ནུས་མོད་ཀྱི་། ཐམས་ཅད་དུ་ནི་མི་བྱེད་དོ་ཞེ་ན་།
 krīḍanaśīlo devānāṃ priyaḥ sukhaidhitaḥ kṛtamapi punaḥ punaḥ kārayati,	བརྩེ་བའི་དང་ཚུལ་ཅན་བླུན་པོ་རྣམས་དགའ་བ་སྐྱེད་དེ་བར་བསྐྱེད་པ་ནི་བྱས་ཤིང་བྱས་པ་ལ་ཡང་དང་ཡང་བྱེད་དུ་གཞུག་སྟེ་།
 tathāhi bījādivad ityanena nirloṭhitameva |	འདི་ལྟར་འདི་ནི་ས་བོན་ལ་སོགས་པ་ཉེ་བར་འགོད་པར་དཔྱད་ཟིན་ཏོ་༎
 tasmātsvabhāvasyānyathātvāsambhavāt taddharmaṇaḥ tathābhāvaḥ antyāvasthāvadanivāryaḥ |	དེ་ལྟ་བས་ན་ངོ་བོ་ཉིད་གཞན་དུ་འགྱུར་བ་མེད་པའི་ཕྱིར་རོ་༎ དེའི་ཆོས་ཅན་གྱི་ངོ་བོ་ཉིད་དེ་ལྟ་བུ་ནི་ཐ་མའི་གནས་སྐབས་བཞིན་དུ་བཟློག་ཏུ་མི་རུང་ངོ་༎ 
 antyāvasthāyāṃ prāgasamarthasya sāmarthyotpattau tasya sāmarthyasya tatsvabhāvatve 'pūrvotpattirevasā |	ཐ་མའི་གནས་སྐབས་ན་སྔོན་ནུས་པ་མེད་པ་ལས་ནུས་པ་སྐྱེ་ན་། ནུས་པ་དེའི་ངོ་བོ་ཉིད་ཡིན་ན་ནི་། སྔོན་མེད་པ་སྐྱེ་བ་ཁོ་ན་ཡིན་ནོ་༎
 atatsvabhāvatve saḥ akāraka eva sāmarthyākhyātpadārthāntarāt kāryotpattyabhyupagamāt |	དེའི་ངོ་བོ་ཉིད་མ་ཡིན་ན་ནི་བྱེད་པ་པོ་མ་ཡིན་པ་ཉིད་དེ་། ནུས་པ་ཞེས་བྱ་བའི་དངོས་པོ་ལས་འབྲས་བུ་སྐྱེ་བའི་ཕྱིར་རོ་༎
 (2|17) api ca yo 'sau sakaleṣu sahakāriṣu karoti sa tadaiva kasmāt karoti |	གཞན་ཡང་རེ་ཞིག་དེ་ཉིད་ལྷན་ཅིག་བྱེད་པ་མཐའ་༄༢༤༤བ་དག་དང་ལྡན་པ་འབྲས་བུ་ཇི་སྟེ་སྐྱེད་། བསྐྱེད་པ་མཐོང་སྟེ་།
 ? kurvan dṛṣṭastena karotīti brūmaḥ |	དེས་ན་བསྐྱེད་དོ་ཞེས་སྨྲའོ་༎
 aho mahāsāmarthyaṃ mahāprabhāvasya darśanaṃ yasmādatatsvabhāvān api bhāvān svabhāvamātreṇa nānāprakāreṣu vyāpāreṣu niyuṅkte |	མཐུ་ཆེན་པོ་ཅན་གྱི་མཐོང་བ་དངོས་པོ་དེའི་ངོ་བོ་ཉིད་མ་ཡིན་པ་དག་ཀྱང་། རང་གི་ངོ་བོ་ཙམ་གྱིས་བྱ་བ་སྣ་ཚོགས་པ་རྣམས་ལ་སྦྱོར་བ་ནི་ནུས་པ་ཆེན་པོ་ཅན་ཡིན་ནོ་༎ 
 yadi nāma kiñcit kathañcidatrabhavato darśanaviṣayatām atikrāmet,	བརྒྱ་ཞིག་ལ་འགའ་ཞིག་ཇི་ཞིག་ལྟར་འདིར་ཁྱོད་ཀྱི་མཐོང་བའི་ལམ་ལས་འདས་ཅན་ཡིན་ནོ་༎ ན་། ཀྱེ་མ་མི་སྐྱེད་པའི་ཆོས་ཅན་ཡིན་ཏེ་།
 hanta aprasavadharmakamapetasantānaṃ syaditīyaṃ cintā cittaṃ dunoti |	རྒྱུ་མེད་པ་ཅན་དུ་འགྱུར་བས་བསམ་པ་འདི་ནི་སེམས་ལ་གདུང་ངོ་༎
 na vai vayam atatsvabhāvānāṃ bhāvānām asmaddarśanavaśāt kāryakriyāṃ brūmaḥ kintu svabhāvenaiva te kāryakāraṇadharmāḥ,	ཁོ་བོ་ནི་དེའི་ངོ་བོ་ཉིད་མ་ཡིན་པ་ལས་བདག་གིས་མཐོང་བས་འབྲས་བུ་བསྐྱེད་དོ་ཞེས་མི་ཟེར་རོ་༎ འོ་ན་ཅི་ཞེ་ན་དེ་དག་ནི་ངོ་བོ་ཉིད་ཀྱིས་དེ་སྐྱེད་པའི་ཆོས་མི་ཟེར་རོ་༎ ཅན་ཡིན་ལ་། 
 tān paśyantaḥ kevalaṃ jānīmahe te ete kārakasvabhāvā iti | (2|18) satyam idamapyasti,	དེ་དག་མཐོང་ན་འདི་དག་ནི་སྐྱེད་པ་པོ་ཡིན་ནོ་ཞེས་བྱ་བར་ཤེས་པར་ཟད་དོ་༎
 svabhāvasteṣāṃ kāryakriyādharmā tena samastapratyayānāmakṛtvā kāryaṃ nopekṣāpattiriti |	འདི་ཡང་ཡོད་པར་བདེན་ན་དེ་དག་འབྲས་བུ་བསྐྱེད་པའི་ཆོས་ཀྱི་ངོ་བོ་ཉིད་ཡིན་པ་དེས་ན་། རྐྱེན་མཐའ་དག་དང་ལྡན་པ་རྣམས་མ་བསྐྱེད་པར་བཏང་སྙོམས་སུ་འཁོད་དོ་ཞེས་བྱ་བ་ནི་མ་ཡིན་ནོ་༎
 so 'kṣepakriyādharmā svabhāvaḥ kiṃ teṣāṃ tadaivāntyāvasthāyāmutpanna āhosvit prāgapyāsīt?	ཅི་དེ་དག་གི་མི་སྡོད་པར་བསྐྱེད་པའི་ཆོས་ཅན་གྱི་ངོ་བོ་ཉིད་དེ་། ཐ་མའི་གནས་སྐབས་དེ་ཁོ་ནའི་ཚེ་འབྱུང་ངམ་།
 āsīt, apracyutā nutpatrasthiraikasvabhāvānā kadācit kasyacitsvabhāvasyābhāvavirodhāt |	འོན་ཏེ་སྔོན་ཡང་ཡོད་དེ་མ་ཉམས་མ་བྱུང་བ་བརྟན་པ་གཅིག་པུའི་ངོ་བོ་ཉིད་ཅན་རྣམས་ལ་ངོ་བོ་ཉིད་འགའ་མེད་བ་འགལ་བའི་ཕྱིར་རོ་༎ 
 tatkimidānīṃ mātā ca vandhyā ca asti?	དེ་ནི་ཅི་དེ་མ་ཡང་ཡིན་མོ་གཤམ་ཡང་ཡིན་ནམ་།
 ko vāsya bhāṣitasyārthaḥ- akṣepakriyāsvabhāvaḥ kāryaṃ ca na karotīti |	མི་སྡོད་པར་སྐྱེད་པའི་ཆོས་ཀྱི་ངོ་བོ་ཉིད་ཀྱང་ཡིན་ལ་། མི་སྐྱེད་པ་ཡང་ཡིན་ནོ་ཞེས་སྨྲས་པ་འདིའི་དོན་ཅི་ཡིན་།
 (2|19) sahitaḥ svakāryajananasvabhāvaḥ na kevala iti cet |	གལ་ཏེ་དེའི་ངོ་བོ་ནི་ལྷན་ཅིག་པ་ཡིན་གྱི་། འབའ་ཞིག་ནི་མ་ཡིན་ནོ་ཞེ་ན་།
 anyastarhi kevalo 'nyaśca sahitaḥ svabhāvabhedāt |	འོ་ན་ནི་འབའ་ཞིག་ཀྱང་གཞན་ལ་ལྷན་ཅིག་པ་ཡང་གཞན་ཡིན་ཏེ་།
 svabhāvabheda eva hi bhāvabhedasya lakṣaṇam |	དངོས་པོ་ཐ་དད་པའི་མཚན་ཉིད་ནི་། ངོ་བོ་ཉིད་ཐ་དད་པ་ཡིན་པའི་ཕྱིར་རོ་༎
 na hi sa sāhitye 'pi pararūpeṇa kartā syāt |	ལྷན་ཅིག་པ་ཉིད་ཡིན་ཡང་གཞན་གྱི་ངོ་བོས་བྱེད་པ་པོ་ནི་མ་ཡིན་ལ་།
 svarūpaṃ ca tasya prāgapi tadeveti kathaṃ kadacit kriyāvirāmaḥ |	འདིའི་རང་གི་ངོ་བོ་ནི་སྔོན་ཡང་དེ་ཁོ་ནར་ཟད་ན་། ཇི་ལྟར་རེས་འགའ་སྐྱེད་པ་དང་འབྲལ་།
 yasyāpi bhāvah kṣaṇikaḥ tasyāpi kasmāt kevalo na karoti? yadi bhavet kuryādeva | kathaṃ na bhavati?	གང་གི་དངོས་པོ་སྐད་ཅིག་པ་ཡིན་པ་དེའི་ལྟར་ན་ཡང་ཇི་སྟེ་འབའ་ཞིག་གིས་མི་སྐྱེད་། གལ་ཏེ་ཡིན་ན་ནི་སྐྱེད་པ་ཁོ་ནའོ་༎
 kṣaṇikatvāt |	མ་ཡིན་ན་སྐད་ཅིག་མ་ཡིན་པའི་ཕྱིར་རོ་༎
 uktaṃ yādṛśasya kriyā |	ཇི་ལྟ་བུ་ཞིག་བསྐྱེད་པ་ནི་བཤད་ཟིན་ཏེ་།
 sa kathamekakṣaṇabhāvī anyathā bhavet?	སྐད་ཅིག་མ་འབྱུང་བ་ཅན་དེ་ཇི་ལྟར་གཞན་དུ་འགྱུར་།
 yaśca bhavati sa eva na bhavatīti nāyaṃ prasaṅgaḥ kārakākārakayoḥ svabhāvataddhetvorvirodhāt |	གང་ཞིག་འགྱུར་བ་དེ་ནི་དེ་ཉིད་༄༢༤༥ཨ་༌་༎ མ་ཡིན་པས་ཐལ་བ་འདིར་མི་འགྱུར་ཏེ་། བྱེད་པ་པོ་དང་། བྱེད་པ་པོ་མ་ཡིན་པ་དག་གི་ངོ་བོ་ཉིད་དང་དེའི་རྒྱུ་དག་འགལ་བའི་ཕྱིར་རོ་༎
 (2|20) yo 'pi manyate- akṣepakriyādharmaiva sa tasya svabhāvaḥ,	གང་ཞིག་དེའི་ངོ་བོ་ཉིད་དེ་ནི་མི་སྡོད་པར་སྐྱེ་བའི་ཆོས་ཅན་ཁོ་ན་ཡིན་པས་།
 na sa sāhityamapekṣate,	དེ་ནི་ལྷན་ཅིག་པ་ཉིད་ལ་མི་ལྟོས་སོ་༎
 kāryaṃ tu pratyayāntarāpekṣamiti sahitebhya eva jāyate na kevalebhya iti,	འབྲས་བུ་ནི་རྐྱེན་གཞན་ལ་ལྟོས་པས་། ལྷན་ཅིག་པ་ཁོ་ན་ལས་སྤྱིའི་འབའ་ཞིག་ལས་ནི་མ་ཡིན་ནོ་སྙམ་དུ་སེམས་ན་།
 tasyāpi kathaṃ- sa bhāvaḥ kevalo 'pi karotyeva? kāryaṃ ca tasmātrotpadyate iti tadavastho virodhaḥ |	དེ་ལྟར་ན་ཡང་ཅི་ལྟར་དེ་འབའ་ཞིག་གིས་ཀྱང་སྐྱེད་པ་ཁོ་ན་ཡིན་ལ་འབྲས་བུ་ཡང་དེ་ལས་མི་སྐྱེ་ཞེས་བྱ་སྟེ་། གནས་སྐབས་དེ་ནི་འགལ་ལོ་༎
 na kevalaḥ karotyeveti cet |	གལ་ཏེ་འབའ་ཞིག་གིས་སྐྱེད་པ་ཁོ་ནི་མ་ཡིན་ནོ་ཞེ་ན་།
 kathamidānīmakṣepakriyāsvabhāvaḥ |	ད་ནི་ཇི་ལྟར་ན་མི་འདོད་པར་སྐྱེད་པའི་ངོ་བོ་ཉིད་ཡིན་ཏེ་།
 nanu etadeva paridīpitaṃ bhavati, karotyeveti |	འདི་སྐད་དུ་སྐྱེད་པ་ཁོ་ནའོ་ཞེས་ཡོངས་སུ་བསྟན་པ་མ་ཡིན་ནམ་།
 kāryaṃ cāyaṃ kevalo 'pi samarthaḥ san paramapekṣamāṇaṃ kathamupekṣeta?	འདི་འབའ་ཞིག་ཀྱང་ནུས་པ་ཡིན་ན་། འབྲས་བུ་གཞན་ལ་ལྟོས་ན་ཡང་ཇི་ལྟར་བཏང་སྙོམས་སུ་འཇོག་སྟེ་།
 paramanādṛtyaitat prasahya kuryāt |	གཞན་ལ་མི་འཆོལ་བར་འདི་གསལ་བར་སྐྱེད་པར་འགྱུར་རོ་༎
 evaṃ hi anenātmanaḥ sāmarthyaṃ darśitaṃ bhavati |	དེ་ལྟ་ན་འདིས་བདག་ཉིད་ཀྱི་ནུས་པ་བསྟན་པ་ཡིན་ནོ་༎
 kāryaṃ paramapekṣata iti tataḥ kevalād anutpattimasya kathayasi sa kevalo 'pi samarthasvabhāva iti tataḥ utpattiṃ brūṣe,	འབྲས་བུ་གཞན་ལ་ལྟོས་སོ་ཞེས་བྱ་བ་ནི་དེ་འབའ་ཞིག་ལས་མི་སྐྱེ་བར་སྨྲ་བ་ཡིན་ལ་། དེ་འབའ་ཞིག་ཀྱང་ནུས་པའི་ངོ་བོ་ཉིད་ཡིན་ནོ་ཞེས་བྱ་བ་ནི་། དེ་ལས་སྐྱེ་བར་སྨྲས་པ་ཡིན་ན་།
 ete ca kathamevatraṃ syātām?	འདི་དག་གཅིག་ལ་ཇི་ལྟར་འགྱུར་ཏེ་།
 tadayamīrṣyāśalyavitudyamānamarmā viklavaṃ vikrośatītyupekṣāmevārhati |	དེ་ལྟ་བས་ན་ཕྲག་དོག་གི་ཟུག་རྡུས་གནད་དུ་བརྒྱབ་པ་ཅན་འདི་འཆལ་ཞིང་འཁང་བར་ཟད་པས་། བཏང་སྙོམས་སུ་དོར་བར་འོས་སོ་༎
 tasmādidamekārthakriyālakṣaṇaṃ sahakāritvaṃ kṣaṇikānāmeva bhāvānām |	དེ་ལྟ་བས་ན་གཅིག་སྐྱེད་པའི་མཚན་ཉིད་ཀྱི་ལྷན་ཅིག་བྱེད་པ་ཉིད་ནི་།
 na tu akṣaṇikānāṃ yeṣāṃ pṛthagapi bhāvaḥ sambhavati pṛthak kāryakaraṇasambhavena sahakāritvaniyamāyogāt | (2|21) yatra tu santānopakāreṇa bhāvāḥ hetutāṃ pratipadyante,	དངོས་པོ་སྐད་ཅིག་པ་རྣམས་ཁོ་ནའི་ཡིན་གྱི་སྐད་ཅིག་པ་མ་ཡིན་པ་སོ་སོ་ན་ཡོད་པ་སྲིད་པ་ཅན་རྣམས་ཀྱི་ནི་མ་ཡིན་ཏེ་། སོ་སོར་སྐྱེད་པར་སྲིད་པས་ལྷན་ཅིག་བྱེད་པ་ཉིད་དུ་ངེས་པ་མི་རུང་པའི་ཕྱིར་རོ་། ༎ གང་དུ་རྒྱུན་གྱིས་ཕན་འདོགས་པས་དངོས་པོ་རྣམས་རྐྱེན་ཉིད་དུ་སྟོན་པ་དཔེར་ན་འབྲས་ཐུག་པོ་ཆེ་དང་ས་བོན་ལ་སོགས་པ་ལས་འབྲས་ཆན་དང་མྱུ་གུ་ལ་སོགས་པ་འབྱུང་པ་། ༎ ལས་། 
 yathā taṇḍulabījādibhya odanāṅkurādijanmani dahanodakapṛthivyādayaḥ,	མེ་དང་ཆུ་དང་ས་ལ་སོགས་པ་ལྟ་བུ་དེ་ལ་ནི་།
 tatra santānāśrayeṇa viśeṣotpādanaṃ pratyayānāṃ sahakriyocyate na dravyāśrayeṇa,	རྒྱུ་ལ་བརྟེན་ནས་ཁྱད་པར་འབྱུང་བ་ལ་། རྐྱེན་རྣམས་ཀྱི་ལྷན་ཅིག་བྱེད་པར་བཤད་ཀྱི་། རྫས་ལ་བརྟེན་ནས་ནི་མ་ཡིན་ཏེ་།
 kṣaṇike dravye viśeṣasyānutpatteḥ |	རྫས་སྐད་ཅིག་པ་ལ་ཁྱད་པར་འབྱུང་བ་མེད་པའི་ཕྱིར་རོ་༎
 nahi taṇḍulādīnāṃ viśeṣānutpattau dahanādibhāve 'pi odanajanma syāt |	འབྲས་ཐུག་པོ་ཆེ་ལ་སོགས་པ་མེ་ལ་སོགས་པ་ལ་རིམ་གྱིས་ངོ་བོ་ཉིད་ཁྱད་པར་གྱུར་པ་མི་འབྱུང་༄༢༤༥བ་ན་། འབྲས་ཆན་ལ་སོགས་པ་འགྲུབ་པའམ་།
 tathā prabhāsvarādapavarakaṃ praviṣṭasya yadīndriyaṃ svopakāribhyo 'tiśayaṃ krameṇa na pratipadyeta tadā prāgivārthapratilpattiṃ naiva janayet	སྣང་བ་ནས་མུན་ཁང་དུ་ཞུགས་པའི་དབང་པོ་ལ་རང་གིས་ཕན་འདོགས་པ་དག་ལས་རྒྱུན་གྱི་ཁྱད་པར་མི་འབྱུང་ན་དོན་རྟོགས་པ་སྐྱེ་བ་མེད་དོ་༎ ཐོགས་པ་མེད་པར་སྐྱེད་པའི་དབང་པོ་ལ་སོགས་པ་ནི་། ཕན་ཚུན་ལས་ཁྱད་པར་འབྱུང་བ་མེད་དེ་།
 akṣepakāriṣu indriyādiṣu na viśeṣotpattiḥ parasparataḥ sambhavati | tatra yathāsvaṃ pratyayaiḥ parasparopasarpaṇādyāśrayairye yogyadeśādyavasthā jātāste saha svabhāvaniṣpattyā jñānahetutāṃ pratipadyante ityekārthakriyaiva sahakāritvam |	དེར་ནི་ཕན་ཚུན་ཉེ་བར་འགྲོ་བ་ལ་སོགས་པའི་རྟེན་བདག་ཉིད་ཇི་ལྟ་བའི་རྐྱེན་རྣམས་ཀྱིས་རུང་བའི་ཡུལ་ལ་སོགས་པར་གནས་པ་ཅན་སྐྱེད་པ་དེ་དག་ལྷན་ཅིག་ངོ་བོ་ཉིད་གྲུབ་པས་༎ ཤེས་པའི་རྐྱེན་ཉིད་དུ་ཤེས་པས་དོན་གཅིག་བྱེད་པ་ཁོ་ན་ལྷན་ཅིག་བྱེད་པ་ཉིད་ཡིན་༎ ནོ་༎ 
 (2|22) yatra tu viśeṣamutpādayantaḥ sahakāriṇaḥ pratyayāḥ tatra hetusantānaḥ pratyayāntarāṇyapekṣata iti tataḥ svabhāvāntarasya pratilambhaḥ	གང་དུ་ཁྱད་པར་བསྐྱེད་པས་ལྷན་ཅིག་བྱེད་པ་རྣམས་རྐྱེན་ཉིད་པ་དེར་ནི་། རྒྱུའི་རྒྱུན་རྐྱེན་ལ་ལྟོས་པ་ཡིན་པས་། དེ་ལས་ངོ་བོ་ཉིད་གཞན་ཐོབ་བོ་ཞེས་བྱའོ་༎
 tatra svarasataḥ hetupratyayānāṃ pūrvopanipātakṣaṇānāṃ nivṛttau tebhya eva viśiṣṭakṣaṇotpattirevaṃ krameṇa yāvadatyantātiśayavato 'ntyakāraṇakalāpāt kāryotpattiḥ |	དེ་ལ་རྒྱུ་དང་རྐྱེན་རྣམས་ཀྱི་སྐད་ཅིག་མ་སྔ་མ་རང་གི་ངང་གིས་ལོག་ན་། དེ་དག་ཁོ་ན་ལས་སྐད་ཅིག་མ་ཁྱད་པར་ཅན་འབྱུང་བའི་ཕྱིར་། རིམ་གྱིས་ཁྱད་པར་དུ་གྱུར་པ་དང་ལྡན་པ་རྒྱུའི་ཚོགས་ཐ་མ་ལས་འབྲས་བུའི་བར་དུ་འབྱུང་ངོ་༎ 
 (2|23) sahakāriṇaḥ samutpatraviśeṣātkāraṇātkāryotpattau tasyaiva viśeṣasyotpattirna syāt |	ལྷན་ཅིག་བྱེད་པ་ལས་ཡང་དག་པར་བྱུང་བའི་རྒྱུ་ལས་འབྲས་བུ་སྐྱེན་ནི་། ཁྱད་པར་ཉིད་དུ་འབྱུང་བར་མི་རུང་ངོ་༎
 aviśiṣṭādviśeṣotpattau kāryasyāpi syāt |	ཁྱད་པར་ཅན་མ་ཡིན་པ་ལས་ཁྱད་པར་སྐྱེ་ན་ནི་། འབྲས་བུ་ཡང་འགྱུར་ཏེ་།
 tataśca parasparaviśeṣotpādānapekṣiṇa eva sahakāriṇaḥ kāryaṃ kurvīran |	ལྷན་ཅིག་བྱེད་པ་ཁྱད་པར་ཕན་ཚུན་འབྱུང་པ་ལ་མི་ལྟོས་པས་ཀྱང་འབྲས་བུ་སྐྱེད་པར་འགྱུར་རོ་༎ 
 tenākṣaṇikānāmapi sahakārisāpekṣāṇāṃ kāraṇatā syāt |	དེས་ན་སྐད་ཅིག་པ་མ་ཡིན་པ་ལྷན་ཅིག་བྱེད་པ་ལ་མི་ལྟོས་པ་རྣམས་ཀྱང་རྒྱུ་ཉིད་དུ་འགྱུར་ལ་།
 apekṣaṇīyebhyaḥ svabhāvātiśayotpattiśca na syāt |	ལྟོས་པར་བྱ་བ་རྣམས་ལས་ངོ་བོ་ཉིད་ཁྱད་པར་དུ་གྱུར་པ་འབྱུང་བ་ནི་མེད་དོ་༎
 atha sahakāriṇā kāryotpādānuguṇaviśeṣajananāya kṛtaviśeṣa evopattiṣṭheta |	འོན་ཏེ་ཁྱད་པར་འབྱུང་ན་ཡང་ལྷན་ཅིག་བྱེད་པས་བྱས་པའི་ཁྱད་པར་ཁོ་ན་ཉེ་བར་གནས་པར་འགྱུར་ཏེ་། 
 evaṃ satyanavasthā syāt |	དེ་ལྟ་ན་། ཐུག་པ་མེད་པར་འགྱུར་རོ་༎
 na ca sahakāriṇaḥ parasparakāryotpādānuguṇaviśeṣotpādane nityaṃ yogyāvasthāḥ, yena nityānuṣakta eṣāṃ viśeṣaḥ syāt |	ལྷན་ཅིག་བྱེད་པ་རྣམས་ནི་གང་གིས་ན་འདི་དག་ཕན་ཚུན་བྱས་པའི་ཁྱད་པར་དང་རྟག་ཏུ་རྗེས་སུ་འབྲེལ་བར་འགྱུར་བ་ཕན་ཚུན་ནས་འབྲས་བུ་སྐྱེ་བ་དང་། མཐུན་པའི་ཁྱད་པར་སྐྱེད་པར་རུང་བར་རྟག་ཏུ་གནས་པ་ཅན་ཡང་མ་ཡིན་ཏེ་།
 tadupāyāpāyayoḥ kāryasyotpattyanutpattidarśanāt |	དེ་ཡོད་པ་དང་མེད་པ་དག་གི་འབྲས་བུ་གསལ་བ་དང་། བྲལ་བ་མཐོང་བའི་ཕྱིར་རོ་༎
 tenādyo viśeṣaḥ sahakāribhyo nirupakārasya notpadyata iti cet |	དེས་ན་ཁྱད་པར་དང་པོ་ནི་ལྷན་ཅིག་ཅིག་བྱེད་པ་དག་གིས་ཕན་མ་བཏགས་པ་ཡིན་པར་མི་འཐད་དོ་ཞེ་ན་།
 nāsmākaṃ punaḥ punarabhidhāne 'pi kaścidudvego bhavati yadyevamapi lokasya nyāyapratītirbhavati |	ཁོ་བོ་ནི་ཡང་དང་ཡང་དུ་སྨྲ་བ་ལ་སྐྱོ་བ་འགའ་ཡང་མེད་དེ་། གལ་ཏེ་དེ་ལྟ་ན་ཡང་འཇིག་རྟེན་༄༢༤༦ཨ་༌་༎ གྱིས་རིགས་པ་གོ་བར་འགྱུར་བ་ལྟར་ན་ད་དུང་ཡང་སྨྲ་བར་བྱའོ་༎ ལྷན་ཅིག་བྱེད་པ་རྣམས་ནི་གང་གིས་ན་དེ་མེད་པའི་ཕྱིར་།
 hanta tarhi ucyatām | na viśeṣotpādanāt sahakāriṇāṃ sahakāritvaṃ paramārthataḥ sambhavati | yataḥ tadabhāvādviśeṣe kartavye sahakāritāvirahaḥ syāt |	ཁྱད་པར་སྐྱེད་པ་ལ་ལྷན་ཅིག་བྱེད་པ་དག་ཏུ་མི་འགྱུར་བ་ཁྱད་པར་སྐྱེད་པ་ཁོ་ནས་ལྷན་ཅིག་སྐྱེད་པ་ཉིད་ཡིན་པ་ཡང་མ་ཡིན་ནོ་༎ འོ་ན་ཅི་ཞེ་ན་དོན་གཅིག་བྱེད་པས་ཀྱང་ཡིན་ནོ་༎
 (2|24) atha kathamekārthakriyāpi bhavet sāpi na bhavet parasparato viśeṣarahitānām |	གལ་ཏེ་ཕན་ཚུན་ནས་ཁྱད་པར་མེད་པ་རྣམས་ལ་དེ་ཡང་མེད་དོ་༎
 atha bhavet,	འོན་ཏེ་ཡོད་ན་ནི་སོ་སོ་ལ་ཡང་འགྱུར་རོ་༎
 pṛthagapi sā bhavet | tathāca, tasmād viśeṣād bhavanaśīlaṃ kāryamapi kevalāt syāditi cet |	དེ་ལྟ་ན་ནི་ཁྱད་པར་དེ་ལས་འབྱུང་བ་ཅན་གྱི་འབྲས་བུ་ཡང་འབའ་ཞིག་ལས་འབྱུང་བར་འགྱུར་རོ་ཞེ་ན་།
 atroktamuttaraṃ pratikṣaṇamaparāparaiḥ pratyayaiḥ yathā bhāvasantāne viśeṣasyotpattiḥ,	སྐད་ཅིག་རེ་རེ་ལ་རྐྱེན་གཞན་དང་གཞན་དག་གིས་ཇི་ལྟར་དངོས་པོའི་རྒྱུ་ན་ལ་ཁྱད་པར་སྐྱེ་བ་དང་། 
 yogyadeśatādyavasthāviśeṣāḥ kāryakaraṇaśīlāḥ, teṣāṃ ca yata utpattiḥ, pratyekaṃ ca sāmarthye 'pi kevalānāmakriyā,	ཡུལ་རུང་བ་ཅན་ཉིད་ལ་སོགས་པའི་གནས་སྐབས་ཀྱི་བྱེ་བྲག་པ་དག་འབྲས་བུ་སྐྱེད་པ་དང་། དེ་དག་ཀྱང་གང་ལས་སྐྱེ་བ་དང་། སོ་སོར་ནུས་ཀྱང་ཇི་ལྟར་འབའ་ཞིག་གིས་མི་སྐྱེད་དེ་།
 kartṛviśeṣasya pṛthagekaikasya bhāvasyābhāvāt | kāryadvaividhyaṃ ca sahakāribhiḥ akṣepakārindriyavijñānavacca kāryakāraṇayoḥ svabhāvabhedāditi sarvamuktam |	བྱེད་པ་པོའི་ཁྱད་པར་སོ་སོ་ན་ཡོད་པ་མེད་པའི་ཕྱིར་དང་། འབྲས་བུ་རྣམ་པ་གཉིས་པོ་ལྷན་ཅིག་བྱེད་པས་སྐྱེད་པའི་ཁྱད་པར་བརྒྱུད་པ་ལས་བྱུང་བའི་ཆོས་ཅན་དང་། 
 (2|25) tatra sahakāribhyaḥ santānopakārāpekṣakāraṇakāryajanmani sahakāriṇāmādyo viśeṣaḥ sahakārikṛtaviśeṣajanmā na bhavati,	གཞན་ཏེ་མྱུ་གུ་ལ་སོགས་པ་ལྟ་བུ་དང་། མི་སྡོད་པར་སྐྱེད་པའི་དབང་པོའི་རྣམ་པར་ཤེས་པ་ལྟ་བུ་སྟེ་། འབྲས་བུ་དང་། རྒྱུའི་ངོ་བོ་ཉིད་ཐ་དད་པའི་ཕྱིར་རོ་ཞེས་བྱ་བ་ཐམས་ཅད་བཤད་ཟིན་ཏོ་༎ དེ་ལ་ལྷན་ཅིག་བྱེད་པ་དག་ལས་རྒྱུན་གྱིས་ཕན་འདོགས་པ་ལ་ལྟོས་པའི་འབྲས་བུའི་རྒྱུ་སྐྱེ་བ་ལ་ལྷན་ཅིག་བྱེད་པའི་ཁྱད་པར་དང་པོ་ནི་ལྷན་ཅིག་བྱེད་པས་ཁྱབ་པའི་ཁྱད་པར་ལས་སྐྱེ་བ་ཅན་མ་ཡིན་ཏེ་།
 anantarakāryavat,	འབྲས་བུ་མཇུག་ཐོགས་ཅན་ལྟ་བུའོ་༎
 tataḥ ye viśeṣā jāyante te tajjanmānaḥ tatprakṛtitvāditi nānavasthā |	དེ་ཕན་ཆད་ཀྱི་ཁྱད་པར་གང་ཡིན་པ་དེ་དག་ནི་དེ་ལས་སྐྱེ་བ་ཅན་ཡིན་ཏེ་། དེ་དང་དེ་དག་ནི་དེའི་རང་བཞིན་ཅན་ཡིན་པའི་ཕྱིར་། ཐུག་པ་མེད་པ་མ་ཡིན་ནོ་༎
 tathā yadyakṣaṇiko 'pi bhāvaḥ kārya karoti,	གལ་ཏེ་ཁྱད་པར་དང་པོའི་རྒྱུ་བཞིན་དུ་སྐད་ཅིག་པ་མ་ཡིན་པའི་དངོས་པོ་ཁྱད་པར་དུ་གྱུར་པ་མ་བསྐྱེད་པས་ཀྱང་འབྲས་བུ་བསྐྱེད་པར་འགྱུར་རོ་ཞེ་ན་།
 karotu nāma,	བསྐྱེད་ལ་ནི་རག་སྟེ་།
 sa yadi akṣepakartṛdharmā, tadā pṛthagbhāvasya sambhavātkevalo 'pi tathā syād ityuktam | atatsvabhāvastu tadāpyakāraka eva |	གལ་ཏེ་འདིའི་ངོ་བོ་ཉིད་དེ་མི་སྡོད་པར་སྐྱེད་པར་བྱེད་པའི་ཆོས་ཅན་ཞིག་ཡིན་ན་ནི་། སོ་སོ་ན་ཡོད་པ་སྲིད་པས་འབའ་ཞིག་གིས་ཀྱང་དེ་ལྟར་འགྱུར་རོ་ཞེས་བཤད་ཟིན་ཏོ་། ༎ དེའི་ངོ་བོ་ཉིད་མ་ཡིན་ན་ནི་དེའི་ཚེ་ཡང་སྐྱེད་པར་བྱེད་པ་མ་ཡིན་པ་། ༎ ཉིད་དོ་༎ 
 tasmādakṣaṇikānāṃ kāraṇānām ekārthakriyayā na kaścit sahakāritvaniyamaḥ |	དེ་ལྟ་བས་ན་སྐད་ཅིག་པ་མ་ཡིན་པའི་རྒྱུ་དག་ལས་། དོན་གཅིག་བྱེད་པས་འགའ་ཡང་ལྷན་༄༢༤༦བ་ཅིག་བྱེད་པ་ཉིད་དུ་ངེས་པ་མེད་དོ་༎
 nāpi santatyopakāreṇeti na tasya kaścitsahakārīti kevalo 'pi kuryāt |	རྒྱུན་གྱིས་ཕན་འདོགས་པས་ཀྱང་མ་ཡིན་པས་། དེའི་ལྷན་ཅིག་བྱེད་པ་འགའ་ཡང་མེད་དེ་།
 prāyastu saṃghātasthāyī bhāvasantānaḥ sahakāripratyayairupajanitaviśeṣaḥ svakāryaṃ kurvan dṛṣṭo bījādivat |	དེའི་ཕྱིར་འབའ་ཞིག་གིས་ཀྱང་བསྐྱེད་པར་འགྱུར་རོ་༎ དངོས་པོའི་རྒྱུན་ཚོགས་པ་ལ་གནས་པ་ཅན་ནི་། ཕལ་ཆེར་ལྷན་ཅིག་བྱེད་པའི་རྐྱེན་གྱི་ཁྱད་བར་བསྐྱེད་པས་རང་གི་འབྲས་བུ་སྐྱེད་པ་མཐོང་སྟེ་། ས་བོན་ལ་སོགས་པ་བཞིན་ནོ་༎
 tatsthirahetuvādino hetoḥ pratyayāntarāpekṣakārakasya vyaktaṃ svabhāvāntarasyotpattiḥ |	རྒྱུ་རྟག་པར་སྨྲ་པའི་ལྟར་ན་རྐྱེན་ལ་ལྟོས་པ་ཡིན་ན་ནི་། སྐྱེད་པར་བྱེད་པའི་ངོ་བོ་ཉིད་གཞན་ཞིག་འབྱུང་ངོ་ཞེས་བྱ་བར་གསལ་བ་ཡིན་ཏེ་། འབྲས་བུ་ལ་ལྟོས་པ་ཞེས་བྱའོ་༎
 kārakasvabhāvasya prāgapi sattve 'kriyā na yujyate |	སྐྱེད་པར་བྱེད་པའི་ངོ་བོ་ཉིད་སྔོན་ཡང་ཡོད་ན་ནི་། མི་བསྐྱེད་པ་མི་རུང་ངོ་༎
 (2|26) tasmādyo yadātmā sa svasattāmātreṇa tādṛśo bhavati na bhūtvā tadbhāve parābhisaṃskāramapekṣata iti svabhāvato 'sthitidharmaṇo bhāvasya na kiñcitrāśakāraṇaiḥ |	དེ་ལྟ་བས་ན་གང་གི་བདག་ཉིད་གང་ཡིན་པ་དེ་ནི་། ཡོད་པ་ཙམ་གྱིས་དེ་ལྟ་བུར་འགྱུར་གྱི་། གྱུར་ནས་ཡང་དེའི་དངོས་པོར་བྱ་བའི་ཕྱིར་གཞན་གྱིས་མངོན་པར་འདུ་བྱ་བ་ལ་ལྟོས་པ་ནི་མ་ཡིན་ནོ་༎ དངོས་པོ་ངོ་བོ་ཉིད་ཀྱིས་མི་གནས་པའི་ཆོས་ཅན་ལ་ནི་།
 sthitidharmaṇo 'pi bhāvasya na nāśakāraṇaiḥ kiñcit svabhāvānyathātvasya kenacit kartumaśakyatvāt |	འཇིག་པའི་རྒྱུ་དག་ཅུང་ཟད་ཀྱང་མི་དགོས་སོ་༎ དངོས་པོ་གནས་པའི་ཆོས་ཅན་ལ་ཡང་སུས་ཀྱང་ངོ་བོ་ཉིད་གཞན་དུ་བྱ་བར་མི་ནུས་པའི་ཕྱིར་། འཇིག་པའི་རྒྱུ་དག་གིས་ཅི་ཞིག་བྱ་།
 tadanyathātvapratipattau sa tatsvabhāva eva na syāditi pūrva eva vikalpaḥ syāt | tatra ca prāgevoktaṃ dūṣaṇam |	འོན་ཏེ་གཞན་ཉིད་དུ་འགྱུར་ན་ནི་དེའི་ངོ་བོ་ཉིད་ཁོ་ནར་མི་འགྱུར་བས་བརྟག་པ་སྔ་མར་ཟད་དེ་དེ་ལ་ཡང་བཤད་ཟིན་ཏོ་༎
 yaśca parasmādanyathābhāvaḥ so 'paraḥ svabhāvaḥ yaścāparaḥ sa kathaṃ tasya syāt?	ཕ་རོལ་ལས་གཞན་དུ་འགྱུར་བ་གང་ཡིན་པ་དེ་ནི་། གཞན་གྱི་ངོ་བོ་ཉིད་ཡིན་ལ་། གང་ཞིག་གཞན་ཡིན་པ་དེ་ཇི་ལྟར་དེའི་ཡིན་ཏེ་།
 svabhāvabhedo hi vastubhedalakṣaṇam |	དངོས་པོ་ཐ་དད་པ་ནི་ངོ་བོ་ཉིད་ཐ་དད་པའི་མཚན་ཉིད་ཡིན་པའི་ཕྱིར་རོ་༎
 tathā ca yaḥ sthitidharmā jātaḥ na tasyānyathābhāvaḥ syāt |	དེ་ལྟ་ན་དངོས་པོ་སྔ་མ་འཕོ་བ་མེད་པའི་ཆོས་ལ་གནས་པས་དེས་གཞན་དུ་འགྱུར་བ་མེད་དོ་༎ 
 etena kaṭhinādīnāṃ tāmrādīnām agnyādeḥ dravatvādisvabhāvāntarotpattiḥ pratyuktā |	འདིས་ནི་ཟངས་ལ་སོགས་པའི་སྲ་བ་ལ་སོགས་པ་མེ་ལ་སོགས་པ་ལས་སྙི་བ་ལ་སོགས་པའི་ངོ་བོ་ཉིད་གཞན་དུ་འགྱུར་བ་བསལ་བ་ཡིན་ཏེ་།
 tatrāpi pūrvakasya svarasanirodhitvādvināśe 'gnyāderupādānāccāpara eva dravādisvabhāvaḥ utpannaḥ |	དེ་ལ་ཡང་སྔ་མ་རང་གི་ངང་གིས་འཇིག་པ་ཅན་ཡིན་པའི་ཕྱིར་ཞིག་ན་། མེ་ལ་སོགས་པ་དང་། ཉེ་བར་ལེན་པ་ལས་སྙི་བ་ལ་སོགས་པའི་ངོ་བོ་ཉིད་གཞན་ཁོ་ན་ཞིག་འབྱུང་བ་ཡིན་ནོ་༎ 
 (2|27) sa svayaṃ sthitidharmaiva svahetubhirjanitaḥ,	དེ་ནི་རང་གིས་གནས་པའི་ཆོས་ཅན་ཁོ་ན་ཡིན་ཏེ་།
 vināśahetorasambhave 'vasthānāt |	འཇིག་པའི་རྒྱུ་མི་སྲིད་ན་གནས་པའི་ཕྱིར་རོ་༎
 tasya parasmādvināśo bhavati iti | na ca vināśo nāmāparaḥ svabhāvaḥ,	དེ་ནི་གཞན་གྱིས་འཇིག་ལ་འཇིག་པ་ཞེས་བྱ་བ་ངོ་བོ་ཉིད་གཞན་ཡང་མེད་དེ་།
 bhāvacyutireva vināśaḥ iti cet |	དངོས་པོ་འཕོ་བ་ཁོ་ན་འཇིག་པ་ཡིན་ནོ་ཞེ་ན་། ལན་འདི་ནི་རྣམ་པར་བརྟག་པ་གཉིས་༄༢༤༧ཨ་༌་༎
 nedaṃ vikalpadvayamatikrāmati - kiṃ nityo bhāva utānityaḥ |	ལས་མི་འདའོ་༎ ཅི་དངོས་པོ་ངོ་བོ་ཉིད་ཀྱིས་བརྟག་པ་ཞིག་གམ་མི་རྟག་པ་ཞིག་ཅེས་བརྟག་པར་བྱ་བ་ལ་། 
 prāṅnityo bhūtvā paścādanityo bhavatīti ca bruvāṇo bhāvadvayaṃ cāha nityānityasvabhāvabhedam |	སྔར་རྟག་པར་གྱུར་ནས་ཕྱིས་མི་རྟག་པར་འགྱུར་རོ་ཞེས་སྨྲ་ན་ནི་།
 prāktanasya nityābhimatasya svabhāvasya svayaṃ nāśaṃ bruvāṇaḥ sarvadaiva nāśamanāśaṃ ca prāheti pūrvasmin vināśaheturasamartha eva |	རྟག་པར་འདོད་པ་སྔ་མ་ཐམས་ཅད་དུ་རྟག་པ་དང་མི་རྟག་པའི་ངོ་བོ་ཉིད་ཐ་དད་པ་ཅན་གྱི་དངོས་པོ་གཉིས་དང་། རང་གིས་འཇིག་པ་དང་། མི་འཇིག་པར་རབ་ཏུ་སྨྲ་བ་ཡིན་ཏེ་། དེ་ལྟར་ན་སྔ་མ་ལ་འཇིག་པའི་རྒྱུ་ནུས་པ་མེད་དོ་༎
 na prāṅnityo bhūtvā paścādanityaḥ bhavati,	སྔར་རྟག་པར་གྱུར་ནས་ཕྱིས་མི་རྟག་པར་འགྱུར་བ་ནི་མ་ཡིན་ནོ་༎
 kiṃ tarhi,	འོ་ན་ཅི་ཞེ་ན་།
 paścādapi nitya eva,	ཕྱིས་ཀྱང་རྟག་པ་ཁོ་ན་ཡིན་ཏེ་།
 ekasvabhāvatvāt |	ངོ་བོ་ཉིད་གཅིག་པའི་ཕྱིར་རོ་༎
 sa tarhi bhāvaḥ svabhāvena nāśamanāviśan kathaṃ naṣṭo nāma?	འོ་ན་དངོས་པོ་དེ་ངོ་བོ་ཉིད་ཀྱིས་འཇིག་པ་དང་མ་འབྲེལ་ན་འཇིག་པ་ཞེས་བྱ་བ་ཇི་ལྟ་བུ་ཡིན་ཏེ་།
 tatsvabhāvavināśayoḥ aparaspararūpatvāt |	དེའི་ངོ་བོ་ཉིད་དང་འཇིག་པ་དག་ནི་ཕན་ཚུན་གྱི་ངོ་བོ་ཅན་མ་ཡིན་པ་ཉིད་ཀྱི་ཕྱིར་རོ་༎ 
 tasmāt satyasya vināśe vināśasvabhāvena tena bhavitavyaṃ,	དེ་ལྟ་བས་ན་འདི་ལ་འཇིག་པ་ཡོད་པ་དང་། འདི་འཇིག་པའི་ངོ་བོ་ཉིད་དུ་འགྱུར་དགོས་ཏེ་།
 tathāpi vināśaheturvyartha ityuktam |	དེ་ལྟ་ན་ཡང་འཇིག་པའི་རྒྱུ་དོན་མེད་དོ་ཞེས་བཤད་ཟིན་ཏོ་༎ དེས་ན་དངོས་པོའི་ངོ་བོ་ཉིད་ཀྱིས་འཇིག་པ་ཡིན་ཡང་རུང་།
 tena svabhāvato naścare 'naśvare vā bhāve na vināśahetorupayogaḥ |	མི་འཇིག་པ་ཡིན་ཡང་རུང་སྟེ་། འཇིག་པའི་རྒྱུ་དགོས་པ་མེད་དོ་༎
 (2|28) tasmādvināśaṃ pratyanapekṣo bhāvastadbhāvaniyataḥ iti yaḥ san sa vināśī naśvaratāyā nivṛttau sattvanivṛtirityanvayavyatirekasiddhiḥ |	དེ་ལྟ་བས་ན་དངོས་པོ་འཇིག་པ་ལ་ལྟོས་པ་མེད་པས་དེའི་ངོ་བོར་ངེས་པ་ཡིན་ནོ་༎ ཡོད་པ་གང་ཡིན་པ་དེ་ནི་འཇིག་པ་ཡིན་ལ་། འཇིག་པ་ལོག་ན་ཡོད་པ་ལྡོག་པས་རྗེས་སུ་འགྲོ་བ་དང་ལྡོག་པ་གྲུབ་པའོ་༎
 svabhāvato naśvaratve 'pi kaścidatatsvabhāvo 'pi syāt |	གལ་ཏེ་ངོ་བོ་ཉིད་ཀྱིས་འཇིག་པ་ཉིད་ཡིན་ན་ཡང་། ལ་ལ་དེའི་ངོ་བོ་ཉིད་མ་ཡིན་པར་ཡང་འགྱུར་ཏེ་།
 na hi sarvaḥ sarvasya svabhāva iti na tatribandhanānvayavyatirekāsiddhiriti cet |	ཐམས་ཅད་ཀྱི་ངོ་བོ་ཉིད་ཐམས་ཅད་ཡིན་པ་ནི་མེད་པས་རྗེས་སུ་འགྲོ་བ་དང་། ལྡོག་པ་མ་གྲུབ་པོ་ཞེ་ན་།
 na, akṣaṇikatve 'vastutvaprasaṅgāt |	མ་ཡིན་ཏེ་། སྐད་ཅིག་པ་ཉིད་མ་ཡིན་ན་དངོས་པོ་མེད་པ་ཉིད་དུ་ཐལ་བར་འགྱུར་བའི་ཕྱིར་རོ་༎
 śaktirhi bhāvalakṣaṇam |	དངོས་པོའི་མཚན་ཉིད་ནི་ནུས་པ་ཡིན་ནོ་༎
 sarvaśaktivirahaḥ punarabhāvalakṣaṇam |	ནུས་པ་ཐམས་ཅད་བྲལ་བ་ནི་དངོས་པོ་མེད་པའི་མཚན་ཉིད་ཡིན་ནོ་༎
 na caivākṣaṇikasya kvacit kācit śaktirasti, kramayaugapadyābhyāṃ kāryakriyāśakti virahāt |	སྐད་ཅིག་པ་མ་ཡིན་པ་ནི་འགའ་ཡང་གང་དུ་ནུས་པ་མེད་དེ་རིམ་དང་ཅིག་ཅར་དག་གིས་དོན་བྱེད་པར་འགལ་བའི་ཕྱིར་རོ་༎
 itthaṃ ca yat sattat kṣaṇikameveti vyāptisiddhiḥ | (3|1) arthāntare gamye kāryaṃ heturavyabhicārāt | kāryakāraṇabhāvena gamakatve sarvathā gamyagamakabhāvaḥ syāt,	དེ་ལྟ་བས་ན་གང་ཡོད་པ་དེ་ནི་སྐད་ཅིག་པ་ཁོ་ན་ཡིན་པས་ཁྱབ་པ་གྲུབ་བོ་༎ དོན་གཞན་ཤེས་པར་བྱ་བ་ལ་འབྲས་བུ་གཏན་ཚིགས་ཡིན་ཏེ་འཁྲུལ་པ་མེད་པའི་ཕྱིར་རོ་༎ ༎ གལ་ཏེ་རྒྱུ་དང་འབྲས་བུའི་དངོས་པོ་རྟགས་ཤེས་པར་བྱེད་པ་ཉིད་ཡིན་ན་། རྣམ་པ་ཐམས་ཅད་དུ་ཤེས་པར་བྱ་༄༢༤༧བ་བ་དང་། ཤེས་པར་བྱེད་པའི་དངོས་པོ་ཡིན་ཏེ་།
 sarvathā janyajanakabhāvād iti cet | na |	རྣམ་པ་ཐམས་ཅད་དུ་བསྐྱེད་པར་བྱ་བ་དང་། སྐྱེད་པར་བྱེད་པའི་དངོས་པོ་ཡིན་པའི་ཕྱིར་རོ་ཞེ་ན་།
 tadabhāve bhavatastadutpattiniyamābhāvāt |	མ་ཡིན་ཏེ་དེ་མེད་པར་འབྱུང་བ་ནི་དེ་ལས་འབྱུང་བ་ངེས་པ་མེད་པའི་ཕྱིར་རོ་༎
 tasmāt kāryaṃ svabhāvairyāvadbhiravinābhāvi kāraṇe teṣāṃ hetuḥ |	དེ་ལྟ་བས་ན་རྒྱུའི་ངོ་བོ་ཉིད་ཇི་སྙེད་གཅིག་མེད་པར་འབྲས་བུ་མི་འབྱུང་བ་དེ་དག་རྒྱུ་ཡིན་ཏེ་། 
 tatkāryatvaniyamāt |	དེའི་འབྲས་བུ་ཉིད་དུ་ངེས་པའི་ཕྱིར་རོ་༎
 taireva ca dharmairye tairvinā na bhavanti |	གང་དག་དེ་དག་མེད་ན་མི་འབྱུང་བའི་ཆོས་དེ་དག་ཉིད་ཀྱིས་སོ་༎
 aṃśena janyajanakabhāvaprasaṅga iti cet |	གལ་ཏེ་ཆ་ཤས་ཀྱིས་བསྐྱེད་པར་བྱ་བ་དང་། སྐྱེད་པར་བྱེད་པ་ཉིད་དུ་ཐལ་བར་འགྱུར་རོ་ཞེ་ན་།
 na, tajjanyaviśeṣagrahaṇe 'bhimatatvāt liṅga viśeṣopādhīnāṃ ca sāmānyānām |	མ་ཡིན་ཏེ་དེས་བསྐྱེད་པར་བྱ་བའི་ཁྱད་པར་དང་། རྟགས་ཀྱི་ཁྱད་པར་གྱི་བྱེ་བྲག་ཅན་གྱི་སྤྱི་རྣམས་འཛིན་ན་། འདོད་པའི་ཕྱིར་རོ་༎
 aviśiṣṭasāmānyavivakṣāyāṃ vyabhicāra iti gamakatvaṃ neṣyate |	ཁྱད་པར་ཅན་མ་ཡིན་པའི་སྤྱིའི་བརྗོད་པར་འདོད་ན་། འཁྲུལ་པའི་ཕྱིར་མི་འདོད་དོ་༎
 (3|2) kasyacitkadācitkutaścidbhāve 'pi sarvastādṛśastathāvidhajanmeti kuto 'vasitam,	གལ་ཏེ་འགའ་ཞིག་རེས་འགའ་ཞིག་ལས་འབྱུང་ཡང་དེ་དང་འདྲ་བ་ཐམས་ཅད་དེ་ལས་སྐྱེའོ་ཞེས་བྱ་བ་གོ་ག་ལས་།
 tathā ca nānvayavyatirekāviti cet |	དེ་ལྟ་ན་རྗེས་སུ་འགྲོ་བ་དང་། ལྡོག་པ་ནི་མ་ཡིན་ནོ་ཞེ་ན་། མ་ཡིན་ཏེ་། དེ་ལས་འབྱུང་བ་ཅན་མ་ཡིན་པ་དེ་ནི་།
 na, atadbhāvinastasya sakṛdapi tato 'bhāvāt |	ལན་འགའ་ཡང་དེ་ལས་མི་འབྱུང་བའི་ཕྱིར་ཏེ་།
 parasparāpekṣayā janyajanakasvabhāvalakṣaṇe kāryakāraṇe |	ཕན་ཚུན་ལྟོས་པས་བསྐྱེད་པར་བྱ་བ་དང་། སྐྱེད་པར་བྱེད་པའི་ངོ་བོ་ཉིད་ཀྱི་མཚན་ཉིད་ཅན་གྱི་འབྲས་བུ་དག་ཡིན་ནོ་༎
 tatra yadi dhūmo 'gnyādisāmagjyā anyato 'pi bhavettadā tasya tajjanyaḥ svabhāvo na bhavatīti sakṛdapi tato na bhavet |	དེ་ལ་གལ་ཏེ་དུ་བ་མེ་ལ་སོགས་པའི་ཚོགས་པ་ལས་གཞན་པ་ལས་ཀྱང་འབྱུང་བར་འགྱུར་ན་། དེ་ནི་དེས་བསྐྱེད་པར་བྱ་བའི་ངོ་བོ་ཉིད་མ་ཡིན་པས་། ལན་འགའ་ཡང་འབྱུང་བར་མི་འགྱུར་ཏེ་།
 arthāntaravat |	དོན་གཞན་བཞིན་ནོ་༎
 nāpi sāmagrī taṃ janayed atajjananasvabhāvatvāt | sāmagjyantaravat |	ཚོགས་པས་ཀྱང་དེ་སྐྱེད་པར་མི་འགྱུར་ཏེ་། དེ་སྐྱེད་པའི་ངོ་བོ་ཉིད་མ་ཡིན་པའི་ཕྱིར་ཚོགས་པ་གཞན་བཞིན་ནོ་༎
 na ca dhūmasya tadatajjanyaḥ svabhāvo yuktaḥ |	དུ་བ་ནི་དེ་དང་དེ་མ་ཡིན་པས་བསྐྱེད་པར་བྱ་བའི་ངོ་བོ་ཉིད་དུ་ཡང་རིགས་པ་མ་ཡིན་ཏེ་། 
 ekasvabhāvatvāt |	ངོ་བོ་ཉིད་གཅིག་པའི་ཕྱིར་རོ་༎
 dhūmādhūmajananasvabhāvād bhavato dhūmādhūmasvabhāvaḥ syāt |	དུ་བ་དང་དུ་བ་མ་ཡིན་པ་བསྐྱེད་པའི་ངོ་བོ་ཉིད་ལས་འབྱུང་ན་ནི་། དུ་བ་དང་དུ་བ་མ་ཡིན་པའི་ངོ་བོ་ཉིད་དུ་འགྱུར་ཏེ་།
 kāryasvabhāvānāṃ kāraṇasvabhāvakṛtatvāt |	འབྲས་བུའི་ངོ་བོ་ཉིད་རྣམས་ནི་རྒྱུའི་ངོ་བོ་ཉིད་ཀྱིས་བྱས་པའི་ཕྱིར་རོ་༎
 akāraṇāpekṣaṇe cāhetukatvaprasaṅgāt |	རྒྱུ་ལ་མི་ལྟོས་ན་ཡང་རྒྱུ་མེད་པ་ཉིད་ཐལ་བར་འགྱུར་བའི་ཕྱིར་རོ་༎
 tasmādyo dhūmajananaḥ so 'gnyādisāmagrīviśeṣo yaḥ agnyādisāmagrīviśeṣeṇa janitaḥ sa eva dhūmo bhavatīti kāryakāraṇayorevaṃ svabhāvasya niyamāt tadvijātīyādutpattirna bhavati | tadyādṛśaṃ kāryaṃ yādṛśāt kāraṇād dṛṣṭamekadā tattanna vyabhicarati |	དེ་ལྟ་བས་ན་དུ་བ་སྐྱེད་པར་བྱེད་པ་གང་ཡིན་པ་དེ་ནི་། མེ་ལ་སོགས་པའི་ཚོགས་པའི་ཁྱད་པར་ཡིན་ལ་མེ་ལ་སོགས་པའི་ཚོགས་པའི་ཁྱད་པར་གྱིས་བསྐྱེད་པ་གང་ཡིན་པ་དེ་ནི་དུ་བ་ཡིན་ཏེ་། དེ་ལྟར་ན་རྒྱུ་དང་འབྲས་བུ་དག་གི་ངོ་བོ་ཉིད་ངེས་པའི་ཕྱིར་རིགས་མི་མཐུན་པ་ལས་བྱུང་བ་མ་ཡིན་ནོ་། དེ་ལྟ་༄༢༤༨ཨ་༌་༎ བས་ན་འབྲས་བུས་རྒྱུ་འཁྲུལ་པ་མེད་དོ་༎
 tena siddhe kāryakāraṇabhāve kāryasya kāraṇena vyāptiḥ siddhā bhavati |	དེས་རྒྱུ་དང་འབྲས་བུའི་དངོས་པོ་གྲུབ་ན་འབྲས་བུ་ལ་རྒྱུས་ཁྱབ་པར་གྲུབ་པ་ཡིན་ནོ་༎
 (3|3) nanu vijātīyādapi kiñcid bhavad dṛṣṭaṃ tadyathā go mayādeḥ śālūkādiḥ |	རིགས་མི་མཐུན་པ་ལས་ཀྱང་ཅུང་ཟད་འབྱུང་བ་མཐོང་སྟེ་། དཔེར་ན་པ་ལང་གི་ལྕི་བ་ལ་སོགས་པ་ལས་ཤ་ལའུ་ཀ་ལ་སོགས་པ་ལྟ་བུ་མ་ཡིན་ནམ་ཞེ་ན་།
 na vijātīyādutpattiḥ |	རིགས་མི་མཐུན་པ་ལས་འབྱུང་བ་ནི་མ་ཡིན་ཏེ་།
 tathāvidhameva hi tādṛśāmādinimittamiti na kāraṇabhedaḥ |	དེ་ལྟ་བུ་ཁོ་ན་དེ་འདྲ་བའི་དང་པོའི་རྒྱུ་མཚན་ཡིན་པས་། རྒྱུ་ཐ་དད་པ་མ་ཡིན་ནོ་༎
 prabandhena vṛttau tu śarād bhavati |	རྒྱུན་གྱིས་འབྱུང་ན་ནི་། འདམ་བུ་ལས་འབྱུང་ངོ་༎
 asti ca gomayetarajanmanoḥ svabhāvabhedaḥ rūpasyābhede 'pi |	ཡང་ན་བ་ལང་གི་ལྕི་བ་དང་། ཅིག་ཤོས་སྐྱེ་བ་ཅན་དག་གཟུགས་ཐ་མི་དད་ཀྱང་ངོ་བོ་ཐ་དད་པ་ཡོད་དོ་༎
 na hi ākāratulyataiva bhāvānāṃ tattve nimittam,	དངོས་པོ་རྣམས་ཀྱི་རྣམ་པ་མཚུངས་པ་ཁོ་ན་ནི་དེ་ཉིད་ཀྱི་རྒྱུ་མ་ཡིན་ཏེ་།
 abhinnākārāṇāmapi keṣāñcidanyato viśeṣājjātibhedadarśanāt |	རྣམ་པ་ཐ་དད་པ་མ་ཡིན་པ་རྣམས་ཀྱང་ཁ་ཅིག་ཁྱད་པར་གཞན་གྱི་སྒོ་ནས་རིགས་ཐ་དད་པ་མཐོང་བའི་ཕྱིར་རོ་༎ དེ་ལྟ་མ་ཡིན་ཏེ་།
 anyathā hi vilakṣaṇāyā api sāmagrayā avilakṣaṇakāryotpattau na kāraṇabhedābhedābhyāṃ kāryabhedābhedāvityahetukau viśvasya bhedābhedau syātām	ཚོགས་པ་མཚན་ཉིད་མི་འདྲ་བ་ལས་ཀྱང་མཚན་ཉིད་མི་འདྲ་བ་མ་ཡིན་པ་འབྱུང་ན་ནི་། རྒྱུའི་ཐ་དད་པ་དང་ཐ་དད་པ་མ་ཡིན་པ་དག་ལས་འབྲས་བུའི་ཐ་དད་པ་དང་། ། ཐ་དད་པ་མ་ཡིན་པ་དག་མ་ཡིན་པས་། ཐམས་ཅད་ཀྱི་ཐ་དད་པ་དང་། ཐ་དད་པ་མ་ཡིན་པ་དག་རྒྱུ་མེད་པར་འགྱུར་ཏེ་།
 tathā hi na bhedādbheda iti abhedādapi nābhedaḥ |	འདི་ལྟར་ཐ་དད་པ་ལས་ཐ་དད་པ་མ་ཡིན་པ་ལས་ཀྱང་ཐ་དད་པ་མ་ཡིན་ནོ་༎ དེ་མ་གཏོགས་པའི་དངོས་པོའི་ངོ་བོ་ཉིད་ཀྱང་འགའ་ཡང་མེད་པས་།
 tadvyatiriktaśca na kaścidbhāvasvabhāva ityahetukatvādbhāvānāṃ nityaṃ sattvamasattvaṃ vā syāt |	དངོས་པོ་རྣམས་རྒྱུ་མེད་པ་ཅན་མ་ཡིན་པའི་ཕྱིར་རྟག་ཏུ་ཡོད་པའམ་། མེད་པ་ཞིག་ཏུ་འགྱུར་ཏེ་། ལྟོས་པར་བྱ་བ་མེད་པའི་ཕྱིར་རོ་༎
 apekṣayā hi bhāvāḥ kādācitkā bhavanti |	དངོས་པོ་རྣམས་ནི་ལྟོས་པའི་ཕྱིར་རེས་འགའ་བ་ཡིན་ནོ་༎
 vyavasthāvāṃśca sādhyeṣu sādhananiyogo na syāt |	བསྒྲུབ་པར་བྱ་བ་དག་ལ་སྒྲུབ་པ་ཉེ་བར་སྦྱོར་བ་རྣམ་པར་གནས་པ་དང་ལྡན་པར་ཡང་མི་འགྱུར་ཏེ་། 
 kāraṇaśaktipratiniyame hi kiñcideva kasyacit sādhanāyopādīyeta, nāparaṃ,	རྒྱུའི་ནུས་པ་སོ་སོར་ངེས་ན་འགའ་ཞིག་འགའ་སྒྲུབ་པར་བྱེད་པར་གཟུང་གི་གཞན་ནི་མ་ཡིན་ནོ་༎
 tasyaiva tatra śakteḥ,	དེ་ཁོ་ན་དེ་ལ་ནུས་པའི་ཕྱིར་ལ་།
 anyasya cāśakteḥ tayostajjananetarasvabhāvatvena bhedāt |	གཞན་ནི་མི་ནུས་པའི་ཕྱིར་ཏེ་། དེ་གཉིས་ནི་བསྐྱེད་པ་དང་ཅིག་ཤོས་ཀྱི་ངོ་བོ་ཉིད་ཀྱིས་ཐ་དད་པའི་ཕྱིར་རོ་༎
 tajjananasvabhāvavilakṣaṇādapi tasyotpattau na tajjananaśaktipratiniyama iti yat kiñcit yataḥ kutaścitsyāt |	དེ་བསྐྱེད་པའི་ངོ་བོ་ཉིད་དང་མཚན་ཉིད་མི་འདྲ་བ་ལས་ཀྱང་དེ་འབྱུང་ན་ནི་དེ་བསྐྱེད་པར་ནུས་ན་ངེས་པ་མེད་པས་ཅི་ཡང་རུང་སྟེ་། གང་ཡང་རུང་བ་ལས་འབྱུང་བར་འགྱུར་རོ་༎
 tajjananaśaktisāmye tu tadeveti na kāryaṃ duṣṭaṃ kāraṇaṃ vyabhicarati |	དེ་བསྐྱེད་ནུས་པར་མཚུངས་ན་ནི་དེ་ཉིད་ཡིན་པས་འབྲས་བུ་རྒྱུ་འཁྲུལ་པ་མ་མཐོང་ངོ་༎
 (4|1) upalabdhilakṣaṇaprāptasyānupalabdhirabhāvasyābhāvavyavahārasya vā hetuḥ |	དམིགས་པའི་རིག་བྱར་གྱུར་པ་མི་དམིགས་པ་ནི་། དངོས་པོ་མེད་༄༢༤༨བ་པར་ཐ་སྙད་གདགས་པའི་གཏན་ཚིགས་ཡིན་ནོ་༎ དེ་ལ་དམིགས་པ་དམིགས་པར་བྱེད་པའི་ཆོས་ཉིན་ན་ནི་།
 atropalabdherupalabhamānadharmatve tajjñānamupalabdhiḥ |	དེའི་ཤེས་པ་དམིགས་པ་ཡིན་ནོ་༎
 tasmādanyopalabdhiranupalabdhirvivakṣitopalabdheranyatvāt,	བརྗོད་པར་འདོད་པའི་དམིགས་པ་ལས་གཞན་ཡིན་པའི་ཕྱིར་། དེ་ལས་གཞན་པའི་དམིགས་པ་ནི་མི་དམིགས་པ་ཡིན་ཏེ་།
 abhakṣyāsparśanīyavatparyudāsavṛttyā |	མ་ཡིན་པར་འཇུག་པས་བཟར་མི་རུང་བ་དང་རེག་ཏུ་མི་རུང་བ་བཞིན་ནོ་༎
 upalabhyamānadharmatve svaviṣayavijñānajananayogyatālakṣaṇo viṣayasvabhāvaḥ upalabdhiḥ |	དམིགས་པར་བྱ་བའི་ཆོས་ཉིད་ཡིན་ན་ནི་། དམིགས་པ་ཡུལ་གྱི་ངོ་བོ་ཉིད་རང་གི་ཡུལ་ཅན་གྱི་ཤེས་པ་སྐྱེད་པར་རུང་བ་ཉིད་ཀྱི་མཚན་ཉིད་ཅན་ཡིན་ཏེ་།
 yogyatāyā bhāvasvarūpatvāt |	རུང་བ་ཉིད་ནི་དངོས་པོའི་ངོ་བོ་ཡིན་པའི་ཕྱིར་རོ་༎
 tasmādanya upalambhajananayogya evānupalabdhiḥ pūrvavat |	དེ་ལས་གཞན་པའི་དམིགས་པར་རུང་པ་ཁོ་ན་ཉིད་མི་དམིགས་པ་སྟེ་། སྔ་མ་བཞིན་ནོ་༎
 yatra yasmitrupalabhyamāne niyamena yasyopalabdhiḥ bhavati yogyatāyā aviśeṣāt satatsaṃsṛṣṭaḥ ekajñānasaṃsargāt |	རུང་པ་ཉིད་དུ་ཁྱད་པར་མེད་པའི་ཕྱིར་། གང་དུ་གང་ཞིག་དམིགས་ན་། གང་ཞིག་ངེས་པར་དམིགས་པར་འགྱུར་བ་དེ་ནི་དེ་དང་འབྲེལ་པ་ཡིན་ཏེ་།
 tayoḥ satornaikarūpaniyatā pratipattirasambhavāt |	ཤེས་པ་གཅིག་དང་འབྲེལ་པའི་ཕྱིར་རོ་༎ དེ་གཉིས་ཡོད་ན་ངོ་བོ་གཅིག་ངེས་པར་གཏོགས་པ་མ་ཡིན་ཏེ་། མི་སྲིད་པའི་ཕྱིར་རོ་༎
 tasmādaviśiṣṭayogyatārūpayoḥ ekajñānasaṃsargiṇostayoḥ parasparāpekṣamevānyatvamihābhipretaṃ, pratyāsatterāśrayaṇāt |	དེ་ལྟ་བས་ན་འདིར་གཞན་ཉིད་ནི་རུང་བ་ཉིད་ཀྱི་ངོ་བོ་ཁྱད་པར་མེད་པ་ཅན་ཤེས་པ་དང་འབྲེལ་པ་ཅན་དག་ཕན་ཚུན་ལྟོས་པ་ཁོ་ན་ཡིན་པར་འདོད་དོ་༎
 sa kevalastadapekṣayā tadanyaśceducyate tadā tajjñānaṃ tatsvabhāvo vā jñātṛjñeya dharmalakṣaṇānupalabdhiḥ |	དེ་འབའ་ཞིག་དེ་ལ་ལྟོས་ནས་གཞན་ཡིན་པས་། དེའི་ངོ་བོ་ཉིད་དེ་ཤེས་པར་བྱེད་པའམ་། ཤེས་པར་བྱ་བའི་ཆོས་ཀྱི་མཚན་ཉིད་ནི་མི་དམིགས་པ་ཡིན་ཏེ་། དེ་ནི་ཟླ་བོ་དངོས་པོ་མེད་པའམ་།
 sābhāvaṃ pratiyogino 'bhāvavyavahāraṃ vā sādhayati |	དངོས་པོ་མེད་པར་ཐ་སྙད་གདགས་པར་སྒྲུབ་པ་ཡིན་ནོ་༎
 (4|2) kathamanyabhāvastadabhāvo yena bhāvarūpānupalabdhirabhāvamabhāvavyavahāraṃ vā sādhayediti cet |	ཇི་ལྟར་ན་གཞན་ཡོད་པ་དེ་མེད་པ་ཡིན་། གང་གིས་ན་དངོས་པོ་མེད་པའི་ངོ་བོའི་མི་དམིགས་པས་དངོས་པོ་མེད་པར་ཐ་སྙད་གདགས་པ་སྒྲུབ་པར་བྱེད་ཅེ་ན་།
 uktamatra yathā paryudāsavṛttyāpekṣātaḥ tadvivikto 'rthastajjñānaṃ vābhāvo 'nupalabdhiścocyata iti |	འདིར་ཅི་ལྟར་མ་ཡིན་པར་འཇུག་པ་ལ་ལྟོས་པའི་སྒོ་ནས་དངོས་པོ་མེད་པ་དང་མི་དམིགས་པ་དག་མི་དམིགས་པ་ཡིན་པར་བཤད་ཟིན་ཏེ་༎ དེ་སྒྲུབ་པར་མ་གྲུབ་པའི་ཕྱིར་རོ་༎
 na pratiṣedhamātraṃ, tasya sādhanāsiddherabhāvavyavahārāsiddhiprasaṅgāt |	དངོས་པོ་མེད་པར་ཐ་སྙད་གདགས་པ་མི་འགྲུབ་པར་ཐལ་བར་འགྱུར་བའི་ཕྱིར་རོ་༎
 tasyāsaṃsṛṣṭarūpasya bhāvasiddhirevāparasyābhāvasiddhirityanyabhāvo 'pi tadabhāva iti vyapadiśyate |	འབྲེལ་པ་མེད་པའི་ངོ་བོ་དེ་ཡོད་པར་གྲུབ་པ་ཉིད་གཞན་མེད་པར་གྲུབ་པ་ཡིན་པས་། གཞན་ཡོད་པ་ཡང་དེ་མེད་པ་མ་ཡིན་ནོ་ཞེས་ཐ་སྙད་གདགས་སོ་༎
 anyabhāvalakṣaṇo 'bhāvaḥ svayaṃ pramāṇasiddhastadabhāvavyavahāraṃ sādhayet,	གཞན་ཡོད་པའི་མཚན་ཉིད་ཀྱི་དངོས་པོ་མེད་པར་རང་གི་ཚད་མས་འགྲུབ་པའམ་།
 tatsiddhisiddho veti na kaścidviśeṣo yenānupalabdhyābhāvavyavahārasiddhervirodhaḥ syāt |	དེ་གྲུབ་པས་དེ་མེད་པར་གྲུབ་པ་དེ་དངོས་པོ་མེད་པར་ཐ་སྙད་གདགས་པ་སྒྲུབ་པར་བྱེད་པ་ལ་ཁྱད་པར་འགའ་ཡང་མེད་ན་གང་གིས་ན་མི་དམིགས་པས་དངོས་པོ་མེད་༄༢༤༩ཨ་༌་༎ པར་ཐ་སྙད་གདགས་པར་འགྲུབ་པ་འགལ་བར་འགྱུར་།
 (4|3) sa evānyabhāvastadviṣayā copalabdhistadabhāvasya kiṃ na sādhanam?	གཞན་ཡོད་པ་དེ་ཉིད་དང་དེའི་ཡུལ་ཅན་གྱི་ཤས་པ་དངོས་པོ་མེད་པའི་སྒྲུབ་པ་ཅི་སྟེ་མ་ཡིན་། 
 kiṃ punarabhāvasya siddhireva tadabhāvasiddhiḥ? iti cet |	ཅིའི་ཕྱིར་གཞན་ཡོད་པར་གྲུབ་པ་ཉིད་དེ་མེད་པར་གྲུབ་པ་ཡིན་ཞེས་བྱ་ཞེ་མ་ཡིན་། ན་། 
 apṛthaksiddheḥ sambandhābhāvācca |	སོ་སོར་མ་གྲུབ་པའི་ཕྱིར་དང་། འབྲེལ་པ་མེད་པའི་ཕྱིར་ཏེ་།
 anyabhāvastāvatra sādhanam |	རེ་ཞིག་གཞན་ཡོད་པ་ནི་སྒྲུབ་པ་མ་ཡིན་ནོ་༎
 yatsiddhau yasya na siddhistattasya liṅgaṃ bhavati dhūmāgnivat |	གང་ཞིག་གྲུབ་པ་ན་གང་མི་འགྲུབ་པ་ནི་དེའི་རྟགས་ཡིན་ཏེ་། མེ་དང་དུ་བ་ལྟ་བུ་ཡིན་ནོ་༎
 anyabhāvasiddhayaiva tadabhāvaḥ prasidhyati,	གཞན་ཡོད་པར་གྲུབ་པ་ཉིད་ཀྱིས་།
 tasya tadanyāsaṃsṛṣṭarūpasya tattvavyavasthāpakena pramāṇenaivānyavyavaccedasiddheḥ |	དེ་མེད་པར་གྲུབ་སྟེ་དེ་ལས་གཞན་པ་དང་འབྲེལ་པ་མེད་པའི་ངོ་བོ་ཅན་དེའི་དེ་ཉིད་རྣམ་པར་འཇོག་པར་བྱེད་པའི་ཚད་མ་ཁོ་ནས་གཞན་རྣམ་པར་བཅད་པ་འགྲུབ་པའི་ཕྱིར་རོ་༎
 (4|4) sambandhābhāvācca tacca tasya liṅgaṃ yadi syāt, tasya tena kaścitsambandho bhavet |	འབྲེལ་པ་མེད་པའི་ཕྱིར་དང་། དེ་དེའི་རྟགས་ཡིན་ན་དེ་དང་དེར་འབྲེལ་པ་འགའ་ཞིག་ཏུ་འགྱུར་ཏེ་།
 yathā kṛtakatvasyānityatvena ekārthasamavāyo dhūmasya vā liṅginaikārthasamavāyaḥ |	དཔེར་ན་བྱས་པ་ཉིད་དང་། མི་རྟག་པ་ཉིད་དག་དོན་གཅིག་ལ་འདུ་བ་དང་རྟགས་དོན་གཅིག་ལ་འདུ་བའམ་།
 ādhārādheyabhāvo vā janyajanakabhāvo vā |	རྟེན་དང་བརྟེན་པའི་དངོས་པོའམ་བསྐྱེད་པར་བྱ་བ་དང་། སྐྱེད་པར་བྱེད་པའི་དངོས་པོ་ལྟ་བུ་ཞིག་ཡིན་གྲང་ན་།
 naivaṃ kaścid bhāvābhāvayoḥ sambandhaḥ yenāsyānyabhāvaḥ sādhanaṃ syāt |	དངོས་པོ་ཡོད་པ་དང་། མེད་པ་དག་ལ་ནི་གང་གིས་ན་འདིའི་བསྒྲུབ་པར་འགྱུར་བའི་འབྲེལ་པ་དེ་ལྟ་བུ་འགའ་ཡང་མེད་དོ་༎ 
 asti viṣayaviṣayibhāvaḥ śabdārthasambandhavaditi cet |	གལ་ཏེ་ཡུལ་དང་ཡུལ་ཅན་གྱི་དངོས་པོ་ཡོད་དེ་། སྒྲ་དང་དོན་འབྲེལ་པ་བཞིན་ནོ་ཞེ་ན་།
 śabdārthayoḥ tatpratipādanābhiprāye sati tatprayogāt kāryakāraṇalakṣaṇo 'vinābhāvalakṣaṇo vā sambandhaḥ syāt |	སྒྲ་དང་དོན་དག་ནི་དེ་སྟོན་ན་སྦྱོར་བས་དེ་དང་ལྷན་ཅིག་གི་རྒྱུ་དང་འབྲས་བུའི་མཚན་ཉིད་དམ་མེད་ན་མི་འབྱུང་བའི་མཚན་ཉིད་ཀྱི་འབྲེལ་བར་འགྱུར་ན་།
 ayaṃ cātra na sambhavati yataḥ viṣayaviṣayibhāvaḥ syāt |	རྣམ་པ་འདི་ཡང་འདི་ལ་མེད་པས་ཇི་ལྟར་ཡུལ་དང་ཡུལ་ཅན་གྱི་དངོས་པོ་ཡིན་།
 siddhe hi tayoḥ sādhyasādhanabhāve tanmukhena viṣayaviṣabhibhāvaḥ syāt |	དེ་གཉིས་བསྒྲུབ་པར་བྱ་བ་དང་། སྒྲུབ་པའི་དངོས་པོར་གྲུབ་ན་ནི་། དེའི་སྒོ་ནས་ཡུལ་དང་ཡུལ་ཅན་གྱི་དངོས་པོར་འགྱུར་ན་།
 sa eva cāsati sambandhe na sidhyati |	དེ་ཉིད་ནི་འབྲེལ་པ་མེད་ན་མི་འགྲུབ་པོ་༎ དེ་མ་གྲུབ་ན་ཡུལ་དང་ཡུལ་ཅན་གྱི་དངོས་པོ་ཡང་མ་ཡིན་ནོ་༎
 anyathetaretarāśrayamidaṃ syāt |	དེ་ལྟ་མ་ཡིན་ན་འདི་གཅིག་ལ་གཅིག་བརྟེན་པ་ཡིན་པར་འགྱུར་རོ་༎
 (4|5) anyabhāvāccābhāvasiddhāvasamudāyaśca sādhyaḥ syāt |	གཞན་ཡོད་པ་ལས་མེད་པ་གྲུབ་ན་སྤྱི་བསྒྲུབ་པར་བྱ་བ་མ་ཡིན་པར་འགྱུར་རོ་༎
 tathā ca ghaṭābhāvastadanyabhāvāt iti ghaṭasya sarvatra sarvadā cābhāvaḥ prasajyeta |	དེ་ལྟ་ན་ནི་དེ་ལས་གཞན་པ་ཡོད་པའི་ཕྱིར་བུམ་པ་མེད་དོ་ཞེས་བྱ་བ་ལས་བུམ་པ་ཐམས་ཅད་ན་ཐམས་ཅད་དུ་མེད་པར་འགྱུར་རོ་༎ གལ་ཏེ་མ་ཡིན་ཏེ་ཕྱོགས་ལ་སོགས་པ་ཆོས་ཅན་མེད་པར་སྒྲུབ་པར་བྱེད་པའི་ཕྱིར་རོ་༎ རོ་སྙམ་སྟེ་། 
 na, pradeśādirdharmī ghaṭābhāvena viśeṣyata iti tadviśeṣaṇabhūto 'bhāvaḥ sādhyate na tu kevalaḥ |	འདི་སྙམ་དུ་ཕྱོགས་ལ་སོགས་པ་ཆོས་ཅན་ཁྱད་པར་དུ་གྱུར་པའི་མེད་པ་སྒྲུབ་པར་བྱེད་༄༢༤༩བ་ཀྱི་། འབའ་ཞིག་ནི་མ་ཡིན་ནོ་༎
 tato nāsamudāyasya sādhyatā |	དེས་ན་སྤྱི་མི་སྒྲུབ་པ་ཡང་མ་ཡིན་ལ་།
 na ca liṅgaliṅganorasambandhaḥ, anyabhāvasya pradeśādinā sambandhād iti cet |	ཡོད་པ་དང་ཕྱོགས་ལ་སོགས་པ་ཆོས་ཅན་དུ་འབྲེལ་པའི་ཕྱིར་རྟགས་དང་རྟགས་ཅན་འབྲེལ་པ་མེད་པ་ཡང་མ་ཡིན་ནོ་སྙམ་དུ་སེམས་ན་མ་ཡིན་ཏེ་། 
 na, pradeśāderevānyabhāvatvāt |	ཕྱོགས་ལ་སོགས་པ་ཉིད་དེ་གཞན་པ་ཡོད་པའི་ཕྱིར་རོ་༎
 yatraiva hi pradeśādau yatrāstīti ucyate sa eva tenāsaṃsṛṣṭo 'nyabhāvaḥ |	ཕྱོགས་གང་ཁོ་ན་ན་གང་ཞིག་མེད་དོ་ཞེས་བྱ་བ་དེ་ཉིད་དེ་དང་འབྲེལ་པ་མེད་པའི་གཞན་ཡོད་པ་ཡིན་ཏེ་།
 taddarśanādevāsya ghaṭo nāsti iti vikalpo bhavati iti kathaṃ tasyaiva liṅgaliṅgibhāvaḥ?	དེ་མཐོང་བ་ཁོ་ནས་འདི་བུམ་པ་མེད་དོ་སྙམ་དུ་སེམས་ན་། ཇི་ལྟར་དེ་ཁོ་ན་རྟགས་དང་རྟགས་ཅན་གྱི་དངོས་པོ་ཡིན་།
 (4|6) na cātra sāmānyaviśeṣabhāvakalpanā sambhavati yena sāmānyaṃ heturbhaved viśeṣo dharmāti,	འདིར་གང་གིས་ན་སྤྱི་ནི་གཏན་ཚིགས་སུ་འགྱུར་ལ་ཁྱད་པར་ནི་ཆོས་ཅན་དུ་འགྱུར་ཞེས་བྱ་བ་སྤྱི་དང་ཁྱད་པར་གྱི་དངོས་པོ་རྣམ་པར་བརྟག་པ་ཡང་མི་སྲིད་དེ་།
 tadviśeṣapratipattereva tadabhāvasya pratīteḥ,	དེའི་ཁྱད་པར་རྟོགས་པ་ཁོ་ནས་དེ་མེད་པར་རྟོགས་པའི་ཕྱིར་ལ་། དེ་ལ་རྗེས་སུ་འགྲོ་བ་ཡང་མེད་པའི་ཕྱིར་རོ་༎
 tasyānyatrānvayasyābhāvāt pratijñārthaikadeśatvācca na hetutā |	དམ་བཅས་པའི་ཕྱོགས་གཅིག་ཡིན་པའི་ཕྱིར་ཡང་རྟགས་ཉིད་མ་ཡིན་ནོ་༎
 na ca yatra pradeśamātraṃ tatra ghaṭābhāvaḥ |	གང་ན་ཕྱོགས་ཙམ་ཡོད་པ་དེ་ན་བུམ་པ་མེད་པ་ཡང་མ་ཡིན་ནོ་༎
 tādṛśe kevale pradeśe sarvatrābhāva iti cet |	གལ་ཏེ་ཕྱོགས་འབའ་ཞིག་ཡིན་པ་དེ་ལྟ་བུ་ནི་མེད་པ་ཁོ་ན་ཡིན་ནོ་ཞེ་ན་།
 nanu tasyaiva kaivalyaṃ ghaṭavirahaḥ |	དེ་འབའ་ཞིག་ཅེས་བྱ་བ་བུམ་པ་དང་བྲལ་བ་ཞེས་བྱ་བ་མ་ཡིན་ནམ་།
 sa ca tatpratipattāveva siddha iti kasya idānīṃ talliṅgam?	འདིར་རྟགས་སུ་གྱུར་པ་དེ་ཡང་ཕྱོགས་རྟོགས་པ་ཁོ་ནར་གྲུབ་པ་ཡིན་ན་། དེ་དེ་གང་གི་རྟགས་ཡིན་།
 anvayasyānugamanamapi nirarthakam |	རྗེས་སུ་འགྲོ་བ་སྨོས་པ་ཡང་དོན་མེད་པ་ཡིན་ནོ་༎
 tasmādanyabhāvo na sādhanamabhāvasya |	དེ་ལྟ་བས་ན་གཞན་ཡོད་པ་ནི་དངོས་པོ་མེད་པའི་སྒྲུབ་པ་མ་ཡིན་ནོ་༎
 (4|7) asti virodhaḥ sambandhaḥ tato 'nyabhāvādabhāvasya siddhiḥ iti cet |	གལ་ཏེ་འགལ་བའི་འབྲེལ་པ་ཡོད་དེ་དེའི་ཕྱིར་གཞན་ཡོད་པ་ལས་དངོས་པོ་མེད་པ་འགྲུབ་པོ་ཞེ་ན་། གང་ཞིག་གང་དང་འགལ་། གཞན་ཡོད་པ་དང་ཟློ་བོར་རོ་༎
 kena kasya virodho 'nyabhāvena pratiyoginaḥ kiṃ nu vai pratiyogī pramātumiṣṭo yena liṅgaliṅganorvirodhaḥ sambandhaḥ syāt?	ཅི་གང་གིས་རྟགས་དང་རྟགས་ཅན་འགལ་བའི་འབྲེལ་པར་འགྱུར་བ་ཟློ་བོ་གཞལ་བར་འདོད་དམ་།
 abhāvastupratiyogino ghaṭasya anyabhāvena aviruddhaḥ sahāvasthānāt |	དངོས་པོ་མེད་པ་ནི་ཟླ་བོ་བུམ་པ་ཡོད་པ་དང་འགལ་བ་མེད་དེ་། ལྷན་ཅིག་གནས་པའི་ཕྱིར་རོ་༎
 tasmin prameye liṅgaliṅginoḥ kathaṃ virodhaḥ?	གཞལ་བྱ་དེ་ལ་རྟགས་དང་རྟགས་ཅན་དག་ཇི་ལྟར་འགལ་།
 tasmātsambandhābhāvaḥ |	དེ་བས་ན་འབྲེལ་པ་མེད་དོ་༎
 atrāpi asamudāyasādhyatvaṃ tadavastham |	འདི་ལ་ཡང་སྤྱི་བསྒྲུབ་པར་བྱ་བ་ཉིད་མ་ཡིན་བདེའི་སོ་ན་འདུག་གོ་༎
 (4|8) nanu anyabhāvatadabhāvayorasati sambandhe 'nyabhāvagatyāpi tadabhāvagatirna syāditi cet |	དེ་མེད་པ་དང་། གཞན་ཡོད་པ་དག་འབྲེལ་པ་མེད་ན་། གཞན་ཡོད་པར་རྟོགས་ཀྱང་དེ་རྟོགས་པར་མི་འགྱུར་བ་ཡིན་ནམ་ཞེ་ན་།
 na vai kutaścit sambandhādanyabhāvastadabhāvagamaka iṣṭaḥ kintu anyabhāva eva tadabhāvo yathoktaṃ prāk |	འབྲེལ་པ་གང་ལས་ཀྱང་གཞན་ཡོད་པ་དེ་མེད་པའི་ཤེས་པར་བྱེད་པ་ཡིན་པར་མི་འདོད་ཀྱི་། འོན་ཀྱང་གཞན་ཡོད་པ་ཉིད་དེ་མེད་པ་ཡིན་ཏེ་། ཇི་སྐད་སྔར་བཤད་པ་ཡིན་༄༢༥༠ཨ་༌་༎ ནོ་༎
 tasyānyāsaṃsṛṣṭarūpasya kevalasyaikātmavyasthitasya tadātmanā pariccedasyaivānyavyavaccedatvāt tasya kaivalyamevāparasya vaikalyamiti tadanyabhāva eva tadabhāvaḥ |	གཞན་དང་འབྲེལ་པ་མེད་པའི་ངོ་བོ་འབའ་ཞིག་པ་བདག་ཉིད་གཅིག་པུ་རྣམ་པར་གནས་པ་དེ་། དེའི་བདག་ཉིད་དུ་ཡོངས་སུ་གཅོད་པ་ཉིད་གཞན་རྣམ་པར་གཅོད་པ་ཡིན་པའི་ཕྱིར་། འབའ་ཞིག་ཉིད་གཞན་དང་བྲལ་བ་ཡིན་པས་། དེ་ལས་གཞན་པ་ཡོད་པ་ཉིད་དེ་མེད་པ་ཡིན་ལ་།
 tataśca tatpratipattireva tadapratipattiḥ |	དེ་ལས་གཞན་པ་རྟོགས་པ་ཉིད་དེ་མེད་པར་རྟོགས་པ་ཞེས་བྱའོ་༎ དེ་ལྟ་མ་ཡིན་ཏེ་ཡོངས་སུ་བཅད་པས་དེ་ལས་གཞན་རྣམས་མི་གཅོད་ན་།
 anyathā tasya pariccedena tato 'nyasya avyavaccede tatparicceda eva na syāt |	དེ་ཡོངས་སུ་བཅད་པ་ཉིད་དུ་མི་འགྱུར་ཏེ་།
 tadatadrūpayoravivekāt |	དེ་དང་དེ་མ་ཡིན་པའི་ངོ་བོ་དག་རྣམ་པར་མ་ཕྱེ་བའི་ཕྱིར་རོ་༎
 ya eva vyavahāraḥ kasyacitkvaceddeśe darśanāt prāptiparihārārthaḥ sa na syāt |	ལ་ལར་འགའ་ཞིག་མཐོང་ནས་ཐོབ་པ་དང་། ཡོངས་སུ་སྤང་བར་བྱ་བའི་དོན་གྱི་ཐ་སྙད་གང་ཡིན་པ་དེར་མི་འགྱུར་ཏེ་།
 na hyayamanalaṃ paśyatrapi kevalam analameva paśyatīti kathaṃ salilārthī tatra na praverteta?	མེ་མཐོང་ཡང་གང་གིས་ན་ཆུ་དོན་དུ་གཉེར་བ་འཇུག་པར་འགྱུར་བ་མེ་འབའ་ཞིག་ཁོ་ན་ནི་མ་ཡིན་ནོ་༎
 anupalambhena salilābhāvaḥ pratīyata iti cet |	གལ་ཏེ་མི་དམིགས་པས་ཆུ་མེད་པར་རྟོགས་པར་འགྱུར་རོ་ཞེ་ན་།
 ko 'yamanupalambho nāma?	མི་དམིགས་པ་ཞེས་བྱ་བ་འདི་ཅི་ཡིན་༎ གལ་ཏེ་ཆུ་དམིགས་པ་མེད་པ་ཡིན་ནོ་ཞེ་ན་ནི་།
 yadi salilopalambhābhāvaḥ tadā kathamabhāvaḥ kasyacitpratipattiḥ pratipattiheturvā?	མེད་པ་དེ་ཇི་ལྟར་འགའ་ཞིག་རྟོགས་པའམ་། རྟོགས་པའི་རྒྱུ་ཡིན་།
 tasyāpi kathaṃ pratipattiḥ?	དེ་ཡང་ཇི་ལྟར་རྟོགས་།
 tasya tato vānyasya kasyacidapyapratipattāvapi yadyabhāvaḥ pratīyate tadā svāpamadamūrccāvyavadhānapṛṣṭhībhāvādyavasthāsvapi kiṃ na pratīyate?	དེའམ་དེ་ལས་གཞན་པ་ཡང་རུང་འགའ་ཡང་མ་རྟོགས་པར་ཡང་ཡིན་ན་ནི་། གཉིད་ལོག་པ་དང་མྱོས་པ་དང་བརྒྱལ་བ་དང་། ཆོས་པ་དང་། རྒྱབ་ཀྱིས་ཕྱོགས་པ་ལ་སོགས་པའི་གནས་སྐབས་དག་ཏུ་ཡང་ཅི་སྟེ་། དངོས་པོ་མེད་པ་མ་རྟོགས་།
 ityetacca vicāritaṃ pramāṇaviniścaye |	གཞན་ཡང་ཚད་མ་རྣམ་པར་གཏན་ལ་དབབ་པར་དཔྱད་ཟིན་ཏོ་༎
 tasmādayamanalaṃ paśyatrapi analo 'yaṃ salilam iti nādhyavasyatīti na tiṣṭhetrāpi pratiṣṭheta |	དེ་ལྟ་བས་ན་འདིས་མི་མཐོང་ཡང་འདི་ནི་མེ་ཡིན་གྱི་། ཆུ་མ་ཡིན་ནོ་ཞེས་བྱ་བར་མི་ཤེས་པས་། འདུག་པར་ཡང་མི་བྱ་། འགྲོ་བར་ཡང་མི་བྱ་བའི་ཕྱིར་།
 tataśca dustaraṃ vyasanaṃ pratipattuḥ syāt |	བརྒལ་དཀའ་བའི་སྐབས་སུ་ཆུད་པར་གྱུར་ཏོ་༎
 (4|9) tata evaikasya darśanād anyābhāvagatiścet kathamekaṃ dṛṣṭamanyatrāstīti pratyāyayati?	གལ་ཏེ་གཅིག་མཐོང་བ་དེ་ཁོ་ནས་གཞན་མེད་པར་རྟོགས་པར་འགྱུར་རོ་ཞེ་ན་། ཇི་ལྟར་གཅིག་མཐོང་བས་གཞན་མེད་དོ་ཞེས་བྱ་བར་རྟོགས་པར་འགྱུར་།
 tasyaiva kevalasya darśanād iti cet |	གལ་ཏེ་འབའ་ཞིག་མཐོང་བའི་ཕྱིར་རོ་ཞེ་ན་།
 idamevāsmābhiḥ prāgabhihitaṃ kasmāttavātra paruṣamivābhāti?	འདི་ཉིད་ཁོ་བོས་བཤད་པ་ན་། ཅི་སྟེ་ཁྱོད་འདི་ལ་མ་རངས་པ་ལྟར་སྟོན་།
 tasmāttīrādarśineva śakuninā dūraparyaṭayāpi pratyāgantavyamityalam avidyamānapratiṣṭhānayā diśaḥ pratipattyā |	དེ་ལྟ་བས་ན་འགྲམ་མ་མཐོང་བའི་བྱ་བཞིན་དུ་རིང་དུ་སོང་ཡང་ཕྱིར་འོང་དགོས་པས་། གཏིང་མི་ཚུགས་པ་ཅན་གྱི་ཕྱོགས་སྒྲུབ་པས་ནི་ཆོག་གོ་༎
 (4|10) yadyekapariccedādevānyavyavaccedaḥ sidhyati tadā sarvasyānyasya aviśeṣeṇa tatrābhāvasiddhirbhavet |	གལ་ཏེ་དེ་ལྟར་གཅིག་ཡོངས་སུ་བཅད་པ་ཁོ་ནས་གཞན་རྣམ་པར་བཅད་པ་འགྲུབ་ན་། དེ་ན་ཁྱད་པར་མེད་པར་༄༢༥༠བ་གཞན་ཐམས་ཅད་མེད་པར་འགྲུབ་པར་འགྱུར་བས་།
 na tu tulyayogyāvasthasyaiva | upalabdhilakṣaṇaprāptasyānupalabdhirabhāvasādhanīti ca viśeṣaṇaṃ na vaktavyam,	དམིགས་པའི་རིག་བྱར་གྱུར་པ་རུང་བར་མཚུངས་པར་གནས་པ་ཁོ་ན་མི་དམིགས་པ་དངོས་པོ་མེད་པའི་སྒྲུབ་པ་ཡིན་ནོ་ཞེས་བྱ་བའི་ཁྱད་པར་ཡང་བརྗོད་མི་དགོས་ཏེ་།
 anupalabdhilakṣaṇaprāptānāmapi tatra vyavaccedāt |	དེར་དམིགས་པའི་རིག་བྱར་མ་གྲུབ་པ་རྣམས་ཀྱང་རྣམ་པར་བཅད་པའི་ཕྱིར་རོ་༎
 (4|11) ekātmapariccedāt tasya tadanyātmavyavaccedo bhavati tadātmaniyatapratibhāsajñānāt na hi tadātmā tadanyasyātmā bhavati |	དེའི་བདག་ཉིད་གཅིག་ཡོངས་སུ་བཅད་པས་དེ་ལས་གཞན་པའི་བདག་ཉིད་རྣམ་པར་བཅད་པ་ཡིན་ཏེ་། དེའི་བདག་ཉིད་དུ་ངེས་པར་སྣང་བ་ཤེས་པའི་ཕྱིར་རོ་༎ དེའི་བདག་ཉིད་ནི་དེ་ལས་གཞན་པའི་བདག་ཉིད་མ་ཡིན་ནོ་༎
 anyātmāvyavaccede pravṛttinivṛttyoḥ abhāva iti pūrvaḥ prasaṅgaḥ |	གཞན་གྱི་བདག་ཉིད་རྣམ་པར་མ་བཅད་ན་། འཇུག་པ་དང་ལྡོག་པ་དག་མེད་པས་ཐལ་བ་སྔ་མར་འགྱུར་རོ་༎
 taṃ ca deśakālasvabhāvāvasthāniyataṃ tadātmanopalabhamānā buddhiḥ tathātvapracyutimasya vyavaccinati | evaṃ hi taddeśādiniyataḥ pariccitro bhavati,	ཡུལ་དང་དུས་དང་ངོ་བོ་ཉིད་དང་གནས་སྐབས་སུ་ངེས་པ་དེ་བློས་དེའི་བདག་ཉིད་དུ་དམིགས་པ་ན་འདིའི་དེ་ཁོ་ན་ཉིད་མེད་པ་རྣམ་པར་གཅོད་དོ་༎ 
 yadi anyathābhāvo vyavaccinno bhavatiḥ tathātvaṃ ca tasyaiva bhavati nānyasyeti anyathābhūtāttathābhūtaṃ vyavaccindatyeva tat pariccinati |	གལ་ཏེ་གཞན་གྱི་དངོས་པོ་རྣམ་པར་བཅད་པར་གྱུར་ན་། དེ་ལྟར་ན་གདོང་དེ་དེས་ཡོངས་སུ་བཅད་པ་དང་། དེ་ཁོ་ན་ཉིད་ཀྱང་དེ་དེ་ཁོ་ནའི་ཡིན་གྱི་གཞན་གྱི་མ་ཡིན་ནོ་ཞེས་བྱ་བ་ཡིན་ཏེ་། གཞན་དུ་གྱུར་པ་རྣམ་པར་གཅོད་པ་ཉིད་དེ་ཡོངས་སུ་གཅོད་པ་ཡིན་ནོ་༎
 evamekapramāṇavṛttiḥ sarvabhāvān dvairāśye vyavasthāpayati |	དེ་བས་ན་ཚད་མ་གཅིག་འཇུག་པ་ནི་དངོས་པོ་ཐམས་ཅད་ཕུང་པོ་གཉིས་སུ་རྣམ་པར་འཇོག་པར་བྱེད་དེ་། 
 tasyānvayavyatirekabuddhijanakatvenaiva sāphalyāt |	དེ་ནི་རྗེས་སུ་འགྲོ་བ་དང་ལྡོག་པའི་བློའི་རྒྱུ་ཉིད་ཁོ་ནས་འབྲས་བུ་དང་བཅས་པ་ཉིད་ཡིན་པའི་ཕྱིར་རོ་༎
 tadvayatiriktāśeṣavyavaccedena vyāptisādhanādeva prakārāntarasyābhāvaḥ sidhyati |	དེ་ལས་མ་གཏོགས་པ་མ་ལུས་པ་རྣམ་པར་བཅད་པས་ཁྱབ་པ་སྒྲུབ་པ་ཁོ་ནས་རྣམ་པ་གཞན་མེད་པར་གྲུབ་པོ་༎
 tasya tadanyatayā vyāptyabhāve tena tadarthāvyavaccedātpunarapi bhāvasyāpariccedaprasaṅgāt |	དེ་དེ་ལས་གཞན་པ་ཉིད་ཀྱིས་མ་ཁྱབ་པར་། དེས་དོན་དེ་རྣམ་པར་མ་བཅད་པའི་ཕྱིར་ཡང་དངོས་པོ་ཡོངས་སུ་མ་བཅད་པར་ཐལ་བར་འགྱུར་རོ་༎ དེ་ལྟ་བས་ན་།
 (4|12) tasmātkvacitpramāṇaṃ pravṛttaṃ tat pariccinatti,	ཚད་མའི་བྱེད་པ་ནི་འགའ་ཞིག་ལ་ཚད་མ་འཇུག་པ་དེ་ནི་།
 tadanyad vyavaccināti,	ཡོངས་སུ་གཅོད་ཅིང་དེ་ལས་གཞན་པ་ནི་རྣམ་པར་གཅོད་ལ་།
 tṛtīyaprakārābhāvaṃ ca sūcayati iti ekapramāṇavyāpāra eṣaḥ |	རྣམ་པ་གསུམ་པ་གཞན་ནི་མེད་པར་སྒྲུབ་པར་བྱེད་པ་ཞེས་བྱ་བ་འདི་ཡིན་ནོ་༎
 tathāhi kvacitpramāṇaṃ pravṛtaṃ tadeva tadanyasmād vyavaccinattī,	འདི་ལྟར་འགའ་ཞིག་ལ་ཚད་མར་འཇུག་པ་ནི་། དེ་ལས་གཞན་པ་ལས་རྣམ་པར་གཅོད་དེ་།
 tasyaiva pariccedāt | tadanyadeva ca tasmād vyavaccinatti anyasya tatra apariccedāt |	དེ་ཉིད་ཡོངས་སུ་གཅོད་པ་དང་དེ་ལས་གཞན་པ་ཉིད་དེ་ལས་རྣམ་པར་གཅོད་པ་དང་དེ་ལས་ཡོངས་སུ་མི་གཅོད་པའི་ཕྱིར་རོ་༎
 atastadeva pramāṇaṃ prakārāntabhāvaṃ sādhayati,	དེའི་ཕྱིར་ཚད་མ་དེ་ཉིད་རྣམ་པ་གཞན་མེད་པར་སྒྲུབ་པར་བྱེད་དེ་། དེ་སྣང་ན་མི་སྣང་པ་ཐམས་ཅད་ནི་དེ་༄༢༥༡ཨ་༌་༎
 tasmin dṛṣṭatadanyatvena sarvasyaiva vyasthāpanāt,	ལས་གཞན་པ་ཉིད་དུ་རྣམ་པར་འཇོག་པའི་ཕྱིར་ལ་།
 atadanyasyaiva ca tattvena vyavasthāpanāt |	དེ་ལས་གཞན་པ་མ་ཡིན་པ་ཉིད་ནི་དེ་ཉིད་དུ་རྣམ་པར་འཇོག་པའི་ཕྱིར་རོ་༎
 etena kramākramādayo 'pyanyonyavyavaccedarūpā vyākhytāḥ |	འདིས་ནི་རིམ་དང་རིམ་མ་ཡིན་པ་ལ་སོགས་པ་ཕན་ཚུན་རྣམ་པར་གཅོད་པའི་ངོ་བོ་ཅན་དག་ཀྱང་རྣམ་པར་བཅད་པ་ཡིན་ནོ་༎
 tadevamekasyopalambhāttasya tadanyātmano vyavaccedaḥ |	དེ་ལྟ་བས་ན་དེ་ལྟར་གཅིག་དམིགས་པས་དེའི་དེ་ལས་གཞན་པའི་བདག་ཉིད་རྣམ་པར་གཅོད་པ་ཡིན་གྱི་། 
 na taddeśakālayoḥ sarvasyānyasya bhāvasya vyavaccedaḥ |	དེའི་ཡུལ་དང་དུས་དག་ཏུ་གཞན་ཡོད་པ་ཐམས་ཅད་རྣམ་པར་གཅོད་པ་ནི་མ་ཡིན་གྱི་། ཡིན་ནོ་༎ དེ་ལྟ་བས་ན་དེའི་བདག་ཉིད་མ་ཡིན་པར་ཡང་འགྱུར་ལ་།
 tasmādatadatmā ca syāttaddeśakālaśca,	དེའི་ཡུལ་དང་དུས་དག་ཏུའང་འགྱུར་ཏེ་།
 rasarūpādivat |	རོ་དང་གཟུགས་ལ་སོགས་པ་བཞིན་ནོ་༎
 tasmādyathoktādevānupalambhātkvacit kadācitkasyacidabhāvasiddhiḥ |	དེ་ལྟ་བས་ན་ཇི་སྐད་བཤད་པའི་མི་དམིགས་པ་ཁོ་ན་ལས་རེས་འགའ་ལ་ལ་ཞིག་ཏུ་འགའ་ཞིག་དངོས་པོ་མེད་པར་འགྲུབ་བོ་༎
 (4|13) anyabhāvaviṣayasyopalabdhirapi tadabhāvasya sādhikeṣṭaiva na tu liṅgatvena |	གཞན་ཡོད་པའི་ཡུལ་ཅན་གྱི་དམིགས་པ་ཡང་དེ་མེད་པའི་སྒྲུབ་པར་བྱེད་པར་འདོད་པ་ཁོ་ན་ཡིན་གྱི་རྟགས་ཉིད་དུ་ནི་མ་ཡིན་ཏེ་།
 tatrāpyabhāvasya pṛthak sādhyatve sambandhābhāvasya tulyatvāt |	དེར་ཡང་དངོས་པོ་མེད་པ་ལོགས་ཤིག་ཏུ་སྒྲུབ་པར་བྱེད་པ་ཉིད་ཡིན་ལ་། འབྲེལ་པ་མེད་པར་མཚུངས་པའི་ཕྱིར་རོ་༎
 liṅgāvirbhāvakāla eva tadabhāvasiddheśca |	རྟགས་འབྱུང་བའི་དུས་སུ་ཁོ་ན་ན་དེ་མེད་པར་འགྲུབ་པའི་ཕྱིར་ཏེ་།
 na hi anyasya bhāvaṃ pratipadya tatpratipatteḥ anvayavyatirekau prasādhya tadabhāvaṃ pratipadyate |	གཞན་ཡོད་པ་རྟོགས་ནས་འདོད་དེ་རྟོགས་པའི་རྗེས་སུ་འགྲོ་བ་དང་ལྡོག་པ་དག་རབ་ཏུ་བསྒྲུབས་ནས་དེ་མེད་པར་རྟོགས་པ་མ་ཡིན་ནོ་༎ འོ་ན་ཅི་ཞེ་ན་།
 kiṃ tarhi? tadanyaṃ pratipadyamāna eva tadabhāvaṃ pratipadyate |	དེ་ལས་གཞན་པ་རྟོགས་པ་ཁོ་ན་ནི་དེ་མེད་པ་རྟོགས་ཏེ་། མཐོང་མ་ཐག་ཏུ་ཆོད་པ་མེད་པར་འདི་ནི་ཡོད་དོ་༎
 darśanānantaram idamasti idaṃ tu nāsti iti vyavasthāpanāt |	འདི་ནི་མེད་དོ་ཞེས་བྱ་བར་ཤེས་པའི་ཕྱིར་རོ་༎
 tacca tasya liṅgaṃ bhavati yasyānvayi vyatireko ca | dṛṣṭāntāsiddheḥ |	དེ་ནི་གང་ཞིག་གང་གིས་རྗེས་སུ་འགྲོ་བ་དང་ལྡོག་པ་དེའི་རྟགས་ཡིན་པའི་དཔེ་མ་གྲུབ་པའི་ཕྱིར་རོ་༎ 
 na hi evaṃ śakyaṃ darśayituṃ yatra anyabhāvopalabdhistatra tadabhāvaḥ iti |	འདི་སྐད་དུ་། གང་ན་གཞན་ཡོད་པའི་དམིགས་པ་ཡོད་པ་དེ་ན་དེ་མེད་དོ་ཞེས་བསྟན་པར་ནི་མི་ནུས་ཏེ་། 
 tadekopalabdheḥ kvacidapyabhāvāt |	དམིགས་པ་གཅིག་པུ་དེ་ནི་གང་ན་ཡང་མེད་པའི་ཕྱིར་རོ་༎
 sāmānyena pradarśane dṛṣṭānte 'pi pramāṇāntaraṃ nāsti, kiṃtu saiva tadanyabhāvopalabdhiḥ sādhyadharmasya sādhiketi anavasthā dṛṣṭāntānāmityapratipattiḥ |	སྤྱིར་རབ་ཏུ་བསྟན་པའི་དཔེ་ལ་ཡང་ཚད་མ་གཞན་མེད་པའི་ཕྱིར་དེ་ལས་གཞན་པ་ཡོད་པ་དམིགས་པ་དེ་ཉིད་བསྒྲུབ་པར་བྱ་བའི་ཆོས་ཀྱི་སྒྲུབ་པར་བྱེད་པ་ཡིན་པས་། དཔེ་ཐུག་པ་མེད་པ་ཉིད་ཀྱི་ཕྱིར་རྟོགས་པ་མ་ཡིན་ནོ་༎
 tasmāt naiva kutaścilliṅgāt tadabhāvasiddhiḥ |	དེ་ལྟ་བས་ན་རྟགས་གང་ལས་ཀྱང་དངོས་པོ་མེད་པ་མི་འགྲུབ་བོ་༎
 so 'nyabhāvaḥ pratyakṣalakṣaṇenānupalambhena siddhaḥ san mūḍhapratipattāvabhāvavyavahāraṃ sādhayed iti alaṃ prasaṅgena |	མངོན་སུམ་གྱི་མཚན་ཉིད་ཀྱི་མི་དམིགས་པས་གྲུབ་པ་གཞན་ཡོད་པ་དེ་ནི་རྟོགས་པ་ལ་དངོས་པོ་མེད་པར་ཐ་སྙད་གདགས་པ་སྒྲུབ་པར་བྱེད་པ་ཡིན་པས་ཞར་ལ་འོངས་པས་ཆོ་ག་༄༢༥༡བ་གོ་༎ 
 (4|14) seyamanupalabdhistridhā |	མི་དམིགས་པ་དེ་ནི་རྣམ་པ་གསུམ་སྟེ་།
 siddhe kāryakāraṇabhāve siddhābhāvasya kāraṇasyānupalabdhiḥ,	རྒྱུ་དང་འབྲས་བུའི་དངོས་པོ་གྲུབ་ལ་།
 vyāpyavyāpakabhāvasiddhau siddhābhāvasya vyāpakasyānupalabdhiḥ svabhāvānupalabdhiśca |	དངོས་པོ་མེད་པར་གྲུབ་པའི་རྒྱུ་མི་དམིགས་པ་དང་། ཁྱད་པར་བྱ་བ་དང་། ཁྱད་པར་བྱེད་པ་གྲུབ་ལ་། དངོས་པོ་མེད་པར་གྲུབ་པའི་ཁྱད་པར་བྱེད་པའི་མི་དམིགས་པ་དང་། རང་བཞིན་མི་དམིགས་པའོ་༎
 tatra kāraṇavyāpakayorapi abhāvavyavahāraḥ tadanyabhāvasiddhayaiva sidhyati |	དེ་ལ་རྒྱུ་དང་ཁྱབ་པར་བྱེད་པ་དག་གི་ངོ་བོ་ཉིད་དངོས་པོ་མེད་པར་ཐ་སྙད་གདགས་པ་འགྲུབ་པ་ཡང་གཞན་ཡོད་པ་གྲུབ་པ་ཁོ་ན་ལས་ཡིན་ནོ་༎
 sa tathā siddhaḥ san kāryavyāpyayorabhāvam abhāvavyavahāraṃ vā sādhayati |	དེ་ལྟར་གྲུབ་པ་དེ་ནི་འབྲས་བུ་དང་། ཁྱབ་པར་བྱ་བ་དག་དངོས་པོ་མེད་པའམ་། དངོས་པོ་མེད་པར་ཐ་སྙད་གདགས་པ་གྲུབ་པར་བྱེད་པ་ཡིན་ནོ་༎
 svabhāvānupalabdhau tu anupalabdhyā liṅgabhūtayā abhāvavyavahāra eva sādhyate |	རང་བཞིན་མི་དམིགས་པ་ལ་ནི་མི་དམིགས་པ་རྟགས་སུ་གྱུར་པས་ཐ་སྙད་གདགས་པ་ཁོ་ན་སྒྲུབ་པར་བྱེད་པ་ཡིན་ནོ་༎
 (4|15) yadi kāraṇavyāpakau tadanyabhāvasiddhayānupalabdhyā siddhāsad vyavahārāvanyasyābhāvamabhāvavyavahāṃra ca sādhayataḥ |	གལ་ཏེ་རྒྱུ་དང་ཁྱབ་པར་བྱེད་པ་དེ་ལས་གཞན་ཡོད་པར་གྲུབ་པའི་ངོ་བོ་མི་དམིགས་པས་གྲུབ་པ་དག་། གཞན་དངོས་པོ་མེད་པའམ་དངོས་པོ་མེད་པར་ཐ་སྙད་གདགས་པ་སྒྲུབ་པར་བྱེད་ལ་། 
 sā ca tayorupalabdhilakṣaṇaprāptāvevāsadvyavahārasya sādhiketi kathaṃ tayoḥ parokṣe 'rtheprayogaḥ?	དེ་ཡང་མི་དམིགས་པའི་རིག་བྱར་གྱུར་པ་དེ་གཉིས་ཁོ་ནའི་མེད་པར་ཐ་སྙད་གདགས་པའི་སྒྲུབ་པར་བྱེད་པ་ཡིན་ན་། དེ་གཉིས་ཇི་ལྟར་ལྐོག་ཏུ་སྦྱོར་བ་ཡིན་།
 naiva prayogaḥ pramāṇatayā,	རྟགས་མ་ངེས་པའི་ཕྱིར་ཚད་མ་ཉིད་ཀྱིས་ནི་།
 liṇgasyāniścayāt | kevalaṃ kāraṇavyāpakayorhi siddhasambandhayoryadyabhāvaḥ parasyāpi avaśyamabhāvaḥ iti etasya darśanārthamete prayujyete iti |	སྦྱོར་བ་མ་ཡིན་པ་ཁོ་ནའི་རྒྱུ་དང་ཁྱབ་པར་བྱེད་པ་འབྲེལ་པ་གྲུབ་པ་དག་གལ་ཏེ་མེད་ན་གཞན་གདོན་མི་ཟ་བར་མེད་པར་ངེས་སོ་ཞེས་བསྟན་པར་བྱ་བའི་ཕྱིར་འདི་དག་སྦྱོར་བ་འབའ་ཞིག་ཏུ་ཟད་དོ་༎
 eṣa eva pakṣadharmo 'nvayavyatirekavān iti tadaṃśena vyāptaḥ trilakṣaṇa eva trividha eva heturgamakaḥ svaśādhyadharmāvyabhicārāt |	དེ་ལྟ་བས་ན་ཕྱོགས་ཀྱི་ཆོས་འདི་རྗེས་སུ་འགྲོ་བ་དང་། ལྡོག་པ་དང་ལྡན་པ་ཡིན་པས་། དེའི་ཆས་ཁྱབ་པ་མཚན་ཉིད་གསུམ་པའི་གཏན་ཚིགས་རྣམ་པ་གསུམ་ཁོ་ན་ཤེས་པར་བྱེད་པ་ཡིན་ཏེ་། རང་གི་བསྒྲུབ་པར་བྱ་བའི་ཆོས་ལ་འཁྲུལ་པ་མེད་པའི་ཕྱིར་རོ་༎
 (5|1) ṣaḍliṅgo heturityapare |	གཞན་དག་ནི་གཏན་ཚིགས་མཚན་ཉིད་དྲུག་པའོ་ཞེས་ཟེར་ཏེ་།
 trīṇi caitāni abādhitaviṣayatvaṃ vivakṣitaikasaṃkhyatvaṃ jñātatvaṃ ceti |	གསུམ་པོ་དེ་དག་དང་། གནོད་པར་མ་བྱས་པའི་ཡུལ་ཅན་ཉིད་དང་། གྲངས་གཅིག་པ་བརྗོད་པར་འདོད་པ་ཅན་ཉིད་དང་། ཤེས་པ་ཉིད་ཅེས་བྱ་བ་ཡིན་ནོ་༎
 tatrābādhitaviṣayatvaṃ tāvat pṛthag lakṣaṇaṃ na bhavati,	དེ་ལ་རེ་ཞིག་གནོད་པར་མ་བྱས་པའི་ཡུལ་ཅན་ཉིད་ནི་མཚན་ཉིད་ཐ་དད་པ་ཉིད་མ་ཡིན་ཏེ་། 
 bādhāvinābhāvayorvirodhāt |	གནོད་པ་དང་མེད་ན་མི་འབྱུང་བ་དག་འགལ་བའི་ཕྱིར་རོ་༎
 avinābhāvo hi satyeva sādhyadharme bhāvo hetoḥ |	མེད་ན་མི་འབྱུང་བ་ནི་བསྒྲུབ་པར་བྱ་བའི་ཆོས་ཡོད་པ་ཁོ་ན་གཏན་ཚིགས་ཡོད་པ་ཡིན་ནོ་། 
 sa hetustallakṣaṇaḥ dharmiṇi syād atra ca sādhyadharmaḥ kathaṃ na bhavet?	ཇི་ལྟར་ཆོས་ཅན་ལ་༄༢༥༢ཨ་༌་༎ དེ་ལྟ་བུའི་མཚན་ཉིད་ཀྱི་གཏན་ཚིགས་ཀྱང་ཡོད་པར་འགྱུར་ལ་། འདི་ལ་བསྒྲུབ་པར་བྱ་བའི་ཆོས་ཀྱང་མེད་པར་འགྱུར་། མངོན་སུམ་དང་། རྗེས་སུ་དཔག་པ་བསྒྲུབ་པར་བྱ་བའི་ཆོས་ལ་གནོད་པར་ཞུགས་པ་དག་ནི་།
 pratyakṣānumāne hi sādhyadharmaṃ bādhamāne taṃ dharmiṇo niṣkāsayataḥ tasmiṃśca satyeva heturbhavan taṃ tatraivāvasthāpayatīti paraṃ bata bhāvānāmasvāsthyam	དེ་ཆོས་ཅན་དེ་ལས་ཟློག་པར་བྱེད་ལ་། དེ་ཡོད་པ་ཁོ་ནས་གཏན་ཚིགས་ཡོད་པ་ནི་། དེ་ཆོས་ཅན་དེ་ལ་འཇུག་པར་བྱེད་པས་། ཀྱེ་མ་དངོས་པོ་རྣམས་རབ་ཏུ་ཉམ་ང་བར་གྱུར་ཏོ་༎
 anyatra sādhyadharmeṇāvinābhāvī heturna punaḥ sādhyadharmiṇeveti cet |	གལ་ཏེ་གཞན་ལ་གཏན་ཚིགས་བསྒྲུབ་པར་བྱ་བའི་ཆོས་མེད་ན་ནི་མི་འབྱུང་བ་ཡིན་གྱི་། ཆོས་ཅན་ཁོ་ན་ལ་ནི་མ་ཡིན་ནོ་ཞེ་ན་།
 tat kimayaṃ tapasvī śaṇḍhamudvāhya putraṃ mṛgayate?	དེ་ཅི་སྟེ་ཉོན་མོངས་འདི་མ་ནིང་བཅིབས་ནས་དུ་ཚོལ་བར་བྱེད་དམ་།
 yasya dharmiṇyasatyapi sādhyadharme bhāvaḥ, tamupadarśya kathaṃ sa dharmī sādhyadharmavānityucyate?	གང་ཞིག་ཆོས་ཅན་ལ་བསྒྲུབ་པར་བྱ་བ་མེད་ཀྱང་ཡོད་པ་དེ་ཉེ་བར་བསྟན་ནས་། ཆོས་ཅན་དེ་བསྒྲུབ་པར་བྱ་བའི་ཆོས་དང་ལྡན་པ་ཞེས་ཇི་སྐད་དུ་བྱ་།
 (5|2) ata eva bādhābhāva uktaḥ |	གལ་ཏེ་དེ་ཉིད་ཀྱི་ཕྱིར་གནོད་པ་མེད་པ་སྨོས་ཏེ་།
 syādetad, yata eva heturanyathāpi bhavedata eva pramāṇābhyāmabādhitadharmā dharmītyucyata iti |	འདི་སྙམ་དུ་གང་གི་ཕྱིར་། ཁོ་ནར་གཏན་ཚིགས་གཞན་དུ་ཡང་ཡོད་པར་འགྱུར་བ་དེ་ཁོ་ནའི་ཕྱིར་ཚད་མ་དག་གིས་གནོད་པར་མ་བྱས་པའི་ཆོས་དང་ལྡན་པའི་ཆོས་ཅན་ཞེས་བྱའོ་སྙམ་དུ་སེམས་ན་།
 tatkimidānīṃ hetoḥ sāmarthyam? abādhayaiva sādhyasiddhervyartho hetuḥ |	དེ་དག་གནོད་པ་མེད་པ་ཁོ་ནས་བསྒྲུབ་པར་བྱ་བ་གྲུབ་པའི་ཕྱིར་གཏན་ཚིགས་ལ་ནུས་པ་ཅི་ཞིག་ཡོད་། 
 bādhāyāmapi sādhyābhāvasya tena sādhanāt kutaḥ sādhanasya sāmarthyam | aniyame bādhakapramāṇavṛttau sādhyābhāvasya,	བསྒྲུབ་པར་བྱ་བ་མེད་པས་གནོད་པར་བྱེད་པའི་ཚད་མ་འཇུག་པར་ངེས་པ་ཞིག་ཡིན་ན་ནི་གནོད་པ་མེད་ན་བསྒྲུབ་པར་བྱ་བ་འགྲུབ་པས་གཏན་ཚིགས་དོན་མེད་དོ་༎ གནོད་པ་ཡོད་ན་ཡང་སྒྲུབ་པ་ནུས་པ་མེད་པའི་ཕྱིར་རོ་༎ མ་ངེས་པ་ཞིག་ཡིན་ན་ནི་།
 bādhakapramāṇasyābhāvaḥ sādhyābhāvasya ca saṃbhavaḥ syāditi na sāmarthyamabādhāyāḥ |	གནོད་པར་བྱེད་པའི་ཚད་མ་ཡང་མེད་པར་འགྱུར་ལ་། བསྒྲུབ་པར་བྱ་བ་མེད་པ་ཡང་སྲིད་པས་གནོད་པ་མེད་པ་ལ་ནུས་པ་མེད་པ་ཡིན་ནོ་༎ གནོད་པ་མེད་པ་ནི་གནོད་པ་མེད་པ་ཡིན་ནོ་༎ འོ་ན་ཅི་ཞེ་ན་།
 (5|3) na bādhāyā abhāvo 'bādhā |	གནོད་པ་མི་དམིགས་པ་ཡིན་ཏེ་།
 kiṃ tarhi? bādhāyā anupalabdhiḥ sā ca puruṣasya kvacid bādhāyāḥ saṃbhave 'pi syāditi sa hetuprayogasya viṣayaḥ |	དེ་ཡང་ལ་ལར་གནོད་པ་སྲིད་ཀྱང་སྐྱེས་བུ་ལ་ཡོད་པར་འགྱུར་བས་།
 kiṃ nu vai heturbādhopalabdherbibheti na punarbādhāyā yena bādhāmanādṛtya tadanupalabdhau prayoktavya iṣṭaḥ?	དེ་ནི་གཏན་ཚིགས་སྦྱོར་བའི་ཡུལ་ཡིན་ནོ་༎ གཏན་ཚིགས་གནོད་པ་དམིགས་པ་ལའང་འཇིགས་ཀྱི་། གནོད་པ་ལ་མི་འཇིགས་སམ་ཅི་ན་གང་གིས་ན་གནོད་པ་ཚོད་ཡོད་པར་བྱས་ཏེ་མི་དམིགས་པ་ལའང་སྦྱོར་བར་འདོད་།
 sa tarhi paramārthena- 'bādhā kimasti nāsti' ityanapekṣya bādhāyā anupalabdhau prayoktavyaḥ?	གཏན་ཚིགས་དེ་ནི་དོན་དམ་པར་གནོད་པ་ཡོད་དམ་མེད་ཀྱང་རུང་སྟེ་། མི་ལྟོས་པར་གནོད་པ་མི་དམིགས་པ་ལ་སྦྱར་བར་བྱ་བའམ་།
 kimarthaṃ prayujyate?	ཅིའི་ཕྱིར་སྦྱར་བར་བྱ་།
 sādhyasiddhayartham |	བསྒྲུབ་པར་༄༢༥༢བ་བྱ་བ་བསྒྲུབ་པར་བྱ་བའི་ཕྱིར་རོ་༎
 sa kiṃ kvacit satyāmapi bādhāyāṃ sādhyaṃ sādhayed yenāsyā abhāvaniścayaṃ prati yatno na kriyate hetuśca pratyujyate | evaṃ ca sati abādhitaviṣayatvaṃ hetulakṣaṇaṃ na bhavati |	དེས་ལ་ལར་གནོད་པ་ཡིན་བཞིན་དུ་ཡང་བསྒྲུབ་པར་བྱ་བསྒྲུབ་པར་བྱེད་དམ་ཅི་གང་གིས་ན་འདི་མེད་པར་ངེས་པར་བྱ་བ་ལ་འབད་པར་ཡང་མི་བྱེད་ལ་། གཏན་ཚིགས་ཀྱང་སྦྱོར་། དེ་ལྟ་ན་ཡང་གནོད་པར་བྱས་པའི་ཡུལ་ཅན་ཉིད་། གཏན་ཚིགས་ཀྱི་མཚན་ཉིད་མ་ཡིན་ཏེ་།
 bādhāyāmapi satyāmasya sāmarthyāt |	གནོད་པ་ཡོད་བཞིན་དུ་ཡང་འདིས་ནུས་པའི་ཕྱིར་རོ་༎
 tathā ca saṃśayitasya pravṛttirna yujyate |	དེ་ལྟ་ན་ཡང་ཐེ་ཚོམ་ཅན་ལ་ཁས་མ་བླངས་ན་། འཇུག་པ་མི་རུང་བའི་ཕྱིར་།
 yathā ca bādhānupalabdhau tāmabhyupagamya prayujyate tathā tadupalabdhāvapi prayujyatām,	ཇི་ལྟར་མི་དམིགས་པ་ལ་གནོད་པ་ཡོད་པ་སྲིད་ན་ཡང་ཁས་བླངས་ནས་། སྦྱོར་བ་དེ་བཞིན་དུ་། གནོད་པ་མི་དམིགས་པ་ལ་ཡང་སྦྱོར་བར་འགྱུར་རོ་༎
 abhyupagame viśeṣābhāvāt |	ཁས་ལེན་ན་ཁྱད་པར་མེད་པའི་ཕྱིར་རོ་༎
 (5|4) na bādhāyāṃ satyāṃ hetoḥ sāmarthyamiti cet |	གལ་ཏེ་གནོད་པ་ཡོད་ན་མི་ནུས་སོ་ཞེ་ན་༎
 yadyevam, anirṇītabādhāsambhavo hetuḥ prayogaṃ hārhati,	གལ་ཏེ་དེ་ལྟ་ན་སྦྱར་ཀྱང་མི་ནུས་པར་འགྱུར་དུ་འོང་བས་།
 mā bhūt bādhāyāḥ saṃbhavapakṣe prayuktasyāpyasāmarthyamiti |	གནོད་པ་མི་སྲིད་པར་གཏན་ལ་མ་བབ་པར་སྦྱོར་བར་འོས་པ་མ་ཡིན་ནོ་༎
 bādhānupalambhe sati sāmarthyamiti cet |	གལ་ཏེ་གནོད་པ་མི་དམིགས་ན་། ནུས་སོ་སྙམ་ན་།
 kimupalambho bādhāṃ vyāpnoti,	དམིགས་པས་གནོད་པ་ལ་ཁྱབ་བམ་ཅི་ན་།
 yato hetorbādhāsambhavakṛtam asāmarthyaṃ na sambhavet? atha tannivṛttau bādhā nivartate |	གང་གིས་ན་འདི་ལྟར་གཏན་ཚིགས་གནོད་པ་སྲིད་པས་བྱས་པའི་ནུས་པ་མེད་པར་མི་འགྱུར་བ་དེ་ལོག་ན་། 
 tathāpi bādhānupalambhādeva sādhyāsiddhervyartho hetuḥ |	གནོད་པ་ལྡོག་། དེ་ལྟ་ན་ཡང་གནོད་པ་མི་དམིགས་པ་ཁོ་ན་ལས་བསྒྲུབ་པར་བྱ་བ་འགྲུབ་པའི་ཕྱིར་། གཏན་ཚིགས་དོན་མེད་པ་ཡིན་ཏེ་།
 anupalambhe bādhāyā asambhavāt |	མི་དམིགས་ན་གནོད་པ་མི་སྲིད་པའི་ཕྱིར་རོ་༎
 upalambhasya nivṛttāvapi bādhāyā anivṛttau tadavasthaṃ hetorasāmarthyamityaprayogaḥ |	དམིགས་པ་ལོག་ཀྱང་གནོད་པ་མི་ལྡོག་ན་ནི་། གཏན་ཚིགས་ནུས་པ་མེད་པ་དེའི་སོན་འདུག་པས་སྦྱོར་བ་མ་ཡིན་ནོ་༎
 tasmāt svasādhyabhāvābhāvādhyāmanyathāpi bhavanhetuḥ dharmiṇi na kiñcidbhāvayati na vibhāvayati iti tadupakṣepo na samarthaḥ |	དེ་ལྟ་བས་ན་ཆོས་ཅན་ལ་རང་གིས་བསྒྲུབ་པར་བྱ་བ་ཡོད་པ་དང་། མེད་པ་དག་ལས་གཞན་དུ་ཡང་ཡོད་པ་ནི་ཅུང་ཟད་ཀྱང་སྒྲུབ་པར་མི་བྱེད་འཇིག་པར་ཡང་མི་བྱེད་པས་། དེ་ཉེ་བར་བཀོད་པ་ནི་ནུས་པ་མ་ཡིན་ནོ་༎
 iti bādhāvinābhāvayorvirodhaḥ | tatrābādhā rūpāntaram |	དེ་ལྟ་བས་ན་གནོད་པ་དང་མེད་ན་མི་འབྱུང་བ་དག་ནི་ལྷན་ཅིག་ཡོད་པ་མ་ཡིན་ཏེ་། དེས་ན་གནོད་པ་མེད་པའི་ངོ་བོ་གཞན་མ་ཡིན་ནོ་༎
 (5|5) tatrāma tasmād viśeṣaṇāntaraṃ bhavet lakṣaṇāntaratvena copādānamarhati yasya bhāve 'pi yasya aparasyābhāvaḥ syāt |	དེ་དེ་ལས་ཁྱད་པར་གཞན་ནམ་མཚན་ཉིད་གཅིག་ཏུ་སྨོས་པར་འོས་པར་འགྱུར་ན་། གང་ཞིག་ཡོད་བཞིན་དུ་ཡང་གང་ཞིག་གཞན་དུ་འགྱུར་བ་སྟེ་།
 tadyathā pakṣadharmatvaṃ sapakṣe ca bhāva iti |	དཔེར་ན་ཕྱོགས་ཀྱི་ཆོས་ཉིད་དང་མཐུན་པའི་ཕྱོགས་ལ་ཡོད་པ་ཞེས་བྱ་བ་ལྟ་བུ་ཞིག་ཡིན་གྲང་ན་། 
 n acaitad abādhāyā avinābhāve sati sambhavati iti na sādhyaviparyayāvinābhāvinorhetuviruddhayorviṣaye bādhā saṃbhavati iti na tadabhāvaḥ pṛthaganayorlakṣaṇāntaratvena vācyaḥ |	མེད་ན་མི་འབྱུང་བ་ཡོད་བཞིན་དུ་གནོད་པ་སྲིད་པ་འདི་ནི་མེད་པས་བསྒྲུབ་པར་བྱ་བ་དང་། བཟློག་པ་མེད་ན་མི་འབྱུང་བ་གཏན་ཚིགས་༄༢༥༣ཨ་༌་༎ དང་འགལ་བ་དག་གི་ཡུལ་ལ་གནོད་པ་མི་སྲིད་པའི་ཕྱིར་། དེ་མེད་པ་ནི་། ལོགས་ཤིག་ཏུ་འདི་གཉིས་ཀྱི་མཚན་ཉིད་ཉིད་དུ་བརྗོད་པར་བྱའོ་༎
 tasmād hetoḥ prayoge pratijñādoṣāṇāṃ saṃbhavo nāsti | nāpi kevalā pratijñaiva prayujyate |	དེ་ལྟ་བས་ན་གཏན་ཚིགས་སྦྱོར་བ་ལ་དམ་བཅས་པའི་ཉེས་པ་རྣམས་མི་སྲིད་དོ་༎
 tataśca na pratijñādoṣā vācyāḥ |	དམ་བཅས་པ་འབའ་ཞིག་སྦྱོར་བ་ཡང་མེད་པས་དམ་བཅས་པའི་ཉེས་པ་བརྗོད་པར་མི་བྱའོ་༎
 (5|6) etena ekasaṃkhyāvivakṣāpi pratyuktā |	འདིས་ནི་གྲངས་གཅིག་བརྗོད་པར་འདོད་པ་ཅན་ཡང་བསལ་བ་ཡིན་ནོ་༎
 katham? eko hi hetuḥ svasādhyabhāva eva bhavediti tatrāvyabhicārī tatraiva tasmādanyo 'pi kathaṃ heturbhavati?	ཅི་ལྟ་བུ་གཅིག་ནི་རང་གིས་བསྒྲུབ་པར་བྱ་བ་ཡོད་པ་ཁོ་ནས་ཡོད་པའི་ཕྱིར་། དེར་འཁྲུལ་པ་མེད་པ་ཅན་ཡིན་ནོ་༎
 ekasya yat sādhyaṃ tadabādhakasya dharmasya bhāva eva bhāvāditi bādhayā samānam |	དེ་ཉིད་ལ་དེ་ལས་གཞན་པ་དེ་གནོད་པར་བྱེད་པ་ཁོ་ན་ཡང་ཡོད་པའི་ཕྱིར་དེ་དང་འགལ་བས་འདིར་གནོད་པ་དང་མཚུངས་སོ་༎
 (5|7) api ca | kiṃ yo vastuto 'sambhavatpratihetuḥ sa samyagjñānasya viparyayasya vā heturiṣṭa āhosvidapradarśitapratihetuḥ? kiṃ cātaḥ?	གཞན་ཡང་ཅི་དངོས་སུ་གཏན་ཚིགས་ཀྱི་ཟླ་བོ་མི་སྲིད་པ་དེ་ཡང་དག་པའི་ཤེས་པའམ་། བཟློག་པའི་རྒྱུ་ཡིན་ནམ་། འོན་ཏེ་གཏན་ཚིགས་ཀྱི་ཟླ་བོ་རབ་ཏུ་མ་བསྟན་པ་ཞིག་ཡིན་། ཅིར་འགྱུར་།
 yadyasambhavatpratihetuḥ aśakyaniścayatvādalakṣaṇametad hetvabhāvo vā |	གལ་ཏེ་གཏན་ཚིགས་ཀྱི་ཟླ་བོ་མ་བསྟན་པ་ཞིག་ཡིན་ནོ་ཞེ་ན་ནི་། ངེས་པར་བྱ་བར་མི་ནུས་པའི་ཕྱིར་། འདི་མཚན་ཉིད་མ་ཡིན་ནོ་༎ གཏན་ཚིགས་མེད་པ་ཡང་མ་ཡིན་ཏེ་།
 na hi aniścitātmanaḥ pratipādakadharmasya tallakṣaṇatvaṃ yathā sandigdhasya pakṣadharmatvasya |	སྒྲུབ་བར་བྱེད་པའི་ཆོས་མ་ངེས་པའི་བདག་ཉིད་ནི་། དེའི་མཚན་ཉིད་མ་ཡིན་ཏེ་། ཕྱོགས་ཀྱི་ཆོས་ཐེ་ཚོམ་ཅན་བཞིན་ནོ་༎
 nāpi sandigdhalakṣaṇo heturbhavediti na kaścid heturbhavet |	ཐེ་ཚོམ་ཅན་གྱི་མཚན་ཉིད་ནི་། གཏན་ཚིགས་ཀྱང་མ་ཡིན་པས་། འགའ་ཡང་གཏན་ཚིགས་སུ་མི་འགྱུར་ཏེ་།
 tulye lakṣaṇe di dṛṣṭaḥ pratiyoginaḥ saṃbhavo 'dṛṣṭapratiyogiṣu api śaṃkāmutpādayati viśeṣābhāvāt |	མཚན་ཉིད་མཚུངས་པ་ལ་ཟླ་བོ་སྲིད་པ་མཐོང་ན་། ཟླ་བོ་མ་མཐོང་བ་ལ་ཡང་དོགས་པ་སྐྱེད་པར་བྱེད་དེ་ཁྱད་པར་མེད་པའི་ཕྱིར་རོ་༎
 sati vā viśeṣe sa viśeṣo hetorlakṣaṇam |	ཁྱད་པར་ཡོད་ན་ནི་གཏན་ཚིགས་ཀྱི་མཚན་ཉིད་ཡིན་ཏེ་།
 yatastadviśeṣād heturekāntena nirastapratipakṣaḥ svasādhyaṃ niścāyayatīti atallakṣaṇo na hetuḥ syāt tathā ca vyarthā ekasaṃkhyāvivakṣā |	དེས་གཉེན་པོ་གཅིག་ཏུ་བསལ་བའི་གཏན་ཚིགས་ཀྱིས་རང་གི་བསྒྲུབ་པར་བྱ་བ་ངེས་པར་བྱེད་པས་དེའི་མཚན་ཉིད་ཅན་མ་ཡིན་པ་གཏན་ཚིགས་སུ་མི་འགྱུར་རོ་༎ དེ་ལྟ་ན་གྲངས་གཅིག་བརྗོད་པར་འདོད་པ་ཅན་དོན་མེད་པ་ཡིན་ནོ་༎
 ato viruddhāvyabhicāriṇo lakṣaṇaṃ hīyeta svalakṣaṇayuktayorhetvorekatra dharmiṇi virodhenopanipāte sati viruddhāvyabhicārī iti |	འདིའི་ཕྱིར་འགལ་བར་འཁྲུལ་པ་མེད་པའི་མཚན་ཉིད་ཉམས་པར་འགྱུར་ཏེ་། རང་གི་མཚན་ཉིད་དང་ལྡན་པའི་གཏན་ཚིགས་དག་ཆོས་ཅན་གཅིག་ལ་འགལ་བར་འདུ་ན་འགལ་བ་འཁྲུལ་པ་མེད་པ་ཞེས་བྱའོ་༎
 (5|8) na ca tasya viśeṣasya svarūpaṃ nirdiṣṭaṃ, yadrūpaṃ pratītya pratiyoginaḥ sambhavāsambhavāvutpaśyāmaḥ |	གང་ཞིག་རྟོགས་ནས་ཟླ་བོ་སྲིད་དམ་མི་སྲིད་པ་དག་བལྟ་བར་བྱ་བ་ཁྱད་པར་དེའི་ངོ་བོ་ཡང་མི་སྟོན་ཏམ་།
 tasmātrāstyevaṃ viśeṣa iti sarvatra śaṅkayā bhavitavyam |	དེ་ལྟ་བས་ན་ཁྱད་༄༢༥༣བ་པར་མེད་པ་ཁོ་ན་ཡིན་པས་། ཐམས་ཅད་དུ་དོགས་པར་འགྱུར་རོ་༎
 dṛṣṭapratihetorapi hetoḥ prāgitareṇa na kaścidviśeṣo lakṣyate |	ཟླ་བོའི་གཏན་ཚིགས་མཐོང་བའི་གཏན་ཚིགས་ཀྱང་། དང་པོར་ཅིག་ཤོས་དང་། ཁྱད་པར་ཅུང་ཟད་ཀྱང་མི་དམིགས་སོ་༎
 na ca saṃbhavatpratihetūnāmapi sarvadā tasyopalabdhiḥ | atiśayavatī tu prajñā pratihetūtprekṣiṇī dṛṣṭā |	ཟླ་བོའི་གཏན་ཚིགས་སྲིད་པ་རྣམས་ཀྱི་ཡང་དེ་ཐམས་ཅད་དུ་མི་དམིགས་པ་ནི་མ་ཡིན་ནོ་༎ ཤེས་རབ་ཕུལ་དུ་བྱུང་བ་དང་ལྡན་པས་བརྟགས་ན་མཐོང་སྟེ་།
 tenāniścayaḥ pratiyoginaḥ saṃbhavāsaṃbhavayoriti vastuto |	དེས་ན་སྲིད་པ་དང་མི་སྲིད་པ་དག་མ་ངེས་པས་མཚན་ཉིད་མ་ངེས་པའི་ཕྱིར་།
 sambhavatpratihetutvalakṣaṇasya aniścitatvātra kaścid hetuḥ syāt |	འགའ་ཡང་གཏན་ཚིགས་སུ་འགྱུར་རོ་༎
 (5|9) athāpradarśitapratihetuḥ yathāha,	འོན་ཏེ་ཟླ་བོའི་གཏན་ཚིགས་རབ་ཏུ་མ་བསྟན་པ་ཞིག་ཡིན་ཏེ་།
 “yadā tarhi śabdatvaṃ nityamabhyupagaccati tadāyaṃ hetureva syād yadyatra anityatvahetuṃ kṛtakatvādi kaścitra darśayed ” iti |	ཇི་སྐད་དུ་འོ་ན་ནི་གང་གི་ཚེ་སྒྲ་ཉིད་རྟག་པར་ཁས་ལེན་པ་དེའི་ཚེ་འདིའི་གཏན་ཚིགས་ཁོ་ནར་འགྱུར་རོ་༎ གལ་ཏེ་འདི་ལ་མི་རྟག་པ་ཉིད་ཀྱི་གཏན་ཚིགས་བྱས་པ་ཉིད་ལ་སོགས་པ་འགའ་ཞིག་ཀྱང་བསྟན་པར་མ་གྱུར་ནའོ་ཞེས་བཤད་པ་ལྟ་བུའོ་ཞེ་ན་། འདི་ནི་བསྒྲགས་སུ་ཡང་མི་རུང་ལ་།
 idamidānīṃ sumahad vyasanamāyātaṃ gurubhirabhihitatvādaprakāśyaṃ,	བཅབ་ཏུ་ཡང་མི་རུང་བས་མི་བཟད་པའི་སྐབས་སུ་ཆུད་པ་ཡིན་ན་།
 nyāyamanupālayadbhirasaṃvaraṇīyamiti kaṣṭataraṃ vyasanaṃ kathaṃ nirvoḍhuṃ śakyeta?	ཇི་ལྟ་ཞིག་ཏུ་བརྒལ་བར་ནུས་།
 sa tāvadayaṃ hetuḥ vastūni svasādhyaprakṛtīni kṛtvā tatpramāṇakān puruṣān abhyudayaniḥ	གཏན་ཚིགས་འདིས་ཇེ་དངོས་པོ་རྣམས་ཀྱང་རང་གིས་བསྒྲུབ་པར་བྱ་བའི་དེ་ཉིད་ཀྱི་རང་བཞིན་དུ་བྱས་ཤིང་། དེའི་ཚད་མ་ཅན་གྱི་སྐྱེས་བུ་རྣམས་ཀྱང་། མངོན་པར་མཐོ་བ་དང་། ངེས་པར་ལེགས་པ་དག་ལ་ཡང་དག་པར་སྦྱར་ནས་།
 śreyasābhyāṃ yojayitvā punaśca pratibhāvatā puruṣeṇa hetvantaranidarśanena utkīlitasādhanasāmarthyaḥ	ཡང་ཕྱིར་ཁྱོད་ཀྱིས་སྐྱེས་བུས་གཏན་ཚིགས་གཞན་བསྟན་པས་སྒྲུབ་པར་བྱེད་པའི་ནུས་པ་མེད་པར་བྱས་ཏེ་། 
 tāni vastūni tadbhāvasampadastāṃśca puruṣān abhyudayaniḥ śreyasasampadaḥ pracyāvya	དངོས་པོ་དེ་དག་དང་། སྐྱེས་བུ་དེ་དག་ཀྱང་དེའི་དངོས་པོ་དང་ཕུན་སུམ་ཚོགས་པ་ལས་ཉམས་པར་བྱས་ནས་།
 bhraṣṭarājya iva rājā tapovanaṃ gaccatīti kimatra brūmaḥ |	རྒྱལ་པོ་རྒྱལ་སྲིད་ཤོར་བ་ལྟར་དཀའ་ཐུབ་ཀྱི་ནགས་ཚལ་དུ་འགྲོ་བས་འདིར་ཇི་སྐད་སྨྲ་བར་བྱ་། 
 (5|10) puruṣapratibhākṛtaṃ hi yadi sādhanatvaṃ syāt tadā na kiñcit sādhanamasādhanaṃ vā |	སྒྲུབ་པ་ཉིད་སྐྱེས་བུའི་སྤོབས་པས་བྱས་པ་ཡང་ཡིན་ཏེ་། དེ་ནི་དངོས་སུ་སྨྲ་བའམ་། སྒྲུབ་པ་མ་ཡིན་པ་ཅི་ཞིག་ཡོད་།
 sa ca heturyadi svabhāvatastaddharmabhāvī tadā kathamanyathā kriyeta?	གཏན་ཚིགས་ཀྱི་ངོ་བོ་ཉིད་ཀྱིས་ཆོས་དེ་ཡོད་པ་ཅན་ཞིག་ཡིན་ན་ནི་། ཇི་ལྟར་གཞན་དུ་བྱེད་པར་འགྱུར་ཏེ་།
 vastusvabhāvānyathābhāvasyābhāvāt | ekasya ca viruddhobhayasvabhāvasyābhāvāt |	དངོས་པོ་རྣམས་ཀྱི་ངོ་བོ་ཉིད་གཞན་དུ་འགྱུར་བ་དང་། ངོ་བོ་ཉིད་འགལ་བ་གཉིས་ཀྱང་མེད་པའི་ཕྱིར་རོ་༎
 ataddharmabhāvī ca kathamanyadāpi sādhanaṃ kasyacit |	ཆོས་དེའི་ཡོད་པ་ཅན་མ་ཡིན་པ་ཞིག་ཡིན་ན་ཡང་གཞན་དུ་ཡང་ཇི་ལྟར་འགའ་ཞིག་གིས་སྒྲུབ་པ་ཡིན་། 
 tasmāt svabhāvataḥ svasvasādhyāvinābhāvinoryathoktalakṣaṇayoḥ kāryasvabhāvahetvoḥ tallakṣaṇasya pratihetorasaṃbhavādalakṣaṇamekasaṃkhyāvivakṣā,	དེ་ལྟ་བས་ན་ངོ་བོ་ཉིད་ཀྱིས་རང་གིས་བསྒྲུབ་པར་བྱ་བ་མེད་ན་མི་འབྱུང་བར་བཤད་པའི་མཚན་ཉིད་ཅན་འབྲས་བུ་དང་རང་བཞིན་དག་གི་དེའི་མཚན་ཉིད་ལ་ཟླ་སྒྲུབ་པ་ཡིན་། ༄༢༥༤ཨ་༌་༎ བོའི་གཏན་ཚིགས་མི་སྲིད་པའི་ཕྱིར་རོ་༎ གྲངས་གཅིག་བརྗོད་པར་འདོད་པ་ཅན་ནི་མཚན་ཉིད་མ་ཡིན་ཏེ་།
 vyavaccedyābhāvāt |	རྣམ་པར་གཅད་པར་བྱ་བ་མེད་པའི་ཕྱིར་རོ་༎
 (5|11) jñānaṃ punarna liṅgasyātmarūpamiti kathaṃ liṅgalakṣaṇaṃ bhaviṣyati |	ཤེས་པ་ཉིད་ནི་རྟགས་ཀྱི་ཆོས་མ་ཡིན་ན་ཇི་ལྟར་རྟགས་ཀྱི་མཚན་ཉིད་དུ་འགྱུར་།
 kiṃrūpād hetoranumeyo 'rtho jñātavya iti cintāyāṃ pratipatturavisaṃvādakalingasvarūpamabhidhīyate	རྟགས་ངོ་བོ་ཇི་ལྟ་བུ་ཞིག་ལས་དོན་རྟོགས་པར་བྱ་ཞེས་བསམ་པར་བྱ་བ་ལ་། རྟོགས་པར་བྱེད་པ་ལ་སླུ་བར་མི་བྱེད་པའི་ངོ་བོ་ལ་བྱ་སྟེ་།
 yasya darśanād ayaṃ pravibhāgena sādhanaṃ vyavasthāpya tasyeṣṭārthasaṃnidhānasaṃpratyayāt pravṛttimavalambate |	གང་ཞིག་མཐོང་ནས་འདིས་སྒྲུབ་པ་དང་། སྒྲུབ་པ་མ་ཡིན་པ་དག་རྣམ་པར་ཕྱེ་ནས་། དེ་ལ་འདོད་པའི་དོན་ཉེ་བར་འཇོག་པར་བྱེད་པ་ལ་ཡིད་ཆེས་ནས་འཇུག་པར་འགྱུར་བ་ཡིན་ནོ་༎ 
 tathā yadasyātmarūpaṃ tallakṣaṇaṃ na tu pararūpam |	དེ་ལ་འདིའི་བདག་གི་ངོ་བོ་གང་ཡིན་པ་དེ་ནི་མཚན་ཉིད་ཡིན་གྱི་གཞན་གྱི་ངོ་བོ་ནི་མ་ཡིན་ནོ་༎
 pratipattijanmani upayogamātrāt tallakṣaṇatve prameyapuruṣādīnāmapi tallakṣaṇatvaṃ bhavet |	རྟོགས་པ་སྐྱེ་བ་ལ་ཉེ་བར་སྦྱོར་བ་ཙམ་གྱིས་དེའི་མཚན་ཉིད་ཡིན་ན་ནི་། ཧ་ཅང་ཐལ་བར་འགྱུར་རོ་༎ དེ་ལྟ་ན་ནི་གཞལ་བྱ་དང་སྐྱེས་བུ་ལ་སོགས་པ་ཡང་དེའི་མཚན་ཉིད་དུ་འགྱུར་ཏེ་།
 na hi teṣvapi asatsu liṅgini jñānaṃ bhavati |	དེ་དག་མེད་པར་ནི་རྟགས་ཅན་ལ་ཤེས་པ་མི་སྐྱེའོ་༎
 (5|12) niścitagrahaṇaṃ tarhi na kartavyam |	འོ་ན་ནི་ངེས་པ་སྨོས་པར་མི་བྱའོ་ཞེ་ན་།
 na, tasyānyārthatvāt |	མི་བྱ་བ་མ་ཡིན་ཏེ་། དེ་ནི་གཞན་གྱི་དོན་དུ་ཡིན་པའི་ཕྱིར་རོ་༎
 sapakṣavipakṣayordarśanādarśanamātrato gamakaṃ hetumiccatāṃ naiva samartho heturbhavati satorapi darśanādarśanayoragamakatvadarśanāt | tena bhāvābhāvābhyāmeva gamako heturiti jñāpanārtha niścitagrahaṇam |	མཐོང་བ་དང་མ་མཐོང་བ་དག་གིས་གཏན་ཚིགས་ཤེས་པ་བྱེད་པ་ཡིན་པར་འདོད་པ་དག་གིས་གཏན་ཚིགས་ནུས་པར་མི་འགྱུར་བ་ཁོ་ན་སྟེ་། མཐོང་བ་དང་། མ་མཐོང་བ་དག་ཡོད་བཞིན་དུ་ཡང་ཤེས་པར་བྱེད་པ་ཉིད་མ་ཡིན་པ་མཐོང་བའི་ཕྱིར་རོ་༎ དེས་ན་ཡོད་པ་དང་མེད་པ་དག་གིས་ཤེས་པར་བྱེད་པ་ཡིན་ནོ་ཞེས་ཤེས་པར་བྱ་བའི་ཕྱིར་ངེས་པ་སྨོས་སོ་༎
 tena pararūpaṃ liṅgasya lakṣaṇaṃ na bhavati,	དེས་ན་གཞན་གྱི་ངོ་བོ་ནི་མཚན་ཉིད་མ་ཡིན་ཏེ་།
 tena liṅgasya rūpaviśeṣānamidhānāt |	དེས་རྟགས་ཀྱི་ངོ་བོའི་ཁྱད་པར་མི་སྟོན་པའི་ཕྱིར་རོ་༎
 tau hi bhāvābhāvau tadbhāvasādhakapramāṇavṛttyā boddhavyau,	ཡོད་པ་དང་མེད་པ་དེ་དག་ནི་དེའི་ངོ་བོ་སྒྲུབ་པ་འཇུག་པས་ཁོང་དུ་ཆུད་པར་བྱ་སྟེ་། 
 upāyāntarābhāvāt |	ཐབས་གཞན་མེད་པའི་ཕྱིར་རོ་༎
 (5|13) yadyapi bhāvābhāvavacanamātreṇa tatsādhanapramāṇavṛttiḥ ākṣipyate, anyathā tayoreva sattā prasiddheḥ,	དེས་ན་ཡོད་པ་དང་། མེད་པ་སྨོས་པ་ཙམ་གྱིས་ཀྱང་དེ་བསྒྲུབ་པའི་ཚད་མ་འཕེན་མོད་ཀྱི་། འདི་གཉིས་གསལ་བར་བྱ་བའི་ཕྱིར་། མཚན་ཉིད་ལ་ལས་ངེས་པ་ཞེས་བྱ་བའི་སྒྲ་རབ་ཏུ་སྦྱོར་བ་ཡིན་ནོ་༎
 jñānasattānibandhanatvājjñeyasattāvyavasthāyāḥ iti sarvatra jñeyasattāvyavasthaiva	དེ་ལྟ་མ་ཡིན་ན་ཤེས་བྱ་ཡོད་པར་རྣམ་པར་གཞག་པ་ནི་ཤེས་པ་ཡོད་པའི་རྒྱུ་རྐྱེན་ཡིན་པའི་ཕྱིར་། དེ་གཉིས་ཉིད་ཡོད་པར་རབ་ཏུ་མི་འགྲུབ་པས་ཐམས་ཅད་ལ་ཡོད་པ་རྣམ་པར་གཞག་པ་ཉིད་དེ་སྒྲུབ་པ་དང་ལྡན་པའི་ཚད་མ་འདྲེན་པ་ཡིན་ནོ༎
 tatsādhanaṃ pramāṇamākarṣatiḥ parārthatvācca śāstrapraṇayanasyaḥ trirūpaṃ liṅgaṃ	༄༢༥༤བ་བསྟན་བཅོས་བྱེད་པ་ནི་གཞན་གྱི་དོན་ཡིན་པའི་ཡང་ཕྱིར་ཏེ་། ཚུལ་གསུམ་པའི་རྟགས་ཡོད་པ་ནི་། དོན་འདོམས་པར་བྱེད་པ་ཡིན་ནོ་ཞེས་བྱ་བ་ལ་། གང་དག་ཚུལ་དེ་མི་ཤེས་པ་དེ་དག་ནི་།
 saṃvādakamiti tadrūpamapratipattṛṇāṃ tataḥ pravṛttirna bhavatīti paropalakṣaṇātvādeva	དེས་མི་འཇུག་པས་གཞན་ཤས་པར་བྱེད་པ་ཡིན་པའི་ཕྱིར་ཤེས་པ་གྲུབ་མོད་ཀྱི་།
 pravartake jñānaṃ siddhamḥ tathāpi tāveva viśiṣṭau bhāvābhāvau kecid darśanādarśanamātreṇa	འོན་ཀྱང་ཁ་ཅིག་ཡོད་པ་དང་། མེད་པ་དེ་དག་ཁོ་ན་མཐོང་བ་དང་། མ་མཐོང་བ་ཙམ་གྱིས་རྣམ་པར་འཇོག་པར་བྱེད་པས་།
 vyavasthāpayantīti teṣāṃ niṣedhārtho 'yaṃ niścitaśabdaḥ prayuktaḥ |	དེ་དགག་པའི་ཕྱིར་ངེས་པའི་སྒྲ་སྨོས་སོ་༎
 satorapi bhāvābhāvadarśanayoḥ anvayavyatirekayoḥ saṃśayāt |	ཡོད་པ་དང་མེད་པ་དག་ཡོད་ཀྱང་རྗེས་སུ་འགྲོ་བ་དང་། ལྡོག་པ་དག་ཡོད་པ་ལ་ཐེ་ཚོམ་ཟ་བའི་ཕྱིར་།
 tasmāt pratibandhasādhakapramāṇavṛttyaiva bhāvābhāvau sidhyata iti vipratipattinirāsārthamasmābhirniścitagrahaṇaṃ kṛtam |	ཡོད་པར་རབ་ཏུ་འགྲུབ་པ་ནི་ཚད་མ་གང་ལས་འདི་གཉིས་ངེས་པ་དེ་ལ་རག་ལུས་པ་ཡིན་ནོ་ཞེས་ཤེས་པར་བྱ་བའི་ཕྱིར་། ཁོ་བོས་སྨོས་པར་བྱས་པ་ཡིན་ནོ་༎
 yato 'pi trairūpyavacanamātreṇa tatsādhanapramāṇākṣepasiddhiḥ, na jñānaṃ pṛthagato rūpāntaraṃ bhavati,	གང་གི་ཕྱིར་ཡོད་པ་དང་མེད་པ་སྨོས་པ་ཙམ་གྱིས་དེ་སྒྲུབ་པའི་ཚད་མ་འཕེན་པར་འགྲུབ་པ་དེའི་ཕྱིར་ཡང་ཤེས་པ་ནི་མཚན་ཉིད་ཐ་དད་པར་གྱུར་པ་མ་ཡིན་ཏེ་།
 tenaivāvagatatvād,	དེ་ཉིད་ཀྱི་དོན་རྟོགས་པའི་ཕྱིར་།
 upalayārthavat pakṣadharmatvāt |	ཕྱོགས་ཀྱི་ཆོས་ཉིད་ལས་ཉེ་བར་གཏོད་པའི་དོན་བཞིན་ནོ་༎
 (5|14) anvayavyatirekayorapi tarhi na pṛthakatvam,	འོ་ན་ནི་རྗེས་སུ་འགྲོ་བ་དང་ལྡོག་པ་དག་ཀྱང་སོ་སོ་ཉིད་མ་ཡིན་ཏེ་།
 ekasya prayogādubhayagateriti cet | na |	གཅིག་སྦྱར་བས་གཉི་ག་རྟོགས་པའི་ཕྱིར་རོ་ཞེ་ན་མ་ཡིན་ཏེ་།
 hetoḥ sapakṣāsapakṣayorbhāvābhāvau na parasparamākṣipataḥ |	མཐུན་པའི་ཕྱོགས་དང་མི་མཐུན་པའི་ཕྱོགས་དག་ལ་གཏན་ཚིགས་ཡོད་པ་དང་། མེད་པ་དག་ནི་ཕན་ཚུན་ལྟོས་ནས་ཚིག་གཅིག་གིས་གཉི་ག་གོ་བར་བྱེད་དོ་ཞེས་བྱའི་།
 ekaṃ vākyamubhayaṃ gamayatītyucyate naiko 'rthaḥ svabhāvo dvitīyasyeti | nanu tatraiva bhāva ityatra tadarthatayā tadabhāve 'bhāvo gamyate,	གཉིས་པ་དང་དོན་གཅིག་པ་ནི་མ་ཡིན་ནོ་༎
 atadbhāve 'vaśyamabhāva ityatra ca tadbhāve bhāva iti parasparākṣepa iti cet |	དེ་ཁོ་ན་ལ་ཡོད་པ་དང་མེད་པ་ལ་མེད་པ་ཞེས་བྱ་བའི་ཚིག་ཕན་ཚུན་འཕེན་པ་མ་ཡིན་ནམ་ཞེ་ན་།
 vacanametat sāmarthyādubhayamākṣipati ekasyāpi niyamakhyāpakasya dvitīyākṣepanāntarīyakatvāt | na ca tāvatobhayorekasvabhāvatā | pṛthagabhidhānaṃ tu prayoganiyamārtham |	ངེས་པ་སྟོན་པ་གཅིག་ཀྱང་འཕེན་པ་གཉིས་པ་མེད་ན་མེད་པའི་ཕྱིར་ཚིག་འདིས་ནི་ཤུགས་ཀྱིས་གཉི་ག་འཕེན་པར་བྱེད་ཀྱི་།
 na punaḥ kevalau bhāvābhāvau parasparamākṣipataḥ |	ཡོད་པ་དང་མེད་པ་འབའ་ཞིག་འཕེན་པར་བྱེད་པ་ནི་མ་ཡིན་ནོ་༎
 niyamavantau ca na kevalau niyamasyobhayarūpatvāt |	ངེས་པ་དང་ལྡན་པ་དག་ནི་འབའ་ཞིག་པ་དག་མ་ཡིན་ཏེ་། ངེས་པ་ནི་གཉི་གའི་ངོ་བོ་ཡིན་པའི་ཕྱིར་རོ་༎
 (5|15) tasmāt tatraiva bhāva iti na bhāva evocyate itareṇāpi nā bhāva eva yena bhāvo 'bhāvo vā dvitīyamākṣipet |	དེ་ལྟ་བས་ན་གང་གིས་ན་ཡོད་པའམ་། མེད་པ་གཉིས་པ་འཕེན་པར་འགྱུར་བ་དེ་ལ་ཡོད་པ་ཉིད་ཅེས་བྱ་བ་ཡང་ཡོད་པ་འབའ་ཞིག་ལ་མི་བྱ་ལ་། ཅིག་ཤོས་ཀྱིས་ཀྱང་མེད་པ་འབའ་ཞིག་མ་ཡིན་ནོ་༎
 naivaṃ jñānaṃ, paropalakṣaṇaśāstrāgṛhītajñānāt trailakṣaṇyādavyatirekāditi na lakṣaṇāntaram |	ཤེས་པ་ནི་དེ་ལྟར་གཞན་ཤེས་པར་བྱེད་པའི་མཚན་ཉིད་གསུམ་པ་ལས་ཐ་དད་པ་མ་ཡིན་པས་། མཚན་ཉིད་གཞན་མ་ཡིན་ནོ་༎ དེ་ལྟ་བས་ན་གཏན་ཚིགས་༄༢༥༥ཨ་༌་༎
 tasmātra hetuḥ ṣaḍlakṣaṇaḥ |	ནི་མཚན་ཉིད་དྲུག་པ་མ་ཡིན་ནོ་༎
