skt	tib
 dharmakīrtipraṇītā santānāntarasiddhiḥ	༄༣༥༥བ་༅་༎ རྒྱ་གར་སྐད་དུ་། སནཏ་ནའ་ནྱ་ཏ་ར་སིདདྷི་ནའ་མ་པྲ་ཀ་ར་ན་། བོད་སྐད་དུ་། རྒྱུད་གཞན་གྲུབ་པ་ཞེས་བྱ་བའི་རབ་ཏུ་བྱེད་པ་། འཇམ་དཔལ་གཞོན་ནུར་གྱུར་པ་ལ་ཕྱག་འཚལ་ལོ་༎ རང་ལུས་བློ་སྔོན་འགྲོ་པ་ཡི་༎
 buddhipūrvāṃ kriyāṃ dṛṣṭvā svadehe 'nyatra tadgrahāt |	བྱ་བ་མཐོང་ནས་གཞན་ལ་དེ་༎
 jñāyate yadi dhīścittamātre 'pyeṣa nayaḥ samaḥ ||	འཛིན་ཕྱིར་གལ་ཏེ་བློ་ཤེས་འགྱུར་༎ སེམས་ཙམ་ལ་ཡང་ཚུལ་འདི་མཚུངས་༎
 ātmani cittaspandanapūrvau kriyābhilāpau dṛṣṭvānyatra tayordarśanādyadi spandanamanumīyeta,	གལ་ཏེ་བདག་ཉིད་ལ་བྱ་བ་དང་། བརྗོད་པ་སེམས་ཀྱི་ག-ཡོ་བ་སྔོན་དུ་འགྲོ་བ་ཅན་དག་མཐོང་ནས་། གཞན་ལ་དེ་དག་མཐོང་བས་ག-ཡོ་པ་རྗེས་སུ་དཔོག་པར་བྱེད་ན་།
 cittamātre 'pyaṣa nayaḥ samaḥ |	ཚུལ་འདི་ནི་སེམས་ཙམ་ལ་ཡང་མཚུངས་པས་།
 ataḥ cittamātratāvādī api paracittamanumātuṃ śaknoti |	སེམས་ཙམ་དུ་སྨྲ་བས་ཀྱང་གཞན་གྱི་སེམས་རྗེས་སུ་དཔག་པར་བྱ་ནུས་ཏེ་།
 tacca kāyavāgvijñaptipratibhāsi jñānaṃ jñānāntaraspandanaveśeṣeṇa vinā bhavatyevaṃ na matam | [1-3]	དེ་ཡང་ཤེས་པ་གཞན་གྱིས་ག-ཡོ་བའི་ཁྱད་པར་མེད་པར་ལུས་ངག་གི་རྣམ་པར་རིག་བྱེད་དུ་སྣང་པའི་ཤེས་པ་དེ་ལྟ་༄༣༥༦ཨ་༌་༎ བུ་དག་ཡོད་པར་མི་འདོད་དོ་༎
 atha parajñānasya kriyānupalambhāt paradhīranumātuṃ na yujyata iti cet?	གལ་ཏེ་གཞན་གྱི་ཤེས་པའི་བྱེད་པ་མ་དམིགས་པའི་ཕྱིར་གཞན་གྱི་རྗེས་སུ་དཔག་པར་མི་རུང་ངོ་ཞེ་ན་། འདྲ་བའི་ཕྱིར་མ་ཡིན་ཏེ་།
 na; tulyatvāt paro 'pi parajñānapūrvau tau kadāpi na paśyati 'taḥ tenāpi tanna jñāyate | [4-5]	ཕ་རོལ་པོས་ཀྱང་གཞན་གྱི་ཤེས་པ་སྔོན་དུ་འགྲོ་བ་ཅན་དེ་དག་ནམ་ཡང་མ་མཐོང་པས་དེས་ཀྱང་དེ་ཤེས་པར་མི་འགྱུར་རོ་༎
 ātmanaścittasya paravartinornimittatvānupapatteḥ paracittaṃ jñāyata iti cet |	གལ་ཏེ་བདག་ཉིད་ཀྱི་སེམས་གཞན་ལ་ཡོད་པ་དག་གི་རྒྱུ་མཚན་ཉིད་དུ་མི་རུང་བའི་ཕྱིར་རོ་༎ གཞན་གྱི་སེམས་ཤེས་པར་འགྱུར་རོ་ཞེ་ན་།
 kiṃ na yujyate?	ཇི་ལྟར་མི་རུང་།
 svasamutthāpakacittasya pratisaṃvedanābhāvāt, ātmacittaśrayiṇoścātmani darśanāt |	རང་གི་ཀུན་ནས་སློང་བའི་སེམས་སོ་སོར་ཡང་དག་པར་མྱོང་བ་མེད་པའི་ཕྱིར་དང་། བདག་ཉིད་ཀྱི་སེམས་ཀྱི་རྟེན་ཅན་ཡང་བདག་ཉིད་ལ་མཐོང་བའི་ཕྱིར་ཏེ་།
 tāvapi yadi yathā syātāṃ tādṛśāvupalabhyeyātām |	དེ་དག་ཀྱང་དེ་ལྟ་བུ་ཡིན་ན་ནི་དེ་དང་འདྲ་བར་དམིགས་པར་འགྱུར་བ་ཞིག་ན་།
 anyathā darśanādanyanimittaṃ sidhyatīti cet? aparasminnapi samānameva,	དེ་ལྟ་མ་ཡིན་པར་མཐོང་བས་། རྒྱུ་མཚན་གཞན་གྲུབ་པ་ཡིན་ནོ་ཞེ་ན་།
 svasamutthāpakacittasya saṃvedanābhāvāt |	གཞན་ལ་ཡང་རང་གི་ཀུན་ནས་སློང་བར་བྱེད་པའི་སེམས་ཡང་དག་པར་མྱོང་བ་མེད་པས་འདྲ་ལ་། 
 svacittaspandananimittake vijñaptipratibhāsinī jñāne cāntarmukhapratibhāsinī pratīteḥ bahirmukhapratibhāsinī anyanimittadutpadyete | [6-12]	རྣམ་པར་རིག་བྱེད་དུ་སྣང་བའི་ཤེས་པ་རང་གི་སེམས་ཀྱི་ག-ཡོ་བའི་རྒྱུ་མཚན་ཅན་དག་ཀྱང་ཁ་ནང་དུ་བལྟས་པའི་སྣང་བས་ཡིན་པར་རྟོགས་པའི་ཕྱིར་ཁ་ཕྱིར་པ་ལྟས་པའི་སྣང་བ་དག་རྒྱུ་མཚན་གཞན་ལས་སྐྱེ་བར་འགྱུར་རོ་ལ་། 
 animitte eva bahirmukhapratibhāsinīti kinneṣyate cet?	༎ ཁ་ཕྱིར་བལྟས་པའི་སྣང་བ་དག་རྒྱུ་མཚན་མེད་པ་ཁོ་ནར་ཅི་སྟེ་མི་འདོད་ལ་། 
 animittatve sarvasyānimittatvaṃ prasajyeta |	༎ ཅེ་ན་། རྒྱུ་མཚན་མེད་པ་ཉིད་ཡིན་ན་ཐམས་ཅད་རྒྱུ་མཚན་ཉིད་དུ་ཐལ་ལ་། 
 vicchinnāvicchinnapratibhāsakṛto bhedo na jñānayoḥ spandanatvanimittabhedavibhāgakṛt |	༎ ཅེ་ན་། བར་འགྱུར་རོ་༎ རྣམ་པར་ཆད་པ་དང་རྣམ་པར་མ་ཆད་པར་སྣང་བས་བྱས་པའི་ཁྱད་པར་ནི་ཤེས་པ་དག་པའི་རྒྱུ་མཚན་ག-ཡོ་བ་ཉིད་ཐ་དད་པར་རྣམ་པར་འབྱེད་པ་མ་ཡིན་ནོ་༎
 tenāvicchinnapratibhāsinorapyanimittatvaṃ bhavet,	དེས་ན་རྣམ་པར་མ་ཆད་པར་སྣང་བ་དག་ཀྱང་རྒྱུ་མཚན་མེད་པ་ཉིད་དུ་འགྱུར་ཏེ་།
 viśeṣābhāvāt |	ཁྱད་པར་མེད་པའི་ཕྱིར་རོ་༎
 tathā sati, avicchinnatvaviśiṣṭaḥ pratibhāsabheda eva spandanapūrvako na bhavati |	དེ་ལྟ་བས་ན་སྣང་བའི་ཁྱད་པར་རྣམ་པར་མ་ཆད་པའི་ཁྱད་པར་ཅན་ནི་ག-ཡོ་བ་སྔོན་དུ་འགྲོ་བ་ཅན་མ་ཡིན་ནོ་༎ འོ་ན་ཅི་ཞེ་ན་།
 kintarhi? vicchinnasyāpi kriyāviśeṣasya pratibhāsa eva |	རྣམ་པར་ཆད་པ་ལ་། ཡང་བྱ་བའི་ཁྱད་པར་དུ་སྣང་བ་ཁོ་ན་ཡིན་ནོ་༎
 śaropalaprakṣepaṇayantranirmāṇaparapracālanādikriyāviśeṣapratibhāsināṃ vicchinnasyāpi pratibhāsasya spandanapūrvakatvāt |	མདའ་དང་རྡོ་འཕངས་པ་དང་། སྒྱོགས་དང་སྤྲུལ་པ་དང་། གཞན་གྱིས་རབ་ཏུ་བསྐྱོད་པ་ལ་སོགས་༄༣༥༦བ་པའི་བྱ་བའི་ཁྱད་པར་དུ་སྣང་བ་ཅན་རྣམས་། ཡུལ་ཆད་པར་སྣང་ཡང་ག-ཡོ་བ་སྔོན་དུ་འགྲོ་བ་ཅན་ཡིན་པའི་ཕྱིར་ལ་།
 parakṛtacālanādināṃ cāvicchinnasyāpyatadpūrvakatvāt | [13-19]	གཞན་གྱིས་བྱས་པའི་ག-ཡོ་བ་ལ་སོགས་པ་རྣམ་པར་མ་ཆད་པ་ཡིན་ཡང་དེ་སྔོན་དུ་འགྲོ་བ་ཅན་མ་ཡིན་པའི་ཕྱིར་རོ་༎
 tena hyatra kriyāviśeṣamātreṇa spandanasya pratītiritī yujyate |	དེ་ལྟ་བས་ན་འདིར་བྱ་བའི་ཁྱད་པར་ཙམ་གྱིས་ག-ཡོ་པ་རྟོགས་པ་ཡིན་པར་རིགས་སོ་༎
 tatra yadi kasyacidpūrvakatvam,	དེ་ལ་འགའ་ཞིག་སྔོན་དུ་འགྲོ་བ་ཅན་མ་ཡིན་བ་ཉིད་ཡིན་ན་།
 na ko 'pi tatpūrvakaḥ syāt,	འགའ་ཡང་དེ་སྔོན་དུ་འགྲོ་བ་ཅན་དུ་མི་འགྱུར་ཏེ་།
 viśeṣābhāvāt |	ཁྱད་པར་མེད་པའི་ཕྱིར་རོ་༎
 ataḥ kriyāviśeṣasāmānyaṃ spandanaviśeṣasāmānyasya gamakam | tatra yathā kriyāmupalabhya, ātmani spandanānupalambhādanyatra spandanapratītiḥ;	དེ་ལྟ་བས་ན་བྱ་བའི་ཁྱད་པར་གྱི་སྤྱི་ནི་ག-ཡོ་བའི་སྤྱི་རྟོགས་པར་བྱེད་པ་ཡིན་ནོ་༎ དེ་ལ་ཇི་ལྟར་བྱ་བ་དམིགས་ལ་བ་དག་ཉིད་ལ་ག-ཡོ་བ་མི་དམིགས་པའི་ཕྱིར་། གཞན་ལ་ག-ཡོ་བ་རྟོགས་པ་ལྟར་།
 tathā kriyāpratibhāsopalambhane 'pi |	བྱ་བར་སྣང་བ་དམིགས་པ་ལ་ཡང་དེ་དང་འདྲའོ་༎
 samānametat; paro 'pi parakriyābhilāpayornimittaṃ nāstīti kinnecchati?	ཕ་རོལ་པོ་ཡང་གཞན་གྱི་བརྗོད་པ་དང་བྱ་བ་དག་རྒྱུ་མཚན་མེད་པར་ཅི་སྟེ་མི་འདོད་དེ་འདི་ནི་མཚུངས་སོ་༎
 tenāvaśyaṃ tau spandananimittakatvāt tadbhāve na bhavata iti vaktavyam | paro 'pi tayoḥ pratibhāsau tathaiva vadet | ataḥ nānayoḥ parasparaṃ bhedaḥ | [20-26]	དེས་ན་གདོན་མི་ཟ་བར་དེ་གཉིས་ནི་ག-ཡོ་བའི་རྒྱུ་མཚན་ཅན་ཡིན་པའི་ཕྱིར་དེ་མེད་ན་མི་འབྱུང་ངོ་ཞེས་བྱ་བ་འདི་བརྗོད་དགོས་སོ་༎ ཕ་རོལ་པོ་ཡང་དེར་སྣང་བ་དག་ལ་དེ་དང་འདྲ་པར་སྨྲ་བར་འགྱུར་བས་འདི་དག་ནི་ཕན་ཚུན་ཁྱད་པར་མེད་དོ་༎
 yadi tatra pratibhāsinyoḥ spandananimittakatvamucyate,	གལ་ཏེ་དེར་སྣང་བ་དག་ག-ཡོ་བའི་རྒྱུ་མཚན་ཅན་ཉིད་ཡིན་པར་སྨྲ་བ་ན་།
 svapnāvasthāyāmapi kinnocyate?	རྨི་ལམ་གྱི་ལ་ཡང་ཅིའི་ཕྱིར་མི་སྨྲ་ཞེ་ན་།
 sarva samānam |	ཐམས་ཅད་མཚུངས་ཏེ་།
 paro 'pi svapnopalabdhaparakriyābhilāpau spandananimittakāviti kinna vadati?	ཕ་རོལ་པོ་ཡང་རྨི་ལམ་ན་གཞན་གྱི་བྱ་བ་དང་ཚིག་དམིགས་པ་དག་ག-ཡོ་བའི་རྒྱུ་མཚན་ཅན་ཡིན་པར་ཅི་སྟེ་མི་སྨྲ་།
 tayorabhāvāditi cet |	གལ་ཏེ་དེ་དག་མེད་པའི་ཕྱིར་རོ་ཞེ་ན་།
 tathopalabdhisāpyāt kinna staḥ?	དེ་བཞིན་དུ་དམིགས་པ་མཚུངས་ན་ཅི་སྟེ་མེད་།
 atha middhenopahatatvāt puruṣasya arthaśūnyaṃ vijñānaṃ jāyata iti cet |	གལ་ཏེ་མི་གཉིད་ཀྱིས་ཟིལ་གྱིས་ནོན་པའི་ཕྱིར་། དོན་གྱིས་སྟོང་པའི་རྣམ་པར་ཤེས་པ་འབྱུང་ངོ་ཞེ་ན་།
 paramate 'pi tasmādeva parādhipatyaśūnyaṃ vijñānamupajāyate | [27-32]	ཕ་རོལ་པོའི་ལྟར་ན་ཡང་། དེ་ཁོ་ནའི་ཕྱིར་གཞན་གྱི་དབང་གིས་སྟོང་པའི་རྣམ་པར་ཤེས་པ་འབྱུང་བར་འགྱུར་རོ་༎
 atha svapne 'pi jñānasyārthavattvāttadopalabhyamānā api parasantānā eveti cet |	གལ་ཏེ་རྨི་ལམ་ན་ཡང་ཤེས་པ་དོན་དང་ལྡན་པ་ཡིན་ལ་། དེའི་ཚེ་དམིགས་པ་རྣམས་ཀྱང་རྒྱུད་གཞན་ཉིད་ཡིན་ནོ་ཞེ་ན་། གལ་ཏེ་ཕ་རོལ་པོ་ལ་བསྔོ་བའི་ཕྱིར་། ལུང་དང་རིགས་པ་དང་བྲལ་༄༣༥༧ཨ་༌་༎
 paraṃ prativigrahītuṃ yadi yuktyāgamarahitastathāvidho 'sad vādaḥ samāśriyeta,	བའི་ཕྱིར་རྒོལ་བ་དམ་པ་མ་ཡིན་པ་དེ་ལྟ་བུ་ལ་རྟེན་པར་བྱེད་ན་ནི་།
 tadā parābhimataṃ tasya parāyattatvaṃ na ko 'pi nivārayet | etatkeṣañcinmata eva sarvāṇi tathāvidhāni jñānāni santānāntarāyattāni |	ཕ་རོལ་པོ་ཡང་དེ་གཞན་གྱི་དབང་ཅན་དུ་འདོད་པ་ལ་སུ་ཡང་ཟློག་པར་མི་བྱེད་དོ་༎ འདི་འབའ་ཞིག་གི་ལྟར་ན་དེ་ལྟ་བུའི་ཤེས་པ་ཐམས་ཅད་རྒྱུད་གཞན་དབང་ཅན་ཡོད་བ་ཁོ་ན་ཡིན་ཏེ་།
 viṣeṣastu sākṣātparamparayā ca |	ཁྱད་པར་ནི་མངོན་སུམ་དང་བརྒྱུད་པ་འདི་ཡོད་དོ་༎
 kadācit svapne 'pi tasya sākṣāt santānāntarayattā iṣṭaiva;	རེས་འགའ་ནི་རྨི་ལམ་ན་ཡང་ཡོད་པ་མངོན་སུམ་དེ་རྒྱུད་གཞན་གྱི་དབང་ཅན་དུ་འདོད་པ་ཁོ་ན་སྟེ་། 
 devādyadhiṣṭhānataḥ satyasvapnadarśanāt |	ལྷ་ལ་སོགས་པའི་བྱིན་གྱི་རླབས་ཀྱིས་རྨི་ལམ་མཐོང་བའི་ཕྱིར་རོ་༎
 tasmādasya naitadasadvādasamāśrayaḥ | [33-38]	དེ་བས་ན་འདིའི་འདི་ནི་རྒོལ་བ་དམ་པ་མ་ཡིན་པ་ལ་བརྟེན་པ་མ་ཡིན་ནོ་༎
 tāvattayā kriyayāpi taccittaṃ kathaṃ jñāyate?	རེ་ཞིག་བྱ་བ་དེ་ཉིད་ཀྱིས་ཀྱང་སེམས་དེ་ཅི་སྟེ་རྟོགས་པར་བྱེད་།
 cittasya kāryatvāt |	སེམས་ཀྱི་འབྲས་བུ་ཡིན་པའི་ཕྱིར་རོ་༎
 tasya kāryatvaṃ tu cittāntare 'pi tulyamiti kathanna jñāyate?	དེའི་འབྲས་བུ་ཡིན་པ་ནི་སེམས་གཞན་ལ་ཡང་འདྲ་བས་ཅི་སྟེ་རྟོགས་པར་མི་བྱེད་།
 api ca, yadi tatkriyā svasattāmātreṇa svasantānaṃ pratyāyet, tadānupalabhyamānenāpi syāttathā pratipattiḥ |	གཞན་ཡང་གལ་ཏེ་བྱ་བ་དེ་རང་ཡོད་པ་ཙམ་གྱིས་རང་གི་རྒྱུད་རྟོགས་པར་བྱེད་ན་ནི་། མི་དམིགས་པས་ཀྱང་དེ་ལྟ་བུ་རྟོགས་པར་འགྱུར་རོ་༎
 na; jñānāpekṣatvālliṅgasya iti cet |	གལ་ཏེ་རྟགས་ནི་ཤེས་པ་ལ་ལྟོས་པའི་ཕྱིར་མི་འགྱུར་རོ་ཞེ་ན་།
 tada tatra kimanayā paramparayā - paracittāt kriyā,	དེ་ལ་དེའི་ཚེ་གཞན་གྱི་སེམས་ལས་ནི་བྱ་བའོ་༎
 kriyātaḥ jñānam,	བྱ་བ་ལས་ནི་ཤེས་པའོ་༎
 jñānāt tasya pratipattiriti | [39-44]	ཤེས་པ་ལས་ནི་དེ་རྟོགས་པའོ་ཞེས་བྱ་བ་བརྒྱུད་པ་འདིས་ཅི་ཞིག་བྱ་།
 paracittaprabhavadharmi kriyāpratibhāsijñānamevāsya gamakaṃ bhavati |	བྱ་བར་སྣང་བ་གཞན་གྱི་སེམས་ལས་རབ་ཏུ་སྐྱེ་བའི་ཆོས་ཅན་གྱི་ཤེས་པ་ཁོ་ན་འདི་རྟོགས་པར་བྱེད་པ་ཡིན་པར་འགྱུར་ཏེ་།
 tasyādhigatistu antaśaḥ tadāśritatvāt |	དེ་རྟོགས་པ་ནི་ཐ་མར་ཡང་དེ་ལ་བརྟེན་པའི་ཕྱིར་རོ་༎
 spandanamātrasāmānyaṃ kriyābhilāpajñānasāmānyasya kāraṇatvāt kāryeṇa kāraṇasya gatiḥ |	ག-ཡོ་བ་ཙམ་གྱིས་སྤྱི་ནི་བྱ་བ་དང་བརྗོད་པའི་ཤེས་པ་སྤྱིའི་རྒྱུ་ཡིན་པས་འབྲས་བུའི་རྒྱུ་རྟོགས་པ་ཡིན་ནོ་༎
 tatra ātmaspandananimittakasyāntarmukhavṛttiḥ,	དེ་ལ་བདག་ཉིད་ཀྱི་ག-ཡོ་བའི་རྒྱུ་མཚན་ཅན་ནི་ཁ་ནང་དུ་བལྟས་པར་འཇུག་ལ་།
 anyasyānyathā |	གཞན་ནི་གཞན་དུ་ཡིན་ཏེ་།
 prāyeṇādhikṛtyāsau bhedaḥ |	ཁྱད་པར་འདི་ནི་ཕལ་ཆེ་བའི་དབང་དུ་བྱས་པ་ཡིན་ནོ་༎
 etayoḥ saḥ kāryakāraṇabhāvaḥ svāpādyavasthāyāmitarasyāmapi ca samānaḥ |	འདི་དག་གི་རྒྱུ་དང་འབྲས་བུའི་ངོ་བོ་དེ་ནི་གཉིད་ལོག་པ་ལ་སོགས་པའི་གནས་སྐབས་དང་གཞན་ན་ཡང་མཚུངས་སོ་༎
 bhrāntyavasthāyāṃ yathāsvaṃ pratyayaviśeṣopāśrayāt paraspandanadinimittodbhūtavijñānavāsanaiva kadācitparābhogādeḥ vyavahitādapi vṛttiṃ labhate:	འཁྲུལ་པའི་གནས་སྐབས་ན་ནི་བདག་ཉིད་ཇི་ལྟ་བ་བཞིན་གྱི་རྐྱེན་གྱི་ཁྱད་པར་ལ་ཉེ་བར་བརྟེན་པའི་ཕྱིར་གཞན་གྱི་༄༣༥༧བ་ག-ཡོ་བ་ལ་སོགས་པའི་རྒྱུ་མཚན་གྱིས་འབྱུང་བའི་རྣམ་པར་ཤེས་པའི་བག་ཆགས་དེ་དག་ཁོ་ན་རེས་འགའ་གཞན་གྱིས་ཉེ་བར་སྦྱར་བ་ལ་སོགས་པས་བར་དུ་ཆོད་ཀྱང་འཇུག་པ་རྙེད་པར་འགྱུར་གྱི་།
 na tvatyantāsadābhogāt |	ཉེ་བར་སྦྱོར་བ་གཏན་མེད་པ་ནི་མ་ཡིན་ནོ་༎
 tasmāt sarvāvasthāsu kriyādivijñapteḥ cittaspandanamanumīyata eva | [45-51] kriyātaḥ spandanapratipattau svāpa itarasmiñca syātpratipattiratha vā naiva kadācana |	དེའི་ཕྱིར་ན་གནས་སྐབས་ཐམས་ཅད་དུ་བྱ་བ་ལ་སོགས་པའི་རྣམ་པར་རིག་བྱེད་ཀྱིས་སེམས་ཀྱི་ག-ཡོ་བ་རྗེས་སུ་དཔག་པར་བྱ་བ་ཁོ་ན་ཡིན་ནོ་༎ བྱ་བས་ག-ཡོ་བ་རྟོགས་ན་ནི་། གཉིད་ལོག་པ་དང་། གཞན་ན་རྟོགས་པར་འགྱུར་རོ་༎ ཡང་ན་ནི་ནམ་ཡང་མི་འགྱུར་ཏེ་།
 paraspandanabhāve 'pi kriyālambanodayāt |	གཞན་གྱི་ག-ཡོ་བ་མེད་པར་ཡང་བྱ་བ་དམིགས་པ་འབྱུང་བའི་ཕྱིར་རོ་༎
 bhavatvālambanodayaḥ, na tu kriyā |	དམིགས་པ་འབྱུང་བར་འགྱུར་གྱི་བྱ་བ་ནི་མ་ཡིན་ནོ་༎
 kriyayā spandanaṃ gamyate | bhrāntyavasthānāṃ kriyaiva na bhavati, arthaśūnyajñānodayānna doṣaḥ |	བྱ་བས་ནི་ག-ཡོ་བ་རྟོགས་པར་བྱེད་ན་འཁྲུལ་བའི་གནས་སྐབས་ན་ནི་བྱ་བ་ཡང་མེད་དོ་༎ དོན་གྱིས་སྟོང་པའི་ཤེས་པ་འབྱུང་བའི་ཕྱིར་ཉེས་པ་མེད་དོ་༎
 sarvaprakāravyapadeśasāmyāt kadācijjñānamarthaśūnyam,	རྣམ་པ་ཐམས་ཅད་དུ་ཐ་སྙད་གདགས་པ་མཚུངས་པ་ལས་རེས་འགའ་ནི་ཤེས་པ་དོན་གྱིས་སྟོང་ངོ་༎ 
 anyadānyathā ityeṣo 'dhikāraḥ kuto labdhaḥ?	གཞན་ནི་གཞན་དུ་ཡིན་ནོ་ཞེས་བྱ་བའི་དབང་འདི་ག་ལས་ཐོབ་།
 atha middhādināvasthānyathābhāvaścet |	གལ་ཏེ་གཉིད་ལ་སོགས་པས་གནས་སྐབས་འགྱུར་བ་ཡིན་ནོ་ཞེ་ན་།
 yadyevaṃ sambhavet, bhavatu avidyopaplutatvāttathodayaḥ |	གལ་ཏེ་འདི་ལྟ་བུ་སྲིད་པ་ཡོང་ན་མ་རིག་པས་དཀྲུགས་པའི་ཕྱིར་དེ་ལྟར་འབྱུང་དུ་ཟད་མོད་། 
 tathā sati arthāntaravādahānyā ete 'nekāśakyanigūhanadoṣaprasaṅgāḥ mahākṛcchrā uttereṇaikena nihatā bhavanti | [52-58]	དེ་ལྟ་ན་ནི་དོན་གཞན་དུ་སྨྲ་བ་ཉམས་པར་འགྱུར་བས་གླགས་དུ་མ་སྦ་བར་མི་ནུས་པ་ཅན་ཚེགས་ཆེན་པོ་ཅན་འདི་ལན་གདབ་བ་གཅིག་གིས་ངེས་པར་ཆོམས་པར་འགྱུར་རོ་མོད་། 
 nanu tayoḥ darśanāt kāyavāgvijñaptibhyāṃ svamutthāpakacittasyānumānamiti nyāyyam |	༎ ཅི་ག་དེ་དག་མཐོང་བས་ལུས་དང་ངག་གི་རྣམ་པར་རིག་བྱེད་དག་ལས་རབ་ཀུན་ནས་སློང་བར་བྱེད་པའི་རྗེས་སུ་དཔག་པར་རིགས་པ་མ་ཡིན་ནམ་།
 na tu santānāntarasambaddhavijñaptipratibhāsijñāne paravijñaptī bhavitumarhataḥ, tayoranupādānopādeyatvāditi cet |	རྒྱུད་གཞན་དང་འབྲེལ་བའི་རྣམ་པར་རིག་བྱེད་དུ་སྣང་བའི་ཤེས་པ་དག་ནི་གཞན་གྱི་རྣམ་བར་རིག་བྱེད་དག་ཡིན་བར་འོས་པ་མ་ཡིན་ཏེ་། དེ་དག་ནི་ཉེ་བར་ལེན་པ་དང་ཉེ་བར་ལེན་པ་ལས་བྱུང་བ་མ་ཡིན་པའི་ཕྱིར་། རོ་ཞེ་ན་། 
 nocyate paracittasamutthitavijñaptirūpatvāttatra pratibhāsijñānena samutthāpakacittaṃ gamyata iti |	གཞན་གྱི་སེམས་ཀྱིས་ཀུན་ནས་བསླང་བའི་རྣམ་པར་རིག་བྱེད་ཀྱི་ངོ་བོ་ཅན་ཉིད་ཡིན་པའི་ཕྱིར་། དེར་སྣང་བའི་ཤེས་པས་ཀུན་ནས་༄༣༥༨ཨ་༌་༎ སློང་བར་བྱེད་པའི་སེམས་རྟོགས་པར་བྱེད་དོ་ཞས་ནི་མི་ཟེར་རོ་༎
 kiṃ tarhi? tasya kāryatvāt |	འོ་ན་ཅི་ཞེ་ན་། དེའི་འབྲས་བུ་ཡིན་པའི་ཕྱིར་རོ་༎
 vijñaptiriti samutthāpakacittasantānājjāte kriyāvāgākārake jñāne eva | samutthāpakacittaṃ ca tayorevopādānakāraṇam,	རྣམ་པར་རིག་བྱེད་དག་ནི་བྱ་བ་དང་ཚིག་གི་རྣམ་པ་ཅན་གྱི་ཤེས་པ་། ཀུན་ནས་སློང་བར་བྱེད་པའི་སེམས་ཀྱི་རྒྱུད་ལས་སྐྱེས་པ་དག་ཁོ་ན་ཡིན་ནོ་༏་༏་ཀུན་ནས་སློང་བར་བྱེད་པའི་སེམས་ཀྱང་དེ་དག་གི་ནི་ཉེ་བར་ལེན་པའི་རྒྱུ་ཁོ་ན་ཡིན་ལ་། 
 santānāntarajñānayoḥ tvadhipatipratyayaḥ |	རྒྱུད་གཞན་གྱི་ཤེས་པ་དག་ནི་བདག་པོའི་རྐྱེན་ཡིན་ནོ་༎
 vijñapterupādānātte janite | tatsambandhenopacārād vijñaptī bhavataḥ |	རྣམ་པར་རིག་བྱེད་ཀྱི་ཉེ་བར་ལེན་པས་བསྐྱེད་པ་དེ་དག་ལ་འབྲེལ་བ་དེས་ཀྱང་ཉེ་བར་གདགས་པས་རྣམ་པར་རིག་བྱེད་དག་ཡིན་པར་འགྱུར་རོ་༎ 
 bhavatu svaparayoḥ svasvapratibhāsasyānubhavaḥ,	བདག་དང་གཞན་ལ་རང་རང་གི་སྣང་བ་ཉམས་སུ་མྱོང་མོད་ཀྱི་།
 taimirikadvayadṛṣṭadvicandravat; tathāvidhavijñānasya hetuḥ vāsanotpādasvabhāvabiśeṣo 'nādikālikaikārthagrāhādhyavasāyitvāt |	རབ་རིབ་ཅན་ཉིད་ཀྱིས་ཟླ་བ་གཉིས་མཐོང་བ་བཞིན་དུ་རྣམ་པར་ཤེས་པ་དེ་ལྟ་བུའི་རྒྱུའི་བག་ཆགས་སྐྱེ་བའི་རང་བཞིན་གྱི་ཁྱད་པར་ཐོག་མ་མེད་པའི་དུས་ལས་དོན་གཅིག་འཛིན་པར་ངེས་པའི་ཕྱིར་རོ་༎ 
 ekahetusambhūtayoḥ svaparavoijñaptijñānayoḥ vijñaptivenopacāraḥ | [59-64]	རྒྱུ་གཅིག་ལས་སྐྱེས་པས་རང་དང་གཞན་གྱི་རྣམ་པར་རིག་བྱེད་ཀྱི་ཤེས་པ་དག་ལ་རྣམ་པར་རིག་བྱེད་དུ་ཉེ་བར་འདོགས་པའི་ཕྱིར་རོ་༎ སོ་༎ 
 kiñca kriyādipratibhāsivijñānāt kāryaliṅgājjātaṃ yatparacittajñānaṃ tatparacittaṃ viṣayīkriyata āhosvinna?	ཅི་སྟེ་བྱ་བ་ལ་སོགས་པར་སྣང་བའི་རྣམ་པར་ཤེས་པ་འབྲས་བུའི་རྟགས་ལས་སྐྱེས་པ་གཞན་གྱི་སེམས་ཤེས་པ་དེ་དག་གཞན་གྱི་སེམས་ཡུལ་དུ་བྱེད་དམ་། འོན་ཏེ་མ་ཡིན་ཏེ་།
 viṣayīkaraṇe 'rthāntaraṃ syāt |	ཡུལ་དུ་བྱེད་ན་ནི་དོན་གཞན་ཡིན་པར་འགྱུར་རོ་༎
 aviṣayatve tu kathaṃ jñānena paracittasattā pratīyate?	ཡུལ་དུ་མི་བྱེད་ན་ནི་ཤེས་པས་ཕ་རོལ་གྱི་སེམས་ཡོད་པ་ཇི་ལྟར་ཤེས་ཏེ་།
 tatsvarūpājñāne tatsiddhairasambhavāditi cet 3?	དེའི་ངོ་བོ་ཉིད་མ་ཤེས་པར་དེ་འགྲུབ་པ་མི་སྲིད་པའི་ཕྱིར་རོ་ཞེ་ན་།
 eṣa prasaṅgo 'pi samaḥ |	འདི་ཡང་ཐལ་བར་འགྱུར་བར་མཚུངས་ཏེ་།
 kriyāvāgbhyāṃ paracittaṃ pratipattimatāmapi tatsvarūpaviṣayīkaraṇe svacittajñānavat tadākārasyāpi jñānaṃ prasajyeta |	བྱ་བ་དང་ཚིག་དག་གིས་གཞན་གྱི་སེམས་རྟོགས་པ་ལྟར་ན་ཡང་དེའི་ངོ་བོ་ཉིད་ཡུལ་དུ་བྱེད་ན་ནི་། དེའི་ཚེ་རང་གི་སེམས་ཤེས་པ་བཞིན་དུ་དེའི་རྣམ་པ་ཡང་ཤེས་པར་ཐལ་བྱེད་ན་ནི་། བར་འགྱུར་རོ་༎ 
 tadajñāne tu tena tatsvarūpasya grahaṇaṃ katham? [65-67]	དེ་མི་ཤེས་ན་ནི་དེས་དེའི་ངོ་བོ་ཉིད་ཇི་ལྟར་བྱེད་ན་ནི་། བར་འགྱུར་རོ་༎ 
 atha liṅgāt sāmānyadhigateḥ nākārasya pratītiriti cet?	འཛིན་། གལ་ཏེ་རྟགས་ཀྱིས་ནི་སྤྱི་རྟོགས་པའི་ཕྱིར་རྣམ་པར་རྟོགས་པ་མ་ཡིན་ནོ་ཞེ་ན་།
 kiñca tatsāmānyaṃ paracittam evānyadvāhosvidavācyam |	སྤྱི་དེ་ཅི་གཞན་གྱི་སེམས་ཉིད་ཡིན་ནམ་། འོན་ཏེ་གཞན་ཞིག་གམ་། འོན་ཏེ་བརྗོད་དུ་མི་རུང་བ་ཞིག་ཡིན་།
 anyatvāvācyatvayorekatve tvanena tatsāmānyameva gṛhyeta,	གཞན་ཉིད་དང་བརྗོད་དུ་མི་རུང་བ་ཉིད་དག་ཅིག་ཡིན་ན་ནི་འདིས་སྤྱི་དེ་ཁོ་ན་གཟུང་གི་། 
 na paracittam |	གཞན་གྱི་སེམས་ནི་མ་ཡིན་ན་།
 tatkathamanena tad gamyate?	ཇི་ལྟར་འདིས་དེ་༄༣༥༨བ་རྟོགས་པར་འགྱུར་།
 nāpi sāmānyaṃ paracittameva |	སྤྱི་གཞན་གྱི་སེམས་ཉིད་ཀྱང་མ་ཡིན་ཏེ་།
 tathā sati tadākārasyāpi jñānaṃ prasahyeta ityuktam | [86-71]	དེ་ཡོད་ན་དེའི་རྣམ་པ་ཡང་ཤེས་པར་ཐལ་བར་འགྱུར་རོ་ཞེས་བཤད་ཟིན་ཏེ་།
 na hyeṣā anumānaprakriyā |	འདི་ནི་རྗེས་སུ་དཔག་པའི་ཚུལ་ཡང་མ་ཡིན་ནོ་༎
 na hyanumānamarthasvarūpasya grāhakam |	རྗེས་སུ་དཔག་པ་ནི་དོན་གྱི་རང་གི་ངོ་བོ་འཛིན་པར་བྱེད་པ་མ་ཡིན་ཏེ་།
 pratyakṣavat pratibhāsāviśiṣṭatvādeḥ prasaṅgāt |	མངོན་སུམ་དང་འདྲ་བར་སྣང་པ་ཁྱད་པར་མེད་པ་ལ་སོགས་པར་ཐལ་བར་འགྱུར་བའི་ཕྱིར་རོ་༎ དེའི་ཕྱིར་འདི་ནི་ཚད་མ་ཉིད་མ་ཡིན་ནོ་༎
 tena nāsya prāmāṇyam | tatsvarūpāgrahe 'pyabhipretārthāvisaṃvādāt prāmāṇyam |	དེའི་རང་གི་ངོ་བོ་མི་འཛིན་ཀྱང་མངོན་པར་འདོད་པའི་དོན་ལ་མི་སླུ་བས་ཚད་མ་ཉིད་ཡིན་པའི་ཕྱིར་རོ་༎
 dhūmādiliṅgājjātamapi na vahnayādisvarūpaviṣayi,	དུ་བ་ལ་སོགས་པའི་རྟགས་ལས་སྐྱེས་པ་ཡང་མེ་ལ་སོགས་པའི་རང་གི་ངོ་བོའི་ཡུལ་ཅན་མ་ཡིན་ཏེ་། 
 dṛṣṭenāviśeṣaprasaṅgāt |	མཐོང་བ་དང་ཁྱད་པར་མེད་པར་ཐལ་བར་འགྱུར་བའི་ཕྱིར་རོ་༎
 anumānasyātītādau niḥsvabhāvatāyā cāpravṛtteḥ, arthakriyāprasaṅgācca | [72-76]	རྗེས་སུ་དཔག་པ་འདས་པ་ལ་སོགས་པ་དང་། ངོ་བོ་ཉིད་མེད་པ་དག་ལ་ཡང་འཇུག་པར་མི་འགྱུར་བའི་ཕྱིར་དང་། དོན་བྱེད་པར་ཐལ་བར་འགྱུར་བའི་ཡང་ཕྱིར་རོ་༎
 paracittānumāne 'pyabhipretārthāvisaṃvādo 'styeva |	གཞན་གྱི་སེམས་རྗེས་སུ་དཔག་པ་ལ་ཡང་མངོན་པར་འདོད་པའི་དོན་ལ་མི་སླུ་བ་ཡོད་པ་ཁོ་ན་སྟེ་། 
 tatpravartanadvāreṇa prāṇyantarasattāṃ pratipadya punaḥ punarvyavahārapravṛttau tadādhipatyādāgārthasya prāpteḥ |	འཇུག་པར་བྱེད་པ་དེའི་སྒོ་ནས་སྲོག་ཆགས་གཞན་ཡོད་པར་རྟོགས་ནས་ཡང་ནས་ཡང་དུ་ཐ་སྙད་དག་ལ་འཇུག་ན་། དེའི་དབང་གིས་འབྱུང་བའི་དོན་ཐོབ་པའི་ཕྱིར་རོ་༎
 tanmātraphalacintakasyalokasya prāṇyantarānumāne pravṛtteśca |	འཇིག་རྟེན་ནི་འབྲས་བུ་དེ་ཙམ་ལ་སེམས་ཤིང་སྲོག་ཆགས་གཞན་རྗེས་སུ་དཔག་པ་ལ་འཇུག་པའི་ཡང་ཕྱིར་ཏེ་། 
 uttarārthaviśeṣapratibhāsijñānānubhavodayamātreṇa puruṣasya nirākāṅkṣatvāt |	སྐྱེས་བུ་དོན་ཕྱི་མའི་ཁྱད་པར་དུ་སྣང་བའི་ཤེས་པ་མྱོང་བ་ཙམ་གྱིས་རེ་བ་མེད་པ་ཉིད་ཀྱི་ཕྱིར་རོ་༎
 pūrvajñānena vyavahārasamāpteḥ kṛtārthatatvaṃ pramāṇatvena siddhatvāt | [77-81] nanu svapne 'pi pūrvajñānāduttarārthapratibhāsijñānamutpadyate |	ཤེས་པ་སྔ་མས་ཐ་སྙད་རྫོགས་པས་དོན་བྱས་པ་ཉིད་ཚད་མ་ཉིད་དུ་གྲུབ་པའི་ཕྱིར་རོ་༎ རྨི་ལམ་ན་ཡང་ཤེས་པ་སྔ་མ་ལས་དོན་ཕྱི་མར་སྣང་བའི་ཤེས་པ་སྐྱེ་བ་མ་༎ ཡིན་ན་མ་། 
 na tanmātreṇa pūrvajñānasya prāmāṇyaṃ yujyate,	དེ་ཙམ་གྱིས་ནི་ཤེས་པ་སྔ་མ་ཚད་མ་ཡིན་པར་འོས་པ་མ་༎ ཡིན་ན་མ་། ཡིན་ཏེ་། 
 tadānīṃ sarveṣāṃ jñānānāṃ bhrāntatvāt |	དེའི་ཚེ་ཤེས་པ་ཐམས་ཅད་འཁྲུལ་བ་ཡིན་པའི་ཕྱིར་རོ་༎ ཡིན་ན་མ་། ཡིན་ཏེ་། 
 tatra vijñaptijñānaṃ na kadāciccittaspandanādhipatyena vinā udbhavatītyataḥ tābhyāṃ ye anumīyate |	ཞེ་ན་། འདིར་རྣམ་པར་རིག་བྱེད་ཀྱི་ཤེས་པ་ནི་ནམ་ཡང་སེམས་ཀྱི་ག-ཡོ་པའི་དབང་མེད་པར་མི་༎ ཡིན་ན་མ་། ཡིན་ཏེ་། ཞེ་ན་། འབྱུང་བས་། དེ་དག་གིས་ཀྱང་དི་དག་རྗེས་སུ་དཔོག་པར་བྱེད་དོ་༎
 bhrāntivaśāt kadācid vyavahite 'pi udeti,	འཁྲུལ་པའི་དབང་གིས་ནི་རེས་འགའ་བར་དུ་ཆོད་ཀྱང་འབྱུང་སྟེ་།
 na tu tadādhipatyarahitatvam | viśeṣastvasti sākṣātparamparayā cetyuktam |	དེ་དག་གི་དབང་གིས་སྟོང་པ་ནི་མ་ཡིན་གྱི་མངོན་སུམ་དང་བརྒྱུད་པ་ཞེས་པའི་ཁྱད་པར་འདི་ནི་ཡོད་དོ་ཞེས་བཤད་ཟིན་ཏོ་༎
 tatra yathā pūrvavijñaptijñānānāṃ paramparayā spandanādhipatyādudayaḥ tathā taduttarāvasthābhāvināmapi |	དེ་ལ་ཇི་ལྟར་རྣམ་པར་རིག་བྱེད་༄༣༥༩ཨ་༌་༎ ཀྱི་ཤེས་པ་སྔ་མ་རྣམས་བརྒྱུད་དེ་ག-ཡོ་བའི་དབང་གིས་སྐྱེ་བ་ལྟར་། དེའི་འོག་རོལ་གྱི་གནས་སྐབས་ན་ཡོད་པ་དག་ཀྱང་དེ་དང་འདྲའོ་༎
 vijñaptijñānāśrayaspandanottarāvasthācittasantānādeva paramparayotpādaḥ |	རྣམ་པར་རིག་བྱེད་ཀྱི་ཤེས་པའི་རྟེན་ག-ཡོ་བའི་གནས་སྐབས་ཕྱི་མའི་སེམས་ཀྱི་རྒྱུད་ཁོ་ན་ལས་བརྒྱུད་དེ་སྐྱེའོ་༎ དེ་ཡང་རྗེས་སུ་དཔག་པ་ཅི་འདྲ་བ་དེ་ལྟ་བུའི་མི་སླུ་བ་དང་བརྒྱུད་དེ་སྐྱེའོ་༎ 
 tatrāpi yādṛganumānaṃ tādṛgavisaṃvādo vyavahāraścāpyastyeveti kenāpi na gṛhyate | [82-86]	། ཐ་སྙད་ཀྱང་ཡོད་པ་ཁོ་ན་ཡིན་པས་ཅིས་ཀྱང་མི་གཟུང་ངོ་༎
 paracittānumānena tatsvarūpāgrahe 'pyavisaṃvādād bhavatu tathā prāmāṇyam | sākṣāt paracittavidāṃ tu katham?	གཞན་གྱི་སེམས་ཀྱི་རྗེས་སུ་དཔག་པ་ནི་དེའི་རང་གི་ངོ་བོ་མི་འཛིན་ཀྱང་མི་སླུ་བའི་ཕྱིར་དེ་ལྟར་ཚད་མ་ཉིད་ཡིན་དུ་ཆུག་ན་གཞན་གྱི་སེམས་མངོན་སུམ་དུ་ཤེས་པ་རྣམས་ཀྱིས་གོ་༎ ཇི་ལྟར་།
 yadi te paracittasya svarūpaṃ sākṣājjānanti, tadā tasyārthāntaragrahaṇaṃ syāt |	གལ་ཏེ་གཞན་གྱི་སེམས་ཀྱིས་རང་གི་ངོ་བོ་མངོན་སུམ་དུ་ཤེས་པར་གྱུར་ན་ནི་དེའི་གཟུང་བ་དོན་གཞན་ཡིན་པར་འགྱུར་རོ་༎
 atha na jānanti, kathaṃ te sākṣādvidaḥ?	མི་ཤེས་ན་ནི་དེ་དག་ཇི་ལྟར་མངོན་སུམ་དུ་ཤེས་པ་ཡིན་།
 kathaṃ nāma pratyakṣeṇārthasvarūpasya agrahaṇaṃ ca bhavati |	ཇི་ལྟར་མངོན་སུམ་གྱི་དོན་གྱི་རང་གི་ངོ་བོ་མི་འཛིན་པར་ཡང་འགྱུར་།
 atha na gṛhyate, kathaṃ tarhi pramāṇamiti cet?	འོན་ཏེ་མི་འཛིན་ན་ནི་ཇི་ལྟར་ཚད་མ་ཡིན་ཞེ་ན་།
 aprahīṇagrāhyagrāhaka vikalpayogināṃ paracittajñānamapi vyavahāre 'visaṃvādādeva pramāṇam, rūpādidarśanavat; āśrayāparāvṛteḥ |	གནས་མ་གྱུར་བའི་ཕྱིར་རྣལ་འབྱོར་པ་གཟུང་བ་དང་འཛིན་པའི་རྣམ་པར་རྟོག་པ་མ་སྤངས་པ་རྣམས་ཀྱིས་གཞན་གྱིས་སེམས་ཤེས་པ་ཡང་། ཐ་སྙད་ལ་མི་སླུ་བ་ཉིད་ཀྱིས་གཟུགས་ལ་སོགས་པ་མཐོང་བ་བཞིན་དུ་ཚད་མ་ཉིད་ཡིན་ནོ་༎ 
 yogabalāddhi teṣāṃ jñānaṃ paracittākāraviśeṣānukāri sphuṭābhamupajāyate,	རྣལ་འབྱོར་གྱི་སྟོབས་ཀྱིས་ནི་དེ་དག་ལ་ཤེས་པ་གཞན་གྱི་སེམས་ཀྱི་རྣམ་པའི་བྱེ་བྲག་གི་། རྗེས་སུ་བྱེད་པ་གསལ་བར་སྣང་བ་འབྱུང་བར་འགྱུར་ཏེ་།
 karmadevādyadhiṣṭhānabalāt satyasvapnadarśanavat | teṣāmapi na paracittaviṣayitvena jñānamudeti,	ལས་དང་ལྷ་ལ་སོགས་པའི་བྱིན་གྱི་རླབས་ཀྱི་སྟོབས་ཀྱིས་རྨི་ལམ་བདེན་པ་མཐོང་བ་བཞིན་ནོ་༎ དེ་དག་ལ་ཡང་གཞན་གྱི་སེམས་ཀྱི་ཡུལ་ཅན་ཉིད་ཀྱི་ཤེས་པ་འབྱུང་བ་ནི་མ་ཡིན་༎ ཏེ་། 
 te 'pi tadākārasadṛśasvacittapratibhāsameva jānantītyevamavadhāraṇād paracittavida iti vyavahāraḥ |	དེ་དག་ཀྱང་རང་གི་སེམས་སྣང་བ་དེ་དང་། རྣམ་པ་མཚུངས་པ་ཁོ་ན་ཉིད་ཤེས་པ་ལས་། གཞན་གྱི་སེམས་ཤེས་པ་ཞེས་བྱ་བ་ངེས་པར་གཟུངས་བས་ཐ་སྙད་འདོགས་སོ་༎
 tadākārānukārisfuṭābhatvāt tatpratyakṣam, avisaṃvāditvācca pramāṇam iti matam |	མངོན་སུམ་དུ་ནི་དེའི་རྣམ་པའི་རྗེས་སུ་བྱེད་པ་གསལ་བར་སྣང་བའི་ཕྱིར་དང་། མི་སླུ་པའི་ཚད་མ་ཞེས་བྱ་བར་འདོད་དོ་༎
 acintyo hi bhagavataḥ sarvārthādhigamaḥ,	བཅོམ་ལྡན་འདས་ཀྱིས་དོན་ཐམས་ཅད་ཐུགས་སུ་ཆུང་པ་ནི་བསམ་གྱིས་མི་ཁྱབ་སྟེ་།
 sarvathā jñānabhidhānaviṣayātītatvāt || [87-93]	རྣམ་པ་ཐམས་ཅད་དུ་ཤེས་པ་དང་བརྗོད་པའི་ཡུལ་ལས་འདས་པའི་ཕྱིར་རོ་༎
