skt	tib
 antarvyāptisamarthanam | oṃ namo buddhāya |	༄༣༠༩བ་༅་༎ རྒྱ་གར་སྐད་དུ་། ཨཨནཏར་བཡའ་བ་ཏི་། བོད་སྐད་དུ་། ནང་གི་ཁྱབ་པ་། འཕགས་པ་འཇམ་དཔལ་གཞོན་ནུར་གྱུར་པ་ལ་ཕྱག་འཚལ་ལོ་༎
 iha sattvamarthakriyākāritvaṃ taditarasattvalakṣaṇāyogāt |	འདིར་ཡོད་པ་དོན་བྱ་བ་བྱེད་པ་ཡིན་ཏེ་། དེ་ལས་གཞན་ཡོད་པའི་མཚན་ཉིད་དུ་མི་རིགས་པའི་ཕྱིར་རོ་༎
 tacca kramayaugapadyābhyāṃ vyāptaṃ parasparavyavacchedalakṣaṇatvādanayoḥ |	དེ་ཡང་རིམ་དང་ཅིག་ཅར་དག་གིས་ཁྱབ་པ་ཡིན་ཏེ་། དེ་དག་ཕན་ཚུན་རྣམ་པར་གཅོད་པའི་མཚན་ཉིད་ཡིན་པ་ཉིད་ཀྱིས་ན་རྣམ་པ་གཞན་མི་སྲིད་པའི་ཕྱིར་རོ་༎ 
 prakārāntareṇa karaṇāsambhavāt | kramayaugapadye cākṣaṇikatve na staḥ |	སྐད་ཅིག་མ་མ་ཡིན་པ་ལ་རིམ་དང་ཅིག་ཅར་གྱི་དོན་བྱེད་པ་མེད་པའི་ཕྱིར་རོ་༎ དོ་༎ 
 pūrvvāparakālayoaravicalitaikasvabhāvasya karttṛtvākarttṛtve virudvadharmmadvayāyogāt |	དུས་སྔ་ཕྱིར་འགྱུར་བ་མེད་པའི་རང་བཞིན་གཅིག་པ་ནི་བྱེད་པ་པོ་ཉིད་དང་བྱེད་པ་པོ་མ་ཡིན་པ་ཉིད་འགལ་བའི་ཆོས་གཉིས་མི་རིགས་པ་ཡིན་ནོ་༎
 tatra na tāvat kramaḥ kramāṇāmekaikaṃ prati pūrvāparakālayoḥ karttṛtvākarttṛtvāpatteḥ |	དེ་ལ་རེ་ཞིག་རིམ་གྱིས་མ་ཡིན་ཏེ་། རིམ་པ་དང་བཅས་པ་རེ་རེ་དུས་སྔ་ཕྱི་ལ་བྱེད་པ་པོ་དང་བྱེད་པ་པོ་མ་ཡིན་པ་ཉིད་དུ་ཐལ་བར་འགྱུར་བའི་ཕྱིར་རོ་༎
 evaṃ sarvvakramābhāvāt kevalaṃ sakalakāryyayaugapadyamavaśiṣyate |	དེ་ལྟ་བས་ན་ཐམས་ཅད་དུ་རིམ་པ་མེད་པའི་ཕྱིར་བྱ་བ་ཐམས་ཅད་ལ་ཅིག་ཅར་འབའ་ཞིག་ཏུ་ད་ལྟར་བར་གནས་པ་ཡིན་ཏེ་།
 tatra ca sphuṭa taraḥ pūrvvāparakālayoḥ karttṛtvākartṛtvaprasaṅgaḥ |	དེ་ལ་དུས་སྔ་ཕྱིར་བྱེད་པ་པོ་ཉིད་དང་བྱེད་པ་པོ་ཉིད་མ་ཡིན་པར་ཤིན་ཏུ་འགལ་བར་ཐལ་བར་འགྱུར་རོ་༎
 virudve ca karttṛtvākarttṛtve ekadharmmiṇi na sambhavataḥ |	བྱེད་པ་པོ་ཉིད་དང་བྱེད་པ་པོ་ཉིད་མ་ཡིན་པ་འགལ་བས་ཆོས་ཅན་གཅིག་ལ་མི་སྲིད་པའི་ཕྱིར་རོ་༎ 
 ekasvabhāvaśca tāvatkālamakṣaṇika iti sidva etasmin kramayaugapadyayorayogaḥ |	ངོ་བོ་གཅིག་པ་ཡང་དུས་དེ་སྲིད་ཀྱི་བར་དུ་སྐད་ཅིག་མ་ཡིན་པའི་ཕྱིར་འདི་ལ་རིམ་དང་ཅིག་ཅར་འབྲེལ་༄༣༡༠ཨ་༌་པའི་ཕྱིར་རོ་༎ ༎ པ་མེད་པར་འགྲུབ་པོ་༎
 tadevamakṣaṇike vyāpakānupalabdhyā niṣidvaṃ sattvaṃ kṣaṇika evā[va] tiṣṭhate iti kṣaṇikatvena vyāptaṃ |	དེ་ལྟར་ན་སྐད་ཅིག་མ་མ་ཡིན་པ་ལ་ཁྱབ་པར་བྱེད་པ་མི་དམིགས་པ་ཡོད་པ་ཉིད་བཀག་པས་སྐད་ཅིག་མ་ཉིད་དུ་གནས་པའི་ཕྱིར་སྐད་ཅིག་མ་ཉིད་ཀྱིས་ཁྱབ་པ་ཡིན་ཏེ་།
 tattena vyāptaṃ yat yatra dharmmiṇi sidhyati tatra kṣaṇikatvaṃ prasādhayati | idamevedānīṃ vicāryyate | keyaṃ (kveyaṃ)	དེ་ལ་དེས་ཁྱབ་པར་ཆོས་ཅན་གང་ལ་གྲུབ་པ་དེར་སྐད་ཅིག་ཉིད་དུ་གྲུབ་པར་བྱེད་དོ་༎ ད་ནི་འདི་དཔྱད་པར་བྱ་སྟེ་།
 vyāptigrahītavyā dṛṣṭāntadharmmiṇi sādhyadharmmiṇi vā | kecidāhuḥ | dṛṣṭāntadharmmiṇyeva dhūmavat |	དཔེའི་ཆོས་ཅན་ན་མ་བསྒྲུབ་པར་བྱ་བའི་ཆོས་ཅན་གང་ལས་འདིར་ཁྱབ་པ་འཛིན་ཞེ་ན་ཁ་ཅིག་ནི་དཔེའི་ཆོས་ཅན་ལས་དུ་བ་བཞིན་ནོ་ཞེས་ཟེར་རོ་༎ 
 anyathā sādhanavaiphalyaṃ syāt | ubhayadharmmasidvi(dve) ranāntarīyakatvāt vyāptisidveḥ |	གཞན་དུ་ན་སྒྲུབ་པར་བྱེད་པའི་དོན་མེད་པའི་ཕྱིར་དང་། ཁྱབ་པ་གྲུབ་པས་ཆོས་གཉིས་གྲུབ་པ་མེད་ན་མི་འབྱུང་བའི་ཕྱིར་༎
 nahi mahānasasidvāyāmagnidhūmayorvyāptau punaragnisidvaye dhūmaliṅgamanviṣyata iti | tathāhi |	གང་གི་ཕྱིར་ཚང་བར་དུ་མེ་དང་དུ་བའི་ཁྱབ་པ་གྲུབ་བ་ན་མེ་གྲུབ་པ་ན་། ཡང་མེ་གྲུབ་པའི་ཕྱིར་རྟགས་དུ་བ་ལས་སྐྱེས་པའི་རྗེས་སུ་དཔག་པ་ཚོལ་བར་མི་བྱེད་དོ་༎ མི་འདྲ་བར་བཀོད་པ་ཡིན་ཏེ་འདི་ལྟར་།
 dṛṣṭānte gṛhyate vyāptirdharmmayostatra dṛṣṭayoḥ |	དེ་ལ་ཆོས་གཉིས་མཐོང་བ་ཡིས་༎ དཔེ་ལ་ཁྱབ་པ་འཛིན་པ་ཡིན་༎
 hetumātrasya dṛṣṭasya vyāptiḥ pakṣe tu gamyate ||	གཏན་ཚིགས་ཙམ་ནི་མཐོང་བ་ཡིས་༎ ཕྱོགས་ལ་ཁྱབ་པ་འཛིན་པ་ཡིན་༎
 sā ca sarvvopasaṃhārāt sāmānyamavalambate |	དེ་ཡང་ཐམས་ཅད་ཉེར་བསྡུས་པས་༎ སྤྱི་ཉིད་ལ་ནི་དམིགས་པ་སྟེ་༎
 tasya dharmmiṇi vṛttistu pratīyetānumānataḥ ||	དེ་ནི་ཆོས་ཅན་ལ་འཇུག་པས་༎ རྗེས་སུ་དཔག་པས་རྟོགས་པ་ཡིན་༎
 pratyakṣadṛṣṭayorvanhidhūmayoḥ kāryyakāraṇabhāvasidvau tayorvyāptisidviriti pratyakṣasidve vanhau yuktamanumānavaiphalyam |	མངོན་སུམ་གྱིས་མཐོང་བ་དག་གིས་མེ་དང་དུ་བ་རྒྱུ་དང་འབྲས་བུའི་ངོ་བོར་གྲུབ་ན་དེ་གཉིས་ཀྱི་ཁྱབ་པ་འགྲུབ་སྟེ་།
 naivaṃ vyāptisidveḥ prāk pramāṇāntarasidvaṃ dharmmiṇi kṣaṇikatvam |	མངོན་སུམ་གྱིས་མེ་དང་ལྡན་པར་འགྲུབ་པ་ནི་རྗེས་སུ་དཔག་པ་འབྲས་བུ་མེད་པ་ཡིན་ནོ་༎ ཁྱབ་པ་གྲུབ་པའི་སྔ་རོལ་དུ་ཚད་མ་གཞན་གྱི་ཆོས་ཅན་ལ་སྐད་ཅིག་མ་ཉིད་དུ་གྲུབ་པ་མ་ཡིན་ཏེ་།
 sādhanadharmmameva tu kevalamanupaśyanto viparyyaye bādhakapramāṇavalāttasya kṣaṇikatvena vyāptiṃ pratīmaḥ |	འདིར་སྒྲུབ་པར་བྱེད་པའི་ཆོས་འདི་ཁོ་ན་འབའ་ཞིག་མཐོང་བས་བཟློག་ན་གནོད་པ་ཅན་གྱི་སྟོབས་ཀྱིས་དེ་ལ་སྐད་ཅིག་མ་གཉིས་ཀྱིས་ཁྱབ་པར་རྟོགས་སོ་༎ 
 tattataḥ sādhanavaiphalyam |	དེ་ལ་གང་གིས་ན་སྒྲུབ་པར་བྱེད་པ་དེ་དོན་མེད་པ་ཡིན་།
 vaiphalyameva, kṣaṇikatvavyāptasya sattvasya tathātvena dharmmiṇi pratītau kṣaṇikatvasyāpi pratīteriti cet | na |	དོན་མེད་པ་ཉིད་ཡིན་ཏེ་སྐད་ཅིག་མ་ཉིད་ཀྱིས་ཁྱབ་པ་ཡོད་པ་དེ་བཞིན་དུ་ཆོས་ཅན་ལ་རྟོགས་ན་སྐད་ཅིག་མ་ཉིད་དུ་ཡང་རྟོགས་སོ་ཞེས་ཟེར་ན་། མ་ཡིན་ཏེ་།
 sarvvopasaṃhāravatī hi vyāptiḥ sādhyasidveraṅgam | tadiyamanapekṣitadharmmiviśeṣaṃ sādhanadharmmamātramavalambate |	ཐམས་ཅད་བསྡུས་པ་དང་ལྡན་པའི་ཁྱབ་པ་ནི་བསྒྲུབ་པར་བྱ་བ་འགྲུབ་པའི་ཡན་ལག་ཡིན་ལ་། དེ་བས་ན་འདི་ནི་ཆོས་ཅན་གྱི་ཁྱད་པར་པ་ལྟོས་པ་མེད་པར་སྒྲུབ་པར་བྱེད་པའི་ཆོས་ཙམ་དམིགས་པ་སྟེ་།
 tadyathā | yatra dhūmastatrāgniriti |	གང་ན་དུ་བ་ཡོད་པ་དེ་ན་མེ་ཡོད་དོ་ཞེས་བྱ་བ་བཞིན་ནོ་༎
 na punaryatra mahānase dhūmastatrāgniriti |	ཡང་གང་ན་ཚང་བང་གི་དུ་བ་ཡོད་པ་དེ་ན་མེ་ཡོད་དོ་ཞེས་བྱ་བ་ནི་མ་ཡིན་ནོ་༎ 
 evamihāpi yat sattatkṣaṇikamiti vyāptipratītau sādhanadharmmasyāpi dharmmiṇi sattvaṃ nāntarbhavati |	དེ་བཞིན་དུ་འདིར་ཡང་གང་ཡོད་པ་དེ་ནི་སྐད་ཅིག་མ་༄༣༡༠བ་ཡིན་ནོ་ཞེས་བྱ་བས་ཁྱབ་པ་རྟོགས་ན་སྒྲུབ་པར་བྱེད་པའི་ཆོས་ཀྱང་ཆོས་ཅན་ལ་ཡོད་པའི་ནང་དུ་མི་འདུ་ན་བསྒྲུབ་པར་བྱ་བའི་ཆོས་ལྟ་ཅི་སྨོས་ཡིན་ནོ་༎ 
 kiṃ punaḥ sādhyadharmmasya | tasmāt sattvasāmānyasya sādhanadharmmasya pakṣadharmmatvaṃ vyāptiścaikaśaḥ pratipādya tadubhayasāmarthyāt sādhyadharmmasya dharmmiṇi vṛttiḥ pratīyata iti kuto 'numānavaiphalyaṃ |	། དེ་ལྟ་བས་ན་ཡོད་པའི་སྤྱི་སྒྲུབ་པར་བྱེད་པའི་ཆོས་ཕྱོགས་ཀྱི་ཆོས་ཉིད་ཁྱབ་པ་སོ་སོར་རྟོགས་ནས་དེ་གཉིས་ཀྱི་ནུས་པས་བསྒྲུབ་པར་བྱ་བའི་ཆོས་ཅན་ལ་འཇུག་པའི་ཕྱིར་གང་གིས་ན་རྗེས་སུ་དཔག་པ་འབྲས་བུ་མེད་པ་ཡིན་ཏེ་།
 yadyevaṃ vyāptipratītāvasati dharmmiṇi parāmarśe sādhyadharmmiṇi vyāptigrahaṇamiti | kutaḥ | tatra dṛṣṭasya sattvasya vyāptipratīteḥ |	གལ་ཏེ་དེ་ལྟ་བུའི་ཁྱབ་པ་རྟོགས་ན་ཆོས་ཅན་ལ་མཆོག་ཏུ་འཛིན་པ་མེད་པས་ཁྱབ་པ་འཛིན་ན་དེ་ལ་མཐོང་བའི་ཡོད་པའི་ཁྱབ་པ་གང་དུ་རྟོགས་ཏེ་།
 yathā mahānasadṛṣṭāgnidhūmayorvyāptigrahe dṛṣṭāntadharmmiṇi vyāptigrahaṇamucyate |	དཔེར་ན་ཚང་བང་དུ་མཐོང་བས་མེ་དང་དུ་བའི་ཁྱབ་པ་གཟུང་བས་དཔེའི་ཆོས་ཅན་ལ་ཁྱབ་པ་གཟུང་བ་མ་ཡིན་ནོ་ཞེས་ཟེར་ན་མ་ཡིན་ཏེ་། 
 na hi vyāptigrahaṇe mahānasaparāmarśo 'stītyuktaṃ |	ཁྱབ་པར་འཛིན་པ་ནི་ཚང་བང་ལ་མཆོག་ཏུ་འཛིན་པ་མེད་དོ་ཞེས་བསྟན་ཏོ་ཡིན་ཏེ་། 
 nanu vyāptipakṣadharmmatvayorekaśaḥ pratītāvapi yasyaiva pakṣadharmmatvamavagatantasyaiva sādhyena vyāptiravasiteti sāmarthyāt sādhyasattākathanamavaiyarthyaṃ sādhanasya |	༎ ཁྱབ་པ་དང་ཕྱོགས་ཀྱི་ཆོས་གཉིས་སོ་སོར་རྟོགས་པས་ཀྱང་། གང་ལ་ཕྱོགས་ཀྱི་ཆོས་ཉིད་རྟོགས་པ་དེ་ཉིད་ལ་བསྒྲུབ་པར་བྱ་བས་ཁྱབ་པར་རྟོགས་པའི་ཕྱིར་ཤུགས་ཀྱིས་བསྒྲུབ་པར་བྱ་བ་རྟོགས་པ་མ་ཡིན་ནམ་༏་ཇི་ལྟར་སྒྲུབ་པར་བྱེད་པ་དོན་མེད་པ་མ་ཡིན་། འོན་ཀྱང་ཕྱོགས་ཀྱི་ཆོས་ཉིད་རྟོགས་པས་བསྒྲུབ་པར་བྱ་བ་རྟོགས་པ་མ་ཡིན་ཏེ་།
 nanu na pakṣadharmmatvagatiḥ sādhyagatiḥ sādhyadharmmasaṃsparśāt |	བསྒྲུབ་པར་བྱ་བའི་ཆོས་ལ་མ་རེག་པའི་ཕྱིར་རོ་༎
 nāpi vyāptipratītireva sādhyasidviḥ |	ཁྱབ་པ་རྟོགས་པ་ཉིད་ཀྱང་བསྒྲུབ་པར་བྱ་བ་གྲུབ་པ་ནི་མ་ཡིན་ཏེ་།
 sāmānyālambanatayā dharmmiviśeṣeṇa dharmmayoranavacchedāt |	སྤྱི་ལ་དམིགས་པ་ཉིད་ཀྱི་ཆོས་ཅན་གྱི་ཁྱད་པར་གྱི་ཆོས་དག་ཡོངས་སུ་མི་གཅོད་པའི་ཕྱིར་རོ་༎ གཞན་དུ་ན་ཁྱད་པར་གྱི་ཆོས་དག་གིས་ཁྱབ་པར་ཐལ་བར་འགྱུར་བའི་ཕྱིར་རོ་༎
 anyathā viśeṣayorvyāptiprasaṅgāt tadayaṃ vyastaviṣayaḥ sāmarthyāditi hetunirddeśaḥ |	དེ་ལྟ་བས་ན་ཁྱབ་པའི་ཡུལ་འདིས་ཤུགས་ཀྱིས་གཏན་ཚིགས་བསྟན་ཏོ་༎
 atha hetostrairūpyaparicchedasāmarthyāt sādhyapratītirutpadyata ityucyate |	གལ་ཏེ་གཏན་ཚིགས་ཀྱི་ཚུལ་གསུམ་ཡོངས་སུ་བཅད་པའི་ཤུགས་ཀྱིས་བསྒྲུབ་པར་བྱ་བ་རྟོགས་པ་འབྱུང་ངོ་ཞེས་ཟེར་ན་།
 na tarhīdānīṃ vyarthohetuḥ |	དེ་ལྟ་ན་ཁྱོད་ཀྱི་ཡང་གཏན་ཚིགས་དོན་མེད་པ་ཡིན་ཏེ་།
 svarūpaniścayena sādhyaniścayopajananāt |	རང་གི་ངོ་བོ་ངེས་པས་བསྒྲུབ་པར་བྱ་བ་ངེས་པ་བསྐྱེད་པའི་ཕྱིར་རོ་༎
 na hi kvacidiyattādhikaṃ liṅgasya karttavyamastīti |	དེ་ཙམ་ལས་རྟགས་ཀྱི་བྱ་བ་འགའ་ཡང་མེད་དོ་༎ གཞན་ཡང་། ཕྱོགས་ཀྱི་ཆོས་ཉིད་གཟུང་བ་ལས་༎ འབྲེལ་པ་ཡང་ནི་དྲན་པ་ཡིས་༎
 api ca gṛhīte pakṣadharmmatve sambandhe ca smṛte anumānaṃ bhavadbhiriṣyate | tadvadantarvyāptāvapīṣyatāṃ |	རྗེས་སུ་དཔག་པ་བྱེད་འདོད་ན་༎ དེ་བཞིན་ནང་ཁྱབ་ཀྱང་འདོད་ཀྱིས་༎
 na hi bahirvyāptivādināmapi vismṛtāyāṃ vyāptau anumānapravṛttirasti |	ཕྱིའི་ཁྱབ་པ་སྨྲ་བ་ལ་ཡང་ཁྱབ་པ་བརྗེད་པས་རྗེས་སུ་དཔག་པས་འཇུག་པ་མེད་དོ་༎
 tatra yasyaiva pakṣadharmmatvamavagataṃ tasyaiva sādhyadharmmeṇa vyāptismṛteḥ kinna sarvvānumānavaiyarthyaṃ |	དེ་ལ་གང་གི་ཕྱོགས་ཀྱི་ཆོས་ཉིད་རྟོགས་པས་དེ་ལ་བསྒྲུབ་པར་བྱ་བའི་ཆོས་ཀྱི་ཁྱབ་པ་དྲན་པའི་ཕྱིར་། ཅིའི་ཕྱིར་རྗེས་སུ་དཔག་པ་ཐམས་ཅད་དོན་མེད་པ་༄༣༡༡ཨ་༌་༎ མ་ཡིན་།
 sādhyadharmmiṇo 'parāmarśeṇa vyāpteḥ smaraṇāditi cet |	བསྒྲུབ་པར་བྱ་བའི་ཆོས་ཅན་ལ་མཆོག་ཏུ་མི་འཛིན་པས་ཁྱབ་པ་དྲན་པའི་ཕྱིར་རོ་ཞེས་ཟེར་ན་། 
 sādhyadharmmiṇi dṛṣṭasyaiva vyāptismaraṇe kathaṃ sādhyadharmmiṇo 'parāmarśaḥ |	བསྒྲུབ་པར་བྱ་བའི་ཆོས་ཅན་ལ་མཐོང་བ་ཉིད་ཀྱིས་ཁྱབ་པ་དྲན་པའི་ཕྱིར་ཇི་ལྟར་བསྒྲུབ་པར་བྱ་བའི་ཆོས་ཅན་ལ་མཆོག་ཏུ་མི་ན་། འཛིན་པ་ཡིན་། 
 sāmānyālambanatvādvyāpteḥ | sādhyadharmmino 'navacchedāditi cet |	ཁྱབ་པ་སྤྱི་ལ་དམིགས་པ་ཡིན་པའི་ཕྱིར་བསྒྲུབ་པར་བྱ་བའི་ཆོས་ཅན་ཡོངས་སུ་མི་གཅོད་དོ་ཞེས་ཟེར་ན་།
 nanu tatra dṛṣṭasya kathaṃ tenānavacchedaḥ |	དེ་ལ་མཐོང་བས་མ་ཡིན་ནམ་ཇི་ལྟར་དེས་ཡོངས་སུ་མི་གཅོད་།
 tenāvacchinnasya vā asādhāraṇatvāt kathaṃ vyāptiḥ |	དེས་ཡོངས་སུ་གཅོད་ན་ཡང་ཐུན་མོང་མ་ཡིན་པའི་ཕྱིར་ཇི་ལྟར་ཁྱབ་།
 ayogavyavacchedena viśeṣaṇānnāsādhāraṇateti cet tathāpi kinna sādhyadharmmī parāmṛśyate |	མ་འབྲེལ་པ་རྣམ་པར་གཅོད་པའི་ཁྱད་པར་ཡིན་པའི་ཕྱིར་ཐུན་མོང་མ་ཡིན་པ་མ་ཡིན་ནོ་ཞེས་ཟེར་ན་༏་དེ་ལྟར་ན་ཡང་བསྒྲུབ་པར་བྱ་བའི་ཆོས་ཅན་ལ་མཆོག་ཏུ་མི་འཛིན་།
 yatra yatra parvvate dhūmastatra tatrāgniryathā mahānasa iti sāmānyālambanāyāṃ vyāptau	གང་དང་གང་ན་རིའི་དུ་བ་ཡོད་པ་དེ་དང་དེ་ན་མེ་ཡོད་དོ་༎ དཔེར་ན་ཚང་བང་བཞིན་ནོ་ཞེས་བྱ་བ་ལྟ་བུའོ་༎ སྤྱི་ལ་འཛིན་པའི་ཁྱབ་པ་ཡོད་ན་ཆོས་ཅན་གྱི་ཁྱད་པར་ལ་མཆོག་ཏུ་འཛིན་པའི་ཡན་ལག་མ་ཡིན་པའི་ཕྱིར་ཞེས་ཟེར་ན་།
 dharmmiviśeṣaparāmarśasyānaṅgatvāditi cet yuktametat sādhyadharmmiṇā hyayogavyavacchedaḥ sādhanadharmmasya rūpāntarameva pakṣadhammatvākhyaṃ |	འདི་ནི་རིགས་ཏེ་བསྒྲུབ་པའི་ཆོས་ཅན་དང་མ་འབྲེལ་པ་རྣམ་པར་གཅོད་པ་དང་། སྒྲུབ་པར་བྱེད་པའི་ཆོས་ཀྱི་ངོ་བོ་གཞན་ཉིད་ཕྱོགས་ཀྱི་ཆོས་ཉིད་དུ་བཤད་པ་ཡིན་གྱི་།
 na tvayaṃ vyāpteraṅgaṃ |	དེ་ལ་ཁྱབ་པའི་ཡན་ལག་མ་ཡིན་ཏེ་།
 tamantareṇāpi vyāpteḥ sāmānyālambanāyāḥ paricchedaparisamāpteḥ kathamanyathā dṛṣṭāntadharmmiṇi vyāptigrahaṇavārttāpi tadedānīṃ pakṣadharmmatvāyogāt	དེ་མེད་པས་ཀྱང་སྤྱི་ལ་དམིགས་པའི་ཁྱབ་པ་ཡོངས་སུ་གཅོད་པ་གྲུབ་པའི་ཕྱིར་རོ་༎ གཞན་དུ་ན་དཔེའི་ཆོས་ཅན་ལ་ཁྱབ་པ་འཛིན་པའི་གཏན་དུ་ཇི་ལྟར་འགྱུར་ཏེ་དེའི་ཚེ་ཕྱོགས་ཀྱི་ཆོས་ཉིད་མི་འཛིན་པའི་ཕྱིར་རོ་༎
 pakṣadharmmatvagrahaṇe vā tadaiva sādhyamapi sāmarthyādasidvaṃ sidvamiti sarvvānumānavaiyarthyaprasaṅgaḥ |	ཕྱོགས་ཀྱི་ཆོས་ཉིད་འཛིན་ན་ཡང་དེ་ཉིད་ཀྱི་ཚེ་བསྒྲུབ་པར་བྱ་བ་ཡང་ཤུགས་ཀྱིས་གྲུབ་པའི་ཕྱིར་རྗེས་སུ་དཔག་པ་ཐམས་ཅད་དོན་མེད་པར་ཐལ་བར་འགྱུར་རོ་༎
 paścātkālabhāviliṅgajñānamapi ca smṛtireva syāt na pramāṇaṃ |	དུས་ཕྱིས་བྱུང་བའི་རྟགས་ཅན་གྱི་ཤེས་པ་ཡང་དྲན་པ་ཉིད་ཡིན་གྱི་ཚད་མ་ནི་མ་ཡིན་ནོ་༎ 
 tasmāt vyāpteranaṅgatvāt pakṣadharmmatvaṃ vyāptigrahaṇe sadapi nāntarbhavatīti pṛthaggṛhītasmṛtayoḥ pakṣadharmmatvavyāptyoḥ sāmarthyādanumeyagatirutpadyate iti |	དེ་བས་ན་ཁྱབ་པའི་ཡན་ལག་མ་ཡིན་པའི་ཕྱིར་ཕྱོགས་ཀྱི་ཆོས་ཉིད་ཁྱད་པར་འཛིན་པའི་ནང་དུ་འདུ་བར་མི་འགྱུར་བའི་ཕྱིར་ཐ་དད་པར་འཛིན་པ་དང་། དྲན་པའི་ཕྱོགས་ཀྱི་ཆོས་ཉིད་དང་ཁྱབ་པ་དག་གིས་ཤུགས་ཀྱིས་རྗེས་སུ་དཔག་པར་བྱ་བའི་ཤེས་པ་འབྱུང་ངོ་༎ 
 evamavaiyarthyaṃ sādhanānāmeṣitavyam iti mānaphalatvāt |	དེ་ལྟ་བས་ན་སྒྲུབ་པར་བྱེད་པ་རྣམས་དོན་མེད་པར་འདོད་པ་མི་བྱ་པ་འབྱུང་ངོ་༎ སྟེ་། རྗེས་སུ་དཔག་པ་འབྲས་བུ་བཅས་པའི་ཕྱིར་རོ་༎
 tadvat pṛthagmūtayoḥ pakṣadharmmatvavyāptyoḥ sāmarthyādanumānotpattirantarvyāptāvapi kinneṣyate | tadiṣṭau vā kathaṃ sādhanavaiyarthyaṃ |	དེ་བཞིན་དུ་ཐ་དད་པར་འཛིན་པ་དང་། དྲན་པའི་ཕྱོགས་ཀྱི་ཆོས་ཉིད་དང་། དྲན་པའི་ཤུགས་ཀྱིས་རྗེས་སུ་དཔག་པ་འབྱུང་བ་ནང་གི་ཁྱབ་པ་ལ་ཡང་ཅིའི་ཕྱིར་༄༣༡༡བ་འདོད་༏་ཡང་དེ་འདོད་ན་སྒྲུབ་པར་བྱེད་པ་ཇི་ལྟར་དོན་མེད་པ་ཡིན་།
 trairūpyagatisāmarthyādanumeyagatiriti hi tadupādānaśaktireva sāmarthyamucyate,	ཚུལ་གསུམ་རྟོགས་པའི་ཤུགས་ཀྱིས་རྗེས་སུ་དཔག་པར་བྱ་བ་རྟོགས་ཤེ་ན་། དེ་སྐྱེད་པའི་ནུས་པ་ཉིད་ལས་ཤུགས་ཞེས་བཤད་དོ་༎
 na tu trairupyapratīterantarbhāva iti sarvvaṃ samānaṃ |	ཚུལ་གསུམ་པ་རྟོགས་པའི་ནང་དུ་བསྒྲུབ་པར་བྱ་བ་རྟོགས་པ་འདུ་བ་མ་ཡིན་ནོ་ཞེས་བྱ་བར་ཐམས་ཅད་མཚུངས་སོ་༎
 na sarvvaṃ samānaṃ |	མཚུངས་པ་མ་ཡིན་ཏེ་། ནང་གི་ཁྱབ་པ་ལ་། ཁྱབ་པ་རྟོགས་པ་ཉིད་ཀྱིས་ཕྱོགས་ཀྱི་ཆོས་ཉིད་རྟོགས་པ་ཡིན་ཏེ་།
 antarvyāptau hi vyāptiṃ prati gatyaiva pakṣadharmmatvamavagataṃ anavagate pakṣadharmmatve vyāpterapyanavagateḥ |	ཕྱོགས་ཀྱི་ཆོས་ཉིད་མ་རྟོགས་ན་ཁྱབ་པ་ཡང་མི་རྟོགས་པའི་ཕྱིར་རོ་༎
 tato vyāptipūrvvake sādhanavāhye pakṣadharmmavacanamanarthakamanantavyāptau |	དེ་བས་ན་ནང་གི་ཁྱབ་པ་ལ་ཁྱབ་པ་ནང་དུ་འགྲོ་བའི་སྒྲུབ་པར་བྱེད་པའི་ཚིག་ལ་ཕྱོགས་ཀྱི་ཆོས་དོན་མེད་པ་ཡིན་གྱི་ཕྱིའི་ཁྱབ་པ་ནི་དེ་ལྟ་མ་ཡིན་ཏེ་།
 naivaṃ bahirvyāptau bahireva vyāptigrahaṇāt | atrāha,- “yena tena krameṇātra prayukte sādhane sati |	ཕྱི་རོལ་ཉིད་ཀྱི་ཁྱབ་པ་འཛིན་པའི་ཕྱིར་རོ་ཞེ་ན་། འདིར་སྨྲས་པ་། རིམ་པ་གང་ཡང་རུང་བས་འདིར་༎ སྒྲུབ་བྱེད་རབ་ཏུ་སྦྱོར་གྱུར་ན་༎
 avetyaṃ pakṣadharmmatvaṃ paścādvyāptiḥ pratīyate ||	ཕྱོགས་ཀྱི་ཆོས་ཉིད་ཤེས་པ་ཡིས་༎ ཕྱིས་ནི་ཁྱབ་པ་རྟོགས་པར་འགྱུར་༎ ཁྱོད་ཕྱོགས་བཞིན་དུ་དཔེ་ལ་ནི་༎
 pratyakṣa iva dṛṣṭānte tatra setyanyathā kathaṃ |	དེ་ལས་དེ་གཞན་ཇི་ལྟ་བུ་༎ གཉིས་མཐོང་ནས་ནི་ཤེས་ཤེ་ན་༎
 dvau dṛṣṭvā vidma iti ced vyāpteḥ prāk dvayadṛk kathaṃ ||“	ཁྱབ་སྔོན་གཉིས་མཐོང་ཇི་ལྟར་ཡིན་༎
 vyāptipakṣadharmmatve hi svavākyābhyāṃ yena tena prayuktābhyāṃ sūcyete na tu sākṣāt pratīyete |	ཁྱབ་པ་དང་ཕྱོགས་ཀྱི་ཆོས་རིམ་པ་གང་ཡང་རུང་བས་རབ་ཏུ་སྦྱོར་བའི་རང་གི་ཚིག་དག་གིས་བསྟན་གྱི་། 
 vācaḥ svayamapramāṇatvāt | yadāha,-	དེ་དག་མངོན་དུ་རྟོགས་པ་ནི་མ་ཡིན་ཏེ་ཚིག་གི་བདག་ཉིད་ནི་ཚད་མ་ཡིན་པའི་ཕྱིར་རོ་༎ རང་ཉིད་ནུས་པ་མེད་ན་ཡང་༎
 śaktasya sūcakaṃ heturvaco 'śaktamapi svayamiti |	གཏན་ཚིགས་ཀྱིས་ནི་ནུས་པ་སྟོན་༎ ཞེས་གསུངས་པ་ཡིན་ནོ་༎
 sūcitayo 'stu tayoḥ sattve hetau prathamatarapakṣadharmmatvaviṣayameva pramāṇamabhimukhībhavatu |	དེ་དག་བརྗོད་པས་ཀྱང་དང་པོ་ཡོད་པའི་གཏན་ཚིགས་ལ་། ཕྱོགས་ཀྱི་ཆོས་ཀྱི་ཡུལ་ཅན་ཉིད་ཀྱི་ཚད་མ་མངོན་དུ་འགྱུར་བ་ཡིན་ཏེ་།
 tena pramāṇena dharmmiṇi sidvasya sattvasya paścādvyāptiḥ pramāṇāntareṇa gṛhyata iti kasya vaiyarthyamiti |	ཚད་མ་དེས་ཆོས་ཅན་ལ་ཡོད་པ་གྲུབ་ན་ཕྱིས་ཁྱབ་པ་ཚད་མ་གཞན་གྱིས་འཛིན་ཏོ་ཞེས་གང་གིས་ན་དོན་མེད་པ་ཡིན་༎ ཁྱོད་ཀྱི་ཕྱོགས་ལ་ཡང་༎
 pratyakṣe 'pi dṛṣṭāntadharmmiṇi prathamaṃ heturgṛhyate paścādvyāptirityeṣa eva kramaḥ anyathā dṛṣṭāntadharmmiṇi vyāptirgṛhītetyetadeva na syāt	དཔེའི་ཆོས་ཅན་ལ་དང་པོ་གཏན་ཚིགས་འཛིན་ཅིང་ཕྱིས་ནི་ཁྱབ་པའོ་ཞེས་བྱ་བའི་རིམ་པ་འདི་ཡིན་ནོ་༎ གཞན་དུ་དཔེའི་ཆོས་ཅན་ལས་ཁྱབ་པ་འཛིན་ཏོ་ཞེས་བྱ་བ་དེར་མི་འགྱུར་ཏེ་ཡིན་ནོ་༎ 
 dṛṣṭāntadharmmiṇyadṛṣṭasyaiva hetorvyāptigrahaṇāt |	། དཔེའི་ཆོས་ཅན་མ་མཐོང་བས་གཏན་ཚིགས་ཀྱི་ཁྱབ་པ་འཛིན་པའི་ཕྱིར་རོ་༎
 yadyevaṃ sādhyadharmmo 'pi vyāptigrahaṇādhikaraṇe dharmmiṇi grahītabya eva yathā vanhidhūmayoriti cet | na |	གལ་ཏེ་དེ་ལྟར་ན་ཁྱབ་པ་འཛིན་པའི་རྟེན་ཆོས་ཅན་འཛིན་ན་། བསྒྲུབ་པར་བྱ་བའི་ཆོས་ཀྱང་འཛིན་པ་ཉིད་དེ་། མེ་དང་དུ་བ་བཞིན་ནོ་ཞེས་ཟེར་ན་མ་ཡིན་ཏེ་།
 tatra dṛṣṭasya hetorvipakṣe bādhakavṛttimātrādeva vyāptisidveḥ |	དེ་ལ་མཐོང་བའི་གཏན་ཚིགས་མི་མཐུན་པའི་ཕྱོགས་ལ་གནོད་པ་ཅན་ཞུགས་པ་ཙམ་ཉིད་ཀྱིས་ཁྱབ་པ་གྲུབ་པའི་ཕྱིར་རོ་༎ དེ་བས་ན་༄༣༡༢ཨ་༌་༎ ཡང་ཁྱབ་པ་འཛིན་པའི་སྔོན་དུ་སྐད་ཅིག་མ་ཉིད་དུ་ནམ་ཡང་གྲུབ་པ་མེད་དེ་།
 jñātaścaivaṃ na khalu vyāptigrahaṇāt prāk kṣaṇikasya kvacidapi sidvirasti tasyānumeyatvāt | asidvāyāñca vyāptāvanumānāpravṛtteḥ | sādhanāntarasya ca tadarthamananusaraṇāt | anusaraṇe 'pyanavasthā syāt | avasthāne tāvat prayāsasya vaiyarthyāt |	དེ་རྗེས་སུ་དཔག་པར་བྱ་བའི་ཕྱིར་དང་། ཁྱབ་པ་མ་གྲུབ་ན་རྗེས་སུ་དཔག་པར་མི་འགྲུབ་པའི་ཕྱིར་དང་། སྒྲུབ་པར་བྱེད་པ་གཞན་ཡང་དེའི་རྗེས་སུ་མི་འབྲང་བའི་ཕྱིར་དང་། རྗེས་སུ་འབྲང་ན་ཡང་ཐུག་པ་མེད་པོར་ཐལ་པར་འགྱུར་བའི་ཕྱིར་དང་། ཐུག་པ་ཡོད་ན་ཡང་དེ་ཙམ་གྱིས་རྩོལ་བ་དོན་མེད་པའི་ཕྱིར་དང་། བཟློག་ན་གནོད་པ་ཅན་གྱི་སྟོབས་ཉིད་ཀྱིས་ཁྱབ་པ་གྲུབ་པ་ལ་གནོད་པ་མེད་པའི་ཕྱིར་རོ་༎ མེ་དང་དུ་བ་མ་མཐོང་བར་ཡང་རྒྱུ་དང་འབྲས་བུའི་ངོ་བོ་གྲུབ་པ་མེད་དོ་༎
 viaparyyaye vyāptibalādeva vyāptisidveravighātāt | vanhidhūmayostu nādṛṣṭayoḥ kāryyakāraṇabhāvasidveḥ | tatsidvau na vipakṣe bādhakavṛttiriti dvayadarśanavyapekṣā?	དེ་གྲུབ་པས་བཟློག་ན་གནོད་པ་ཅན་འཇུག་པ་གཉིས་མཐོང་བ་ལ་ལྟོས་པ་མེ་དང་དུ་བའི་ཁྱབ་པ་གྲུབ་པོ་༎ ཡོད་པ་དང་སྐད་ཅིག་མ་གཉིས་ནི་དེ་ལྟར་མ་ཡིན་ཏེ་། ཇི་སྐད་དུ་བསྟན་པའི་རིགས་པས་གྲུབ་པའི་ཕྱིར་རོ་༎
 vanhidhūmayorvyāptisidviḥ sattvakṣaṇikatvayostu naivaṃ | yathoktanyāyena vyāptisidveḥ | tasmāt sattvamātrasya tatra dharmmiṇi sidvasya bādhakavaśādvyāptiḥ setsyatītyeṣitavyaṃ |	དེ་བས་ན་ཡོད་པ་ཙམ་ཆོས་ཅན་དེ་ལ་གྲུབ་པས་ཁྱབ་པ་གྲུབ་པའི་སྟོབས་ཀྱིས་གྲུབ་པར་འདོད་པར་བྱའོ་༎ 
 tadvadantarvyāptāvapi |	དེ་བཞིན་དུ་ནང་གི་ཁྱབ་པ་ལ་ཡང་ཡིན་ནོ་༎
 te ime vyāptipakṣadharmmatve svasvapramāṇavyavacchedyasādhanavākye na tu kevalaṃ sūcayitavye |	ཁྱབ་པ་དང་ཕྱོགས་ཀྱི་ཆོས་དེ་ལ་ཡང་། རང་རང་གི་ཚད་མས་ཡོངས་སུ་གཅོད་པར་བྱེད་པའི་སྒྲུབ་པར་བྱེད་པའི་ངག་གིས་ངེས་པ་འབའ་ཞིག་བསྟན་པར་བྱ་བ་ཡིན་ནོ་༎ ངག་གཅིག་གིས་གཉི་ག་བསྟན་པར་མི་ནུས་པས་༎
 na cānyataravākyena śakyamubhayaṃ sūcayitumiti kuto 'nyataravākyavaiyarthyaṃ || ekasyaiva hi dharmmasya kramātrairūpyaniścayaḥ |	གང་གིས་ན་ངག་གཞན་དོན་མེད་པ་ཡིན་༎ གཅིག་ཉིད་ཀྱིས་ནི་གང་ཕྱིར་ཆོས་༎ རིམ་པ་བཞིན་ཚུལ་གསུམ་ངེས་པ་ཡིས་༎ བརྗེད་པས་རྗེས་དཔག་མེད་པའི་ཕྱིར་༎
 vismṛtāvanumābhāvāt tat kiṃ vyarthānumākhileti ||	དེ་ཅིས་རྗེས་དཔག་དོན་མེད་ཡིན་༎
 api ca saṃgrahaślokaḥ,-	ཞེས་བྱ་བ་ནི་བསྡུ་བའི་ཚིགས་སུ་བཅད་པའོ་༎ གཞན་ཡང་། གནོད་པས་བསྒྲུབ་བྱ་གྲུབ་ཅེ་ན་༎
 bādhakāt sādhyasidviścedvyartho hetvantaragrahaḥ |	གཏན་ཚིགས་གཞན་གཟུང་དོན་མེད་ཡིན་༎ གནོད་པས་དེ་མ་གྲུབ་ཅེ་ན་།
 bādhakāttadasidviścedvyartho dharmmyantaragrahaḥ ||	ཆོས་གཞན་གཟུང་བ་དོན་མེད་ཡིན་༎
 yadi hi dharmmiṇi vyāptiḥ sidhyantyeva sādhyasidvimantarbhāvayati |	གལ་ཏེ་ཆོས་ཅན་ལ་ཁྱབ་པ་གྲུབ་པ་ཉིད་ཀྱིས་སྒྲུབ་པར་བྱ་བ་ནང་དུ་འདུ་བར་འགྱུར་ན་། 
 nanu lābha evaiṣaḥ |	རྙེད་པ་ཐོབ་པ་མ་ཡིན་ནམ་༎
 byāptiprasādhakādeva pramāṇāt sādhyasidveḥ sattvahetvapāśrayaṇaprayāsasya nirasanāt |	ཁྱབ་པ་སྒྲུབ་པར་བྱེད་པ་ཉིད་ཀྱི་ཚད་མ་ལས་བསྒྲུབ་བྱ་གྲུབ་པའི་ཕྱིར་དང་། ཡོད་པའི་གཏན་ཚིགས་ཀྱི་རྟེན་གྱི་འབད་པ་སེལ་པའི་ཕྱིར་རོ་༎
 na hi vyasanamevaitalliṅgāntarānusaraṇaṃ nāma |	གང་གི་ཕྱིར་རྟགས་ཀྱི་རྗེས་སུ་འབྲང་བ་ཞེས་བྱ་བ་ཞེན་པ་ནི་མ་ཡིན་ནོ་༎
 atha na vyāptisādhakāt sādhyasidviḥ |	འོན་ཏེ་ཁྱབ་པ་སྒྲུབ་པར་བྱེད་པ་ལས་བསྒྲུབ་བྱ་མ་གྲུབ་ན་།
 na tarhyantarvyāptau hetuvaiyarthyamiti kimakāṇḍakātaratayā bahu taramāyāsamāviśasi |	དེའི་ཚེ་ནང་གི་ཁྱབ་པའི་གཏན་ཚིགས་དོན་མེད་པ་མ་ཡིན་པས་སྐབས་མ་ཡིན་པ་ལ་སྡང་བ་ཉིད་ཀྱི་ཤིན་ཏུ་སྡུག་བསྔལ་བ་མང་པོ་ལ་ཅིའི་ཕྱིར་འཇུག་། 
 dvayaṃ hi bhavataḥ sādhyaṃ dṛṣṭāntadharmmiṇi vṛttiḥ sādhyadharmmiṇi ca |	ཁྱེད་ཀྱི་༄༣༡༢བ་བསྒྲུབ་པར་བྱ་བ་གཉིས་ཡིན་ཏེ་། དཔེའི་ཆོས་ཅན་ལ་འཇུག་པ་དང་། བསྒྲུབ་པར་བྱ་བའི་ཆོས་ཅན་ལ་འཇུག་པ་སྟེ་།
 yathākramaṃ byāptipakṣadharmmatvayoḥ sidvyarthaṃ |	རིམ་པ་ཇི་ལྟ་བ་བཞིན་དུ་ཁྱབ་པ་དང་། ཕྱོགས་ཀྱི་ཆོས་ཉིད་དག་གྲུབ་པའི་ཕྱིར་རོ་༎
 nanu yadā pratiniyate dharmmiṇi vivādaḥ, tadvahirbhūte ca dharmmiṇi vyāptigrahaṇaṃ tadānīṃ bhavedvaiyarthyaṃ |	ཡང་ཁྱོད་ལ་སོ་སོར་ངེས་པའི་ཆོས་ཅན་ལ་རྩོད་པ་དེ་ལས་ཕྱི་རོལ་དུ་གྱུར་བའི་ཡང་ཆོས་ཅན་ལ་ཁྱབ་པ་འཛིན་པ་ནི་དེའི་ཚེ་དོན་མེད་པར་འགྱུར་རོ་༎
 yadā tu vastumātre vivādaḥ tadā sarvvavastuṣu hetorvṛttistvayāpi sādhyā mayāpi ceti katamasmin dharmmiṇi hetorvṛttisādhanaṃ mama vyarthaṃ bhaviṣyati	གང་གི་ཚེ་ཡང་དངོས་པོ་ཙམ་ལ་རྩོད་པ་དེའི་ཚེ་། དངོས་པོ་ཐམས་ཅད་ལ་གཏན་ཚིགས་འཇུག་པ་ནི་ཁྱོད་དང་བདག་གིས་ཀྱང་བསྒྲུབ་པར་བྱ་བའི་ཕྱིར་ཆོས་ཅན་འགའ་ཞིག་ལ་གཏན་ཚིགས་འཇུག་པ་སྒྲུབ་པར་བྱེད་པ་དག་ལ་དོན་མེད་པར་ཇི་ལྟར་འགྱུར་། རེ་ཞིག་ཇི་ལྟར་སྤྱིའི་ཁྱབ་པ་ཡིན་ཞེ་ན་།
 kathamidānīṃ bahirvyāptirvivādādhikaraṇaṃ bhūta evānyatamasmin vyāptisādhanāt | tāvanmātralakṣaṇatvācca sādhyadharmmiṇaḥ | bādhakaṃ pramāṇaṃ pravarttamānamantargatamapi dharmmiṇaṃ bahiṣkarotīti cet etadeva kathaṃ bhavatu bādhakena pravarttamānenaiva tasmin sādhyasādhanāt	རྩོད་པའི་གཞིར་གྱུར་པ་ཉིད་ལས་གཞན་གང་ཡང་རུང་བ་ལ་ཁྱབ་པ་སྒྲུབ་པར་བྱེད་པའི་ཕྱིར་། སྒྲུབ་པར་བྱེད་པའི་ཆོས་ཅན་དེ་ཙམ་གྱིས་མཚན་ཉིད་མ་ཡིན་པའི་ཕྱིར་གནོད་པ་ཅན་གྱི་ཚད་མ་འཇུག་པས་ནང་དུ་ཆུད་པའི་ཡང་ཆོས་ཅན་ཡང་ཕྱི་རོལ་དུ་བྱེད་དོ་ཞེས་ཟེར་ན་། ། དེ་དེ་ཉིད་ཡིན་པར་ཇི་ལྟར་འགྱུར་། གནོད་པ་ཅན་ཞུགས་པ་ཉིད་ཀྱི་ཆོས་ཅན་དེ་ལ་བསྒྲུབ་པར་བྱ་བ་སྒྲུབ་པར་བྱེད་པའི་ཕྱིར་དང་། 
 sādhyasaṃśayopagame sādhyadharmmiṇi lakṣaṇopagamāditi cet ayuktametat |	བསྒྲུབ་པར་བྱ་བའི་རང་གི་ངོ་བོ་རྟོགས་ན་བསྒྲུབ་པར་བྱ་བའི་ཆོས་ཅན་གྱི་མཚན་ཉིད་ལས་འདས་པའི་ཕྱིར་རོ་ཞེ་ན་། དེ་ནི་རིགས་པ་མ་ཡིན་ཏེ་།
 bādhakamātrāt na sādhyasidvirityasminpakṣe dharmmyantaraparigrahavaiyarthyābhidhānāt |	གནོད་པ་ཅན་ཙམ་གྱིས་བསྒྲུབ་པར་བྱ་བ་མ་གྲུབ་པོ་ཞེས་བྱ་བ་ཕྱོགས་འདི་ལ་གཞན་ཡོངས་སུ་འཛིན་པ་དོན་མེད་དོ་ཞེས་བརྗོད་པའི་ཕྱིར་རོ་༎ 
 bādhakāt sādhyasidvirityasmiṃstu pakṣe sādhanavaiyarthyamāpāditaṃ |	གནོད་པ་ཅན་གྱིས་བསྒྲུབ་བྱ་གྲུབ་པོ་ཞེས་བྱ་བའི་ཕྱོགས་འདི་ལ་ཡང་སྒྲུབ་པར་བྱེད་པ་དོན་མེད་དོ་ཞེས་བསྟན་ཟིན་ཏོ་༎
 tasmādvādhakamātreṇa sādhyāsidvau na kvacit sandehanivṛttiḥ |	དེ་ལྟ་བས་ན་གནོད་པ་ཅན་ཙམ་གྱིས་བསྒྲུབ་བྱ་གྲུབ་ན་འགའ་ལ་ཡང་ཐེ་ཚོམ་མི་ལྡོག་པར་མི་འགྱུར་རོ་༎
 sandehānivṛttau na vahiṣkaraṇamavahiṣkṛtaśca sādhyadharmmyeveti tatra vyāptirantarvyāptireva nedānīṃ bahirvyāptervārttāpi |	ཐེ་ཚོམ་ལོག་ན་ཕྱི་རོལ་དུ་བྱེད་པ་འང་མ་ཡིན་དང་། བསྒྲུབ་པར་བྱ་བའི་ཆོས་ཅན་ལས་ཀྱང་ཕྱི་རོལ་དུ་བྱས་པ་མ་ཡིན་པས་དེ་ལ་ཁྱབ་པ་ནི་ནང་གི་ཁྱབ་པ་ཉིད་དེ་། ད་ནི་ཕྱིའི་ཁྱབ་པ་བརྗོད་པ་ཙམ་ཡང་མེད་དོ་། དེ་བས་ན་ཕྱིའི་ཁྱབ་པ་འདིའི་ཕྱོགས་སུ་ཇི་ལྟར་འགྱུར་།
 tadiyaṃbahirvyāptiramusmin pakṣe kathaṃ bhavati yadi pratiniyate dharmmiṇi vivādaḥ | tadvahirbhūte ca dharmmiṇi vyāptigrahaṇambhavati |	གལ་ཏེ་ཡང་སོ་སོར་ངེས་པའི་ཆོས་ཅན་ལ་རྩོད་པ་དང་། དེ་ལས་ཕྱི་རོལ་དུ་གྱུར་པའི་ཆོས་ཅན་ལ་ཁྱབ་པ་འཛིན་པར་འགྱུར་ན་།
 tatra ca durudvaraḥ dharmmyantaraparigrahavaiyarthyadoṣaḥ |	དེ་ལ་ཡང་ཆོས་གཞན་ཡོངས་སུ་འཛིན་པ་དོན་མེད་པའི་ཉེས་པ་བསལ་བའི་བཀའ་སྟེ་།
 bādhakamātreṇa tu sādhyasidvau hetyantarameva vyarthaṃ |	གནོད་པ་ཅན་ཙམ་གྱིས་བསྒྲུབ་བྱ་གྲུབ་ན་གཏན་ཚིགས་གཞན་དོན་མེད་པ་ཁོ་ནའོ་༎ ༄༣༡༣ཨ་༌་༎ གཞན་ཡང་། ཡོད་པའི་གཏན་ཚིགས་ཁྱད་པར་གྱིས་༎
 api ca satvahetorviśeṣeṇa na vahirvyāptisambhavaḥ | asidve dharmmiṇaḥ sattve vivādānavatārataḥ |	ཕྱི་ཡི་ཁྱབ་པ་མི་སྲིད་དེ་༎ ཆོས་ཅན་ཡོད་པ་མི་གྲུབ་ན་༎ རྩོད་པ་འཇུག་པར་མི་འགྱུར་རོ་༎ དེ་ལ་གྲུབ་པས་ཁྱབ་པ་ཡང་༎
 tatrāsidvasya ca vyāptigrahaṇe sādhyadharmmiṇi ||	འཛིན་ན་བསྒྲུབ་བྱའི་ཆོས་ཅན་ལ་༎
 vyāptigrahaḥ kathaṃ nasyāddṛṣṭānte 'pi na vā bhavet ||	ཁྱབ་པ་འཛིན་པར་ཅིས་མི་འགྱུར་༎
 yatra hi dharmmiṇi dṛṣṭasya hetorvyāptiḥ pratīyate tatra tasya vyāptigrahaṇamākhyāyate |	ཡང་ན་དཔེར་ལ་འགྱུར་མ་ཡིན་༎ ཆོས་ཅན་འགའ་ཞིག་ལ་མཐོང་བའི་གཏན་ཚིགས་ཀྱི་ཁྱབ་པ་རྟོགས་པ་དེ་ལ་དེའི་ཁྱབ་པ་འཛིན་པར་བསྟན་ཏོ་༎ བསྒྲུབ་པར་བྱ་བའི་ཆོས་ཅན་ལ་ཡང་ཁྱབ་པ་མཐོང་སྟེ་།
 dṛṣṭañca sādhyadharmmiṇi sattvamanyathā vimatyayogāditi kathaṃ nāntarvyāptiḥ |	གཞན་དུ་ན་ལོག་པར་རྟོགས་པ་མི་རིགས་པའི་ཕྱིར་ཇི་ལྟར་ཕྱིའི་ཁྱབ་པ་ཡིན་༎
 tathāpi sādhanavaiyarthyaniṣedhāya bahireva gṛhṇīma iti cet tat kimidānīṃ tvadicchānurodhāt dharmmiṇi hetorddarśanamadarśanamastu |	དེ་ལྟ་ན་ཡང་སྒྲུབ་པར་བྱེད་པ་དོན་མེད་པས་ཕྱི་རོལ་ཉིད་ཀྱི་ཁྱབ་པ་གཟུང་བར་བྱའོ་། ཞེ་ན་། དེ་བས་ན་ད་ལྟར་གྱི་ཁྱོད་ཀྱི་འདོད་པའི་ངོར་ཆོས་ཅན་ལ་གཏན་ཚིགས་མ་མཐོང་བར་ཇི་ལྟར་འགྱུར་༎ 
 darśanaviśeṣe vā bahireva vyāptigrahaṇavyavasthāstu |	ཡང་ན་མཐོང་བ་ལ་ཁྱད་པར་མེད་ན་ཡང་༎ ཕྱི་རོལ་ཉིད་ཀྱི་ཁྱབ་པ་གཟུང་བར་རྣམ་པར་གཞག་། 
 ubhayatra dṛṣṭasya vyāptigrahaṇe 'pyasti bahirvyāptibhāga iti cet |	གཉི་ག་ལ་མཐོང་བའི་ཁྱབ་པ་འཛིན་པ་ཡང་ཕྱི་རོལ་གྱི་ཁྱབ་པའི་ཆ་ཡོད་དོ་ཞེ་ན་། 
 nanu kimarthamiyān bhāgo yatnena saṃrakṣyate |	ཅིའི་ཕྱིར་ཁྱབ་པ་ཙམ་འབད་པས་སྲུང་།
 mābhūt hetuvaiyarthyamiti cet |	གཏན་ཚིགས་དོན་མེད་པར་མ་གྱུར་ཅིག་ཅེས་སྨོན་ཏེ་།
 nanu yadi bādhakavṛttimātreṇa vyāptigrahaṇādhikaraṇe dharmmiṇi sādhyasidveḥ sādhanavaiyarthyamantarvyāptau tadetadvahirvyāptāvapi tulyaṃ |	གནོད་པ་ཅན་ཞུགས་པ་ཙམ་གྱི་ཁྱབ་པ་འཛིན་པའི་གཞི་ཆོས་ཅན་ལ་བསྒྲུབ་བྱ་སྒྲུབ་པའི་ཕྱིར་ནང་གི་ཁྱབ་པ་ལ་སྒྲུབ་པར་བྱེད་པ་དོན་མེད་པ་མ་ཡིན་ནམ་ཞེ་ན་། དེ་ནི་ནང་གི་དང་ཕྱིའི་ཁྱབ་པ་ལ་ཡང་མཚུངས་པ་མ་ཡིན་ནོ་༎
 tasmād vyasanamātraṃ bahirvyāptigrahaṇe viśeṣeṇa sattve hetau kevalaṃ jaḍadhiyāmeva niyamena dṛṣṭāntasāpekṣaḥ sādhanaprayogaḥ paritoṣāya jāyate	དེ་བས་ན་ཕྱིའི་ཁྱབ་པ་འཛིན་པ་ནི་ཡོད་པའི་གཏན་ཚིགས་ཀྱི་ཁྱད་པར་ལ་ཞེན་པ་ཙམ་མོ་༎ དཔེ་ལ་ལྟོས་པའི་སྒྲུབ་པར་བྱེད་པའི་སྦྱོར་བ་ནི་རྨོངས་པའི་བློ་ཅན་འབའ་ཞིག་ཁོ་ན་ངེས་པར་དགའ་བ་སྐྱེད་པ་ཡིན་ནོ་༎
 teṣāmevānugrahārthamācāryyo dṛṣṭāntamupādatte | yat sattatkṣaṇikaṃ yathā ghaṭa iti |	དེ་དག་རྗེས་སུ་གཟུང་བའི་དོན་དུ་སློབ་དཔོན་གྱིས་གང་ཡོད་པ་དེ་ནི་སྐད་ཅིག་མ་ཡིན་ཏེ་། བུམ་པ་བཞིན་ནོ་ཞེས་དཔེ་ཉེ་བར་བསྟན་ཏོ་༎
 paṭumatayastu naivaṃ dṛṣṭāntamapekṣante |	བློ་ག-ཡེར་བག་ཅན་ནི་ཡང་དཔེའི་སྦྱོར་བ་ལ་ལྟོས་པ་མ་ཡིན་ནོ་༎ དེ་ཕྱིར་དཔེ་ལ་ཆགས་རྣམས་ལ་༎
 “tasmāddṛṣṭāntaroktebhyo ghaṭaṃ dṛṣṭāntamabravīt |	བུམ་པའི་དཔེ་ནི་བསྟན་པ་མཛད་༎
 tathā māneṣvavaiyarthyādantarvyāptāvapīṣyatām ||	དེ་མི་དགོས་ལ་དོན་མེད་ཡིན་༎ ནང་གི་ཁྱབ་པ་བློ་ལྡན་ལའོ་༎
 ityantaraślokaḥ ||	ཞེས་བྱ་བ་ནི་བར་སྐབས་ཀྱི་ཚིགས་སུ་བཅད་པའོ་༎
 kathamidānīṃ anumeye sattvameva sattvameva sapakṣa eva sattvamasapakṣe vāsattvameva niścitamiti hetostrairupyamavagantavyam | “matau sapakṣāsapakṣau sādhyadharmmayutāyutau | sattvāsattve tatra hetoste grāhye yatra tatra vā ||“	ད་ནི་ཇི་ལྟར་རྗེས་སུ་དཔག་པར་བྱ་བ་ལ་ཡོད་པ་ཉིད་དང་༎ མཐུན་པའི་ཕྱོགས་ཉིད་ལ་ཡོད་པ་དང་། མི་མཐུན་པའི་ཕྱོགས་ལ་མེད་པ་ཉིད་དུ་ངེས་ཞེས་བྱ་བ་ཇི་ལྟ་རྟོགས་པར་བྱ་ཞེ་ན་། བསྒྲུབ་བྱའི་ཆོས་ལྡན་མི་ལྡན་ལས་༎ མཐུན་ཕྱོགས་མི་མཐུན་ཕྱོགས་སུ་འདོད་༎ དེ་ལ་༄༣༡༣བ་གཏན་ཚིགས་ཡོད་མེད་ནི་༎ གང་ཡིན་དེ་རུ་གཟུང་བར་བྱ་༎
 sādhyadharmmayuktaḥ sarvvaḥ sāmānyena sapakṣaḥ, atadyuktaścāsapakṣa iti |	བསྒྲུབ་པར་བྱ་བའི་ཆོས་དང་ལྡན་པ་ཐམས་ཅད་ནི་སྤྱིར་མཐུན་པའི་ཕྱོགས་ཡིན་ལ་དེ་དང་མི་ལྡན་པ་ནི་མི་མཐུན་པའི་ཕྱོགས་ཡིན་ནོ་༎
 tasmin sapakṣa eva sattvamasapakṣe cāsattvameva yathākramamanvayavyatirekau tau punaryatra tatra vā dharmmiṇi grahītavyau yatra śakyau grahītum	མཐུན་པའི་ཕྱོགས་དེ་ཉིད་ལ་ཡོད་པ་དང་། མི་མཐུན་པའི་ཕྱོགས་ལ་མེད་པ་ཉིད་དེ་། རིམ་པ་ཇི་ལྟ་བ་བཞིན་དུ་རྗེས་སུ་འགྲོ་བ་དང་ལྡོག་པ་དག་ཡིན་ནོ་༎ དེ་དག་ཀྱང་གང་ཡང་རུང་བའི་ཆོས་ཅན་དེར་གཟུང་བར་བྱ་སྟེ་། གང་དུ་གཟུང་བར་ནུས་པར་རོ་༎
 tadiha sattvasya sarvvato 'kṣaṇikādvyāvṛttau bādhakabalāt sidvāyāṃ yat sattat kṣaṇikameveti anvayaḥ sādhyadharmmiṇyavagṛhyate |	གང་འདིར་ཡོད་པ་སྐད་ཅིག་མ་མ་ཡིན་པ་ཐམས་ཅད་ལས་ལོག་པར་གནོད་པ་ཅན་གྱི་ཚད་མའི་སྟོབས་གྲུབ་ན་གང་ཡོད་པ་དེ་ནི་སྐད་ཅིག་མ་ཉིད་ཡིན་ནོ་ཞེས་བྱ་བའི་རྗེས་སུ་འགྲོ་བ་སྒྲུབ་པའི་ཆོས་ཅན་ལ་བཟུང་བ་ཡིན་ཏེ་། 
 tatra dṛṣṭasya hetorvyāptigrahaṇāt dharmmyantarāsambhavāt | sambhave 'pi tadanusaraṇavaiyarthyāt |	དེ་ལ་མཐོང་བའི་གཏན་ཚིགས་ཀྱི་ཁྱབ་པ་གཟུང་བའི་ཕྱིར་དང་། ཆོས་གཞན་མི་སྲིད་པའི་ཕྱིར་དང་། སྲིད་ན་ཡང་དེའི་རྗེས་སུ་འབྲང་བའི་དོན་ཡོད་པའི་ཕྱིར་རོ་༎
 yadyevamasādhāraṇo nāma kathamanaikāntika uktaḥ ||	གལ་ཏེ་དེ་ལྟར་ན་ཐུན་མོང་མ་ཡིན་པའི་མ་ངེས་པ་ཡིན་པར་ཇི་སྐད་སྨྲ་། ཐུན་མོང་མ་ཡིན་གཏན་ཚིགས་ཀྱི་༎
 asādhāraṇatāṃ hetudoṣammūḍhavyapekṣayā | abravīdagrahādvyāpti(pte)	ཉེས་པ་རྨོངས་ལ་ལྟོས་པ་ཡིན་༎ ཁྱབ་པ་མི་འཛིན་ཕྱིར་བསྟན་བྱའི་༎
 rnaivaṃ sarvvopasaṃhṛtau || uktametajjaḍadhiyo dharmmyantara eva vyāptigrahaṇaṃ pratipannāḥ |	ཐམས་ཅད་བསྡུས་ལ་མ་ཡིན་ནོ་༎ འདི་སྐད་བསྟན་ཏེ་། བློ་རྨོངས་པ་དག་ཆོས་གཞན་ཉིད་ལ་ཞུགས་པ་དེའི་མངོན་པའི་ང་རྒྱལ་ལ་ལྟོས་ནས་།
 tadabhimānāpekṣayāsādhāraṇamanaikāntikamāha śrāvaṇatvaṃ dṛṣṭāntābhāvāt | sādhyadharmmiṇi ca vyāptiraniṣṭeragṛhītāyāṃ vyāptau sandigdhobhayatayāniścayakaratvāt |	མཉན་པར་བྱ་བ་ཡིན་པའི་ཕྱིར་ཞེས་བྱ་བ་ཐུན་མོང་མ་ཡིན་པའི་མ་ངེས་པ་ཡིན་པར་བསྟན་ཏོ་༎ དཔེ་མེད་པའི་ཕྱིར་དང་། བསྒྲུབ་པར་བྱ་བའི་ཆོས་ཅན་ལ་ཁྱབ་པ་མི་འདོད་པའི་ཕྱིར་དང་། ཁྱབ་པ་མ་བཟུང་ན་གཉི་ག་ཐེ་ཚོམ་ཟ་བས་མ་ངེས་པར་བྱེད་པའི་ཕྱིར་རོ་༎
 athavā asādhāraṇataiva śrāvaṇatvasya mūḍhābhimānopakalpitā | dṛṣṭaiva hi śabdavyaktidharmmiṇī vivādādhikaraṇāt | anyathā dharmmyasidviprasaṅgācca |	ཡང་ན་མཉན་པར་བྱ་བ་ཉིད་ཀྱི་ཐུན་མོང་མ་ཡིན་པ་ཉིད་དུ་རྨོངས་པའི་མངོན་པའི་ང་རྒྱལ་གྱིས་བསྟན་པ་ཡིན་ཏེ་༏་གང་གི་ཕྱིར་ཆོས་ཅན་ལ་སྒྲའི་གསལ་བ་ཉིད་མཐོང་བ་ཉིད་རྩོད་པའི་གཞི་ཡིན་པའི་ཕྱིར་རོ་༎ གཞན་དུ་ན་ཆོས་ཅན་མ་གྲུབ་པར་ཐལ་བར་འགྱུར་རོ་༎
 dṛṣṭādṛṣṭaśabdavyaktisādhāraṇañca śrāvaṇatvaṃ hetuḥ | dhūmasāmānyavat |	མཐོང་བ་དང་མ་མཐོང་བའི་སྒྲའི་གསལ་བ་གཉིས་མཉན་པའི་གཏན་ཚིགས་ཡིན་ཏེ་དུ་བའི་སྤྱི་ཡིན་ནོ་༎ 
 tataḥ sarvvopasaṃhāravatyāḥ vyāpteḥ sambhavāt sattvādivadadṛṣṭameva sādhanaṃ śrāvaṇatvākhyaṃ |	དེ་བས་ན་ཐམས་ཅད་བསྡུས་པ་དང་ལྡན་པའི་ཁྱབ་པ་སྲིད་པའི་ཕྱིར་ཡོད་པ་ལ་སོགས་པ་བཞིན་དུ་མཉན་པར་བྱ་བ་ཉིད་སྒྲུབ་པར་བྱེད་པ་སྐྱོན་མེད་པར་བཤད་དོ་༎
 kramayaugapadyānupalambha eva cātra bādhakaṃ pramāṇaṃ |	འདིར་རིམ་དང་ཅིག་ཅར་མི་དམིགས་པ་ཉིད་གནོད་པ་ཅན་གྱི་ཚད་མ་ཡིན་ལ་།
 śrotrajñānajana katvameva hi śrāvaṇatvaṃ |	མཉན་པའི་ཤེས་པ་སྐྱེད་པར་བྱེད་པ་ཉིད་ནི་མཉན་པར་བྱ་བ་ཉིད་དོ་༎
 tasmānmūḍhavyapekśayāsādhāraṇatvāt |	དེ་ལྟ་བས་ན་རྨོངས་པ་ལྟོས་ན་མཉན་པར་བྱ་བ་༄༣༡༤ཨ་༌་༎
 asādhāraṇasya sarvvopasaṃhārāyogāt | sādhya dharmmiṇi vyāptipratītāveva sādhyapratīteḥ sādhanavaiphalyaṃ syādeva |	ཉིད་ཐུན་མོང་མ་ཡིན་པའི་ཕྱིར་དང་། ཐུན་མོང་མ་ཡིན་པ་ལ་ཡང་ཐམས་ཅད་ཉེ་བར་བསྡུས་པ་མི་རིགས་པའི་ཕྱིར་དང་། བསྒྲུབ་པར་བྱ་བའི་ཆོས་ཅན་ཁྱབ་པ་རྟོགས་པས་བསྒྲུབ་བྱ་རྟོགས་པའི་ཕྱིར་སྒྲུབ་པར་བྱེད་པ་དོན་མེད་པ་ཉིད་དུ་འགྱུར་རོ་༎
 tanmābhūvvaiphalyamiti naiva vyāptirgrahītavyā |	འབྲས་བུ་མེད་པར་མ་གྱུར་ཅིག་ཅེས་སྨོས་པས་ཁྱབ་པ་མི་འཛིན་ནོ་༎
 tasyāmagṛhītāyāṃ sandigdhobhayatayā syādanaikāntikatvaṃ |	དེ་མ་བཟུང་ན་གཉི་ག་ལ་ཐེ་ཚོམ་ཟ་བས་མ་ངེས་པ་ཉིད་དུ་འགྱུར་རོ་༎
 sarvvopasaṃhāreṇa tu vyāptigrahaṇe yathoktanyāyena sādhanavaiphalyābhāvāt | aduṣṭaṃ sattvādi sādhanameveti veditavyam | tadevamubhayathā mūḍhajanāpekṣayāsādhāraṇamanaikāntikamuktam |	ཐམས་ཅད་ཉེ་བར་བསྡུས་པས་ཁྱབ་པ་བཟུང་ན་ཇི་སྐད་བསྟན་པའི་རིགས་པས་སྒྲུབ་པར་བྱེད་པ་འབྲས་བུ་ཡོད་པའི་ཕྱིར་ཡོད་པ་ལ་སོགས་པའི་སྒྲུབ་པར་བྱེད་པའི་སྐྱོན་མེད་པ་རིག་པར་བྱའོ་༎ དེ་ལྟར་ན་རྣམ་པ་གཉིས་ཀྱིས་ཐུན་མོང་མ་ཡིན་པའི་མ་ངེས་པ་བསྟན་ཏོ་༎ ཕྱི་རོལ་ཁྱབ་པར་སྨྲ་བ་ལ་ཡང་སྒྲུབ་པར་བྱེད་པ་དེ་ཉིད་ཡིན་ནོ་༎
 samānañcaitadvahirvyāptivādināmapi yadi hi mūḍhamatāpekṣā na syāt syādeva śrāvaṇatvamaduṣṭo hetuḥ |	གལ་ཏེ་མི་རྨོངས་པའི་བསམ་པ་ལ་ལྟོས་ནས་མཉན་པར་བྱ་བ་ཉིད་ཀྱི་གཏན་ཚིགས་སྐྱོན་མེད་པ་ཡིན་ཏེ་། 
 satvādivanniyataśabdeṣu hi vivāde śabdāntaraṃ syāt |	ཡོད་པ་ལ་སོགས་པ་བཞིན་ནོ་༎ ངེས་པ་དང་ལྡན་པའི་སྒྲ་རྣམས་ལ་བརྩོན་ན་སྒྲ་གཞན་དཔེ་ཡིན་ནོ་༎ སྒྲ་ཐམས་ཅད་ལ་ཡང་ལོག་པར་རྟོགས་པ་ཡོད་ན་།
 dṛṣṭāntaḥ sarvvaśabdeṣu vigatau bādhakaṃ pramāṇaṃ pravarttammanaṃ adṛṣṭāntamapi tatraikaṃ dṛṣṭāntayatīti kathama sādhāraṇamanaikāntikaṃ veti antarvyāptisamarthanaṃ samāptamiti || 0 ||	དཔེ་མེད་པའི་ཕྱིར་དེ་ལ་དཔེ་གང་ཞིག་གཞག་པར་བྱ་༎ གནོད་པ་ཅན་གྱི་ཚད་མ་ཞུགས་པས་ཇི་ལྟར་ཐུན་མོང་མ་ཡིན་པའི་མ་ངེས་པ་ཡིན་།
