skt	tib
 for example -vat, -mat, remain undivided, and terms such as a numeral+ -dha| -vidha| -prakara remain also undivided| 3|3| compound words with the suffixes -ta| -tva or -bhava| -bhuta fundamentally remain undivided| for example: karyakaranabhava|-bhuta|-ta| 3|4| compound words with evam-, tat-, tatha-, para-, yatha-, su-, sva- in the wordhead fundamentally remain undivided| for example: evamjatiya, tadutpatti, tathakrta, paratantra, yathartha, yathasvam, sujnanatva, svabhava| 3|5| some compound words which are regarded as terminology remain also undivided| for example: agnihotra, ayogavyavaccheda, arthapatti, padartha, paramartha, prasajyapratisedha, viruddhavyabhicarin, samanantarapratyaya, samtanaparinama, samanyalaksana, svabhavapratibandha| 4| those terms whose wordhead is subject to the sandhi rules (for example, -d dhetu-) are cited in their original form (for example, -d *hetu-) for the sake of using this database to make an kWic index| 1| august| 1997 | tsukuba motoi ono note: this database is quite a tentative one, and i must admit that there are a lot of errors and defects in this version| i would appreciate it very much if the user would point out any errors in this version so that we can make a better new version in the future| e-mail: ono@logos|tsukuba|ac|jp *************************************************************************	༄༢༣༡བ་༌་༎ རྒྱ་གར་སྐད་དུ་། ཉའ་ཡ་བིན་དུ་ན་ནའ་མ་པྲ་ཀ་ར་ན་། བོད་སྐད་དུ་། རིགས་པའི་ཐིགས་པ་ཞེས་བྱ་བའི་རབ་ཏུ་བྱེད་པ་། འཇམ་དཔལ་གཞོན་ནུར་གྱུར་པ་ལ་ཕྱག་འཚལ་ལོ་༎
 01001 samyag-jñāna-pūrvikā sarva-puruṣa-artha-siddhir iti tad vyutpādyate|	ཡང་དག་པའི་ཤེས་པ་ནི་། སྐྱེས་བུའི་དོན་ཐམས་ཅད་འགྲུབ་པའི་སྔོན་དུ་འགྲོ་བ་ཅན་ཡིན་པས་ན་དེ་བསྟན་ཏོ་༎
 01002 dvividhaṃ samyag-jñānam|	ཡང་དག་པའི་ཤེས་པ་ནི་རྣམ་པ་གཉིས་ཏེ་།
 01003 pratyakṣam anumānaṃ ca iti|	མངོན་སུམ་དང་རྗེས་སུ་དཔག་པའོ་༎
 01004 tatra pratyakṣaṃ kalpanā apoḍham abhrāntam|	དེ་ལ་མངོན་སུམ་ནི་རྟོག་པ་དང་བྲལ་ཞིང་མ་འཁྲུལ་པའོ་༎ རྟོག་པ་ནི་།
 01005 abhilāpa-saṃsarga-yogya-pratibhāsā pratītiḥ kalpanā|	ཤེས་པ་ལ་བརྗོད་པ་དང་འདྲེར་རུང་བ་སྣང་བ་སྟེ་དེ་དང་བྲལ་བའོ་༎
 01006 tayā rahitaṃ timira-āśubhramaṇa-nauyāna-saṃkṣobha-ādy-anāhita-vibhramaṃ jñānaṃ pratyakṣam|	རབ་རིབ་དང་། མྱུར་དུ་བསྐོར་བ་དང་། གྲུར་ཞུགས་པ་དང་། འཁྲུག་པ་ལ་སོགས་པས་འཁྲུལ་པ་མ་སྐྱེས་པའི་ཤེས་པ་ནི་མངོན་སུམ་མོ་༎
 01007 tat caturvidham|	དེ་ནི་རྣམ་པ་བཞི་སྟེ་།
 01008 indriya-jñānam| 01009 sva-viṣaya-anantara-viṣaya-sahakāriṇā indriya-jñānena samanantarapratyayena janitaṃ tan manovijñānam|	དབང་པོའི་ཤེས་པ་དང་། རང་གི་ཡུལ་གྱི་དེ་མ་ཐག་པ་ཡུལ་ལྷན་ཅིག་བྱེད་པ་ཅན་། དབང་པོའི་ཤེས་པ་མཚུངས་པ་དེ་མ་ཐག་པའི་རྐྱེན་གྱིས་བསྐྱེད་པའི་ཡིད་ཀྱི་རྣམ་པར་ཤེས་པ་དང་། 
 01010 sarva-citta-caittānām ātma-saṃvedanam| 01011 bhūta-artha-bhāvanā-prakarṣa-paryantajaṃ yogijñānaṃ ca iti|	སེམས་དང་སེམས་ལས་བྱུང་བ་ཐམས་ཅད་ཀྱི་རང་རིག་པ་དང་། ཡང་དག་པའི་དོན་བསྒོམ་པའི་རབ་ཀྱི་མཐའ་ལས་བྱུང་བ་རྣལ་འབྱོར་པའི་ཤེས་པའོ་༎
 01012 tasya viṣayaḥ svalakṣaṇam|	དེའི་ཡུལ་ནི་རང་གི་མཚན་ཉིད་དེ་།
 01013 yasya arthasya saṃnidhāna-asaṃnidhānābhyāṃ jñāna-pratibhāsa-bhedas tat svalakṣaṇam|	དོན་གང་ཉེ་བ་དང་མི་ཉེ་བ་དག་ལས་ཤེས་པ་ལ་སྣང་བ་ཐ་དད་པ་དེ་ནི་རང་གི་མཚན་ཉིད་དོ་༎
 01014 tad eva paramārthasat| 01015 arthakriyāsāmarthya-lakṣaṇatvād vastunaḥ|	དེ་ཉིད་དོན་དམ་པར་ཡོད་པ་སྟེ་དངོས་པོའི་མཚན་ཉིད་ནི་དོན་བྱེད་མཚན་ཉིད་ཁོ་ན་ཡིན་པའི་ཕྱིར་རོ་༎ 
 01016 anyat sāmānyalakṣaṇam|	གཞན་ནི་སྤྱིའི་མཚན་ཉིད་དེ་།
 01017 so anumānasya viṣayaḥ|	དེ་ནི་རྗེས་སུ་དཔག་པའི་ཡུལ་ཡིན་ནོ་༎
 01018 tad eva ca pratyakṣaṃ jñānaṃ pramāṇa-phalam|	མངོན་སུམ་གྱི་ཤེས་པ་དེ་ཉིད་ཚད་མའི་འབྲས་བུ་སྟེ་།
 01019 artha-pratīti-rūpatvāt|	དོན་རྟོགས་པའི་ངོ་བོ་ཁོ་ན་ཡིན་པའི་ཕྱིར་རོ་༎
 01020 artha-sārūpyam asya pramāṇam|	དོན་དང་འདྲ་བ་ཉིད་དེའི་ཚད་མ་སྟེ་།
 01021 tad-vaśād artha-pratīti-siddher iti|	དེའི་དབང་གིས་དོན་རྟོགས་པ་འགྲུབ་པའི་ཕྱིར་རོ་༎ རིགས་པའི་ཐིགས་པ་ཞེས་བྱ་བའི་རབ་ཏུ་བྱེད་པ་ལས་། མངོན་སུམ་གྱི་ལེའུ་སྟེ་དང་པོའོ་།
 02001 anumānaṃ dvividhā|	༎ ། རྗེས་སུ་དཔག་པ་ནི་རྣམ་པ་གཉིས་ཏེ་།
 02002 svārthaṃ parārthaṃ ca|	རང་གི་དོན་དང་གཞན་གྱི་དོན་ནོ་༎
 02003 tatra svārthaṃ trirūpāl liṅgād yad anumeye jñānaṃ tad anumānam|	དེ་ལ་རང་གི་དོན་གྱི་རྗེས་སུ་དཔག་པར་བྱ་བ་ལ་ཚུལ་གསུམ་པའི་རྟགས་ལས་ཤེས་པ་གང་ཡིན་པའོ་༎ 
 02004 pramāṇa-phala-vyavasthā atra api pratyakṣa-vat|	འདིར་ཡང་ཚད་མའི་འབྲས་བུ་རྣམ་པར་གཞག་པ་ནི་མངོན་སུམ་དང་འདྲའོ་༎
 02005 trairūpyaṃ punar liṅgasya anumeye sattvam eva, sapakṣa eva sattvam,	ཚུལ་གསུམ་པ་ཉིད་ཀྱི་རྟགས་ནི་རྗེས་སུ་དཔག་པར་བྱ་བ་ལ་ཡོད་པ་ཉིད་དང་། ༄༢༣༢ཨ་༌་༎ མཐུན་པའི་ཕྱོགས་ཉིད་ལ་ཡོད་པ་དང་། མི་མཐུན་པའི་ཕྱོགས་ལ་མེད་པ་ཉིད་དུ་ངེས་པའོ་༎
 asapakṣe ca asattvam eva niścitam| 02006 anumeyo atra jijñāṣita-viśeṣo dharmī| 02007 sādhya-dharma-sāmānyena samāno arthaḥ sapakṣaḥ|	རྗེས་སུ་དཔག་པར་བྱ་བ་ནི་འདིར་ཤེས་པར་འདོད་པའི་བྱེ་བྲག་དང་ལྡན་པའི་ཆོས་ཅན་ནོ་༎ མཐུན་པའི་ཕྱོགས་ནི་བསྒྲུབ་པར་བྱ་བའི་ཆོས་ཀྱི་སྤྱི་དང་དོན་མཐུན་པའོ་༎
 02008 na sapakṣo asapakṣaḥ|	མི་མཐུན་པའི་ཕྱོགས་ནི་མཐུན་པའི་ཕྱོགས་མ་ཡིན་པ་སྟེ་།
 02009 tato anyas tad-viruddhas tad-abhāvaś ca iti|	དེ་ལས་གཞན་པ་དང་། དེ་དང་འགལ་བ་དང་། དེ་མེད་པའོ་༎
 02010 trirūpāṇi ca trīṇy eva liṅgāni|	ཚུལ་གསུམ་པོ་དག་ནི་རྟགས་གསུམ་ཁོ་ན་དང་ལྡན་པ་སྟེ་།
 02011 anupalabdhiḥ svabhāvaḥ kāryaṃ ca iti|	མི་དམིགས་པ་དང་། རང་བཞིན་དང་། འབྲས་བུའོ་༎
 02012 tatra anupalabdhir yathā, na pradeśa-viśeṣe kvacid ghaṭaḥ,	དེ་ལ་མི་དམིགས་པ་ནི་དཔེར་ན་ཕྱོགས་ཀྱི་བྱེ་བྲག་འགའ་ཞིག་ན་བུམ་པ་མེད་དེ་།
 upalabdhi-lakṣaṇa-prāptasya anupalabdher iti	དམིགས་པའི་རིག་བྱར་གྱུར་པ་ལས་མི་དམིགས་པའི་ཕྱིར་རོ་ཞེས་བྱ་བ་ལྟ་བུའོ་༎
 02013 upalabdhi-lakṣaṇa-prāptir upalambha-pratyaya-antara-sākalyaṃ svabhāva-viśeṣaś ca|	དམིགས་པའི་རིག་བྱར་གྱུར་པ་ནི་དམིགས་པའི་རྐྱེན་གཞན་ཚང་བ་ཉིད་དང་རང་བཞིན་ཁྱད་པར་ཅན་ཏེ་། 
 02014 yaḥ svabhāvaḥ satsv anyeṣu upalambha-pratyayeṣu san pratyakṣa eva bhavati sa svabhāva-viśeṣaḥ|	རང་བཞིན་གང་ཡོད་ལ་དམིགས་པའི་རྐྱེན་གཞན་དག་ཀྱང་ཡོད་ན་མངོན་སུམ་ཁོ་ནར་འགྱུར་ཏེ་། 
 02015 svabhāvaḥ sva-sattā-mātra-bhāvini sādhya-dharme hetuḥ|	བའོ་༎ རང་བཞིན་ནི་རང་ཡོད་པ་ཙམ་དུ་གྱུར་པ་། བསྒྲུབ་པར་བྱ་བའི་ཆོས་ཀྱི་གཏན་ཚིགས་ཏེ་།
 02016 yathā vṛkṣo ayaṃ śiṃśapātvād iti|	དཔེར་ན་ཤིང་ཤ་པ་ཡིན་པའི་ཕྱིར་།
 02017 kāryaṃ yathā vahnir atra dhūmād iti|	འདི་ནི་ཤིང་ངོ་ཞེས་བྱ་བ་ལྟ་བུའོ་༎ འབྲས་བུ་ནི་དཔེར་ན་དུ་བ་ཡོད་པའི་ཕྱིར་། དེ་ན་མེ་ཡོད་དོ་ཞེས་བྱ་བ་ལྟ་བུའོ་༎
 02018 atra dvau vastu-sādhanau| ekaḥ pratiṣedha-hetuḥ	འདི་ལ་གཉིས་ནི་དངོས་པོ་སྒྲུབ་པའོ་༎ གཅིག་ནི་དགག་པའི་གཏན་ཚིགས་སོ་༎
 02019 svabhāvapratibandhe hi saty artho arthaṃ gamayet|	རང་བཞིན་འབྲེལ་པ་ཡོད་ན་། དོན་གྱིས་དོན་གོ་བར་བྱེད་དེ་།
 02020 tad-apratibaddhasya tad-avyabhicāra-niyama-abhāvāt|	དེ་དང་མ་འབྲེལ་ན་དེར་མི་འཁྲུལ་བར་ངེས་པ་མེད་པའི་ཕྱིར་རོ་༎
 02021 sa ca pratibandhaḥ sādhye arthe liṅgasya|	བསྒྲུབ་པར་བྱ་བའི་དོན་ལ་རྟགས་འབྲེལ་པ་དེ་ཡང་། དངོས་སུ་ན་བསྒྲུབ་པར་བྱ་བའི་དོན་གྱི་རང་བཞིན་ཡིན་པའི་ཕྱིར་དང་། བསྒྲུབ་པར་བྱ་བའི་དོན་ལས་འབྱུང་བའི་ཕྱིར་ཏེ་།
 02022 vastutas tādātmyāt tadutpatteś ca| 02023 atad-svabhāvasya atadutpatteś ca tatra apratibaddha-svabhāvatvāt|	དེའི་རང་བཞིན་མ་ཡིན་པ་དང་། དེ་ལས་བྱུང་བ་མ་ཡིན་པ་ནི་དེ་དང་འབྲེལ་པ་མེད་པའི་རང་བཞིན་ཡིན་པའི་ཕྱིར་རོ་༎ དེའི་བདག་ཉིད་དང་དེ་ལས་བྱུང་བ་དེ་གཉིས་ཀྱང་།
 02024 te ca tādātmya-tadupattī svabhāva-kāryayor eva iti tābhyām eva vastu-siddhiḥ|	རང་བཞིན་དང་འབྲས་བུ་ཁོ་ན་ཡིན་ཏེ་། དེ་གཉིས་ཁོ་ནས་དངོས་པོ་གྲུབ་པོ་༎
 02025 pratiṣedha-siddhir api yathoktāyā eva anupalabdheḥ|	དགག་པ་སྒྲུབ་ཀྱང་མི་དམིགས་པ་ཇི་སྐད་སྨོས་པ་ཁོ་ན་ལས་འགྱུར་ཏེ་།
 02026 sati vastuni tasyā asambhavāt|	དངོས་པོ་ཡོད་ན་ནི་དེ་མི་སྲིད་པའི་ཕྱིར་རོ་༎
 02027 anyathā ca anupalabdhi-lakṣaṇa-prāpteṣu deśa-kāla-svabhāva-viprakṛṣṭeṣv artheṣv ātma-pratyakṣa-nivṛtter abhāva-niścaya-abhāvāt|	གཞན་དུ་ནི་ཡུལ་དང་། དུས་དང་། རང་བཞིན་གྱིས་བསྐལ་པའི་དོན་དམིགས་པའི་རིག་བྱར་མ་༄༢༣༢བ་གྱུར་པ་རྣམས་ལ་། རང་གི་མངོན་སུམ་ལོག་ཀྱང་དངོས་པོ་མེད་པར་ངེས་པ་མེད་པའི་ཕྱིར་རོ་༎
 02028 amūḍha-smṛti-saṃskārasya atītasya vartamānasya ca pratipattṛ-pratyakṣasya nivṛttir abhāva-vyavahāra-pravartanī|	མི་རྨོངས་པར་དྲན་པའི་འདུ་བྱེད་སྒྲུབ་པ་པོའི་མངོན་སུམ་འདས་པ་དང་། ད་ལྟར་གྱི་ལོག་ན་དངོས་པོ་མེད་པའི་ཐ་སྙད་འཇུག་སྟེ་།
 02029 tasyā eva abhāva-niścayāt|	དེ་ཉིད་ཀྱི་དངོས་པོ་མེད་པར་ངེས་པའི་ཕྱིར་རོ་༎
 02030 sā ca prayoga-bhedād ekadaśa-prakārā|	དེ་ནི་སྦྱོར་བའི་བྱེ་བྲག་གིས་རྣམ་པ་བཅུ་གཅིག་སྟེ་།
 02031 svabhāva-anupalabdhir yathā, na atra dhūma upalabdhi-lakṣaṇa-prāptasya anupalabdhir iti|	རང་བཞིན་མི་དམིགས་པ་ནི་དཔེར་ན་འདི་ན་དུ་བ་མེད་དེ་དམིགས་པའི་རིག་བྱར་གྱུར་པ་ལས་མི་དམིགས་པའི་ཕྱིར་རོ་༎ ཞེས་བྱ་བ་ལྟ་བུའོ་༎
 02032 kārya-anupalabdhir yathā,	འབྲས་བུ་མི་དམིགས་པ་ནི་།
 na iha apratibaddha-sāmarthyāni dhūma-kāraṇāni santi dhūma-abhāvād iti|	དཔེར་ན་འདི་ན་དུ་བའི་རྒྱུ་ནུས་པ་ཐོགས་པ་མེད་པ་དག་མེད་དེ་། དུ་བ་མེད་པའི་ཕྱིར་རོ་ཞེས་བྱ་བ་ལྟ་བུའོ་༎
 02033 vyāpaka-anupalabdhir yathā,	ཁྱབ་པར་བྱེད་པ་མི་དམིགས་པ་ནི་།
 na atra śiṃśapā, vṛkṣa-abhāvād iti|	དཔེར་ན་འདི་ན་ཤིང་མེད་པའི་ཕྱིར་ཤིང་ཤ་པ་མེད་དོ་༎ ཞེས་བྱ་བ་ལྟ་བུའོ་༎
 02034 svabhāva-viruddha-upalabdhir yathā, na atra śīta-sparśo vahner iti|	རང་བཞིན་འགལ་བ་དམིགས་པ་ནི་དཔེར་ན་འདི་ན་མེ་ཡོད་པའི་ཕྱིར་གྲང་བའི་རེག་པ་མེད་དོ་ཞེས་པ་ལྟ་བུའོ་༎
 02035 viruddha-kārya-upalabdhir yathā, na atra śīta-sparśo dhūmād iti|	འགལ་བའི་འབྲས་བུ་དམིགས་པ་ནི་དཔེར་ན་འདི་ན་དུ་བ་ཡོད་པའི་ཕྱིར་། གྲང་བའི་རེག་པ་མེད་དོ་ཞེས་བྱ་བ་ལྟ་བུའོ་༎
 02036 viruddha-vyāpta-upalabdhir yathā, na dhūma-bhāvī bhūtasya api bhāvasya vināśaḥ,	འགལ་བ་ཁྱབ་པ་དམིགས་པ་ནི་དཔེར་ན་དངོས་པོ་བྱུང་བ་ཡང་འཇིག་པར་ངེས་པར་འགྱུར་བ་མེད་དེ་། 
 hetv-antara-apekṣaṇād iti|	རྒྱུ་གཞན་ལ་ལྟོས་པའི་ཕྱིར་རོ་ཞེས་བྱ་བ་ལྟ་བུའོ་༎
 02037 kārya-viruddha-upalabdhir yathā, na iha apratibaddha-sāmarthyāni śīta-kāraṇāni santi, vahner iti|	འབྲས་བུ་འགལ་བ་དམིགས་པ་ནི་དཔེར་ན་འདི་ན་མེ་ཡོད་པའི་ཕྱིར་གྲང་བའི་རྒྱུའི་ནུས་པ་ཐོགས་པ་མེད་པ་དག་མེད་དོ་ཞེས་བྱ་བ་ལྟ་བུའོ་༎ 
 02038 vyāpaka-viruddha-upalabdhir yathā, na atra tuṣāra-sparśo vahner iti|	ཁྱབ་པར་བྱེད་པ་འགལ་བ་དམིགས་པ་ནི་དཔེར་ན་འདི་ན་མེ་ཡོད་པའི་ཕྱིར་བ་མོའི་རེག་པ་མེད་དོ་ཞེས་བྱ་བ་ལྟ་ལྟ་བུའོ་༎ བུའོ་༎ 
 02039 kāraṇa-anupalabdhir yathā, na atra dhūmo vahny-abhāvād iti|	རྒྱུ་མི་དམིགས་པ་ནི་དཔེར་ན་འདི་ན་མེ་མེད་པའི་ཕྱིར་དུ་བ་མེད་དོ་ཞེས་བྱ་བ་ལྟ་བུའོ་༎
 02040 kāraṇa-viruddha-upalabdhir yathā, na asya roma-harṣa-ādi-viśeṣāḥ,	རྒྱུ་འགལ་བ་དམིགས་པ་ནི་དཔེར་ན་འདི་ན་སྤུ་ལོང་ཞེས་བྱ་བ་ལ་སོགས་པའི་བྱེ་བྲག་མེད་དེ་། 
 saṃnihita-dahana-viśeṣatvād iti|	གདུང་བར་བྱེད་པའི་བྱེ་བྲག་ཉེ་བ་ཉིད་ཀྱི་ཕྱིར་རོ་ཞེས་བྱ་བ་ལྟ་བུའོ་མེད་དེ་། 
 02041 kāraṇa-viruddha-kārya-upalabdhir yathā, na roma-harṣa-ādi-viśeṣa-yukta-puruṣavān ayaṃ pradeśaḥ, dhūmād iti|	༎ རྒྱུ་འགལ་བའི་འབྲས་བུ་དམིགས་པ་ནི་དཔེར་ན་ཕྱོགས་འདི་ན་དུ་བ་ཡོད་མེད་དེ་། ༎ པའི་ཕྱིར་། སྤུ་ལོང་ཞེས་བྱེད་པ་ལ་སོགས་པའི་བྱེ་བྲག་དང་ལྡན་པའི་མི་དང་ལྡན་པ་མ་ཡིན་ནོ་ཞེས་བྱ་བ་མེད་དེ་། ༎ པའི་ཕྱིར་། ལྟ་བུའོ་༎ དོན་གཞན་ཡོད་པ་དང་དགག་པ་དག་གིས་སྦྱོར་བ་ཐ་དད་ཀྱང་།
 02042 ime sarve kārya-anupalabdhy-ādayo daśa-anupalabdhi-prayogāḥ svabhāva-anupalabdhau saṃgraham upayānti| 02043 pāraṃparyeṇa arthāntara-vidhi-pratiṣedhāyāṃ prayoga-bhede api|	བརྒྱུད་པའི་སྒོ་ནས་འབྲས་བུ་མི་དམིགས་པ་ལ་སོགས་པ་མི་དམིགས་པའི་སྦྱོར་བ་བཅུ་པོ་དེ་དག་ཐམས་ཅད་ནི་རང་བཞིན་མི་༄༢༣༣ཨ་༌་༎
 02044 prayoga-darśana-abhyāsāt svayam apy evaṃ vyavaccheda-pratītir bhavati iti svārthe apy anumāne asyāḥ prayoga-nirdeśaḥ|	དམིགས་པའི་ནང་དུ་བསྡུ་བར་འགྱུར་རོ་༎ སྦྱོར་བ་མཐོང་བ་གོམས་པ་ལས་བདག་ཉིད་ཀྱང་དེ་བཞིན་དུ་རྣམ་པར་གཅོད་པ་རྟོགས་པར་འགྱུར་བས་། བདག་གི་དོན་གྱི་རྗེས་སུ་དཔག་པ་ལ་ཡང་བྱེ་བྲག་བསྟན་ཏོ་༎
 02045 sarvatra ca asyām abhāva-vyavahāra-sādhanyām anupalabdhau yeṣāṃ svabhāva-viruddha-ādīnām	མེད་པའི་ཐ་སྙད་སྒྲུབ་པའི་མི་དམིགས་པ་དེ་དག་ཐམས་ཅད་ལ་ཡང་རང་བཞིན་འགལ་བ་ལ་སོགས་པ་དམིགས་པ་དང་། རྒྱུ་ལ་སོགས་པ་མི་དམིགས་པས་།
 upalabdhyā kāraṇa-ādīnām anupalabdhyā ca pratiṣedha uktas teṣām upalabdhi-lakṣaṇa-prāptānām|	དགག་པ་བཤད་པ་གང་ཡིན་པ་དེ་དག་ནི་དམིགས་པའི་རིག་བྱར་གྱུར་པ་ཁོ་ན་དག་ལས་དམིགས་པ་དང་། 
 02045 eva upalabdhir anupalabdhiś ca veditavyā|	མི་དམིགས་པར་ཡང་རིག་པར་བྱའོ་༎
 02046 anyeṣāṃ virodha-kāryakāraṇabhāva-siddheḥ|	གཞན་དག་ལ་ནི་འགལ་བ་དང་༎ རྒྱུ་དང་འབྲས་བུ་ཡོད་པ་དང་། མེད་པ་མི་འགྲུབ་པའི་ཕྱིར་རོ་༎ བསྐལ་པའི་ཡུལ་མི་དམིགས་པའི་མངོན་སུམ་དང་རྗེས་སུ་དཔག་པའི་མཚན་ཉིད་ནི་ཐེ་ཚོམ་གྱི་རྒྱུ་ཡིན་ཏེ་། 
 02047 pramāṇa-nivṛttav apy artha-abhāva-asiddher iti|	ཚད་མ་ལོག་ཀྱང་དོན་མེད་པར་མི་འགྲུབ་པའི་ཕྱིར་རོ་༎ རིགས་པའི་ཐིག་པ་ཞེས་བྱ་བའི་རབ་ཏུ་བྱེད་པ་ལས་། བདག་གི་དོན་རྗེས་སུ་དཔག་པའི་ལེའུ་སྟེ་གཉིས་པའོ་།
 03001 trirūpa-liṅga-ākhyānaṃ parārtham anumānam|	༎ ། གཞན་གྱི་དོན་གྱི་རྗེས་སུ་དཔག་པ་ནི་ཚུལ་གསུམ་པའི་རྟགས་བརྗོད་པ་སྟེ་།
 03002 kāraṇe kārya-upacārāt|	རྒྱུ་ལ་འབྲས་བུ་བཏགས་པའི་ཕྱིར་རོ་༎
 03003 tad dvividham| 03004 prayoga-bhedāt|	སྦྱོར་བའི་བྱེ་བྲག་གིས་དེ་ནི་རྣམ་པ་གཉིས་ཏེ་།
 03005 sādharmya-vaidharmya-vacana iti|	ཆོས་མཐུན་པ་ཉིད་ཅན་དང་། ཆོས་མི་མཐུན་པ་ཉིད་ཅན་ནོ་༎
 03006 na anayor arthataḥ kaścid bhedaḥ| 03007 anyatra prayoga-bhedāt|	སྦྱོར་བའི་བྱེ་བྲག་མ་གཏོགས་པར་འདི་གཉིས་དོན་དུ་ནི་བྱེ་བྲག་ཅི་ཡང་མེད་དོ་༎
 03008 tatra sādharmyavat prayogaḥ: yad upalabdhi-lakṣaṇa-prāptaṃ sann na upalabhyate so asad-vyavahāra-viṣayaḥ siddhaḥ,	དེ་ལ་ཆོས་མཐུན་པ་ཉིད་ཅན་ནི་དམིགས་པའི་རིག་བྱར་གྱུར་པ་གང་མ་དམིགས་པ་དེ་ནི་མེད་པའི་ཐ་སྙད་ཀྱི་ཡུལ་དུ་གྲུབ་སྟེ་།
 yathā anyaḥ kaścid dṛṣṭaḥ śaśa-viṣāṇa-ādiḥ| na upalabhyate ca kaścit pradeśa-viśeṣa upalabdhi-lakṣaṇa-prāpto ghaṭa ity anupalabdhi-prayogaḥ|	དཔེར་ན་རི་བོང་གི་རབ༹་ལ་སོགས་པ་གཞན་འགའ་ཞིག་མཐོང་བ་བཞིན་ཏེ་། ཕྱོགས་ཀྱི་བྱེ་བྲག་གང་ན་དམིགས་པའི་རིག་བྱར་གྱུར་པ་བུམ་པ་མི་དམིགས་སོ་ཞེས་བྱ་བ་ལྟ་བུའོ་༎ 
 03009 tathā svabhāvahetoḥ prayogaḥ: yat sat tat sarvam anityam,	དེ་བཞིན་དུ་རང་བཞིན་གྱི་གཏན་ཚིགས་ཀྱི་སྦྱོར་བ་ནི་གང་ཡོད་པ་དེ་ཐམས་ཅད་ནི་མི་རྟག་སྟེ་།
 yathā ghaṭa-ādir iti śuddhasya svabhāvahetoḥ prayogaḥ|	དཔེར་ན་བུམ་པ་ལ་སོགས་པ་ལྟ་བུའོ་ཞེས་བྱ་བ་ནི་རང་བཞིན་དག་པའི་སྦྱོར་བའོ་༎
 03010 yad utpattimat tad anityam iti svabhāvabhūta-dharma-bhedena svabhāvasya prayogaḥ| 03011 yat kṛtakaṃ tad anityam ity upādhi-bhedena|	གང་སྐྱེ་བ་དང་ལྡན་པ་དེ་ནི་མི་རྟག་པའོ་ཞེས་བྱ་བ་ནི་རང་བཞིན་དུ་གྱུར་པའི་ཆོས་ཀྱི་བྱེ་བྲག་གིས་རང་བཞིན་གྱི་སྦྱོར་བའོ་༎ གང་བྱས་པ་དེ་ནི་མི་རྟག་པའོ་ཞེས་བྱ་བ་དེ་ནི་ཁྱད་པར་གྱི་བྱེ་བྲག་གིས་༎ ཏེ་། 
 03012 apekṣita-para-vyāpāro hi bhāvaḥ svabhāva-niṣpattau kṛtaka iti|	རང་གི་ངོ་བོ་འགྲུབ་པར་བྱ་བའི་ཕྱིར་གཞན་གྱི་བྱེད་པ་ལ་ལྟོས་པའི་༄༢༣༣བ་ངོ་བོ་ནི་བྱས་པའོ་ཞེས་བྱའོ་༎
 03013 evaṃ pratyaya-bhedabheditva-ādayo api draṣṭavyāḥ|	བརྩལ་མ་ཐག་ཏུ་བྱུང་བ་དང་། རྐྱེན་གྱི་བྱེ་བྲག་གིས་ཐ་དད་པ་ཅན་ཉིད་ལ་སོགས་པ་ལ་ཡང་དེ་བཞིན་དུ་བལྟ་བར་བྱའོ་༎ 
 03014 sann utpattimān kṛtako vā śabda iti pakṣa-dharma-upadarśanam|	ཡོད་པའམ་སྐྱེ་བ་དང་ལྡན་པ་འམ་བྱས་པ་ཞེས་བྱ་བའི་སྒྲ་ནི་ཕྱོགས་ཀྱི་ཆོས་ཉེ་བར་སྟོན་པའོ་༎
 03015 sarva ete sādhana-dharmā yathāsvaṃ pramāṇaiḥ| siddha-sādhana-dharma-mātra-anubandha eva sādhya-dharmo avagantavyāḥ| 03016 tasya eva tat|	སྒྲུབ་པའི་ཆོས་དེ་དག་ཐམས་ཅད་ནི་རང་གི་ངོ་བོ་སྒྲུབ་པ་ཅི་ལྟ་བུ་དག་གིས་སྒྲུབ་པའི་ཆོས་ཙམ་དང་བསྒྲུབ་པར་བྱ་བའི་ཆོས་རྗེས་སུ་འབྲེལ་པར་གྲུབ་པ་ཁོ་ནར་ཁོང་དུ་ཆུད་པར་བྱ་སྟེ་། 
 03017 svabhāvasya ca hetutvāt|	དངོས་སུ་ན་དེ་ཉིད་དེའི་རང་བཞིན་ཡིན་པའི་ཕྱིར་དང་། རང་བཞིན་ཡང་གཏན་ཚིགས་ཡིན་པའི་ཕྱིར་ཏེ་།
 03018 vastutas tayos tādātmyam| 03019 tan-niṣpattāv aniṣpannasya tat-svabhāvatva-abhāvāt| 03020 vyabhicāra-sambhavāc ca|	དེ་གྲུབ་ལ་དེ་མ་གྲུབ་ན་ནི་དེའི་རང་བཞིན་ཉིད་མེད་པའི་ཕྱིར་དང་། འཁྲུལ་པ་ཡང་སྲིད་པའི་ཕྱིར་རོ་༎
 03021 kāryahetoḥ prayogaḥ: yatra dhūmas tatra agniḥ,	འབྲས་བུའི་གཏན་ཚིགས་ཀྱི་སྦྱོར་བ་ནི་གང་ན་དུ་བ་ཡོད་པ་དེ་ན་མེ་ཡོད་དེ་།
 yathā mahānasa-ādau| asti ca iha dhūma iti|	དཔེར་ན་ཚང་བང་ལ་སོགས་པ་བཞིན་ཏེ་། འདི་ན་ཡང་དུ་བ་ཡོད་དོ་ཞེས་བྱ་བ་ལྟ་བུའོ་༎
 03022 iha api siddha eva kāryakāraṇabhāve kāraṇe sādhye kāryahetur vaktavyaḥ|	འདིར་ཡང་རྒྱུ་དང་འབྲས་བུའི་དངོས་པོར་གྲུབ་པ་ཁོ་ན་ལ་རྒྱུ་བསྒྲུབ་པར་བྱ་བ་ལ་འབྲས་བུའི་གཏན་ཚིགས་སུ་བརྗོད་པར་བྱའོ་༎
 03023 vaidharmyavataḥ prayogaḥ: yat sad upalabdhi-lakṣaṇa-prāptaṃ tad upalabhyata eva,	ཆོས་མི་མཐུན་པ་ཉིད་ཅན་གྱི་སྦྱོར་བ་ནི་གང་ཡོད་ལ་དམིགས་པའི་རིག་བྱར་གྱུར་པ་དེ་ནི་དམིགས་པ་ཁོ་ནར་འགྱུར་ཏེ་།
 yathā nīla-ādi-viśeṣaḥ| na ca evam iha upalabdhi-lakṣaṇa-prāptasya sata upalabdhir ghaṭasya ity anupalabdhi-prayogaḥ|	དཔེར་ན་སྔོན་པོ་ལ་སོགས་པའི་བྱེ་བྲག་ལྟ་བུ་ཡིན་ན་འདི་ན་ནི་དམིགས་པའི་རིག་བྱར་གྱུར་པ་བུམ་པ་དེ་ལྟར་མི་དམིགས་སོ་ཞེས་བྱ་བ་ནི་མི་དམིགས་པའི་སྦྱོར་བའོ་༎
 03024 asaty anityatve na asty eva sattvam utpattimattvaṃ kṛtakatvaṃ vā| saṃś ca śabda utpattimān kṛtako vā iti svabhāvahetoḥ prayogaḥ|	མི་རྟག་པ་ཉིད་མེད་ན་ཡོད་པའམ་སྐྱེ་བ་དང་ལྡན་པའམ་བྱས་པ་མེད་པ་ཉིད་ཡིན་ན་། སྒྲ་ནི་ཡོད་པའམ་སྐྱེ་བ་དང་ལྡན་པའམ་། བྱས་པའོ་༎
 03025 asaty agnau na bhavaty eva dhūmaḥ| atra ca asti dhūma iti kāryahetoḥ prayogaḥ|	ཞེས་བྱ་བ་ནི་རང་བཞིན་གྱིས་སྦྱོར་བའོ་༎ མེ་མེད་ན་དུ་བ་མི་འབྱུང་བ་ཉིད་ལ་། འདི་ན་ནི་དུ་བ་ཡོད་དོ་ཞེས་བྱ་བ་ནི་འབྲས་བུའི་གཏན་ཚིགས་ཀྱི་སྦྱོར་བའོ་༎
 03026 sādharmyeṇa api hi prayoge arthād vaidharmya-gatir iti|	དོན་གྱིས་ན་ཆོས་མཐུན་པས་ཀྱང་སྦྱོར་བ་ལ་ཆོས་མི་མཐུན་པ་ཉིད་རྟོགས་ཏེ་།
 03027 asati tasmin sādhyena hetor anvaya-abhāvāt|	དེ་མེད་ན་ནི་བསྒྲུབ་པར་བྱ་བ་གཏན་ཚིགས་ཀྱི་རྗེས་སུ་འགྲོ་བ་མེད་པའི་ཕྱིར་རོ་༎
 03028 tathā vaidharmyeṇa apy anvaya-gatiḥ|	དེ་བཞིན་དུ་ཆོས་མི་མཐུན་པས་ཀྱང་རྗེས་སུ་འགྲོ་བ་རྟོགས་ཏེ་།
 03029 asati tasmin sādhya-abhāve hetv-abhāvasya asiddheḥ|	དེ་མེད་ན་ནི་བསྒྲུབ་པར་བྱ་བ་མེད་ན་གཏན་ཚིགས་མེད་པར་མི་འགྲུབ་པའི་ཕྱིར་རོ་༎
 03030 na hi svabhāvapratibandhe asaty ekasya nivṛttav aparasya niyamena nivṛttiḥ|	རང་བཞིན་འབྲེལ་པ་མེད་ན་ནི་ཅིག་ལོག་པས་གཞན་ངེས་པར་ལྡོག་པ་མ་ཡིན་ནོ་༎
 03031 sa ca dviprakāraḥ sarvasya| tādātmya-lakṣaṇas tadutpatti-lakṣaṇaś ca ity uktam|	དེ་ཡང་ཐམས་ཅད་ཀྱི་རྣམ་པ་གཉིས་ཏེ་། དེའི་བདག་ཉིད་དང་དེ་ལས་བྱུང་བ་ཞེས་སྨོས་པ་༄༢༣༤ཨ་༌་༎ ཡིན་ནོ་༎
 03032 tena hi nivṛttiṃ kathayatā pratibandho darśanīyaḥ| tasmāt nivṛtti-vacanam ākṣipta-pratibandha-upadarśanam	དེས་ན་ལྡོག་པ་བརྗོད་པས་འབྲེལ་པ་བསྟན་པར་བྱའོ་༎ དེ་ལྟ་བས་ན་ལྡོག་པའི་ཚིག་གིས་ནི་འབྲེལ་པ་བསྡུས་པ་ཁོ་ན་ཡིན་ལ་།
 eva bhavati| yac ca pratibandha-upadarśanaṃ tad eva anvaya-vacanam ity ekena api	འབྲེལ་པ་བསྟན་པ་གང་ཡིན་པ་དེ་ཡང་རྗེས་སུ་འགྲོ་བ་ཞེས་བྱ་སྟེ་། དེ་ལྟ་བས་ན་རྗེས་སུ་འགྲོ་བའི་སྒོ་ཡང་རུང་ལྡོག་པའི་སྒོ་ཡང་རུང་སྟེ་། ཚིག་གཅིག་བརྗོད་པས་ཀྱང་།
 vākyena anvaya-mukhena vyatireka-mukhena vā prayuktena sapakṣa-asapakṣayor liṅgasya sadasattva-khyāpanaṃ kṛtaṃ bhavati iti na avaśyaṃ vākya-dvaya-prayogaḥ|	མཐུན་པའི་ཕྱོགས་དང་མི་མཐུན་པའི་ཕྱོགས་ལ་རྟགས་ཡོད་པ་དང་མེད་པ་བསྟན་པར་འགྱུར་བས་དེ་ལྟར་ན་ཚིག་གཉིས་ཀྱིས་སྦྱོར་བ་བསྟན་པར་ངེས་པ་མེད་དོ་༎ 
 03033 anupalabdhāv api: yat sad upalabdhi-lakṣaṇa-prāptaṃ tad upalabhyata eva ity ukte,	མི་དམིགས་པ་ལ་ཡང་གང་ཡོད་ལ་དམིགས་པའི་རིག་བྱར་གྱུར་པ་དེ་ནི་པ་མེད་དོ་༎ ། དམིགས་པ་ཁོ་ནར་འགྱུར་རོ་ཞེས་བསྟན་པར་མི་དམིགས་ན་།
 anupalabhyamānaṃ tādṛśam asad iti pratīter anvaya-siddheḥ|	དེ་ལྟ་བུ་མེད་དོ་ཞེས་བྱ་བར་རྟོགས་པའི་ཕྱིར་རྗེས་སུ་འགྲོ་བ་གྲུབ་པོ་༎
 03034 dvayor apy anayoḥ prayogayor na avaśyaṃ pakṣa-nirdeśaḥ|	སྦྱོར་བ་འདི་གཉི་ག་ལ་ཡང་ཕྱོགས་བསྟན་པར་ངེས་པ་མེད་དེ་།
 03035 yasmāt sādharmyavat-prayoge api yad upalabdhi-lakṣaṇa-prāptaṃ san na upalabhyate so asad-vyavahāra-viṣayaḥ| na upalabhyate ca atra upalabdhi-lakṣaṇa-prāpto ghaṭa ity ukte sāmarthyād eva na iha ghaṭa iti bhavati|	འདིར་ཆོས་མཐུན་པ་ཉིད་ཅན་གྱི་སྦྱོར་བ་ལ་ཡང་དམིགས་པའི་རིག་བྱར་གྱུར་པ་གང་དམིགས་པ་དེ་ནི་མེད་པའི་ཐ་སྙད་ཀྱི་ཡུལ་ཡིན་ལ་། འདི་ན་ཡང་དམིགས་པའི་རིག་བྱར་གྱུར་པ་བུམ་པ་མི་དམིགས་སོ་ཞེས་བསྟན་པར་ཤུགས་ཀྱིས་འདི་ན་བུམ་པ་མེད་དོ་ཞེས་བྱ་བར་འགྱུར་། རོ་༎ 
 03036 tathā vaidharmyavat-prayoge api: yaḥ sad-vyavahāra-viṣaya upalabdhi-lakṣaṇa-prāptaḥ,	དེ་བཞིན་དུ་ཆོས་མི་མཐུན་པ་ཉིད་ཅན་གྱི་སྦྱོར་བ་ལ་ཡང་ཡོད་པའི་ཐ་སྙད་ཀྱི་ཡུལ་གང་ཡོད་ལ་། དམིགས་པའི་རིག་བྱར་གྱུར་པ་དེ་ནི་དམིགས་པ་ཁོ་ནར་འགྱུར་ན་།
 sa upalabhyata eva| na tathā atra tādṛśo ghaṭa upalabhyata ity ukte sāmarthyād eva na iha sad-vyavahāra-viṣaya iti bhavati|	འདི་ན་དེ་འདྲ་བའི་བུམ་པ་དེ་ནི་མི་དམིགས་སོ་ཞེས་བསྟན་པས་ཤུགས་ཉིད་ཀྱིས་འདིར་ཡོད་པའི་ཐ་སྙད་ཀྱི་ཡུལ་མེད་དོ་ཞེས་བྱ་བར་འགྱུར་རོ་༎ 
 03037 kīdṛśaḥ punaḥ pakṣa iti nirdeśyaḥ|	ཕྱོགས་ཇི་ལྟ་བུ་ཞིག་བསྟན་པར་བྱ་ཞེ་ན་།
 03038 svarūpeṇa eva svayam iṣṭo anirākṛtaḥ pakṣa iti|	རང་གི་ངོ་བོ་ཁོ་ན་དང་། བདག་ཉིད་དང་། འདོད་པ་དང་། མ་བསྩལ་བར་བསྟན་པར་བྱ་བ་ནི་ཕྱོགས་སོ་ཞེས་བསྟན་པར་བྱ་བ་ཡིན་ཏེ་།
 03039 svarūpeṇa iti sādhyatvena iṣṭaḥ|	རང་གི་ངོ་བོ་ཞེས་བྱ་བ་ནི་བསྒྲུབ་པར་བྱ་བ་ཁོ་ནར་འདོད་པའོ་༎
 03040 svarūpeṇa eva iti sādhyatvena eva iṣṭo na sādhanatvena api| 03041 yathā śabdasya anityatve sādhye cākṣuṣatvaṃ hetuḥ,	རང་གི་ངོ་བོ་ཁོ་ན་ཞེས་བྱ་བ་ནི་བསྒྲུབ་པར་བྱ་བ་ཁོ་ན་འདོད་པ་ཡིན་གྱི་སྒྲུབ་པ་ཉིད་ཡིན་ཡང་རུང་བ་མ་ཡིན་ཏེ་། དཔེར་ན་སྒྲ་མི་རྟག་པ་ཉིད་དུ་བསྒྲུབ་པར་བྱ་བ་ལ་གཏན་ཚིགས་མིག་གིས་གཟུང་བ་ཉིད་ནི་སྒྲ་ལ་མ་གྲུབ་པའི་ཕྱིར་བསྒྲུབ་པར་བྱ་བ་ཡིན་ན་།
 śabde asiddhatvāt sādhyam| na punas tad iha sādhyatvena eva iṣṭam, sādhanatvena abhidhānāt|	དེ་འདིར་ནི་སྒྲུབ་པ་ཁོ་ནར་བརྗོད་པའི་ཕྱིར་བསྒྲུབ་པར་བྱ་བ་ཉིད་ཁོ་ནར་ནི་མི་འདོད་དོ་༎ 
 03042 svayam iti vādinā| 03043 yas tadā sādhanam āha|	བདག་ཉིད་ཅེས་བྱ་བ་ནི་དེའི་ཚེ་རྒོལ་བས་བསྒྲུབ་པ་སྨྲས་པ་གང་ཡིན་པའོ་༎
 03044 etena yady api kvacic śāstre sthitaḥ sādhanam āha:	༄༢༣༤བ་དེས་ན་གལ་ཏེ་བསྟན་བཅོས་འགའ་ཞིག་ལ་བརྟེན་ཏེ་སྒྲུབ་པ་སྨྲས་ན་ཡང་།
 tac śāstrakāreṇa tasmin dharmiṇy aneka-dharma-abhyupagame api yas tadā tena vādinā dharmaḥ svayaṃ sādhayitum iṣṭaḥ, sa eva sādhyo na itara ity uktaṃ bhavati|	བསྟན་བཅོས་དེ་བྱེད་པས་ཆོས་ཅན་དེ་ལ་ཆོས་མང་ཞིག་ཁས་ལེན་དུ་ཟིན་ཀྱང་དེའི་ཚེ་རྒོལ་བ་དེས་ཆོས་གང་སྒྲུབ་པར་འདོད་པ་དེ་ཉིད་བསྒྲུབ་པར་བྱ་བ་ཡིན་གྱི་། ཅིག་ཤོས་ན་མ་ཡིན་ནོ་ཞེས་བསྟན་པར་འགྱུར་རོ་༎
 03045 iṣṭa iti yatra arthe vivādena sādhanam upanyastaṃ tasya siddhim icchatā so anukto api vacanena sādhyaḥ|	འདོད་པ་ཞེས་བྱ་བ་དོན་གང་ལ་རྩོད་པས་སྒྲུབ་པ་བཀོད་པ་དེ་སྒྲུབ་པར་འདོད་པའོ་༎ དེ་ནི་ཚིག་ཏུ་མ་སྨྲས་ཀྱང་བསྒྲུབ་པར་བྱ་བ་ཡིན་ཏེ་།
 03046 tad adhikaraṇatvād vivādasya|	དེ་ནི་རྩོད་པའི་གཞི་ཡིན་པའི་ཕྱིར་རོ་༎
 03047 yathā parārthaś cakṣur-ādayaḥ saṃghātatvāc śayana-āsana-ādy-aṅga-vad iti| atra	དཔེར་ན་འདུས་པ་ཡིན་པའི་ཕྱིར་། མིག་ལ་སོགས་པ་ནི་གཞན་གྱི་དོན་བྱེད་དེ་། མལ་ཆ་དང་སྟན་ལ་སོགས་པའི་ཡན་ལག་བཞིན་ནོ་ཞེས་བྱ་བ་ལྟ་བུའོ་༎
 ātma-arthā ity anuktāv apy ātma-arthatā sādhyā| tena na ukta-mātram eva sādhyam ity uktaṃ bhavati|	འདིར་བདག་གི་དོན་ཞེས་མ་བརྗོད་ཀྱང་བདག་གི་དོན་ཉིད་དུ་བསྒྲུབ་པར་བྱ་བ་ཡིན་ཏེ་།
 03048 anirākṛta iti, etal-lakṣaṇa-yoge api yaḥ sādhayitum iṣṭo apy arthaḥ pratyakṣa-anumāna-pratīti-sva-vacanair nirākriyate, na sa pakṣa iti pradarśana-artham|	དེས་ན་སྨྲས་པ་ཙམ་ཁོ་ན་ནི་བསྒྲུབ་པར་བྱ་བ་མ་ཡིན་ནོ་ཞེས་བསྟན་པར་འགྱུར་རོ་༎ མ་བསལ་བ་ཞེས་བྱ་བ་ནི་མཚན་ཉིད་དེ་དག་དང་ལྡན་དུ་ཟིན་ཀྱང་སྒྲུབ་པར་འདོད་པའི་དོན་གང་ཞིག་ལ་མངོན་སུམ་དང་། རྗེས་སུ་དཔག་པ་དང་། གྲགས་པ་དང་། རང་གི་ཚིག་རྣམས་ཀྱིས་བསལ་བ་གང་ཡིན་པ་དེ་ནི་ཕྱོགས་མ་ཡིན་ནོ་ཞེས་བསྟན་པའི་ཕྱིར་ཏེ་། 
 03049 tatra pratyakṣa-nirākṛto yathā,	དེ་ལ་མངོན་སུམ་གྱིས་བསལ་བ་ནི་།
 aśrāvaṇaḥ śabda iti|	དཔེར་ན་སྒྲ་ནི་མཉན་དུ་མི་རུང་ངོ་ཞེས་བྱ་བ་ལྟ་བུའོ་༎
 03050 anumāna-nirākṛto yathā, nityaḥ śabda iti|	རྗེས་སུ་དཔག་པས་བསལ་བ་ནི་དཔེར་ན་བུམ་པ་ནི་རྟག་པའོ་ཞེས་བྱ་བ་ལྟ་བུའོ་༎
 03051 pratīti-nirākṛto yathā,	གྲགས་པས་བསལ་བ་ནི་།
 acandraḥ śaśī iti|	དཔེར་ན་རི་བོང་ཅན་ནི་ཟླ་བ་མ་ཡིན་ནོ་ཞེས་བྱ་བ་ལྟ་བུའོ་༎
 03052 sva-vacana-nirākṛto yathā,	རང་གི་ཚིག་གིས་བསལ་བ་ནི་།
 na anumānaṃ pramāṇam|	དཔེར་ན་རྗེས་སུ་དཔག་པ་ནི་ཚད་མ་མ་ཡིན་ནོ་ཞེས་བྱ་བ་ལྟ་བུ་སྟེ་།
 03053 iti catvāraḥ pakṣābhāsā nirākṛtā bhavanti|	ཕྱོགས་ལྟར་སྣང་བ་བཞི་བསལ་བ་ཡིན་ནོ་༎
 03054 evaṃ siddhasya, asiddhasya api sādhanatvena abhimatasya, svayaṃ vādinā tadā sādhayitum aniṣṭasya,	དེ་ལྟར་ན་གྲུབ་པ་དང་མ་གྲུབ་ཀྱང་སྒྲུབ་པ་ཉིད་དུ་འདོད་པ་དང་། དེའི་ཚེ་རྒོལ་བ་བདག་ཉིད་ཀྱིས་སྒྲུབ་པར་མི་འདོད་པ་དང་། སྨྲས་པ་ཙམ་དང་བསལ་བ་ལས་བཟློག་པ་ནི་བསྒྲུབ་པར་བྱ་བ་ཡིན་ནོ་༎
 ukta-mātrasya ca viparyayeṇa sādhyaḥ| tena eva svarūpeṇa abhimato vādina iṣṭo anirākṛtaḥ pakṣa iti pakṣa-lakṣaṇam anavadyaṃ darśitaṃ bhavati|	དེ་ཉིད་ཀྱི་ངོ་བོ་དང་། རྒོལ་བའི་འདོད་པ་དང་། མ་བསལ་བ་ནི་ཕྱོགས་ཡིན་ཏེ་། དེ་ལྟར་ན་ཕྱོགས་ཀྱི་མཚན་ཉིད་ཁ་ན་མ་ཐོ་བ་མེད་པར་བསྟན་པ་ཡིན་ནོ་༎
 03055 trirūpaliṅga-ākhyānaṃ parārtha-anumānam ity uktam| tatra trayāṇāṃ rūpāṇām ekasya api rūpasya anuktau sādhanābhāsaḥ|	གཞན་གྱི་དོན་གྱི་རྗེས་སུ་དཔག་པ་ནི་ཚུལ་གསུམ་པའི་རྟགས་བརྗོད་པ་སྟེ་ཞེས་སྨྲས་པ་དེ་ལས་། ཚུལ་གསུམ་ལས་གཅིག་མ་སྨྲས་ན་ཡང་སྒྲུབ་པ་ལྟར་སྣང་བ་ཡིན་ནོ་༎ སྨྲས་ཀྱང་གོ་བར་བྱ་བ་༄༢༣༥ཨ་༌་༎
 03056 uktāv apy asiddhau sandehe vā pratipādya-pratipādakayoḥ|	དང་གོ་བར་བྱེད་པ་གཉིས་ལས་མ་གྲུབ་པའམ་།
 03057 ekasya rūpasya dharmi-sambandhasya asiddhau sandehe vā asiddho hetvābhāsāḥ|	ཐེ་ཚོམ་ཟ་ན་ཡང་ངོ་༎ ཆོས་ཅན་དང་འབྲེལ་པའི་ཚུལ་གཅིག་མ་གྲུབ་པའམ་། ཐེ་ཚོམ་ཟ་ན་མ་གྲུབ་པའི་གཏན་ཚིགས་ལྟར་སྣང་བ་ཡིན་ཏེ་།
 03058 yathā, anityaḥ śabda iti sādhye cākṣuṣatvam ubhaya-asiddham|	དཔེར་ན་སྒྲ་མི་རྟག་པའོ་ཞེས་སྒྲུབ་པ་ལ་། མིག་གིས་གཟུང་བ་ཉིད་ནི་གཉི་ག་ལ་མ་གྲུབ་པ་ལྟ་བུའོ་༎ ཤིང་རྣམས་ལ་སེམས་ཡོད་པར་སྒྲུབ་པ་ལ་།
 03059 cetanās tarava iti sādhye sarva-tvag-apaharaṇe maraṇaṃ prativādy-asiddham,	ཤུན་པ་ཐམས་ཅད་བཤུས་ནས་འཆི་བ་ནི་ཕྱིར་རྒོལ་བ་ལ་མ་གྲུབ་སྟེ་།
 vijñāna-indriya-āyur nirodha-lakṣaṇasya maraṇasya anena abhyupagamāt,	དེ་ནི་རྣམ་པར་ཤེས་པ་དང་། དབང་པོ་དང་། ཚེ་འགགས་པའི་མཚན་ཉིད་ལ་འཆི་བ་ཡིན་པར་ཁས་ལེན་པའི་ཕྱིར་རོ་༎
 tasya ca taruṣv asambhavāt|	དེ་ཡང་ཤིང་དག་ལ་མི་སྲིད་པའི་ཕྱིར་རོ་༎
 03060 acetanāḥ sukha-ādaya iti sādhye utpattimatvaṃ vā sāṃkhyasya svayaṃ vādino asiddham|	བདེ་བ་ལ་སོགས་པ་སེམས་པ་མེད་པར་སྒྲུབ་པ་ལ་སྐྱེ་བ་ཅན་ནམ་། མི་རྟག་པ་ཉིད་ནི་གྲངས་ཅན་རྒོལ་བ་བདག་ཉིད་ལ་མ་གྲུབ་པའོ་༎
 03061 tathā svayaṃ tad-āśrayaṇasya vā sandehe asiddhaḥ|	དེ་བཞིན་དུ་བདག་ཉིད་དང་དེའི་གཞི་ལ་ཐེ་ཚོམ་ཟ་ན་ཡང་མ་གྲུབ་པ་ཡིན་ཏེ་།
 03062 yathā bāṣpa-ādi-bhāvena sandihyamāno bhūta-saṃghāto agni-siddhāv upadiśyamānaḥ sandigdha-asiddhaḥ| 03063 yathā iha nikuñje mayūraḥ kekāyitād iti| 03064 tad-āpāta-deśa-vibhrame|	དཔེར་ན་མེ་བསྒྲུབ་པར་བྱ་བ་ལ་རླངས་པ་ལ་སོགས་པའི་དངོས་པོར་ཐེ་ཚོམ་ཟ་བའི་འབྱུང་བ་འདུས་པ་ལྟ་བུ་དང་། དཔེར་ན་རྨ་བྱའི་སྒྲ་གྲག་པའི་ཕྱིར་རི་སུལ་འདི་ན་རྨ་བྱ་ཡོད་དོ་ཞེས་བྱ་བ་ལ་། དེ་གྲག་པའི་ཡུལ་མི་རྟོགས་པ་ལྟ་བུའོ་༎
 03065 dharmy-asiddhāv apy asiddhaḥ,	ཆོས་ཅན་མ་གྲུབ་ན་ཡང་མ་གྲུབ་པ་ཡིན་ཏེ་།
 yathā sarvagata ātmā iti sādhye sarvatra upalambhamāna-guṇatvam|	དཔེར་ན་བདག་ཐམས་ཅད་ན་གནས་པར་སྒྲུབ་པ་ལ་ཐམས་ཅད་ན་དམིགས་པའི་ཡོན་ཏན་ཉིད་ལྟ་བུའོ་༎ 
 03066 tathā ekasya rūpasya asapakṣe asattvasya asiddhāv anaikāntiko hetvābhāsaḥ|	དེ་བཞིན་དུ་མི་མཐུན་པའི་ཕྱོགས་ལ་མེད་པའི་ཚུལ་གཅིག་མ་གྲུབ་ན་ཡང་མ་ངེས་པའི་གཏན་ཚིགས་ལྟར་སྣང་བ་ཡིན་ཏེ་།
 03067 yathā śabdasya anityatva-ādike dharme sādhye prameyatva-ādiko dharmaḥ sapakṣa-vipakṣayoḥ sarvatra ekadeśe vā vartamānaḥ|	དཔེར་ན་སྒྲ་རྟག་པ་ཉིད་ལ་སོགས་པའི་ཆོས་སུ་སྒྲུབ་པ་ལ་། གཞལ་བྱ་ཉིད་ལ་སོགས་པའི་ཆོས་ནི་མཐུན་པའི་ཕྱོགས་དང་མི་མཐུན་པའི་ཕྱོགས་ཐམས་ཅད་ལའམ་། ཕྱོགས་གཅིག་ལ་ཡོད་པ་ལྟ་བུའོ་༎
 03068 tathā, asya eva rūpasya sandehe apy anaikāntika eva|	དེ་བཞིན་དུ་ཚུལ་དེ་ཉིད་ལ་ཐེ་ཚོམ་ཟ་ན་ཡང་མ་ངེས་པ་ཁོ་ན་སྟེ་།
 03069 yathā asarvajñaḥ kaścid vivakṣitaḥ puruṣo rāga-ādimān vā sādhye vaktṛtva-ādiko dharmaḥ sandigdha-vipakṣa-vyāvṛttikaḥ|	དཔེར་ན་བརྗོད་པར་འདོད་པའི་མི་ལ་ལ་ཞིག་ཐམས་ཅད་མཁྱེན་པ་མ་ཡིན་པའམ་། འདོད་ཆགས་ལ་སོགས་པ་དང་ལྡན་པ་སྒྲུབ་པ་ལ་སྨྲ་བ་ལ་སོགས་པའི་ཆོས་ལྟ་བུ་སྟེ་། མི་མཐུན་པའི་ཕྱོགས་ལས་ལྡོག་པ་ལ་ཐེ་ཚོམ་ཟ་བ་ཡིན་ནོ་༎
 03070 sarvajño vaktā na upalabhyate ity evaṃprakārasya anupalambhasya adṛśya-ātma-viṣayatvena sandeha-hetutvāt| tato asarvajña-viparyayād vaktṛtva-āder vyāvṛttiḥ sandigdhā|	ཐམས་ཅད་མཁྱེན་པ་ལ་སྨྲ་བ་མ་དམིགས་སོ་ཞེས་བྱ་བའི་མི་དམིགས་པའི་རྣམ་པ་དེ་ལྟ་བུ་ནི་ཡུལ་ལྟར་མི་སྣང་བ་ཉིད་ཀྱིས་ཐེ་ཚོམ་གྱི་རྒྱུ་ཡིན་༄༢༣༥བ་པའི་ཕྱིར་རོ་༎ དེ་བས་ན་ཐམས་ཅད་མཁྱེན་པ་མ་ཡིན་པ་ལས་ལྡོག་པ་ལ་སྨྲ་བ་ལ་སོགས་པ་ལྡོག་པ་ནི་ཐེ་ཚོམ་དུ་འགྱུར་བ་ཡིན་ཏེ་།
 03071 vaktṛtva-sarvajñatvayor virodha-abhāvāc ca yaḥ sarvajñaḥ sa vaktā na bhavati ity adarśane api vyatireko na sidhyati sandehāt|	སྨྲ་བ་ཉིད་དང་། ཐམས་ཅད་མཁྱེན་པ་ཉིད་གཉིས་ལ་འགལ་བ་མེད་པའི་ཕྱིར་རོ་༎ མ་མཐོང་དུ་ཟིན་ཀྱང་ཐམས་ཅད་མཁྱེན་པ་གང་ཡིན་པ་དེ་སྨྲ་བ་མ་ཡིན་ནོ་ཞེས་བྱ་བའི་ལྡོག་པ་ནི་མི་འགྲུབ་སྟེ་། ཐེ་ཚོམ་ཟ་བའི་ཕྱིར་རོ་༎
 03072 dvividho hi padārthānāṃ virodhaḥ|	དངོས་པོ་རྣམས་ཀྱི་འགལ་བ་ནི་རྣམ་པ་གཉིས་ཏེ་།
 03073 avikala-kāraṇasya bhavato anyabhāve abhāvād virodha-gatiḥ|	རྒྱུ་མ་ཚང་བ་མེད་པར་འབྱུང་བ་ལ་གཞན་ཡོད་ན་མེད་པའི་ཕྱིར་འགལ་བ་སྟེ་།
 03074 śīta-uṣṇa-sparśa-vat|	གྲང་བ་དང་ཚ་བའི་རེག་པ་ལྟ་བུའོ་༎
 03075 paraspara-parihāra-sthita-lakṣaṇatayā vā bhāva-abhāva-vat|	གཅིག་གིས་གཅིག་སྤངས་ཏེ་གནས་པའི་མཚན་ཉིད་ཁོ་ན་སྟེ་ཡོད་པ་དང་མེད་པ་ལྟ་བུའོ་༎
 03076 sa ca dvividho api virodho vaktṛtva-sarvajñatvayor na sambhavati| 03077 na ca aviruddha-vidher anupalabdhāv apy abhāva-gatiḥ|	འགལ་བ་རྣམ་པ་དེ་གཉི་ག་ཡང་སྨྲ་བ་ཉིད་དང་ཐམས་ཅད་མཁྱེན་པ་ཉིད་ལ་མི་སྲིད་པའི་ཕྱིར་མི་འགལ་བ་ཡོད་པའི་ཕྱིར་དམིགས་ཀྱང་མེད་པར་རྟོགས་པ་མ་ཡིན་ནོ་༎
 03078 rāga-ādīnāṃ vacana-ādeś ca kāryakāraṇabhāva-asiddheḥ|	འདོད་ཆགས་ལ་སོགས་པ་དང་ཚིགས་ལ་སོགས་པ་ཡང་རྒྱུ་དང་འབྲས་བུའི་དངོས་པོར་མ་གྲུབ་པའི་ཕྱིར་། 
 03079 arthāntarasya ca akāraṇasya nivṛttau na vacana-āder nivṛttiḥ|	དོན་གཞན་རྒྱུ་མ་ཡིན་པ་ལོག་པས་ཚིག་ལ་སོགས་པ་ལྡོག་པ་ནི་མ་ཡིན་ཏེ་ཕྱིར་། 
 03080 iti sandigdha-vyatireko anaikāntiko vacana-ādiḥ|	། དེ་ལྟར་ཚིག་ལ་སོགས་པ་ལྡོག་པ་ལ་ཐེ་ཚོམ་ཟ་བ་དང་ལྡན་པའི་མ་ངེས་པ་ཡིན་ནོ་༎
 03081 dvayo rūpayor viparyaya-siddhau viruddhaḥ|	ཚུལ་གཉིས་ཀྱི་ཕྱིན་ཅི་ལོག་ཏུ་གྲུབ་པ་ནི་འགལ་བ་ཡིན་ནོ་༎
 03082 kayor dvayoḥ|	གཉིས་པོ་གང་ཞེ་ན་།
 03083 sapakṣe sattvasya,	མཐུན་པའི་ཕྱོགས་ལ་ཡོད་པ་དང་། མི་མཐུན་པའི་ཕྱོགས་ལ་མེད་པའོ་༎
 asapakṣe ca asattvasya, yathā kṛtakatvaṃ prayatnānantarīyakatvaṃ ca nityatve sādhye viruddho hetvābhāsaḥ|	བྱས་པ་ཉིད་དང་བརྩལ་མ་ཐག་ཏུ་འབྱུང་བ་ཉིད་ནི་རྟག་པ་ཉིད་སྒྲུབ་པ་ལ་འགལ་བའི་གཏན་ཚིགས་ལྟར་སྣང་བ་ཡིན་ཏེ་།
 03084 anayoḥ sapakṣe asattvam, asapakṣe ca sattvam iti viparyaya-siddhiḥ|	འདི་གཉིས་ཀྱི་མཐུན་པའི་ཕྱོགས་ལ་མེད་པ་དང་། མི་མཐུན་པའི་ཕྱོགས་ལ་ཡོད་པས་ཕྱིན་ཅི་ལོག་ཏུ་གྲུབ་པ་ཡིན་ལ་།
 03085 etau ca sādhya-viparyaya-sādhanād viruddhau|	དེ་གཉིས་ནི་བསྒྲུབ་པར་བྱ་བ་ཕྱིན་ཅི་ལོག་ཏུ་སྒྲུབ་པའི་ཕྱིར་འགལ་བ་དག་ཡིན་ནོ་༎
 03086 nanu ca tṛtīyo api iṣṭa-vighāta-kṛd viruddhaḥ|	འདོད་པ་ལ་གནོད་པ་བྱེད་པའི་ཕྱིར་འགལ་བ་གསུམ་པ་ཡང་བ་མ་ཡིན་ནམ་།
 03087 yathā parārthāś cakṣur-ādayaḥ saṃghātatvāc śayana-āsana-ādy-aṅga-vad iti|	དཔེར་ན་འདུས་པ་ཡིན་པའི་ཕྱིར་མིག་ལ་སོགས་པ་ནི་གཞན་གྱི་དོན་བྱེད་པ་ཉིད་དེ་མལ་ཆ་དང་སྟན་ལ་སོགས་པའི་ཡན་ལག་བཞིན་ནོ་ཞེས་པ་ལྟ་བུའོ་༎
 03088 tad iṣṭa-saṃhata-pārārthya-viparyaya-sādhanād viruddhaḥ|	དེ་ནི་འདུས་པ་མ་ཡིན་པ་གཞན་གྱི་དོན་བྱེད་པར་འདོད་དེ་། ཕྱིན་ཅི་ལོག་ཏུ་སྒྲུབ་པའི་ཕྱིར་འགལ་བའོ་༎
 03089 sa iha kasmān na uktaḥ|	དེ་ཅིའི་ཕྱིར་མ་སྨྲས་ཤེ་ན་།
 03090 anayor antarbhāvāt|	འདི་གཉིས་ཁོ་ནའི་ནང་དུ་འདུས་པའི་ཕྱིར་།
 03091 na hy ayam ābhyāṃ sādhya-viparyaya-sādhanatvena bhidyate|	དེ་ནི་བསྒྲུབ་པར་བྱ་བ་ལོག་པར་༄༢༣༦ཨ་༌་༎ བསྒྲུབས་པས་འདི་གཉིས་དང་ཐ་དད་པ་མ་ཡིན་ནོ་༎
 03092 na hi iṣṭa-uktayoḥ sādhyatvena kaścid viśeṣa iti| 03093 dvayo rūpayor ekasya asiddhāv aparasya ca sandehe anaikāntikaḥ|	འདོད་པ་དང་སྨྲས་པ་གཉིས་ལ་བསྒྲུབ་པར་བྱ་བ་ཉིད་དུ་ནི་བྱེ་བྲག་ཅི་ཡང་མེད་དོ་༎ ཚུལ་གཉིས་ལས་གཅིག་ནི་མ་གྲུབ་ལ་། ཅིག་ཤོས་ལ་ནི་ཐེ་ཚོམ་ཟ་བ་ཡང་མ་ངེས་པ་ཡིན་ཏེ་།
 03094 yathā vīta-rāgaḥ kaścit sarvajño vā,	དཔེར་ན་སྨྲ་བའི་ཕྱིར་འདོད་ཆགས་དང་བྲལ་བའམ་། ཐམས་ཅད་མཁྱེན་པ་ཡིན་ནོ་ཞེས་བྱ་བ་ལྟ་བུ་སྟེ་།
 vaktṛtvād iti| vyatireko atra asiddhaḥ,	འདི་ལ་ལྡོག་པ་ནི་མ་གྲུབ་ལ་།
 sandigdho anvayaḥ|	རྗེས་སུ་འགྲོ་བ་ལ་ནི་ཐེ་ཚོམ་ཟ་བ་ཡིན་ཏེ་། ཐམས་ཅད་མཁྱེན་པ་དང་འདོད་ཆགས་དང་བྲལ་བ་ནི་བསྐལ་པ་ཡིན་པའི་ཕྱིར་།
 03095 sarvajña-vīta-rāgayor viprakarṣād vacana-ādes tatra sattvam asattvaṃ vā sandigdham|	དེ་ལ་ཚིག་ལ་སོགས་པ་ཡོད་དམ་མེད་པར་ཐེ་ཚོམ་ཟ་བའི་ཕྱིར་རོ་༎
 03096 anayor eva dvayo rūpayoḥ sandehe anaikāntikaḥ|	ཚུལ་དེ་ཉིད་ལ་ཐེ་ཚོམ་ཟ་ན་མ་ངེས་པ་ཡིན་ཏེ་།
 03097 yathā sātmakaṃ jīvaccharīraṃ prāṇa-ādimattvād iti|	དཔེར་ན་སྲོག་ལ་སོགས་པ་དང་ལྡན་པའི་ཕྱིར་། གསོན་པོའི་ལུས་ནི་བདག་དང་བཅས་པ་ཡིན་ནོ་ཞེས་བྱ་བ་ལྟ་བུ་སྟེ་།
 03098 na hi sātmaka-nirātmakābhyām anyo rāśir asti yatra ayaṃ prāṇa-ādir vartate|	བདག་དང་བཅས་པ་དང་བདག་མེད་པ་ལས་གང་ལ་སྲོག་ལ་སོགས་པ་གནས་པར་འགྱུར་བའི་ཕུང་པོ་གཞན་ནི་མེད་དེ་།
 03099 ātmano vṛtti-vyavacchedābhyāṃ sarva-saṃgrahād|	བདག་གནས་པ་དང་རྣམ་པར་གཅོད་པ་དག་གིས་ཐམས་ཅད་བསྡུས་པའི་ཕྱིར་རོ་༎
 03100 na apy anayor ekatra vṛtti-niścayaḥ|	འདི་གཉིས་ལས་གཅིག་ལ་གནས་པར་ཡང་ངེས་པ་མེད་དེ་།
 03101 sātmakatvena anātmakatvena vā prasiddhe prāṇa-āder asiddheḥ|	བདག་དང་བཅས་པའམ་བདག་མེད་པར་སྒྲུབ་པ་ལ་སྲོག་ལ་སོགས་པ་མ་གྲུབ་པའི་ཕྱིར་རོ་༎
 03102 tasmāj jīvaccharīra-sambandhī prāṇa-ādiḥ sātmakād anātmakāc ca sarvasmād vyāvṛttatvena asiddhes tābhyāṃ na vyatiricyate|	དེ་བས་ན་གསོན་པོའི་ལུས་དང་འབྲེལ་བ་ཅན་གྱི་སྲོག་ལ་སོགས་པ་ནི་བདག་དང་བཅས་པ་དང་བདག་མེད་པ་ཐམས་ཅད་ལས་ལྡོག་པ་ཉིད་དུ་མ་གྲུབ་པའི་ཕྱིར་དེ་གཉིས་དང་མ་བྲལ་བའོ་༎ 
 03103 na tatra anveti| 03104 ekātmany apy asiddheḥ|	བདག་གཅིག་ལ་ཡང་མ་གྲུབ་པའི་ཕྱིར་དེ་ལ་རྗེས་སུ་འགྲོ་བ་མེད་དོ་༎
 03105 na api sātmakād anātmakāc ca tasya anvaya-vyatirekayor abhāva-niścayaḥ| 03106 eka-abhāva-niścayasya apara-bhāva-niścaya-nāntarīyakatvāt|	བདག་དང་བཅས་པ་དང་བདག་མེད་པ་དེའི་རྗེས་སུ་འགྲོ་བ་དང་། ལྡོག་པ་གཉིས་མེད་པར་ངེས་པ་མེད་དེ་།
 03107 anvaya-vyatirekayor anyonya-vyavaccheda-rūpatvāt| tata eva anvaya-vyatirekayoḥ sandehād anaikāntikāḥ|	རྗེས་སུ་འགྲོ་བ་དང་ལྡོག་པ་གཉིས་ནི་ཕན་ཚུན་གཅོད་པའི་ངོ་བོ་ཁོ་ན་ཡིན་པའི་ཕྱིར་རོ་༎ གཅིག་མེད་པར་ངེས་པ་ནི་ཅིག་ཤོས་ཡོད་པར་གདོན་མི་ཟ་བའི་ཕྱིར་རོ་༎ དེ་ཉིད་ཀྱི་ཕྱིར་རྗེས་སུ་འགྲོ་བ་དང་ལྡོག་པ་གཉིས་ལ་ཐེ་ཚོམ་ཟ་བའི་མ་ངེས་པ་ཡིན་ཏེ་། 
 03108 sādhya-itarayor ato niścaya-abhāvāt|	བསྒྲུབ་པར་བྱ་བ་དང་ཅིག་ཤོས་ལ་ངེས་པ་མེད་པའི་ཕྱིར་རོ་༎
 03109 evam eṣāṃ trayāṇāṃ rūpāṇām ekaikasya dvayor dvayor vā rūpayor asiddhau sandehe vā yathāyogam asiddha-viruddha-anaikāntikās trayo hetvābhāsāḥ|	དེ་ལྟར་ན་ཚུལ་གསུམ་པོ་དེ་དག་ལས་ཚུལ་རེ་རེ་ཡང་གཉིས་གཉིས་ལ་མ་གྲུབ་པའམ་། ཐེ་ཚོམ་ཟ་བ་ཡིན་ཏེ་། ཅི་རིགས་པར་གཏན་ཚིགས་ལྟར་སྣང་བ་གསུམ་པོ་མ་༄༢༣༦བ་གྲུབ་པ་དང་འགལ་བ་དང་། མ་ངེས་པ་དག་ཡིན་ནོ་༎
 03110 viruddhāvyabhicāry api saṃśaya-hetur uktaḥ| sa iha kasmān na uktaḥ|	འགལ་བ་མི་འཁྲུལ་པ་ཅན་ཡང་ཐེ་ཚོམ་གྱི་རྒྱུར་བཤད་ན་། དེ་འདིར་མ་སྨོས་ཏེ་།
 03111 anumāna-viṣaye asambhavāt|	རྗེས་སུ་དཔག་པའི་ཡུལ་ལ་མི་སྲིད་པའི་ཕྱིར་རོ་༎
 03112 na hi sambhavo asti kārya-svabhāvayor ukta-lakṣaṇayor anupalambhasya ca viruddhatāyāḥ|	འབྲས་བུའམ་རང་བཞིན་ནམ་མི་དམིགས་པའི་མཚན་ཉིད་སྨོས་པ་ལ་འགལ་བ་མི་འཁྲུལ་པ་ཅན་མི་སྲིད་ལ་། 
 03113 na ca anyo avyabhicārī|	མི་འཁྲུལ་པ་ཅན་གཞན་ནི་མེད་དོ་༎
 03114 tasmād avastu-darśana-bala-pravṛttam āgama-āśrayam anumānam āśritya tad-artha-vicāreṣu viruddhāvyabhicārī sādhana-doṣa uktaḥ|	དེ་ལྟ་བས་ན་དངོས་པོ་མ་མཐོང་པའི་སྟོབས་ཀྱིས་ཞུགས་པ་ཡིན་པས་ན་ལུང་ལ་བརྟེན་པའི་རྗེས་སུ་དཔག་པ་ལ་བརྟེན་ཏེ་། དེའི་དོན་དཔྱད་པ་དག་ལ་འགལ་བ་མི་འཁྲུལ་པ་ཅན་ནི་སྒྲུབ་པའི་སྐྱོན་དུ་བཤད་དོ་༎
 03115 śāstrakārāṇām artheṣu bhrāntyā viparīta-svabhāva-upasaṃhāra-sambhavāt|	བསྟན་བཅོས་བྱེད་པ་རྣམས་ནི་དོན་རྣམས་ལ་འཁྲུལ་པས་རང་བཞིན་ལོག་པར་སྟོན་པ་སྲིད་པའི་ཕྱིར་རོ་༎ 
 03116 na hy asya sambhavo yathāvasthita-vastu-sthitiṣv ātma-kārya-anupalambheṣu|	དངོས་པོ་ཅི་ལྟ་བ་བཞིན་དུ་གནས་པར་འདུག་པ་བདག་དང་འབྲས་བུ་དང་མི་དམིགས་པ་དག་ལ་མི་སྲིད་པའི་ཕྱིར་རོ་༎
 03117 tatra udāharaṇam: yat sarva-deśa-avasthitaiḥ sva-sambandhibhir yugapad abhisambadhyate tat sarvagatam,	འདིར་དཔེ་ནི་གང་ཞིག་ཡུལ་ཐམས་ཅད་ན་གནས་པ་རང་དང་འབྲེལ་བ་ཅན་དག་དང་། གཅིག་པུར་མངོན་པར་འབྲེལ་བ་དེ་ནི་ཐམས་ཅད་ལ་གནས་པ་ཡིན་ཏེ་། དཔེར་ན་ནམ་མཁའ་ལ་སོགས་པ་བཞིན་ནོ་༎
 yathā ākāśam| abhisambadhyate ca sarva-deśa-avasthitaiḥ sva-sambandhibhir yugapat sāmānyam iti| 03118 tat-sambandhi-svabhāva-mātra-anubandhinī tad-deśa-saṃnihita-svabhāvatā|	སྤྱི་ཡང་ཡུལ་ཐམས་ཅད་པ་རང་དང་འབྲེལ་བ་ཅན་དག་དང་ཅིག་ཅར་དུ་མངོན་པར་འབྲེལ་ཏོ་༎ དེ་དང་འབྲེལ་བ་ཅན་གྱི་རང་བཞིན་ཙམ་གྱི་རྗེས་སུ་འཇུག་པའི་རང་བཞིན་ཅན་དེའི་ཡུལ་ན་འདུག་པའི་རང་བཞིན་ཉིད་ཡིན་ནོ་༎
 03119 na hi yo yatra na asti tad-deśam ātmanā vyāpnoti iti svabhāvahetu-prayogaḥ|	གང་ན་གང་མེད་པ་དེ་ནི་དེའི་ཡུལ་བདག་ཉིད་ཁྱབ་པར་བྱེད་པ་མ་ཡིན་ནོ་ཞེས་བྱ་བ་ནི་རང་བཞིན་གྱི་གཏན་ཚིགས་ཀྱི་སྦྱོར་བ་ཡིན་ནོ་༎ 
 03120 dvitīyo api prayogaḥ: yad upalabdhi-lakṣaṇa-prāptaṃ san na upalabhyate na tat tatra asti| tad yathā,	སྦྱོར་བ་གཉིས་པ་ཡང་དམིགས་པའི་རིག་བྱར་གྱུར་པ་གང་ཞིག་གང་ན་མི་དམིགས་པ་དེ་ནི་དེ་ན་མེད་དེ་།
 kvacid avidyamāno ghaṭaḥ| na upalabhyate ca upalabdhi-lakṣaṇa-prāptaṃ sāmānyaṃ vyakty-antarāleṣv	དཔེར་ན་འགའ་ཞིག་ན་བུམ་པ་མེད་དོ་ཞེས་བྱ་བ་ལྟ་བུ་ཡིན་ལ་གསལ་བའི་བར་རྣམས་ལ་ཡང་དམིགས་པའི་རིག་བྱར་གྱུར་པ་སྤྱི་མི་དམིགས་སོ་ཞེས་བྱ་བའོ་༎
 iti| ayam anupalambhaḥ svabhāvaś ca paraspara-viruddha-artha-sādhanād ekatra saṃśayaṃ janayataḥ|	མི་དམིགས་པ་འདི་དང་རང་བཞིན་དེ་ནི་ཕན་ཚུན་འགལ་བའི་དོན་དུ་བསྒྲུབས་པ་ཡིན་པས་གཅིག་ལ་ཐེ་ཚོམ་སྐྱེད་པར་བྱེད་དོ་༎
 03121 trirūpo hetur uktaḥ| tāvatā ca artha-pratītir iti na pṛthag dṛṣṭānto nāma sādhana-avayavaḥ kaścid| tena na asya lakṣaṇaṃ pṛthag ucyate	གཏན་ཚིགས་ཀྱི་མཚན་ཉིད་གསུམ་སྨོས་པ་དེ་ཙམ་གྱིས་དོན་རྟོགས་པས་དཔེ་ཞེས་བྱ་བ་སྒྲུབ་པའི་ཡན་ལག་ནི་ལོགས་ཤིག་ཏུ་ཅི་ཡང་མེད་དོ་༎ དེས་ན་དེའི་མཚན་ཉིད་ལོགས་ཤིག་ཏུ་མ་བརྗོད་དེ་དོན་གོ་བའི་ཕྱིར་རོ་༎ གཏན་ཚིགས་ནི་མཐུན་པའི་ཕྱོགས་༄༢༣༧ཨ་༌་༎
 03122 hetoḥ sapakṣa eva sattvam asapakṣāc ca sarvato vyāvṛttī rūpam uktam abhedena|	ཉིད་ལ་ཡོད་པ་དང་། མི་མཐུན་པའི་ཕྱོགས་ཐམས་ཅད་ལས་ལྡོག་པའི་ཚུལ་དུ་བྱེ་བྲག་མེད་པར་བཤད་པ་ལ་།
 punar viśeṣeṇa kārya-svabhāvayor ukta-lakṣaṇayor janma-tan-mātra-anubandhau darśanīya-avaktau| tac ca darśayatā,	ཡང་བྱེ་བྲག་ཏུ་ནི་འབྲས་བུ་དང་རང་བཞིན་གཉིས་ཀྱི་སྐྱེ་བ་དང་དེ་ཙམ་གྱི་རྗེས་སུ་འཇུག་པ་ཡིན་པར་བསྟན་པ་ཤེས་པར་བྱ་བར་བཤད་དེ་། 
 yatra dhūmas tatra agniḥ,	དེ་ཡང་སྟོན་པར་བྱེད་པས་གང་ན་དུ་བ་ཡོད་པ་དེ་ན་མེ་ཡོད་ལ་བཤད་དེ་། 
 asaty agnau na kvacid dhūmo yathā mahānasa-itarayoḥ,	། མེ་མེད་ན་དུ་བ་ཡང་མེད་དེ་། དཔེར་ན་ཚང་བང་དང་གཞན་པ་ལྟ་བུའོ་༎
 yatra kṛtakatvaṃ tatra anityatvam,	གང་ན་བྱས་པ་ཉིད་ཡོད་པ་དེ་ན་མི་རྟག་པ་ཉིད་ཡོད་ལ་།
 anityatva-abhāvo kṛtakatva-asambhavo yathā	མི་རྟག་པ་ཉིད་མེད་ན་བྱས་པ་ཡང་མི་སྲིད་དེ་།
 ghaṭa-ākāśayoḥ,	དཔེར་ན་བུམ་པ་དང་ནམ་མཁའ་དག་ལྟ་བུའོ་ཞེས་བཤད་པར་བྱའོ་༎
 iti darśanīyam| na hy anyathā sapakṣa-vipakṣayoḥ sadasattve yathokta-prakāre śakye darśayitum| tat kāryatā-niyamaḥ kārya-liṅgasya svabhāva-liṅgasya ca svabhāvena vyāptiḥ| asmiṃś ca arthe darśite darśita eva dṛṣṭānto bhavati| etāvān mātra-rūpatvāt tasya iti|	གཞན་དུ་ན་མཐུན་པའི་ཕྱོགས་དང་མི་མཐུན་པའི་ཕྱོགས་དག་ལ་ཡོད་པ་དང་མེད་པ་ཇི་སྐད་སྨོས་པའི་རྣམ་པ་དག་བསྟན་པར་མི་ནུས་སོ་༎ འབྲས་བུའི་རྟགས་ནི་དེའི་འབྲས་བུ་ཉིད་དུ་ངེས་པའམ་རང་བཞིན་གྱི་རྟགས་ནི་རང་བཞིན་གྱིས་ཁྱབ་པ་ཡིན་ལ་། དེའི་ཚུལ་ནི་དེ་ཙམ་དུ་ཟད་པའི་ཕྱིར་རོ་༎
 03123 etena eva dṛṣṭānta-doṣā api nirastā bhavanti|	འདིས་ནི་དཔེའི་ཉེས་པ་རྣམས་ཀྱང་བསལ་བ་ཡིན་ཏེ་།
 03124 yathā nityaḥ śabdo amūrtatvāt| karma-vat paramāṇu-vad ghaṭa-vad iti| ete dṛṣṭāntābhāsāḥ sādhya-sādhana-dharma-ubhaya-vikalāḥ|	དཔེར་ན་སྒྲ་ནི་རྟག་པ་ཡིན་ཏེ་ལུས་ཅན་མ་ཡིན་པའི་ཕྱིར་། ལས་དང་རྡུལ་ཕྲ་རབ་དང་། བུམ་པ་བཞིན་ནོ་ཞེས་བྱ་བ་ནི་། བསྒྲུབ་པར་བྱ་བ་དང་། སྒྲུབ་པར་བྱེད་པའི་ཆོས་དག་གཉིས་ཀ་མེད་པ་ཡིན་ནོ་༎
 03125 tathā sandigdha-sādhya-dharma-ādayaś ca,	དེ་བཞིན་དུ་བསྒྲུབ་པར་བྱ་བའི་ཆོས་ལ་ཐེ་ཚོམ་ཟ་བ་ལ་སོགས་པ་ཡང་། དཔེར་ན་སྨྲ་བའི་ཕྱིར་ན་། འདོད་ཆགས་ལ་སོགས་པ་དང་ལྡན་པ་ཡིན་ཏེ་།
 yathā rāga-ādimān ayaṃ vacanād rathyā-puruṣa-vat| maraṇa-dharmo ayaṃ puruṣo rāga-ādimattvād rathyā-puruṣa-vat| asarvajño ayaṃ rāga-ādimatvād rathyā-puruṣa-vad iti|	ལམ་པོ་ཆེའི་མི་བཞིན་ནོ་ཞེས་བྱ་བ་དང་། མི་འདི་ནི་འདོད་ཆགས་ལ་སོགས་པ་དང་ལྡན་པའི་ཕྱིར་། འཆི་བའི་ཆོས་ཅན་ཡིན་ཏེ་ལམ་པོ་ཆེའི་མི་བཞིན་ནོ་ཞེས་བྱ་བ་དང་། འདོད་ཆགས་ལ་སོགས་པ་དང་ལྡན་པའི་ཕྱིར་ཐམས་ཅད་མཁྱེན་པ་མ་ཡིན་ཏེ་། ལམ་པོ་ཆེའི་མི་བཞིན་ནོ་༎ ཞེས་བྱ་བ་ལྟ་བུའོ་༎
 03126 tathā ananvayo apradarśita-anvayaś ca, yathā yo uktā sa rāga-ādimān,	རྗེས་སུ་འགྲོ་བ་མེད་པ་དང་། རྗེས་སུ་འགྲོ་བ་རབ་ཏུ་མ་བསྟན་པ་ནི་དཔེར་ན་གང་སྨྲ་བ་དེ་ནི་འདོད་ཆགས་ལ་སོགས་པ་དང་ལྡན་པ་སྟེ་།
 iṣṭa-puruṣa-vat| anityaḥ śabdaḥ kṛtakatvād ghaṭa-vad iti|	འདོད་པའི་མི་བཞིན་ནོ་ཞེས་བྱ་བ་དང་། བྱས་པའི་ཕྱིར་སྒྲ་ནི་མི་རྟག་པ་སྟེ་། བུམ་པ་བཞིན་ནོ་ཞེས་བྱ་བ་ལྟ་བུའོ་༎
 03127 tathā viparīta-anvayaḥ, yad anityaṃ tat kṛtakam iti|	དེ་བཞིན་དུ་རྗེས་སུ་འགྲོ་བ་ཕྱིན་ཅི་ལོག་ནི་གང་མི་རྟག་པ་དེ་ནི་བྱས་པའོ་ཞེས་བྱ་བ་ལྟ་བུ་སྟེ་།
 03128 sādharmyeṇa dṛṣṭānta-doṣāḥ|	ཆོས་༄༢༣༧བ་མཐུན་པས་ཡིན་ནོ་༎
 03129 vaidharmyeṇa api, paramāṇu-vat karma-vat ākāśa-vad iti sādhya-ādy-avyatirekiṇaḥ|	ཆོས་མི་མཐུན་པས་ཀྱང་རྡུལ་ཕྲ་རབ་དང་ལས་དང་ནམ་མཁའ་བཞིན་ནོ་ཞེས་བྱ་བ་ནི་། བསྒྲུབ་པར་བྱ་བ་ལ་སོགས་པ་ལས་མི་ལྡོག་པ་ཅན་དག་ཡིན་ནོ་༎
 03130 tathā sandigdha-sādhya-vyatireka-ādayaḥ,	དེ་བཞིན་དུ་བསྒྲུབ་པར་བྱ་བ་ལས་། ལྡོག་པ་ལ་ཐེ་ཚོམ་ཟ་བ་ལ་སོགས་པ་ནི་།
 yathā asarvajñāḥ kapila-ādayo anāptā vā avidyamāna-sarvajñatā-āptatā-liṅgabhūta-pramāṇa-atiśaya-śāsanatvād iti| atra vaidharmya-udāharaṇam,	དཔེར་ན་སེར་སྐྱ་ལ་སོགས་པ་ནི་ཐམས་ཅད་མཁྱེན་པའམ་ཡིད་ཆེས་པ་མ་ཡིན་ཏེ་། ཐམས་ཅད་མཁྱེན་པ་དང་འདོད་ཆགས་དང་བྲལ་བའི་རྟགས་སུ་གྱུར་པ་ཚད་མ་ཕུལ་དུ་ཕྱིན་པ་བསྟན་པ་མེད་པ་ཉིད་ཀྱི་ཕྱིར་རོ་ཞེས་བྱ་བ་ལྟ་བུའོ་༎ 
 yaḥ sarvajña āpto vā sa jyotir-jñāna-ādikam upadiṣṭavān,	འདིར་ཆོས་མི་མཐུན་པའི་དཔེ་ནི་གང་ཞིག་ཐམས་ཅད་མཁྱེན་པའམ་༏་འདོད་ཆགས་དང་བྲལ་བ་ཡིན་པ་དེས་ནི་སྐར་མའི་ཤེས་པ་ལ་སོགས་པ་བསྟན་ཏེ་། དཔེར་ན་ཁྱུ་མཆོག་དང་སྡོང་རིས་ལ་སོགས་པ་ལྟ་བུའོ་༎
 yathā ṛṣabha-vardhamāna-ādir iti| tatra asarvajñatā anāptayoḥ sādhya-dharmayoḥ sandigdho vyatirekaḥ|	ཆོས་མི་མཐུན་པའི་དཔེ་ལས་བསྒྲུབ་པར་བྱ་བའི་ཆོས་ཐམས་ཅད་མཁྱེན་པ་ཉིད་མ་ཡིན་པ་དང་། ཡིད་ཆེས་པ་མ་ཡིན་པ་གཉིས་ལྡོག་པ་ལ་ཐེ་ཚོམ་ཟ་བ་ཡིན་ནོ་༎
 03131 sandigdha-sādhana-vyatireko yathā,	བསྒྲུབ་པ་ལས་ལྡོག་པ་ལ་ཐེ་ཚོམ་ཟ་བ་ནི་།
 na trayīvidā brāhmaṇena grāhya-vacanaḥ kaścid vivakṣitaḥ puruṣo rāga-ādimattvād iti| atra vaidharmya-udāharaṇam,	དཔེར་ན་གསུམ་རིག་པའི་བྲམ་ཟེས་ནི་མི་འགའ་ཞིག་གི་བརྗོད་པར་འདོད་པའི་ཚིག་གཟུང་བར་མི་བྱ་སྟེ་། འདོད་ཆགས་ལ་སོགས་པ་དང་ལྡན་པའི་ཕྱིར་རོ་ཞེས་བྱ་བ་ལྟ་བུའོ་༎
 ye grāhya-vacanā na te rāga-ādimantaḥ| tad yathā gautama-ādayo dharma-śāstrāṇāṃ praṇetāra iti| gautama-ādibhyo rāga-ādimattvasya sādhana-dharmasya vyāvṛttiḥ sandigdhā|	འདིར་ཆོས་མི་མཐུན་པའི་དཔེ་ནི་ཚིག་གཟུང་བར་བྱ་བ་གང་དག་ཡིན་པ་དེ་ནི་འདོད་ཆགས་ལ་སོགས་པ་དང་མི་ལྡན་པ་སྟེ་། དཔེར་ན་གོ་ཏ་མ་ལ་སོགས་པ་ཆོས་ཀྱི་བསྟན་བཅོས་རྣམས་བྱེད་པ་ལྟ་བུ་སྟེ་། གོ་ཏ་མ་ལ་སོགས་པ་ལས་སྒྲུབ་པའི་ཆོས་འདོད་ཆགས་ལ་སོགས་པ་དང་ལྡན་པ་ལྡོག་པ་ལ་ཐེ་ཚོམ་ཟ་བ་ཡིན་ནོ་༎
 03132 sandigdha-ubhaya-vyatireko yathā,	གཉིས་ཀ་ལས་ལྡོག་པ་ལ་ཐེ་ཚོམ་ཟ་བ་ནི་།
 avīta-rāgāḥ kapila-ādayaḥ,	དཔེར་ན་སེར་སྐྱ་ལ་སོགས་པ་ནི་ཡོངས་སུ་འཛིན་པ་དང་ཀུན་ཏུ་འཛིན་པ་དང་ལྡན་པའི་ཕྱིར་འདོད་ཆགས་དང་བྲལ་བ་མ་ཡིན་ནོ་ཞེས་བྱ་བ་ལྟ་བུའོ་༎
 parigraha-āgraha-yogād iti| atra vaidharmyeṇa udāharaṇam,	འདིར་ཆོས་མི་མཐུན་པའི་དཔེ་ནི་།
 yo vīta-rāgo na tasya parigraha-āgrahaḥ,	གང་ཞིག་འདོད་ཆགས་དང་བྲལ་བ་དེ་ལ་ནི་། ཡོངས་སུ་འཛིན་པ་དང་། ཀུན་དུ་འཛིན་པ་མེད་དེ་།
 yathā ṛṣabha-āder iti| ṛṣabha-āder avīta-rāgatva-parigraha-āgraha-yogayoḥ sādhya-sādhana-dharmayoḥ sandigdho vyatirekaḥ|	དཔེར་ན་ཁྱུ་མཆོག་ལ་སོགས་པ་ལྟ་བུ་སྟེ་། བསྒྲུབ་པར་བྱ་བ་དང་སྒྲུབ་པའི་ཆོས་འདོད་ཆགས་དང་བྲལ་བ་ཉིད་དང་། ཡོངས་སུ་འཛིན་པ་དང་ཀུན་དུ་འཛིན་པ་ཁྱུ་མཆོག་ལ་སོགས་པ་ལས་ལྡོག་༄༢༣༨ཨ་༌་༎
 03133 avyatireko yathā,	པ་ལ་ཐེ་ཚོམ་ཟ་བ་ཡིན་ནོ་༎
 avīta-rāgo ayaṃ vaktṛtvāt| vaidharmyeṇa udāharaṇam,	ལྡོག་པ་མེད་པ་ནི་དཔེར་ན་སྨྲ་བའི་ཕྱིར་འདོད་ཆགས་དང་བྲལ་བ་མ་ཡིན་ནོ་ཞེས་བྱ་བ་ལྟ་བུའོ་༎ 
 yatra avīta-rāgatvaṃ na asti na sa vaktā,	གང་ལ་འདོད་ཆགས་དང་མ་བྲལ་བ་ཉིད་མེད་པ་དེ་ནི་སྨྲ་བ་མ་བ་ལྟ་བུའོ་༎ ཡིན་ཏེ་། དཔེར་ན་རྡོའི་དུམ་བུ་བཞིན་ནོ་ཞེས་བྱ་བ་ལྟ་བུ་སྟེ་བ་ལྟ་བུའོ་༎ ཡིན་ཏེ་། 
 yathā upala-khaṇḍa iti| yady apy upala-khaṇḍād ubhayaṃ vyāvṛttaṃ tathā api sarvo vīta-rāgo na vaktā iti vyāptyā vyatireka-asiddher avyatirekaḥ|	། གལ་ཏེ་རྡོའི་དུམ་བུ་ལས་གཉི་ག་ལྡོག་པ་ཡོད་མོད་བ་ལྟ་བུའོ་༎ ཡིན་ཏེ་། ། ཀྱི་། འོན་ཀྱང་འདོད་ཆགས་དང་བྲལ་བ་ཐམས་ཅད་སྨྲ་བ་མ་ཡིན་ནོ་ཞེས་བྱ་བར་ཁྱབ་པར་ལྡོག་པ་མ་གྲུབ་པའི་ཕྱིར་ལྡོག་པ་མེད་པ་ཡིན་བ་ལྟ་བུའོ་༎ ཡིན་ཏེ་། ། ཀྱི་། ནོ་༎ 
 03134 apradarśita-vyatireko yathā,	ལྡོག་པ་རབ་ཏུ་མ་བསྟན་པ་ནི་བ་ལྟ་བུའོ་༎ ཡིན་ཏེ་། ། ཀྱི་། ནོ་༎ 
 anityaḥ śabdaḥ, kṛtakatvād ākāśa-vad iti vaidharmyeṇa|	། ཆོས་མི་མཐུན་པ་དཔེར་ན་སྒྲ་ནི་བྱས་པའི་མི་རྟག་པ་སྟེ་། དཔེར་ན་ནམ་མཁའ་བཞིན་ནོ་ཞེས་བྱ་བ་ལྟ་བུའོ་༎
 03135 viparīta-vyatireko yathā,	ལྡོག་པ་ཕྱིན་ཅི་ལོག་ནི་།
 yad akṛtakaṃ tan nityaṃ bhavati iti|	དཔེར་ན་གང་མ་བྱས་པ་དེ་ནི་རྟག་པ་ཡིན་ནོ་ཞེས་བྱ་བ་ལྟ་བུའོ་༎
 03136 na hy ebhir dṛṣṭāntābhāsāir hetoḥ sāmānyalakṣaṇaṃ sapakṣa eva sattvaṃ vipakṣe	དཔེ་ལྟར་སྣང་བ་དེ་དག་གིས་ནི་གཏན་ཚིགས་ཀྱི་སྤྱིའི་མཚན་ཉིད་མཐུན་པའི་ཕྱོགས་ཉིད་ལ་ཡོད་པ་དང་། མི་མཐུན་པའི་ཕྱོགས་ཐམས་ཅད་ལ་མེད་པ་ཉིད་དམ་།
 ca sarvatra asattvam eva niścayena śakyaṃ darśayituṃ viśeṣa-lakṣaṇaṃ vā| tad arthāpattyā eṣāṃ nirāso draṣṭavyaḥ|	བྱེ་བྲག་གི་མཚན་ཉིད་བསྟན་པར་མི་ནུས་ཏེ་། དེའི་ཕྱིར་དོན་གྱི་དབང་གིས་དེ་དག་བསལ་བར་རིག་པར་བྱའོ་༎
 03137 dūṣaṇā nyūnatā-ādy-uktiḥ|	མ་ཚང་བ་ཉིད་ལ་སོགས་པ་སྨྲས་པ་ནི་།
 03138 ye pūrvaṃ nyūnatā-ādayaḥ sādhana-doṣā uktās teṣām udbhāvanaṃ dūṣaṇam| tena para-iṣṭa-artha-siddhi-pratibandhāt|	སུན་འབྱིན་པ་དག་ཡིན་ནོ་༎ སྔར་སྒྲུབ་པའི་རྐྱེན་མ་ཚང་བ་ལ་སོགས་པ་སྨོས་པ་གང་ཡིན་པ་དེ་དག་བརྗོད་པ་ནི་སུན་འབྱིན་པ་ཡིན་ཏེ་། དེས་ཕ་རོལ་པོ་འདོད་པའི་དོན་འགྲུབ་པ་ལ་གེགས་བྱེད་པའི་ཕྱིར་རོ་༎
 03139 dūṣaṇābhāsās tu jātayaḥ|	སུན་འབྱིན་པ་ལྟར་སྣང་བདག་ནི་ལྟག་ཆོད་རྣམས་ཏེ་།
