skt	tib
 00104 namo buddhāya|	༄༢༣༨ཨ་༅་༎ རྒྱ་གར་སྐད་དུ་། ཧེ་ཏུ་བིན་དུ་ནའ་མ་པྲ་ཀ་ར་ན་། བོད་སྐད་དུ་། གཏན་ཚིགས་ཀྱི་ཐིགས་པ་ཞེས་བྱ་བའི་རབ་ཏུ་བྱེད་པ་། འཇམ་དཔལ་གཞོན་ནུར་གྱུར་པ་ལ་ཕྱག་འཚལ་ལོ་༎
 00105 parokṣa-artha-pratipatter anumāna-āśrayatvāt tad-vyutpādana-	དོན་ལྐོག་ཏུ་གྱུར་པ་སྒྲུབ་པའི་རྟེན་ནི་། རྗེས་སུ་དཔག་པ་ཉིད་ཡིན་པས་། དེ་བྱེ་བྲག་ཏུ་རྟོགས་པར་༄༢༣༨བ་བྱ་བའི་ཕྱིར་།
 00106 arthaṃ saṃkṣepata idam ārabhyate|	མདོར་བསྡུས་ནས་འདི་བརྩམ་མོ་༎
 00108 pakṣa-dharmas tad-aṃśena vyāpto hetus tridhā eva saḥ |	ཕྱོགས་ཆོས་དེའི་ཆས་ཁྱབ་པ་ནི་༎ གཏན་ཚིགས་དེ་ནི་རྣམ་གསུམ་ཉིད་༎
 00109 avinābhāva-niyamād hetvābhāsās tato apare ||	མེད་ན་མི་འབྱུང་ངེས་ཕྱིར་རོ་༎ གཏན་ཚིགས་ལྟར་སྣང་དེ་ལས་གཞན་༎
 00110 pakṣo dharmī,	ཕྱོགས་ནི་ཆོས་ཅན་ཏེ་།
 avayave samudāya-upacārāt| prayojana-abhāvād	ཡན་ལག་ལ་སྤྱི་ཉེ་བར་བརྟགས་པའི་ཕྱིར་རོ་༎
 00111 anupacāra iti cet, na,	གལ་ཏེ་དགོས་པ་མེད་པའི་ཕྱིར་ཉེ་བར་གདགས་པར་མི་བྱའོ་ཞེ་ན་།
 sarva-dharmi-dharma-pratiṣedha-arthatvād	མ་ཡིན་ཏེ་ཉེ་བར་གདགས་པ་ནི་ཆོས་ཅན་གྱི་ཆོས་ཐམས་ཅད་དགག་པའི་ཕྱིར་ཏེ་།
 00112 upacārasya| evaṃ hi cākṣuṣatva-ādi-parihṛtaṃ bhavati|	དེ་ལྟར་ན་མིག་གིས་གཟུང་བར་བྱ་བ་ཡིན་པའི་ཕྱིར་རོ་ཞེས་བྱ་བ་ལ་སོགས་པ་ཡོངས་སུ་སྤངས་པ་ཡིན་ནོ་༎
 00113 dharma-vacanena api dharmasya parāśrayatvād dharmy-āśraya-	གལ་ཏེ་ཆོས་ནི་གཞན་ལ་བརྟེན་པ་ཡིན་པས་ཀྱང་། རྟེན་ཆོས་ཅན་འགྲུབ་ལ་།
 00114 siddhau dharmi-grahaṇāt pratyāsatteḥ sādhya-dharmi-siddhir iti	ཆོས་ཅན་སྨོས་པས་ཀྱང་ཉེ་བ་ཡིན་པའི་ཕྱིར་། བསྒྲུབ་པར་བྱ་བའི་ཆོས་ཅན་ཡིན་པར་འགྲུབ་པོ་ཞེ་ན་། དཔེའི་ཆོས་ཅན་ཡང་ཉེ་བ་ཡིན་པའི་ཕྱིར་རོ་༎
 00115 cet, na, dṛṣṭānta-dharmiṇo api pratyāsatteḥ| tad-aṃśa-vyāptyā 00116 dṛṣṭānta-dharmiṇi sattva-siddher dharmi-vacanāt sādhya-dharmi-	དེའི་ཆོས་ཁྱབ་པས་དཔེའི་ཆོས་ཅན་ལ་ཡོད་པར་གྲུབ་པའི་ཕྱིར་༏་ཆོས་ཅན་གྱི་ཆོས་སྨོས་པས་ནི་། བསྒྲུབ་པར་བྱ་བའི་ཆོས་ཅན་ཡོངས་སུ་བསྡུས་སོ་༎
 00117 parigrahaḥ| siddhe api punar-vacanaṃ niyama-artham āśaṅkyeta|	བསྒྲུབ་ཀྱང་ངེས་པར་བྱ་བའི་ཕྱིར་ཡང་སྨོས་སུ་དོགས་པར་འགྱུར་ཏེ་།
 00118 sajātīya eva sattvam iti siddhe api tad-abhāve vyatireke	མཐུན་པ་ལ་ཡོད་པ་ཁོ་ནས་ལྡོག་པ་ལ་དེ་མེད་པར་གྲུབ་མོད་ཀྱི་།
 00119 sādhya-abhāve asattva-vacana-vat tad-aṃśa-vyāpti-vacanāt siddhe	བསྒྲུབ་པར་བྱ་བ་མེད་པ་ལ་མེད་པ་ཞེས་སྨོས་པ་བཞིན་དུ་། དེའི་ཆོས་ཁྱབ་པ་སྨོས་པས་།
 00120 api dṛṣṭānta-dharmiṇi sattve dharmi-vacanaṃ tatra eva bhāva-	དཔེའི་ཆོས་ཅན་ལ་ཡང་ཡོད་པར་གྲུབ་མོད་ཀྱི་། དེ་ཉིད་ལ་ཡོད་པར་ངེས་པར་བྱ་བའི་ཕྱིར་། ཆོས་ཅན་སྨོས་སུ་དོགས་པར་འགྱུར་རོ་༎
 00121 niyama-artham āśaṅkyeta| tasmāt sāmarthyād artha-gatāv apy 00201 upacāra-mātrāt samāna-nirdeśāt pratipatti-gauravaṃ ca parihṛtaṃ	དེ་བས་ན་ཤུགས་ཀྱིས་དོན་གོ་ཡང་ཉེ་བར་བརྟགས་པ་ཙམ་ཡི་གེ་མཉམ་པས་སྒྲུབ་དཀའ་བ་ཡང་ཡོངས་སུ་སྤངས་པ་ཡིན་ནོ་༎ གལ་ཏེ་ཕྱོགས་ཀྱི་ཆོས་ཉིད་ཡིན་ན་།
 00202 bhavati| pakṣasya dharmatve tad-viśeṣaṇa-apekṣasya anyatra ananuvṛtter	དེའི་ཁྱད་པར་ལ་ལྟོས་པ་གཞན་དུ་མི་འཇུག་གོ་ཞེ་ན་།
 00203 asādhāraṇatā iti cet, na, ayogavyavacchedena viśeṣaṇād 00204 yathā caitro dhanurdhara iti na anyayogavyavacchedena yathā 00205 pārtho dhanurdhara iti|	མ་ཡིན་ཏེ་མ་འབྲེལ་བ་རྣམ་པར་བཅད་པས་བྱེ་བྲག་ཏུ་བྱས་པའི་ཕྱིར་དཔེར་ན་ནག་པ་གཞུ་ཐོགས་སོ་ཞེས་བྱ་བ་ལྟ་བུ་ཡིན་གྱི་། དཔེར་ན་སྲིད་སྒྲུབ་གཞུ་ཐོགས་པ་ལྟ་བུའོ་། ཞེས་གཞན་དང་འབྲེལ་བ་རྣམ་པར་བཅད་པས་ནི་མ་ཡིན་ནོ་༎
 00206 tad-aṃśas tad-dharmaḥ|	དེའི་ཆ་ནི་དེའི་ཆོས་སོ་༎
 00207 vyāptir vyāpakasya tatra bhāva eva vyāpyasya vā 00208 tatra eva bhāvaḥ|	ཁྱབ་པ་ནི་དེ་ལ་ཁྱབ་པར་བྱེད་པ་ཡོད་པ་ཁོ་ནའམ་།
 00209 etena anvayo vyatireko vā pakṣa-dharmaś ca yathāsvaṃ 00210 pramāṇena niścita uktaḥ,	ཡང་ན་དེ་ཁོ་ན་ལ་ཁྱབ་པར་བྱ་བ་ཡོད་པའོ་༎ འདིས་རྗེས་སུ་འགྲོ་བའམ་། ལྡོག་པ་དང་ཕྱོགས་ཀྱི་ཆོས་རང་གི་ཚད་མ་ཇི་ལྟ་བདག་གིས་ངེས་པར་བཤད་༄༢༣༩ཨ་༌་༎ པ་ཡིན་ཏེ་།
 sarvatra hetau sādhya-dharma-abhāve	གཏན་ཚིགས་ཐམས་ཅད་ལ་བསྒྲུབ་པར་བྱ་བའི་ཆོས་མེད་ན་།
 00211 vyāpty-asiddher vyāpaka-nivṛttau vā vyatireka-abhāvāt anvaya-vyatirekābhyāṃ	ཁྱབ་པ་མི་འགྲུབ་པའི་ཕྱིར་རམ་། ཡང་ན་ཁྱབ་པར་བྱེད་པ་ལོག་ན་ལྡོག་པ་མེད་པའི་ཕྱིར་རོ་༎ རྗེས་སུ་འགྲོ་བ་དང་། ལྡོག་པ་ངེས་པ་དག་གིས་ནི་།
 00212 niścitābhyāṃ tad-aṃśa-vyāptir niścitā|	དེའི་ཆོས་ཁྱབ་པ་ངེས་པ་ཡིན་ནོ་༎
 00213 tatra pakṣa-dharmasya sādhya-dharmiṇi pratyakṣato anumānato 00214 vā prasiddhir niścayaḥ,	དེ་ལ་བསྒྲུབ་པར་བྱ་བའི་ཆོས་ཅན་ལ་། ཕྱོགས་ཀྱི་ཆོས་མངོན་སུམ་མམ་། རྗེས་སུ་དཔག་པའི་སྒོ་ནས་རབ་ཏུ་གྲུབ་པ་ནི་ངེས་པ་སྟེ་།
 yathā pradeśe dhūmasya śabde	དཔེར་ན་ཕྱོགས་ན་དུ་བའམ་།
 00215 vā kṛtakatvasya| sadhūmaṃ hi pradeśam arthāntara-vivikta-rūpam	སྒྲ་ལ་བྱས་པ་ཉིད་ལྟ་བུའོ་༎ དུ་བ་དང་བཅས་པའི་ཕྱོགས་དོན་གཞན་གྱིས་དཔེ་ན་པའི་ངོ་བོ་ཅན་ཐུན་མོང་མ་ཡིན་པའི་བདག་ཉིད་དུ་མངོན་སུམ་གྱིས་མཐོང་བ་ལ་།
 00216 asādhāraṇa-ātmanā dṛṣṭavataḥ pratyakṣeṇa yathā-dṛṣṭa-bheda-viṣayaṃ 00217 smārtaṃ liṅga-vijñānam utpadyate|	ཇི་ལྟར་མཐོང་བ་ཐ་དད་པའི་ཡུལ་ཅན་དྲན་པ་རྟགས་ཤེས་པ་སྐྱེའོ་༎
 00218 tatra yad ādyam asādhāraṇa-viṣayaṃ darśanaṃ tad 00219 eva pramāṇam|	དེ་ལ་དང་པོ་ཡུལ་ཐུན་མོང་མ་ཡིན་པ་མཐོང་བ་གང་ཡིན་པ་དེ་ཁོ་ན་ཚད་མ་ཡིན་ནོ་༎ 
 00220 tasmin tathābhūte dṛṣṭe sati sa yena yena asādhāraṇas 00221 tad-asādhāraṇatāṃ tato bhedam abhilapanty atad-vyāvṛtti-viṣayā 00222 smṛtir utpannā pratyakṣa-balena yathādṛṣṭa-ākāra-grahaṇān na	དེ་དེ་ལྟར་མཐོང་ནས་མངོན་སུམ་གྱི་སྟོབས་ཀྱིས་དེ་དང་དང་གང་གིས་ཐུན་མོང་མ་ཡིན་པ་དེའི་ཐུན་མོང་མ་ཡིན་པ་ཉིད་དེ་ལས་ཐ་དད་པ་མངོན་པར་བརྗོད་པ་དེ་མ་ཡིན་པ་ལས་ལོག་པའི་ཡུལ་ཅན་གྱི་དྲན་པ་སྐྱེས་པ་ནི་། ཇི་ལྟར་ཡོངས་སུ་མཐོང་བའི་རྣམ་པ་འཛིན་པའི་ཕྱིར་ཚད་མ་མ་ཡིན་ཏེ་།
 00223 pramāṇam, prāg asādhāraṇaṃ dṛṣṭvā asādhāraṇa ity abhilapato	སྔར་ཐུན་མོང་མ་ཡིན་པ་མཐོང་ནས་། ཐུན་མོང་མ་ཡིན་པའོ་ཞེས་མངོན་པར་བརྗོད་པས་ནི་།
 00224 apūrva-artha-adhigama-abhāvād arthakriyā-sādhanasya darśanād	སྔོན་མ་རྟོགས་པའི་དོན་རྟོགས་པ་མེད་པའི་ཕྱིར་རོ་༎ དོན་བྱེད་པ་སྒྲུབ་པ་མཐོང་ཟིན་པའི་ཕྱིར་།
 00225 adṛṣṭasya punas tat-sādhana-svabhāvasya vikalpena apratipatteś 00301 ca anumāna-vat| arthakriyā-arthī hi sarvaḥ pramāṇam apramāṇaṃ	རྣམ་པར་རྟོག་པས་ནི་རྗེས་སུ་དཔག་པ་ནི་དེ་སྒྲུབ་པའི་རང་གི་ངོ་བོ་མ་མཐོང་བ་ཡང་རྟོགས་པ་མེད་པའི་ཕྱིར་རོ་༎ དོན་བྱེད་པ་དོན་དུ་གཉེར་བ་རྟོགས་པ་དང་ལྡན་པ་ཐམས་ཅད་ནི་ཚད་མའམ་།
 00302 vā anveṣate prekṣāvān,	ཚད་མ་མ་ཡིན་པ་ཚོལ་ན་།
 na ca sāmānyaṃ kāṃcid arthakriyām	སྤྱི་ནི་དོན་བྱེད་ཅུང་ཟད་ཀྱང་མི་ནུས་ཏེ་།
 00303 upakalpayati svalakṣaṇa-pratipatter ūrdhvaṃ tat-sāmarthya-utpanna-	རང་གི་མཚན་ཉིད་རྟོགས་པའི་འོག་ཏུ་དེའི་མཐུ་ལས་སྐྱེས་པ་རྣམ་པར་རྟོག་པ་ཅན་གྱི་རྣམ་པར་ཤེས་པའི་གཟུང་བ་ཡིན་པས་།
 00304 vikalpa-vijñāna-grāhyaṃ yathā nīlaṃ dṛṣṭvā nīlam iti	དཔེར་ན་སྔོན་པོ་མཐོང་ནས་སྔོན་པོའོ་མཐོང་ནས་སྔོན་པོའོ་སྙམ་པའི་རྣམ་པར་ཤེས་པ་ལ་སྣང་བ་བཞིན་ཏེ་། 
 00305 jñāne| tad eva hi nīla-svalakṣaṇaṃ tathāvidha-sādhya-arthakriyākāri,	སྔོན་པོའི་རང་གི་མཚན་ཉིད་དེ་ཉིད་དེ་ལྟ་བུས་བསྒྲུབ་པར་བྱ་བ་། དོན་བྱ་བ་བྱེད་པ་ཡིན་ལ་།
 00306 tac ca tena ātmanā dṛṣṭam eva pratyakṣeṇa| na ca	དེ་ཡང་དེའི་བདག་ཉིད་དུ་མངོན་སུམ་གྱིས་མཐོང་བ་ཁོ་ན་ཡིན་ནོ་༎
 00307 tat-svalakṣaṇa-grahaṇa-uttarakālabhāvi-nīla-vikalpasya viṣayeṇa nīla-	དེའི་རང་གི་མཚན་ཉིད་གཟུང་བའི་འོག་ཏུ་འབྱུང་བ་སྔོན་པོ་རྣམ་པར་རྟོག་པའི་ཡུལ་༄༢༣༩བ་གྱིས་ནི་། 
 00308 artha-sādhya-arthakriyā kriyate| tasmād anadhigata-artha-viṣayaṃ	སྔོན་པོ་དོན་གྱིས་བསྒྲུབ་པར་བྱ་བའི་དོན་བྱ་བ་སྒྲུབ་པར་མི་བྱེད་དེ་།
 00309 pramāṇam ity apy anadhigate svalakṣaṇa iti viśeṣanīyam|	དེ་ལྟ་བས་ན་དོན་མ་རྟོགས་པའི་ཡུལ་ཅན་ཚད་མ་ཡིན་ཞེས་བྱ་བ་ཡང་རང་གི་མཚན་ཉིད་མ་རྟོགས་པ་ཞེས་ཁྱད་པར་དུ་བྱའོ་༎
 00310 adhigate tu svalakṣaṇe tat-sāmarthya-janmā vikalpas tad-anukārī 00311 kāryatas tad-viṣayatvāt smṛtir eva na pramāṇam, anadhigata-	རང་གི་མཚན་ཉིད་རྟོགས་ནས་དེའི་མཐུ་ལས་སྐྱེས་པ་ཅན་རྣམ་པར་རྟོག་པ་དེ་དང་མཐུན་པར་བྱེད་པ་ནི་བྱ་བའི་སྒོ་ནས་དེའི་ཡུལ་ཅན་ཡིན་པའི་ཕྱིར་དྲན་པ་ཁོ་ན་ཡིན་གྱི་། ཚད་མ་ནི་མ་ཡིན་ཏེ་།
 00312 vastu-rūpa-anadhigateḥ,	དངོས་པོའི་ངོ་བོ་མ་རྟོགས་པ་མེད་པའི་ཕྱིར་རོ་༎
 vastv-adhiṣṭhānatvāt pramāṇa-vyavasthāyāḥ,	ཚད་མ་རྣམ་པར་གཞག་པ་ནི་དངོས་པོ་ལ་བརྟེན་པ་ཅན་ཉིད་ཡིན་པའི་ཕྱིར་རོ་༎
 00313 arthakriyā-yogya-viṣayatvāt tad-arthināṃ pravṛtteḥ,	དེའི་དོན་དུ་འཇུག་པ་ནི་དོན་བྱེད་པར་རུང་བའི་ཡུལ་ཅན་ཡིན་པའི་ཕྱིར་རོ་༎
 00314 arthakriyā-yogya-lakṣaṇaṃ hi vastu;	དངོས་པོ་ནི་དོན་བྱེད་པར་རུང་བའི་མཚན་ཉིད་ཅན་ཡིན་པའི་ཕྱིར་རོ་༎
 tato api vikalpād vastuny	རྣམ་པར་རྟོག་པ་དེ་ལས་ཀྱང་དེ་ལ་ལྷག་པར་ཆགས་པས་།
 00315 eva tad-adhyavasāyena pravṛtteḥ,	དངོས་པོ་ཁོ་ན་ལ་འཇུག་པའི་ཕྱིར་རོ་༎
 pravṛttau vikalpasya pratyakṣeṇa 00316 abhinna-yogakṣematvāt|	ཞུགས་ནས་མངོན་དང་རྣམ་པར་རྟོག་པ་གྲུབ་པ་དང་བདེ་བ་མི་དད་པའི་ཕྱིར་རོ་༎
 00317 pūrva-pratyakṣa-kṣaṇena upayoga-abhedād uttareṣu kasyacid	གལ་ཏེ་མངོན་སུམ་སྔ་མ་དང་ཕྱི་མ་རྣམས་སུ་འགའ་ཞིག་ལ་ཉེ་བར་སྦྱོར་བ་ཐ་མི་དད་པའི་ཕྱིར་རོ་༎
 00318 aprāmāṇya-prasaṅga iti cet, na, kṣaṇa-viśeṣa-sādhya-artha-vāñchāyāṃ 00319 nānā-yogakṣematvāt| sādhāraṇe hi kārye na teṣāṃ sāmarthya-bhedaḥ,	ཚད་མ་ཉིད་མ་ཡིན་པར་ཐལ་བར་འགྱུར་རོ་ཞེ་ན་། མ་ཡིན་ཏེ་སྐད་ཅིག་མའི་བྱེ་བྲག་གིས་བསྒྲུབ་པར་བྱ་བའི་དོན་དུ་འདོད་པ་ལ་གྲུབ་པ་དང་། 
 00320 aparāpara-dhūma-pramita-saṃnikṛṣṭa-agniṣv iva agni-mātra-sādhye	བདེ་བ་ཐ་དད་པའི་ཕྱིར་རོ་༎ འབྲས་བུ་ཐུན་མོང་བ་ཟམ་གྱི་བསྒྲུབ་པར་བྱ་བའི་དོན་ལ་དུ་བ་གཞན་དང་གཞན་གྱིས་གཞལ་བའི་མེ་ཉེ་བ་བཞིན་ནོ་༎
 00401 arthe| etena dharma-dharmi-liṅga-ādi-vikalpasya pramāṇa-pṛṣṭha- 00402 bhāvinaḥ prāmāṇyaṃ pratyuktam|	འདིས་ནི་ཆོས་དང་ཆོས་ཅན་དང་རྟགས་ལ་སོགས་པའི་རྣམ་པར་རྟོག་པ་ཚད་མའི་རྗེས་ལ་འབྱུང་བ་ཚད་མ་ཉིད་དུ་བསལ་བ་ཡིན་ནོ་༎
 00403 anvaya-niścayo api svabhāvahetau sādhya-dharmasya vastutas	རྗེས་སུ་འགྲོ་བ་ངེས་པ་ཡང་རང་བཞིན་གྱི་གཏན་ཚིགས་ཀྱི་ནི་བསྒྲུབ་པར་བྱ་བའི་ཆོས་དངོས་སུ་ན་དེའི་ངོ་བོ་ཅན་ཉིད་ཡིན་པས་།
 00404 tad-bhāvatayā sādhana-dharma-bhāva-mātra-anubandha-	སྒྲུབ་པའི་ཆོས་ཀྱི་ངོ་བོ་ཙམ་དང་རྗེས་སུ་འབྲེལ་པར་གྲུབ་པ་ཡིན་ནོ་༎
 00405 siddhiḥ| sā sādhya-viparyaye hetor bādhaka-pramāṇa-vṛttiḥ| 00406 yathā yat sat tat kṣaṇikam eva,	དེ་ནི་བསྒྲུབ་པར་བྱ་བ་ལས་བཟློག་པ་ལ་གཏན་ཚིགས་ཀྱི་གནོད་པ་ཅན་གྱི་ཚད་མ་འཇུག་པ་ཡིན་ཏེ་དཔེར་ན་གང་ཡོད་པ་དེ་ནི་སྐད་ཅིག་མ་ཁོ་ན་ཡིན་ནོ་༎
 akṣaṇikatve arthakriyā-virodhāt	སྐད་ཅིག་མ་ཉིད་མ་ཡིན་ན་དོན་བྱེད་པ་དང་འགལ་བའི་ཕྱིར་དེའི་མཚན་ཉིད་དངོས་པོ་ཉིད་ཉམས་པར་འགྱུར་བལྟ་བུའོ་༎
 00407 tal-lakṣaṇaṃ vastutvaṃ hīyate| kāryahetau kāryakāraṇabhāva-	འབྲས་བུའི་ཚིགས་ཀྱི་རྒྱུ་དང་འབྲས་བུའི་ངོ་བོ་གྲུབ་པ་ཡིན་ཏེ་།
 00408 siddhiḥ, yathā idam asya upalambha upalabdhi-lakṣaṇa-prāptaṃ 00409 prāg anupalabdham upalabhyate, satsv apy anyeṣu hetuṣv	འདི་ལྟ་སྟེ་འདི་དམིགས་ན་དམིགས་པའི་༄༢༤༠ཨ་༌་༎ རིག་བྱར་གྱུར་པ་སྔོན་པོ་མི་དམིགས་པ་འདི་དམིགས་པ་ཡིན་ནོ་༎ རྒྱུ་གཞན་དག་ཡོད་ཀྱང་འདི་མེད་ན་མེད་པའི་ཕྱིར་།
 00410 asya abhāve na bhavati iti yas tad-bhāve bhāvas tad-abhāve	དེ་ཡོད་ན་ནི་ཡོད་མེད་ན་ནི་མེད་བས་།
 00411 abhāvaś ca pratyakṣa-anupalambha-sādhanaḥ kāryakāraṇabhāvas	རྒྱུ་དང་འབྲས་བུའི་ངོ་བོ་ནི་མངོན་སུམ་དང་མི་དམིགས་པའི་གྲུབ་པ་ཅན་ཡིན་ཏེ་།
 00412 tasya siddhiḥ| kāryakāraṇabhāva eva hy arthāntarasya evaṃ	དེ་གྲུབ་པའོ་༎ དེ་ལྟར་ན་རྒྱུ་དང་འབྲས་བུའི་ངོ་བོ་ནི་དོན་ཐ་དད་པ་ཁོ་ནར་འགྱུར་ལ་།
 00413 syāt yatra dhūmas tatra avaśyam agniḥ, agner bhāva	གང་ན་དུ་བ་ཡོད་པ་དེ་ན་གདོན་མི་ཟ་བར་མེ་ཡོད་དེ་།
 00414 eva hi bhāvo dhūmasya tat-kāryatvam| anupalabdhāv apy	མེ་ཡོད་ན་ཡོད་པ་ཁོ་ན་དེའི་འབྲས་བུ་ཉིད་དུ་བ་ཡིན་པའི་ཕྱིར་རོ་༎
 00415 anvaya-niścayo asad-vyavahārasya upalabdhi-lakṣaṇa-prāpta-anupalabdhi-	མི་དམིགས་པའི་རྗེས་སུ་འགྲོ་བ་ངེས་པ་ཡང་མེད་པའི་ཐ་སྙད་དམིགས་པའི་རིག་བྱར་གྱུར་པ་མི་དམིགས་པ་ཙམ་འཇིག་པའི་སྒྲུབ་པ་ཅན་ཡིན་ཏེ་། 
 00416 mātre vṛtti-sādhanaṃ nimitta-antara-abhāva-upadarśanāt|	རྒྱུ་མཚན་གཞན་མེད་པར་མཐོང་བའི་ཕྱིར་རོ་༎
 00417 vyatireka-niścayo api kārya-svabhāvahetoḥ kāryakāraṇa- 00418 vyāpyavyāpakabhāva-siddhau dṛśya-viṣayābhyāṃ kāraṇa-vyāpaka-	ལྡོག་པ་ངེས་པ་ཡང་འབྲས་བུ་དང་རང་བཞིན་གྱི་གཏན་ཚིགས་དག་གིས་ནི་རྒྱུ་དང་འབྲས་བུ་དང་ཁྱབ་པར་བྱ་བ་དང་། ཁྱབ་པར་བྱེད་པའི་ངོ་བོ་གྲུབ་ན་ཡུལ་བལྟར་རུང་བ་རྒྱུ་དང་ཁྱབ་པར་བྱེད་པ་དག་མི་དམིགས་པས་། 
 00419 anupalabdhibhyāṃ sādhya-abhāve hetv-abhāva-siddhir uddiṣṭa-	བསྒྲུབ་པར་བྱ་བ་མེད་ན་གཏན་ཚིགས་འགྲུབ་པའོ་༎
 00420 viṣayasya abhāvasya upadarśane,	ཡུལ་བསྟན་པ་ཅན་མེད་པར་ཉེ་བར་སྟོན་པ་ལ་།
 anyathā anupalabdhi-lakṣaṇa-prāptasya	དེ་ལྟ་མ་ཡིན་ན་དམིགས་པའི་རིག་བྱར་མ་གྱུར་པ་གང་དུ་ཡང་མེད་པར་མི་འགྲུབ་པའི་ཕྱིར་རོ་༎ 
 00421 kvacid abhāva-asiddheḥ| anuddiṣṭa-viṣayaṃ sādhya-abhāve 00422 abhāva-khyāpanaṃ apratibandha-mātra-siddhau sidhyati iti na tatra	ཡུལ་མ་བསྟན་པ་ཅན་ནི་བསྒྲུབ་པར་བྱ་བ་མེད་ན་མེད་པར་སྟོན་པ་ཡིན་ཕྱིར་རོ་༎ 
 00501 vyatireka-sādhane anupalabdhyor dṛśya-viṣayatā apekṣyate| vyatireka-	ཏེ་། འབྲེལ་པ་ཙམ་གྲུབ་ན་འགྲུབ་པས་དེ་ལས་ནི་ལྡོག་པ་བསྒྲུབ་པར་བྱ་བ་མི་དམིགས་པ་ཡུལ་ལྟར་རུང་བ་ལྟོས་པ་ཕྱིར་རོ་༎ ཏེ་། མ་ཡིན་ནོ་༎ 
 00502 niścayo anupalabdhāv upalabdhi-lakṣaṇa-prāptāt sato anupalambha-	མི་དམིགས་པའི་ལོག་པ་ངེས་པ་ནི་དམིགས་པའི་རིག་བྱར་གྱུར་པ་མི་དམིགས་པ་མེད་པ་ཉེ་བར་ཕྱིར་རོ་༎ ཏེ་། མ་ཡིན་ནོ་༎ སྟོན་པའོ་༎ མཚན་ཉིད་དེ་ལྟ་བུ་ཅན་དེ་ནི་ཕྱིར་རོ་༎ ཏེ་། 
 00503 abhāva-darśanam|	མ་ཡིན་ནོ་༎ སྟོན་པའོ་༎ 
 00504 etal-lakṣaṇas tridhā eva so hetus triprakāra eva, svabhāvaḥ	རྣམ་པ་གསུམ་། གཏན་ཚིགས་ནི་རྣམ་པ་གསུམ་ཁོ་ན་སྟེ་། རང་བཞིན་དང་འབྲས་བུ་དང་། མི་དམིགས་པ་ཡིན་ཏེ་།
 00505 kāryam anupalabdhiś ca iti yathā anitye kasmiṃścit sādhye sattvam 00506 agnimati pradeśe dhūmo abhāve ca upalabdhi-lakṣaṇa-prāptasya anupalabdhir	དཔེར་ན་འགའ་ཞིག་མི་རྟག་པ་བསྒྲུབ་པར་བྱ་བ་ལ་ཡོད་པ་ལྟ་བུ་དང་། མེ་དང་ལྡན་པའི་ཕྱོགས་ལ་དུ་བ་ལྟ་བུ་དང་། མེད་པ་ལ་དམིགས་པའི་རིག་བྱར་གྱུར་པ་མི་དམིགས་པ་ཞེས་བྱ་བ་ལྟ་བུའོ་༎
 00507 ity atra eva trividhe avinābhāva-niyamāt| pakṣa-dharmasya	རྣམ་པ་གསུམ་པོ་འདི་ཁོ་ནར་། མེད་ན་མི་འབྱུང་ངེས་ཕྱིར་རོ་༎ ཕྱོགས་ཀྱི་ཆོས་ཀྱི་ཁྱབ་པ་ཇི་སྐད་དུ་།
 00508 yathoktā vyāptir avinābhāvaḥ;	བཤད་པ་ནི་མེད་ན་མི་འབྱུང་བ་ཡིན་ཏེ་།
 sa trividhād hetor 00509 anyatra na asti ity atra eva niyata ucyate|	དེ་ནི་གཏན་ཚིགས་རྣམ་པ་གསུམ་ལས་མེད་པས་འདི་ཉིད་དུ་ངེས་པ་ཞེས་བྱའོ་༎
 00510 tatra sādhana-dharma-bhāva-mātra-anvayini sādhya-dharme	དེ་ལ་སྒྲུབ་པའི་ཆོས་ཀྱི་ངོ་བོ་ཙམ་དང་ལྡན་༄༢༤༠བ་པ་ཅན་ནི་བསྒྲུབ་པར་བྱ་བའི་ཆོས་ཀྱི་རང་བཞིན་གྱི་གཏན་ཚིགས་ཡིན་ནོ་༎
 00511 svabhāvo hetuḥ| aparāpara-vyāvṛtti-bhedena dharma-bhede api	ཕན་ཚུན་ལྡོག་པའི་བྱེ་བྲག་གིས་ཆོས་ཐ་དད་པ་ཡིན་ཡང་།
 00512 vastuto liṅgi-svabhāva eva hetu-svabhāve anvaya-vyabhicāra-abhāvāl	དངོས་སུ་ན་གཏན་ཚིགས་ནི་རྟགས་ཅན་གྱི་རང་བཞིན་ཁོ་ན་ཡིན་ནོ་༎ རང་བཞིན་ལ་རྗེས་སུ་འགྲོ་བ་འཁྲུལ་པ་མེད་པ་ལས་མཚན་ཉིད་ལ་གཞན་གྱི་ལུགས་ལ་ལྟོས་ནས་། 
 00513 lakṣaṇe tan-mātra-anvayena viśeṣaṇaṃ para-mata-apekṣam|	དེ་ཙམ་དང་ལྡན་པ་ཅན་གྱིས་ཁྱད་པར་དུ་བྱས་སོ་༎
 00514 pare hy arthāntara-nimittam atad-bhāva-mātra-anvayinam api 00515 dharmaṃ svabhāvam icchanti| viśeṣaṇena tathāvidhasya atat-	གཞན་དག་ནི་དོན་གཞན་གྱི་རྒྱུ་མཚན་ཅན་དེའི་ངོ་བོ་ཙམ་དང་ལྡན་པ་མ་ཡིན་པའི་ཆོས་ཀྱང་རང་བཞིན་དུ་འདོད་པས་།
 00516 svabhāvatāṃ tasmin sādhye hetor vyabhicāraṃ ca āha, yathā	ཁྱད་པར་གྱིས་དེ་ལྟ་བུ་རང་བཞིན་མ་ཡིན་པ་ཉིད་དང་། བསྒྲུབ་པར་བྱ་བ་དེ་ལ་གཏན་ཚིགས་འཁྲུལ་པར་བསྟན་དེ་།
 00517 hetumati vināśe kṛtakatvasya|	དཔེར་ན་འཇིག་པ་རྒྱུ་དང་ལྡན་པ་ལ་བྱས་པ་ལྟ་བུའོ་༎
 00518 tasya dvidhā prayogaḥ;	དེའི་སྦྱོར་བ་ནི་རྣམ་པར་གཉིས་ཏེ་།
 sādharmyeṇa vaidharmyeṇa ca,	ཆོས་མཐུན་པ་ཉིད་ཅན་དང་༎ ཆོས་མི་མཐུན་པ་ཅན་གཉིས་ཀྱིས་སོ་༎
 00519 yathā yat sat tat sarvaṃ kṣaṇikaṃ yathā ghaṭa-ādayaḥ saṃś	དཔེར་ན་གང་ཡོད་པ་དེ་ཐམས་ཅད་ནི་སྐད་ཅིག་མ་སྟེ་། དཔེར་ན་བུམ་པ་ལ་སོགས་པ་ལྟ་བུའོ་༎ སྒྲ་ཡང་ཡོད་པ་ཡིན་པས་ཞེས་བྱ་བ་དང་། དེ་བཞིན་དུ་སྐད་ཅིག་མ་ཉིད་མེད་ན་ཡོད་པ་ཡང་མེད་པ་ཡིན་ན་།
 00520 ca śabda iti,	སྒྲ་ནི་ཡོད་པས་ཞེས་བྱ་བ་ལྟ་བུ་སྟེ་། རྗེས་སུ་འགྲོ་བའམ་། ལྡོག་པས་ཐམས་ཅད་ཉེ་བར་བསྡུས་ནས་།
 tathā kṣaṇikatva-abhāve sattva-abhāvaḥ, saṃś ca 00521 śabda ity anvaya-vyatirekābhyāṃ sarva-upasaṃhāreṇa vyāpti-pradarśana 00522 lakṣaṇau sādharmya-vaidharmya-prayogau|	ཁྱབ་པ་རབ་ཏུ་སྟོན་པའི་མཚན་ཉིད་ཅན་གྱིས་ཆོས་མཐུན་པ་ཅན་དང་། ཆོས་མི་མཐུན་པ་ཅན་གྱི་སྦྱོར་བ་དག་ཡིན་ནོ་༎
 00523 atra sāmarthyād eva pratijñā-arthasya pratīter na pratijñāyāḥ	འདིར་ནི་ཤུགས་ཁོ་ནས་དམ་བཅས་པའི་དོན་རྟོགས་པའི་ཕྱིར་དམ་བཅས་པའི་སྦྱོར་བ་མི་བྱའོ་༎
 00524 prayogaḥ| apradarśite prameye arthe kathaṃ tat-pratītir iti cet|	གལ་ཏེ་གཞལ་བྱའི་དོན་རབ་ཏུ་མ་བསྟན་ན་། དེ་ཅི་ལྟར་རྟོགས་ཤེ་ན་། བདག་ཉིད་ཀྱིས་རྟོགས་པ་ལ་གཞན་བྱ་ཉེ་བར་སྟོན་པར་བྱེད་པ་སུ་ཞིག་ཡོད་དེ་།
 00601 svayaṃ pratipattau prameyasya ka upadarśayitā| pradeśa-sthaṃ 00602 dhūmam upalabdhavatas tasya agninā vyāpteḥ smaraṇe tat-sāmarthyād	ཕྱོགས་ན་ཡོད་པའི་དུ་བ་ཉེ་བར་དམིགས་པས་དེ་ལ་མེས་ཁྱབ་པ་དྲན་ན་།
 00603 eva agnir atra iti pratītir bhavati| na ca tatra kaścid	དེའི་མཐུ་ཁོ་ནས་འདི་ན་མེ་ཡོད་དོ་སྙམ་དུ་ཤེས་སོ་༎ དེ་ན་འདི་ལ་འགའ་ཡང་འདི་ན་མེ་ཡོད་དོ་ཞེས་སྟོན་པར་ཡང་མི་བྱེད་ལ་།
 00604 agnir atra ity asmai nivedayati| na api prāg eva pratipadyate	བདག་ཉིད་ཀྱིས་ཀྱང་ཅུང་ཟད་ཀྱང་མི་རྟོགས་ཏེ་།
 00605 kiṃcit, pramāṇam antareṇa evaṃ pratīter nimitta-abhāvāt|	ཚད་མ་མ་རྟོགས་པར་དེ་ལྟར་རྟོགས་པའི་རྒྱུ་མཚན་མེད་པའི་ཕྱིར་རོ་༎
 00606 pratītau liṅgasya vaiyarthyaṃ| svayam eva akasmād	རྟོགས་ན་ནི་རྟོགས་དོན་མེད་པ་ཉིད་དུ་འགྱུར་རོ་༎ བདག་ཉིད་ཀྱིས་བབ་ཅོལ་དུ་འདི་ན་མེ་ཡོད་དོ་སྙམ་དུ་༄༢༤༡ཨ་༌་༎
 00607 agnir atra iti prameyaṃ vyavasthāpya paścāt tat-pratipattaye	གཞལ་བྱ་རྣམ་པར་བཞག་ནས་། ཕྱིས་དེ་རབ་ཏུ་སྒྲུབ་པའི་ཡན་ལག་གི་རྗེས་སུ་འབྲང་ངོ་སྙམ་ན་།
 00608 liṅgam anusarati iti ko ayaṃ pratipatteḥ kramaḥ| pareṇa api 00609 tad ucyamānaṃ plavata eva, upayoga-abhāvāt| viṣaya-upadarśanam	རྟོགས་པའི་རིམ་པ་འདི་ནི་ཅི་ཞིག་ཡིན་། དེ་གཞན་གྱིས་བརྗོད་ན་ཡང་དགོས་པ་མེད་པའི་ཕྱིར་ཆ་ཆུང་ངོ་༎
 00610 upayoga iti cet,	གལ་ཏེ་དགོས་པ་ཡུལ་བསྟན་པ་ཡིན་ནོ་ཞེ་ན་།
 tena eva tāvad darśitena ko arthaḥ| yadi	རེ་ཞིག་བསྟན་པ་དེ་ཉིད་ཀྱིས་ཅི་ཞིག་ཕན་།
 00611 pratītir anyathā na syāt,	གལ་ཏེ་གཞན་དུ་ན་རྟོགས་པར་མི་འགྱུར་ན་ནི་།
 sarvaṃ śobheta| tasmād eṣaḥ svayaṃ	ཐམས་ཅད་ལེགས་པར་འགྱུར་རོ་༎ དེ་ལྟ་བས་ན་འདིས་བདག་ཉིད་ཀྱིས་རྟོགས་པ་ན་།
 00612 pratītau vinā api kenacid viṣaya-upasthāpakena pratiyan asmān	ཡུལ་ཉེ་བར་འགོད་པ་འགའ་ཡང་མེད་པར་རྟོགས་ལ་། ཁོ་བོ་དོན་དུ་གཉེར་བ་མཐོང་ནས་།
 00613 kāryiṇo dṛṣṭvā parvabrāhmaṇa iva vyaktaṃ mūlyaṃ mṛgayate|	དུས་སྟོན་གྱི་བྲམ་ཟེ་བཞིན་དུ་། གསལ་བར་རྔན་པ་སྒུགས་པར་བྱེད་པ་ཡིན་ནོ་༎
 00614 asmad-vacanād api svayaṃ siddham eva liṅgam anusṛtya 00615 pratyeti iti ko anayor avasthayor viśeṣaḥ| dṛṣṭā ca pakṣa-dharma- 00616 sambandha-vacana-mātrād pratijñā-vacanam antareṇa api pratītir	ཁོ་བོས་བརྗོད་ཀྱང་བདག་ཉིད་གྲུབ་ཟིན་པའི་རྟགས་ཁོ་ནའི་རྗེས་སུ་འབྲངས་ན་རྟོགས་པར་འགྱུར་བས་གནས་སྐབས་འདི་གཉིས་ལ་ཁྱད་པར་ཅི་ཞིག་ཡོད་། དམ་བཅའ་བ་སྨོས་པ་མེད་པར་ཡང་ཕྱོགས་ཀྱི་ཆོས་དང་འབྲེལ་པ་སྨོས་པ་ཙམ་གྱིས་རྟོགས་པ་ཡང་མཐོང་བའི་ཕྱིར་དེ་དགོས་པ་ཅི་ཞིག་། ཡོད་། 
 00617 iti kas tasya upayogaḥ| sva-niścaya-vad anyeṣām api niścaya-utpādanāya	རང་ལ་ངེས་པ་བཞིན་དུ་གཞན་དག་ལ་ངེས་པ་བསྐྱེད་པར་འདོད་པའི་ཕྱིར་སྒྲུབ་། ཡོད་། 
 00618 ca sādhanam ucyate,	པ་ཞེས་བྱའོ་༎ 
 tatra svayam ayaṃ prameyasya upadarśanam	དེ་ལ་འདི་དག་ཉིད་ཀྱིས་གཞལ་བྱ་ཉེ་བར་བསྟན་པ་མེད་པར་ཡང་རྟོགས་ལ་།
 00619 antareṇa api pratipadya paraṃ pratipādayan apūrvam	གཞན་ཁོང་དུ་ཆུད་པར་བྱེད་པ་ན་།
 00620 artha-kramam āśrayata iti kim atra kāraṇam| tasmān na prameya-	དོན་གྱི་རིམ་པ་སྔོན་མ་བྱུང་བ་མ་བསྟན་ཏོ་ཞེས་བྱ་བ་འདི་ལ་རྒྱུ་ཅི་ཞིག་ཡོད་། དེ་ལྟ་བས་ན་གཞན་དུ་ན་ཡང་རྟོགས་པ་སྐྱེ་བའི་ཕྱིར་།
 00621 vacanena kiṃcit prayojanam, anyathā api pratipatter 00622 utpatteḥ|	གཞལ་བྱ་སྨོས་པ་ནི་ཅུང་ཟད་ཀྱང་ཀྱང་མི་དགོས་སོ་༎
 00623 etena upanaya-nigamana-ādikam api pratyuktam, etāvatā eva	འདིས་ནི་ཉེ་བར་གཏོད་པ་དང་། མཇུག་སྡུད་པ་ལ་སོགས་པ་ཡང་སྤངས་པ་ཡིན་ཏེ་། སྦྱོར་བ་འདི་ཙམ་ཁོ་ནས་རྟོགས་པར་བཏུབ་པའི་ཕྱིར་རོ་༎
 00624 sādhya-pratīter bhāvāt| ḍiṇḍika-rāgaṃ parityajya-ākṣiṇī-	རེ་ཞིག་ཁ་བྱའི་ཆགས་པ་ཡོངས་སུ་བོར་ལ་མིག་ཚུམས་ཏེ་།
 00625 nimīlya cintaya tāvat kim iyatā pratītiḥ syān na vā| bhāve	ཅི་འདི་ཙམ་གྱིས་རྟོགས་པར་བཏུབ་བམ་། འོན་ཏེ་མི་བཏུབ་ཅེས་སོམས་ཤིག་། 
 00701 kiṃ prapañca-mālayā, iti iyān eva sādhana-vākye prayogo 00702 jyāyān|	བཏུབ་པ་ལྟར་ན་ནི་སྤྲོས་པའི་ཕྲེང་པས་ཅི་ཞིག་བྱ་། སྒྲུབ་པའི་ཚིག་ལ་སྦྱོར་བ་འདི་ཙམ་ཁོ་ན་ཞིག་སྦྱར་བར་བྱའོ་༎
 00703 atra pakṣa-dharma-sambandha-vacanayoḥ krama-niyamo api na 00704 kaścit, sarvathā gamakatvāt|	འདི་ལ་ཡང་ཕྱོགས་ཀྱི་ཆོས་དང་འབྲེལ་པ་སྨོས་པ་དག་གི་རིམ་པ་ངེས་པ་ནི་འགའ་ཡང་མེད་དེ་ཇི་ལྟར་ཡང་རྟོགས་པར་བྱེད་པའི་ཕྱིར་རོ་༎ 
 00705 sambandha-vacane api kevalaḥ prayogo bhinnaḥ,	༄༢༤༡བ་འབྲེལ་པ་སྨོས་པ་ལ་ཡང་སྦྱོར་བ་འབའ་ཞིག་ཐ་དད་པར་ཟད་དེ་།
 ubhayathā api 00706 dharma-bhede tathā api tad-bhāvasya eva khyāpanāt| na hy	གཉི་ག་ལྟར་ཡང་ཆོས་ཐ་དད་ཀྱང་དེའི་ངོ་བོ་ཁོ་ན་སྟོན་པའི་ཕྱིར་རོ་༎
 00707 atat-svabhāvasya bhāva ekāntena anyabhāvaḥ kṛtakatvasya bhāve	དེའི་རང་བཞིན་མ་ཡིན་པ་ཡོད་ན་གཞན་ཡོད་པར་ངེས་པ་མེད་དེ་།
 00708 prayatnānantarīyakatva-vat,	བྱས་པ་ཉིད་ཡོད་ན་བརྩལ་ནས་འབྱུང་བའི་ཆོས་ཉིད་བཞིན་ནོ་༎
 na apy atat-svabhāvasya nivṛttāv akāryasya	དེའི་རང་བཞིན་མ་ཡིན་པ་ལོག་ན་ཡང་འབྲས་བུ་མ་ཡིན་པ་དེ་ལྡོག་པ་མེད་དེ་།
 00709 tasya nivṛttir yathā anayor eva dharmayor nivṛttiḥ| tasmād	དཔེར་ན་ཆོས་འདི་གཉིས་ཁོ་ན་བཟློག་པ་བཞིན་ནོ་༎
 00710 anvaya-vyatirekayor yathā-lakṣaṇam eko api prayukto dvitīyam 00711 ākṣipati iti na ekatra sādhana-vākye dvayoḥ prayoga iṣyate, 00712 vaiyarthyāt,	དེ་ལྟ་བས་ན་རྗེས་སུ་འགྲོ་བ་དང་ལྡོག་པ་དག་ལས་མཚན་ཉིད་ཇི་ལྟ་བ་གཅིག་རབ་ཏུ་སྦྱར་བས་ཀྱང་གཉིས་པ་འཕེན་པས་སྒྲུབ་པའི་ཚིག་གཅིག་ལ་གཉི་ག་སྦྱོར་བར་མི་འདོད་དེ་། དོན་མེད་པའི་ཕྱིར་རོ་༎
 tat-svabhāvatayā anvaya-siddhau tad-abhāve abhāva-siddheḥ,	དེའི་རང་བཞིན་ཡིན་པ་ཉིད་ཀྱིས་རྗེས་སུ་འགྲོ་བ་གྲུབ་ན་། དེ་མེད་ན་མེད་པ་འགྲུབ་པའི་ཕྱིར་ལ་།
 00713 tad-abhāve abhāva-siddhau ca anvayasya api siddheḥ|	དེ་མེད་ན་མེད་པ་གྲུབ་ན་དེའི་རྗེས་སུ་འགྲོ་བ་གྲུབ་པའི་ཕྱིར་རོ་༎ ལྡོག་པ་སྦྱོར་བ་ནི་།
 00714 tad-abhāva eva abhāva-khyātir yathā syān na anyatra viruddhe	ཇི་ལྟར་ན་དེ་མེད་པ་ཁོ་ན་ལ་མེད་པ་ཡིན་པར་སྟོན་པར་འགྱུར་བ་སྟེ་།
 00715 vā iti niyama-khyāpana-artho api vyatireka-prayogo na yuktaḥ,	གཞན་ལ་ཡང་མ་ཡིན་ལ་འགལ་བ་ལ་ཡང་མ་ཡིན་ནོ་ཞེས་ངེས་པར་བསྟན་པའི་དོན་དུ་ཡང་ངེས་པ་མ་ཡིན་ཏེ་།
 00716 anya-viruddhayor api vipakṣatvāt|	གཞན་དང་འགལ་བ་དག་ཀྱང་མི་མཐུན་པའི་ཕྱོགས་ཡིན་པའི་ཕྱིར་རོ་༎
 00717 katham idam avagamyate sad avaśyaṃ naśvara-svabhāvam iti 00718 yena anvaya-vyatireka-sambhava iti cet,	གང་གིས་ན་རྗེས་སུ་འགྲོ་བ་དང་ལྡོག་པ་དག་ཏུ་འགྱུར་བ་ཡོད་པ་གདོན་མི་ཟ་བར་འཇིག་པའི་རང་བཞིན་ཡིན་ན་ཞེས་བྱ་བ་འདི་ཇི་ལྟར་ཁོང་དུ་ཆུད་ཅེ་ན་།
 vināśa-hetv-ayogāt| svabhāvata	འཇིག་པའི་རྒྱུ་མི་རུང་བའི་ཕྱིར་རོ་༎
 00719 eva naśvarā bhāvāḥ; na eṣāṃ niṣpannānām anyato 00720 vināśa-utpattiḥ,	དངོས་པོ་རྣམས་ནི་རང་གི་ངོ་བོ་ཁོ་ནས་འཇིག་པ་ཡིན་གྱི་གྲུབ་པ་རྣམས་གཞན་ལས་འཇིག་པ་འབྱུང་བ་འདི་ནི་མེད་དེ་།
 tasya asāmarthyāt;	དེ་ལ་ནུས་པ་མེད་པའི་ཕྱིར་རོ་༎
 na hi vināśa-hetur bhāva-svabhāvam 00721 eva karoti, tasya nivṛtteḥ| na api bhāva-antaram eva,	འཇིག་པའི་རྒྱུས་དངོས་པོའི་རང་གི་ངོ་བོ་ཁོ་ན་བྱེད་པ་ནི་མ་ཡིན་ཏེ་། དེ་གྲུབ་ཟིན་པའི་ཕྱིར་རོ་༎
 00722 bhāva-antara-karaṇe bhāve tad-avasthe na kiṃcit karoti iti tathā-upalabdhy-	ངོ་བོ་ཉིད་གཞན་ཞིག་བྱེད་ན་ཡང་དངོས་པོ་དེའི་སོ་ན་འདུག་པ་ལ་ཅུང་ཟད་ཀྱང་མི་བྱེད་པས་། དེ་བཞིན་དུ་དམིགས་པ་ལ་སོགས་པར་ཐལ་བར་འགྱུར་རོ་༎
 00801 ādi-prasaṅgaḥ| na api bhāva-antaram asya āvaraṇam, tad-avasthe	ངོ་བོ་ཉིད་གཞན་ནི་འདིའི་སྒྲིབ་པ་ཡིན་ཏེ་།
 00802 tasminn āvaraṇasya apy ayogāt| na api vināśa-hetunā bhāva-abhāvaḥ 00803 kriyate, abhāvasya vidhinā upagame vyatireka-avyatireka-	དེའི་སོ་ན་འདུག་ན་དེ་ལ་སྒྲིབ་པར་ཡང་མི་རུང་བའི་ཕྱིར་རོ་༎ འཇིག་པའི་རྒྱུས་དངོས་པོ་མེད་པར་བྱེད་པར་ཡང་མ་ཡིན་ཏེ་།
 00804 vikalpa-anatikramāt| bhāva-pratiṣedha-ekarūpatve bhāvaṃ na	མེད་པའི་ཚུལ་དུ་ཁས་ལེན་ན་ཐ་དད་པ་དང་། ཐ་དད་པ་མ་ཡིན་པར་རྣམ་པར་རྟོག་པ་ལས་མ་འདས་པའི་ཕྱིར་རོ་༎ དངོས་པོ་དགག་པའི་ངོ་བོ་ཉིད་གཅིག་ཡིན་ན་ནི་།
 00805 karoti iti syāt,	དངོས་པོ་མི་བྱེད་ཅེས་བྱ་བར་༄༢༤༢ཨ་༌་༎ འགྱུར་རོ་༎
 evaṃ ca akartur ahetutvam iti na vināśa-hetuḥ 00806 kaścit|	དེ་ལྟ་ན་བྱེད་པ་པོ་མ་ཡིན་པ་ནི་རྒྱུ་ཉིད་མ་ཡིན་པས་འཇིག་པའི་རྒྱུ་འགའ་ཡང་མེད་དོ་༎ དོན་མེད་པའི་ཡང་ཕྱིར་ཏེ་།
 00807 vaiyarthyāc ca| yadi svabhāvato naśvaraḥ svātmany anavasthāyī-	གལ་ཏེ་དངོས་པོ་རང་གི་ངོ་བོས་འཇིག་པ་ཡིན་ན་།
 00808 bhāvaḥ, tasya na kiṃcin nāśa-kāraṇaiḥ,	དེ་ལ་འཇིག་པའི་རྒྱུ་ཅུང་ཟད་ཀྱང་མི་དགོས་ཏེ་།
 tat-svabhāvatayā	དེའི་ངོ་བོ་ཉིད་ཡིན་པ་ཁོ་ནས་བདག་ཉིད་འཇིག་པའི་ཕྱིར་རོ་༎
 00809 eva svayaṃ nāśāt| yo hi yat svabhāvaḥ sa sva-hetor 00810 eva utpadyamānas tādṛśo bhavati,	གང་ཞིག་གང་གི་ངོ་བོ་ཉིད་ཡིན་པ་དེ་ནི་རང་གི་རྒྱུ་ཁོ་ན་ལས་སྐྱེ་བ་ན་དེ་ལྟ་བུར་འགྱུར་གྱི་།
 na punas tad-bhāve hetv-antaram	དེ་ངོ་བོར་བྱ་བ་ལ་རྒྱུ་གཞན་ལ་ནི་མི་ལྟོས་ཏེ་།
 00811 apekṣate, prakāśa-drava-uṣṇa-kaṭhina-ādi-dravya-vat| na hi prakāśa-ādayas	གསལ་བ་དང་། གཤེར་བ་དང་། དྲོ་བ་དང་། སྲ་བ་ལ་སོགས་པའི་རྫས་དང་འདྲའོ་༎ གསལ་བ་ལ་སོགས་པ་དེ་དག་གི་བདག་ཉིད་དུ་བྱུང་བ་རྣམས་ནི་ཡང་གསལ་བ་ལས་ངོ་བོར་བྱ་བའི་ཕྱིར་། རྒྱུ་གཞན་ལ་མི་ལྟོས་ཏེ་།
 00812 tad-ātmāna utpannā punaḥ prakāśa-ādi-bhāve hetv-antaram 00813 apekṣante, tad-ātmanas tādātmya-abhāve nairātmya-prāsaṅgāt|	དེའི་བདག་ཉིད་ལ་དེའི་བདག་ཉིད་མེད་ན་བདག་ཉིད་མེད་པར་ཐལ་བར་འགྱུར་རོ་༎
 00814 tadvad asthiti-dharmā cet svabhāvato niṣpanno na punas	དེ་དང་འདྲ་བར་གལ་ཏེ་མི་གནས་པའི་ཆོས་ཅན་ཞིག་ཡིན་ན་ནི་།
 00815 tad-ātmatāyāṃ hetv-antaram apekṣate| 00816 bīja-ādi-vad anekānta iti cet,	ངོ་བོ་ཉིད་ཀྱིས་གྲུབ་པ་ཡང་དེའི་བདག་ཉིད་དུ་བྱ་བའི་ཕྱིར་རྒྱུ་གཞན་ལ་མི་ལྟོས་སོ་༎ གལ་ཏེ་ས་བོན་ལ་སོགས་པ་བཞིན་དུ་མ་ངེས་པ་ཡིན་ནོ་སྙམ་སྟེ་།
 syād etat: bīja-ādīnām aṅkura-ādi-	འདི་སྙམ་དུ་ས་བོན་ལ་སོགས་པ་མྱུ་གུ་ལ་སོགས་པ་བསྐྱེད་པའི་རང་བཞིན་ཡང་།
 00817 janana-svabhāvānām api salila-ādi-hetv-antara-apekṣaṇāt kevalā na	ཆུ་ལ་སོགས་པ་རྒྱུ་གཞན་ལ་ལྟོས་པའི་ཕྱིར་འབའ་ཞིག་གིས་ནི་སྐྱེད་པར་མི་བྱེད་དོ་༎
 00818 janayanti, tadvad bhāvo api vināśe syād iti| na tat-svabhāvasya	དངོས་པོ་འཇིག་པ་ཡང་དེ་དང་འདྲ་བར་འགྱུར་རོ་སྙམ་དུ་སེམས་ན་མ་ཡིན་ཏེ་། དེའི་ངོ་བོ་ཉིད་སྐྱེ་བའི་ཕྱིར་ལ་།
 00819 jananād ajanakasya ca atat-svabhāvatvāt| ata eva	སྐྱེད་པར་བྱེད་པ་མ་ཡིན་པ་ཡང་དེའི་ངོ་བོ་ཉིད་མ་ཡིན་པའི་ཕྱིར་རོ་༎
 00820 tayor avasthayor vastu-bhedo niśceyaḥ,	དེ་ཉིད་ཀྱི་ཕྱིར་གནས་སྐབས་དེ་གཉིས་པོ་ཐ་དད་པར་ངེས་ཏེ་།
 bhāvānāṃ svabhāva 00821 anyathātva-abhāvāt tat-svabhāvasya paścād iva prāg api	དངོས་པོ་རྣམས་ཀྱི་ངོ་བོ་ཉིད་གཞན་དུ་འགྱུར་བ་ཉིད་མེད་པས་། དེའི་ངོ་བོ་ཉིད་ནི་ཕྱིས་བཞིན་དུ་སྔོན་པོ་ཡང་སྐྱེད་པར་ཐལ་བར་འགྱུར་བའི་ཕྱིར་རོ་༎
 00822 janana-prasaṅgāt| tasmād yo antyo avasthā-viśeṣaḥ sa eva aṅkura-ādi-	དེ་ལྟ་བས་ན་གནས་སྐབས་ཀྱི་བྱེ་བྲག་ཐ་མ་གང་ཡིན་པ་དེ་ཉིད་མྱུ་གུ་ལ་སོགས་པ་སྐྱེད་པའི་ངོ་བོ་ཉིད་ཡིན་ནོ་༎
 00901 janana-svabhāvaḥ| pūrva-bhāvinas tv avasthā-viśeṣāḥ kāraṇasya 00902 kāraṇāni iti na anekāntaḥ,	སྔོན་གྱི་གནས་སྐབས་ན་ཡོད་པའི་བྱེ་བྲག་རྣམས་ནི་རྒྱུའི་རྒྱུད་ཉིད་ཡིན་པས་མ་ངེས་པ་ཉིད་ཡིན་ནོ་༎ 
 kṣaṇikeṣu bhāveṣv aparāpara-utpatter 00903 aikya-abhāvāt|	དེ་ལྟ་བས་ན་དངོས་པོ་སྐད་ཅིག་མ་རྣམས་ལ་གཞན་དང་གཞན་སྐྱེ་བས་གཅིག་པ་ཉིད་མེད་པའི་ཕྱིར་རོ་༎
 00904 te antyāḥ samarthāḥ kiṃ na janayanti iti, janayanty	གལ་ཏེ་ཐ་མ་དག་ནུས་པ་ཡིན་ན་ཅིའི་ཕྱིར་སྐྱེད་པར་མི་བྱེད་ཅེ་ན་། སྐྱེད་པར་བྱེད་པ་ཁོ་ནའོ་༎
 00905 eva, na atra anyathābhāvaḥ svabhāvasya avaiparītyāt| teṣu sarveṣu	༄༢༤༢བ་འདི་ལ་གཞན་དུ་འགྱུར་བ་མེད་དེ་ངོ་བོ་ཉིད་བཟློག་པ་མེད་པའི་ཕྱིར་རོ་༎
 00906 sahakāriṣu samartha-svabhāveṣu ko aparasya upayoga iti cet, na vai	གལ་ཏེ་ལྷན་ཅིག་བྱེད་པ་དེ་དག་ཐམས་ཅད་ནུས་པའི་ངོ་བོ་ཉིད་ཡིན་པ་ལ་། གཞན་གྱི་ཉེ་བར་སྦྱོར་བ་ཅི་ཞིག་དགོས་ཤེ་ན་།
 00907 bhāvānāṃ kācit prekṣā-pūrva-kāritā yato ayam eko api samarthaḥ 00908 kim asmābhir ity apare nivarteran| nirabhiprāya-vyāpārā	དངོས་པོ་རྣམས་ལ་ནི་གང་གིས་ན་འདི་གཅིག་པུས་ཀྱང་ནུས་ན་བདག་གིས་ཅི་ཞིག་བྱ་ཞེས་གཞན་དག་ལྡོག་པར་འགྱུར་བ་རྟོག་པ་སྔོན་དུ་གཏོང་ཞིང་བྱེད་པ་ཅན་དག་ནི་འགའ་ཡང་མེད་པ་ཁོ་ན་སྟེ་།
 00909 hi sva-hetu-pariṇāma-upanidhi-dharmās tat-prakṛtes tathābhavanto	སེམས་པ་མེད་པར་བྱེད་པ་ཅན་རང་གི་རྒྱུ་ཡོངས་སུ་གྱུར་པས་འདུ་བའི་ཆོས་ཅན་དག་ཡིན་ལ་། དེའི་རང་བཞིན་ལས་དེ་ལྟ་བུར་འགྱུར་བ་ལ་ཀླན་ཀ་བཙལ་བར་འོས་པ་མ་ཡིན་ལ་། ནོ་༎ 
 00910 na upālambham arhanti| samarthāḥ kiṃ na aparāparaṃ janayanti	གལ་ཏེ་ནུས་པ་དག་ཅིའི་ཕྱིར་གཞན་དང་གཞན་སྐྱེད་པར་མི་བྱེད་ཅེ་ན་ལ་། ནོ་༎ 
 00911 iti cet, na, tatra eva sāmarthyāt| tasya eva ekasya janane	། མ་ཡིན་ཏེ་དེ་ཁོ་ན་ལ་ནུས་པའི་ཕྱིར་རོ་༎ གཅིག་པུ་དེ་ཉིད་བསྐྱེད་པར་བྱ་བར་ནུས་ཀྱི་། གཞན་ལ་ནི་མ་ཡིན་པས་།
 00912 samarthā na anyasya iti na aparāpara-jananam|	གཞན་དང་གཞན་སྐྱེད་པ་མ་ཡིན་ནོ་༎
 00913 bhinna-svabhāvebhyaś cakṣur-ādibhyaḥ sahakāribhya eka- 00914 kārya-utpattau na kāraṇa-bhedāt kārya-bhedaḥ syād iti cet,	གལ་ཏེ་མིག་ལ་སོགས་པ་ལྷན་ཅིག་བྱེད་པ་ངོ་བོ་ཉིད་ཐ་དད་པ་དག་ལས་འབྲས་བུ་གཅིག་སྐྱེ་ན་རྒྱུའི་བྱེ་བྲག་ལས་འབྲས་བུའི་བྱེ་བྲག་ཏུ་མི་འགྱུར་རོ་ཞེ་ན་།
 00915 na, yathāsvaṃ svabhāva-bhedena tad-viśeṣa-upayogatas tad-upayoga-	མ་ཡིན་ཏེ་བདག་ཉིད་ཇི་ལྟ་བའི་ངོ་བོ་ཉིད་ཀྱི་བྱེ་བྲག་གིས་དེའི་ཁྱད་པར་ལ་ཉེ་བར་སྦྱོར་བའི་ཕྱིར་།
 00916 kārya-svabhāva-viśeṣa-asaṅkarāt,	དེའི་ཉེ་བར་སྦྱོར་བས་བྱ་བའི་ཁྱད་པར་འཆོལ་བ་མེད་པའི་ཕྱིར་རོ་༎
 yathā mṛt-piṇḍa-kulāla 00917 sūtra-ādibhyo bhavato ghaṭasya mṛt-piṇḍād amṛt-svabhāvebhyo	དཔེར་ན་འཇི་བའི་གོང་བུ་དང་། རྫ་མཁན་དང་སྐུད་པ་ལ་སོགས་པ་དག་ལས་བུམ་པར་འགྱུར་བ་ལ་།
 00918 vṛkṣa-ādibhyo bhinnaḥ svabhāvaḥ kulālāt tasya eva mṛd-ātmanaḥ	འཇི་བའི་གོང་བུ་ལས་ནི་འཇི་བའི་ངོ་བོ་ཉིད་མ་ཡིན་པ་ཤིང་ལ་སོགས་པ་ལས་གཞན་པའི་ངོ་བོ་ཉིད་།
 00919 sataḥ saṃsthāna-viśeṣa-ātmatayā tad-anyebhyo bhinnaḥ sūtrāt	རྫ་མཁན་ལས་ནི་འཇི་བའི་བདག་ཉིད་ཡིན་པ་དེ་ཉིད་དབྱིབས་ཀྱི་བྱེ་བྲག་གི་བདག་ཉིད་ཀྱིས་དེ་ལས་གཞན་པ་དག་ལས་ཐ་དད་པ་།
 00920 tasya eva mṛt-saṃsthāna-viśeṣa-ātmanaś cakra-āder vibhaktaḥ svabhāvo	སྐུད་པ་ལས་ནི་འཇི་བ་དང་དབྱིབས་ཀྱི་བྱེ་བྲག་གི་བདག་ཉིད་ཅན་དེ་ཉིད་འཁོར་ལོ་ལ་སོགས་པ་ལས་རྣམ་པར་ཕྱེ་བའི་ངོ་བོ་ཉིད་དུ་འགྱུར་བ་ལྟ་བུ་སྟེ་།
 00921 bhavati; tad evaṃ na kulālān mṛt-svabhāvatā, na	དེ་ལྟར་ན་རྫ་མཁན་ལས་ནི་འཇི་བའི་ངོ་བོ་ཉིད་མ་ཡིན་ལ་།
 01001 mṛdaḥ saṃsthāna-viśeṣaḥ;	འཇི་བ་ལས་ཀྱང་དབྱིབས་ཀྱི་བྱེ་བྲག་མ་ཡིན་ནོ་༎
 na ca tayoḥ śakti-viśeṣa-viṣaya- 01002 bhedo api taj-janita-viśeṣa-bhedasya kāryasya svabhāva-bhedaḥ,	དེ་གཉིས་ཀྱི་ནུས་པའི་བྱེ་བྲག་གི་ཡུལ་ཐ་དད་ཀྱང་དེས་བསྐྱེད་པའི་ཁྱད་པར་གྱི་བྱེ་བྲག་གི་འབྲས་བུའི་ངོ་བོ་ཉིད་དི་ཐ་དད་པ་མ་ཡིན་ཏེ་། 
 01003 mṛt-saṃsthānayor aparaspara-ātmatayā saṃsthāna-mṛd-rūpābhyāṃ 01004 tayor apratibhāsana-prasaṅgāt|	འཇི་བ་དང་དབྱིབས་དག་ཕན་ཚུན་གྱི་བདག་ཉིད་ཅན་མ་ཡིན་པ་ཉིད་ཀྱིས་མ་ཡིན་ཏེ་། ། དེ་གཉིས་དབྱིབས་དང་འཇི་བའི་ངོ་བོ་དག་ཏུ་མི་སྣང་བར་༄༢༤༣ཨ་༌་མ་ཡིན་ཏེ་། ། ༎ ཐལ་བར་འགྱུར་བའི་ཕྱིར་རོ་༎
 01005 anyad eva saṃsthānaṃ guṇo mṛd-dravyāt,	གལ་ཏེ་ཡོན་ཏན་དབྱིབས་ནི་རྫས་ལས་གཞན་པ་ཁོ་ན་ཡིན་ཏེ་།
 tena bhinna- 01006 svabhāvaḥ kulāla-mṛt-piṇḍayor upayoga-viṣaya iti cet, uktam	དེས་ན་རྫ་མཁན་དང་། འཇི་བའི་ཉེ་བར་སྦྱོར་བའི་ཡུལ་ངོ་བོ་ཉིད་ཐ་དད་པ་ཡིན་ནོ་ཞེ་ན་འདི་ལས་བཤད་ཟིན་ཏོ་༎ 
 01007 atra| api ca yadi saṃsthānaṃ bhinnaṃ mṛdaḥ,	གཞན་ཡང་འཇི་བ་ལ་དབྱིབས་ཐ་དད་པ་ཞིག་ཡིན་ན་།
 kulālaḥ kiṃ	རྫ་མཁན་གྱིས་ཅིའི་ཕྱིར་ལོགས་ཤིག་ཏུ་མི་བྱེད་།
 01008 na pṛthak karoti| guṇasya dravya-paratantratvam iti na pṛthak	གལ་ཏེ་ཡོན་ཏན་ནི་རྫས་ཀྱིས་གཞན་གྱི་དབང་ཡིན་པས་ལོགས་ཤིག་ཏུ་མི་བྱེད་དོ་༎
 01009 karoti| tat-saṃsthāna-ādhāra-ātmakaṃ yadi svabhāvena tad dravyaṃ	གལ་ཏེ་རང་བཞིན་གྱི་རྫས་དེ་དབྱིབས་དེའི་རྟེན་གྱི་བདག་ཉིད་ཅན་ཡིན་པའམ་།
 01010 tat-saṃsthānaṃ vā tad-ādheya-ātmakam,	དབྱིབས་དེ་དེ་ལ་རག་ལས་པའི་བདག་ཉིད་ཅན་ཞིག་ཡིན་ན་།
 kiṃ kulāla-apekṣayā iti cet,	རྫ་མཁན་ལ་ལྟོས་ཅི་དགོས་ཤེ་ན་མ་ཡིན་ཏེ་།
 01011 na, tataḥ paraspara-sambandha-yogyatā-pratilambhāt; anyathā	དེ་ལས་ཕན་ཚུན་འབྲེལ་དུ་རུང་པ་ཉིད་ཐོབ་པའི་ཕྱིར་རོ་༎ དེ་ལྟ་མ་ཡིན་ཏེ་དངོས་པོའི་ཆོས་ཉིད་རུང་བ་ཁོ་ནས་།
 01012 vastuna eva yogyatā dharmatā iti prāg api mṛt-piṇḍasya saṃsthāna- 01013 viśeṣa-sambandha-yogyatve sati saṃsthāna-viśeṣeṇa sambandha-	སྔོན་ཡང་འཇི་བའི་གོང་བུ་དབྱིབས་ཀྱི་ཁྱད་པར་དང་འབྲེལ་དུ་རུང་བ་ཉིད་གཅིག་ཡིན་ན་ནི་དབྱིབས་ཀྱི་ཁྱབ་པ་དང་འབྲེལ་པའི་ཁྱད་པར་དུ་ཐལ་བར་འགྱུར་རོ་༎
 01014 prasaṅgaḥ| evaṃ tarhi sā yogyatā mṛd-dravyasya kulālād 01015 bhavati iti na anayoḥ svabhāva-bhedaḥ, bhede hi prāg-vat prasajyeta|	དེ་ལྟ་ཡིན་ན་ནི་འོ་ན་རྫས་འཇི་བའི་རུང་བ་དེ་རྫ་མཁན་ལས་འགྱུར་བས་འདི་གཉིས་ངོ་བོ་ཉིད་ཐ་དད་པ་ཡང་མ་ཡིན་ནོ་༎ ཐ་དད་པ་ཡིན་ན་ནི་། སྔ་མ་བཞིན་དུ་ཐལ་བར་འགྱུར་བའི་ཕྱིར་རོ་༎
 01016 asti tāvad eka-svabhāvatve api kasyacid aneka-pratyaya-upadheya- 01017 viśeṣatā iti na mṛt-saṃsthānayor eka-svabhāvatva-sādhanāya 01018 nirbandhaḥ|	རེ་ཞིག་ངོ་བོ་ཉིད་གཅིག་པ་ཉིད་ལ་ཡང་རྐྱེན་དུ་མས་པར་དུ་བྱ་བ་འགའ་ཡོད་པས་། འཇི་བ་དང་དབྱིབས་དག་ངོ་བོ་ཉིད་གཅིག་ཏུ་བསྒྲུབ་པར་མི་འདོད་དོ་༎ དེས་ན་དངོས་སུ་འབྲས་སུ་ངོ་བོ་ཉིད་གཅིག་པ་ཉིད་ཡིན་ཡང་།
 01019 tena sahakāriṇaḥ pratyayā na eka-upayoga-viṣayāḥ kārya-	ལྷན་ཅིག་བྱེད་པའི་རྐྱེན་དག་ཉེ་བར་སྦྱོར་བའི་ཡུལ་གཅིག་པ་ཅན་མ་ཡིན་ན་།
 01020 svabhāvasya ekatve api vastuta iti yathā iha kāraṇa-bhedo bhinna-	ཇི་ལྟར་འདིར་རྒྱུ་ཐ་དད་པའི་ཉེ་བར་སྦྱོར་བའི་ཡུལ་གཅིག་པ་ཅན་མ་ཡིན་ནོ་༎
 01021 viśeṣa-upayogān na eka-kāryas tathā cakṣur-ādibhyo vijñāna-utpattāv	ཇི་ལྟར་འདིར་རྒྱུ་ཐ་དད་པའི་ཉེ་བར་སྦྱོར་བའི་ཡུལ་ཐ་དད་པའི་ཕྱིར་འབྲས་བུ་གཅིག་པ་མ་ཡིན་པ་དེ་བཞིན་དུ་། མིག་ལ་སོགས་པ་ལ་མིག་གི་རྣམ་པར་ཤེས་པ་སྐྱེ་བ་ལ་ཡང་རིག་པར་བྱ་སྟེ་།
 01022 unneyaḥ| tathā hi samanantarapratyayād vijñānāc 01101 cakṣurvijñānasya upalambha-ātmatā tasya eva upalambha-ātmanaḥ	འདི་ལྟར་མཚུངས་པ་དེ་མ་ཐག་པའི་རྐྱེན་ལས་ནི་མིག་གི་རྣམ་པར་ཤེས་པ་དམིགས་པའི་བདག་ཉིད་ཡིན་ལ་དམིགས་པའི་བདག་ཉིད་མིག་གི་དབང་པོ་ལས་ནི་གཟུགས་འཛིན་དུ་རུང་བ་ཉིད་དུ་སོ་སོར་ངེས་པ་ཡིན་།
 01102 sataś cakṣur-indriyād rūpa-grahaṇa-yogyatā-pratiniyamo viṣayāt	ཡུལ་ལས་ནི་དེ་དང་འདྲ་བའི་ངོ་བོ་ཅན་ཉིད་ཅེས་བྱ་བ་ཡིན་ནོ་༎
 01103 tat tulya-rūpatā ity abhinnatve api vastutaḥ kāryasya kāraṇānāṃ	དངོས་སུ་འབྲས་བུ་ཐ་དད་པའི་ངོ་བོ་ཉིད་མ་ཡིན་ཡང་།
 01104 bhinnebhyaḥ svabhāvebhyo bhinnā eva viśeṣā bhavanti iti na	རྒྱུའི་ངོ་བོ་ཉིད་ཐ་༄༢༤༣བ་དད་པ་དག་ལས་ཁྱད་པར་ཐ་དད་པ་ཁོ་ན་དག་ཏུ་འགྱུར་བས་། 
 01105 kāraṇa-bhede apy abhedas tat-kārya-viśeṣasya| ta eva ete kāraṇa-	རྒྱུ་ཐ་དད་པ་ཡིན་ཡང་དེས་བྱ་བའི་ཁྱད་པར་ཐ་མི་དད་པ་ཡིན་ནོ་༎ རྒྱུའི་ནུས་པ་ཐ་དད་པ་དེ་དག་ཁོ་ན་སྐད་ཅིག་པ་ཡིན་པའི་ཕྱིར་།
 01106 śakti-bhedā yathāsvaṃ prativiśiṣṭa-kārya-janane avyavadheya- 01107 śaktitayā pratyupasthitāḥ kṣaṇikatvāt sāmagrī-kāryasya svabhāva- 01108 sthity-āśraya ity ucyante| tathā hi tat tebhyaḥ samastebhya 01109 upalambha-ātmakaṃ rūpa-grahaṇa-pratiniyataṃ viṣaya-	བདག་ཉིད་ཇི་ལྟ་བ་བཞིན་སོ་སོའི་ཁྱད་པར་ཅན་གྱི་འབྲས་བུ་སྐྱེད་པར་ནུས་པ་ཆོད་པ་མེད་པ་ཉིད་དུ་ཉེ་བར་གནས་པ་ནི་ཚོགས་པའི་འབྲས་བུའི་ངོ་བོ་ཉིད་གནས་པའི་གཞི་དག་ཡིན་ཞེས་བྱ་སྟེ་།
 01110 rūpaṃ ca iti prativiśiṣṭa-svabhāvam ekaṃ jātam| 01111 apratirodha-śaktikeṣv anantara-kāryeṣv anādheyaviśeṣeṣu kṣaṇikeṣu 01112 pratyayeṣu parasparaṃ kaḥ sahakāra-artha iti cet, na vai	འདི་ལྟར་དེ་ནི་དེ་མཐའ་དག་ལས་དམིགས་པའི་བདག་ཉིད་དང་། གཟུགས་འཛིན་པར་སོ་སོར་ངེས་པ་དང་། ཡུལ་དང་ངོ་བོ་ཅན་ཞེས་བྱ་བ་སོ་སོའི་ཁྱད་པར་ཅན་གྱི་ངོ་བོ་ཉིད་གཅིག་སྐྱེས་སོ་༎ གལ་ཏེ་ནུས་པ་འགོག་པ་མེད་པ་འབྲས་བུ་མཇུག་ཐོགས་པ་སྐད་ཅིག་པ་ཁྱད་པར་དུ་བོགས་དབྱུང་དུ་མེད་པ་དག་གི་རྐྱེན་རྣམས་ལ་༎ ། ཕན་ཚུན་ལྷན་ཅིག་བྱེད་པའི་དོན་ཅི་ཞིག་ཡིན་ཞེ་ན་།
 01113 sarvatra atiśaya-utpādanaṃ sahakriyā| kiṃ tarhi| bahūnāṃ yad	ལྷན་ཅིག་བྱེད་པ་ནི་ཐམས་ཅད་དུ་བོགས་འབྱིན་པ་སྐྱེད་པ་འབའ་ཞིག་ཀྱང་མ་ཡིན་ནོ་༎ འོ་ན་ཅི་ཞེ་ན་།
 01114 eka-artha-karaṇam api,	མང་པོ་དག་དོན་གཅིག་བྱེད་པ་གང་ཡིན་པ་ཡིན་ཏེ་།
 yathā antyasya kāraṇa-kalāpasya| tad	དཔེར་ན་ཚོགས་ཐ་མ་ལྟ་བུའོ་༎
 01115 eva mukhyaṃ sahakāritvaṃ sahakārīṇām, tasya eva antyasya	འདི་ཉིད་དངོས་སུ་ལྷན་ཅིག་བྱེད་པ་རྣམས་ཀྱི་ལྷན་ཅིག་བྱེད་པ་ཡིན་ཏེ་། ཐ་མ་དེ་ཉིད་རྒྱུ་ཡིན་པའི་ཕྱིར་རོ་༎
 01116 kāraṇatvāt tatra ca kṣaṇa ekasya svabhāvasya avivekād viśeṣasya 01117 kartum aśakyatvāt,	སྐད་ཅིག་མ་དེ་ལ་ངོ་བོ་ཉིད་གཅིག་ལ་དབྱེ་བ་མེད་པས་ཁྱད་པར་དུ་བྱ་བར་མི་ནུས་པའི་ཕྱིར་ཏེ་།
 svabhāva-antara-utpatti-lakṣaṇatvād viśeṣa-	ཁྱད་པར་འབྱུང་བའི་མཚན་ཉིད་ནི་། ངོ་བོ་ཉིད་གཞན་འབྱུང་བའི་ཕྱིར་རོ་༎
 01118 utpatteḥ| bhāva-antara-utpattāv antyaṃ na syāt, tataś ca na	ངོ་བོ་ཉིད་གཞན་འབྱུང་ན་ནི་ཐ་མར་མི་འགྱུར་ཏེ་། དེའི་ཕྱིར་མངོན་སུམ་གྱི་རྒྱུར་མི་འགྱུར་རོ་༎
 01119 sākṣāt kāraṇaṃ syāt| tasmān na kāraṇasya sahakāribhyo viśeṣa-	དེ་ལྟ་བས་ན་ལྷན་ཅིག་བྱེད་པ་རྣམས་ལས་རྒྱུའི་ཁྱད་པར་འབྱུང་བ་མ་ཡིན་ནོ་༎ གང་དག་ལ་སྔོན་དང་ཕྱིས་དང་ཐ་དད་པའི་ངོ་བོ་མེད་པ་།
 01120 utpattiḥ| te samarthāḥ svabhāvato antyāḥ pratyayāḥ 01121 saha jāyante kṣaṇikā yeṣāṃ prāg-paścāt-pṛthag-bhāvo na asti 01122 yebhyaś ca anantaraṃ kāryam utpadyate,	གང་གི་མཇུག་ཐོགས་སུ་འབྲས་བུ་འབྱུང་བའི་རྐྱེན་ཐ་མ་ངོ་བོ་ཉིད་ཀྱིས་ནུས་པར་སྐད་ཅིག་པ་དེ་དག་ལྷན་ཅིག་སྐྱེ་སྟེ་།
 tatra eka-arthakriyā 01123 eva sahakāritvam|	དེ་ལ་བྱ་བ་གཅིག་པ་ཁོ་ན་ལྷན་ཅིག་བྱེད་པ་ཉིད་ཡིན་ནོ་༎
 01201 samarthaḥ kuto jāyata iti cet,	གལ་ཏེ་ནུས་པ་དེ་དག་ག་ལས་བྱུང་ཞེ་ན་།
 sva-kāraṇebhyaḥ|	རང་གི་ངག་ལས་སོ་༎
 01202 tāny enam apara-pratyaya-saṃnidhāna kiṃ janayanti, 01203 kadācid anyathā api syuḥ,	གལ་ཏེ་དེ་དག་གིས་འདི་རྐྱེན་གཞན་དང་ཉེ་བ་མེད་པ་ཁོ་ནར་ཅི་སྟེ་མི་སྐྱེད་དེ་རེས་འགའ་གཞན་དུ་ཡང་འགྱུར་རོ་༎
 tataś ca eko api kvacid janayed iti	དེའི་ཕྱིར་ལ་ལར་གཅིག་པུས་ཀྱང་སྐྱེ་བར་འགྱུར་རོ་ཞེ་ན་། འདུ་བྱེད་རྒྱུ་མ་གཞན་དང་གཞན་གྱི་རྐྱེན་དང་ལྡན་པས་།
 01204 cet, aparāpara-pratyaya-yogena pratikṣaṇaṃ bhinna-śaktayaḥ 01205 saṃskārāḥ santanvanto yady api kutaścit sāmyāt sarūpāḥ 01206 pratīyante,	སྐད་ཅིག་མ་རེ་རེ་ལ་ནུས་པ་ཐ་དད་པ་ཅན་དག་འགའ་ཞིག་གིས་མཚུངས་པས་ངོ་བོ་འདྲ་བར་ཤེས་མོད་ཀྱི་།
 tathā api bhinna eva eṣāṃ svabhāvaḥ;	དེ་༄༢༤༤ཨ་༌་༎ ལ་འདི་དག་གི་ངོ་བོ་ཉིད་ཐ་དད་པ་ཁོ་ན་ཡིན་ཏེ་།
 tena kiṃcid 01207 eva kasyacit kāraṇam|	དེས་ན་འགའ་ཞིག་ཁོ་ན་འགའ་ཞིག་གི་རྒྱུ་ཡིན་ནོ་༎
 01208 tatra yo avyavadhāna-ādi-deśo rūpa-indriya-ādi-kalāpaḥ sa vijñāna-	དེ་ལ་གཟུགས་དང་དབང་པོ་ལ་སོགས་པའི་ཚོགས་ཡུལ་ཆོད་པ་མེད་པ་ལ་སོགས་པ་དང་ལྡན་པ་ཅན་གང་ཡིན་པ་དེ་ནི་།
 01209 janane samartho hetuḥ| yas teṣāṃ paraspara-upasarpaṇa-	རྣམ་པར་ཤེས་པ་སྐྱེད་པར་ནུས་པའི་རྒྱུ་ཡིན་ནོ་༎
 01210 ādy-āśrayaḥ pratyaya-viśeṣaḥ sa tad-hetu-janane samarthaḥ|	དེ་དག་ཕན་ཚུན་ཉེ་བར་འགྲོ་བ་ལ་སོགས་པའི་རྟེན་རྐྱེན་གྱི་ཁྱད་པར་གང་ཡིན་པ་དེ་ནི་དེའི་རྒྱུ་སྐྱེད་པར་ནུས་པ་ཡིན་ནོ་༎
 01211 teṣāṃ ca na pūrvaṃ na paścān na pṛthag bhāva iti samarthān	དེ་དག་ཀྱང་སྔོན་ཡང་མེད་། ཕྱིས་ཀྱང་མེད་།
 01212 api pūrva-apara-pṛthag-bhāva-bhāvino doṣā na upalīyante| tena yas	སོ་སོ་ན་ཡང་མེད་པས་ནུས་ཀྱང་སྔོན་དང་ཕྱིས་ཀྱང་སོ་སོ་ན་ཡོད་པ་ལས་འབྱུང་བའི་ཉེས་པ་དག་གིས་མི་གོས་སོ་༎
 01213 teṣāṃ paraspara-upasarpaṇa-ādi-hetuḥ sa samarthasya hetur iti tatra	དེ་དག་ན་འདི་དག་ཕན་ཚུན་ཉེ་བར་འགྲོ་བ་ལ་སོགས་པའི་རྒྱུ་གང་ཡིན་པ་དེ་ནུས་པའི་རྒྱུ་ཡིན་པས་།
 01214 na kadācid anyathābhāvaḥ| anena nyāyena sarvatra hetu-phala-	དེ་ལ་ནམ་ཡང་གཞན་དུ་འགྱུར་བ་མེད་དོ་༎
 01215 bhāva-pratiniyamo boddhavyaḥ pratikṣaṇam anyānya-svabhāva- 01216 bheda-anvayinīṣu bhāva-śaktiṣu, na tu sthira-eka-svabhāveṣu bhāveṣu,	ཚུལ་འདིས་ཐམས་ཅད་ལ་རྒྱུ་དང་འབྲས་བུའི་ངོ་བོ་སོ་སོར་ངེས་པ་ཁོང་དུ་ཆུད་པར་བྱའོ་༎ དངོས་པོའི་ནུས་པ་སྐད་ཅིག་མ་རེ་རེ་ལ་ངོ་བོ་ཉིད་ཀྱི་བྱེ་བྲག་གཞན་དང་གཞན་གྱི་རྗེས་སུ་འགྲོ་བ་ཅན་དག་ལ་ཡིན་གྱི་དངོས་པོ་བསྟན་པ་གཅིག་པུའི་ངོ་བོ་ཉིད་ཅན་དག་ལ་ནི་མ་ཡིན་ཏེ་།
 01217 svabhāvasya anyathātva-asambhavāt samartha-asamartha-svabhāvānāṃ 01218 kriyā-akriyā-anupapatteḥ|	ངོ་བོ་ཉིད་གཞན་དུ་འགྱུར་བ་མེད་པས་ནུས་པ་དང་མི་ནུས་པའི་ངོ་བོ་ཉིད་དག་ལ་བྱེད་པ་དང་མི་བྱེད་པ་མི་རུང་བའི་ཕྱིར་རོ་༎ 
 01219 anya-sahitaḥ karoti na kevala iti cet,	གལ་ཏེ་ལྷན་ཅིག་བྱེད་ཀྱི་འགའ་ཞིག་ནི་མ་ཡིན་ནོ་ཞེ་ན་།
 kiṃ kevalasya kārya-	ཅི་འབའ་ཞིག་གིས་འབྲས་བུ་བསྐྱེད་པར་ནུས་སམ་། མི་ནུས་སོ་༎ ཅིའི་ཕྱིར་མི་བསྐྱེད་།
 01220 janane samarthaḥ svabhāvo asamartho vā samartha iti cet, kiṃ	མི་བསྐྱེད་ན་ཇི་ལྟར་ནུས་།
 01221 na karoti, akurvan kathaṃ samarthaḥ| kuvinda-ādayaḥ paṭa-ādi-	གལ་ཏེ་ཐ་ག་ལ་སོགས་པ་རས་ཡུག་ལ་སོགས་པ་བྱ་བར་ནུས་མོད་ཀྱི་།
 01222 kriyāyāṃ samarthā api na sarvadā kurvanti iti cet, krīḍana-śīlo 01301 devānāṃpriyo 01301 mūrkhaḥ sukhaidhitaḥ kṛtam api punaḥ punaḥ	ཐམས་ཅད་དུ་ནི་མི་བྱེད་དོ་ཞེ་ན་། བརྩེ་བའི་དང་ཚུལ་ཅན་བླུན་པོ་རྣམས་དགའ་བ་སྐྱེད་དེ་བར་བསྐྱེད་པ་ནི་བྱས་ཤིང་བྱས་པ་ལ་ཡང་དང་ཡང་བྱེད་དུ་གཞུག་སྟེ་།
 01302 kārayati, tathā hy etad bīja-ādy-upanyāse nirloṭhitam| tasmāt	འདི་ལྟར་འདི་ནི་ས་བོན་ལ་སོགས་པ་ཉེ་བར་འགོད་པར་དཔྱད་ཟིན་ཏོ་༎
 01303 svabhāvasya anyathātva-asambhavāt tad-dharmaṇas tathābhāvo 01304 antya-avasthā-vad anivāryaḥ|	དེ་ལྟ་བས་ན་ངོ་བོ་ཉིད་གཞན་དུ་འགྱུར་བ་མེད་པའི་ཕྱིར་རོ་༎ དེའི་ཆོས་ཅན་གྱི་ངོ་བོ་ཉིད་དེ་ལྟ་བུ་ནི་ཐ་མའི་གནས་སྐབས་བཞིན་དུ་བཟློག་ཏུ་མི་རུང་ངོ་༎ 
 01305 antya-avasthāyāṃ prāg asamarthasya sāmarthya-utpattau	ཐ་མའི་གནས་སྐབས་ན་སྔོན་ནུས་པ་མེད་པ་ལས་ནུས་པ་སྐྱེ་ན་།
 01306 sāmarthyasya tat-svabhāvatve apūrva-utpattir eva sā,	ནུས་པ་དེའི་ངོ་བོ་ཉིད་ཡིན་ན་ནི་། སྔོན་མེད་པ་སྐྱེ་བ་ཁོ་ན་ཡིན་ནོ་༎
 atat-svabhāvatve 01307 so akāraka eva,	དེའི་ངོ་བོ་ཉིད་མ་ཡིན་ན་ནི་བྱེད་པ་པོ་མ་ཡིན་པ་ཉིད་དེ་།
 sāmarthya-ākhyād bhāvāt kārya-utpatteḥ|	ནུས་པ་ཞེས་བྱ་བའི་དངོས་པོ་ལས་འབྲས་བུ་སྐྱེ་བའི་ཕྱིར་རོ་༎
 01308 api ca sa eva tāvat sakala-sahakāri-sahitaḥ kāryaṃ kasmāt	གཞན་ཡང་རེ་ཞིག་དེ་ཉིད་ལྷན་ཅིག་བྱེད་པ་མཐའ་༄༢༤༤བ་དག་དང་ལྡན་པ་འབྲས་བུ་ཇི་སྟེ་སྐྱེད་། 
 01309 karoti kurvan dṛṣṭaḥ,	བསྐྱེད་པ་མཐོང་སྟེ་།
 tena karoti iti brūmaḥ| aho mahā-sāmarthyaṃ	དེས་ན་བསྐྱེད་དོ་ཞེས་སྨྲའོ་༎
 01310 mahā-prabhāvasya darśanam atat-svabhāvān api bhāvān	མཐུ་ཆེན་པོ་ཅན་གྱི་མཐོང་བ་དངོས་པོ་དེའི་ངོ་བོ་ཉིད་མ་ཡིན་པ་དག་ཀྱང་།
 01311 svabhāva-mātreṇa nānā-vyāpāreṣu niyuñjanam| yadi nāma	རང་གི་ངོ་བོ་ཙམ་གྱིས་བྱ་བ་སྣ་ཚོགས་པ་རྣམས་ལ་སྦྱོར་བ་ནི་ནུས་པ་ཆེན་པོ་ཅན་ཡིན་ནོ་༎ 
 01312 kadācit kiṃcit kathaṃcit atra-bhavanto darśana-patham atikrāmet,	བརྒྱ་ཞིག་ལ་འགའ་ཞིག་ཇི་ཞིག་ལྟར་འདིར་ཁྱོད་ཀྱི་མཐོང་བའི་ལམ་ལས་འདས་ཅན་ཡིན་ནོ་༎ ན་། ཀྱེ་མ་མི་སྐྱེད་པའི་ཆོས་ཅན་ཡིན་ཏེ་།
 01313 hanta-aprasava-dharmakam apeta-santānaṃ syād iti iyaṃ	རྒྱུ་མེད་པ་ཅན་དུ་འགྱུར་བས་བསམ་པ་འདི་ནི་སེམས་ལ་གདུང་ངོ་༎
 01314 cintā cittaṃ dunoti| na vai vayam atat-svabhāvānām asmad-darśana-	ཁོ་བོ་ནི་དེའི་ངོ་བོ་ཉིད་མ་ཡིན་པ་ལས་བདག་གིས་མཐོང་བས་འབྲས་བུ་བསྐྱེད་དོ་ཞེས་མི་ཟེར་རོ་༎ 
 01315 vaśāt kārya-kriyāṃ brūmaḥ| kiṃ tarhi| svabhāvena eva te 01316 tat-karaṇa-dharmāḥ,	འོ་ན་ཅི་ཞེ་ན་དེ་དག་ནི་ངོ་བོ་ཉིད་ཀྱིས་དེ་སྐྱེད་པའི་ཆོས་མི་ཟེར་རོ་༎ ཅན་ཡིན་ལ་། 
 tān paśyantaḥ kevalaṃ jānīmahe ta ete 01317 kārakā iti| satyam, idam apy asti,	དེ་དག་མཐོང་ན་འདི་དག་ནི་སྐྱེད་པ་པོ་ཡིན་ནོ་ཞེས་བྱ་བར་ཤེས་པར་ཟད་དོ་༎
 svabhāvas teṣāṃ kārya-kriyā-	འདི་ཡང་ཡོད་པར་བདེན་ན་དེ་དག་འབྲས་བུ་བསྐྱེད་པའི་ཆོས་ཀྱི་ངོ་བོ་ཉིད་ཡིན་པ་དེས་ན་། 
 01318 dharmā, tena samasta-pratyayavatām akṛtvā na upekṣā āpattir iti|	རྐྱེན་མཐའ་དག་དང་ལྡན་པ་རྣམས་མ་བསྐྱེད་པར་བཏང་སྙོམས་སུ་འཁོད་དོ་ཞེས་བྱ་བ་ནི་མ་ཡིན་ནོ་༎
 01319 so akṣepa-kriyā-dharmā svabhāvaḥ kiṃ teṣāṃ tadā eva antya-	ཅི་དེ་དག་གི་མི་སྡོད་པར་བསྐྱེད་པའི་ཆོས་ཅན་གྱི་ངོ་བོ་ཉིད་དེ་། ཐ་མའི་གནས་སྐབས་དེ་ཁོ་ནའི་ཚེ་འབྱུང་ངམ་།
 01320 avasthāyām utpanna āhosvit prāg apy āsīt| āsīt, apracyuta-utpanna- 01321 sthira-eka-svabhāvānāṃ kadācana kasyacit svabhāvasya abhāva-	འོན་ཏེ་སྔོན་ཡང་ཡོད་དེ་མ་ཉམས་མ་བྱུང་བ་བརྟན་པ་གཅིག་པུའི་ངོ་བོ་ཉིད་ཅན་རྣམས་ལ་ངོ་བོ་ཉིད་འགའ་མེད་བ་འགལ་བའི་ཕྱིར་རོ་༎ 
 01401 virodhāt| tat kim idānīṃ mātā ca vandhyā ca; ko vā asya	དེ་ནི་ཅི་དེ་མ་ཡང་ཡིན་མོ་གཤམ་ཡང་ཡིན་ནམ་།
 01402 bhāṣitasya artho akṣepa-kriyā-dharmā ca svabhāvo na ca karoti iti|	མི་སྡོད་པར་སྐྱེད་པའི་ཆོས་ཀྱི་ངོ་བོ་ཉིད་ཀྱང་ཡིན་ལ་། མི་སྐྱེད་པ་ཡང་ཡིན་ནོ་ཞེས་སྨྲས་པ་འདིའི་དོན་ཅི་ཡིན་།
 01403 sahitas tat-svabhāvo na kevala iti cet,	གལ་ཏེ་དེའི་ངོ་བོ་ནི་ལྷན་ཅིག་པ་ཡིན་གྱི་། འབའ་ཞིག་ནི་མ་ཡིན་ནོ་ཞེ་ན་།
 anyas tarhi kevalo 01404 anyaś ca sahitas,	འོ་ན་ནི་འབའ་ཞིག་ཀྱང་གཞན་ལ་ལྷན་ཅིག་པ་ཡང་གཞན་ཡིན་ཏེ་།
 svabhāva-bhedo hi bhāva-bhedasya lakṣaṇam|	དངོས་པོ་ཐ་དད་པའི་མཚན་ཉིད་ནི་། ངོ་བོ་ཉིད་ཐ་དད་པ་ཡིན་པའི་ཕྱིར་རོ་༎
 01405 na hi sa sāhitye api pararūpeṇa kartā;	ལྷན་ཅིག་པ་ཉིད་ཡིན་ཡང་གཞན་གྱི་ངོ་བོས་བྱེད་པ་པོ་ནི་མ་ཡིན་ལ་།
 svarūpaṃ ca asya prāg	འདིའི་རང་གི་ངོ་བོ་ནི་སྔོན་ཡང་དེ་ཁོ་ནར་ཟད་ན་། ཇི་ལྟར་རེས་འགའ་སྐྱེད་པ་དང་འབྲལ་།
 01406 api tad eva iti kathaṃ kadācit kriyā-virāmaḥ| yasya api bhāvaḥ 01407 kṣaṇikas tasya api kasmāt kevalo na karoti, yadi bhavet, kuryād eva|	གང་གི་དངོས་པོ་སྐད་ཅིག་པ་ཡིན་པ་དེའི་ལྟར་ན་ཡང་ཇི་སྟེ་འབའ་ཞིག་གིས་མི་སྐྱེད་། གལ་ཏེ་ཡིན་ན་ནི་སྐྱེད་པ་ཁོ་ནའོ་༎
 01408 kathaṃ na bhavati| kṣaṇikatvāt| uktaṃ yādṛśasya kriyā| sa katham	མ་ཡིན་ན་སྐད་ཅིག་མ་ཡིན་པའི་ཕྱིར་རོ་༎ ཇི་ལྟ་བུ་ཞིག་བསྐྱེད་པ་ནི་བཤད་ཟིན་ཏེ་། སྐད་ཅིག་མ་འབྱུང་བ་ཅན་དེ་ཇི་ལྟར་གཞན་དུ་འགྱུར་།
 01409 eka-kṣaṇa-bhāvy anyathā bhavet| yaś ca bhavati, sa eva na	གང་ཞིག་འགྱུར་བ་དེ་ནི་དེ་ཉིད་༄༢༤༥ཨ་༌་༎
 01410 bhavati iti na ayaṃ prasaṅgaḥ,	མ་ཡིན་པས་ཐལ་བ་འདིར་མི་འགྱུར་ཏེ་།
 kāraka-akārakayoḥ svabhāva-tad- 01411 hetor virodhāt|	བྱེད་པ་པོ་དང་། བྱེད་པ་པོ་མ་ཡིན་པ་དག་གི་ངོ་བོ་ཉིད་དང་དེའི་རྒྱུ་དག་འགལ་བའི་ཕྱིར་རོ་༎
 01412 yo api manyate akṣepa-kriyā-dharmā eva sa tasya svabhāvaḥ,	གང་ཞིག་དེའི་ངོ་བོ་ཉིད་དེ་ནི་མི་སྡོད་པར་སྐྱེ་བའི་ཆོས་ཅན་ཁོ་ན་ཡིན་པས་།
 01413 na sa sāhityam apekṣate,	དེ་ནི་ལྷན་ཅིག་པ་ཉིད་ལ་མི་ལྟོས་སོ་༎
 kāryaṃ tu pratyaya-antara-apekṣam	འབྲས་བུ་ནི་རྐྱེན་གཞན་ལ་ལྟོས་པས་།
 01414 iti sahitebhya eva jāyate na kevalebhya iti, tasya api	ལྷན་ཅིག་པ་ཁོ་ན་ལས་སྤྱིའི་འབའ་ཞིག་ལས་ནི་མ་ཡིན་ནོ་སྙམ་དུ་སེམས་ན་།
 01415 kathaṃ sa kevalo api karoty eva kāryaṃ ca tasmān na utpadyate	དེ་ལྟར་ན་ཡང་ཅི་ལྟར་དེ་འབའ་ཞིག་གིས་ཀྱང་སྐྱེད་པ་ཁོ་ན་ཡིན་ལ་འབྲས་བུ་ཡང་དེ་ལས་མི་སྐྱེ་ཞེས་བྱ་སྟེ་།
 01416 iti tad-avastho virodhaḥ| na kevalaḥ karoty eva iti cet, katham	གནས་སྐབས་དེ་ནི་འགལ་ལོ་༎ གལ་ཏེ་འབའ་ཞིག་གིས་སྐྱེད་པ་ཁོ་ནི་མ་ཡིན་ནོ་ཞེ་ན་། ད་ནི་ཇི་ལྟར་ན་མི་འདོད་པར་སྐྱེད་པའི་ངོ་བོ་ཉིད་ཡིན་ཏེ་།
 01417 idānīm akṣepa-kriyā-svabhāvaḥ| nanv etad eva paridīpitaṃ 01418 bhavati karoty eva iti;	འདི་སྐད་དུ་སྐྱེད་པ་ཁོ་ནའོ་ཞེས་ཡོངས་སུ་བསྟན་པ་མ་ཡིན་ནམ་།
 kāryaṃ ca ayaṃ kevalo api samarthaḥ	འདི་འབའ་ཞིག་ཀྱང་ནུས་པ་ཡིན་ན་།
 01419 san param apekṣamānaṃ katham upekṣeta| param anādṛtya etad	འབྲས་བུ་གཞན་ལ་ལྟོས་ན་ཡང་ཇི་ལྟར་བཏང་སྙོམས་སུ་འཇོག་སྟེ་།
 01420 prasahya kuryāt,	གཞན་ལ་མི་འཆོལ་བར་འདི་གསལ་བར་སྐྱེད་པར་འགྱུར་རོ་༎
 evaṃ hy anena ātmanaḥ sāmarthyaṃ darśitaṃ	དེ་ལྟ་ན་འདིས་བདག་ཉིད་ཀྱི་ནུས་པ་བསྟན་པ་ཡིན་ནོ་༎
 01421 bhavati| kāryaṃ param apekṣata iti tataḥ kevalād anutpattir 01501 uktā bhavati,	འབྲས་བུ་གཞན་ལ་ལྟོས་སོ་ཞེས་བྱ་བ་ནི་དེ་འབའ་ཞིག་ལས་མི་སྐྱེ་བར་སྨྲ་བ་ཡིན་ལ་། 
 sa kevalo api samartha-svabhāva iti tata utpattiṃ	དེ་འབའ་ཞིག་ཀྱང་ནུས་པའི་ངོ་བོ་ཉིད་ཡིན་ནོ་ཞེས་བྱ་བ་ནི་། དེ་ལས་སྐྱེ་བར་སྨྲས་པ་ཡིན་ན་།
 01502 brūṣe, ete ca ekatra kathaṃ syātām| tad ayam īrśyā-śalya-vitudyamāna-	འདི་དག་གཅིག་ལ་ཇི་ལྟར་འགྱུར་ཏེ་། དེ་ལྟ་བས་ན་ཕྲག་དོག་གི་ཟུག་རྡུས་གནད་དུ་བརྒྱབ་པ་ཅན་འདི་འཆལ་ཞིང་འཁང་བར་ཟད་པས་། 
 01503 marmā viklavaṃ vikrośati ity upekṣām arhati|	བཏང་སྙོམས་སུ་དོར་བར་འོས་སོ་༎
 01504 tasmād idam eka-arthakriyā-lakṣaṇaṃ sahakāritvaṃ kṣaṇikānāṃ 01505 eva bhāvānām,	དེ་ལྟ་བས་ན་གཅིག་སྐྱེད་པའི་མཚན་ཉིད་ཀྱི་ལྷན་ཅིག་བྱེད་པ་ཉིད་ནི་།
 na tv akṣaṇikānāṃ pṛthagbhāva-sambhavānām, 01506 pṛthak-kriyā-sambhavena sahakāritva-niyama-ayogāt| 01507 yatra tu santāna-upakāreṇa bhāvā hetutāṃ pratipadyante	དངོས་པོ་སྐད་ཅིག་པ་རྣམས་ཁོ་ནའི་ཡིན་གྱི་སྐད་ཅིག་པ་མ་ཡིན་པ་སོ་སོ་ན་ཡོད་པ་སྲིད་པ་ཅན་རྣམས་ཀྱི་ནི་མ་ཡིན་ཏེ་། སོ་སོར་སྐྱེད་པར་སྲིད་པས་ལྷན་ཅིག་བྱེད་པ་ཉིད་དུ་ངེས་པ་མི་རུང་པའི་ཕྱིར་རོ་། ༎ གང་དུ་རྒྱུན་གྱིས་ཕན་འདོགས་པས་དངོས་པོ་རྣམས་རྐྱེན་ཉིད་དུ་སྟོན་པ་དཔེར་ན་འབྲས་ཐུག་པོ་ཆེ་དང་ས་བོན་ལ་སོགས་པ་ལས་འབྲས་ཆན་དང་མྱུ་གུ་ལ་སོགས་པ་འབྱུང་པ་། ༎ ལས་། 
 01508 yathā taṇḍula-bīja-ādibhya odana-aṅkura-ādi-janmani dahana-udaka- 01509 pṛthivy-ādayaḥ,	མེ་དང་ཆུ་དང་ས་ལ་སོགས་པ་ལྟ་བུ་དེ་ལ་ནི་།
 tatra santāna-āśrayeṇa viśeṣa-utpādanaṃ pratyayānāṃ	རྒྱུ་ལ་བརྟེན་ནས་ཁྱད་པར་འབྱུང་བ་ལ་།
 01510 sahakriyā ucyate,	རྐྱེན་རྣམས་ཀྱི་ལྷན་ཅིག་བྱེད་པར་བཤད་ཀྱི་།
 na dravya-āśrayeṇa,	རྫས་ལ་བརྟེན་ནས་ནི་མ་ཡིན་ཏེ་།
 kṣaṇike dravye viśeṣa- 01511 anutpatteḥ;	རྫས་སྐད་ཅིག་པ་ལ་ཁྱད་པར་འབྱུང་བ་མེད་པའི་ཕྱིར་རོ་༎
 na hi taṇḍula-ādīnāṃ dahana-ādau krameṇa svabhāva-	འབྲས་ཐུག་པོ་ཆེ་ལ་སོགས་པ་མེ་ལ་སོགས་པ་ལ་རིམ་གྱིས་ངོ་བོ་ཉིད་ཁྱད་པར་གྱུར་པ་མི་འབྱུང་༄༢༤༥བ་ན་།
 01512 atiśaya-anutpattāv odana-ādi-siddhiḥ prabhāsvarād vā apavaraka-	འབྲས་ཆན་ལ་སོགས་པ་འགྲུབ་པའམ་།
 01513 praviṣṭa-indriyasya sva-upakāribhyaḥ santāna-viśeṣa-anutpattāv artha- 01514 pratipatti-janma| 01515 akṣepa-kāriṣu tv indriya-ādiṣu na viśeṣa-utpattiḥ parasparataḥ| 01516 tatra yathāsvaṃ pratyayaiḥ paraspara-upasarpaṇa-ādy-āśrayair ye	སྣང་བ་ནས་མུན་ཁང་དུ་ཞུགས་པའི་དབང་པོ་ལ་རང་གིས་ཕན་འདོགས་པ་དག་ལས་རྒྱུན་གྱི་ཁྱད་པར་མི་འབྱུང་ན་དོན་རྟོགས་པ་སྐྱེ་བ་མེད་དོ་༎ ཐོགས་པ་མེད་པར་སྐྱེད་པའི་དབང་པོ་ལ་སོགས་པ་ནི་། ཕན་ཚུན་ལས་ཁྱད་པར་འབྱུང་བ་མེད་དེ་།
 01517 yogya-deśa-ādy-avasthā jātāḥ, te saha svabhāva-niṣpattyā jñāna- 01518 hetutāṃ pratipadyanta iti tatra eka-arthakriyā eva sahakāritvam|	དེར་ནི་ཕན་ཚུན་ཉེ་བར་འགྲོ་བ་ལ་སོགས་པའི་རྟེན་བདག་ཉིད་ཇི་ལྟ་བའི་རྐྱེན་རྣམས་ཀྱིས་རུང་བའི་ཡུལ་ལ་སོགས་པར་གནས་པ་ཅན་སྐྱེད་པ་དེ་དག་ལྷན་ཅིག་ངོ་བོ་ཉིད་གྲུབ་པས་༎ ཤེས་པའི་རྐྱེན་ཉིད་དུ་ཤེས་པས་དོན་གཅིག་བྱེད་པ་ཁོ་ན་ལྷན་ཅིག་བྱེད་པ་ཉིད་ཡིན་༎ ནོ་༎ 
 01519 yatra viśeṣa-utpādanena sahakāriṇaḥ pratyayās tatra hetu-	གང་དུ་ཁྱད་པར་བསྐྱེད་པས་ལྷན་ཅིག་བྱེད་པ་རྣམས་རྐྱེན་ཉིད་པ་དེར་ནི་།
 01520 santānaḥ pratyayān apekṣata iti tataḥ svabhāva-antara-pratilambha-	རྒྱུའི་རྒྱུན་རྐྱེན་ལ་ལྟོས་པ་ཡིན་པས་། དེ་ལས་ངོ་བོ་ཉིད་གཞན་ཐོབ་བོ་ཞེས་བྱའོ་༎
 01521 ucyate| tatra sva-rasato hetu-pratyayānāṃ pūrva-kṣaṇa-nivṛttau	དེ་ལ་རྒྱུ་དང་རྐྱེན་རྣམས་ཀྱི་སྐད་ཅིག་མ་སྔ་མ་རང་གི་ངང་གིས་ལོག་ན་།
 01522 tebhya eva viśiṣṭa-kṣaṇa-utpādāt krameṇa yāvad atiśayavato	དེ་དག་ཁོ་ན་ལས་སྐད་ཅིག་མ་ཁྱད་པར་ཅན་འབྱུང་བའི་ཕྱིར་། རིམ་གྱིས་ཁྱད་པར་དུ་གྱུར་པ་དང་ལྡན་པ་རྒྱུའི་ཚོགས་ཐ་མ་ལས་འབྲས་བུའི་བར་དུ་འབྱུང་ངོ་༎ 
 01523 antya-kāraṇa-kalāpāt kāryasya utpattiḥ| 01601 sahakāriṇaḥ samutpanna-viśeṣāt kāraṇāt kārya-utpattau viśeṣasya	ལྷན་ཅིག་བྱེད་པ་ལས་ཡང་དག་པར་བྱུང་བའི་རྒྱུ་ལས་འབྲས་བུ་སྐྱེན་ནི་།
 01602 eva utpattir na yuktā| aviśiṣṭād viśeṣa-utpattau kāryasya api	ཁྱད་པར་ཉིད་དུ་འབྱུང་བར་མི་རུང་ངོ་༎ ཁྱད་པར་ཅན་མ་ཡིན་པ་ལས་ཁྱད་པར་སྐྱེ་ན་ནི་། འབྲས་བུ་ཡང་འགྱུར་ཏེ་།
 01603 syāt; paraspara-viśeṣa-utpādān apekṣiṇo api sahakāriṇaḥ kāryaṃ	ལྷན་ཅིག་བྱེད་པ་ཁྱད་པར་ཕན་ཚུན་འབྱུང་པ་ལ་མི་ལྟོས་པས་ཀྱང་འབྲས་བུ་སྐྱེད་པར་འགྱུར་རོ་༎ 
 01604 kurvīran| tena akṣaṇikānām api sahakāry-anapekṣāṇāṃ kāraṇatā	དེས་ན་སྐད་ཅིག་པ་མ་ཡིན་པ་ལྷན་ཅིག་བྱེད་པ་ལ་མི་ལྟོས་པ་རྣམས་ཀྱང་རྒྱུ་ཉིད་དུ་འགྱུར་ལ་། ལྟོས་པར་བྱ་བ་རྣམས་ལས་ངོ་བོ་ཉིད་ཁྱད་པར་དུ་གྱུར་པ་འབྱུང་བ་ནི་མེད་དོ་༎
 01605 syāt, apekṣaṇīyebhyaḥ svabhāva-atiśaya-utpattiś ca na syāt| atha 01606 sahakāriṇā kṛta-viśeṣa eva viśeṣa-utpādāv apy upatiṣṭheta; evam	འོན་ཏེ་ཁྱད་པར་འབྱུང་ན་ཡང་ལྷན་ཅིག་བྱེད་པས་བྱས་པའི་ཁྱད་པར་ཁོ་ན་ཉེ་བར་གནས་པར་འགྱུར་ཏེ་། དེ་ལྟ་ན་། ཐུག་པ་མེད་པར་འགྱུར་རོ་༎
 01607 anavasthā syāt| na ca sahakāriṇaḥ paraspara-kārya-utpāda-anuguṇa 01608 viśeṣa-utpādane nityaṃ yogya-avasthā yena eṣāṃ paraspara- 01609 kṛta-viśeṣo nitya-anuṣaktaḥ syāt,	ལྷན་ཅིག་བྱེད་པ་རྣམས་ནི་གང་གིས་ན་འདི་དག་ཕན་ཚུན་བྱས་པའི་ཁྱད་པར་དང་རྟག་ཏུ་རྗེས་སུ་འབྲེལ་བར་འགྱུར་བ་ཕན་ཚུན་ནས་འབྲས་བུ་སྐྱེ་བ་དང་། མཐུན་པའི་ཁྱད་པར་སྐྱེད་པར་རུང་བར་རྟག་ཏུ་གནས་པ་ཅན་ཡང་མ་ཡིན་ཏེ་།
 tad-upāya-apāyayoḥ kārya-vyakti-	དེ་ཡོད་པ་དང་མེད་པ་དག་གི་འབྲས་བུ་གསལ་བ་དང་། བྲལ་བ་མཐོང་བའི་ཕྱིར་རོ་༎
 01610 viraha-darśanāt| tena ādyo viśeṣaḥ sahakāribhyo nirupakārasya 01611 na utpadyata iti cet,	དེས་ན་ཁྱད་པར་དང་པོ་ནི་ལྷན་ཅིག་ཅིག་བྱེད་པ་དག་གིས་ཕན་མ་བཏགས་པ་ཡིན་པར་མི་འཐད་དོ་ཞེ་ན་།
 na asmākaṃ punaḥ punar vacane kaścid 01612 udvego bhavati;	ཁོ་བོ་ནི་ཡང་དང་ཡང་དུ་སྨྲ་བ་ལ་སྐྱོ་བ་འགའ་ཡང་མེད་དེ་།
 yady evam api lokasya nyāya-pratītir bhavati,	གལ་ཏེ་དེ་ལྟ་ན་ཡང་འཇིག་རྟེན་༄༢༤༦ཨ་༌་༎
 01613 hanta tarhy ucyatām| na viśeṣa-utpādanād eva sahakāriṇāṃ	གྱིས་རིགས་པ་གོ་བར་འགྱུར་བ་ལྟར་ན་ད་དུང་ཡང་སྨྲ་བར་བྱའོ་༎
 01614 sahakāritvāṃ yatas tad-abhāvād viśeṣa-janane sahakāriṇo na	ལྷན་ཅིག་བྱེད་པ་རྣམས་ནི་གང་གིས་ན་དེ་མེད་པའི་ཕྱིར་། ཁྱད་པར་སྐྱེད་པ་ལ་ལྷན་ཅིག་བྱེད་པ་དག་ཏུ་མི་འགྱུར་བ་ཁྱད་པར་སྐྱེད་པ་ཁོ་ནས་ལྷན་ཅིག་སྐྱེད་པ་ཉིད་ཡིན་པ་ཡང་མ་ཡིན་ནོ་༎ 
 01615 syuḥ| kiṃ tarhi| eka-arthakriyāyā api| sa api bhavet parasparato	འོ་ན་ཅི་ཞེ་ན་དོན་གཅིག་བྱེད་པས་ཀྱང་ཡིན་ནོ་༎
 01616 viśeṣa-rahitānām| atha bhavet,	གལ་ཏེ་ཕན་ཚུན་ནས་ཁྱད་པར་མེད་པ་རྣམས་ལ་དེ་ཡང་མེད་དོ་༎
 pṛthag api bhavet;	འོན་ཏེ་ཡོད་ན་ནི་སོ་སོ་ལ་ཡང་འགྱུར་རོ་༎
 tathā ca tad 01617 viśeṣa-bhāvi kāryam api kevalād bhavet iti cet,	དེ་ལྟ་ན་ནི་ཁྱད་པར་དེ་ལས་འབྱུང་བ་ཅན་གྱི་འབྲས་བུ་ཡང་འབའ་ཞིག་ལས་འབྱུང་བར་འགྱུར་རོ་ཞེ་ན་།
 pratikṣaṇam 01618 aparāparaiḥ pratyayair yathā bhāva-santāne viśeṣa-utpattir yogya-	སྐད་ཅིག་རེ་རེ་ལ་རྐྱེན་གཞན་དང་གཞན་དག་གིས་ཇི་ལྟར་དངོས་པོའི་རྒྱུ་ན་ལ་ཁྱད་པར་སྐྱེ་བ་དང་། 
 01619 deśatā-ādy-avasthā-viśeṣāṇāṃ ca kārya-karaṇaṃ teṣāṃ ca yata 01620 utpattiḥ pratyekaṃ ca sāmarthye api yathā kevalānām akriyā-	ཡུལ་རུང་བ་ཅན་ཉིད་ལ་སོགས་པའི་གནས་སྐབས་ཀྱི་བྱེ་བྲག་པ་དག་འབྲས་བུ་སྐྱེད་པ་དང་། དེ་དག་ཀྱང་གང་ལས་སྐྱེ་བ་དང་། སོ་སོར་ནུས་ཀྱང་ཇི་ལྟར་འབའ་ཞིག་གིས་མི་སྐྱེད་དེ་།
 01701 kartṛ-viśeṣasya pṛthagbhāva-abhāvāt kārya-dvaividhyaṃ ca sahakāri- 01702 sañjanita-viśeṣa-paraṃpara-utpatti-dharmakam anyac ca aṅkura-ādi-	བྱེད་པ་པོའི་ཁྱད་པར་སོ་སོ་ན་ཡོད་པ་མེད་པའི་ཕྱིར་དང་། འབྲས་བུ་རྣམ་པ་གཉིས་པོ་ལྷན་ཅིག་བྱེད་པས་སྐྱེད་པའི་ཁྱད་པར་བརྒྱུད་པ་ལས་བྱུང་བའི་ཆོས་ཅན་དང་། 
 01703 vad akṣepa-kāri-indriya-vijñāna-vac ca kārya-kāraṇayoḥ svabhāva-	གཞན་ཏེ་མྱུ་གུ་ལ་སོགས་པ་ལྟ་བུ་དང་། མི་སྡོད་པར་སྐྱེད་པའི་དབང་པོའི་རྣམ་པར་ཤེས་པ་ལྟ་བུ་སྟེ་། འབྲས་བུ་དང་། རྒྱུའི་ངོ་བོ་ཉིད་ཐ་དད་པའི་ཕྱིར་རོ་ཞེས་བྱ་བ་ཐམས་ཅད་བཤད་ཟིན་ཏོ་༎
 01704 bhedād iti sarvam uktam| tatra sahakāribhyaḥ santāna-upakāra- 01705 apekṣa-kārya-kāraṇa-janmani sahakāriṇām ādyo viśeṣaḥ sahakāri- 01706 kṛta-viśeṣa-janmā na bhavati anantara-kārya-vat,	དེ་ལ་ལྷན་ཅིག་བྱེད་པ་དག་ལས་རྒྱུན་གྱིས་ཕན་འདོགས་པ་ལ་ལྟོས་པའི་འབྲས་བུའི་རྒྱུ་སྐྱེ་བ་ལ་ལྷན་ཅིག་བྱེད་པའི་ཁྱད་པར་དང་པོ་ནི་ལྷན་ཅིག་བྱེད་པས་ཁྱབ་པའི་ཁྱད་པར་ལས་སྐྱེ་བ་ཅན་མ་ཡིན་ཏེ་། འབྲས་བུ་མཇུག་ཐོགས་ཅན་ལྟ་བུའོ་༎
 tat-prabhṛti ye 01707 viśeṣās te taj-janmānaḥ,	དེ་ཕན་ཆད་ཀྱི་ཁྱད་པར་གང་ཡིན་པ་དེ་དག་ནི་དེ་ལས་སྐྱེ་བ་ཅན་ཡིན་ཏེ་།
 tasya teṣāṃ ca tat-prakṛtitvād iti	དེ་དང་དེ་དག་ནི་དེའི་རང་བཞིན་ཅན་ཡིན་པའི་ཕྱིར་། ཐུག་པ་མེད་པ་མ་ཡིན་ནོ་༎
 01708 na anavasthā| tathā yady akṣaṇiko api bhāva ādya-viśeṣa-kāraṇa-vad 01709 ajanita-atiśayaḥ kāryaṃ kuryāt,	གལ་ཏེ་ཁྱད་པར་དང་པོའི་རྒྱུ་བཞིན་དུ་སྐད་ཅིག་པ་མ་ཡིན་པའི་དངོས་པོ་ཁྱད་པར་དུ་གྱུར་པ་མ་བསྐྱེད་པས་ཀྱང་འབྲས་བུ་བསྐྱེད་པར་འགྱུར་རོ་ཞེ་ན་།
 karotu nāma; so asya svabhāvo	བསྐྱེད་ལ་ནི་རག་སྟེ་།
 01710 yady akṣepa-kartṛ-dharmā, pṛthagbhāvasya sambhavāt kevalo 01711 api tathā syād ity uktam atat-svabhāvas tu tadā apy akāraka eva|	གལ་ཏེ་འདིའི་ངོ་བོ་ཉིད་དེ་མི་སྡོད་པར་སྐྱེད་པར་བྱེད་པའི་ཆོས་ཅན་ཞིག་ཡིན་ན་ནི་། སོ་སོ་ན་ཡོད་པ་སྲིད་པས་འབའ་ཞིག་གིས་ཀྱང་དེ་ལྟར་འགྱུར་རོ་ཞེས་བཤད་ཟིན་ཏོ་། ༎ དེའི་ངོ་བོ་ཉིད་མ་ཡིན་ན་ནི་དེའི་ཚེ་ཡང་སྐྱེད་པར་བྱེད་པ་མ་ཡིན་པ་། ༎ ཉིད་དོ་༎ 
 01712 tasmād akṣaṇikānāṃ kāraṇānāṃ na eka-arthakriyayā kaścit	དེ་ལྟ་བས་ན་སྐད་ཅིག་པ་མ་ཡིན་པའི་རྒྱུ་དག་ལས་། དོན་གཅིག་བྱེད་པས་འགའ་ཡང་ལྷན་༄༢༤༦བ་ཅིག་བྱེད་པ་ཉིད་དུ་ངེས་པ་མེད་དོ་༎
 01713 sahakāritva-niyamo na api santāna-upakāreṇa iti na tasya kaścit sahakārī;	རྒྱུན་གྱིས་ཕན་འདོགས་པས་ཀྱང་མ་ཡིན་པས་། དེའི་ལྷན་ཅིག་བྱེད་པ་འགའ་ཡང་མེད་དེ་།
 01714 tasmāt kevalo api kuryāt| prāyas tu saṃghāta-sthāyī bhāva-	དེའི་ཕྱིར་འབའ་ཞིག་གིས་ཀྱང་བསྐྱེད་པར་འགྱུར་རོ་༎ དངོས་པོའི་རྒྱུན་ཚོགས་པ་ལ་གནས་པ་ཅན་ནི་།
 01715 santānaḥ sahakāri-pratyayair upajanita-viśeṣaḥ sva-kāryaṃ kurvan 01716 dṛṣṭaḥ, bīja-ādi-vat| sthirahetuvādino pratyaya-apekṣāyāṃ kārakasya	ཕལ་ཆེར་ལྷན་ཅིག་བྱེད་པའི་རྐྱེན་གྱི་ཁྱད་བར་བསྐྱེད་པས་རང་གི་འབྲས་བུ་སྐྱེད་པ་མཐོང་སྟེ་། ས་བོན་ལ་སོགས་པ་བཞིན་ནོ་༎ རྒྱུ་རྟག་པར་སྨྲ་པའི་ལྟར་ན་རྐྱེན་ལ་ལྟོས་པ་ཡིན་ན་ནི་།
 01717 svabhāva-antarasya utpattir iti vyaktam;	སྐྱེད་པར་བྱེད་པའི་ངོ་བོ་ཉིད་གཞན་ཞིག་འབྱུང་ངོ་ཞེས་བྱ་བར་གསལ་བ་ཡིན་ཏེ་།
 kāryasya apekṣā ity	འབྲས་བུ་ལ་ལྟོས་པ་ཞེས་བྱའོ་༎
 01718 ucyate| kārakasya svabhāvasya prāg api bhāvo akriyā na yujyate|	སྐྱེད་པར་བྱེད་པའི་ངོ་བོ་ཉིད་སྔོན་ཡང་ཡོད་ན་ནི་། མི་བསྐྱེད་པ་མི་རུང་ངོ་༎
 01801 tasmād yo yad-ātmā sa sattā-mātreṇa tādṛśo bhavati;	དེ་ལྟ་བས་ན་གང་གི་བདག་ཉིད་གང་ཡིན་པ་དེ་ནི་། ཡོད་པ་ཙམ་གྱིས་དེ་ལྟ་བུར་འགྱུར་གྱི་།
 01802 na bhūtvā tad-bhāve para-abhisaṃskāram apekṣate| svabhāvato	གྱུར་ནས་ཡང་དེའི་དངོས་པོར་བྱ་བའི་ཕྱིར་གཞན་གྱིས་མངོན་པར་འདུ་བྱ་བ་ལ་ལྟོས་པ་ནི་མ་ཡིན་ནོ་༎ དངོས་པོ་ངོ་བོ་ཉིད་ཀྱིས་མི་གནས་པའི་ཆོས་ཅན་ལ་ནི་།
 01803 asthiti-dharmaṇo bhāvasya na kiṃcin nāśa-kāraṇaiḥ; sthiti-dharmaṇo	འཇིག་པའི་རྒྱུ་དག་ཅུང་ཟད་ཀྱང་མི་དགོས་སོ་༎ དངོས་པོ་གནས་པའི་ཆོས་ཅན་ལ་ཡང་སུས་ཀྱང་ངོ་བོ་ཉིད་གཞན་དུ་བྱ་བར་མི་ནུས་པའི་ཕྱིར་། 
 01804 api bhāvasya nāśa-kāraṇaiḥ kim, svabhāvasya kenacid anyathā	འཇིག་པའི་རྒྱུ་དག་གིས་ཅི་ཞིག་བྱ་།
 01805 kartum aśakyatvāt| anyathātva-pratipattau vā tat-svabhāva eva 01806 na syād iti pūrva eva vikalpaḥ, tatra ca uktam| yaś ca parasmād	འོན་ཏེ་གཞན་ཉིད་དུ་འགྱུར་ན་ནི་དེའི་ངོ་བོ་ཉིད་ཁོ་ནར་མི་འགྱུར་བས་བརྟག་པ་སྔ་མར་ཟད་དེ་དེ་ལ་ཡང་བཤད་ཟིན་ཏོ་༎
 01807 anyathābhāvaḥ so aparaḥ svabhāvaḥ yaś ca aparaḥ sa kathaṃ	ཕ་རོལ་ལས་གཞན་དུ་འགྱུར་བ་གང་ཡིན་པ་དེ་ནི་། གཞན་གྱི་ངོ་བོ་ཉིད་ཡིན་ལ་། གང་ཞིག་གཞན་ཡིན་པ་དེ་ཇི་ལྟར་དེའི་ཡིན་ཏེ་།
 01808 tasya, svabhāva-bheda-lakṣaṇatvād bhāva-bhedasya| tathā ca pūrvako	དངོས་པོ་ཐ་དད་པ་ནི་ངོ་བོ་ཉིད་ཐ་དད་པའི་མཚན་ཉིད་ཡིན་པའི་ཕྱིར་རོ་༎
 01809 bhāvo acyuti-dharme sthita iti na tasya anyathābhāvaḥ|	དེ་ལྟ་ན་དངོས་པོ་སྔ་མ་འཕོ་བ་མེད་པའི་ཆོས་ལ་གནས་པས་དེས་གཞན་དུ་འགྱུར་བ་མེད་དོ་༎ 
 01810 etena kaṭhina-ādīnāṃ tāmra-ādīnām agny-ādibhyo drava-ādi-	འདིས་ནི་ཟངས་ལ་སོགས་པའི་སྲ་བ་ལ་སོགས་པ་མེ་ལ་སོགས་པ་ལས་སྙི་བ་ལ་སོགས་པའི་ངོ་བོ་ཉིད་གཞན་དུ་འགྱུར་བ་བསལ་བ་ཡིན་ཏེ་།
 01811 svabhāva-antara-utpattiḥ pratyuktā| tatra api pūrvakasya sva-rasa-nirodhitvād	དེ་ལ་ཡང་སྔ་མ་རང་གི་ངང་གིས་འཇིག་པ་ཅན་ཡིན་པའི་ཕྱིར་ཞིག་ན་།
 01812 vināśe agny-āder upādānāc ca apara eva drava-ādi-svabhāva- 01813 utpannaḥ|	མེ་ལ་སོགས་པ་དང་། ཉེ་བར་ལེན་པ་ལས་སྙི་བ་ལ་སོགས་པའི་ངོ་བོ་ཉིད་གཞན་ཁོ་ན་ཞིག་འབྱུང་བ་ཡིན་ནོ་༎ 
 01814 sa svayaṃ sthiti-dharmā eva,	དེ་ནི་རང་གིས་གནས་པའི་ཆོས་ཅན་ཁོ་ན་ཡིན་ཏེ་།
 vināśa-hetv-asambhave avasthānāt|	འཇིག་པའི་རྒྱུ་མི་སྲིད་ན་གནས་པའི་ཕྱིར་རོ་༎
 01815 tasya parasmād vināśaḥ, na ca vināśo nāma aparaḥ svabhāvaḥ,	དེ་ནི་གཞན་གྱིས་འཇིག་ལ་འཇིག་པ་ཞེས་བྱ་བ་ངོ་བོ་ཉིད་གཞན་ཡང་མེད་དེ་།
 01816 bhāva-cyutir eva vināśa iti cet,	དངོས་པོ་འཕོ་བ་ཁོ་ན་འཇིག་པ་ཡིན་ནོ་ཞེ་ན་།
 na idam uttaraṃ vikalpa-	ལན་འདི་ནི་རྣམ་པར་བརྟག་པ་གཉིས་༄༢༤༧ཨ་༌་༎
 01817 dvayam atikrāmati| kiṃ nityo bhāvaḥ svabhāvena āhosvid anityo iti	ལས་མི་འདའོ་༎ ཅི་དངོས་པོ་ངོ་བོ་ཉིད་ཀྱིས་བརྟག་པ་ཞིག་གམ་མི་རྟག་པ་ཞིག་ཅེས་བརྟག་པར་བྱ་བ་ལ་། 
 01818 vikalpe prāṅ nityo bhūtvā paścād anityo bhavati iti bruvāṇaḥ	སྔར་རྟག་པར་གྱུར་ནས་ཕྱིས་མི་རྟག་པར་འགྱུར་རོ་ཞེས་སྨྲ་ན་ནི་།
 01819 prāktanasya nitya-abhimatasya sarvadā nitya-anitya-svabhāva-bhedaṃ 01820 bhāva-dvayaṃ ca svayaṃ ca nāśam anāśaṃ ca prāha iti	རྟག་པར་འདོད་པ་སྔ་མ་ཐམས་ཅད་དུ་རྟག་པ་དང་མི་རྟག་པའི་ངོ་བོ་ཉིད་ཐ་དད་པ་ཅན་གྱི་དངོས་པོ་གཉིས་དང་། རང་གིས་འཇིག་པ་དང་། མི་འཇིག་པར་རབ་ཏུ་སྨྲ་བ་ཡིན་ཏེ་།
 01821 pūrvasmin vināśa-hetur asamarthaḥ| na prāṅ nityo bhūtvā paścād	དེ་ལྟར་ན་སྔ་མ་ལ་འཇིག་པའི་རྒྱུ་ནུས་པ་མེད་དོ་༎ སྔར་རྟག་པར་གྱུར་ནས་ཕྱིས་མི་རྟག་པར་འགྱུར་བ་ནི་མ་ཡིན་ནོ་༎
 01822 anityo bhavati| kiṃ tarhi| paścād api nityo eva,	འོ་ན་ཅི་ཞེ་ན་། ཕྱིས་ཀྱང་རྟག་པ་ཁོ་ན་ཡིན་ཏེ་།
 eka-svabhāvatvāt|	ངོ་བོ་ཉིད་གཅིག་པའི་ཕྱིར་རོ་༎
 01823 sa tarhi bhāvaḥ svabhāvena nāśam anāviśan kathaṃ naṣṭo	འོ་ན་དངོས་པོ་དེ་ངོ་བོ་ཉིད་ཀྱིས་འཇིག་པ་དང་མ་འབྲེལ་ན་འཇིག་པ་ཞེས་བྱ་བ་ཇི་ལྟ་བུ་ཡིན་ཏེ་།
 01901 nāma, tat-svabhāva-vināśayor aparaspara-rūpatvāt|	དེའི་ངོ་བོ་ཉིད་དང་འཇིག་པ་དག་ནི་ཕན་ཚུན་གྱི་ངོ་བོ་ཅན་མ་ཡིན་པ་ཉིད་ཀྱི་ཕྱིར་རོ་༎ 
 01902 tasmāt saty asya vināśe vināśa-svabhāvena anena bhavitavyam|	དེ་ལྟ་བས་ན་འདི་ལ་འཇིག་པ་ཡོད་པ་དང་། འདི་འཇིག་པའི་ངོ་བོ་ཉིད་དུ་འགྱུར་དགོས་ཏེ་།
 01903 tathā api vyartho vināśa-hetur ity uktam| tena svabhāvato	དེ་ལྟ་ན་ཡང་འཇིག་པའི་རྒྱུ་དོན་མེད་དོ་ཞེས་བཤད་ཟིན་ཏོ་༎ དེས་ན་དངོས་པོའི་ངོ་བོ་ཉིད་ཀྱིས་འཇིག་པ་ཡིན་ཡང་རུང་།
 01904 naśvare anaśvare vā bhāve na vināśa-hetor upayogaḥ|	མི་འཇིག་པ་ཡིན་ཡང་རུང་སྟེ་། འཇིག་པའི་རྒྱུ་དགོས་པ་མེད་དོ་༎
 01905 tasmād vināśe anapekṣo bhāvas tad-bhāva-niyata iti yaḥ 01906 san sa vināśī,	དེ་ལྟ་བས་ན་དངོས་པོ་འཇིག་པ་ལ་ལྟོས་པ་མེད་པས་དེའི་ངོ་བོར་ངེས་པ་ཡིན་ནོ་༎ ཡོད་པ་གང་ཡིན་པ་དེ་ནི་འཇིག་པ་ཡིན་ལ་།
 nāśvaratāyā nivṛttau ca sattva-nivṛttir ity 01907 anvaya-vyatireka-siddhiḥ|	འཇིག་པ་ལོག་ན་ཡོད་པ་ལྡོག་པས་རྗེས་སུ་འགྲོ་བ་དང་ལྡོག་པ་གྲུབ་པའོ་༎
 01908 svabhāvato naśvaratve api kaścid atat-svabhāvo api syāt, na	གལ་ཏེ་ངོ་བོ་ཉིད་ཀྱིས་འཇིག་པ་ཉིད་ཡིན་ན་ཡང་། ལ་ལ་དེའི་ངོ་བོ་ཉིད་མ་ཡིན་པར་ཡང་འགྱུར་ཏེ་།
 01909 hi sarvaḥ sarvasya svabhāva iti na anvaya-vyatireka-siddhir iti cet,	ཐམས་ཅད་ཀྱི་ངོ་བོ་ཉིད་ཐམས་ཅད་ཡིན་པ་ནི་མེད་པས་རྗེས་སུ་འགྲོ་བ་དང་། ལྡོག་པ་མ་གྲུབ་པོ་ཞེ་ན་།
 01910 na, akṣaṇikatve avastutva-prasaṅgāt| śaktir hi bhāva-lakṣaṇam,	མ་ཡིན་ཏེ་། སྐད་ཅིག་པ་ཉིད་མ་ཡིན་ན་དངོས་པོ་མེད་པ་ཉིད་དུ་ཐལ་བར་འགྱུར་བའི་ཕྱིར་རོ་༎ དངོས་པོའི་མཚན་ཉིད་ནི་ནུས་པ་ཡིན་ནོ་༎
 01911 sarva-śakti-viraho abhāva-lakṣaṇam| na ca akṣaṇya kvacit kācic	ནུས་པ་ཐམས་ཅད་བྲལ་བ་ནི་དངོས་པོ་མེད་པའི་མཚན་ཉིད་ཡིན་ནོ་༎
 01912 śaktiḥ, kramayaugapadyābhyām arthakriyā-virahāt| tasmād yat	སྐད་ཅིག་པ་མ་ཡིན་པ་ནི་འགའ་ཡང་གང་དུ་ནུས་པ་མེད་དེ་རིམ་དང་ཅིག་ཅར་དག་གིས་དོན་བྱེད་པར་འགལ་བའི་ཕྱིར་རོ་༎
 01913 sat tat kṣaṇikam eva iti vyāpti-siddhiḥ| 01914 arthāntare gamye kārye kāryaṃ hetuḥ, avyabhicārāt| 01915 kāryakāraṇabhāvena yadi liṅgasya gamakatvam, sarvathā	དེ་ལྟ་བས་ན་གང་ཡོད་པ་དེ་ནི་སྐད་ཅིག་པ་ཁོ་ན་ཡིན་པས་ཁྱབ་པ་གྲུབ་བོ་༎ དོན་གཞན་ཤེས་པར་བྱ་བ་ལ་འབྲས་བུ་གཏན་ཚིགས་ཡིན་ཏེ་འཁྲུལ་པ་མེད་པའི་ཕྱིར་རོ་༎ ༎ གལ་ཏེ་རྒྱུ་དང་འབྲས་བུའི་དངོས་པོ་རྟགས་ཤེས་པར་བྱེད་པ་ཉིད་ཡིན་ན་། རྣམ་པ་ཐམས་ཅད་དུ་ཤེས་པར་བྱ་༄༢༤༧བ་བ་དང་། ཤེས་པར་བྱེད་པའི་དངོས་པོ་ཡིན་ཏེ་།
 01916 gamyagamakabhāvaḥ| sarvathā janyajanakabhāvād iti cet,	རྣམ་པ་ཐམས་ཅད་དུ་བསྐྱེད་པར་བྱ་བ་དང་། སྐྱེད་པར་བྱེད་པའི་དངོས་པོ་ཡིན་པའི་ཕྱིར་རོ་ཞེ་ན་།
 01917 na, tad-abhāve bhavataḥ tadupatti-niyama-abhāvāt| tasmāt	མ་ཡིན་ཏེ་དེ་མེད་པར་འབྱུང་བ་ནི་དེ་ལས་འབྱུང་བ་ངེས་པ་མེད་པའི་ཕྱིར་རོ་༎
 01918 kāryaṃ svabhāvair yāvadbhir avinābhāvi kāraṇe, teṣāṃ	དེ་ལྟ་བས་ན་རྒྱུའི་ངོ་བོ་ཉིད་ཇི་སྙེད་གཅིག་མེད་པར་འབྲས་བུ་མི་འབྱུང་བ་དེ་དག་རྒྱུ་ཡིན་ཏེ་། 
 01919 hetuḥ, tat-kāryatva-niyamāt,	དེའི་འབྲས་བུ་ཉིད་དུ་ངེས་པའི་ཕྱིར་རོ་༎
 tair eva ca dharmair ye tair	གང་དག་དེ་དག་མེད་ན་མི་འབྱུང་བའི་ཆོས་དེ་དག་ཉིད་ཀྱིས་སོ་༎
 01920 vinā na bhavanti| aṃśena janyajanakatva-prasaṅga iti cet, na,	གལ་ཏེ་ཆ་ཤས་ཀྱིས་བསྐྱེད་པར་བྱ་བ་དང་། སྐྱེད་པར་བྱེད་པ་ཉིད་དུ་ཐལ་བར་འགྱུར་རོ་ཞེ་ན་།
 01921 taj-janya-viśeṣa-grahaṇe abhimatatvāl liṅga-viśeṣa-upādhīnāṃ ca sāmānyānām|	མ་ཡིན་ཏེ་དེས་བསྐྱེད་པར་བྱ་བའི་ཁྱད་པར་དང་། རྟགས་ཀྱི་ཁྱད་པར་གྱི་བྱེ་བྲག་ཅན་གྱི་སྤྱི་རྣམས་འཛིན་ན་། འདོད་པའི་ཕྱིར་རོ་༎
 02001 aviśiṣṭa-sāmānya-vivakṣāyāṃ vyabhicārān na iṣyate|	ཁྱད་པར་ཅན་མ་ཡིན་པའི་སྤྱིའི་བརྗོད་པར་འདོད་ན་། འཁྲུལ་པའི་ཕྱིར་མི་འདོད་དོ་༎
 02002 kasyacit kadācit kutaścit bhāve api sarvas tādṛśas tathāvidha-	གལ་ཏེ་འགའ་ཞིག་རེས་འགའ་ཞིག་ལས་འབྱུང་ཡང་དེ་དང་འདྲ་བ་ཐམས་ཅད་དེ་ལས་སྐྱེའོ་ཞེས་བྱ་བ་གོ་ག་ལས་།
 02003 janmā iti kuto avasitam| tathā ca na anvaya-vyatirekāv iti cet,	དེ་ལྟ་ན་རྗེས་སུ་འགྲོ་བ་དང་། ལྡོག་པ་ནི་མ་ཡིན་ནོ་ཞེ་ན་། མ་ཡིན་ཏེ་། དེ་ལས་འབྱུང་བ་ཅན་མ་ཡིན་པ་དེ་ནི་།
 02004 na, atad-bhāvinas tasya sakṛd api tato abhāvāt| paraspara-apekṣayā	ལན་འགའ་ཡང་དེ་ལས་མི་འབྱུང་བའི་ཕྱིར་ཏེ་།
 02005 janya-janaka-svabhāva-lakṣaṇe kārya-kāraṇe| tatra yadi	ཕན་ཚུན་ལྟོས་པས་བསྐྱེད་པར་བྱ་བ་དང་། སྐྱེད་པར་བྱེད་པའི་ངོ་བོ་ཉིད་ཀྱི་མཚན་ཉིད་ཅན་གྱི་འབྲས་བུ་དག་ཡིན་ནོ་༎
 02006 dhūmo agny-ādi-sāmagryā anyato api bhavet,	དེ་ལ་གལ་ཏེ་དུ་བ་མེ་ལ་སོགས་པའི་ཚོགས་པ་ལས་གཞན་པ་ལས་ཀྱང་འབྱུང་བར་འགྱུར་ན་། 
 tasya taj-janyaḥ	དེ་ནི་དེས་བསྐྱེད་པར་བྱ་བའི་ངོ་བོ་ཉིད་མ་ཡིན་པས་།
 02007 svabhāvo na bhavati iti sakṛd api tato na bhaved arthāntara-vat,	ལན་འགའ་ཡང་འབྱུང་བར་མི་འགྱུར་ཏེ་། དོན་གཞན་བཞིན་ནོ་༎
 02008 na api sāmagrī taṃ janayet,	ཚོགས་པས་ཀྱང་དེ་སྐྱེད་པར་མི་འགྱུར་ཏེ་།
 ataj-janana-svabhāvatvāt sāmagry-antara- 02009 vat| na ca dhūmasya tad-ataj-janya-svabhāvo yuktaḥ,	དེ་སྐྱེད་པའི་ངོ་བོ་ཉིད་མ་ཡིན་པའི་ཕྱིར་ཚོགས་པ་གཞན་བཞིན་ནོ་༎ དུ་བ་ནི་དེ་དང་དེ་མ་ཡིན་པས་བསྐྱེད་པར་བྱ་བའི་ངོ་བོ་ཉིད་དུ་ཡང་རིགས་པ་མ་ཡིན་ཏེ་། 
 02010 eka-svabhāvatvāt| dhūma-adhūma-janana-svabhāvād bhavato dhūma- 02011 adhūma-svabhāvaḥ syāt,	ངོ་བོ་ཉིད་གཅིག་པའི་ཕྱིར་རོ་༎ དུ་བ་དང་དུ་བ་མ་ཡིན་པ་བསྐྱེད་པའི་ངོ་བོ་ཉིད་ལས་འབྱུང་ན་ནི་། དུ་བ་དང་དུ་བ་མ་ཡིན་པའི་ངོ་བོ་ཉིད་དུ་འགྱུར་ཏེ་།
 kārya-svabhāvānāṃ kāraṇa-svabhāva-kṛtatvād	འབྲས་བུའི་ངོ་བོ་ཉིད་རྣམས་ནི་རྒྱུའི་ངོ་བོ་ཉིད་ཀྱིས་བྱས་པའི་ཕྱིར་རོ་༎
 02012 akāraṇa-apekṣaṇe ca ahetutva-prasaṅgāt| tasmād yo	རྒྱུ་ལ་མི་ལྟོས་ན་ཡང་རྒྱུ་མེད་པ་ཉིད་ཐལ་བར་འགྱུར་བའི་ཕྱིར་རོ་༎
 02013 dhūma-jananaḥ,	དེ་ལྟ་བས་ན་དུ་བ་སྐྱེད་པར་བྱེད་པ་གང་ཡིན་པ་དེ་ནི་།
 so agny-ādi-sāmagrī-viśeṣaḥ yo agny-ādy-sāmagrī- 02014 viśeṣa-janitaḥ so dhūma iti kārya-kāraṇayor evaṃ svabhāva-niyamāt 02015 tad vijātīyād utpattir na bhavati| tat kāryaṃ kāraṇaṃ	མེ་ལ་སོགས་པའི་ཚོགས་པའི་ཁྱད་པར་ཡིན་ལ་མེ་ལ་སོགས་པའི་ཚོགས་པའི་ཁྱད་པར་གྱིས་བསྐྱེད་པ་གང་ཡིན་པ་དེ་ནི་དུ་བ་ཡིན་ཏེ་། དེ་ལྟར་ན་རྒྱུ་དང་འབྲས་བུ་དག་གི་ངོ་བོ་ཉིད་ངེས་པའི་ཕྱིར་རིགས་མི་མཐུན་པ་ལས་བྱུང་བ་མ་ཡིན་ནོ་། དེ་ལྟ་༄༢༤༨ཨ་༌་༎ བས་ན་འབྲས་བུས་རྒྱུ་འཁྲུལ་པ་མེད་དོ་༎
 02016 na vyabhicarati| tena siddhe kāryakāraṇabhāve kāryasya 02017 kāraṇena vyāptiḥ siddhā bhavati|	དེས་རྒྱུ་དང་འབྲས་བུའི་དངོས་པོ་གྲུབ་ན་འབྲས་བུ་ལ་རྒྱུས་ཁྱབ་པར་གྲུབ་པ་ཡིན་ནོ་༎
 02018 nanu vijātīyād api kiṃcid bhavad dṛṣṭam, tad yathā	རིགས་མི་མཐུན་པ་ལས་ཀྱང་ཅུང་ཟད་འབྱུང་བ་མཐོང་སྟེ་།
 02019 gomaya-ādeḥ śālūka-ādiḥ| na vijātīyād utpattiḥ| tathāvidham	དཔེར་ན་པ་ལང་གི་ལྕི་བ་ལ་སོགས་པ་ལས་ཤ་ལའུ་ཀ་ལ་སོགས་པ་ལྟ་བུ་མ་ཡིན་ནམ་ཞེ་ན་། རིགས་མི་མཐུན་པ་ལས་འབྱུང་བ་ནི་མ་ཡིན་ཏེ་།
 02020 eva hi tādṛśām ādi-nimittam iti na kāraṇa-bhedaḥ| prabandhena	དེ་ལྟ་བུ་ཁོ་ན་དེ་འདྲ་བའི་དང་པོའི་རྒྱུ་མཚན་ཡིན་པས་། རྒྱུ་ཐ་དད་པ་མ་ཡིན་ནོ་༎ རྒྱུན་གྱིས་འབྱུང་ན་ནི་། འདམ་བུ་ལས་འབྱུང་ངོ་༎
 02101 vṛttau tu śarād bhavati| asti ca gomaya-itara-janman-svabhāva- 02102 bhedo rūpasya abhede api,	ཡང་ན་བ་ལང་གི་ལྕི་བ་དང་། ཅིག་ཤོས་སྐྱེ་བ་ཅན་དག་གཟུགས་ཐ་མི་དད་ཀྱང་ངོ་བོ་ཐ་དད་པ་ཡོད་དོ་༎
 na hy ākāra-tulyatā eva bhāvānāṃ 02103 tattve nimittam,	དངོས་པོ་རྣམས་ཀྱི་རྣམ་པ་མཚུངས་པ་ཁོ་ན་ནི་དེ་ཉིད་ཀྱི་རྒྱུ་མ་ཡིན་ཏེ་།
 abhinna-ākārāṇām api keṣāṃcid anyato viśeṣāj	རྣམ་པ་ཐ་དད་པ་མ་ཡིན་པ་རྣམས་ཀྱང་ཁ་ཅིག་ཁྱད་པར་གཞན་གྱི་སྒོ་ནས་རིགས་ཐ་དད་པ་མཐོང་བའི་ཕྱིར་རོ་༎ དེ་ལྟ་མ་ཡིན་ཏེ་།
 02104 jāti-bheda-darśanāt| anyathā hi vilakṣaṇāyā api sāmagryā 02105 avilakṣaṇa-kārya-utpattau ca kāraṇa-bheda-abhedābhyāṃ kārya-bheda-	ཚོགས་པ་མཚན་ཉིད་མི་འདྲ་བ་ལས་ཀྱང་མཚན་ཉིད་མི་འདྲ་བ་མ་ཡིན་པ་འབྱུང་ན་ནི་། རྒྱུའི་ཐ་དད་པ་དང་ཐ་དད་པ་མ་ཡིན་པ་དག་ལས་འབྲས་བུའི་ཐ་དད་པ་དང་། ། ཐ་དད་པ་མ་ཡིན་པ་དག་མ་ཡིན་པས་།
 02106 abhedāv ity ahetukau viśvasya bheda-abhedau syātām| tathā	ཐམས་ཅད་ཀྱི་ཐ་དད་པ་དང་། ཐ་དད་པ་མ་ཡིན་པ་དག་རྒྱུ་མེད་པར་འགྱུར་ཏེ་།
 02107 hi na bhedād bheda ity abhedād api na abhedaḥ, tad-vyatiriktaś	འདི་ལྟར་ཐ་དད་པ་ལས་ཐ་དད་པ་མ་ཡིན་པ་ལས་ཀྱང་ཐ་དད་པ་མ་ཡིན་ནོ་༎ དེ་མ་གཏོགས་པའི་དངོས་པོའི་ངོ་བོ་ཉིད་ཀྱང་འགའ་ཡང་མེད་པས་།
 02108 ca na kaścid bhāva-svabhāva ity ahetukatvād bhāvānāṃ nityaṃ 02109 sattvam asattvaṃ vā syāt,	དངོས་པོ་རྣམས་རྒྱུ་མེད་པ་ཅན་མ་ཡིན་པའི་ཕྱིར་རྟག་ཏུ་ཡོད་པའམ་། མེད་པ་ཞིག་ཏུ་འགྱུར་ཏེ་།
 apekṣyasya abhāvāt| apekṣayā hi	ལྟོས་པར་བྱ་བ་མེད་པའི་ཕྱིར་རོ་༎
 02110 bhāvāḥ kādācitkā bhavanti vyavasthāvāṃś ca sādhyeṣu	དངོས་པོ་རྣམས་ནི་ལྟོས་པའི་ཕྱིར་རེས་འགའ་བ་ཡིན་ནོ་༎
 02111 sādhana-niyogo na syāt| kāraṇa-śakti-pratiniyame hi kiṃcid eva 02112 kasyacit sādhanāya upādīyeta,	བསྒྲུབ་པར་བྱ་བ་དག་ལ་སྒྲུབ་པ་ཉེ་བར་སྦྱོར་བ་རྣམ་པར་གནས་པ་དང་ལྡན་པར་ཡང་མི་འགྱུར་ཏེ་། རྒྱུའི་ནུས་པ་སོ་སོར་ངེས་ན་འགའ་ཞིག་འགའ་སྒྲུབ་པར་བྱེད་པར་གཟུང་གི་གཞན་ནི་མ་ཡིན་ནོ་༎
 na aparam, tasya eva tatra śakter	དེ་ཁོ་ན་དེ་ལ་ནུས་པའི་ཕྱིར་ལ་།
 02113 anyasya ca aśakteḥ,	གཞན་ནི་མི་ནུས་པའི་ཕྱིར་ཏེ་།
 tayos taj-janana-itara-svabhāvatvena bhedāt|	དེ་གཉིས་ནི་བསྐྱེད་པ་དང་ཅིག་ཤོས་ཀྱི་ངོ་བོ་ཉིད་ཀྱིས་ཐ་དད་པའི་ཕྱིར་རོ་༎
 02114 taj-janana-svabhāva-vilakṣaṇād api tasya utpattau na taj-janana- 02115 śakti-niyame iti yat-yataḥ-kutaścit syāt, taj-janana-	དེ་བསྐྱེད་པའི་ངོ་བོ་ཉིད་དང་མཚན་ཉིད་མི་འདྲ་བ་ལས་ཀྱང་དེ་འབྱུང་ན་ནི་དེ་བསྐྱེད་པར་ནུས་ན་ངེས་པ་མེད་པས་ཅི་ཡང་རུང་སྟེ་། གང་ཡང་རུང་བ་ལས་འབྱུང་བར་འགྱུར་རོ་༎
 02116 śakti-sāmye tu tad eva iti na kāryaṃ dṛṣṭaṃ kāraṇaṃ vyabhicarati|	དེ་བསྐྱེད་ནུས་པར་མཚུངས་ན་ནི་དེ་ཉིད་ཡིན་པས་འབྲས་བུ་རྒྱུ་འཁྲུལ་པ་མ་མཐོང་ངོ་༎
 02118 upalabdhi-lakṣaṇa-prāptasya anupalabdhir abhāva-hetur abhāva- 02119 vyavahāra-hetur vā|	དམིགས་པའི་རིག་བྱར་གྱུར་པ་མི་དམིགས་པ་ནི་། དངོས་པོ་མེད་༄༢༤༨བ་པར་ཐ་སྙད་གདགས་པའི་གཏན་ཚིགས་ཡིན་ནོ་༎ དེ་ལ་དམིགས་པ་དམིགས་པར་བྱེད་པའི་ཆོས་ཉིན་ན་ནི་།
 02120 atra upalabdher upalabhamāna-dharmatve taj-jñānam upalabdhiḥ|	དེའི་ཤེས་པ་དམིགས་པ་ཡིན་ནོ་༎ བརྗོད་པར་འདོད་པའི་དམིགས་པ་ལས་གཞན་ཡིན་པའི་ཕྱིར་།
 02121 tasmād anya-upalabdhir anupalabdhiḥ, vivakṣita-upalabdher	དེ་ལས་གཞན་པའི་དམིགས་པ་ནི་མི་དམིགས་པ་ཡིན་ཏེ་།
 02122 anyatvād abhakṣya-asparśanīya-vat paryudāsa-vṛttyā| upalabhyamāna-	མ་ཡིན་པར་འཇུག་པས་བཟར་མི་རུང་བ་དང་རེག་ཏུ་མི་རུང་བ་བཞིན་ནོ་༎ དམིགས་པར་བྱ་བའི་ཆོས་ཉིད་ཡིན་ན་ནི་།
 02123 dharmatve sva-viṣaya-vijñāna-janana-yogyatā-lakṣaṇo viṣaya- 02201 svabhāva upalabdhiḥ,	དམིགས་པ་ཡུལ་གྱི་ངོ་བོ་ཉིད་རང་གི་ཡུལ་ཅན་གྱི་ཤེས་པ་སྐྱེད་པར་རུང་བ་ཉིད་ཀྱི་མཚན་ཉིད་ཅན་ཡིན་ཏེ་།
 yogyatāyā bhāva-rūpatvāt| tasmād anya-upalabdhi- 02202 yogyatā eva anupalabdhiḥ pūrvavat| yatra yasminn upalabhyamāne	རུང་བ་ཉིད་ནི་དངོས་པོའི་ངོ་བོ་ཡིན་པའི་ཕྱིར་རོ་༎ དེ་ལས་གཞན་པའི་དམིགས་པར་རུང་པ་ཁོ་ན་ཉིད་མི་དམིགས་པ་སྟེ་། སྔ་མ་བཞིན་ནོ་༎ རུང་པ་ཉིད་དུ་ཁྱད་པར་མེད་པའི་ཕྱིར་། གང་དུ་གང་ཞིག་དམིགས་ན་།
 02203 niyamena yasya upalabdhir bhavati yogyatāyā aviśeṣāt, 02204 sa tat-saṃsṛṣṭaḥ,	གང་ཞིག་ངེས་པར་དམིགས་པར་འགྱུར་བ་དེ་ནི་དེ་དང་འབྲེལ་པ་ཡིན་ཏེ་།
 eka-jñāna-saṃsargāt| tayoḥ sator na eka-rūpa-	ཤེས་པ་གཅིག་དང་འབྲེལ་པའི་ཕྱིར་རོ་༎ དེ་གཉིས་ཡོད་ན་ངོ་བོ་གཅིག་ངེས་པར་གཏོགས་པ་མ་ཡིན་ཏེ་། མི་སྲིད་པའི་ཕྱིར་རོ་༎
 02205 niyatā pratipattiḥ, asambhavāt| tasmād aviśiṣṭa-yogyatā-rūpayor 02206 eka-jñāna-saṃsargiṇoḥ paraspara-apekṣam eva anyatvam iha abhipretam,	དེ་ལྟ་བས་ན་འདིར་གཞན་ཉིད་ནི་རུང་བ་ཉིད་ཀྱི་ངོ་བོ་ཁྱད་པར་མེད་པ་ཅན་ཤེས་པ་དང་འབྲེལ་པ་ཅན་དག་ཕན་ཚུན་ལྟོས་པ་ཁོ་ན་ཡིན་པར་འདོད་དོ་༎
 02207 pratyāsatter āśrayaṇāt| sa kevalaḥ tad-apekṣayā	དེ་འབའ་ཞིག་དེ་ལ་ལྟོས་ནས་གཞན་ཡིན་པས་།
 02208 tad-anya iti taj-jñānaṃ tat-svabhāvo vā jñātṛ-jñeya-dharma-	དེའི་ངོ་བོ་ཉིད་དེ་ཤེས་པར་བྱེད་པའམ་།
 02209 lakṣaṇa-anupalabdhiḥ| sā abhāvaṃ pratiyogino abhāva-vyavahāraṃ 02210 vā sādhayati|	ཤེས་པར་བྱ་བའི་ཆོས་ཀྱི་མཚན་ཉིད་ནི་མི་དམིགས་པ་ཡིན་ཏེ་། དེ་ནི་ཟླ་བོ་དངོས་པོ་མེད་པའམ་། དངོས་པོ་མེད་པར་ཐ་སྙད་གདགས་པར་སྒྲུབ་པ་ཡིན་ནོ་༎
 02211 katham anyabhāvas tad-abhāvaḥ,	ཇི་ལྟར་ན་གཞན་ཡོད་པ་དེ་མེད་པ་ཡིན་།
 yena abhāva-rūpa-anupalabdhir 02212 abhāva-vyavahāraṃ sādhayed iti cet,	གང་གིས་ན་དངོས་པོ་མེད་པའི་ངོ་བོའི་མི་དམིགས་པས་དངོས་པོ་མེད་པར་ཐ་སྙད་གདགས་པ་སྒྲུབ་པར་བྱེད་ཅེ་ན་།
 uktam atra yathā paryudāsa- 02213 vṛttyā apekṣāto abhāvo anupalabdhiś ca anupalabdhiḥ| na pratiṣedha- 02214 mātram, tasya sādhana-asiddher abhāva-vyavahāra-asiddhi-	འདིར་ཅི་ལྟར་མ་ཡིན་པར་འཇུག་པ་ལ་ལྟོས་པའི་སྒོ་ནས་དངོས་པོ་མེད་པ་དང་མི་དམིགས་པ་དག་མི་དམིགས་པ་ཡིན་པར་བཤད་ཟིན་ཏེ་༎ དེ་སྒྲུབ་པར་མ་གྲུབ་པའི་ཕྱིར་རོ་༎
 02215 prasaṅgāt| tasya asaṃsṛṣṭa-rūpasya bhāva-siddhir eva aparasya abhāva-	དངོས་པོ་མེད་པར་ཐ་སྙད་གདགས་པ་མི་འགྲུབ་པར་ཐལ་བར་འགྱུར་བའི་ཕྱིར་རོ་༎ འབྲེལ་པ་མེད་པའི་ངོ་བོ་དེ་ཡོད་པར་གྲུབ་པ་ཉིད་གཞན་མེད་པར་གྲུབ་པ་ཡིན་པས་།
 02216 siddhir ity anyabhāvo api tad-abhāva iti vyapadeśyate|	གཞན་ཡོད་པ་ཡང་དེ་མེད་པ་མ་ཡིན་ནོ་ཞེས་ཐ་སྙད་གདགས་སོ་༎
 02217 anyabhāva-lakṣaṇo bhāvaḥ svayaṃ pramāṇa-siddhas tad-abhāva-	གཞན་ཡོད་པའི་མཚན་ཉིད་ཀྱི་དངོས་པོ་མེད་པར་རང་གི་ཚད་མས་འགྲུབ་པའམ་།
 02218 vyavahāraṃ sādhayet tat-siddhi-siddho vā tad-abhāva iti 02219 na kaścid viśeṣaḥ, yena anupalabdhyā abhāva-vyavahāra-siddher virodhaḥ	དེ་གྲུབ་པས་དེ་མེད་པར་གྲུབ་པ་དེ་དངོས་པོ་མེད་པར་ཐ་སྙད་གདགས་པ་སྒྲུབ་པར་བྱེད་པ་ལ་ཁྱད་པར་འགའ་ཡང་མེད་ན་གང་གིས་ན་མི་དམིགས་པས་དངོས་པོ་མེད་༄༢༤༩ཨ་༌་༎ པར་ཐ་སྙད་གདགས་པར་འགྲུབ་པ་འགལ་བར་འགྱུར་།
 02301 syāt| sa eva anyabhāvas tad-viṣayā ca upalabdhis tad-abhāvasya 02302 kiṃ na sādhanam,	གཞན་ཡོད་པ་དེ་ཉིད་དང་དེའི་ཡུལ་ཅན་གྱི་ཤས་པ་དངོས་པོ་མེད་པའི་སྒྲུབ་པ་ཅི་སྟེ་མ་ཡིན་། 
 kiṃ punar anyabhāvasya siddhir eva 02303 tad-abhāva-siddhir iti cet,	ཅིའི་ཕྱིར་གཞན་ཡོད་པར་གྲུབ་པ་ཉིད་དེ་མེད་པར་གྲུབ་པ་ཡིན་ཞེས་བྱ་ཞེ་མ་ཡིན་། ན་། 
 apṛthak-siddhiḥ sambandha-abhāvāc ca|	སོ་སོར་མ་གྲུབ་པའི་ཕྱིར་དང་། འབྲེལ་པ་མེད་པའི་ཕྱིར་ཏེ་།
 02304 anyabhāvas tāvan na sādhanam|	རེ་ཞིག་གཞན་ཡོད་པ་ནི་སྒྲུབ་པ་མ་ཡིན་ནོ་༎
 02305 yat-siddhau yasya na siddhiḥ, tat tasya liṅgaṃ bhavati, dhūma-	གང་ཞིག་གྲུབ་པ་ན་གང་མི་འགྲུབ་པ་ནི་དེའི་རྟགས་ཡིན་ཏེ་། མེ་དང་དུ་བ་ལྟ་བུ་ཡིན་ནོ་༎ གཞན་ཡོད་པར་གྲུབ་པ་ཉིད་ཀྱིས་།
 02306 agni-vat| anyabhāva-siddhyā eva tad-abhāvaḥ prasidhyati, tasya 02307 tad-anya-asaṃsṛṣṭa-rūpasya tattva-vyavasthāpakena pramāṇena eva anya- 02308 vyavaccheda-siddheḥ|	དེ་མེད་པར་གྲུབ་སྟེ་དེ་ལས་གཞན་པ་དང་འབྲེལ་པ་མེད་པའི་ངོ་བོ་ཅན་དེའི་དེ་ཉིད་རྣམ་པར་འཇོག་པར་བྱེད་པའི་ཚད་མ་ཁོ་ནས་གཞན་རྣམ་པར་བཅད་པ་འགྲུབ་པའི་ཕྱིར་རོ་༎
 02309 sambandha-abhāvāc ca| tac ca tasya liṅgaṃ yadi syāt, tasya 02310 tena kaścit sambandho bhavet,	འབྲེལ་པ་མེད་པའི་ཕྱིར་དང་། དེ་དེའི་རྟགས་ཡིན་ན་དེ་དང་དེར་འབྲེལ་པ་འགའ་ཞིག་ཏུ་འགྱུར་ཏེ་།
 yathā kṛtakatva-anityatvayor eka-artha- 02311 samavāyo dhūmasya liṅginaś ca eka-artha-samavāyo vā ādhārādheyabhāvo	དཔེར་ན་བྱས་པ་ཉིད་དང་། མི་རྟག་པ་ཉིད་དག་དོན་གཅིག་ལ་འདུ་བ་དང་རྟགས་དོན་གཅིག་ལ་འདུ་བའམ་། རྟེན་དང་བརྟེན་པའི་དངོས་པོའམ་བསྐྱེད་པར་བྱ་བ་དང་། སྐྱེད་པར་བྱེད་པའི་དངོས་པོ་ལྟ་བུ་ཞིག་ཡིན་གྲང་ན་།
 02312 vā janyajanakabhāvo vā| na evaṃ kaścid bhāva-abhāvayoḥ 02313 sambandhaḥ, yena asya sādhanaṃ syāt|	དངོས་པོ་ཡོད་པ་དང་། མེད་པ་དག་ལ་ནི་གང་གིས་ན་འདིའི་བསྒྲུབ་པར་འགྱུར་བའི་འབྲེལ་པ་དེ་ལྟ་བུ་འགའ་ཡང་མེད་དོ་༎ 
 02314 asti viṣayaviṣayibhāvaḥ śabda-artha-sambandha-vad iti cet, śabda-	གལ་ཏེ་ཡུལ་དང་ཡུལ་ཅན་གྱི་དངོས་པོ་ཡོད་དེ་། སྒྲ་དང་དོན་འབྲེལ་པ་བཞིན་ནོ་ཞེ་ན་།
 02315 arthayos tat-pratipādana-abhiprāye sati tat-prayogāt tena saha 02316 kārya-kāraṇa-lakṣaṇo avinābhāva-lakṣaṇo vā sambandhaḥ syāt|	སྒྲ་དང་དོན་དག་ནི་དེ་སྟོན་ན་སྦྱོར་བས་དེ་དང་ལྷན་ཅིག་གི་རྒྱུ་དང་འབྲས་བུའི་མཚན་ཉིད་དམ་མེད་ན་མི་འབྱུང་བའི་མཚན་ཉིད་ཀྱི་འབྲེལ་བར་འགྱུར་ན་།
 02317 ayaṃ ca atra na sambhavati iti kathaṃ viṣayaviṣayibhāvaḥ syāt|	རྣམ་པ་འདི་ཡང་འདི་ལ་མེད་པས་ཇི་ལྟར་ཡུལ་དང་ཡུལ་ཅན་གྱི་དངོས་པོ་ཡིན་།
 02318 siddhe hi tayoḥ sādhyasādhanabhāve tan-mukhena viṣayaviṣayibhāvaḥ	དེ་གཉིས་བསྒྲུབ་པར་བྱ་བ་དང་། སྒྲུབ་པའི་དངོས་པོར་གྲུབ་ན་ནི་། དེའི་སྒོ་ནས་ཡུལ་དང་ཡུལ་ཅན་གྱི་དངོས་པོར་འགྱུར་ན་།
 02319 syāt; sa eva asati sambandhe na sidhyati; tad-asiddhau	དེ་ཉིད་ནི་འབྲེལ་པ་མེད་ན་མི་འགྲུབ་པོ་༎
 02320 viṣayaviṣayibhāvo api na| anyathā itaretara-āśrayam idaṃ syāt|	དེ་མ་གྲུབ་ན་ཡུལ་དང་ཡུལ་ཅན་གྱི་དངོས་པོ་ཡང་མ་ཡིན་ནོ་༎ དེ་ལྟ་མ་ཡིན་ན་འདི་གཅིག་ལ་གཅིག་བརྟེན་པ་ཡིན་པར་འགྱུར་རོ་༎
 02321 anyabhāvāc ca abhāva-siddhāv asamudāyaś ca sādhyaḥ	གཞན་ཡོད་པ་ལས་མེད་པ་གྲུབ་ན་སྤྱི་བསྒྲུབ་པར་བྱ་བ་མ་ཡིན་པར་འགྱུར་རོ་༎
 02322 syāt| tathā ca ghaṭa-abhāvas tad-anyabhāvād iti ghaṭasya sarvatra 02323 sarvadā ca abhāvaḥ syāt| na,	དེ་ལྟ་ན་ནི་དེ་ལས་གཞན་པ་ཡོད་པའི་ཕྱིར་བུམ་པ་མེད་དོ་ཞེས་བྱ་བ་ལས་བུམ་པ་ཐམས་ཅད་ན་ཐམས་ཅད་དུ་མེད་པར་འགྱུར་རོ་༎ 
 pradeśa-ādi-dharmy-abhāva-sādhanād iti	གལ་ཏེ་མ་ཡིན་ཏེ་ཕྱོགས་ལ་སོགས་པ་ཆོས་ཅན་མེད་པར་སྒྲུབ་པར་བྱེད་པའི་ཕྱིར་རོ་༎ རོ་སྙམ་སྟེ་། 
 02401 cet; pradeśa-ādi-dharmi-viśeṣaṇa-bhūto abhāvaḥ sādhyate, na tu	འདི་སྙམ་དུ་ཕྱོགས་ལ་སོགས་པ་ཆོས་ཅན་ཁྱད་པར་དུ་གྱུར་པའི་མེད་པ་སྒྲུབ་པར་བྱེད་༄༢༤༩བ་ཀྱི་། འབའ་ཞིག་ནི་མ་ཡིན་ནོ་༎ དེས་ན་སྤྱི་མི་སྒྲུབ་པ་ཡང་མ་ཡིན་ལ་།
 02402 kevalaḥ; tato na asamudāyasya sādhyatā| na ca liṅga-liṅginor 02403 asambandho anyabhāvasya pradeśa-ādinā dharmiṇā sambandhād 02404 iti manyate| na,	ཡོད་པ་དང་ཕྱོགས་ལ་སོགས་པ་ཆོས་ཅན་དུ་འབྲེལ་པའི་ཕྱིར་རྟགས་དང་རྟགས་ཅན་འབྲེལ་པ་མེད་པ་ཡང་མ་ཡིན་ནོ་སྙམ་དུ་སེམས་ན་མ་ཡིན་ཏེ་། 
 pradeśa-āder eva anyabhāvatvāt| yatra eva hi	ཕྱོགས་ལ་སོགས་པ་ཉིད་དེ་གཞན་པ་ཡོད་པའི་ཕྱིར་རོ་༎
 02405 pradeśe yan na asti ity ucyate sa eva tena asaṃsṛṣṭo anyabhāvaḥ|	ཕྱོགས་གང་ཁོ་ན་ན་གང་ཞིག་མེད་དོ་ཞེས་བྱ་བ་དེ་ཉིད་དེ་དང་འབྲེལ་པ་མེད་པའི་གཞན་ཡོད་པ་ཡིན་ཏེ་།
 02406 tad-darśanād eva asya ghaṭo na asti iti vikalpa iti kathaṃ tasya eva 02407 liṅgaliṅgibhāvaḥ|	དེ་མཐོང་བ་ཁོ་ནས་འདི་བུམ་པ་མེད་དོ་སྙམ་དུ་སེམས་ན་། ཇི་ལྟར་དེ་ཁོ་ན་རྟགས་དང་རྟགས་ཅན་གྱི་དངོས་པོ་ཡིན་།
 02408 na ca atra sāmānya-viśeṣa-bhāva-kalpanā sambhavati, yena 02409 sāmānyaṃ hetur bhavet viśeṣo dharmī iti,	འདིར་གང་གིས་ན་སྤྱི་ནི་གཏན་ཚིགས་སུ་འགྱུར་ལ་ཁྱད་པར་ནི་ཆོས་ཅན་དུ་འགྱུར་ཞེས་བྱ་བ་སྤྱི་དང་ཁྱད་པར་གྱི་དངོས་པོ་རྣམ་པར་བརྟག་པ་ཡང་མི་སྲིད་དེ་།
 tad-viśeṣa-pratipatter eva	དེའི་ཁྱད་པར་རྟོགས་པ་ཁོ་ནས་དེ་མེད་པར་རྟོགས་པའི་ཕྱིར་ལ་།
 02410 tad-abhāvasya pratītes tasya ca anyatra anya-abhāvāt| pratijñārthaikadeśatvāc	དེ་ལ་རྗེས་སུ་འགྲོ་བ་ཡང་མེད་པའི་ཕྱིར་རོ་༎ དམ་བཅས་པའི་ཕྱོགས་གཅིག་ཡིན་པའི་ཕྱིར་ཡང་རྟགས་ཉིད་མ་ཡིན་ནོ་༎
 02411 ca na hetutvam| na ca yatra pradeśa-mātraṃ 02412 tatra ghaṭa-abhāvaḥ| tādṛśe kevale pradeśe abhāva eva iti cet,	གང་ན་ཕྱོགས་ཙམ་ཡོད་པ་དེ་ན་བུམ་པ་མེད་པ་ཡང་མ་ཡིན་ནོ་༎ གལ་ཏེ་ཕྱོགས་འབའ་ཞིག་ཡིན་པ་དེ་ལྟ་བུ་ནི་མེད་པ་ཁོ་ན་ཡིན་ནོ་ཞེ་ན་།
 02413 nanu tasya eva kevala iti ghaṭa-viraha iti| sa ca liṅgabhūta-	དེ་འབའ་ཞིག་ཅེས་བྱ་བ་བུམ་པ་དང་བྲལ་བ་ཞེས་བྱ་བ་མ་ཡིན་ནམ་།
 02414 pradeśa-pratipattāv eva siddhaḥ| kasya idānīṃ tal liṅgam| anvayasya	འདིར་རྟགས་སུ་གྱུར་པ་དེ་ཡང་ཕྱོགས་རྟོགས་པ་ཁོ་ནར་གྲུབ་པ་ཡིན་ན་། དེ་དེ་གང་གི་རྟགས་ཡིན་། རྗེས་སུ་འགྲོ་བ་སྨོས་པ་ཡང་དོན་མེད་པ་ཡིན་ནོ་༎
 02415 anugamanaṃ ca nirarthakam| tasmād anyabhāvo na sādhanam 02416 abhāvasya|	དེ་ལྟ་བས་ན་གཞན་ཡོད་པ་ནི་དངོས་པོ་མེད་པའི་སྒྲུབ་པ་མ་ཡིན་ནོ་༎
 02417 asti virodhaḥ sambandhaḥ, tato anyabhāvād abhāvasya 02418 siddhir iti cet,	གལ་ཏེ་འགལ་བའི་འབྲེལ་པ་ཡོད་དེ་དེའི་ཕྱིར་གཞན་ཡོད་པ་ལས་དངོས་པོ་མེད་པ་འགྲུབ་པོ་ཞེ་ན་། 
 kena kasya virodhaḥ| anyabhāvena pratiyoginaḥ|	གང་ཞིག་གང་དང་འགལ་། གཞན་ཡོད་པ་དང་ཟློ་བོར་རོ་༎
 02419 kiṃ nu vai pratiyogī pramātum iṣṭo, yena liṅga-liṅginor virodhaḥ	ཅི་གང་གིས་རྟགས་དང་རྟགས་ཅན་འགལ་བའི་འབྲེལ་པར་འགྱུར་བ་ཟློ་བོ་གཞལ་བར་འདོད་དམ་།
 02420 sambandhaḥ syāt| abhāvas tu pratiyogino ghaṭasya anyabhāvena aviruddhaḥ,	དངོས་པོ་མེད་པ་ནི་ཟླ་བོ་བུམ་པ་ཡོད་པ་དང་འགལ་བ་མེད་དེ་།
 02421 saha-avasthānāt| tasmin prameye liṅga-liṅginoḥ kathaṃ	ལྷན་ཅིག་གནས་པའི་ཕྱིར་རོ་༎ གཞལ་བྱ་དེ་ལ་རྟགས་དང་རྟགས་ཅན་དག་ཇི་ལྟར་འགལ་།
 02422 virodhaḥ| tasmāt sambandha-abhāvaḥ| atra apy asamudāya-sādhyatvaṃ	དེ་བས་ན་འབྲེལ་པ་མེད་དོ་༎ འདི་ལ་ཡང་སྤྱི་བསྒྲུབ་པར་བྱ་བ་ཉིད་མ་ཡིན་བདེའི་སོ་ན་འདུག་གོ་༎
 02423 tad-avastham| 02424 nanv anyabhāva-tadbhāvayor asati sambandhe anyabhāva-	དེ་མེད་པ་དང་། གཞན་ཡོད་པ་དག་འབྲེལ་པ་མེད་ན་།
 02425 gatyā api tad-abhāva-gatir na syād iti cet,	གཞན་ཡོད་པར་རྟོགས་ཀྱང་དེ་རྟོགས་པར་མི་འགྱུར་བ་ཡིན་ནམ་ཞེ་ན་།
 na vai kutaścit sambandhād 02501 anyabhāvas tad-abhāva-gamaka iṣṭaḥ,	འབྲེལ་པ་གང་ལས་ཀྱང་གཞན་ཡོད་པ་དེ་མེད་པའི་ཤེས་པར་བྱེད་པ་ཡིན་པར་མི་འདོད་ཀྱི་། འོན་ཀྱང་གཞན་ཡོད་པ་ཉིད་དེ་མེད་པ་ཡིན་ཏེ་། ཇི་སྐད་སྔར་བཤད་པ་ཡིན་༄༢༥༠ཨ་༌་༎
 kiṃ tv anyabhāva-	ནོ་༎
 02502 eva tad-abhāvaḥ, yathoktaṃ prāk| tasya anya-asaṃsṛṣṭa-rūpasya kevalasya 02503 ekātma-vyavasthitasya tadātmanā paricchedasya eva anya-vyavacchedatvāt	གཞན་དང་འབྲེལ་པ་མེད་པའི་ངོ་བོ་འབའ་ཞིག་པ་བདག་ཉིད་གཅིག་པུ་རྣམ་པར་གནས་པ་དེ་། དེའི་བདག་ཉིད་དུ་ཡོངས་སུ་གཅོད་པ་ཉིད་གཞན་རྣམ་པར་གཅོད་པ་ཡིན་པའི་ཕྱིར་།
 02504 tasya kaivalyam aparasya vaikalyam iti tad-anyabhāva	འབའ་ཞིག་ཉིད་གཞན་དང་བྲལ་བ་ཡིན་པས་།
 02505 eva tad-abhāvaḥ,	དེ་ལས་གཞན་པ་ཡོད་པ་ཉིད་དེ་མེད་པ་ཡིན་ལ་།
 tad-anya-pratipattir eva ca tad-apratipattir	དེ་ལས་གཞན་པ་རྟོགས་པ་ཉིད་དེ་མེད་པར་རྟོགས་པ་ཞེས་བྱའོ་༎
 02506 iti| anyathā tasya paricchedena tato anyasya avyavacchede	དེ་ལྟ་མ་ཡིན་ཏེ་ཡོངས་སུ་བཅད་པས་དེ་ལས་གཞན་རྣམས་མི་གཅོད་ན་།
 02507 tat-pariccheda eva na syāt,	དེ་ཡོངས་སུ་བཅད་པ་ཉིད་དུ་མི་འགྱུར་ཏེ་།
 tad-atadrūpayor avivekāt| ya eṣa	དེ་དང་དེ་མ་ཡིན་པའི་ངོ་བོ་དག་རྣམ་པར་མ་ཕྱེ་བའི་ཕྱིར་རོ་༎
 02508 vyavahāraḥ kasyacid darśanāt kvacit prāpti-parihāra-arthaḥ, sa	ལ་ལར་འགའ་ཞིག་མཐོང་ནས་ཐོབ་པ་དང་། ཡོངས་སུ་སྤང་བར་བྱ་བའི་དོན་གྱི་ཐ་སྙད་གང་ཡིན་པ་དེར་མི་འགྱུར་ཏེ་།
 02509 na syāt| na hy ayam analaṃ paśyann api kevalam analam 02510 eva paśyati, yena salila-arthī na pravarteta|	མེ་མཐོང་ཡང་གང་གིས་ན་ཆུ་དོན་དུ་གཉེར་བ་འཇུག་པར་འགྱུར་བ་མེ་འབའ་ཞིག་ཁོ་ན་ནི་མ་ཡིན་ནོ་༎
 02511 anupalambhena salila-abhāvaḥ pratīyata iti cet,	གལ་ཏེ་མི་དམིགས་པས་ཆུ་མེད་པར་རྟོགས་པར་འགྱུར་རོ་ཞེ་ན་།
 ko ayam anupalambho	མི་དམིགས་པ་ཞེས་བྱ་བ་འདི་ཅི་ཡིན་༎
 02512 nāma| yadi salila-upalambha-abhāva iti,	གལ་ཏེ་ཆུ་དམིགས་པ་མེད་པ་ཡིན་ནོ་ཞེ་ན་ནི་།
 kathaṃ so abhāvaḥ	མེད་པ་དེ་ཇི་ལྟར་འགའ་ཞིག་རྟོགས་པའམ་།
 02513 kasyacit pratipattiḥ pratipatti-hetur vā;	རྟོགས་པའི་རྒྱུ་ཡིན་།
 tasya api kathaṃ	དེ་ཡང་ཇི་ལྟར་རྟོགས་།
 02514 pratipattiḥ| tasya tato vā anyasya kasyacid apy apratipattāv 02515 apy abhāva-pratipattau satyāṃ svāpa-mada-mūrchā-vyavadhāna-	དེའམ་དེ་ལས་གཞན་པ་ཡང་རུང་འགའ་ཡང་མ་རྟོགས་པར་ཡང་ཡིན་ན་ནི་།
 02516 pṛṣṭhībhava-ādy-avasthāsv apy abhāvaḥ kiṃ na pratīyate| bhūyo api	གཉིད་ལོག་པ་དང་མྱོས་པ་དང་བརྒྱལ་བ་དང་། ཆོས་པ་དང་། རྒྱབ་ཀྱིས་ཕྱོགས་པ་ལ་སོགས་པའི་གནས་སྐབས་དག་ཏུ་ཡང་ཅི་སྟེ་། དངོས་པོ་མེད་པ་མ་རྟོགས་།
 02517 vicāritaṃ pramāṇaviniścaye| tasmād ayam analaṃ paśyann apy	གཞན་ཡང་ཚད་མ་རྣམ་པར་གཏན་ལ་དབབ་པར་དཔྱད་ཟིན་ཏོ་༎ དེ་ལྟ་བས་ན་འདིས་མི་མཐོང་ཡང་འདི་ནི་མེ་ཡིན་གྱི་།
 02518 analo ayaṃ na salilam ity anadhyavasyan na tiṣṭhen na api	ཆུ་མ་ཡིན་ནོ་ཞེས་བྱ་བར་མི་ཤེས་པས་། འདུག་པར་ཡང་མི་བྱ་། འགྲོ་བར་ཡང་མི་བྱ་བའི་ཕྱིར་།
 02519 pratiṣṭheta iti dustaraṃ vyasanaṃ pratipannaḥ syāt|	བརྒལ་དཀའ་བའི་སྐབས་སུ་ཆུད་པར་གྱུར་ཏོ་༎
 02520 tata eva ekasya darśanād anya-abhāva-gatir bhavati iti cet,	གལ་ཏེ་གཅིག་མཐོང་བ་དེ་ཁོ་ནས་གཞན་མེད་པར་རྟོགས་པར་འགྱུར་རོ་ཞེ་ན་།
 02521 katham ekaṃ dṛṣṭam anyan na asti iti pratyāyayati| kevalasya	ཇི་ལྟར་གཅིག་མཐོང་བས་གཞན་མེད་དོ་ཞེས་བྱ་བར་རྟོགས་པར་འགྱུར་།
 02601 darśanād iti cet,	གལ་ཏེ་འབའ་ཞིག་མཐོང་བའི་ཕྱིར་རོ་ཞེ་ན་།
 idam eva asmābhir abhihitam, kasmāt tava atra	འདི་ཉིད་ཁོ་བོས་བཤད་པ་ན་། ཅི་སྟེ་ཁྱོད་འདི་ལ་མ་རངས་པ་ལྟར་སྟོན་།
 02602 paruṣam iva ābhāti| tasmāt tīra-adarśinā eva śakuninā paryaṭā	དེ་ལྟ་བས་ན་འགྲམ་མ་མཐོང་བའི་བྱ་བཞིན་དུ་རིང་དུ་སོང་ཡང་ཕྱིར་འོང་དགོས་པས་།
 02603 api pratyāgantavyam ity alam avidyamāna-pratiṣṭhānayā diśaḥ	གཏིང་མི་ཚུགས་པ་ཅན་གྱི་ཕྱོགས་སྒྲུབ་པས་ནི་ཆོག་གོ་༎
 02604 pratipattyā| 02605 yady eka-paricchedād eva anya-vyavacchedaḥ sidhyati, sarvasya	གལ་ཏེ་དེ་ལྟར་གཅིག་ཡོངས་སུ་བཅད་པ་ཁོ་ནས་གཞན་རྣམ་པར་བཅད་པ་འགྲུབ་ན་།
 02606 anyasya aviśeṣeṇa tatra abhāva-siddhir bhavet,	དེ་ན་ཁྱད་པར་མེད་པར་༄༢༥༠བ་གཞན་ཐམས་ཅད་མེད་པར་འགྲུབ་པར་འགྱུར་བས་།
 na tulya-yogya-avasthasya 02607 eva; upalabdhi-lakṣaṇa-prāptasya anupalabdhir abhāva-sādhanī 02608 iti viśeṣaṇaṃ ca na vaktavyam,	དམིགས་པའི་རིག་བྱར་གྱུར་པ་རུང་བར་མཚུངས་པར་གནས་པ་ཁོ་ན་མི་དམིགས་པ་དངོས་པོ་མེད་པའི་སྒྲུབ་པ་ཡིན་ནོ་ཞེས་བྱ་བའི་ཁྱད་པར་ཡང་བརྗོད་མི་དགོས་ཏེ་།
 anupalabdhi-lakṣaṇa-prāptānām	དེར་དམིགས་པའི་རིག་བྱར་མ་གྲུབ་པ་རྣམས་ཀྱང་རྣམ་པར་བཅད་པའི་ཕྱིར་རོ་༎
 02609 api tatra vyavacchedāt| ekātma-paricchedāt tad-anya-ātma- 02610 vyavacchedaḥ, tad-ātma-niyata-pratibhāsa-jñānāt na hi tadātmā	དེའི་བདག་ཉིད་གཅིག་ཡོངས་སུ་བཅད་པས་དེ་ལས་གཞན་པའི་བདག་ཉིད་རྣམ་པར་བཅད་པ་ཡིན་ཏེ་། དེའི་བདག་ཉིད་དུ་ངེས་པར་སྣང་བ་ཤེས་པའི་ཕྱིར་རོ་༎ དེའི་བདག་ཉིད་ནི་དེ་ལས་གཞན་པའི་བདག་ཉིད་མ་ཡིན་ནོ་༎
 02611 tad-anyasya ātmā bhavati| anya-ātmano avyavacchede pravṛtti-	གཞན་གྱི་བདག་ཉིད་རྣམ་པར་མ་བཅད་ན་། འཇུག་པ་དང་ལྡོག་པ་དག་མེད་པས་ཐལ་བ་སྔ་མར་འགྱུར་རོ་༎
 02612 nivṛttyor abhāva iti pūrvaḥ prasaṅgaḥ| taṃ ca deśa-kāla-svabhāva- 02613 avasthā-niyataṃ tadātmanā upalambhamānā buddhis tathātva- 02614 pracyutim asya vyavacchinatti| evaṃ hi sa tayā paricchinno	ཡུལ་དང་དུས་དང་ངོ་བོ་ཉིད་དང་གནས་སྐབས་སུ་ངེས་པ་དེ་བློས་དེའི་བདག་ཉིད་དུ་དམིགས་པ་ན་འདིའི་དེ་ཁོ་ན་ཉིད་མེད་པ་རྣམ་པར་གཅོད་དོ་༎ 
 02615 yady anyathābhāvo vyavacchinno bhavati tathātvaṃ ca	གལ་ཏེ་གཞན་གྱི་དངོས་པོ་རྣམ་པར་བཅད་པར་གྱུར་ན་།
 02616 tasya eva bhavati na anyasya ity anyathābhūtād vyavacchindaty	དེ་ལྟར་ན་གདོང་དེ་དེས་ཡོངས་སུ་བཅད་པ་དང་། དེ་ཁོ་ན་ཉིད་ཀྱང་དེ་དེ་ཁོ་ནའི་ཡིན་གྱི་གཞན་གྱི་མ་ཡིན་ནོ་ཞེས་བྱ་བ་ཡིན་ཏེ་། གཞན་དུ་གྱུར་པ་རྣམ་པར་གཅོད་པ་ཉིད་དེ་ཡོངས་སུ་གཅོད་པ་ཡིན་ནོ་༎
 02617 eva tat paricchinatti| evam ekasya pramāṇasya vṛttiḥ sarva- 02618 bhāvān dvairāśye vyavasthāpayati,	དེ་བས་ན་ཚད་མ་གཅིག་འཇུག་པ་ནི་དངོས་པོ་ཐམས་ཅད་ཕུང་པོ་གཉིས་སུ་རྣམ་པར་འཇོག་པར་བྱེད་དེ་། 
 tasya anvaya-vyatireka-buddhi- 02619 hetutvena eva sāphalyāt|	དེ་ནི་རྗེས་སུ་འགྲོ་བ་དང་ལྡོག་པའི་བློའི་རྒྱུ་ཉིད་ཁོ་ནས་འབྲས་བུ་དང་བཅས་པ་ཉིད་ཡིན་པའི་ཕྱིར་རོ་༎
 02620 tad-vyatiriktasya aśeṣasya vyavacchedena vyāpti-sādhanād eva 02621 prakāra-antara-abhāvaḥ sidhyati,	དེ་ལས་མ་གཏོགས་པ་མ་ལུས་པ་རྣམ་པར་བཅད་པས་ཁྱབ་པ་སྒྲུབ་པ་ཁོ་ནས་རྣམ་པ་གཞན་མེད་པར་གྲུབ་པོ་༎
 tasya tad-anyatayā vyāpty-abhāve	དེ་དེ་ལས་གཞན་པ་ཉིད་ཀྱིས་མ་ཁྱབ་པར་།
 02622 tena tad-artha-avyavacchedāt punar bhāvasya apariccheda-prasaṅgāt|	དེས་དོན་དེ་རྣམ་པར་མ་བཅད་པའི་ཕྱིར་ཡང་དངོས་པོ་ཡོངས་སུ་མ་བཅད་པར་ཐལ་བར་འགྱུར་རོ་༎ དེ་ལྟ་བས་ན་།
 02623 tasmāt kvacit pramāṇaṃ pravṛttaṃ tat paricchinatti	ཚད་མའི་བྱེད་པ་ནི་འགའ་ཞིག་ལ་ཚད་མ་འཇུག་པ་དེ་ནི་།
 02624 tad-anyad vyavacchinatti tṛtīya-prakāra-antara-abhāvaṃ ca	ཡོངས་སུ་གཅོད་ཅིང་དེ་ལས་གཞན་པ་ནི་རྣམ་པར་གཅོད་ལ་། རྣམ་པ་གསུམ་པ་གཞན་ནི་མེད་པར་སྒྲུབ་པར་བྱེད་པ་ཞེས་བྱ་བ་འདི་ཡིན་ནོ་༎
 02701 sūcayati iti eka-pramāṇa-vyāpāra eṣaḥ| tathā hi kvacit pramāṇaṃ	འདི་ལྟར་འགའ་ཞིག་ལ་ཚད་མར་འཇུག་པ་ནི་།
 02702 pravṛttaṃ tad eva tad-anyasmād vyavacchinatti,	དེ་ལས་གཞན་པ་ལས་རྣམ་པར་གཅོད་དེ་།
 02703 tasya eva paricchedāt, tad-anyad eva ca tasmād vyavacchinatti,	དེ་ཉིད་ཡོངས་སུ་གཅོད་པ་དང་དེ་ལས་གཞན་པ་ཉིད་དེ་ལས་རྣམ་པར་གཅོད་པ་དང་དེ་ལས་ཡོངས་སུ་མི་གཅོད་པའི་ཕྱིར་རོ་༎
 02704 tatra aparicchedāt| atas tad eva pramāṇaṃ prakāra-antara-abhāvaṃ	དེའི་ཕྱིར་ཚད་མ་དེ་ཉིད་རྣམ་པ་གཞན་མེད་པར་སྒྲུབ་པར་བྱེད་དེ་།
 02705 sādhayati, tasmin dṛśyamāne adṛṣṭasya tad-anyatvena sarvasya	དེ་སྣང་ན་མི་སྣང་པ་ཐམས་ཅད་ནི་དེ་༄༢༥༡ཨ་༌་༎ ལས་གཞན་པ་ཉིད་དུ་རྣམ་པར་འཇོག་པའི་ཕྱིར་ལ་།
 02706 vyavasthāpanād atad-anyasya eva ca tattvena vyavasthāpanāt|	དེ་ལས་གཞན་པ་མ་ཡིན་པ་ཉིད་ནི་དེ་ཉིད་དུ་རྣམ་པར་འཇོག་པའི་ཕྱིར་རོ་༎
 02707 etena krama-akrama-ādayo apy anyonya-vyavaccheda-rūpā vyākhyātāḥ|	འདིས་ནི་རིམ་དང་རིམ་མ་ཡིན་པ་ལ་སོགས་པ་ཕན་ཚུན་རྣམ་པར་གཅོད་པའི་ངོ་བོ་ཅན་དག་ཀྱང་རྣམ་པར་བཅད་པ་ཡིན་ནོ་༎
 02709 tad evaṃ ekasya upalambhāt tasya tad-anya-ātmano vyavacchedaḥ,	དེ་ལྟ་བས་ན་དེ་ལྟར་གཅིག་དམིགས་པས་དེའི་དེ་ལས་གཞན་པའི་བདག་ཉིད་རྣམ་པར་གཅོད་པ་ཡིན་གྱི་། 
 02710 na tad-deśa-kālayoḥ sarvasya anyasya bhāvasya vyavacchedaḥ|	དེའི་ཡུལ་དང་དུས་དག་ཏུ་གཞན་ཡོད་པ་ཐམས་ཅད་རྣམ་པར་གཅོད་པ་ནི་མ་ཡིན་གྱི་། ཡིན་ནོ་༎ 
 02711 tasmād atadātmā ca syāt tad-deśa-kālaś ca,	དེ་ལྟ་བས་ན་དེའི་བདག་ཉིད་མ་ཡིན་པར་ཡང་འགྱུར་ལ་། དེའི་ཡུལ་དང་དུས་དག་ཏུའང་འགྱུར་ཏེ་།
 rasa-rūpa-ādi-	རོ་དང་གཟུགས་ལ་སོགས་པ་བཞིན་ནོ་༎
 02712 vat| tasmād yathoktād eva anupalambhāt kvacit kadācit 02713 kasyacid abhāva-siddhiḥ|	དེ་ལྟ་བས་ན་ཇི་སྐད་བཤད་པའི་མི་དམིགས་པ་ཁོ་ན་ལས་རེས་འགའ་ལ་ལ་ཞིག་ཏུ་འགའ་ཞིག་དངོས་པོ་མེད་པར་འགྲུབ་བོ་༎
 02714 anyabhāva-viṣaya-upalabdhir api tad-abhāvasya sādhikā iṣṭā eva, 02715 na tu liṅgatvena,	གཞན་ཡོད་པའི་ཡུལ་ཅན་གྱི་དམིགས་པ་ཡང་དེ་མེད་པའི་སྒྲུབ་པར་བྱེད་པར་འདོད་པ་ཁོ་ན་ཡིན་གྱི་རྟགས་ཉིད་དུ་ནི་མ་ཡིན་ཏེ་།
 tatra apy abhāvasya pṛthak sādhyatve	དེར་ཡང་དངོས་པོ་མེད་པ་ལོགས་ཤིག་ཏུ་སྒྲུབ་པར་བྱེད་པ་ཉིད་ཡིན་ལ་།
 02716 sambandha-abhāvasya tulyatvāt| liṅga-āvirbhāva-kāla eva tad-abhāva-	འབྲེལ་པ་མེད་པར་མཚུངས་པའི་ཕྱིར་རོ་༎ རྟགས་འབྱུང་བའི་དུས་སུ་ཁོ་ན་ན་དེ་མེད་པར་འགྲུབ་པའི་ཕྱིར་ཏེ་།
 02717 siddheḥ| na hy anyabhāvaṃ pratipadya tat-pratipatter anvaya- 02718 vyatirekau prasādhya tad-abhāvaṃ pratipadyate| kiṃ tarhi|	གཞན་ཡོད་པ་རྟོགས་ནས་འདོད་དེ་རྟོགས་པའི་རྗེས་སུ་འགྲོ་བ་དང་ལྡོག་པ་དག་རབ་ཏུ་བསྒྲུབས་ནས་དེ་མེད་པར་རྟོགས་པ་མ་ཡིན་ནོ་༎ འོ་ན་ཅི་ཞེ་ན་།
 02719 tad-anyaṃ pratipadyamāna eva tad-abhāvaṃ pratipadyate,	དེ་ལས་གཞན་པ་རྟོགས་པ་ཁོ་ན་ནི་དེ་མེད་པ་རྟོགས་ཏེ་།
 02720 darśana-anantaraṃ vyavadhānena vinā idam asti idaṃ tu na asti iti 02721 vyavasthāpanāt,	མཐོང་མ་ཐག་ཏུ་ཆོད་པ་མེད་པར་འདི་ནི་ཡོད་དོ་༎ འདི་ནི་མེད་དོ་ཞེས་བྱ་བར་ཤེས་པའི་ཕྱིར་རོ་༎
 dṛṣṭānta-asiddheḥ| tac ca tasya liṅgaṃ yad 02722 yasya anvayi vyatireki ca| na hy evaṃ śakyaṃ darśayituṃ yatra anya- 02723 bhāva-upalabdhis tatra tad-abhāva iti,	དེ་ནི་གང་ཞིག་གང་གིས་རྗེས་སུ་འགྲོ་བ་དང་ལྡོག་པ་དེའི་རྟགས་ཡིན་པའི་དཔེ་མ་གྲུབ་པའི་ཕྱིར་རོ་༎ འདི་སྐད་དུ་། གང་ན་གཞན་ཡོད་པའི་དམིགས་པ་ཡོད་པ་དེ་ན་དེ་མེད་དོ་ཞེས་བསྟན་པར་ནི་མི་ནུས་ཏེ་། 
 tad-eka-upalabdheḥ kvacid apy	དམིགས་པ་གཅིག་པུ་དེ་ནི་གང་ན་ཡང་མེད་པའི་ཕྱིར་རོ་༎
 02724 abhāvāt| sāmānyena pradarśane dṛṣṭānte api pramāṇa-antara-abhāvāt 02725 sā eva tad-anyabhāva-upalabdhiḥ sādhya-dharmasya sādhikā iti 02726 dṛṣṭānta-anavasthitvād apratipattiḥ|	སྤྱིར་རབ་ཏུ་བསྟན་པའི་དཔེ་ལ་ཡང་ཚད་མ་གཞན་མེད་པའི་ཕྱིར་དེ་ལས་གཞན་པ་ཡོད་པ་དམིགས་པ་དེ་ཉིད་བསྒྲུབ་པར་བྱ་བའི་ཆོས་ཀྱི་སྒྲུབ་པར་བྱེད་པ་ཡིན་པས་། དཔེ་ཐུག་པ་མེད་པ་ཉིད་ཀྱི་ཕྱིར་རྟོགས་པ་མ་ཡིན་ནོ་༎
 02801 tasmān na kutaścil liṅgād abhāva-siddhiḥ| so anyabhāvaḥ	དེ་ལྟ་བས་ན་རྟགས་གང་ལས་ཀྱང་དངོས་པོ་མེད་པ་མི་འགྲུབ་བོ་༎
 02802 pratyakṣa-lakṣaṇena anupalambhena siddho mūḍha-pratipattāv 02803 abhāva-vyavahāraṃ sādhayed ity alaṃ prasaṅgena| 02804 sā iyaṃ tridhā anupalabdhiḥ| siddhe kāryakāraṇabhāve	མངོན་སུམ་གྱི་མཚན་ཉིད་ཀྱི་མི་དམིགས་པས་གྲུབ་པ་གཞན་ཡོད་པ་དེ་ནི་རྟོགས་པ་ལ་དངོས་པོ་མེད་པར་ཐ་སྙད་གདགས་པ་སྒྲུབ་པར་བྱེད་པ་ཡིན་པས་ཞར་ལ་འོངས་པས་ཆོ་ག་༄༢༥༡བ་གོ་༎ མི་དམིགས་པ་དེ་ནི་རྣམ་པ་གསུམ་སྟེ་།
 02805 bhāvasya kāraṇasya anupalabdhir vyāpyavyāpakabhāva-siddhau	རྒྱུ་དང་འབྲས་བུའི་དངོས་པོ་གྲུབ་ལ་། དངོས་པོ་མེད་པར་གྲུབ་པའི་རྒྱུ་མི་དམིགས་པ་དང་། ཁྱད་པར་བྱ་བ་དང་། ཁྱད་པར་བྱེད་པ་གྲུབ་ལ་།
 02806 siddha-abhāvasya vyāpakasya anupalabdhiḥ svabhāva-anupalabdhiś ca|	དངོས་པོ་མེད་པར་གྲུབ་པའི་ཁྱད་པར་བྱེད་པའི་མི་དམིགས་པ་དང་། རང་བཞིན་མི་དམིགས་པའོ་༎
 02807 tatra kāraṇa-vyāpakayor api svabhāvasya asad-vyavahāra-siddhir	དེ་ལ་རྒྱུ་དང་ཁྱབ་པར་བྱེད་པ་དག་གི་ངོ་བོ་ཉིད་དངོས་པོ་མེད་པར་ཐ་སྙད་གདགས་པ་འགྲུབ་པ་ཡང་གཞན་ཡོད་པ་གྲུབ་པ་ཁོ་ན་ལས་ཡིན་ནོ་༎
 02808 anyabhāva-siddher eva| sa tatra asiddhaḥ kārya-vyāpyayor abhāvam	དེ་ལྟར་གྲུབ་པ་དེ་ནི་འབྲས་བུ་དང་། ཁྱབ་པར་བྱ་བ་དག་དངོས་པོ་མེད་པའམ་། དངོས་པོ་མེད་པར་ཐ་སྙད་གདགས་པ་གྲུབ་པར་བྱེད་པ་ཡིན་ནོ་༎
 02809 abhāva-vyavahāraṃ vā sādhayati| svabhāva-anupalabdhau tv anupalabdhyā 02810 liṅgabhūtayā abhāva-vyavahāra eva sādhyate|	རང་བཞིན་མི་དམིགས་པ་ལ་ནི་མི་དམིགས་པ་རྟགས་སུ་གྱུར་པས་ཐ་སྙད་གདགས་པ་ཁོ་ན་སྒྲུབ་པར་བྱེད་པ་ཡིན་ནོ་༎
 02811 yadi kāraṇa-vyāpakau tad-anyabhāva-siddhi-rūpayā anupalabdhyā	གལ་ཏེ་རྒྱུ་དང་ཁྱབ་པར་བྱེད་པ་དེ་ལས་གཞན་ཡོད་པར་གྲུབ་པའི་ངོ་བོ་མི་དམིགས་པས་གྲུབ་པ་དག་། 
 02812 siddha-asad-vyavahārāv anyasya abhāvam abhāva-vyavahāraṃ	གཞན་དངོས་པོ་མེད་པའམ་དངོས་པོ་མེད་པར་ཐ་སྙད་གདགས་པ་སྒྲུབ་པར་བྱེད་ལ་། 
 02813 ca sādhayataḥ sā ca anupalabdhis tayor upalabdhi-lakṣaṇa- 02814 prāptāv eva asad-vyavahārasya sādhikā,	དེ་ཡང་མི་དམིགས་པའི་རིག་བྱར་གྱུར་པ་དེ་གཉིས་ཁོ་ནའི་མེད་པར་ཐ་སྙད་གདགས་པའི་སྒྲུབ་པར་བྱེད་པ་ཡིན་ན་།
 kathaṃ tayoḥ parokṣe	དེ་གཉིས་ཇི་ལྟར་ལྐོག་ཏུ་སྦྱོར་བ་ཡིན་།
 02815 arthe prayogaḥ| na eva prayogaḥ pramāṇatayā,	རྟགས་མ་ངེས་པའི་ཕྱིར་ཚད་མ་ཉིད་ཀྱིས་ནི་།
 liṅgasya aniścayāt| 02816 kevalaṃ kāraṇa-vyāpakayoḥ siddha-sambandhayor yady abhāvaḥ 02817 parasya avaśyam abhāva-niścaya iti darśana-artham ete prayujyete|	སྦྱོར་བ་མ་ཡིན་པ་ཁོ་ནའི་རྒྱུ་དང་ཁྱབ་པར་བྱེད་པ་འབྲེལ་པ་གྲུབ་པ་དག་གལ་ཏེ་མེད་ན་གཞན་གདོན་མི་ཟ་བར་མེད་པར་ངེས་སོ་ཞེས་བསྟན་པར་བྱ་བའི་ཕྱིར་འདི་དག་སྦྱོར་བ་འབའ་ཞིག་ཏུ་ཟད་དོ་༎
 02818 ity eṣa pakṣa-dharmo anvaya-vyatirekavān iti tad-aṃśena	དེ་ལྟ་བས་ན་ཕྱོགས་ཀྱི་ཆོས་འདི་རྗེས་སུ་འགྲོ་བ་དང་། ལྡོག་པ་དང་ལྡན་པ་ཡིན་པས་།
 02819 vyāptas tri-lakṣaṇas trirūpa eva hetur gamakaḥ, sva-sādhya- 02820 dharma-avyabhicārāt|	དེའི་ཆས་ཁྱབ་པ་མཚན་ཉིད་གསུམ་པའི་གཏན་ཚིགས་རྣམ་པ་གསུམ་ཁོ་ན་ཤེས་པར་བྱེད་པ་ཡིན་ཏེ་། རང་གི་བསྒྲུབ་པར་བྱ་བའི་ཆོས་ལ་འཁྲུལ་པ་མེད་པའི་ཕྱིར་རོ་༎
 02821 ṣaḍ-lakṣaṇo hetur ity apare| trīṇi ca etāny abādhita-viṣayatvam	གཞན་དག་ནི་གཏན་ཚིགས་མཚན་ཉིད་དྲུག་པའོ་ཞེས་ཟེར་ཏེ་།
 02901 vivakṣita-eka-saṃkhyatvaṃ jñātatvaṃ ca iti|	གསུམ་པོ་དེ་དག་དང་། གནོད་པར་མ་བྱས་པའི་ཡུལ་ཅན་ཉིད་དང་། གྲངས་གཅིག་པ་བརྗོད་པར་འདོད་པ་ཅན་ཉིད་དང་། ཤེས་པ་ཉིད་ཅེས་བྱ་བ་ཡིན་ནོ་༎
 02902 tatra abādhita-viṣayatvaṃ tāvat pṛthag lakṣaṇaṃ na bhavati,	དེ་ལ་རེ་ཞིག་གནོད་པར་མ་བྱས་པའི་ཡུལ་ཅན་ཉིད་ནི་མཚན་ཉིད་ཐ་དད་པ་ཉིད་མ་ཡིན་ཏེ་། 
 02903 bādha-avinābhāvayor virodhāt| avinābhāvo hi saty eva sādhya-	གནོད་པ་དང་མེད་ན་མི་འབྱུང་བ་དག་འགལ་བའི་ཕྱིར་རོ་༎ མེད་ན་མི་འབྱུང་བ་ནི་བསྒྲུབ་པར་བྱ་བའི་ཆོས་ཡོད་པ་ཁོ་ན་གཏན་ཚིགས་ཡོད་པ་ཡིན་ནོ་། 
 02904 dharme bhāvo hetoḥ| sa hetus tal-lakṣaṇo dharmiṇi syāt, atra	ཇི་ལྟར་ཆོས་ཅན་ལ་༄༢༥༢ཨ་༌་༎ དེ་ལྟ་བུའི་མཚན་ཉིད་ཀྱི་གཏན་ཚིགས་ཀྱང་ཡོད་པར་འགྱུར་ལ་། འདི་ལ་བསྒྲུབ་པར་བྱ་བའི་ཆོས་ཀྱང་མེད་པར་འགྱུར་།
 02905 ca sādhya-dharmaḥ kathaṃ na bhavet| pratyakṣa-anumāne hi	མངོན་སུམ་དང་། རྗེས་སུ་དཔག་པ་བསྒྲུབ་པར་བྱ་བའི་ཆོས་ལ་གནོད་པར་ཞུགས་པ་དག་ནི་།
 02906 sādhya-dharmaḥ bādhamāne taṃ dharmiṇo niṣkāsayataḥ,	དེ་ཆོས་ཅན་དེ་ལས་ཟློག་པར་བྱེད་ལ་། དེ་ཡོད་པ་ཁོ་ནས་གཏན་ཚིགས་ཡོད་པ་ནི་།
 02907 tasmin saty eva hetur bhavaṃs taṃ tatra eva dharmiṇy avasthāpayati 02908 iti paraṃ bata bhāvānām asvāsthyam| anyatra	དེ་ཆོས་ཅན་དེ་ལ་འཇུག་པར་བྱེད་པས་། ཀྱེ་མ་དངོས་པོ་རྣམས་རབ་ཏུ་ཉམ་ང་བར་གྱུར་ཏོ་༎
 02909 sādhya-dharmeṇa avinābhāvī hetur na dharmiṇy eva iti cet, tat	གལ་ཏེ་གཞན་ལ་གཏན་ཚིགས་བསྒྲུབ་པར་བྱ་བའི་ཆོས་མེད་ན་ནི་མི་འབྱུང་བ་ཡིན་གྱི་། ཆོས་ཅན་ཁོ་ན་ལ་ནི་མ་ཡིན་ནོ་ཞེ་ན་།
 02910 kim ayaṃ tapasvī ṣaṇḍham udvāhya putraṃ mṛgyate| yasya	དེ་ཅི་སྟེ་ཉོན་མོངས་འདི་མ་ནིང་བཅིབས་ནས་དུ་ཚོལ་བར་བྱེད་དམ་།
 02911 dharmiṇy asaty api sādhya-dharme bhāvas tam upadarśya	གང་ཞིག་ཆོས་ཅན་ལ་བསྒྲུབ་པར་བྱ་བ་མེད་ཀྱང་ཡོད་པ་དེ་ཉེ་བར་བསྟན་ནས་།
 02912 kathaṃ sa dharmī sādhya-dharmavān ity ucyate| ata eva bādhā	ཆོས་ཅན་དེ་བསྒྲུབ་པར་བྱ་བའི་ཆོས་དང་ལྡན་པ་ཞེས་ཇི་སྐད་དུ་བྱ་། གལ་ཏེ་དེ་ཉིད་ཀྱི་ཕྱིར་གནོད་པ་མེད་པ་སྨོས་ཏེ་། འདི་སྙམ་དུ་གང་གི་ཕྱིར་།
 02913 bhāva uktaḥ; syād etat: yata eva hetur anyathā api bhavet, ata 02914 eva pramāṇābhyām abādhita-dharmā dharmī ity ucyate iti tat	ཁོ་ནར་གཏན་ཚིགས་གཞན་དུ་ཡང་ཡོད་པར་འགྱུར་བ་དེ་ཁོ་ནའི་ཕྱིར་ཚད་མ་དག་གིས་གནོད་པར་མ་བྱས་པའི་ཆོས་དང་ལྡན་པའི་ཆོས་ཅན་ཞེས་བྱའོ་སྙམ་དུ་སེམས་ན་།
 02915 kim idānīṃ hetoḥ sāmarthyam abādhayā eva sādhya-siddheḥ|	དེ་དག་གནོད་པ་མེད་པ་ཁོ་ནས་བསྒྲུབ་པར་བྱ་བ་གྲུབ་པའི་ཕྱིར་གཏན་ཚིགས་ལ་ནུས་པ་ཅི་ཞིག་ཡོད་། 
 02916 yadi sādhya-abhāvo bādhaka-pramāṇa-vṛttau niyataḥ| abādhāyāṃ 02917 sādhya-siddhir iti vyartho hetuḥ;	བསྒྲུབ་པར་བྱ་བ་མེད་པས་གནོད་པར་བྱེད་པའི་ཚད་མ་འཇུག་པར་ངེས་པ་ཞིག་ཡིན་ན་ནི་གནོད་པ་མེད་ན་བསྒྲུབ་པར་བྱ་བ་འགྲུབ་པས་གཏན་ཚིགས་དོན་མེད་དོ་༎
 bādhāyām api, sādhana-sāmarthya	གནོད་པ་ཡོད་ན་ཡང་སྒྲུབ་པ་ནུས་པ་མེད་པའི་ཕྱིར་རོ་༎
 02918 abhāvāt| aniyame na ca bādhakaṃ pramāṇaṃ syāt sādhya-abhāvasya 02919 ca sambhava iti na sāmarthyam abādhāyāḥ|	མ་ངེས་པ་ཞིག་ཡིན་ན་ནི་། གནོད་པར་བྱེད་པའི་ཚད་མ་ཡང་མེད་པར་འགྱུར་ལ་།
 02920 na bādhāyā abhāvo abādhā| kiṃ tarhi| bādhāyā anupalabdhiḥ|	བསྒྲུབ་པར་བྱ་བ་མེད་པ་ཡང་སྲིད་པས་གནོད་པ་མེད་པ་ལ་ནུས་པ་མེད་པ་ཡིན་ནོ་༎ གནོད་པ་མེད་པ་ནི་གནོད་པ་མེད་པ་ཡིན་ནོ་༎ འོ་ན་ཅི་ཞེ་ན་། གནོད་པ་མི་དམིགས་པ་ཡིན་ཏེ་།
 02921 sā ca puruṣasya kvacid bādha-asambhave api syād iti sa	དེ་ཡང་ལ་ལར་གནོད་པ་སྲིད་ཀྱང་སྐྱེས་བུ་ལ་ཡོད་པར་འགྱུར་བས་།
 02922 hetu-prayogasya viṣayaḥ| kiṃ nu vai hetur bādha-upalabdher api	དེ་ནི་གཏན་ཚིགས་སྦྱོར་བའི་ཡུལ་ཡིན་ནོ་༎ གཏན་ཚིགས་གནོད་པ་དམིགས་པ་ལའང་འཇིགས་ཀྱི་། གནོད་པ་ལ་མི་འཇིགས་སམ་ཅི་ན་གང་གིས་ན་གནོད་པ་ཚོད་ཡོད་པར་བྱས་ཏེ་མི་དམིགས་པ་ལའང་སྦྱོར་བར་འདོད་།
 02923 bibheti, na punar bādhāyāḥ, yena bādhām anādṛtya apy anupalabdhau 02924 prayoktavya iṣṭaḥ| sa tarhi hetuḥ paramārthena	གཏན་ཚིགས་དེ་ནི་དོན་དམ་པར་གནོད་པ་ཡོད་དམ་མེད་ཀྱང་རུང་སྟེ་།
 03001 bādhā kim asti na asti ity anapekṣya bādhā-anupalabdhau prayoktavyaḥ	མི་ལྟོས་པར་གནོད་པ་མི་དམིགས་པ་ལ་སྦྱར་བར་བྱ་བའམ་།
 03002 kim arthaṃ prayujyate| sādhya-siddhy-artham| sa kiṃ	ཅིའི་ཕྱིར་སྦྱར་བར་བྱ་། བསྒྲུབ་པར་༄༢༥༢བ་བྱ་བ་བསྒྲུབ་པར་བྱ་བའི་ཕྱིར་རོ་༎
 03003 kvacit satyām api bādhāyāṃ sādhyaṃ sādhayet, yena asyā abhāva 03004 niścayaṃ prati yatno na kriyate hetuś ca prayujyate| tathā	དེས་ལ་ལར་གནོད་པ་ཡིན་བཞིན་དུ་ཡང་བསྒྲུབ་པར་བྱ་བསྒྲུབ་པར་བྱེད་དམ་ཅི་གང་གིས་ན་འདི་མེད་པར་ངེས་པར་བྱ་བ་ལ་འབད་པར་ཡང་མི་བྱེད་ལ་། གཏན་ཚིགས་ཀྱང་སྦྱོར་།
 03005 ca abādhita-viṣayatvaṃ hetu-lakṣaṇaṃ na bhavati, bādhāyām	དེ་ལྟ་ན་ཡང་གནོད་པར་བྱས་པའི་ཡུལ་ཅན་ཉིད་། གཏན་ཚིགས་ཀྱི་མཚན་ཉིད་མ་ཡིན་ཏེ་།
 03006 api satyām asya sāmarthyāt;	གནོད་པ་ཡོད་བཞིན་དུ་ཡང་འདིས་ནུས་པའི་ཕྱིར་རོ་༎ དེ་ལྟ་ན་ཡང་ཐེ་ཚོམ་ཅན་ལ་ཁས་མ་བླངས་ན་། འཇུག་པ་མི་རུང་བའི་ཕྱིར་།
 tathā ca anabhyupagamye saṃśayitasya 03007 pravṛtty-ayogād yathā anupalabdhau bādhā-sadbhāva-sambhave	ཇི་ལྟར་མི་དམིགས་པ་ལ་གནོད་པ་ཡོད་པ་སྲིད་ན་ཡང་ཁས་བླངས་ནས་།
 03008 apy abhyupagamya prayujyate,	སྦྱོར་བ་དེ་བཞིན་དུ་།
 tathā bādha-upalabdhāv api 03009 prayujyatām,	གནོད་པ་མི་དམིགས་པ་ལ་ཡང་སྦྱོར་བར་འགྱུར་རོ་༎
 abhyupagame viśeṣa-abhāvāt|	ཁས་ལེན་ན་ཁྱད་པར་མེད་པའི་ཕྱིར་རོ་༎
 03010 na bādhāyāṃ satyāṃ sāmarthyam iti cet, yady evaṃ	གལ་ཏེ་གནོད་པ་ཡོད་ན་མི་ནུས་སོ་ཞེ་ན་༎ གལ་ཏེ་དེ་ལྟ་ན་སྦྱར་ཀྱང་མི་ནུས་པར་འགྱུར་དུ་འོང་བས་།
 03011 prayuktasya apy asāmarthya-prāptir ity anirṇīta-bādhā-sambhavaḥ	གནོད་པ་མི་སྲིད་པར་གཏན་ལ་མ་བབ་པར་སྦྱོར་བར་འོས་པ་མ་ཡིན་ནོ་༎
 03012 prayogaṃ na arhati| bādhā-anupalambhe sāmarthyam iti cet, kim	གལ་ཏེ་གནོད་པ་མི་དམིགས་ན་། ནུས་སོ་སྙམ་ན་།
 03013 upalambho bādhāṃ vyāpnoti,	དམིགས་པས་གནོད་པ་ལ་ཁྱབ་བམ་ཅི་ན་།
 yata evaṃ hetor bādhā-sambhava- 03014 kṛtam asāmarthyaṃ na sambhavet| atha tan-nivṛttau bādhā	གང་གིས་ན་འདི་ལྟར་གཏན་ཚིགས་གནོད་པ་སྲིད་པས་བྱས་པའི་ནུས་པ་མེད་པར་མི་འགྱུར་བ་དེ་ལོག་ན་། 
 03015 nivartate, tathā api bādhā-anupalambhād eva sādhya-siddher vyartho	གནོད་པ་ལྡོག་། དེ་ལྟ་ན་ཡང་གནོད་པ་མི་དམིགས་པ་ཁོ་ན་ལས་བསྒྲུབ་པར་བྱ་བ་འགྲུབ་པའི་ཕྱིར་། གཏན་ཚིགས་དོན་མེད་པ་ཡིན་ཏེ་།
 03016 hetuḥ, anupalambhe bādhāyā asambhavāt| upalambhasya nivṛttāv	མི་དམིགས་ན་གནོད་པ་མི་སྲིད་པའི་ཕྱིར་རོ་༎ དམིགས་པ་ལོག་ཀྱང་གནོད་པ་མི་ལྡོག་ན་ནི་།
 03017 api bādhāyā anivṛttau tad-avasthaṃ hetor asāmarthyam	གཏན་ཚིགས་ནུས་པ་མེད་པ་དེའི་སོན་འདུག་པས་སྦྱོར་བ་མ་ཡིན་ནོ་༎
 03018 ity aprayogaḥ| tasmāt sva-sādhya-bhāva-abhāvābhyām anyathā api 03019 bhavan hetur dharmiṇi kiṃcin na bhāvayati na vibhāvayati ity	དེ་ལྟ་བས་ན་ཆོས་ཅན་ལ་རང་གིས་བསྒྲུབ་པར་བྱ་བ་ཡོད་པ་དང་། མེད་པ་དག་ལས་གཞན་དུ་ཡང་ཡོད་པ་ནི་ཅུང་ཟད་ཀྱང་སྒྲུབ་པར་མི་བྱེད་འཇིག་པར་ཡང་མི་བྱེད་པས་། དེ་ཉེ་བར་བཀོད་པ་ནི་ནུས་པ་མ་ཡིན་ནོ་༎
 03020 upakṣepo na samarthaḥ| tan na bādhā-avinābhāvau sahāvasthitau;	དེ་ལྟ་བས་ན་གནོད་པ་དང་མེད་ན་མི་འབྱུང་བ་དག་ནི་ལྷན་ཅིག་ཡོད་པ་མ་ཡིན་ཏེ་། 
 03021 tena abādhā rūpa-antaraṃ na bhavati|	དེས་ན་གནོད་པ་མེད་པའི་ངོ་བོ་གཞན་མ་ཡིན་ནོ་༎
 03022 tan nāma tasmād viśeṣaṇa-antaraṃ lakṣaṇa-antara-upādāna-arthaṃ	དེ་དེ་ལས་ཁྱད་པར་གཞན་ནམ་མཚན་ཉིད་གཅིག་ཏུ་སྨོས་པར་འོས་པར་འགྱུར་ན་།
 03023 vā bhavet, yasya bhāve api yasya anyasya abhāvaḥ| tad yathā	གང་ཞིག་ཡོད་བཞིན་དུ་ཡང་གང་ཞིག་གཞན་དུ་འགྱུར་བ་སྟེ་།
 03024 pakṣadharmatvaṃ sapakṣe ca bhāva iti| na ca etad bādhāyā avinābhāve	དཔེར་ན་ཕྱོགས་ཀྱི་ཆོས་ཉིད་དང་མཐུན་པའི་ཕྱོགས་ལ་ཡོད་པ་ཞེས་བྱ་བ་ལྟ་བུ་ཞིག་ཡིན་གྲང་ན་། མེད་ན་མི་འབྱུང་བ་ཡོད་བཞིན་དུ་གནོད་པ་སྲིད་པ་འདི་ནི་མེད་པས་བསྒྲུབ་པར་བྱ་བ་དང་། བཟློག་པ་མེད་ན་མི་འབྱུང་བ་གཏན་ཚིགས་༄༢༥༣ཨ་༌་༎
 03101 sati sambhavati iti na sādhya-viparyaya-avibhāvinor hetu-viruddhayor 03102 viṣaye bādhā sambhavati iti na tad-abhāvaḥ pṛthag	དང་འགལ་བ་དག་གི་ཡུལ་ལ་གནོད་པ་མི་སྲིད་པའི་ཕྱིར་། དེ་མེད་པ་ནི་། ལོགས་ཤིག་ཏུ་འདི་གཉིས་ཀྱི་མཚན་ཉིད་ཉིད་དུ་བརྗོད་པར་བྱའོ་༎
 03103 anayor lakṣaṇa-antaratvena vācyaḥ| tasmād hetoḥ prayoge 03104 pratijñāyā doṣāṇāṃ sambhavo na asti| na api kevalā pratijñā	དེ་ལྟ་བས་ན་གཏན་ཚིགས་སྦྱོར་བ་ལ་དམ་བཅས་པའི་ཉེས་པ་རྣམས་མི་སྲིད་དོ་༎
 03105 prayujyata iti na pratijñā-doṣā vācyāḥ|	དམ་བཅས་པ་འབའ་ཞིག་སྦྱོར་བ་ཡང་མེད་པས་དམ་བཅས་པའི་ཉེས་པ་བརྗོད་པར་མི་བྱའོ་༎
 03106 etena eka-saṃkhyā-vivakṣā api pratyuktā| katham| eko hi sva-	འདིས་ནི་གྲངས་གཅིག་བརྗོད་པར་འདོད་པ་ཅན་ཡང་བསལ་བ་ཡིན་ནོ་༎ ཅི་ལྟ་བུ་གཅིག་ནི་རང་གིས་བསྒྲུབ་པར་བྱ་བ་ཡོད་པ་ཁོ་ནས་ཡོད་པའི་ཕྱིར་། དེར་འཁྲུལ་པ་མེད་པ་ཅན་ཡིན་ནོ་༎
 03107 sādhya-bhāva eva bhāvāt tad-avyabhicārī| tatra eva tasmād anyas 03108 tad-bādhakasya eva bhāvāt tad-viruddha ity atra bādhayā 03109 samānam|	དེ་ཉིད་ལ་དེ་ལས་གཞན་པ་དེ་གནོད་པར་བྱེད་པ་ཁོ་ན་ཡང་ཡོད་པའི་ཕྱིར་དེ་དང་འགལ་བས་འདིར་གནོད་པ་དང་མཚུངས་སོ་༎
 03110 api ca kiṃ vastuto asambhavat-pratihetuḥ sa samyag-jñāna-	གཞན་ཡང་ཅི་དངོས་སུ་གཏན་ཚིགས་ཀྱི་ཟླ་བོ་མི་སྲིད་པ་དེ་ཡང་དག་པའི་ཤེས་པའམ་།
 03111 viparyaya-hetur āhosvid apradarśita-pratihetuḥ kiṃ ca ataḥ|	བཟློག་པའི་རྒྱུ་ཡིན་ནམ་། འོན་ཏེ་གཏན་ཚིགས་ཀྱི་ཟླ་བོ་རབ་ཏུ་མ་བསྟན་པ་ཞིག་ཡིན་། ཅིར་འགྱུར་།
 03112 yady asambhavat-pratihetuḥ,	གལ་ཏེ་གཏན་ཚིགས་ཀྱི་ཟླ་བོ་མ་བསྟན་པ་ཞིག་ཡིན་ནོ་ཞེ་ན་ནི་།
 aśakya-niścayatvād alakṣaṇam	ངེས་པར་བྱ་བར་མི་ནུས་པའི་ཕྱིར་།
 03113 etat| hetv-abhāvo vā| na hy aniścita-ātmanaḥ pratipādaka-dharmasya	འདི་མཚན་ཉིད་མ་ཡིན་ནོ་༎ གཏན་ཚིགས་མེད་པ་ཡང་མ་ཡིན་ཏེ་། སྒྲུབ་བར་བྱེད་པའི་ཆོས་མ་ངེས་པའི་བདག་ཉིད་ནི་།
 03114 tal-lakṣaṇatvaṃ bhavati yathā sandigdha-pakṣadharmatvasya,	དེའི་མཚན་ཉིད་མ་ཡིན་ཏེ་། ཕྱོགས་ཀྱི་ཆོས་ཐེ་ཚོམ་ཅན་བཞིན་ནོ་༎
 03115 na api sandigdha-lakṣaṇo hetur bhavati iti na kaścid hetur	ཐེ་ཚོམ་ཅན་གྱི་མཚན་ཉིད་ནི་། གཏན་ཚིགས་ཀྱང་མ་ཡིན་པས་། འགའ་ཡང་གཏན་ཚིགས་སུ་མི་འགྱུར་ཏེ་།
 03116 bhavet| tulya-lakṣaṇe hi dṛṣṭaḥ pratiyogi-sambhavo adṛṣṭa-	མཚན་ཉིད་མཚུངས་པ་ལ་ཟླ་བོ་སྲིད་པ་མཐོང་ན་།
 03117 pratiyogiṣv api śaṅkām utpādayati, viśeṣa-abhāvāt; sati vā	ཟླ་བོ་མ་མཐོང་བ་ལ་ཡང་དོགས་པ་སྐྱེད་པར་བྱེད་དེ་ཁྱད་པར་མེད་པའི་ཕྱིར་རོ་༎
 03118 viśeṣe hetor lakṣaṇam;	ཁྱད་པར་ཡོད་ན་ནི་གཏན་ཚིགས་ཀྱི་མཚན་ཉིད་ཡིན་ཏེ་།
 tato hi hetur ekāntena nirasta-pratipakṣaḥ 03119 sva-sādhyaṃ niścāyayati ity atal-lakṣaṇo na hetuḥ syāt| tathā ca	དེས་གཉེན་པོ་གཅིག་ཏུ་བསལ་བའི་གཏན་ཚིགས་ཀྱིས་རང་གི་བསྒྲུབ་པར་བྱ་བ་ངེས་པར་བྱེད་པས་དེའི་མཚན་ཉིད་ཅན་མ་ཡིན་པ་གཏན་ཚིགས་སུ་མི་འགྱུར་རོ་༎ 
 03120 vyartha-eka-saṃkhyā-vivakṣā| ato viruddhāvyabhicāriṇo lakṣaṇaṃ	དེ་ལྟ་ན་གྲངས་གཅིག་བརྗོད་པར་འདོད་པ་ཅན་དོན་མེད་པ་ཡིན་ནོ་༎ འདིའི་ཕྱིར་འགལ་བར་འཁྲུལ་པ་མེད་པའི་མཚན་ཉིད་ཉམས་པར་འགྱུར་ཏེ་།
 03121 hīyeta svalakṣaṇa-yuktayor hetvor ekatra dharmiṇi virodhena upanipāte 03122 viruddhāvyabhicārī iti| na ca tasya viśeṣasya svarūpaṃ 03123 nirdiśyate, yat pratītya pratiyoginaḥ sambhava-asambhavāv	རང་གི་མཚན་ཉིད་དང་ལྡན་པའི་གཏན་ཚིགས་དག་ཆོས་ཅན་གཅིག་ལ་འགལ་བར་འདུ་ན་འགལ་བ་འཁྲུལ་པ་མེད་པ་ཞེས་བྱའོ་༎ གང་ཞིག་རྟོགས་ནས་ཟླ་བོ་སྲིད་དམ་མི་སྲིད་པ་དག་བལྟ་བར་བྱ་བ་ཁྱད་པར་དེའི་ངོ་བོ་ཡང་མི་སྟོན་ཏམ་།
 03124 utpaśyāmaḥ| tasmān na asty eva viśeṣa iti sarvatra śaṅkayā 03201 bhavitavyam;	དེ་ལྟ་བས་ན་ཁྱད་༄༢༥༣བ་པར་མེད་པ་ཁོ་ན་ཡིན་པས་། ཐམས་ཅད་དུ་དོགས་པར་འགྱུར་རོ་༎
 dṛṣṭa-pratihetor api hetoḥ prāg itareṇa na kaścid	ཟླ་བོའི་གཏན་ཚིགས་མཐོང་བའི་གཏན་ཚིགས་ཀྱང་། དང་པོར་ཅིག་ཤོས་དང་། ཁྱད་པར་ཅུང་ཟད་ཀྱང་མི་དམིགས་སོ་༎
 03202 viśeṣo lakṣyate| na ca sambhavat-pratihetūnām api sarvadā 03203 tasya upalabdhiḥ; atiśayavatī tu prajñā-utprekṣiṇī dṛṣṭā| tena aniścayaḥ	ཟླ་བོའི་གཏན་ཚིགས་སྲིད་པ་རྣམས་ཀྱི་ཡང་དེ་ཐམས་ཅད་དུ་མི་དམིགས་པ་ནི་མ་ཡིན་ནོ་༎ ཤེས་རབ་ཕུལ་དུ་བྱུང་བ་དང་ལྡན་པས་བརྟགས་ན་མཐོང་སྟེ་།
 03204 sambhava-asambhavayor iti lakṣaṇasya aniścitatvān na	དེས་ན་སྲིད་པ་དང་མི་སྲིད་པ་དག་མ་ངེས་པས་མཚན་ཉིད་མ་ངེས་པའི་ཕྱིར་།
 03205 kaścid hetuḥ syāt|	འགའ་ཡང་གཏན་ཚིགས་སུ་འགྱུར་རོ་༎
 03206 atha apradarśita-pratihetuḥ,	འོན་ཏེ་ཟླ་བོའི་གཏན་ཚིགས་རབ་ཏུ་མ་བསྟན་པ་ཞིག་ཡིན་ཏེ་།
 yathā āha: yadā tarhi śabdatvaṃ 03207 nityam abhyupagacchati, tadā ayaṃ hetur eva syāt,	ཇི་སྐད་དུ་འོ་ན་ནི་གང་གི་ཚེ་སྒྲ་ཉིད་རྟག་པར་ཁས་ལེན་པ་དེའི་ཚེ་འདིའི་གཏན་ཚིགས་ཁོ་ནར་འགྱུར་རོ་༎
 yady atra anityatva 03208 hetuṃ kṛtakatva-ādi kaścin na darśayed iti| idam aprakāśyam	གལ་ཏེ་འདི་ལ་མི་རྟག་པ་ཉིད་ཀྱི་གཏན་ཚིགས་བྱས་པ་ཉིད་ལ་སོགས་པ་འགའ་ཞིག་ཀྱང་བསྟན་པར་མ་གྱུར་ནའོ་ཞེས་བཤད་པ་ལྟ་བུའོ་ཞེ་ན་། འདི་ནི་བསྒྲགས་སུ་ཡང་མི་རུང་ལ་།
 03209 apy asaṃvaraṇīyam api iti kaṣṭhataraṃ vyasanam āyātaṃ	བཅབ་ཏུ་ཡང་མི་རུང་བས་མི་བཟད་པའི་སྐབས་སུ་ཆུད་པ་ཡིན་ན་།
 03210 kathaṃ nirvoḍhuṃ śakyeta| sa tāvad ayaṃ hetur vastūni	ཇི་ལྟ་ཞིག་ཏུ་བརྒལ་བར་ནུས་།
 03211 sva-sādhya-tattva-prakṛtīni kṛtvā tat-pramāṇakān puruṣān abhyudaya	གཏན་ཚིགས་འདིས་ཇེ་དངོས་པོ་རྣམས་ཀྱང་རང་གིས་བསྒྲུབ་པར་བྱ་བའི་དེ་ཉིད་ཀྱི་རང་བཞིན་དུ་བྱས་ཤིང་། དེའི་ཚད་མ་ཅན་གྱི་སྐྱེས་བུ་རྣམས་ཀྱང་།
 03212 niḥśreyasābhyāṃ saṃyojayitvā punaḥ pratibhāvatā	མངོན་པར་མཐོ་བ་དང་། ངེས་པར་ལེགས་པ་དག་ལ་ཡང་དག་པར་སྦྱར་ནས་།
 03213 puruṣeṇa hetv-antara-nidarśanena utkīlita-sādhana-sāmarthyas tāni	ཡང་ཕྱིར་ཁྱོད་ཀྱིས་སྐྱེས་བུས་གཏན་ཚིགས་གཞན་བསྟན་པས་སྒྲུབ་པར་བྱེད་པའི་ནུས་པ་མེད་པར་བྱས་ཏེ་། 
 03214 vastūni tāṃś ca puruṣān tadbhāva-sampadaḥ pracyāvya-	དངོས་པོ་དེ་དག་དང་། སྐྱེས་བུ་དེ་དག་ཀྱང་དེའི་དངོས་པོ་དང་ཕུན་སུམ་ཚོགས་པ་ལས་ཉམས་པར་བྱས་ནས་།
 03215 bhraṣṭa-rājya iva rājā tapovanaṃ gacchati iti kiṃ atra brūmaḥ|	རྒྱལ་པོ་རྒྱལ་སྲིད་ཤོར་བ་ལྟར་དཀའ་ཐུབ་ཀྱི་ནགས་ཚལ་དུ་འགྲོ་བས་འདིར་ཇི་སྐད་སྨྲ་བར་བྱ་། 
 03216 puruṣa-pratibhākṛtaṃ ca sādhanatvam| tat kiṃ vastutaḥ	སྒྲུབ་པ་ཉིད་སྐྱེས་བུའི་སྤོབས་པས་བྱས་པ་ཡང་ཡིན་ཏེ་། དེ་ནི་དངོས་སུ་སྨྲ་བའམ་། སྒྲུབ་པ་མ་ཡིན་པ་ཅི་ཞིག་ཡོད་།
 03217 sādhanam asādhanaṃ vā| sa ca hetuḥ svabhāvatas tad-dharma-bhāvī	གཏན་ཚིགས་ཀྱི་ངོ་བོ་ཉིད་ཀྱིས་ཆོས་དེ་ཡོད་པ་ཅན་ཞིག་ཡིན་ན་ནི་།
 03218 yadi katham anyathā kriyeta,	ཇི་ལྟར་གཞན་དུ་བྱེད་པར་འགྱུར་ཏེ་།
 vastūnāṃ svabhāva-anyathābhāvasya 03219 ubhayoś ca viruddha-svabhāvayor abhāvāt| atad-dharma-bhāvī	དངོས་པོ་རྣམས་ཀྱི་ངོ་བོ་ཉིད་གཞན་དུ་འགྱུར་བ་དང་། ངོ་བོ་ཉིད་འགལ་བ་གཉིས་ཀྱང་མེད་པའི་ཕྱིར་རོ་༎
 03220 ca katham anyadā api sādhanaṃ kasyacit|	ཆོས་དེའི་ཡོད་པ་ཅན་མ་ཡིན་པ་ཞིག་ཡིན་ན་ཡང་གཞན་དུ་ཡང་ཇི་ལྟར་འགའ་ཞིག་གིས་སྒྲུབ་པ་ཡིན་། 
 03221 tasmāt svabhāvataḥ sva-sādhya-avinābhāvinor ukta-lakṣaṇayoḥ	དེ་ལྟ་བས་ན་ངོ་བོ་ཉིད་ཀྱིས་རང་གིས་བསྒྲུབ་པར་བྱ་བ་མེད་ན་མི་འབྱུང་བར་བཤད་པའི་མཚན་ཉིད་ཅན་འབྲས་བུ་དང་རང་བཞིན་དག་གི་དེའི་མཚན་ཉིད་ལ་ཟླ་སྒྲུབ་པ་ཡིན་། 
 03222 kārya-svabhāvayos tal-lakṣaṇasya pratihetor asambhavād alakṣaṇam	༄༢༥༤ཨ་༌་༎ བོའི་གཏན་ཚིགས་མི་སྲིད་པའི་ཕྱིར་རོ་༎
 03301 eka-saṃkhyā-vivakṣā,	གྲངས་གཅིག་བརྗོད་པར་འདོད་པ་ཅན་ནི་མཚན་ཉིད་མ་ཡིན་ཏེ་།
 vyavacchedya-abhāvāt|	རྣམ་པར་གཅད་པར་བྱ་བ་མེད་པའི་ཕྱིར་རོ་༎
 03302 jñānaṃ punar aliṅga-dharmatve kathaṃ liṅga-lakṣaṇaṃ 03303 bhaviṣyati| kiṃ-rūpāl liṅgād artho jñātavya iti cintāyāṃ pratipattur	ཤེས་པ་ཉིད་ནི་རྟགས་ཀྱི་ཆོས་མ་ཡིན་ན་ཇི་ལྟར་རྟགས་ཀྱི་མཚན་ཉིད་དུ་འགྱུར་། རྟགས་ངོ་བོ་ཇི་ལྟ་བུ་ཞིག་ལས་དོན་རྟོགས་པར་བྱ་ཞེས་བསམ་པར་བྱ་བ་ལ་།
 03304 avisaṃvādakasya rūpam abhidhīyate, yasya darśanād	རྟོགས་པར་བྱེད་པ་ལ་སླུ་བར་མི་བྱེད་པའི་ངོ་བོ་ལ་བྱ་སྟེ་།
 03305 ayaṃ sādhana-asādhane pravibhajya tasya iṣṭa-artha-saṃnidhāna	གང་ཞིག་མཐོང་ནས་འདིས་སྒྲུབ་པ་དང་། སྒྲུབ་པ་མ་ཡིན་པ་དག་རྣམ་པར་ཕྱེ་ནས་།
 03306 pratyayāt pravṛttim avalambate| tathā yad asya ātma-rūpaṃ tal	དེ་ལ་འདོད་པའི་དོན་ཉེ་བར་འཇོག་པར་བྱེད་པ་ལ་ཡིད་ཆེས་ནས་འཇུག་པར་འགྱུར་བ་ཡིན་ནོ་༎ དེ་ལ་འདིའི་བདག་གི་ངོ་བོ་གང་ཡིན་པ་དེ་ནི་མཚན་ཉིད་ཡིན་གྱི་གཞན་གྱི་ངོ་བོ་ནི་མ་ཡིན་ནོ་༎
 03307 lakṣaṇam, na tu pararūpam| pratipatti-janmany upayoga-mātrāt	རྟོགས་པ་སྐྱེ་བ་ལ་ཉེ་བར་སྦྱོར་བ་ཙམ་གྱིས་དེའི་མཚན་ཉིད་ཡིན་ན་ནི་།
 03308 tal-lakṣaṇatve atiprasaṅgaḥ| evaṃ prameya-puruṣa-ādīnām api	ཧ་ཅང་ཐལ་བར་འགྱུར་རོ་༎ དེ་ལྟ་ན་ནི་གཞལ་བྱ་དང་སྐྱེས་བུ་ལ་སོགས་པ་ཡང་དེའི་མཚན་ཉིད་དུ་འགྱུར་ཏེ་།
 03309 tal-lakṣaṇatvaṃ bhavet, na hi teṣv asatsu liṅgini jñānaṃ bhavati|	དེ་དག་མེད་པར་ནི་རྟགས་ཅན་ལ་ཤེས་པ་མི་སྐྱེའོ་༎
 03310 niścita-grahaṇaṃ tarhi na kartavyam| na na kartavyam, 03311 tasya anya-arthatvāt| sapakṣa-vipakṣayor darśana-adarśanābhyāṃ gamakaṃ	འོ་ན་ནི་ངེས་པ་སྨོས་པར་མི་བྱའོ་ཞེ་ན་། མི་བྱ་བ་མ་ཡིན་ཏེ་། དེ་ནི་གཞན་གྱི་དོན་དུ་ཡིན་པའི་ཕྱིར་རོ་༎
 03312 hetum icchatāṃ na eva samartho hetur bhavati, sator api 03313 darśana-adarśanayor agamakatva-darśanāt| tena bhāva-abhāvābhyāṃ 03314 gamaka iti jñāpana-arthaṃ niścita-grahaṇam| tena pararūpaṃ	མཐོང་བ་དང་མ་མཐོང་བ་དག་གིས་གཏན་ཚིགས་ཤེས་པ་བྱེད་པ་ཡིན་པར་འདོད་པ་དག་གིས་གཏན་ཚིགས་ནུས་པར་མི་འགྱུར་བ་ཁོ་ན་སྟེ་། མཐོང་བ་དང་། མ་མཐོང་བ་དག་ཡོད་བཞིན་དུ་ཡང་ཤེས་པར་བྱེད་པ་ཉིད་མ་ཡིན་པ་མཐོང་བའི་ཕྱིར་རོ་༎ དེས་ན་ཡོད་པ་དང་མེད་པ་དག་གིས་ཤེས་པར་བྱེད་པ་ཡིན་ནོ་ཞེས་ཤེས་པར་བྱ་བའི་ཕྱིར་ངེས་པ་སྨོས་སོ་༎
 03315 lakṣaṇaṃ na bhavati,	དེས་ན་གཞན་གྱི་ངོ་བོ་ནི་མཚན་ཉིད་མ་ཡིན་ཏེ་།
 tena liṅgasya rūpa-viśeṣa-anabhidhānāt, tau	དེས་རྟགས་ཀྱི་ངོ་བོའི་ཁྱད་པར་མི་སྟོན་པའི་ཕྱིར་རོ་༎
 03316 hi bhāva-abhāvau tad-bhāva-sādhaka-vṛttyā boddhavyau,	ཡོད་པ་དང་མེད་པ་དེ་དག་ནི་དེའི་ངོ་བོ་སྒྲུབ་པ་འཇུག་པས་ཁོང་དུ་ཆུད་པར་བྱ་སྟེ་། 
 upāya-antara- 03317 abhāvāt| tena,	ཐབས་གཞན་མེད་པའི་ཕྱིར་རོ་༎
 yady api bhāva-abhāva-vacana-mātreṇa tat-sādhana- 03318 pramāṇam ākṣipyate,	དེས་ན་ཡོད་པ་དང་། མེད་པ་སྨོས་པ་ཙམ་གྱིས་ཀྱང་དེ་བསྒྲུབ་པའི་ཚད་མ་འཕེན་མོད་ཀྱི་།
 tayoḥ pratipādanāya niścita-śabdaḥ	འདི་གཉིས་གསལ་བར་བྱ་བའི་ཕྱིར་།
 03319 prayukto lakṣaṇe,	མཚན་ཉིད་ལ་ལས་ངེས་པ་ཞེས་བྱ་བའི་སྒྲ་རབ་ཏུ་སྦྱོར་བ་ཡིན་ནོ་༎
 anyathā jñāna-sattā-nibandhanatvāj jñeya-	དེ་ལྟ་མ་ཡིན་ན་ཤེས་བྱ་ཡོད་པར་རྣམ་པར་གཞག་པ་ནི་ཤེས་པ་ཡོད་པའི་རྒྱུ་རྐྱེན་ཡིན་པའི་ཕྱིར་། 
 03320 sattā-vyavasthāyās tayor eva sattā-prasiddher iti sarvatra 03401 sattā-vyavasthā eva tat-sādhanaṃ pramāṇam ākarṣati| parārthatvāc	དེ་གཉིས་ཉིད་ཡོད་པར་རབ་ཏུ་མི་འགྲུབ་པས་ཐམས་ཅད་ལ་ཡོད་པ་རྣམ་པར་གཞག་པ་ཉིད་དེ་སྒྲུབ་པ་དང་ལྡན་པའི་ཚད་མ་འདྲེན་པ་ཡིན་ནོ༎
 03402 ca śāstra-praṇayanasya| trirūpaṃ liṅgaṃ saṃvādakam	༄༢༥༤བ་བསྟན་བཅོས་བྱེད་པ་ནི་གཞན་གྱི་དོན་ཡིན་པའི་ཡང་ཕྱིར་ཏེ་། ཚུལ་གསུམ་པའི་རྟགས་ཡོད་པ་ནི་། དོན་འདོམས་པར་བྱེད་པ་ཡིན་ནོ་ཞེས་བྱ་བ་ལ་།
 03403 arthasya iti tad rūpaṃ ye na vidanti,	གང་དག་ཚུལ་དེ་མི་ཤེས་པ་དེ་དག་ནི་།
 na teṣāṃ tataḥ pravṛttir iti 03404 para-upalakṣaṇatvād yady api jñānaṃ siddham,	དེས་མི་འཇུག་པས་གཞན་ཤས་པར་བྱེད་པ་ཡིན་པའི་ཕྱིར་ཤེས་པ་གྲུབ་མོད་ཀྱི་།
 tathā api tāv eva 03405 bhāva-abhāvau kecid darśana-adarśana-mātreṇa vyavasthāpayanti iti	འོན་ཀྱང་ཁ་ཅིག་ཡོད་པ་དང་། མེད་པ་དེ་དག་ཁོ་ན་མཐོང་བ་དང་། མ་མཐོང་བ་ཙམ་གྱིས་རྣམ་པར་འཇོག་པར་བྱེད་པས་།
 03406 tan-niṣedha-artho niścita-śabda uktaḥ,	དེ་དགག་པའི་ཕྱིར་ངེས་པའི་སྒྲ་སྨོས་སོ་༎
 sator api bhāva-abhāvayor 03407 anvaya-vyatirekayoḥ sattāyāṃ saṃśayāt| tasmād yataḥ sattā-	ཡོད་པ་དང་མེད་པ་དག་ཡོད་ཀྱང་རྗེས་སུ་འགྲོ་བ་དང་། ལྡོག་པ་དག་ཡོད་པ་ལ་ཐེ་ཚོམ་ཟ་བའི་ཕྱིར་།
 03408 prasādhaka-pramāṇād anayor niścayas tad-adhīnā iti jñāpana-artham	ཡོད་པར་རབ་ཏུ་འགྲུབ་པ་ནི་ཚད་མ་གང་ལས་འདི་གཉིས་ངེས་པ་དེ་ལ་རག་ལུས་པ་ཡིན་ནོ་ཞེས་ཤེས་པར་བྱ་བའི་ཕྱིར་།
 03409 asmābhir grahaṇaṃ kṛtam|	ཁོ་བོས་སྨོས་པར་བྱས་པ་ཡིན་ནོ་༎
 03410 yato api bhāva-abhāva-vacana-mātreṇa tat-sādhana-pramāṇa-ākṣepa-siddhiḥ, 03411 pṛthag ato jñānaṃ lakṣaṇaṃ na bhavati,	གང་གི་ཕྱིར་ཡོད་པ་དང་མེད་པ་སྨོས་པ་ཙམ་གྱིས་དེ་སྒྲུབ་པའི་ཚད་མ་འཕེན་པར་འགྲུབ་པ་དེའི་ཕྱིར་ཡང་ཤེས་པ་ནི་མཚན་ཉིད་ཐ་དད་པར་གྱུར་པ་མ་ཡིན་ཏེ་།
 tena eva arthasya avagatatvād	དེ་ཉིད་ཀྱི་དོན་རྟོགས་པའི་ཕྱིར་།
 03412 upanaya-artha-vat pakṣadharmatvāt| anvaya-vyatirekayor	ཕྱོགས་ཀྱི་ཆོས་ཉིད་ལས་ཉེ་བར་གཏོད་པའི་དོན་བཞིན་ནོ་༎ འོ་ན་ནི་རྗེས་སུ་འགྲོ་བ་དང་ལྡོག་པ་དག་ཀྱང་སོ་སོ་ཉིད་མ་ཡིན་ཏེ་།
 03413 api tarhi na pṛthaktvam, ekasya prayogād ubhaya-gater	གཅིག་སྦྱར་བས་གཉི་ག་རྟོགས་པའི་ཕྱིར་རོ་ཞེ་ན་མ་ཡིན་ཏེ་།
 03414 iti cet, na, hetoḥ sapakṣa-asapakṣayor bhāva-abhāvayor aparaspara- 03415 ākṣepāt; ekaṃ vākyam ubhayaṃ gamayati ity ucyate,	མཐུན་པའི་ཕྱོགས་དང་མི་མཐུན་པའི་ཕྱོགས་དག་ལ་གཏན་ཚིགས་ཡོད་པ་དང་། མེད་པ་དག་ནི་ཕན་ཚུན་ལྟོས་ནས་ཚིག་གཅིག་གིས་གཉི་ག་གོ་བར་བྱེད་དོ་ཞེས་བྱའི་། གཉིས་པ་དང་དོན་གཅིག་པ་ནི་མ་ཡིན་ནོ་༎
 03416 na eko artho dvitīyasya| nanu tatra eva bhāvo tad-abhāve 03417 ca abhāva iti vākye paraspara-ākṣepa iti cet, vacanam etad ekasya	དེ་ཁོ་ན་ལ་ཡོད་པ་དང་མེད་པ་ལ་མེད་པ་ཞེས་བྱ་བའི་ཚིག་ཕན་ཚུན་འཕེན་པ་མ་ཡིན་ནམ་ཞེ་ན་།
 03418 api niyama-khyāpakasya dvitīya-ākṣepa-nāntarīyakatvāt sāmarthyād	ངེས་པ་སྟོན་པ་གཅིག་ཀྱང་འཕེན་པ་གཉིས་པ་མེད་ན་མེད་པའི་ཕྱིར་ཚིག་འདིས་ནི་ཤུགས་ཀྱིས་གཉི་ག་འཕེན་པར་བྱེད་ཀྱི་།
 03419 ubhayam ākṣipati na punaḥ kevalau bhāva-abhāvāv ākṣipataḥ;	ཡོད་པ་དང་མེད་པ་འབའ་ཞིག་འཕེན་པར་བྱེད་པ་ནི་མ་ཡིན་ནོ་༎
 03420 niyamavantau ca na kevalau,	ངེས་པ་དང་ལྡན་པ་དག་ནི་འབའ་ཞིག་པ་དག་མ་ཡིན་ཏེ་།
 niyamasya ubhaya-rūpatvāt|	ངེས་པ་ནི་གཉི་གའི་ངོ་བོ་ཡིན་པའི་ཕྱིར་རོ་༎
 03421 tasmāt tatra eva bhāva iti na bhāva eva ucyate,	དེ་ལྟ་བས་ན་གང་གིས་ན་ཡོད་པའམ་། མེད་པ་གཉིས་པ་འཕེན་པར་འགྱུར་བ་དེ་ལ་ཡོད་པ་ཉིད་ཅེས་བྱ་བ་ཡང་ཡོད་པ་འབའ་ཞིག་ལ་མི་བྱ་ལ་།
 itareṇa api na abhāva	ཅིག་ཤོས་ཀྱིས་ཀྱང་མེད་པ་འབའ་ཞིག་མ་ཡིན་ནོ་༎
 03501 eva, yena bhāvo abhāvo vā dvitīyam ākṣipet| na evaṃ jñānaṃ 03502 para-upalakṣaṇāt trailakṣaṇyād vyatirekitam iti na lakṣaṇa-antaram|	ཤེས་པ་ནི་དེ་ལྟར་གཞན་ཤེས་པར་བྱེད་པའི་མཚན་ཉིད་གསུམ་པ་ལས་ཐ་དད་པ་མ་ཡིན་པས་། མཚན་ཉིད་གཞན་མ་ཡིན་ནོ་༎
 03503 tasmān na hetuḥ ṣaḍ-lakṣaṇaḥ|	དེ་ལྟ་བས་ན་གཏན་ཚིགས་༄༢༥༥ཨ་༌་༎ ནི་མཚན་ཉིད་དྲུག་པ་མ་ཡིན་ནོ་༎
