skt	tib
 1| sādhanaṃ dūṣaṇaṃ caiva sābhāsaṃ parasaṃvide |	བསྒྲུབ་དང་སུན་ནི་འབྱིན་པ་དང་། ལྟར་སྣང་བཅས་པས་གཞན་རིག་བྱེད་༎
 pratyakṣam anumānaṃ ca sābhāsaṃ tv ātmasaṃvide ||	མངོན་སུམ་དང་ནི་རྗེས་དཔག་གཉིས་༎ ལྟར་སྣང་བཅས་པས་བདག་རིག་བྱེད་༎
 iti śāstrārthasaṃgrahaḥ ||	འདི་ནི་བསྟན་བཅོས་ཀྱི་དོན་བསྡུས་པའོ་༎
 2| vādinā svayaṃ sādhayitum iṣṭo 'rthaḥ sādhyaḥ |	རྒོལ་བ་བདག་ཉིད་ཀྱིས་བསྒྲུབ་པར་འདོད་པའི་དོན་ནི་བསྒྲུབ་པར་བྱའོ་༎
 sādhyate yena tat sādhanam |	གང་གིས་སྒྲུབ་པར་བྱད་པ་དེ་ནི་བསྒྲུབ་པ་ཡིན་ཏེ་།
 3| hetos trirūpavacanam |	གཏན་ཚིགས་ཀྱི་ཚུལ་གསུམ་བརྗོད་པའོ་༎
 kāni punas tāni triṇi rūpāṇi |	ཚུལ་གསུམ་པོ་དེ་དག་ཀྱང་གང་ཞེ་ན་།
 pakṣe sattvam evety ekaṃ rūpam |	ཕྱོགས་ལ་ཡོད་པ་ཉིད་ནི་ཚུལ་གཅིག་གོ་༎
 sapakṣa eva sattvam iti dvitīyaṃ rūpam |	མཐུན་པའི་ཕྱོགས་ཉིད་ལ་ཡོད་པ་ཞེས་བྱ་བ་ནི་ཚུལ་གཉིས་པའོ་༎
 vipakṣe cāsattvam eva niścitam iti tṛtīyam ||	མི་མཐུན་པའི་ཕྱོགས་ལ་མེད་པ་ཉིད་དུ་ངེས་པ་ཞེས་བྱ་བ་ནི་༄༣༡༤བ་ཚུལ་གསུམ་པའོ་༎
 4| tatra pakṣaḥ prasiddho dharmī prasiddheṇa viśeṣeṇa viśiṣṭaḥ svayaṃ sādhayitum iṣṭaḥ pratyakṣādyaviruddhaḥ |	དེ་ལ་ཕྱོགས་ནི་རབ་ཏུ་གྲུབ་པའི་ཆོས་ཅན་ནོ་༎ རབ་ཏུ་གྲུབ་པའི་ཁྱད་པར་གྱི་བྱེ་བྲག་བདག་ཉིད་སྒྲུབ་པར་འདོད་པ་མངོན་སུམ་ལ་སོགས་པ་དང་འགལ་བ་མེད་པ་ཡིན་ཏེ་།
 yathā śabdo dharmī anityatvena viśeṇa viśiṣtaḥ sādhyate kṛtakatvād iti hetuḥ ||	དཔེར་ན་ཆོས་ཅན་སྒྲ་མི་རྟག་པའི་ཁྱད་པར་གྱི་བྱེ་བྲག་དང་ལྡན་པ་ནི་བསྒྲུབ་པར་བྱའོ་༎ བྱས་པའི་ཕྱིར་རོ་ཞེས་བྱ་བ་ནི་གཏན་ཚིགས་ཡིན་པ་བཞིན་ནོ་༎
 5| kaḥ sapakṣaḥ |	མཐུན་པའི་ཕྱོགས་གང་ཞེ་ན་།
 sādhyadharmeṇa sāmānyena samānaḥ sapakṣo yathā ghaṭādir iti ||	བསྒྲུབ་པར་བྱ་བའི་ཆོས་ཀྱི་སྤྱིས་མཐུན་པ་ནི་མཐུན་པའི་ཕྱོགས་ཏེ་། དཔེར་ན་བུམ་པ་ལ་སོགས་པ་ལྟ་བུའོ་༎
 6| ko vā hetor vipakṣaḥ |	གཏན་ཚིགས་ཀྱི་མི་མཐུན་པའི་ཕྱོགས་གང་ཞེ་ན་།
 yatra sādhyābhāvena hetor abhāvo niyamena kathyate [ yathākāśādir iti ||	གང་དུ་བསྒྲུབ་པར་བྱ་བ་མེད་པས་གཏན་ཚིགས་མེད་པར་ངེས་པར་སྟོན་པ་ཡིན་ཏེ་། དཔེར་ན་ནམ་མཁའ་ལ་སོགས་པ་བཞིན་ནོ་༎
 7| etad eva ca hetos trirūpavacanaṃ parapratyāyanāya prayujyamānaṃ parārtham anumānam ucyate |	གཏན་ཚིགས་ཀྱི་ཚུལ་གསུམ་པ་བསྟན་པ་དེ་ཉིད་ཀྱིས་གཞན་ཁོང་དུ་ཆུད་པའི་ཆེད་དུ་སྦྱོར་བར་བྱས་པ་ནི་གཞན་གྱི་དོན་རྗེས་སུ་དཔག་བ་ཞེས་བསྟན་ཏོ་༎ 
 yathā anityaḥ śabda iti pakṣavacanaṃ kṛtakatvād iti hetuvacanam |	དཔེར་ན་སྒྲ་མི་རྟག་གོ་ཞེས་བྱ་བ་ནི་ཕྱོགས་བརྗོད་པའོ་༎ བྱས་པའི་ཕྱིར་རོ་ཞེས་བྱ་བ་ནི་གཏན་ཚིགས་བརྗོད་པའོ་༎
 ghaṭādivad iti sapakṣavacanaṃ |	བུམ་པ་ལ་སོགས་པ་བཞིན་ནོ་ཞེས་བྱ་བ་ནི་མཐུན་པའི་ཕྱོགས་བརྗོད་པའོ་༎
 ākāśavad iti vipakṣavacanam ||	ནམ་མཁའ་ལ་སོགས་པ་བཞིན་ནོ་ཞེས་བྱ་བ་ནི་མི་མཐུན་པའི་ཕྱོགས་བརྗོད་པའོ་༎
 8| tat punar dvividhaṃ dṛṣṭam |	དེ་ཡང་རྣམ་པ་གཉིས་སུ་སྣང་སྟེ་།
 sādharmyeṇa vaidharmyeṇa ca | (htu 262)	ཆོས་མཐུན་པ་དང་མ་ཆོས་མི་མཐུན་པའོ་།
 9| tatra sādharmyeṇa tāvat |	དེ་ལ་རེ་ཞིག་ཆོས་མཐུན་པ་ནི་༎
 yat kṛtakaṃ tat sarvam anityaṃ dṛṣṭam |	གང་བྱས་པ་དེ་ཐམས་ཅད་ནི་མི་རྟག་པར་མཐོང་བ་༎
 yathā ghaṭādiḥ |	དཔེར་ན་བུམ་པ་ལ་སོགས་པའོ་༎
 kṛtakaś ca śabda iti ||	སྒྲ་ཡང་བྱས་པའི་ཕྱིར་ཞེས་བྱ་བ་ལྟ་བུའོ་༎
 10| vaidharmyeṇa punaḥ | asaty anityatve na bhavaty eva kṛtakatvaṃ yathākāśādau |	ཡང་ཆོས་མི་མཐུན་པ་ནི་མི་རྟག་པ་ཉིད་མེད་ན་བྱས་པ་ཉིད་མེད་དེ་༎ དཔེར་ན་ནམ་མཁའ་ལ་སོགས་པ་བཞིན་ཏེ་།
 śabdas tu kṛtaka iti ||	སྒྲ་ཡང་བྱས་པའི་ཕྱིར་ཞེས་བྱ་བ་ལྟ་བུའོ་༎
 11| kaḥ punaḥ pakṣābhāsaḥ |	གང་ཕྱོགས་ལྟར་སྣང་བ་ཡང་གང་ཞེ་ན་།
 yaḥ pakṣa ivābhāsate | na tu sākṣāt pakṣo bhavati |	ཕྱོགས་ལྟར་སྣང་བ་ནི་དངོས་སུ་ཕྱོགས་མ་ཡིན་པ་ཡིན་ཏེ་།
 pratyakṣādibhir bādhitatvāt ||	མངོན་སུམ་ལ་སོགས་པས་གནོད་པའི་ཕྱིར་རོ་༎
 12| sa tu pakṣābhāsaḥ |	དེ་ནི་ཕྱོགས་ལྟར་སྣང་བ་སྟེ་༎
 yathā dhūmādir dharmībuddhimatā hetunā janyata iti sādhye | pratyakṣaviruddhaḥ pakṣābhāsaḥ |	དཔེར་ན་དུ་བ་ལ་སོགས་པའི་ཆོས་ཅན་བློ་དང་ལྡན་པའི་རྒྱུས་བསྐྱེད་པ་བསྒྲུབ་པར་བྱ་བ་ཡིན་ནོ་ཞེས་བྱ་བ་མངོན་སུམ་དང་འགལ་བས་ཕྱོགས་ལྟར་སྣང་བ་ཡིན་ཏེ་།
 pratyakṣeṇa vahnijanyasya dhumasya darśanāt ||	མངོན་སུམ་གྱིས་མེ་ལས་དུ་བ་སྐྱེ་བ་མཐོང་བའི་ཕྱིར་རོ་༎
 13| anumānaviruddho yathā |	རྗེས་སུ་དཔག་པ་དང་འགལ་བ་ནི་དཔེར་ན་།
 vedavākyaṃ dharmy apauruṣeyam iti sādhye |	རིག་བྱེད་ཀྱི་ཚིག་ནི་ཆོས་ཅན་སྐྱེས་བུས་བྱས་པ་མ་ཡིན་ཏེ་ཞེས་བསྒྲུབ་པར་བྱ་བ་ལ་༎ སྒྲ་ནི་བརྩལ་མ་ཐག་ཏུ་བྱུང་བ་ཡིན་པས་སྐྱེས་བུས་བྱས་པར་གྲུབ་པའི་ཕྱིར་རོ་༎ རང་གི་ཚིག་༄༣༡༥ཨ་༌་༎
 prayatnānantarīyakatve śabdasya pauruṣeyatvasya prasādhanāt || 14| svavacanaviruddho yathā | nānumānaṃ pramāṇam iti parapratipādanāya vacanam uccāryamāṇaṃ parārtham anumānam ity uktatvāt ||	དང་འགལ་བ་ནི་དཔེར་ན་རྗེས་སུ་དཔག་པ་ནི་ཚད་མ་མ་ཡིན་ནོ་ཞེས་བྱ་བ་ནི་། གཞན་གྱི་ཁོང་དུ་ཆུད་པར་བྱ་བའི་ཕྱིར་ཚིག་བརྗོད་པ་ནི་གཞན་གྱི་དོན་གྱི་རྗེས་སུ་དཔག་པ་ཡིན་ནོ་ཞེས་བསྟན་པའི་ཕྱིར་རོ་༎
 15| lokaviruddho yathā | śuci naraśiraḥkapālaṃ prāṇyaṅgatvāc chaṅkhaśuktivat ||	འཇིག་རྟེན་དང་འགལ་བ་ནི་དཔེར་ན་མི་མགོའི་ཐོད་པ་ནི་གཙང་བ་ཡིན་ཏེ་སྲོག་ཆགས་ཀྱི་ཡན་ལག་ཡིན་པའི་ཕྱིར་དུང་ཆོས་དང་ཉ་ཕྱིས་བཞིན་ནོ་ཞེས་བྱ་བ་ལྟ་བུའོ་༎
 16| pratītiviruddho yathā |	རྟོགས་པ་དང་འགལ་བ་ནི་དཔེར་ན་།
 kiyatkālasthāyī kṛtako 'nitya iti |	གང་དུས་ཇི་སྲིད་གནས་པར་བྱས་པ་ནི་མི་རྟག་པ་ཡིན་ནོ་༎
 kiyatkālasthāyino 'pi kṛtakāḥ sarve nityā iti lokapratīteḥ ||	གང་དུས་ཇི་སྲིད་གནས་པར་ཡང་བྱས་པ་ཐམས་ཅད་ནི་རྟག་པ་ཡིན་ནོ་ཞེས་འཇིག་རྟེན་པས་རྟོགས་པའི་ཕྱིར་རོ་༎
 17| aprasiddhaviśeṣaṇo yathā |	ཁྱད་པར་མ་གྲུབ་པ་ནི་དཔེར་ན་།
 vaiśeṣikasya sāṃkhyaṃ prati vināśī śabda iti sādhye || 18| aprasiddhaviśeṣyo yathā |	བྱེ་བྲག་པས་གྲངས་ཅན་པ་ལ་སྒྲ་འཇིག་པ་ཡིན་ནོ་ཞེས་བྱ་བ་ལྟ་བུའོ་༎ ཁྱད་པར་དུ་བྱས་བ་མ་གྲུབ་པ་ནི་༎
 sāṃkhyasya bauddhaṃ prati ātmā cetana iti sādhayataḥ ||	དཔེར་ན་གྲངས་ཅན་པས་སངས་རྒྱས་པ་ལ་བདག་སེམས་དང་བཅས་པ་ཡིན་ནོ་ཞེས་བསྒྲུབ་པ་ལྟ་བུའོ་༎ 
 19| ubhayāprasiddho yathā |	གཉི་ག་མ་གྲུབ་པ་ནི་དཔེར་ན་།
 vaiśeṣikasya bauddhaṃ prati sukhādisamavāyikāraṇam ātmeti (htu 263)	བྱེ་བྲག་བས་སངས་རྒྱས་པ་ལ་སྡུད་པར་བྱེད་པ་ནི་བདག་ཉིད་ཡིན་ནོ་ཞེས་བྱ་བ་ལྟ་བུའམ་༎ 
 || prasiddhasaṃbandho yathā vāyur asthirasvabhāva iti ||	ལུས་ནི་བརྟན་པའི་རང་བཞིན་ཡིན་ནོ་ཞེས་བྱ་བ་ལྟ་བུའོ་༎
 20| uktāḥ pakṣābhāsāḥ || ||	ཕྱོགས་ལྟར་སྣང་བ་བཤད་ཟིན་ཏོ་༎
 21| hetvābhāsaḥ kīdṛśaḥ |	གཏན་ཚིགས་ལྟར་སྣང་བ་ཅི་འདྲ་བ་ཞིག་ཅེ་ན་།
 yo hetur ivābhāsate | na punaḥ siddho hetur iti ||	གང་ཞིག་གཏན་ཚིགས་ལྟར་སྣང་བ་ཡིན་གྱི་གཏན་ཚིགས་སུ་གྲུབ་པ་ནི་མ་ཡིན་པའོ་༎
 22| hetvābhāso 'siddho viruddho 'naikāntikaś ceti triprakāraḥ ||	གཏན་ཚིགས་ལྟར་སྣང་བ་ནི་གསུམ་སྟེ་། མ་གྲུབ་པ་དང་འགལ་བ་དང་མ་ངེས་པའོ་༎
 23| tatra pakṣe 'siddhatvād asiddhasaṃjñako hetvābhāsaḥ | 24| pakṣasapakṣayor nāsti | vipakṣa evāsti sa viruddhasaṃjñako hetvābhāsaḥ |	དེ་ལ་ཕྱོགས་ལ་མ་གྲུབ་པའི་ཕྱིར་མ་གྲུབ་ཅེས་བྱ་བའི་གཏན་ཚིགས་ལྟར་སྣང་བ་ཡིན་ནོ་༎ ཕྱོགས་དང་མཐུན་པའི་ཕྱོགས་ལ་ནི་མེད་པ་མི་མཐུན་པའི་ཕྱོགས་ལ་ཡོད་པ་དེ་ནི་འགལ་བ་ཞེས་བྱ་བའི་གཏན་ཚིགས་ལྟར་སྣང་བ་ཡིན་༎ ཏེ་། 
 sādhyaviparyayasādhanāt ||	བསྒྲུབ་པར་བྱ་བ་ལས་ཕྱིན་ཅི་ལོག་བསྒྲུབ་པའི་ཕྱིར་རོ་༎
 25| tatra yo hetuḥ sapakṣavipakṣayor ubhayatrāsti nāsti vā saṃdihyate |	མཐུན་པའི་ཕྱོགས་དང་མི་མཐུན་པའི་ཕྱོགས་གཉི་ག་ལས་།
 aprasiddhasaṃbandho vā so 'naikāntikasaṃjñako hetvābhāsaḥ |	ཡོད་པའམ་མེད་པའམ་ཐེ་ཚོམ་ཟ་བ་ལའམ་འབྲེལ་པ་མ་གྲུབ་པའི་གཏན་ཚིགས་གང་ཡིན་པ་དེ་ནི་མ་ངེས་པའི་གཏན་ཚིགས་ལྟར་སྣག་བ་ཞེས་བྱ་བ་ཡིན་ཏེ་།
 vādinaḥ prativādino vā sādhayitum iṣṭasyaikāntasyāsādhanāt ||	རྒོལ་བ་དང་ཕྱིར་རྒོལ་བས་བསྒྲུབ་པར་འདོད་པ་ངེས་པ་མི་འགྲུབ་པའི་ཕྱིར་རོ་༎
 26| ubhayāsiddhaḥ tadyathā śabdasyānityatve sādhye cākṣuṣatvaṃ hetuḥ vādiprativādinor asiddhaḥ ||	དཔེར་ན་གཉིས་ལ་མ་གྲུབ་པ་ནི་སྒྲ་མི་རྟག་པ་ཉིད་དུ་གྲུབ་པར་བྱ་བ་ལ་། གཏན་ཚིགས་མིག་གིས་བཟུང་བ་ནི་རྒོལ་བ་དང་། ཕྱིར་རྒོལ་བ་དག་ལ་མ་གྲུབ་པ་ལྟ་བུའོ་༎ ཤིང་སེམས་དང་ལྡན་པར་བསྒྲུབ་པར་བྱ་བ་ལ་ཤུན་སྤགས་ཐམས་ཅད་བཤུས་ན་འཆི་བའི་ཕྱིར་རོ་ཞེས་བྱ་བའི་༄༣༡༥བ་གཏན་ཚིགས་ནི་།
 27| cetanās tarava iti sādhye sarvatvagapaharaṇe maraṇād iti hetuḥ prativādino bauddhasyāsiddha iti prativādyasiddhaḥ |	ཕྱིར་རྒོལ་བ་སངས་རྒྱས་པ་ལ་མ་གྲུབ་པས་ཕྱིར་རྒོལ་བ་ལ་མ་གྲུབ་པ་ཞེས་བྱ་སྟེ་། སེམས་ལ་སོགས་པ་འགགས་པ་ལ་སངས་རྒྱས་པ་འདོད་པའི་ཕྱིར་རོ་༎
 caitanyādinirodhasya bauddhenopagamāt || 28| acetanāḥ sukhādaya iti sādhye |	བདེ་བ་ལ་སོགས་པ་སེམས་མེད་པར་བསྒྲུབ་པར་བྱ་བ་ལ་སྐྱེ་བ་དང་ལྡན་པའི་ཕྱིར་ཞེས་བྱ་བའི་གཏན་ཚིགས་ནི་།
 utpattimattvād iti hetuḥ svayaṃ vādinaḥ sāṃkhyasyāsiddhaḥ |	གྲངས་ཅན་བ་རྒོལ་བ་བདག་ཉིད་ལ་མ་གྲུབ་པས་།
 iti vādyasiddha iti ||	རྒོལ་བ་ལ་མ་གྲུབ་པ་ཞེས་བྱའོ་༎ བྱེ་བྲག་པས་ཕྱིར་རྒོལ་བ་སངས་རྒྱས་པ་ལ་། ས་ལ་སོགས་པའི་ཆོས་ཅན་བྱ་བ་ཡིན་ནོ་ཞེས་བསྒྲུབ་པར་བྱ་བ་ལ་།
 29| vaiśeṣikasya bauddhaṃ prati kṣamādikaṃ dharmī kāryam iti sādhayataḥ pratikṣaṇaṃ sadṛśāparāparotpatter iti svayaṃ vādino 'siddhaḥ |	སྐད་ཅིག་རེ་རེ་འདྲ་བ་གཞན་དང་གཞན་འབྱུང་ངོ་ཞེས་བྱ་བ་ནི་རྒོལ་བ་བདག་ཉིད་ལ་མ་གྲུབ་པ་ཡིན་ཏེ་།
 utpattau siddhāyām api pratikṣaṇasadṛśāparāparotpattir ity asiddhaḥ || (htu 264)	སྐྱེ་བ་གྲུབ་ཀྱང་སྐད་ཅིག་རེ་རེ་འདྲ་བ་གཞན་དང་གཞན་འབྱུང་ངོ་ཞེས་པ་ནི་མ་གྲུབ་པའོ་༎ 
 30| pakṣaikadeśāsiddho yathā |	ཕྱོགས་ཀྱི་ཕྱོགས་གཅིག་ལ་མ་གྲུབ་པ་ནི་དཔེར་ན་ཤིང་རྣམས་ནི་སེམས་དང་ལྡན་པ་པའོ་༎ ཡིན་ཏེ་། 
 cetanās taravaḥ svāpād iti hetuḥ | digambarasya svayaṃ vādinaḥ pakṣaikadeśāsiddhaḥ |	གཉིད་ལོག་པའི་ཕྱིར་རོ་ཞེས་བྱ་བའི་གཏན་ཚིགས་ནི་ཕྱོགས་ཀྱི་གོས་ཅན་རྒོལ་བ་བདག་ཉིད་ལ་ཕྱོགས་ཀྱི་གཅིག་ལ་མ་པའོ་༎ ཡིན་ཏེ་། གྲུབ་སྟེ་། 
 na hi sarve vṛkṣā rātrau patrasaṃkocabhājaḥ ||	ཤིང་ཐམས་ཅད་མཚན་མོ་ལོ་མ་འཁུམ་པ་ལ་བརྟེན་པ་པའོ་༎ ཡིན་ཏེ་། གྲུབ་སྟེ་། མ་ཡིན་ནོ་༎ 
 31| tathā pṛthivyādikaṃ dharmī buddhimaddhetujanyam iti sādhye kāryatvād iti hetur bauddhaṃ praty asiddhaḥ |	དེ་བཞིན་དུ་ས་ལ་སོགས་པའི་ཆོས་ཅན་བློ་དང་ལྡན་པ་ལས་སྐྱེས་པ་ཡིན་ནོ་ཞེས་བསྒྲུབ་པར་བྱ་བ་ལ་འབྲས་བུ་ཡིན་ནོ་ཞེས་བྱ་བའི་གཏན་ཚིགས་ནི་སངས་རྒྱས་པ་ལ་པའོ་༎ ཡིན་ཏེ་། གྲུབ་སྟེ་། མ་ཡིན་ནོ་༎ གྲུབ་སྟེ་། 
 pratyakṣānupalambhanibandhano hi kāryakāraṇabhāvo bauddhasya pṛthivyādau na siddhaḥ |	མངོན་སུམ་དང་མི་དམིགས་པ་རྒྱུ་དང་འབྲས་བུའི་འབྲེལ་པ་བསྒྲུབ་པའི་ངོ་བོས་ས་ལ་སོགས་པ་ལ་གྲུབ་པའི་ཕྱིར་རོ་པའོ་༎ ཡིན་ཏེ་། གྲུབ་སྟེ་། མ་ཡིན་ནོ་༎ གྲུབ་སྟེ་། 
 vihārāhārādiṣu siddhaṃ cet tadā pakṣaikadeśāsiddhaḥ ||	༎ གལ་ཏེ་གནས་དང་བཟའ་བ་ལ་སོགས་པ་གྲུབ་པོ་ཞེས་ཟེར་ན་པའོ་༎ ཡིན་ཏེ་། གྲུབ་སྟེ་། མ་ཡིན་ནོ་༎ གྲུབ་སྟེ་། ༎ ། དེའི་ཚེ་ཕྱོགས་ཀྱི་ཕྱོགས་གཅིག་མ་གྲུབ་པོ་༎
 32| saṃdigdhāsiddho yathā yady ayaṃ dhūmo 'gnir atreti sādhye hetor evāniścayāt || 33| dharmisaṃdehe 'py asiddho yathā |	ཐེ་ཚོམ་ཟ་བའི་མ་གྲུབ་པ་ནི་། དཔེར་ན་གལ་ཏེ་འདི་དུ་བ་ཡིན་ན་འདི་ན་མེ་ཡོད་དོ་ཞེས་བསྒྲུབ་པར་བྱ་བ་ལ་། གཏན་ཚིགས་ཉིད་མ་ངེས་པའི་ཕྱིར་རོ་༎ ཆོས་ཅན་ཐེ་ཚོམ་ཟོས་མ་གྲུབ་པས་ནི་༎ དཔེར་ན་རི་སུལ་དུ་མ་འདི་དག་ལས་༎
 iha bahuṣu nikuñjeṣu kvacid ekasmin nikuñje mayūra iti sādhye kekāyikād iti hetuḥ ||	རི་སུལ་འགའ་ཞིག་ན་རྨ་བྱ་ཡོད་དེ་ཞེས་བསྒྲུབ་པར་བྱ་བ་ལ་རྨ་བྱའི་སྒྲ་གྲགས་པའི་ཕྱིར་རོ་ཞེས་བྱ་བའི་གཏན་ཚིགས་ཡིན་པ་ལྟ་བུའོ་༎ 
 34| dharmyasiddhāv apy asiddho yathā ātmā dharmī sarvagata iti sādhye sarvatropalabhyamānaguṇatvād iti hetuḥ ||	ཆོས་ཅན་མ་གྲུབ་པ་ཡང་མ་གྲུབ་པ་ཡིན་ཏེ་། དཔེར་ན་ཆོས་ཅན་བདག་ཐམས་ཅད་དུ་ཁྱབ་པར་བསྒྲུབ་པར་བྱ་བ་ལ་། ཡོད་ཏན་ཐམས་ཅད་ནི་དམིགས་པའི་ཕྱིར་རོ་ཞེས་བྱ་བའི་གཏན་ཚིགས་ཡིན་པ་ལྟ་བུའོ་༎
 35| daśaite 'siddhasaṃjñakā hetvābhāsāḥ ||	བཅུ་པོ་འདི་དག་ནི་མ་གྲུབ་པ་ཞེས་བྱ་བའི་གཏན་ཚིགས་ལྟར་སྣང་བའོ་༎
 36| || anaikāntiko hetvābhāsaḥ kīdṛśa ucyate ||	མ་ངེས་པའི་གཏན་ཚིགས་ལྟར་སྣང་བ་ཡང་ཅི་འདྲ་བ་ཞིག་ཅེ་ན་། སྨྲས་པ་། དཔེར་ན་སྒྲ་༄༣༡༦ཨ་༌་༎
 37| yathā śabdasya nityatvādike dharme sādhye prameyatvaṃ hetuḥ sapaksvipakṣayoḥ sarvatra vartamānaḥ sādhāraṇānaikāntikaḥ ||	རྟག་པ་ལ་སོགས་པའི་ཆོས་བསྒྲུབ་པར་བྱ་བ་ལ་། གཞལ་བྱ་ཡིན་པའི་ཕྱིར་ཞེས་པའི་གཏན་ཚིགས་ནི་། མཐུན་པའི་ཕྱོགས་དང་མི་མཐུན་པའི་ཕྱོགས་ཐམས་ཅད་ལ་འཇུག་པའི་ཐུན་མོང་གི་མ་ངེས་པའི་ཞེས་བྱའོ་༎ ད་བཞིན་དུ་སྒྲ་རྟག་པར་བསྒྲུབ་པར་བྱ་བ་ལ་།
 38| tathā śabdasya nityatve śrāvaṇatvaṃ hetuḥ sapakṣavipakṣayor apravartamānāt | asādhāraṇānaikāntikaḥ ||	མཉན་པར་བྱ་བ་ཡིན་པའི་ཕྱིར་ཞེས་བྱ་བའི་གཏན་ཚིགས་ནི་མཐུན་པའི་ཕྱོགས་དང་མི་མཐུན་པའི་ཕྱོགས་ལ་མི་འཇུག་པའི་ཕྱིར་ཐུན་མོང་མ་ཡིན་པའི་མ་ངེས་པ་ཡིན་ནོ་༎
 39| tathā śabdasyāprayatnānantarīyakatve sādhye 'nityatvād iti hetuḥ |	དེ་བཞིན་དུ་སྒྲ་བརྩལ་མ་ཐག་ཏུ་བྱུང་བའི་མ་ཡིན་པ་ཉིད་བསྒྲུབ་པར་བྱ་བ་ལ་མི་རྟག་པའི་ཕྱིར་རོ་ཞེས་བྱ་བའི་གཏན་ཚིགས་ནི་། མཐུན་པའི་ཕྱོགས་ཀྱི་ཕྱོགས་གཅིག་ལ་འཇུག་ལ་།
 sapakṣaikadeśavṛttir vipakṣavyāpy anaikāntikaḥ ||	མི་མཐུན་པའི་ཕྱོགས་ལ་ཁྱད་པར་འཇུག་པའི་མ་ངེས་པ་ཡིན་ཏེ་།
 aprayatnānantarīyakaḥ śabdasya vidyudākāśādiḥ sapakṣaḥ tatraikadeśe vidyudādau vartate 'nityatvaṃ nākāśādau prayatnāntarīyakaḥ punaḥ sarvo ghaṭādir vipakṣaḥ | tatra sarvatra vartate || (htu 265)	བརྩལ་མ་ཐག་ཏུ་བྱུང་བ་མ་ཡིན་པའི་སྒྲ་མཐུན་པའི་ཕྱོགས་ནི་གློག་དང་། ནམ་མཁའ་ལ་སོགས་པ་སྟེ་། དེ་ལ་མཐུན་པའི་ཕྱོགས་ལ་ཕྱོགས་གཅིག་གློག་ལ་སོགས་པ་ལ་ནི་མི་རྟག་པ་འཇུག་ལ་། ནམ་མཁའ་ལ་སོགས་པ་ལ་ནི་མ་ཡིན་ནོ་༎ མི་མཐུན་པའི་ཕྱོགས་བརྩལ་མ་ཐག་ཏུ་བྱུང་བ་ལ་སོགས་པ་ཐམས་ཅད་ཡིན་ཏེ་དེ་ཐམས་ཅད་ལ་འཇུག་པ་ཡིན་ནོ་༎
 40| tathā prayatnānantarīyakatve śabdasya sādhye 'nityatvaṃ hetuḥ ghaṭādau sarvatra vidyate | aprayatnānantarīyakaḥ punar vidyudākāśādir vipakṣaḥ |	དེ་བཞིན་དུ་སྒྲ་ནི་བརྩལ་མ་ཐག་ཏུ་བྱུང་བ་ཉིད་ཡིན་ཏེ་ཞེས་བསྒྲུབ་པར་བྱ་བ་ལ་མི་རྟག་པའི་ཕྱིར་ཞེས་བྱ་བའི་གཏན་ཚིགས་ནི་། བུམ་པ་ལ་སོགས་པ་ཐམས་ཅད་ལ་ནི་ཡོད་ལ་བརྩལ་མ་ཐག་ཏུ་བྱུང་བ་མ་ཡིན་པ་མི་མཐུན་པའི་ཕྱོགས་ཡང་གློག་དང་ནམ་མཁའ་ལ་སོགས་པ་དེ་ལས་ཕྱོགས་གཅིག་གློག་ལ་སོགས་པ་ལ་ནི་འཇུག་ལ་།
 tatraikadeśe vidyudādau vartate nākāśādau |	ནམ་མཁའ་ལ་སོགས་པ་ལ་ནི་མ་ཡིན་ལ་།
 tasmād ayaṃ vipakṣaikadeśavṛttiḥ sapakṣavyāpī hetur anaikāntikaḥ ||	དེའི་ཕྱིར་འདི་མི་མཐུན་པའི་ཕྱོགས་གཅིག་ལ་འཇུག་ལ་། མཐུན་པའི་ཕྱོགས་ལ་ཁྱབ་པའི་མ་ངེས་པའི་གཏན་ཚིགས་ཡིན་ནོ་༎
 41| ubhayapakṣaikadeśavṛttir anaikāntiko yathā |	ཕྱོགས་གཉི་གའི་ཕྱོགས་གཅིག་ལ་འཇུག་པའི་མ་ངེས་པ་ནི་དཔེར་ན་།
 śabde dharmiṇi nityatve sādhye 'mūrtatvād iti hetuḥ |	ཆོས་ཅན་ལ་སྒྲ་རྟག་པར་བསྒྲུབ་པར་བྱ་བ་ལ་། ལུས་ཅན་མ་ཡིན་པའི་ཕྱིར་ཞེས་བྱ་བའི་གཏན་ཚིགས་ནི་།
 paramāṇvākāśādiḥ sapakṣo 'sya | tatraikadeśe 'mūrtatvam ākāśe pravartate na paramāṇau mūrtatvāt paramāṇūnam |	མཐུན་པའི་ཕྱོགས་རྡུལ་ཕྲ་རབ་དང་ནམ་མཁའ་ལ་སོགས་པ་དེ་ལ་མཐུན་པའི་ཕྱོགས་གཅིག་ནམ་མཁའ་ནི་ལུས་ཅན་མ་ཡིན་པ་འཇུག་ལ་། རྡུལ་ཕྲ་རབ་ནི་མ་ཡིན་ཏེ་རྡུལ་ཕྲ་རབ་རྣམས་ལུས་ཅན་ཡིན་པའི་ཕྱིར་རོ་༎
 ghaṭasukhādir anityo vipakṣaḥ | tatraikadeśe sukhādau vidyate na ghaṭādau ||	བུམ་པ་དང་བདེ་བ་ལ་སོགས་པ་མི་རྟག་པ་མི་མཐུན་པའི་ཕྱོགས་གཅིག་བདེ་བ་ལ་སོགས་པ་ལ་འཇུག་ལ་། བུམ་པ་ལ་སོགས་པ་༄༣༡༦བ་མ་ཡིན་པ་ལྟ་བུའོ་༎
 42| tathā saṃdigdhavipakṣavyāvṛttikaḥ sapakṣavyāpī hetur anaikāntiko yathā |	དེ་བཞིན་དུ་མི་མཐུན་པའི་ཕྱོགས་ལ་ལྡོག་པ་ལ་ནི་ཐེ་ཚོམ་ཟ་ལ་། མཐུན་པའི་ཕྱོགས་ལ་ཁྱབ་པའི་མ་ངེས་པའི་གཏན་ཚིགས་ནི་།
 kapilādidharmy asarvajña iti sādhye vaktṛtvād iti hetuḥ | rathyāpuruṣādau sapakṣe 'sti |	དཔེར་ན་སེར་སྐྱ་ལ་སོགས་པའི་ཆོས་ཅན་ཐམས་ཅད་མཁྱེན་པ་མ་ཡིན་ཏེ་ཞེས་བསྒྲུབ་པར་བྱ་བ་ལས་སྨྲ་བའི་ཕྱིར་ཞེས་བྱ་བའི་གཏན་ཚིགས་ནི་༏་ལམ་པོ་ཆེའི་སྐྱེས་བུ་ལ་སོགས་པ་དང་མཐུན་པའི་ཕྱོགས་ལ་ནི་ཡོད་ལ་།
 vipakṣe sarvajñe saṃdigdhaḥ |	མི་མཐུན་པའི་ཕྱོགས་ཐམས་ཅད་མཁྱེན་པ་ལ་ནི་ཐེ་ཚོམ་ཟ་སྟེ་།
 sarvajñasyātīndriyatvād vacanam asti na veti saṃdigdham ||	ཐམས་ཅད་མཁྱེན་པ་ནི་དབང་པོ་ལས་འདས་པའི་ཕྱིར་སྨྲ་བ་ཡོད་དམ་མེད་པ་ལ་ཐེ་ཚོམ་ཟ་བ་ཡིན་ནོ་༎
 43| tathā saṃdigdhasapakṣavṛttir vipakṣavyāpl hetur anaikāntiko yathā |	དེ་བཞིན་དུ་མཐུན་པའི་ཕྱོགས་ལ་འཇུག་པ་ལ་ནི་༏་ཐེ་ཚོམ་ཟ་ལ་མི་མཐུན་པའི་ཕྱོགས་ལ་ཁྱབ་པའི་མ་ངེས་པའི་གཏན་ཚིགས་ནི་དཔེར་ན་།
 ṛṣabhavardhāmānādidharmī sarvajña iti sādhye kevaliśāstrakaraṇād iti hetuḥ sapakṣe sarvajñe saṃdigdhaḥ |	ཁྱུ་མཆོག་དང་འཕེལ་བ་ལ་སོགས་པའི་ཆོས་ཅན་ཐམས་ཅད་མཁྱེན་པ་ཡིན་ནོ་ཞེས་བསྒྲུབ་པར་བྱ་བ་ལ་བསྟན་བཅོས་འབའ་ཞིག་བྱེད་པའི་ཕྱིར་ཞེས་བྱ་བ་ལ་གཏན་ཚིགས་ནི་མཐུན་པའི་ཕྱོགས་ཐམས་ཅད་མཁྱེན་པ་ལ་ནི་ཐེ་ཚོམ་ཟ་སྟེ་།
 sarvajñasyātīndriyatvāt kevaliśāstrakaraṇaṃ saṃdigdham |	ཐམས་ཅད་མཁྱེན་པ་ནི་དབང་པོ་ལས་ཤིན་ཏུ་འདས་པའི་ཕྱིར་། བསྟན་བཅོས་འབའ་ཞིག་བྱེད་པ་ལ་ཐེ་ཚོམ་ཟ་བ་ཡིན་ནོ་༎
 vipakṣe varāhamihirādāv asarvajñe vidyate ||	མི་མཐུན་པའི་ཕྱོགས་པ་ར་ཧ་དང་མ་ཧ་རེ་ལ་སོགས་པ་ཐམས་ཅད་མཁྱེན་པ་མ་ཡིན་པ་ལ་ཡོད་པ་ལྟ་བུའོ་༎
 44| saṃdigdhānvayavyatirekahetur anaikāntiko yathā sātmakaṃ jīvaccharīraṃ prāṇādimattvād iti hetuḥ | jīvaccharīrasaṃbandhī prāṇādir na sātmake anātmake vā pravṛtto nivṛtto veti niścīyate || (htu 266)	རྗེས་སུ་འགྲོ་བ་དང་ལྡོག་པ་ལ་ཐེ་ཚོམ་ཟ་བའི་མ་ངེས་པའི་གཏན་ཚིགས་ནི་དཔེར་ན་གསོན་པོའི་ལུས་ནི་བདག་དང་བཅས་པ་ཡིན་ཏེ་སྲོག་ཆགས་ལ་སོགས་པ་དང་ལྡན་པའི་ཕྱིར་རོ་ཞེས་བྱ་བའི་གཏན་ཚིགས་ནི་གསོན་པོའི་ལུས་དང་འབྲེལ་བ་ཅན་སྲོག་ལ་སོགས་པ་བདག་དང་བཅས་པའམ་བདག་མེད་པ་ལ་འཇུག་པའམ་ལྡོག་པ་མ་ངེས་པ་ཡིན་ཏེ་༏་དེ་བས་ན་རྗེས་སུ་འགྲོ་བ་འབའ་ཞིག་པའི་གཏན་ཚིགས་ཡིན་ཏེ་དཔེ་མེད་པ་ཡིན་པའི་ཕྱིར་རོ་༎ 
 45| tataḥ kevalānvayī hetur dṛṣṭāntābhāvāt ||	དེ་བཞིན་དུ་གཉིས་པ་ལ་ཡང་ལྡོག་པ་འབའ་ཞིག་ཡིན་ཏེ་།
 46| tathā dvitīyo 'pi kevalavyatirekī nedaṃ nirātmakaṃ jīvaccharīram aprāṇādimattvaprasaṅgād iti |	གསོན་པོའི་ལུས་འདི་ནི་བདག་མེད་པ་མ་ཡིན་ཏེ་སྲོག་ལ་སོགས་པ་མེད་པར་ཐལ་བར་འགྱུར་བའི་ཕྱིར་རོ་ཞེས་བྱ་བ་ལྟ་བུའོ་༎
 dṛṣṭāntābhāvād eva nānvayaniścayo nāpi vyatirekaniścaya iti saṃśayahetuḥ ||	དཔེ་མེད་པ་ཉིད་ཀྱི་ཕྱིར་རྗེས་སུ་འགྲོ་བ་ངེས་པ་མེད་པ་དང་། ལྡོག་པ་ཡང་ངེས་པ་འདི་ནི་ཐེ་ཚོམ་ཟ་བའི་གཏན་ཚིགས་སོ་༎
 47| uktā nava ete 'naikāntikasaṃjñakā hetvābhāsāḥ ||	བཅུ་པོ་འདི་དག་ནི་མ་ངེས་པའི་གཏན་ཚིགས་ལྟར་སྣང་བ་ཞེས་བསྟན་ཏོ་༎
 48| viruddhasaṃjñako hetvābhāsaḥ kīdṛśaḥ ||	འགལ་བའི་གཏན་ཚིགས་ལྟར་སྣང་བ་ཅི་འདྲ་བ་ཞིག་ཅེ་ན་།
 49| yathā śabdo dharmī nitya iti sādhyo dharmaḥ kṛtakatvād ākāśādivat |	དཔེར་ན་ཆོས་ཅན་སྒྲ་རྟག་སྟེ་ཞེས་བྱ་བ་ནི་༄༣༡༧ཨ་༌་༎ བསྒྲུབ་པར་བྱ་བའི་ཆོས་སོ་༎
 ayaṃ hetur ghaṭādau vipakṣa evāsti na sapakṣe || 50| tathā śabdo dharmī nitya iti sādhye prayatnānantarīyakatvād iti hetur ākāśādau sapakṣe nāsty eva |	བྱས་པའི་ཕྱིར་ནམ་མཁའ་ལ་སོགས་པ་བཞིན་ནོ་ཞེས་བྱ་བའི་གཏན་ཚིགས་འདི་ནི་བུམ་པ་ལ་སོགས་པ་མི་མཐུན་པའི་ཕྱོགས་ཉིད་ལ་ཡོད་ལ་མཐུན་པའི་ཕྱོགས་ལ་ནི་མ་ཡིན་པ་ལྟ་བུའོ་༎ དེ་བཞིན་དུ་ཆོས་ཅན་སྒྲ་རྟག་སྟེ་ཞེས་བསྒྲུབ་པར་བྱ་བ་ལ་།
 vipakṣaikadese ghaṭādau vidyate na vidyudādau ||	བརྩལ་མ་ཐག་ཏུ་བྱུང་བ་ཡིན་པའི་ཕྱིར་ཞེས་བྱ་བའི་ཕྱིར་གཏན་ཚིགས་མཐུན་པའི་ཕྱོགས་ནམ་མཁའ་ལ་སོགས་པ་ལ་མེད་ཕྱོགས་གཅིག་བུམ་པ་ལ་སོགས་པ་ལ་ནི་ཡོད་ལ་། གློག་ལ་སོགས་པ་ལ་ནི་མེད་པ་ལྟ་བུའོ་༎
 etau dvau hetū dharmasvarūpaviparītasādhanau || 51| dharmaviśeśaviparītasādhano yathā |	གཏན་ཚིགས་འདི་གཉིས་ནི་ཆོས་ཀྱི་རང་གི་ངོ་བོ་ཕྱིན་ཅི་ལོག་ཏུ་བསྒྲུབ་པ་དང་། ཆོས་ཅན་རང་གི་ངོ་བོ་ཕྱིན་ཅི་ལོག་ཏུ་བསྒྲུབ་པ་ལ་རྣམ་པ་གཉིས་ཡིན་ཏེ་།
 cakṣurādaya iti dharmī parārthā iti sādhyo dharmaḥ saṃghatatvād iti hetuḥ |	དཔེར་ན་ཆོས་མིག་ལ་སོགས་པ་འདི་དག་གཞན་གྱི་དོན་དུ་བསྒྲུབ་པར་བྱ་བའི་ཆོས་སོ་༎ བསགས་པ་ཡིན་པའི་ཕྱིར་ཞེས་བྱ་བ་ནི་གཏན་ཚིགས་སོ་༎
 mañcapīṭhādivad iti sapakṣavacanaṃ |	ཁྲི་དང་སྟན་ལ་སོགས་པ་བཞིན་ནོ་ཞེས་བྱ་བ་ནི་མཐུན་པའི་ཕྱོགས་བསྟན་པའོ་༎
 ayaṃ tu hetur yathā cakṣurādīnāṃ pārārthyaṃ sādhayati |	འདི་ལྟར་གཏན་ཚིགས་འདིས་མིག་ལ་སོགས་པ་གཞན་གྱི་དོན་དུ་སྒྲུབ་པར་བྱེད་ལ་།
 tathā saṃghātatvaṃ parasya sādhayati |	དེ་བཞིན་དུ་བསགས་པ་ཉིད་གཞན་གྱིར་སྒྲུབ་པར་བྱེད་དེ་།
 mañcapīṭhādīnāṃ saṃghātasya devadattādeḥ parasyopakāradarśanāt ||	ཁྲི་དང་སྟན་ལ་སོགས་པ་བསགས་པས་ལྷ་སྦྱིན་ལ་སོགས་པ་གཞན་གྱི་དོན་བྱེད་པར་མཐོང་བའི་ཕྱིར་རོ་༎ 
 52| dharmisvarūpaviparītasādhano yathā pṛthivyādir dharmī buddhimaddhetujanya iti sādhye sāśrayatvād iti hetuḥ |	ཆོས་ཅན་གྱི་རང་གི་ངོ་བོ་ཕྱིན་ཅི་ལོག་ཏུ་བསྒྲུབ་པ་ནི་། དཔེར་ན་ཆོས་ཅན་ལ་སོགས་པ་ནི་བློ་དང་ལྡན་པའི་རྒྱུ་ལས་སྐྱེས་པ་ཡིན་ཏེ་ཞེས་བྱ་བར་བསྒྲུབ་པར་བྱ་བ་ལ་རྟེན་པ་དང་བཅས་པའི་ཕྱིར་ཞེས་བྱ་བ་ནི་གཏན་ཚིགས་སོ་༎
 ghaṭādivad iti sapakṣavacanam |	བུམ་པ་ལ་སོགས་པ་བཞིན་ནོ་ཞེས་བྱ་བས་ནི་། མཐུན་པའི་ཕྱོགས་བསྟན་ཏོ་༎
 ayaṃ hetur yathā buddhimaddhetujanyatvaṃ sādhayati tathā buddhimataḥ kartuḥ sāśrayatvam api sādhayati ||	འདི་ལྟར་གཏན་ཚིགས་འདིས་ནི་བློ་དང་ལྡན་པའི་རྒྱུ་ལས་སྐྱེས་པ་ཉིད་སྒྲུབ་པར་བྱེད་པ་ཡིན་ལ་། དེ་བཞིན་དུ་བློ་དང་ལྡན་པའི་བྱེད་པའི་རྟེན་པ་དང་བཅས་པ་ཡང་སྒྲུབ་པར་བྱེད་ལ་། དོ་༎ 
 53| dharmiviṣeśaviparītasādhano yathā |	ཆོས་ཅན་གྱི་ཁྱད་པར་ཕྱིན་ཅི་ལོག་ཏུ་བསྒྲུབ་པ་ནི་དཔེར་ན་།
 vaiśeṣikasya mīmāṃsakaṃ praty ātmā dharmī cetayata iti sādhye (htu 267) cetanādhiṣṭhānatvād iti hetur ātmano 'cetanasya yathā caitanyaṃ sādhayati |	བྱེ་བྲག་པས་དཔྱོད་པ་པ་ལ་ཆོས་བདག་ནི་སེམས་དང་ལྡན་པ་ཡིན་ནོ་ཞེས་བསྒྲུབ་པར་བྱ་བ་ལ་སེམས་ཀྱིས་བྱིན་གྱིས་བརླབས་པའི་ཕྱིར་ཞེས་བྱ་བའི་གཏན་ཚིགས་ནི་།
 tathā hetur ayam anityatvam api sādhayati |	བདག་སེམས་མེད་པ་ལ་ཇི་ལྟར་སེམས་དང་ལྡན་པར་སྒྲུབ་པར་བྱེད་པ་དེ་བཞིན་དུ་གཏན་ཚིགས་འདིས་མི་རྟག་པ་ཡང་སྒྲུབ་པར་བྱེད་དེ་།
 anityatvād vijñānasya ||	རྣམ་པར་ཤེས་པ་ནི་མི་རྟག་པའི་ཕྱིར་རོ་༎
 54| uktāḥ pañcaite viruddhasaṃjñakā hetvābhāsāḥ ||	ལྔ་པོ་དེ་དག་གིས་ནི་འགལ་བའི་གཏན་ཚིགས་ལྟར་སྣང་བ་བསྟན་ཏོ་༎
 55| viruddhāvyabhicārī nāma na kaścid dhetudoṣo 'stīti na tasyodāharaṇaṃ yuktam | tatrodāharaṇaṃ | yat sarvadeśāvasthitaiḥ svayaṃ ca svasaṃbandhibhir yugapad abhisaṃbadhyate tat sarvagatam | yathākāśam iti |	འགལ་༄༣༡༧བ་བ་མི་འཁྲུལ་བ་ཞེས་བྱ་བ་ནི་གང་དུ་ཡང་གཏན་ཚིགས་ཀྱི་སྐྱོན་མ་ཡིན་པས་དེའི་དཔེ་བརྗོད་པ་མི་རིགས་ཏེ་།
 abhisaṃbadhyate ca sarvadeśāvasthitaiḥ svasaṃbandhibhir yugapat sāmānyam iti pailukasya svabhāvahetuprayogaḥ | |	དེའི་དཔེ་བརྗོད་ན་གང་ཕྱོགས་ཐམས་ཅད་ན་གནས་པ་དང་། བདག་ཉིད་རང་དང་གཅིག་པར་མངོན་པར་འབྲེལ་པ་ཅན་དེ་ནི་ཐམས་ཅད་དུ་འགྲོ་བ་ཡིན་ཏེ་། དཔེར་ན་ནམ་མཁའ་བཞིན་ཕྱོགས་ཐམས་ཅད་ན་གནས་པ་ནི་རང་དང་འབྲེལ་པས་ཅིག་ཅར་སྤྱི་དང་མངོན་པར་འབྲེལ་པ་ཡིན་ནོ་ཞེས་བྱ་བ་ནི་པེ་ལུ་ཀའི་རང་བཞིན་གྱི་གཏན་ཚིགས་ཀྱི་། སྦྱོར་བའོ་༎ 
 dvitīyo 'pi prayogaḥ paiṭharasya | yad upalabdhilakṣaṇaprāptaṃ yatra nopalabhyate na tatrāsti |	ཡང་སྦྱོར་བ་གཉིས་པ་ནི་དཔེ་ཐ་རའི་ཡིན་ཏེ་གང་དམིགས་པའི་མཚན་ཉིད་ཀྱིར་གྱུར་པ་གང་དུ་མི་དམིགས་པ་དེ་ནི་། སྦྱོར་བའོ་༎ མེད་དོ་༎ 
 tad yathā kvacid avidyamāno ghaṭaḥ |	དཔེར་ན་ཕྱོགས་འགའ་ཞིག་ན་བུམ་པ་མེད་དེ་ཞེས་བྱ་བ་། སྦྱོར་བའོ་༎ མེད་དོ་༎ ལྟ་བུའོ་༎
 nopalabhyate copalabdhilakṣaṇaprāptaṃ sāmānyaṃ vyaktyantarāleṣv iti ||	དམིགས་པའི་མཚན་ཉིད་ཀྱིར་གྱུར་པའི་སྤྱི་གསལ་བ་། སྦྱོར་བའོ་༎ མེད་དོ་༎ ལྟ་བུའོ་༎ དང་། གསལ་བའི་བར་ན་མི་དམིགས་པའི་ཕྱིར་རོ་ཞེས་བྱ་བ་ལྟ་བུའོ་༎
 anupalambho hetuḥ pūrvoktaś ca svabhāvaḥ parasparaṃ bādhayataḥ | saṃśayajananāt |	མི་དམིགས་པའི་གཏན་ཚིགས་འདི་དང་སྔར་བསྟན་པའི་རང་བཞིན་གྱི་གཏན་ཚིགས་འདི་ཕན་ཚུན་གནོད་པས་ཐེ་ཚོམ་བསྐྱེད་པའི་ཕྱིར་རོ་༎
 56| na sapakṣād anyo dṛṣṭānto nāma kaścid iti sapakṣa eva sādharmyadṛṣṭāntaḥ ||	མཐུན་པའི་ཕྱོགས་དང་གཞན་པའི་དཔེ་ཞེས་བྱ་བ་ནི་འགའ་ཡང་མེད་དེ་མཐུན་པའི་ཕྱོགས་འདི་ཉིད་ཆོས་མཐུན་པའི་དཔེ་ཡིན་ནོ་༎
 tatra dṛṣṭāntābhāsaḥ kīdṛśaḥ |	དེ་ལ་དཔེ་ལྟར་སྣང་བ་ཅི་ལྟ་བུ་ཞིག་ཅེ་ན་།
 57| sādharmyeṇa tāvat |	ཆོས་མཐུན་པའི་རེ་ཞིག་འདི་ལྟ་བུ་སྟེ་།
 58| nityaḥ śabdo 'mūrtatvāt karmavat | sādhyavikalaḥ karmaṇo 'nityatvāt ||	སྒྲ་ནི་རྟག་སྟེ་ལུས་ཅན་མ་ཡིན་པའི་ཕྱིར་ལས་བཞིན་ནོ་ཞེས་བྱ་བ་ནི་བསྒྲུབ་པར་བྱ་བ་མ་ཚང་བ་ཡིན་ཏེ་ལས་ནི་མི་རྟག་པའི་ཕྱིར་རོ་༎ 
 59| nityaḥ śabdo 'mūrtatvāt paramāṇuvat |	སྒྲ་ནི་རྟག་སྟེ་ལུས་ཅན་མ་ཡིན་པའི་ཕྱིར་རྡུལ་ཕྲ་རབ་བཞིན་ནོ་ཞེས་བྱ་བ་ནི་སྒྲུབ་པར་བྱེད་པ་མ་ཚང་བ་པའི་ཕྱིར་རོ་༎ ཡིན་ཏེ་། 
 sādhanavikalaḥ paramāṇūnāṃ mūrtatvāt ||	རྡུལ་ཕྲ་རབ་ནི་ལུས་ཅན་ཡིན་པའི་ཕྱིར་རོ་༎
 60| nityaḥ śabdo 'mūrtatvād ghaṭavad | sādhyasādhanobhayavikalaḥ ||	སྒྲ་རྟག་སྟེ་ལུས་ཅན་མ་ཡིན་པའི་ཕྱིར་བུམ་པ་བཞིན་ནོ་ཞེས་བྱ་བ་སྒྲུབ་པར་བྱེད་པ་གཉི་ག་མ་ཚང་བ་ཡིན་ནོ་༎
 61| tathā saṃdigdhasādhyadharmā dṛṣṭāntābhāsaḥ | kaścit puruṣo dharmī rāgādimān vacanāt |	དེ་བཞིན་དུ་བསྒྲུབ་པར་བྱ་བའི་ཆོས་ལ་ཐེ་ཚོམ་ཟ་བའི་དཔེ་ལྟར་སྣང་བ་ནི་དཔེར་ན་ཆོས་ཅན་སྐྱེས་བུ་འགའ་ཞིག་འདོད་ཆགས་ལ་སོགས་པ་དང་ལྡན་པ་ཡིན་ཏེ་།
 rathyāpuruṣavat |	སྨྲ་བའི་ཕྱིར་ལམ་པོ་ཆེའི་སྐྱེས་བུ་བཞིན་ནོ་ཞེས་བྱ་བ་ལ་།
 (htu 268) tatra dṛṣṭānte rathyāpuruṣe rāgādimattvaṃ saṃdigdhaḥ paracetovṛttīnāṃ duranvayatvāt ||	ལམ་པོ་ཆེའི་སྐྱེས་བུའི་དཔེ་ལས་འདོད་ཆགས་ལ་སོགས་པ་དང་ལྡན་པ་ལ་ཐེ་ཚོམ་ཟ་སྟེ་། གཞན་གྱི་སེམས་ནི་རྗེས་སུ་རྟོགས་པར་དཀའ་བའི་ཕྱིར་རོ་༎
 62| saṃdigdhasādhanadharmā yathā | kaścit puruṣo maraṇadharma iti sādhye rāgādimattvād iti hetuḥ | rathyāpuruṣe dṛṣṭānte saṃdigdhaḥ |	སྒྲུབ་པར་བྱེད་པའི་ཆོས་ལ་ཐེ་ཚོམ་ཟ་བ་ན་དཔེར་ན་སྐྱེས་བུ་གང་ཞིག་འཆི་བའི་ཆོས་དང་ལྡན་པ་ཡིན་ཏེ་ཞེས་བསྒྲུབ་པར་བྱ་བ་ལ་འདོད་ཆགས་ལ་སོགས་པ་དང་ལྡན་པ་༄༣༡༨ཨ་༌་༎ ཡིན་པའི་ཕྱིར་ཞེས་བྱ་བའི་གཏན་ཚིགས་ནི་ལམ་པོ་ཆེའི་སྐྱེས་བུའི་དཔེ་ལ་ཐེ་ཚོམ་༌་༎ སྟེ་། 
 vītarāgo 'pi rāgīva ceṣṭate yataḥ ||	འདོད་ཆགས་དང་བྲལ་བ་ཡང་འདོད་ཆགས་དང་བཅས་པ་བཞིན་དུ་ག-ཡོ་བའི་ཕྱིར་༌་༎ སྟེ་། རོ་༎ 
 63| saṃdigdhobhayadharmā dṛṣṭāntābhāso yathā kaścit puruṣo dharmī asarvajña iti sādhye rāgādimattvād iti hetuḥ | rathyāpuruṣe dṛṣṭānte sādhyaṃ sādhanaṃ saṃdigdham ||	ཆོས་གཉི་ག་ལ་ཐེ་ཚོམ་ཟ་བའི་དཔེ་ལྟར་སྣང་བ་དཔེར་ན་ཆོས་ཅན་སྐྱེས་བུ་འགའ་ཞིག་ཐམས་ཅད་མཁྱེན་པ་མ་ཡིན་ཏེ་ཞེས་བསྒྲུབ་པར་བྱ་བ་ལ་འདོད་ཆགས་ལ་སོགས་པ་དང་ལྡན་པའི་ཕྱིར་རེ་ཞེས་བྱ་བའི་གཏན་ཚིགས་ནི་ལམ་པོ་ཆེའི་སྐྱེས་བུའི་དཔེ་ལ་བསྒྲུབ་པར་བྱ་བ་དང་། སྒྲུབ་པར་བྱེད་པ་ལ་ཐེ་ཚོམ་ཟ་བ་ཡིན་ནོ་༎
 64| ananvayo 'pradarśitānvayo viparītānvayaś ca dṛṣṭānṭābhāsāḥ ||	རྗེས་སུ་འགྲོ་བ་མེད་པ་དང་། རྗེས་སུ་འགྲོ་བ་མ་བསྟན་པ་དང་། རྗེས་སུ་འགྲོ་བ་ཕྱིན་ཅི་ལོག་གི་དཔེ་ལྟར་སྣང་བ་ནི་།
 65| tatrānanvayo yathā | yo vaktā sa rāgādimān rathyāpuruṣavat |	དེ་ལ་རྗེས་སུ་འགྲོ་བ་མེད་པ་ནི་དཔེར་ན་གང་སྨྲ་བ་དེ་ནི་འདོད་ཆགས་ལ་སོགས་པ་དང་ལྡན་པ་ཡིན་ཏེ་ལམ་པོ་ཆེའི་སྐྱེས་བུ་བཞིན་ནོ་༎ 
 vaktṛtvarāgādimattvayoḥ kāryakāraṇabhāvapratiṣedhāt ||	སྨྲ་བར་བྱེད་པ་དང་འདོད་ཆགས་ལ་སོགས་པ་དང་ལྡན་པ་དག་བྱ་བ་བྱེད་པའི་ངོ་བོ་བཀག་པའི་ཕྱིར་རོ་༎
 66| apradarśitānvayo yathā | anityaḥ śabdaḥ kṛtakatvād iti |	རྗེས་སུ་འགྲོ་བ་མ་བསྟན་པ་ནི་དཔེར་ན་སྒྲ་ནི་མི་རྟག་སྟེ་བྱས་པའི་ཕྱིར་རོ་ཞེས་བྱ་བ་ལྟ་བུའོ་༎
 atra vidyamāno 'py anvayo vyāptyā na darśita iti |	འདི་ལ་རྗེས་སུ་འགྲོ་བ་ཡོད་མོད་ཀྱི་ཁྱབ་པ་མ་བསྟན་པ་ཞེས་བྱ་བ་སྟེ་།
 vaktṛdoṣād ayaṃ dṛṣṭāntābhāsaḥ ||	དེ་ནི་སྨྲ་བའི་ཉེས་པས་དཔེ་ལྟར་སྣང་བ་བཞིན་ནོ་༎
 67| viparītānvayo yathā |	རྗེས་སུ་འགྲོ་བ་ཕྱིན་ཅི་ལོག་ནི་།
 yad anityaṃ tat kṛtakaṃ ghaṭādivad ity atrānityatvaṃ sādhyam | sādhyenaiva sādhanaṃ vyāptaṃ kathanīyam |	དཔེར་ན་གང་རྟག་པ་དེ་ནི་བྱས་པ་ཡིན་ཏེ་། བུམ་པ་ལ་སོགས་པ་བཞིན་ནོ་ཞེས་བྱ་བ་ནི་འདིར་མི་རྟག་པ་ནི་བསྒྲུབ་པར་བྱ་བ་ཡིན་ཏེ་བསྒྲུབ་པར་བྱ་བས་སྒྲུབ་པར་བྱེད་པ་ལ་ཁྱབ་པ་བསྟན་པར་བྱ་བ་ཡིན་གྱི་།
 na tu sādhanena vyāptaṃ sādhyaṃ kathyate |	སྒྲུབ་པར་བྱེད་པས་བསྒྲུབ་པར་བྱ་བ་ལ་ཁྱབ་པ་བསྟན་པར་བྱ་བ་མ་ཡིན་ནོ་༎
 atha viparītānvayo dṛṣṭāntābhāsaḥ ||	དེའི་ཕྱིར་རྗེས་སུ་འགྲོ་བ་ཕྱིན་ཅི་ལོག་གི་དཔེ་ལྟར་སྣང་བ་ཡིན་ནོ་༎
 68| uktā navaite sādharmyeṇa dṛṣṭāntābhāsāḥ ||	དེ་དག་ནི་ཆོས་མཐུན་པའི་དཔེ་ལྟར་སྣང་བ་དགུ་བསྟན་པ་ཡིན་ནོ་༎
 69| vaidharmyeṇa dṛṣṭāntābhāsā ucyante |	ཆོས་མི་མཐུན་པའི་དཔེ་ལྟར་སྣང་བ་བསྟན་པར་བྱ་སྟེ་།
 70| sādhyāvyatirekī dṛṣṭāntābhāso yathā |	བསྒྲུབ་པར་བྱ་བ་ལྡོག་པ་མེད་པའི་དཔེ་ལྟར་སྣང་བ་ནི་།
 nityaḥ śabdo 'mūrtatvāt paramāṇuvat |	དཔེར་ན་སྒྲ་རྟག་སྟེ་ལུས་ཅན་མ་ཡིན་པའི་ཕྱིར་།
 atra paramāṇor vaidharmyadṛṣṭāntatvād amūrtatvaṃ sādhanadharmo vyāvṛtto (htu 269)	རྡུལ་ཕྲ་རབ་བཞིན་ནོ་ཞེས་བྱ་བ་ནི་འདིར་རྡུལ་ཕྲ་རབ་ནི་ཆོས་མི་མཐུན་པའི་དཔེ་ཡིན་པའི་ཕྱིར་ལུས་ཅན་མ་ཡིན་པ་སྒྲུབ་པར་བྱེད་པའི་ཆོས་ལྡོག་པ་ཡིན་ཏེ་།
 mūrtatvāt paramāṇūnām |	རྡུལ་ཕྲ་རབ་ནི་ལུས་ཅན་ཡིན་པའི་ཕྱིར་རོ་༎
 nityatvaṃ sādhyadharmo na vyāvṛttaḥ | paramāṇor nityatvāt || 71| sādhanāvyatirekl yathā | nityaḥ śabdo 'mūrtatvāt karmavat |	བསྒྲུབ་པར་བྱ་བའི་ཆོས་རྟག་པ་ནི་ལོག་པ་མ་ཡིན་རྡུལ་ཕྲ་རབ་ནི་རྟག་པའི་ཕྱིར་རོ་༎ སྒྲུབ་པར་བྱེད་པ་ལྡོག་པ་མེད་པ་ནི་དཔེར་ན་སྒྲ་རྟག་སྟེ་ལུས་ཅན་མ་ཡིན་པའི་ཕྱིར་ལས་བཞིན་ནོ་ཞེས་བྱ་བ་ནི་འདིར་བསྒྲུབ་པར་བྱ་བའི་ཆོས་རྟག་༄༣༡༨བ་པ་པ་ཉིད་ལྡོག་༎ པ་ཡིན་ཏེ་། 
 atra nityatvaṃ sādhyadharmo vyāvṛttaḥ karmaṇo 'nityatvāt |	ལས་ནི་མི་རྟག་པའི་ཕྱིར་རོ་༎ སྒྲུབ་པར་བྱེད་པའི་ཆོས་ནི་ལྡོག་པ་མ་ཡིན་ཏེ་།
 sādhanadharmo na vyāvṛttaḥ karmaṇo 'mūrtatvāt ||	ལས་ནི་ལུས་ཅན་མ་ཡིན་པའི་ཕྱིར་རོ་༎
 72| ubhayāvyāvṛtto yathā | nityaḥ śabdo 'mūrtatvād ākāśādivat | atrākāśādau vaidharmyadṛṣṭāntāt sādhyaṃ sādhanaṃ ca na vyāvṛttam ||	གཉི་ག་ལྡོག་པ་མེད་པ་ནི་དཔེར་ན་སྒྲ་ནི་རྟག་སྟེ་ལུས་ཅན་མ་ཡིན་པའི་ཕྱིར་ནམ་མཁའ་ལ་སོགས་པ་བཞིན་ནོ་ཞེས་བྱ་བ་འདིར་ནམ་མཁའ་ལ་སོགས་པའི་ཆོས་མི་མཐུན་པའི་དཔེ་ལས་བསྒྲུབ་པར་བྱ་བ་དང་། སྒྲུབ་པར་བྱེད་པ་ལྡོག་པ་མེད་པ་ཡིན་ནོ་༎
 73| tathā saṃdigdhasādhyavyatirekī saṃdigdhasādhanavyatirekī | saṃdigdhobhayavyatirekī ceti | 74| saṃdigdhasādhyavyatireko dṛṣṭāntābhāso yathā |	དེ་བཞིན་དུ་བསྒྲུབ་པར་བྱ་བ་དང་ལྡོག་པ་ལ་ཐེ་ཚོམ་ཟ་བ་དང་། སྒྲུབ་པར་བྱེད་པ་ལྡོག་པ་ལ་ཐེ་ཚོམ་ཟ་བ་དང་། གཉི་ག་ལྡོག་པ་ལ་ཐེ་ཚོམ་ཟ་བ་ལས་བསྒྲུབ་པར་བྱ་བ་ལྡོག་པ་ལ་ཐེ་ཚོམ་ཟ་བའི་དཔེ་ལྟར་སྣང་བ་ནི་།
 asarvajñāḥ kapilādayaḥ |	དཔེར་ན་སེར་སྐྱ་ལ་སོགས་པ་ནི་ཐམས་ཅད་མཁྱེན་པ་མ་ཡིན་ཏེ་།
 sarvajñatāliṅgabhūtakevaliśāstrākaraṇād iti | atra vaidharmyodāharaṇam | yaḥ sarvajñaḥ sa jyotirjñānādikam upadiṣṭavān yathā ṛṣabhavardhamānādir iti |	ཐམས་ཅད་མཁྱེན་པའི་རྟགས་སུ་གྱུར་པའི་བསྟན་བཅོས་འབའ་ཞིག་བྱས་པ་མེད་པའི་ཕྱིར་རོ་ཞེས་བྱ་བ་འདིར་ཆོས་མི་མཐུན་པའི་དཔེར་བརྗོད་པ་གང་ཐམས་ཅད་མཁྱེན་པ་མ་ཡིན་པ་དེས་ནི་སྐར་མ་ཤེས་པ་ལ་སོགས་པའི་བསྟན་བཅོས་ཏེ་དཔེར་ན་ཁྱུ་མཆོག་དང་འཕེལ་བ་ལ་སོགས་པ་བཞིན་ནོ་ཞེས་བྱ་བ་ལ་འདིར་ཆོས་མི་མཐུན་པའི་དཔེར་བརྗོད་ལ་། ཁྱུ་མཆོག་དང་འཕེལ་བ་ལ་སོགས་པ་ལས་ཐམས་ཅད་མཁྱེན་པ་མ་ཡིན་པ་ལ་ལོག་གམ་མི་ལོག་ཐེ་ཚོམ་ཡིན་ནོ་༎
 atra vaidharmyodāharaṇād ṛṣabhavardhamānāder asarvajñatā nivṛttāna veti saṃdehaḥ || 75| saṃdigdhasādhanavyatireko yathā | nātra trayīvidā brāhmaṇena grāhyavacanaḥ kapilakaṇādādiḥ puruṣo rāgādimattvād iti |	སྒྲུབ་པར་བྱེད་པ་ལྡོག་པ་ལ་ཐེ་ཚོམ་ཟ་བ་ནི་༏་དཔེར་ན་འདིར་གསུམ་རིག་པའི་བྲམ་ཟེ་སེར་སྐྱ་དང་གཟེགས་ཟན་ལ་སོགས་པའི་སྐྱེས་བུའི་ཚིག་གཟུང་བར་བྱ་བ་མ་ཡིན་ཏེ་། འདོད་ཆགས་ལ་སོགས་པ་དང་ལྡན་པའི་ཕྱིར་རོ་ཞེས་བྱ་བ་འདིར་ཆོས་མཐུན་པའི་དཔེ་བརྗོད་པ་ནི་གང་གི་ཚིག་གཟུང་བར་བྱ་བ་དེ་ནི་འདོད་ཆགས་ལ་སོགས་པ་དང་ལྡན་པ་མ་ཡིན་ཏེ་། 
 atra vaidharmyodāharaṇaṃ ye grāhyavacanā na te rāgādimanto yathā gautamādayo dharmaśāstrāṇāṃ praṇetāra iti gautamādibhyo rāgādimattvasya dharmasya vyāvṛttiḥ saṃdigdhā ||	དཔེར་ན་གོཨོ་ཏ་མ་ལ་སོགས་པའི་ཆོས་ཀྱི་བསྟན་བཅོས་རྩོམ་པ་ལྟ་བུ་སྟེ་། གོཨོ་ཏ་མ་ལ་སོགས་པ་ལས་འདོད་ཆགས་ལ་སོགས་པ་དང་ལྡན་པའི་ཆོས་ལྡོག་པ་ལ་ཐེ་ཚོམ་ཟ་བའོ་༎ 
 76| saṃdigdhobhayavyatirekī yathā |	གཉི་ག་ལྡོག་པ་ལ་ཐེ་ཚོམ་ཟ་བ་ནི་དཔེར་ན་སེར་སྐྱ་ལ་སོགས་པ་ནི་འདོད་ཆགས་དང་བྲལ་བ་མ་ཡིན་ཏེ་ཚོམ་ཟ་བའོ་༎ 
 avītarāgāḥ kapilādayaḥ parigrahāgrahayogād iti |	། ཡོངས་སུ་འཛིན་པ་དང་ཀུན་དུ་འཛིན་པ་དང་ལྡན་པའི་ཕྱིར་ཞེས་བྱ་ཚོམ་ཟ་བའོ་༎ 
 atra vaidharmyodāharaṇaṃ yo vītarāgo na tasya parigrahāgrahau saṃbhavataḥ (htu 270)	། བ་ལ་། འདིར་ཆོས་མཐུན་པའི་དཔེར་བརྗོད་པ་། གང་འདོད་ཆགས་དང་བྲལ་བ་དེ་ནི་ཡོངས་སུ་འཛིན་པ་དང་། ཀུན་དུ་འཛིན་པ་དང་ལྡན་བ་མ་ཡིན་ཏེ་།
 yathā ṛṣabhavardhamānāder iti |	དཔེར་ན་ཁྱུ་མཆོག་དང་འཕེལ་བ་ལ་སོགས་པ་བཞིན་༄༣༡༩ཨ་༌་༎
 ṛṣabhāder vaidharmyadṛṣṭāntāt avītarāgatvaṃ sādhyadharmaḥ parigrahāgrahayogaḥ sādhanadharmo vyāvṛtto na veti saṃdehaḥ |	ནོ་ཞེས་བྱ་བ་ལ་། ཁྱུ་མཆོག་ལ་སོགས་པ་ཆོས་མི་མཐུན་པའི་དཔེ་ལས་འདོད་ཆགས་དང་བྲལ་བ་ཉིད་བསྒྲུབ་པར་བྱ་བའི་ཆོས་དང་ཡོངས་སུ་འཛིན་པ་དང་། ཀུན་དུ་འཛིན་པ་སྒྲུབ་པར་བྱེད་པའི་ཆོས་ལྡོག་གམ་མི་ལྡོག་ཐེ་ཚོམ་ཟའི་།
 apūrvārthalābhaḥ parigrahaḥ |	སྔར་མ་རྙེད་པ་དངོས་པོ་རྙེད་པ་ནི་ཡོངས་སུ་འཛིན་པའོ་༎
 labdhasyāparityāga āgrahaḥ |	རྙེད་པ་ཡོངས་སུ་མི་གཏོང་བ་ནི་ཀུན་དུ་འཛིན་པའོ་༎
 tau ca dvāv api ṛṣabhādau saṃbhavyete |	གཉིས་པོ་དེ་དག་ཀྱང་ཁྱུ་མཆོག་ལ་སོགས་པ་ལ་སྲིད་དེ་།
 chatracāmaradundubhīnāṃ parigrahāgrahaśravaṇāt ||	གདུགས་དང་། རྔ་ཡབ་དང་། རྔ་བོ་ཆེ་རྣམས་ཡོངས་སུ་འཛིན་པ་དང་། ཀུན་དུ་འཛིན་པ་ཐོས་པའི་ཕྱིར་རོ་༎
 77| avyatireko vaidharmyadṛṣṭāntābhāso 'pradarśitavyatireko viparītavyatirekaś ceti | 78| avyatireko yathā |	ལྡོག་པ་མེད་པའི་ཆོས་མི་མཐུན་པའི་དཔེ་ལྟར་སྣང་བ་དང་༏་ལྡོག་པ་རབ་ཏུ་མ་བསྟན་པ་དང་། ལྡོག་པ་ཕྱིན་ཅི་ལོག་ཅེས་བྱ་བ་ལས་།
 kapiiādir avītarāgo vaktṛtvāt |	ལྡོག་པ་མེད་པ་ནི་དཔེར་ན་སེར་སྐྱ་ལ་སོགས་པ་འདོད་ཆགས་དང་བྲལ་བ་མ་ཡིན་ཏེ་། སྨྲས་པའི་ཕྱིར་རོ་༎
 yatrāvītarāgatvaṃ nāsti na sa vaktā yathopalakhaṇḍa iti |	གང་དུ་འདོད་ཆགས་དང་བྲལ་བ་མེད་པ་མ་ཡིན་པ་དེ་ནི་སྨྲ་བ་མ་ཡིན་ཏེ་།
 yady upalakhaṇḍād ayaṃ vyāvṛttas tathāpi sarvo vītarāgo vakteti saṃdehaḥ ||	དཔེར་ན་རྡོའི་དུམ་བུ་བཞིན་ནོ་ཞེས་བྱ་བ་ལ་གལ་ཏེ་འདི་རྡོའི་དུམ་བུ་ལས་ལོག་མོད་ཀྱི་། འོན་ཀྱང་འདོད་ཆགས་དང་བྲལ་བས་ཐམས་ཅད་ལས་སྨྲ་བ་ལོག་པ་མ་ཡིན་ཏེ་ཐེ་ཚོམ་ཟ་བའི་ཕྱིར་རོ་༎
 79| apradarśitavyatireko yathā | anityaḥ śabdaḥ kṛtakatvād ākāśādivad iti |	ལྡོག་པ་མ་བསྟན་པ་ནི་དཔེར་ན་སྒྲ་མི་རྟག་སྟེ་བྱས་པའི་ཕྱིར་ནམ་མཁའ་ལ་སོགས་པ་བཞིན་ནོ་ཞེས་བྱ་བ་ནི་དོན་དམ་པར་ཡང་དག་པ་དཔེ་ཡིན་ཡང་།
 paramārthataḥ saṃyag dṛṣṭānto 'py ayaṃ vaktṛdoṣād dṛṣṭāntābhāsaḥ |	སྨྲ་བ་པོའི་ཉེས་པས་དཔེ་ལྟར་སྣང་བ་ཡིན་ཏེ་།
 parārthānumāne vaktur guṇadoṣayor vicāryamāṇatvāt |	གཞན་གྱི་དོན་གྱི་རྗེས་སུ་དཔག་པ་ལ་སྨྲ་བ་པོའི་ཡོན་ཏན་དང་། ཉེས་པ་གཉིས་རྣམ་པར་དཔྱད་པར་བྱ་བ་ཡིན་པའི་ཕྱིར་རོ་༎
 tathā hi yan nityaṃ tat sarvaṃ niyamenākṛtakaṃ dṛṣṭaṃ yathākāśādir iti vacanena vibhajya vaktrā vyāptipūrvako vyātireko na pradarśita ity apradarśitavyatirekaḥ	འདི་ལྟར་གང་རྟག་པ་དེ་ཐམས་ཅད་ནི་ངེས་པར་མ་བྱས་པར་མཐོང་སྟེ་། དཔེར་ན་ནམ་མཁའ་ལ་སོགས་པ་བཞིན་ནོ་ཞེས་བྱ་བའི་ཚིག་གིས་རྣམ་པར་དབྱེ་སྟེ་སྨྲ་བ་པོས་ཁྱབ་པ་སྔོན་དུ་འགྲོ་བའི་ལྡོག་པ་མ་བསྟན་པའི་ཕྱིར་། ལྡོག་པ་རབ་ཏུ་མ་བསྟན་པ་ཞེས་བྱའོ་༎
 80| viparītavyatireko yathā |	ལྡོག་པ་ཕྱིན་ཅི་ལོག་ནི་དཔེར་ན་། གང་མ་བྱས་པ་དེ་ནི་རྟག་པར་མཐོང་སྟེ་ཞེས་བྱ་བ་ལ་འདིར་ནི་སྒྲུབ་པར་བྱེད་པ་ལོག་པ་ལ་ཁྱབ་པར་བསྟན་པར་བྱ་བ་ཡིན་ནོ་༏་། 
 yad akṛtakaṃ tan nityaṃ dṛṣṭam iti | atra sādhananivṛttyā sādhyanivṛttir vyāptā darśayitavyā tena yatra yatra sādhyanivṛttis tatra tatra niyamena sādhananivṛttiḥ sidhyatīti ||	དེས་ན་གང་དང་གང་བསྒྲུབ་པར་བྱ་བ་ལོག་པ་དེ་དང་དེས་ངེས་པར་སྒྲུབ་པར་བྱེད་པ་ལྡོག་པར་འགྱུར་རོ་༎
 81| uktā dṛṣṭāntābhāsā aṣṭādaśa ||	དཔེ་ལྟར་སྣང་བ་བཅོ་བརྒྱད་བཤད་ཟིན་ཏོ་༎
 82| eta eva sarve pakṣahetudṛṣṭāntābhāsāḥ | vādinā sādhayitum iṣṭam arthaṃ na sādhayantīti sādhanābhāsā (htu 271)	ཕྱོགས་དང་གཏན་ཚིགས་དང་། དཔེ་ལྟར་སྣང་བ་དེ་དག་ཉིད་ཀྱིས་རྒོལ་བས་སྒྲུབ་པར་མི་བྱེད་པའི་ཕྱིར་བསྒྲུབ་པ་ལྟར་སྣང་བར་འགྱུར་བ་ཡིན་ནོ་༎
 vādino bhavanti | evaṃ ca prativādinā dūṣaṇatvenopanyastā dūṣaṇāni bhavanti |	༄༣༡༩བ་འདི་ལྟར་ཡང་ཕྱིར་རྒོལ་བས་སུན་འབྱིན་པ་ཉིད་ཉེ་བར་བཀོད་པ་དེ་དག་སུན་འབྱིན་པར་འགྱུར་བ་ཡིན་ཏེ་།
 pūrvapakṣavādino 'bhipretārthasiddhipratibandhāt |	ཕྱོགས་སྔ་མ་རྒོལ་བའི་མངོན་པར་འདོད་པའི་དོན་འགྲུབ་པ་ལ་གགས་བྱེད་པའི་ཕྱིར་རོ་༎ སྒྲུབ་པར་བྱེད་པ་མ་ཚང་བར་བརྗོད་པ་ཉིད་སུན་འབྱིན་པ་ཡིན་ནོ་ཞེས་བསྟན་ཏོ་༎
 sādhanasya nyūnatodbhāvanam eva dūṣaṇasya lakṣaṇaṃ vibhajya pṛthag ucyate |	དེ་ལྟ་བས་ན་སྒྲུབ་པར་བྱེད་པ་བཞིན་དུ་སུན་འབྱིན་པའི་མཚན་ཉིད་རྣམ་པར་ཕྱེ་སྟེ་ལོགས་ཤིག་ཏུ་མ་བསྟན་ཏོ་༎
 83| dūṣaṇābhāsaḥ | etāny eva dūṣaṇāni prativādinoktāni | yadā pūrvapakṣavādī mithyādūṣaṇatvena pratipādayatīti tadā dūṣaṇābhāsā jātaya iti paṭhyante |	སུན་འབྱིན་པ་ལྟར་སྣང་བ་ནི་སུན་འབྱིན་པ་དེ་དག་ཉིད་ཕྱིར་རྒོལ་བས་སྨྲས་པ་ཡིན་ནོ་༎ གང་གི་ཚེ་ཕྱོགས་སྔ་མ་རྒོལ་བ་ཡང་དག་པ་མ་ཡིན་པའི་སྐྱོན་བརྗོད་པ་དེ་སུན་འབྱིན་པ་ལྟར་སྣང་བ་ཡིན་ཏེ་། ལྟག་ཆོད་ཅེས་བྱའོ་༎
 abhūtadoṣodbhāvanāni mithyottarāṇi jātyuttaraṇīti vacanāt |	ཡང་དག་པ་མ་ཡིན་པའི་སྐྱོན་བརྗོད་པ་ནི་ཕྱིན་ཅི་ལོག་གི་ལན་ཏེ་ལྟག་ཆོད་ཡིན་ནོ་ཞེས་བསྟན་ཏེ་། 
 yāthāduṣṭapakṣe pakṣadoṣodbhāvanaṃ nirdoṣe hetau hetudoṣakhyāpanam | aduṣṭadṛṣṭānte dṛṣṭāntadoṣopādānaṃ dūṣaṇābhāsa iti nyāyāt | j	དཔེར་ན་ཕྱོགས་སྐྱོན་མེད་པ་ལ་ཕྱོགས་ཀྱི་སྐྱོན་བརྗོད་པ་དང་། གཏན་ཚིགས་སྐྱོན་མེད་པ་ལ་གཏན་ཚིགས་ཀྱི་སྐྱོན་བརྗོད་པ་དང་། དཔེ་སྐྱོན་མེད་པ་ལ་དཔེའི་སྐྱོན་བརྗོད་པ་ནི་སུན་འབྱིན་པ་ལྟ་བ་སྣང་བ་ཞེས་བྱ་བར་རིག་པའི་ཕྱིར་རོ་༎
 84| tatra pratijñāhetudāharaṇopanayanigamanāni pañcāvayavaṃ paraiḥ sādhanam ucyate |	དེ་ལ་གཞན་དག་ནི་དམ་བཅའ་བ་དང་། གཏན་ཚིགས་དང་དཔེ་དང་། ཉེ་བར་སྦྱོར་བ་དང་མཇུག་བསྡུ་བ་དང་། ཡན་ལག་ལྔ་དང་ལྡན་པ་ནི་སྒྲུབ་པར་བྱེད་པ་ཡིན་ནོ་ཞེས་ཟེར་ཏེ་།
 yathānityaḥ śabda iti pratijñā kṛtakatvād iti hetuḥ |	དཔེར་ན་སྒྲ་མི་རྟག་སྟེ་ཞེས་བྱ་བ་ནི་དམ་བཅའ་བའོ་༎ བྱས་པའི་ཕྱིར་ཞེས་བྱ་བ་ནི་གཏན་ཚིགས་སོ་༎
 yat kṛtakaṃ tat sarvam anityaṃ dṛṣṭaṃ yathā ghaṭādīty udāharaṇam |	གང་བྱས་པ་དེ་ཐམས་ཅད་ནི་མི་རྟག་པར་མཐོང་སྟེ་། དཔེར་ན་བུམ་པ་ལ་སོགས་པ་ལྟ་བུ་ཞེས་བྱ་བ་ནི་དཔེའོ་༎
 tathā kṛtakaḥ śabda ity upanayaḥ |	དེ་བཞིན་དུ་སྒྲ་ཡང་བྱས་པ་ཡིན་ནོ་ཞེས་བྱ་བ་ནི་ཉེ་བར་སྦྱོར་བའོ་༎
 tasmād anitya iti nigamanam |	དེ་བས་ན་མི་རྟག་པ་ཡིན་ནོ་ཞེས་བྱ་བ་ནི་འཇུག་བསྡུ་བ་སྟེ་།
 dṛṣṭānte pratītisamartho hetur dharmiṇy upanīyata ity upanayaḥ |	དཔེ་ལ་རྟོགས་པའི་ནུས་པ་ཅན་གྱི་གཏན་ཚིགས་ཆོས་ཅན་ལ་ཉེ་བར་སྦྱོར་བ་ནི་ཉེ་བར་སྦྱོར་བ་ཞེས་བྱའོ་༎
 pratijñāyāḥ punarvacanaṃ nigamanam iti vacanāt |	དམ་བཅའ་བ་ཡང་ཟློས་པ་ནི་མཇུག་བསྡུ་བ་ཞེས་བསྟན་ཏོ་༎
 naitad asti | tribhir evāvayavair anvayavyatirekapakṣadharmasaṃjñakaiḥ sādhyārthasiddheḥ || 85| tathā hi | vādakāle vyāptipūrvaka eva prayogaḥ kartavyaḥ |	དེ་ལྟ་བུ་ནི་མེད་དེ་རྗེས་སུ་འགྲོ་བ་དང་། ལྡོག་པ་དང་ཕྱོགས་ཀྱི་ཆོས་ཞེས་བྱ་བ་ཡང་གསུམ་པ་ཉིད་ཀྱིས་བསྒྲུབ་པར་བྱ་བའི་དོན་འགྲུབ་པའི་ཕྱིར་རོ་༎ འདི་ལྟར་རྩོད་པའི་དུས་སུ་ཁྱབ་པ་སྔོན་དུ་འགྲོ་བ་ཉིད་ཀྱི་སྦྱོར་བ་པའི་ཕྱིར་རོ་༎ ཞེས་བྱ་སྟེ་། 
 yat kṛtakaṃ tat sarvam anityaṃ dṛstaṃ yathā ghaṭādir iti |	གང་བྱས་པ་དེ་ཐམས་ཅད་ནི་མི་རྟག་པར་མཐོང་སྟེ་པའི་ཕྱིར་རོ་༎ ཞེས་བྱ་སྟེ་། ། དཔེར་ན་བུམ་པ་བཞིན་ན་ཞེས་བྱ་བ་ནི་།
 sādhyena sādhanasya dṛṣṭānte vyāptikathanam anvaya ucyate ||	དཔེ་ལ་བསྒྲུབ་པར་བྱ་བས་སྒྲུབ་པར་བྱེད་པ་ལ་ཁྱབ་པ་བསྟན་པ་ནི་རྗེས་སུ་འགྲོ་བ་ཞེས་བསྟན་ཏོ་༎ མི་མཐུན་པའི་ཕྱོགས་ལ་ཡང་བསྒྲུབ་༄༣༢༠ཨ་༌་༎
 86| vipakṣe ca sādhyanivṛttyā sādhananivṛttir vyatireka ucyate yathāsaty anityatve na bhavaty eva kṛtakatvaṃ yathākāśādau |	པར་བྱ་བ་ལོག་པར་སྒྲུབ་པར་བྱེད་པ་ལ་ནི་ལྡོག་པ་ཞེས་བསྟན་ཏོ་༎ དཔེར་ན་མི་རྟག་པ་མེད་པས་བྱས་པ་ཉིད་དུ་མི་འགྱུར་ཏེ་། དཔེར་ན་ནམ་མཁའ་ལ་སོགས་པ་བཞིན་ནོ་༎
 (htu 272) 87| kṛtakaś ca śabda iti pakṣadharmavacanam |	སྒྲ་ཡང་བྱས་པའི་ཕྱིར་ཞེས་བྱ་བ་ལས་ཕྱོགས་ཀྱི་ཆོས་བསྟན་ཏོ་༎
 pratijñānigamane punaḥ sarvathā na vaktavye ||	དམ་བཅའ་བ་དང་མཇུག་བསྡུ་བ་ནི་རྣམ་པ་ཐམས་ཅད་དུ་བརྗོད་པར་མི་བྱའོ་༎
 88| tathā sādharmyavati prayoge 'nvayābhidhānasāmarthyād eva vyatireko 'vagantavya iti na pṛthag ucyate |	དེ་བཞིན་དུ་ཆོས་མཐུན་པ་ཉིད་ཅན་དག་གི་སྦྱོར་བ་ལ་རྗེས་སུ་འགྲོ་བ་བརྗོད་པ་ཤུགས་ཉིད་ཀྱིས་ལྡོག་པ་ཁོང་དུ་ཆུད་པས་འདི་ལོགས་ཤིག་ཏུ་མ་བསྟན་ཏོ་༎
 yathā yat kṛtakaṃ tat sarvam anityaṃ draṣṭavyam |	དཔེར་ན་གང་བྱས་པ་དེ་དག་ཐམས་ཅད་ནི་མི་རྟག་པར་མཐོང་སྟེ་།
 yathā ghaṭādiḥ | kṛtakaś ca śabda iti | sādharmyavān prayogaḥ |	དཔེར་ན་བུམ་པ་ལ་སོགས་པ་ལྟ་བུའོ་༏་། སྒྲ་ཡང་བྱས་པ་ཡིན་ནོ་ཞེས་བྱ་བ་ནི་ཆོས་མཐུན་པ་ཉིད་ཅན་གྱི་སྦྱོར་བའོ་༎
 tathā vaidharmyavati prayoge vyatirekoktisāmarthyād evānvayaḥ pratipanna iti nānvayaḥ punar ucyate |	ཆོས་མི་མཐུན་པ་ཉིད་ཅན་གྱི་སྦྱོར་བ་ནི་ལྡོག་པ་བསྟན་པའི་ཤུགས་ཉིད་ཀྱིས་རྗེས་སུ་འགྲོ་བ་རྟོགས་པའོ་༎ འདིར་ཡང་རྗེས་སུ་འགྲོ་བ་བརྗོད་པར་མི་བྱའོ་༎
 yan nityaṃ tad akṛtakaṃ dṛṣṭaṃ yathākāśādiḥ kṛtakaś ca śabda iti | vaidharmyavān prayogaḥ ||	གང་རྟག་པ་དེ་ནི་མ་བྱས་པར་མཐོང་སྟེ་། དཔེར་ན་ནམ་མཁའ་ལ་སོགས་པ་བཞིན་ནོ་༎ སྒྲ་ཡང་བྱས་པ་ཡིན་ནོ་ཞེས་བྱ་བ་ནི་ཆོས་མི་མཐུན་པའི་སྦྱོར་བའོ་༎
 89| uktāḥ sādhanābhāsā dūṣanābhasāḥ ||	བསྒྲུབ་པ་ལྟར་སྣང་བ་དང་། སུན་འབྱིན་པ་ལྟར་སྣང་བ་བཤད་ཟིན་ཏོ་༎
 90| pratyakṣaṃ kīdṛśam |	མངོན་སུམ་ཅི་འདྲ་བ་ཞིག་ཡིན་ཞེ་ན་།
 pratyakṣaṃ kalpanāpoḍham abhrāntam |	མངོན་སུམ་ནི་རྟོག་པ་དང་བྲལ་ཞིང་མ་འཁྲུལ་པ་སྟེ་དབང་པོ་ལ་སོ་སོར་གནས་པ་ནི་རྟེན་པའོ་༎ 
 pratigatam āśritam akṣaṃ yad vijñānaṃ tat pratyakṣam |	རྣམ་པར་ཤེས་པ་གང་ཡིན་པ་དེ་ནི་མངོན་སུམ་སྟེ་།
 pañcendriyāśrayāṇi jñānānīti yāvat |	དབང་པོ་ལྔ་ལ་བརྟེན་པའི་ཤེས་པ་ཡིན་ནོ་ཞེས་བྱ་བའི་ཐ་ཚིག་གོ་༎
 atyādayaḥ krāntādyarthe dvitiyayeti samāsena pratyakṣaśabdo vācyaliṅgaḥ siddhaḥ | pratyakṣo bodhaḥ pratyakṣā buddhiḥ | pratyakṣaṃ jñānam ity upapannaṃ bhavati ||	ཤིན་ཏུ་ལ་སོགས་པ་གནན་པ་ལ་སོགས་པའི་དོན་ལ་གཉིས་པ་ཞེས་བྱ་བ་བྱེད་པ་པོའི་བསྡུ་བས་མངོན་སུམ་གྱི་སྒྲ་ནི་བརྗོད་པར་བྱ་བའི་རྟགས་སུ་གྲུབ་སྟེ་མངོན་སུམ་རྟོགས་པ་དང་། མངོན་སུམ་བློ་དང་། མངོན་སུམ་ཤེས་པ་ཞེས་བྱ་བ་ནི་རིགས་པར་གྱུར་པ་ཡིན་ནོ་༎
 91| cakṣuḥśrotraghrāṇajihvākāyākhyāni pañcendriyāṇi tadāśritāni pañca jñānāni pramāṇāni |	མིག་དང་རྣ་བ་དང་སྣ་དང་ལྕེ་དང་ལུས་ཞེས་བྱ་བ་ནི་དབང་པོ་ལྔ་སྟེ་།
 tadgrāhyā viṣayā rūpaśabdagandharasasparśākhyāḥ prameyāṇi pañcaiva ||	དེ་ལ་བརྟེན་པའི་ཤེས་པ་ལྔ་ནི་གཟུང་བའི་ཡུལ་གཟུགས་དང་། སྒྲ་དང་། དྲི་དང་། རོ་དང་། རེག་བྱ་དང་ཞེས་བྱ་བ་གཞལ་བྱ་ལྔ་ཉིད་ལ་ཚད་མ་ཡིན་ནོ་༎
 92| tac ca pratyakṣaṃ nāmajātyādikalpanārahitaṃ nirvikalpakam abhrāntaṃ ca yadi bhavati | tadā pramāṇam ucyate |	མངོན་སུམ་དེ་ཡང་མིང་དང་རིགས་ལ་སོགས་པའི་རྟོགས་པ་དང་བྲལ་བ་རྣམ་པར་མི་རྟོག་པ་དང་གལ་ཏེ་ཡང་འཁྲུལ་པར་མ་གྱུར་པ་ཡིན་ན་ཚད་མར་བཤད་དེ་།
 darśitasyārthasyāvisaṃvādanāt ||	བསྟན་པའི་དོན་ལ་མི་སླུ་པའི་ཕྱིར་རོ་༎
 93| tatra nāmakalpanā | devadatto 'yam iti yad jñānam | jātikalpanā gaur iyam iti jñānam |	དེ་ལ་མིང་གི་རྣམ་པར་རྟོག་པ་ནི་འདི་ནི་༄༣༢༠བ་ལྷ་སྦྱིན་ནོ་ཞེས་བྱ་བར་ཤེས་པའོ་༎ རིགས་ཀྱི་རྣམ་པར་རྟོག་པ་ནི་འདི་ནི་བ་ལང་ངོ་སྙམ་དུ་ཤེས་པའོ་༎
 viśeṣaṇaviśeṣyam (htu 273) iti kalpanā nīlotpalam iti jñānaṃ |	ཁྱད་པར་དང་ཁྱད་པར་དུ་བྱ་བའི་རྣམ་པར་རྟོག་པ་ནི་ཨཽཏཔལ་སྔོན་པོ་ཞེས་བའོ་༎
 anyad api savikaipakaṃ jñānaṃ pratyakṣābhāsaḥ | bhrāntaṃ cārthe 'pi taimirikasya dvicandrajñānaṃ | śuktikāyāṃ rajatajñānaṃ sthāṇur ayaṃ puruṣo veti jñānam |	གཞན་ཡང་རྣམ་པར་རྟོག་པ་དང་བཅས་པའི་མངོན་སུམ་ལྟར་སྣང་བ་དང་། ཡང་དོན་ལ་འཁྲུལ་པ་རབ་རིབ་ཀྱིས་ཟླ་བ་གཉིས་སུ་ཤེས་པ་དང་། ཉ་ཕྱིས་ལ་དངུལ་དུ་ཤེས་པ་དང་། འདི་ནི་སྔོན་དུ་མ་མམ་སྐྱེས་བུའོ་ཞེས་ཤེས་པ་ཡིན་ནོ་༎
 anyad api jñānaṃ pratyakṣābhāsaḥ pradarśitārthāprāpakatvāt ||	ཤེས་པ་གཞན་ཡང་མངོན་སུམ་ལྟར་སྣང་བ་ཡིན་ཏེ་བསྟན་པའི་དོན་དང་ཕྲད་པར་མི་བྱེད་པའི་ཕྱིར་རོ་༎ 
 94| tatra trividhaṃ pratyakṣaṃ |	དེ་ལ་མངོན་སུམ་ནི་རྣམ་པ་གསུམ་སྟེ་།
 vyavahāram apekṣya indriyajñānam | sarvacittacaittānāṃ svarūpasaṃvedanaṃ svasaṃvedanam | bhūtārthabhāvanāprakarṣaparyantajaṃ yogijñānaṃ ceti ||	ཐ་སྙད་འདོགས་པའི་དབང་པོའི་ཤེས་པ་དང་། སེམས་དང་སེམས་ལས་བྱུང་བ་ཐམས་ཅད་རང་གི་ངོ་བོ་རིག་པ་ནི་རང་རིག་པ་དང་། ཡང་དག་པའི་དོན་བསྒོམས་པས་གསལ་བ་རབ་རིབ་ཀྱི་མཐར་ཐུག་པ་ནི་རྣལ་འབྱོར་གྱི་ཤེས་པའོ་༎ དེའི་ཡུལ་ནི་རང་གི་མཚན་ཉིད་དེ་།
 95| tasya viṣayaḥ svalakṣaṇam arthakriyāsamarthaṃ tu svalakṣaṇam ucyate |	དོན་བྱེད་པར་ནུས་པ་སྟེ་། རང་གི་མཚན་ཉིད་ལ་བྱའོ་༎
 sāmānyaṃ tu nārthakriyāsamartham |	སྤྱིས་ནི་དོན་བྱེད་པར་ནུས་པ་མ་ཡིན་ནོ་༎
 96| tad eva ca pratyakṣaṃ pramāṇam |	དེ་དག་ཉིད་ཀྱང་མངོན་སུམ་གྱི་ཚད་མ་ཡིན་ནོ་༎
 pramāṇam arthapratītirūpaṃ phalaṃ ca tādṛśam eva |	དོན་རྟོགས་པའི་ངོ་བོ་ཡིན་པའི་ཕྱིར་འབྲས་བུ་ཡང་ཡིན་ཏེ་དེ་དང་འདྲ་བ་ཚད་མ་ཉིད་ཀྱི་ཕྱིར་། 
 na pramāṇaphalayor bhedaḥ kaścid asti ||	ཚད་མ་དང་འབྲས་བུ་ལ་བྱེ་བྲག་ཅུང་ཟད་ཀྱང་མེད་དོ་༎
 97| anumānaṃ dvidhā svārthaṃ parārthaṃ ca |	རྗེས་སུ་དཔག་པ་ནི་རྣམ་པ་གཉིས་ཏེ་༏་རང་གི་དོན་དང་གཞན་གྱི་དོན་ཏོ་༎
 98| tatra svārthaṃ tāvat |	དེ་ལ་རང་གི་དོན་ནི་རེ་ཞིག་ཕྱོགས་ཀྱི་ཆོས་བཟུང་ནས་།
 gṛhīte ca pakṣadharme smṛte ca sādhyasādhanabhāve paścāt pratipattā yathārthaṃ pratipadyate yena tat svārtham anumānam |	བསྒྲུབ་པར་བྱ་བ་དང་སྒྲུབ་པར་བྱེད་པ་འབྲེལ་པ་དྲན་པའི་རྗེས་ལ་རྟོགས་པ་པོས་དོན་ཇི་ལྟ་བ་བཞིན་དུ་རྟོགས་པ་། གང་ཡིན་པ་དེ་ཉིད་རང་གི་དོན་གྱི་རྗེས་སུ་དཔག་པ་ཡིན་ནོ་༎
 99| pakṣadharmaś ca trividha eva bhavati |	ཕྱོགས་ཀྱི་ཆོས་ནི་རྣམ་པ་གསུམ་ཉིད་དུ་འགྱུར་ཏེ་།
 kāryaṃ svabhāvo 'nupalambhaś ceti |	འབྲས་བུ་དང་རང་བཞིན་དང་མི་དམིགས་པའོ་༎
 100| siddhe hi kāryakāraṇabhāve kāryaṃ hetur draṣṭavyaḥ |	རྒྱུ་དང་འབྲས་བུར་གྲུབ་ན་འབྲས་བུའི་གཏན་ཚིགས་ཡིན་པར་ལྟ་སྟེ་།
 yathā yatra dhūmas tatrāgniḥ | yathā mahānasādau |	དཔེར་ན་གང་ན་དུ་བ་ཡོད་པ་ན་མེ་ཡོད་དེ་། དཔེར་ན་ཚ་བ་ལ་སོགས་པ་བཞིན་ནོ་༎
 asti ceha dhūma iti [ asaty agnau na bhavaty eva dhūmo yathā sajalapradeśe |	འདི་ན་གང་དུ་བ་ཡོད་པའི་ཕྱིར་ཞེས་བྱ་བ་ལྟ་བུའོ་༎ མེ་མེད་ན་དུ་བ་ཡང་མེད་དེ་། དཔེར་ན་ཆུ་དང་བཅས་པའི་ཕྱོགས་ལྟ་བུའོ་༎
 asti ceha dhūma iti |	འདི་ན་ཡང་དུ་བ་ཡོད་པའི་ཕྱིར་ཞེས་བྱ་བ་ལྟ་བུའོ་༎
 101| svabhāvahetuḥ |	རང་བཞིན་གྱི་གཏན་ཚིགས་ནི་འདི་ནི་ཤིང་ཡིན་ཏེ་།
 vṛkṣo 'yaṃ śiṃśapātvād iti | pūrvapravartitaśiṃśapāvyavahāravat |	ཤིང་ཤ་པ་ཡིན་པའི་ཕྱིར་སྔོན་ཐ་སྙད་ཞུགས་པའི་ཤིང་ཤ་པ་བཞིན་ནོ་༎
 asati vṛkṣatve na bhavaty eva śiṃśapātvam |	ཤིང་མེད་ན་ཤིང་ཤ་པ་མེད་དེ་།
 yathā sthaṇḍilapradeśe |	དཔེར་ན་ཤིང་༄༣༢༡ཨ་༌་༎ གིས་དཔེན་པའི་ཕྱོགས་བཞིན་ནོ་༎
 atrāpi vyāpyavyāpakabhāve niścite sati vyāpyo hetur draṣṭavyaḥ || (htu 274)	འདིར་ཡང་ཁྱབ་པར་བྱེད་པའི་ངོ་བོ་དེས་ན་། ཁྱབ་པར་བྱ་བ་ནི་གཏན་ཚིགས་ཡིན་པར་ལྟའོ་༎
 102| anupalambhahetur yathā |	མི་དམིགས་པའི་གཏན་ཚིགས་ནི་།
 nātra ghaṭa upalabdhilakṣaṇaprāptasyānupalabdheḥ śaśaviṣāṇādivat |	འདི་ནི་བུམ་པ་མེད་དེ་། དམིགས་པའི་མཚན་ཉིད་ཀྱིར་གྱུར་པ་མི་དམིགས་པའི་ཕྱིར་ཏེ་། རི་བོང་གི་རབ༹་ལ་སོགས་པ་བཞིན་ནོ་༎ འདིར་ཡང་དམིགས་སུ་རུང་བ་དམིགས་པ་ལ་།
 atrāpi dṛṣyānupalambho dṛṣyābhavena vyāpto yadā niścitas tadāyaṃ hetur gamakaḥ ||	དམིགས་སུ་རུང་བ་མེད་པས་ཁྱབ་པར་གལ་ཏེ་དེས་ན་དེའི་ཚེ་གཏན་ཚིགས་འདི་རྟོགས་པར་བྱེད་པ་ཡིན་ནོ་༎ 
 103| anumānābhāsaḥ kīdṛśaḥ | pūrvavat | śeṣavat |	རྗེས་སུ་དཔག་པ་ལྟར་སྣང་བ་ཅི་འདྲ་ཞིག་ཅེ་ན་།
 sāmānyatodṛṣṭaṃ ceti paraiḥ kalpitam anumānaṃ sarvam anumānābhāsaḥ ||	སྔ་མ་དང་ལྡན་པ་དང་། ལྷག་མ་དང་ལྡན་པ་དང་། སྤྱི་མཐོང་བ་སྟེ་། གཞན་གྱིས་བརྟགས་པའི་རྗེས་སུ་དཔག་པ་ཐམས་ཅད་ནི་རྗེས་སུ་དཔག་པ་ལྟར་སྣང་བ་ཡིན་ཏེ་། དེ་རྣམས་ལ་དེའི་བདག་ཉིད་དང་དེ་ལས་བྱུང་བའི་མཚན་ཉིད་ཀྱི་འབྲེལ་པ་མེད་པའི་ཕྱིར་། རོ་༎ 
 teṣu tādātmyatadutpattilakṣaṇasya pratibandhābhāvāt [ siddhe saty eva hi kāryakāraṇabhāve vyāpyavyāpakabhāve ca sādhyasādhanabhāvo nānyathā vyabhicārasaṃbhavāt ||	རྒྱུ་དང་འབྲས་བུའི་འབྲེལ་པ་དང་། ཁྱབ་པར་བྱ་བ་དང་ཁྱབ་པར་བྱེད་པའི་འབྲེལ་བ་གྲུབ་པ་ཉིད་དུ་གྱུར་ན་། བསྒྲུབ་པར་བྱ་བ་དང་སྒྲུབ་པར་བྱེད་པའི་འབྲེལ་པ་ཡིན་གྱི་༎ གཞན་དུ་ནི་མ་ཡིན་ཏེ་སླུ་བ་མེད་པའི་ཕྱིར་རོ་༎
 104| yathā vṛṣṭimān ayaṃ megho gambhīradhvanatvād iti |	དཔེར་ན་སྤྲིན་འདི་ཆར་ལྟར་བཅས་པ་ཡིན་ཏེ་། འབྲུག་སྒྲ་ཟབ་མི་དང་ལྡན་པའི་ཕྱིར་རོ་ཞེས་བྱ་བ་ལ་།
 gambhīradhvanavato 'pi meghasya vṛṣṭivighātasaṃbhavāt ||	སྒྲ་ཟབ་མོ་དང་ལྡན་པའི་སྤྲིན་ལས་ཆར་མི་འབྱུང་བ་སྲིད་པའི་ཕྱིར་རོ་༎ དཔེར་ན་སྟོང་དུ་ཆར་བབ་པ་ཡིན་ཏེ་། གཙང་པོ་རྒྱས་པ་མཐོང་བའི་ཕྱིར་རོ་ཞེས་བྱ་བ་ལ་།
 105| yathopari vṛṣṭo devo nadīpūradarśanāt bandhabhaṅgādināpi nadīpūrasya darśaṇāt ||	གཙང་པོ་འགགས་པ་ལས་ཀྱང་ཆུ་བོ་རྒྱས་པར་མཐོང་བའི་ཕྱིར་རོ་༎ དེ་བཞིན་དུ་འབྲས་འདི་དག་ནི་ཆོས་པ་ཡིན་ཏེ་།
 106| yathā pakvā ete taṇḍulā ekasthālyantargatatvād dṛṣṭataṇḍulavat ||	ཕྲུ་བ་གཅིག་གི་ནང་ན་ཡོད་པའི་ཕྱིར་མཐོང་བའི་འབྲས་བཞིན་ནོ་༎
 107| pakvāny etāny phalāni ekaśākhaprabandhāt |	འབྲས་བུ་འདི་དག་ནི་སྨིན་པ་ཡིན་ཏེ་།
 upayuktaphalavat | atra bhūyo darśane 'pi sādhyasādhanayor vyabhicārasaṃbhava eva || 108| yathā yat pārthivaṃ tat sarvaṃ lohalekhyaṃ dṛṣṭam |	ཡལ་ག་གཅིག་ལས་སྐྱེས་པའི་ཕྱིར་ཟོས་པའི་འབྲས་བུ་བཞིན་ནོ་ཞེས་བྱ་བ་ལ་འདིར་ཕལ་ཆེར་དེ་ལྟར་མཐོང་བ་ཡང་བསྒྲུབ་པར་བྱ་བ་དང་། སྒྲུབ་པར་བྱེད་པ་དག་ལ་ནི་སླུ་བ་ཡོད་པ་ཁོ་ནའོ་༎ དཔེར་ན་གང་ས་ལས་སྐྱེས་པ་དེ་དག་ཐམས་ཅད་ནི་། ལྕགས་ཀྱིས་གཅོད་པར་མཐོང་སྟེ་། དཔེར་ན་ཤིང་ལ་སོགས་པ་བཞིན་ནོ་ཞེས་བྱ་བ་ལ་རྡོ་རྗེ་ཡངས་ལས་སྐྱེས་པ་ཡིན་ནོ་༎ གང་སྲོག་ཆགས་ཡིན་པ་དེ་དག་ཐམས་ཅད་ནི་མགྲིན་པ་དང་བཅས་པ་ཡིན་ཏེ་།
 yathā kāṣṭhādi) | vajram api pārthivaṃ || 109| yaḥ prāṇī sa sarvaḥ sagrīvaḥ |	དཔེར་ན་རྔ་མོ་ལ་སོགས་པ་བཞིན་ནོ་༎ བསྟན་བྱ་བ་ལ་།
 yathā karabhādiḥ kulīro 'pi prāṇī ||	ཀུ་ལི་ར་ཡང་སྲོག་ཆགས་ཡིན་ནོ་༎
 110| yathā yad dravad dravyam ārdrakṛt tad dṛṣṭaṃ yathodakaṃ |	དཔེར་ན་གང་༄༣༢༡བ་ཞུ་བའི་རྫས་དེ་ནི་རླན་གྱིས་བྱས་པར་མཐོང་སྟེ་། དཔེར་ན་ཆུ་བཞིན་ནོ་ཞེས་བྱ་བ་ལ་།
 pāradam api dravad dravyam iti |	རྔུལ་ཆུ་ཡང་ཞུ་བའི་རྫས་ཡིན་ནོ་༎
 evam anye 'py anumānābhāsā draṣṭavyā iti ||	དེ་བཞིན་དུ་གཞན་དག་ཀྱང་རྗེས་སུ་དཔག་པ་ལྟར་སྣང་བ་ཡིན་པར་བལྟ་བར་བྱའོ་༎
 hetutattvopadeśaḥ samāptaḥ ||	གཏན་ཚིགས་ཀྱི་དེ་ཁོ་ན་ཉིད་བསྟན་པ་། མཁས་པ་ཆེན་པོ་ཛེ་ཏའ་རིའི་ཞལ་སྔ་ནས་མཛད་པ་རྫོགས་སོ་།
